Balance (Global),Close price (Global),Close time (Global),Comment (Global),Comm/Swap (Global),Drawdown (Global),MAE (Global),MFE (Global),Open price (Global),Open time (Global),Order (Global),% Drawdown (Global),Profit/Loss (Global),Sample type (Global),Size (Global),Stop Loss (Global),Strategy name (Global),Symbol (Global),Ticket (Global),Time in trade (Global),Type (Global)
37.06,1.6078,02.01.2007 02:19:58,tp 1.60780,0.0,-0.0,0.0,0.0,1.6089,02.01.2007 02:05:00,1,-0.0,37.06,IS,0.41,0.0,Phase3-EA-SA2v2-EURCHF-M5-43,EURCHFMT4,2,14m 58s,Sell
112.66,233.08,02.01.2007 03:34:58,tp 233.080,0.0,-0.0,0.0,0.0,233.47,02.01.2007 02:30:00,2,-0.0,75.6,IS,0.23,0.0,Phase3-EA-S4v1-GBPJPY-M5-194,GBPJPYMT4,2,1h 4m,Sell
30.53,1.2146,02.01.2007 06:45:00,,0.0,-82.13000000000466,0.0,0.0,1.21632,02.01.2007 02:30:00,3,-0.09114146669292045,-82.13,IS,0.58,0.0,Phase3-EA-SA2v2-USDCHF-M15-107,USDCHFMT4,2,4h 15m,Buy
27.8,118.82,02.01.2007 22:00:00,,0.0,-84.86000000000058,0.0,0.0,118832,02.01.2007 18:15:00,4,-0.09417100771412205,-2.73,IS,0.27,0.0,Phase3-EA-S1v2-USDJPY-M15-0,USDJPYMT4,2,3h 45m,Buy
19.53,1.21312,03.01.2007 03:00:00,,-2.53,-93.13000000000466,0.0,0.0,1213,02.01.2007 22:45:00,5,-0.10334840853660812,-8.27,IS,0.58,0.0,Phase3-EA-SA2v2-USDCHF-M15-107,USDCHFMT4,4,4h 15m,Sell
59.76,119.46,03.01.2007 18:15:00,,0.0,-52.90000000000873,0.0,0.0,119282,03.01.2007 18:00:00,6,-0.058704293048289474,40.23,IS,0.27,0.0,Phase3-EA-S1v2-USDJPY-M15-0,USDJPYMT4,4,15m 0s,Buy
57.05,119.45,03.01.2007 18:30:00,,0.0,-55.610000000015134,0.0,0.0,119462,03.01.2007 18:15:00,7,-0.0617116396297869,-2.71,IS,0.27,0.0,Phase3-EA-S1v2-USDJPY-M15-0,USDJPYMT4,6,15m 0s,Buy
93.79,1.6153,03.01.2007 21:19:57,tp 1.61530,0.0,-18.870000000009895,0.0,0.0,1.6164,03.01.2007 20:45:00,8,-0.02094045387186428,36.74,IS,0.41,0.0,Phase3-EA-SA2v2-EURCHF-M5-43,EURCHFMT4,4,34m 57s,Sell
48.54,1.2253,04.01.2007 02:45:00,,-1.7,-64.1200000000099,0.0,0.0,1.22622,03.01.2007 22:30:00,9,-0.07115537372885218,-45.25,IS,0.58,0.0,Phase3-EA-SA2v2-USDCHF-M15-107,USDCHFMT4,6,4h 15m,Buy
24.86,232.68,04.01.2007 04:30:00,,-2.08,-87.80000000000291,0.0,0.0,232792,03.01.2007 23:05:00,10,-0.09743359035234661,-23.68,IS,0.23,0.0,Phase3-EA-S4v1-GBPJPY-M5-194,GBPJPYMT4,4,5h 25m,Buy
6.6,119.35,04.01.2007 06:15:00,,-1.97,-106.05999999999767,0.0,0.0,119422,03.01.2007 22:45:00,11,-0.11769711381286233,-18.26,IS,0.27,0.0,Phase3-EA-S1v2-USDJPY-M15-0,USDJPYMT4,8,7h 30m,Buy
-6.52,1614,04.01.2007 06:40:00,,-2.41,-119.17999999999302,0.0,0.0,1.61432,03.01.2007 22:20:00,12,-0.1322566662664192,-13.12,IS,0.41,0.0,Phase3-EA-SA2v2-EURCHF-M5-43,EURCHFMT4,6,8h 20m,Buy
-1.52,1.6137,04.01.2007 11:00:00,,0.0,-114.17999999999302,0.0,0.0,1.61352,04.01.2007 02:15:00,13,-0.12670805633747023,5.0,IS,0.34,0.0,Phase3-EA-S4v1-EURCHF-M15-221,EURCHFMT4,2,8h 45m,Buy
136.74,230.92,05.01.2007 02:59:58,tp 230.920,-1.75,-0.0,0.0,0.0,232.77,03.01.2007 23:00:00,14,-0.0,138.26,IS,0.09,0.0,Phase3-EA-B1v1-GBPJPY-M30-1,GBPJPYMT4,2,1d 3h 59m,Sell
-18.9,230692,05.01.2007 03:24:58,sl 230.692,-0.7,-155.63999999999942,0.0,0.0,231492,04.01.2007 23:05:00,15,-0.17267098854473703,-155.64,IS,0.23,0.0,Phase3-EA-S4v1-GBPJPY-M5-194,GBPJPYMT4,6,4h 19m,Buy
16.06,1.6117,05.01.2007 04:09:58,tp 1.61170,-1.66,-120.67999999999302,0.0,0.0,1.6128,04.01.2007 20:40:00,16,-0.13388547222807592,34.96,IS,0.41,0.0,Phase3-EA-SA2v2-EURCHF-M5-43,EURCHFMT4,8,7h 29m,Sell
-20.44,1609,05.01.2007 15:15:00,,0.0,-157.17999999999302,0.0,0.0,1.61032,05.01.2007 06:30:00,17,-0.17437950385158482,-36.5,IS,0.34,0.0,Phase3-EA-S4v1-EURCHF-M15-221,EURCHFMT4,4,8h 45m,Buy
-12.55,1.2356,08.01.2007 02:45:00,,-0.56,-149.2899999999936,0.0,0.0,1.23542,05.01.2007 22:30:00,18,-0.16562613646776395,7.89,IS,0.58,0.0,Phase3-EA-SA2v2-USDCHF-M15-107,USDCHFMT4,8,2d 4h 15m,Buy
-27.28,1.6066,08.01.2007 06:35:00,,-0.8,-164.01999999998952,0.0,0.0,1.60702,05.01.2007 22:15:00,19,-0.18196797443527413,-14.73,IS,0.41,0.0,Phase3-EA-SA2v2-EURCHF-M5-43,EURCHFMT4,10,2d 8h 20m,Buy
-70.47,228.33,08.01.2007 08:55:00,,0.0,-207.20999999999185,0.0,0.0,228552,08.01.2007 03:30:00,20,-0.229884062813889,-43.19,IS,0.23,0.0,Phase3-EA-S4v1-GBPJPY-M5-194,GBPJPYMT4,8,5h 25m,Buy
-133.17,118.37,08.01.2007 13:30:00,,-0.66,-269.90999999998894,0.0,0.0,118642,05.01.2007 22:30:00,21,-0.29944504316440657,-62.7,IS,0.27,0.0,Phase3-EA-S1v2-USDJPY-M15-0,USDJPYMT4,10,2d 15h 0m,Buy
-175.17,1.93002,08.01.2007 16:59:57,sl 1.93002,0.0,-311.90999999998894,0.0,0.0,1.93302,08.01.2007 11:30:00,22,-0.3460409151695401,-42.0,IS,0.14,0.0,Phase3-EA-B1v1-GBPUSD-M30-14,GBPUSDMT4,2,5h 29m,Buy
-226.53,229.49,08.01.2007 18:29:58,sl 229.490,-0.44,-363.2699999999895,0.0,0.0,228.82,05.01.2007 19:00:00,23,-0.40302101007867547,-51.36,IS,0.09,0.0,Phase3-EA-B1v1-GBPJPY-M30-1,GBPJPYMT4,4,2d 23h 29m,Sell
-192.87,118.7,08.01.2007 22:00:00,,0.0,-329.60999999998603,0.0,0.0,118552,08.01.2007 18:30:00,24,-0.3656777469431288,33.66,IS,0.27,0.0,Phase3-EA-S1v2-USDJPY-M15-0,USDJPYMT4,12,3h 30m,Buy
-347.61,231.11,09.01.2007 06:24:57,sl 231.110,0.0,-484.34999999999127,0.0,0.0,230.31,09.01.2007 01:40:00,25,-0.5373502525163337,-154.74,IS,0.23,0.0,Phase3-EA-S4v1-GBPJPY-M5-194,GBPJPYMT4,10,4h 44m,Sell
-442.81,1.61242,09.01.2007 07:20:00,,-1.66,-579.5499999999884,0.0,0.0,1.6096,08.01.2007 23:00:00,26,-0.6429675623946332,-95.2,IS,0.41,0.0,Phase3-EA-SA2v2-EURCHF-M5-43,EURCHFMT4,12,8h 20m,Sell
-368.81,231.17,10.01.2007 03:19:59,tp 231.170,-1.12,-505.54999999998836,0.0,0.0,231.56,09.01.2007 23:30:00,27,-0.5608700736236837,74.0,IS,0.23,0.0,Phase3-EA-S4v1-GBPJPY-M5-194,GBPJPYMT4,12,3h 49m,Sell
-358.41,1.6136,10.01.2007 13:00:00,,0.0,-495.1499999999942,0.0,0.0,1.61322,10.01.2007 04:15:00,28,-0.5493320481747999,10.4,IS,0.34,0.0,Phase3-EA-S4v1-EURCHF-M15-221,EURCHFMT4,6,8h 45m,Buy
-335.99,119.59,11.01.2007 01:00:00,,-1.96,-472.7299999999959,0.0,0.0,119482,10.01.2007 21:30:00,29,-0.524458727928252,22.42,IS,0.27,0.0,Phase3-EA-S1v2-USDJPY-M15-0,USDJPYMT4,14,3h 30m,Buy
-198.55,232572,11.01.2007 11:59:58,tp 232.572,-1.08,-335.2899999999936,0.0,0.0,230722,09.01.2007 03:30:00,30,-0.3719792839190696,137.44,IS,0.09,0.0,Phase3-EA-B1v1-GBPJPY-M30-1,GBPJPYMT4,6,2d 8h 29m,Buy
-190.02,120.34,11.01.2007 17:30:00,,0.0,-326.75999999999476,0.0,0.0,120302,11.01.2007 17:15:00,31,-0.362515884199933,8.53,IS,0.27,0.0,Phase3-EA-S1v2-USDJPY-M15-0,USDJPYMT4,16,15m 0s,Buy
-168.05,120.42,11.01.2007 18:15:00,,0.0,-304.7899999999936,0.0,0.0,120322,11.01.2007 18:00:00,32,-0.3381418054391512,21.97,IS,0.27,0.0,Phase3-EA-S1v2-USDJPY-M15-0,USDJPYMT4,18,15m 0s,Buy
-132.74,1.61122,12.01.2007 01:09:59,tp 1.61122,-0.79,-269.4799999999959,0.0,0.0,1.61012,11.01.2007 21:25:00,33,-0.2989679901891237,35.31,IS,0.41,0.0,Phase3-EA-SA2v2-EURCHF-M5-43,EURCHFMT4,14,3h 44m,Buy
-58.35,234402,12.01.2007 03:54:59,tp 234.402,0.0,-195.0899999999965,0.0,0.0,234012,12.01.2007 02:40:00,34,-0.21643782546384138,74.39,IS,0.23,0.0,Phase3-EA-S4v1-GBPJPY-M5-194,GBPJPYMT4,14,1h 14m,Buy
-11.91,1249,12.01.2007 05:14:58,tp 1.24900,0.0,-148.64999999999418,0.0,0.0,1.25,12.01.2007 02:45:00,35,-0.16491610413244828,46.44,IS,0.58,0.0,Phase3-EA-SA2v2-USDCHF-M15-107,USDCHFMT4,10,2h 29m,Sell
24.25,1.6099,12.01.2007 07:44:58,tp 1.60990,0.0,-112.48999999999069,0.0,0.0,1611,12.01.2007 01:20:00,36,-0.1247992771870723,36.16,IS,0.41,0.0,Phase3-EA-SA2v2-EURCHF-M5-43,EURCHFMT4,16,6h 24m,Sell
-38.89,1.61342,12.01.2007 10:15:00,,0.0,-175.6299999999901,0.0,0.0,1.6111,12.01.2007 01:30:00,37,-0.1948484047681224,-63.14,IS,0.34,0.0,Phase3-EA-S4v1-EURCHF-M15-221,EURCHFMT4,8,8h 45m,Sell
-88.95,234212,12.01.2007 11:29:58,sl 234.212,0.0,-225.68999999998778,0.0,0.0,234882,12.01.2007 10:00:00,38,-0.25038624649614327,-50.06,IS,0.09,0.0,Phase3-EA-B1v1-GBPJPY-M30-1,GBPJPYMT4,8,1h 29m,Buy
-72.45,120262,15.01.2007 03:00:00,,-1.01,-209.18999999998778,0.0,0.0,120.34,12.01.2007 23:00:00,39,-0.23208072535126936,16.5,IS,0.27,0.0,Phase3-EA-S1v2-USDJPY-M15-0,USDJPYMT4,20,2d 4h 0m,Sell
-54.17,1.6125,15.01.2007 06:45:00,,-0.79,-190.90999999998894,0.0,0.0,1.61192,12.01.2007 22:25:00,40,-0.21180042677379826,18.28,IS,0.41,0.0,Phase3-EA-SA2v2-EURCHF-M5-43,EURCHFMT4,18,2d 8h 20m,Buy
-50.13,120.43,15.01.2007 19:15:00,,0.0,-186.86999999999534,0.0,0.0,120412,15.01.2007 17:00:00,41,-0.2073183476571211,4.04,IS,0.27,0.0,Phase3-EA-S1v2-USDJPY-M15-0,USDJPYMT4,22,2h 15m,Buy
-32.73,1.61462,16.01.2007 04:55:00,,-1.64,-169.47000000000116,0.0,0.0,1.6152,15.01.2007 20:35:00,42,-0.18801434354071508,17.4,IS,0.41,0.0,Phase3-EA-SA2v2-EURCHF-M5-43,EURCHFMT4,20,8h 20m,Sell
16.58,236.62,16.01.2007 09:00:00,,0.0,-120.16000000000349,0.0,0.0,236362,16.01.2007 03:35:00,43,-0.13330857095564302,49.31,IS,0.23,0.0,Phase3-EA-S4v1-GBPJPY-M5-194,GBPJPYMT4,16,5h 25m,Buy
-25.42,1.96302,16.01.2007 13:29:58,sl 1.96302,0.0,-162.1600000000035,0.0,0.0,1.96602,16.01.2007 09:00:00,44,-0.17990444296077657,-42.0,IS,0.14,0.0,Phase3-EA-B1v1-GBPUSD-M30-14,GBPUSDMT4,4,4h 29m,Buy
-64.27,1613,16.01.2007 14:45:00,,0.0,-201.0100000000093,0.0,0.0,1.61442,16.01.2007 06:00:00,45,-0.22300562456553155,-38.85,IS,0.34,0.0,Phase3-EA-S4v1-EURCHF-M15-221,EURCHFMT4,10,8h 45m,Buy
-28.93,1.61302,17.01.2007 00:19:57,tp 1.61302,-0.79,-165.6700000000128,0.0,0.0,1.61192,16.01.2007 21:05:00,46,-0.18379852654978734,35.34,IS,0.41,0.0,Phase3-EA-SA2v2-EURCHF-M5-43,EURCHFMT4,22,3h 14m,Buy
-14.37,120.7,17.01.2007 01:15:00,,-0.65,-151.11000000001513,0.0,0.0,120632,16.01.2007 22:15:00,47,-0.16764529092134364,14.56,IS,0.27,0.0,Phase3-EA-S1v2-USDJPY-M15-0,USDJPYMT4,24,3h 0m,Buy
-6.0,1.24802,17.01.2007 04:30:00,,0.0,-142.7400000000198,0.0,0.0,1.2482,17.01.2007 00:15:00,48,-0.15835939928604004,8.37,IS,0.58,0.0,Phase3-EA-SA2v2-USDCHF-M15-107,USDCHFMT4,12,4h 15m,Sell
-48.69,1.9644,17.01.2007 10:59:57,sl 1.96440,-0.69,-185.43000000002212,0.0,0.0,1.9614,16.01.2007 18:00:00,49,-0.20572077490268906,-42.69,IS,0.14,0.0,Phase3-EA-B1v1-GBPUSD-M30-14,GBPUSDMT4,6,16h 59m,Sell
-68.29,1.61382,17.01.2007 15:15:00,,0.0,-205.03000000002794,0.0,0.0,1.6131,17.01.2007 06:30:00,50,-0.22746551517175784,-19.6,IS,0.34,0.0,Phase3-EA-S4v1-EURCHF-M15-221,EURCHFMT4,12,8h 45m,Sell
-125.11,1.2453,18.01.2007 06:00:00,,0.0,-261.8500000000349,0.0,0.0,1.24652,18.01.2007 01:45:00,51,-0.29050307344156767,-56.82,IS,0.58,0.0,Phase3-EA-SA2v2-USDCHF-M15-107,USDCHFMT4,14,4h 15m,Buy
-118.25,1.6138,18.01.2007 07:45:00,,-2.37,-254.99000000003434,0.0,0.0,1.61352,17.01.2007 23:25:00,52,-0.2828924143473952,6.86,IS,0.41,0.0,Phase3-EA-SA2v2-EURCHF-M5-43,EURCHFMT4,24,8h 20m,Buy
19.02,239662,18.01.2007 11:29:59,tp 239.662,0.0,-117.72000000003027,0.0,0.0,237812,18.01.2007 06:00:00,53,-0.13060157267727926,137.27,IS,0.09,0.0,Phase3-EA-B1v1-GBPJPY-M30-1,GBPJPYMT4,10,5h 29m,Buy
55.18,1.61712,18.01.2007 22:59:57,tp 1.61712,0.0,-81.56000000002678,0.0,0.0,1.61602,18.01.2007 22:10:00,54,-0.0904847457319033,36.16,IS,0.41,0.0,Phase3-EA-SA2v2-EURCHF-M5-43,EURCHFMT4,26,49m 57s,Buy
0.19,1.61892,19.01.2007 13:30:00,,0.0,-136.55000000003201,0.0,0.0,1.6169,19.01.2007 04:45:00,55,-0.15149205529291607,-54.99,IS,0.34,0.0,Phase3-EA-S4v1-EURCHF-M15-221,EURCHFMT4,14,8h 45m,Sell
35.55,1.61852,22.01.2007 04:20:00,tp 1.61852,-0.79,-101.19000000003143,0.0,0.0,1.61742,19.01.2007 21:20:00,56,-0.11226276876668873,35.36,IS,0.41,0.0,Phase3-EA-SA2v2-EURCHF-M5-43,EURCHFMT4,28,2d 7h 0m,Buy
23.8,239672,22.01.2007 08:55:00,,0.0,-112.94000000003143,0.0,0.0,239.61,22.01.2007 03:30:00,57,-0.1252985186728868,-11.75,IS,0.23,0.0,Phase3-EA-S4v1-GBPJPY-M5-194,GBPJPYMT4,18,5h 25m,Sell
15.09,1.61842,22.01.2007 13:30:00,,0.0,-121.65000000003783,0.0,0.0,1.6181,22.01.2007 04:45:00,58,-0.13496161498633943,-8.71,IS,0.34,0.0,Phase3-EA-S4v1-EURCHF-M15-221,EURCHFMT4,16,8h 45m,Sell
36.83,121.71,22.01.2007 18:45:00,,0.0,-99.9100000000326,0.0,0.0,121612,22.01.2007 17:45:00,59,-0.11084270409605737,21.74,IS,0.27,0.0,Phase3-EA-S1v2-USDJPY-M15-0,USDJPYMT4,26,1h 0m,Buy
19.51,1.24922,23.01.2007 02:30:00,,-2.46,-117.23000000003958,0.0,0.0,1.2489,22.01.2007 22:15:00,60,-0.13005795417056304,-17.32,IS,0.58,0.0,Phase3-EA-SA2v2-USDCHF-M15-107,USDCHFMT4,16,4h 15m,Sell
10.66,1.61782,23.01.2007 06:25:00,,-1.64,-126.0800000000454,0.0,0.0,1.6176,22.01.2007 22:05:00,61,-0.1398763700573655,-8.85,IS,0.41,0.0,Phase3-EA-SA2v2-EURCHF-M5-43,EURCHFMT4,30,8h 20m,Sell
64.88,1.61622,23.01.2007 14:45:00,,0.0,-71.86000000004424,0.0,0.0,1.6182,23.01.2007 06:00:00,62,-0.07972331814978469,54.22,IS,0.34,0.0,Phase3-EA-S4v1-EURCHF-M15-221,EURCHFMT4,18,8h 45m,Sell
201.51,241452,23.01.2007 18:29:57,tp 241.452,-0.54,-0.0,0.0,0.0,239602,19.01.2007 05:00:00,63,-0.0,136.63,IS,0.09,0.0,Phase3-EA-B1v1-GBPJPY-M30-1,GBPJPYMT4,12,4d 13h 29m,Buy
248.24,1.2412,23.01.2007 22:14:59,tp 1.24120,0.0,-0.0,0.0,0.0,1.2422,23.01.2007 22:00:00,64,-0.0,46.73,IS,0.58,0.0,Phase3-EA-SA2v2-USDCHF-M15-107,USDCHFMT4,18,14m 59s,Sell
254.46,121.64,24.01.2007 01:45:00,,0.0,-0.0,0.0,0.0,121612,24.01.2007 01:15:00,65,-0.0,6.22,IS,0.27,0.0,Phase3-EA-S1v2-USDJPY-M15-0,USDJPYMT4,28,30m 0s,Buy
328.18,241322,24.01.2007 03:34:57,tp 241.322,0.0,-0.0,0.0,0.0,240932,24.01.2007 00:55:00,66,-0.0,73.72,IS,0.23,0.0,Phase3-EA-S4v1-GBPJPY-M5-194,GBPJPYMT4,20,2h 39m,Buy
226.89,1.61862,24.01.2007 04:30:00,,-1.65,-101.2899999999936,0.0,0.0,1.6156,23.01.2007 20:10:00,67,-0.11213554839696055,-101.29,IS,0.41,0.0,Phase3-EA-SA2v2-EURCHF-M5-43,EURCHFMT4,32,8h 20m,Sell
289.22,1.61612,24.01.2007 11:30:00,,0.0,-38.95999999999185,0.0,0.0,1.6184,24.01.2007 02:45:00,68,-0.04313161186242418,62.33,IS,0.34,0.0,Phase3-EA-S4v1-EURCHF-M15-221,EURCHFMT4,20,8h 45m,Sell
335.65,1.24932,24.01.2007 23:14:57,tp 1.24932,0.0,-0.0,0.0,0.0,1.24832,24.01.2007 23:00:00,69,-0.0,46.43,IS,0.58,0.0,Phase3-EA-SA2v2-USDCHF-M15-107,USDCHFMT4,20,14m 57s,Buy
268.58,121.05,25.01.2007 00:15:00,,-1.94,-67.07000000000698,0.0,0.0,121342,24.01.2007 17:15:00,70,-0.07424532839472237,-67.07,IS,0.27,0.0,Phase3-EA-S1v2-USDJPY-M15-0,USDJPYMT4,30,7h 0m,Buy
299.8,1.6174,25.01.2007 01:34:57,tp 1.61740,-4.93,-35.85000000000582,0.0,0.0,1.6185,24.01.2007 21:20:00,71,-0.039685329103189976,31.22,IS,0.41,0.0,Phase3-EA-SA2v2-EURCHF-M5-43,EURCHFMT4,34,4h 14m,Sell
373.93,238.09,25.01.2007 02:14:59,tp 238.090,0.0,-0.0,0.0,0.0,238.48,25.01.2007 00:50:00,72,-0.0,74.13,IS,0.23,0.0,Phase3-EA-S4v1-GBPJPY-M5-194,GBPJPYMT4,22,1h 24m,Sell
415.93,120862,25.01.2007 03:00:00,,0.0,-0.0,0.0,0.0,121.05,25.01.2007 00:15:00,73,-0.0,42.0,IS,0.27,0.0,Phase3-EA-S1v2-USDJPY-M15-0,USDJPYMT4,32,2h 45m,Sell
263.29,237342,25.01.2007 05:09:58,sl 237.342,0.0,-152.63999999999942,0.0,0.0,238142,25.01.2007 02:30:00,74,-0.16881980863327897,-152.64,IS,0.23,0.0,Phase3-EA-S4v1-GBPJPY-M5-194,GBPJPYMT4,24,2h 39m,Buy
239.61,1.6172,25.01.2007 10:20:00,,0.0,-176.31999999999243,0.0,0.0,1.61792,25.01.2007 02:00:00,75,-0.1950098837671553,-23.68,IS,0.41,0.0,Phase3-EA-SA2v2-EURCHF-M5-43,EURCHFMT4,36,8h 20m,Buy
236.34,1.6177,25.01.2007 10:30:00,,0.0,-179.5899999999965,0.0,0.0,1.61782,25.01.2007 01:45:00,76,-0.19862650309519192,-3.27,IS,0.34,0.0,Phase3-EA-S4v1-EURCHF-M15-221,EURCHFMT4,22,8h 45m,Buy
85.01,238.93,26.01.2007 02:44:57,sl 238.930,0.0,-330.91999999999825,0.0,0.0,238.13,26.01.2007 01:00:00,77,-0.3659974519976716,-151.33,IS,0.23,0.0,Phase3-EA-S4v1-GBPJPY-M5-194,GBPJPYMT4,26,1h 44m,Sell
86.27,1.24822,26.01.2007 03:15:00,,-2.46,-329.6600000000035,0.0,0.0,1.2483,25.01.2007 23:00:00,78,-0.3646038922566008,1.26,IS,0.58,0.0,Phase3-EA-SA2v2-USDCHF-M15-107,USDCHFMT4,22,4h 15m,Sell
160.13,238.44,26.01.2007 04:49:58,tp 238.440,0.0,-255.8000000000029,0.0,0.0,238.83,26.01.2007 03:05:00,79,-0.2829147474344432,73.86,IS,0.23,0.0,Phase3-EA-S4v1-GBPJPY-M5-194,GBPJPYMT4,28,1h 44m,Sell
206.39,1.25372,29.01.2007 03:14:57,tp 1.25372,0.0,-209.54000000000815,0.0,0.0,1.25272,29.01.2007 02:00:00,80,-0.2317511969406367,46.26,IS,0.58,0.0,Phase3-EA-SA2v2-USDCHF-M15-107,USDCHFMT4,24,1h 14m,Buy
191.02,1.61892,29.01.2007 04:45:00,,-1.64,-224.9100000000035,0.0,0.0,1.6185,26.01.2007 20:25:00,81,-0.24875041378217708,-15.37,IS,0.41,0.0,Phase3-EA-SA2v2-EURCHF-M5-43,EURCHFMT4,38,2d 8h 20m,Sell
225.38,1.6224,30.01.2007 03:54:58,tp 1.62240,-1.64,-190.5500000000029,0.0,0.0,1.6235,29.01.2007 21:40:00,82,-0.21074826084297643,34.36,IS,0.41,0.0,Phase3-EA-SA2v2-EURCHF-M5-43,EURCHFMT4,40,6h 14m,Sell
258.38,238.75,30.01.2007 05:15:00,,-0.68,-157.5500000000029,0.0,0.0,238572,29.01.2007 23:50:00,83,-0.17425026762430357,33.0,IS,0.23,0.0,Phase3-EA-S4v1-GBPJPY-M5-194,GBPJPYMT4,30,5h 25m,Buy
197.21,1.2516,30.01.2007 06:30:00,,0.0,-218.72000000000116,0.0,0.0,1.25292,30.01.2007 02:15:00,84,-0.24190427505418707,-61.17,IS,0.58,0.0,Phase3-EA-SA2v2-USDCHF-M15-107,USDCHFMT4,26,4h 15m,Buy
215.66,1.6235,30.01.2007 12:00:00,,0.0,-200.27000000000407,0.0,0.0,1.62282,30.01.2007 03:15:00,85,-0.22149857884556864,18.45,IS,0.34,0.0,Phase3-EA-S4v1-EURCHF-M15-221,EURCHFMT4,24,8h 45m,Buy
259.56,1251,31.01.2007 01:14:58,tp 1.25100,-2.46,-156.3700000000099,0.0,0.0,1252,30.01.2007 23:45:00,86,-0.1729451878667951,43.9,IS,0.58,0.0,Phase3-EA-SA2v2-USDCHF-M15-107,USDCHFMT4,28,1h 29m,Sell
260.34,121622,31.01.2007 01:15:00,,-1.0,-155.59000000001106,0.0,0.0,121.63,30.01.2007 23:45:00,87,-0.1720825080270823,0.78,IS,0.27,0.0,Phase3-EA-S1v2-USDJPY-M15-0,USDJPYMT4,34,1h 30m,Sell
306.67,1.25202,31.01.2007 03:29:58,tp 1.25202,0.0,-109.26000000000931,0.0,0.0,1.25102,31.01.2007 01:15:00,88,-0.12084153754765267,46.33,IS,0.58,0.0,Phase3-EA-SA2v2-USDCHF-M15-107,USDCHFMT4,30,2h 14m,Buy
341.07,1.6222,31.01.2007 04:10:00,tp 1.62220,-1.64,-74.86000000001513,0.0,0.0,1.6233,30.01.2007 23:45:00,89,-0.0827951446166789,34.4,IS,0.41,0.0,Phase3-EA-SA2v2-EURCHF-M5-43,EURCHFMT4,42,4h 25m,Sell
297.16,238.39,31.01.2007 08:40:00,,0.0,-118.77000000001863,0.0,0.0,238622,31.01.2007 03:15:00,90,-0.1313595955934078,-43.91,IS,0.23,0.0,Phase3-EA-S4v1-GBPJPY-M5-194,GBPJPYMT4,32,5h 25m,Buy
304.75,1.6224,31.01.2007 13:45:00,,0.0,-111.18000000002212,0.0,0.0,1.62212,31.01.2007 05:00:00,91,-0.12296505715311688,7.59,IS,0.34,0.0,Phase3-EA-S4v1-EURCHF-M15-221,EURCHFMT4,26,8h 45m,Buy
254.75,237.43,31.01.2007 19:29:58,sl 237.430,0.0,-161.18000000002212,0.0,0.0,236.76,31.01.2007 19:00:00,92,-0.17826504687837882,-50.0,IS,0.09,0.0,Phase3-EA-B1v1-GBPJPY-M30-1,GBPJPYMT4,14,29m 58s,Sell
291.0,1.6205,01.02.2007 03:10:00,tp 1.62050,0.0,-124.93000000002212,0.0,0.0,1.6216,01.02.2007 01:45:00,93,-0.13817255432756392,36.25,IS,0.41,0.0,Phase3-EA-SA2v2-EURCHF-M5-43,EURCHFMT4,44,1h 25m,Sell
321.88,120642,01.02.2007 04:45:00,,0.0,-94.05000000001746,0.0,0.0,120.78,01.02.2007 01:15:00,94,-0.104019280673237,30.88,IS,0.27,0.0,Phase3-EA-S1v2-USDJPY-M15-0,USDJPYMT4,36,3h 30m,Sell
347.47,237.52,02.02.2007 04:25:00,,-0.69,-68.46000000002095,0.0,0.0,237382,01.02.2007 23:00:00,95,-0.0757167459318518,25.59,IS,0.23,0.0,Phase3-EA-S4v1-GBPJPY-M5-194,GBPJPYMT4,34,5h 25m,Buy
323.23,1.24412,02.02.2007 04:30:00,,0.0,-92.7000000000262,0.0,0.0,1.2436,02.02.2007 00:15:00,96,-0.10252618095066458,-24.24,IS,0.58,0.0,Phase3-EA-SA2v2-USDCHF-M15-107,USDCHFMT4,32,4h 15m,Sell
278.08,1.61942,02.02.2007 04:40:00,,-1.65,-137.85000000002037,0.0,0.0,1.6181,01.02.2007 20:20:00,97,-0.15246207167256967,-45.15,IS,0.41,0.0,Phase3-EA-SA2v2-EURCHF-M5-43,EURCHFMT4,46,8h 20m,Sell
357.79,121.27,02.02.2007 17:15:00,,0.0,-58.14000000001397,0.0,0.0,120912,02.02.2007 17:00:00,98,-0.06430282805255003,79.71,IS,0.27,0.0,Phase3-EA-S1v2-USDJPY-M15-0,USDJPYMT4,38,15m 0s,Buy
404.28,1.2476,05.02.2007 03:29:58,tp 1.24760,0.0,-11.650000000008731,0.0,0.0,1.2486,05.02.2007 02:15:00,99,-0.012884897605995685,46.49,IS,0.58,0.0,Phase3-EA-SA2v2-USDCHF-M15-107,USDCHFMT4,34,1h 14m,Sell
389.71,1.6166,05.02.2007 08:15:00,,-0.79,-26.220000000015716,0.0,0.0,1.61702,02.02.2007 23:50:00,100,-0.028999314611944736,-14.57,IS,0.41,0.0,Phase3-EA-SA2v2-EURCHF-M5-43,EURCHFMT4,48,2d 8h 25m,Buy
345.05,1.95932,05.02.2007 12:59:57,sl 1.95932,-2.66,-70.88000000001921,0.0,0.0,1.96232,31.01.2007 19:30:00,101,-0.07839326543455255,-44.66,IS,0.14,0.0,Phase3-EA-B1v1-GBPUSD-M30-14,GBPUSDMT4,8,4d 17h 29m,Buy
366.26,1.6174,05.02.2007 13:45:00,,0.0,-49.670000000012806,0.0,0.0,1.61662,05.02.2007 05:00:00,102,-0.054935009793089365,21.21,IS,0.34,0.0,Phase3-EA-S4v1-EURCHF-M15-221,EURCHFMT4,28,8h 45m,Buy
412.73,1.2482,05.02.2007 22:44:58,tp 1.24820,0.0,-3.2000000000116415,0.0,0.0,1.2492,05.02.2007 22:15:00,103,-0.0035391993424296387,46.47,IS,0.58,0.0,Phase3-EA-SA2v2-USDCHF-M15-107,USDCHFMT4,36,29m 58s,Sell
431.48,120222,06.02.2007 02:15:00,,-1.01,-0.0,0.0,0.0,120.31,05.02.2007 23:00:00,104,-0.0,18.75,IS,0.27,0.0,Phase3-EA-S1v2-USDJPY-M15-0,USDJPYMT4,40,3h 15m,Sell
465.98,1.6132,06.02.2007 05:05:00,tp 1.61320,-1.64,-0.0,0.0,0.0,1.6143,05.02.2007 22:15:00,105,-0.0,34.5,IS,0.41,0.0,Phase3-EA-SA2v2-EURCHF-M5-43,EURCHFMT4,50,6h 50m,Sell
496.19,235.84,06.02.2007 07:50:00,,0.0,-0.0,0.0,0.0,235682,06.02.2007 02:25:00,106,-0.0,30.21,IS,0.23,0.0,Phase3-EA-S4v1-GBPJPY-M5-194,GBPJPYMT4,36,5h 25m,Buy
468.35,1.6125,06.02.2007 13:15:00,,0.0,-27.839999999996508,0.0,0.0,1.61352,06.02.2007 04:30:00,107,-0.0307637260750939,-27.84,IS,0.34,0.0,Phase3-EA-S4v1-EURCHF-M15-221,EURCHFMT4,30,8h 45m,Buy
417.85,237.28,06.02.2007 19:29:57,sl 237.280,-0.43,-78.33999999999651,0.0,0.0,236.61,05.02.2007 13:00:00,108,-0.08656718034206362,-50.5,IS,0.09,0.0,Phase3-EA-B1v1-GBPJPY-M30-1,GBPJPYMT4,16,1d 6h 29m,Sell
454.23,1.60982,06.02.2007 23:14:57,tp 1.60982,0.0,-41.95999999999185,0.0,0.0,1.60872,06.02.2007 20:25:00,109,-0.046366592891912764,36.38,IS,0.41,0.0,Phase3-EA-SA2v2-EURCHF-M5-43,EURCHFMT4,52,2h 49m,Buy
489.57,120.71,07.02.2007 18:15:00,,0.0,-6.619999999995343,0.0,0.0,120552,07.02.2007 17:15:00,110,-0.007315225094001578,35.34,IS,0.27,0.0,Phase3-EA-S1v2-USDJPY-M15-0,USDJPYMT4,42,1h 0m,Buy
484.65,120.69,07.02.2007 18:30:00,,0.0,-11.539999999993597,0.0,0.0,120712,07.02.2007 18:15:00,111,-0.012751918064167787,-4.92,IS,0.27,0.0,Phase3-EA-S1v2-USDJPY-M15-0,USDJPYMT4,44,15m 0s,Buy
523.98,1.2405,08.02.2007 02:44:58,tp 1.24050,-7.43,-0.0,0.0,0.0,1.2415,07.02.2007 22:30:00,112,-0.0,39.33,IS,0.58,0.0,Phase3-EA-SA2v2-USDCHF-M15-107,USDCHFMT4,38,4h 14m,Sell
442.44,1.61642,08.02.2007 05:10:00,,-4.96,-81.5399999999936,0.0,0.0,1.6141,07.02.2007 20:50:00,113,-0.09007557997338785,-81.54,IS,0.41,0.0,Phase3-EA-SA2v2-EURCHF-M5-43,EURCHFMT4,54,8h 20m,Sell
356.43,238202,08.02.2007 06:10:00,,0.0,-167.54999999998836,0.0,0.0,237.75,08.02.2007 00:45:00,114,-0.18508907805422212,-86.01,IS,0.23,0.0,Phase3-EA-S4v1-GBPJPY-M5-194,GBPJPYMT4,38,5h 25m,Sell
312.3,1.95892,08.02.2007 15:59:58,sl 1.95892,-2.13,-211.67999999999302,0.0,0.0,1.96192,06.02.2007 11:00:00,115,-0.23383859171900426,-44.13,IS,0.14,0.0,Phase3-EA-B1v1-GBPUSD-M30-14,GBPUSDMT4,10,2d 4h 59m,Buy
262.63,237602,08.02.2007 16:29:58,sl 237.602,0.0,-261.34999999999127,0.0,0.0,238272,08.02.2007 08:00:00,116,-0.28870803073394624,-49.67,IS,0.09,0.0,Phase3-EA-B1v1-GBPJPY-M30-1,GBPJPYMT4,18,8h 29m,Buy
279.76,1246,09.02.2007 03:15:00,,-0.56,-244.2199999999866,0.0,0.0,1.24562,08.02.2007 23:00:00,117,-0.2697848680537319,17.13,IS,0.58,0.0,Phase3-EA-SA2v2-USDCHF-M15-107,USDCHFMT4,40,4h 15m,Buy
226.3,237602,09.02.2007 08:00:00,,0.0,-297.679999999993,0.0,0.0,237.32,09.02.2007 02:35:00,118,-0.32884104300318334,-53.46,IS,0.23,0.0,Phase3-EA-S4v1-GBPJPY-M5-194,GBPJPYMT4,40,5h 25m,Sell
255.68,1.62532,09.02.2007 15:30:00,,0.0,-268.29999999998836,0.0,0.0,1.6264,09.02.2007 06:45:00,119,-0.296385554413304,29.38,IS,0.34,0.0,Phase3-EA-S4v1-EURCHF-M15-221,EURCHFMT4,32,8h 45m,Sell
273.95,1.6237,12.02.2007 04:45:00,,-0.79,-250.02999999998428,0.0,0.0,1.62312,09.02.2007 20:25:00,120,-0.2762030569137419,18.27,IS,0.41,0.0,Phase3-EA-SA2v2-EURCHF-M5-43,EURCHFMT4,56,2d 8h 20m,Buy
271.69,238132,12.02.2007 07:40:00,,0.0,-252.28999999997905,0.0,0.0,238.12,12.02.2007 02:15:00,121,-0.2786996329591111,-2.26,IS,0.23,0.0,Phase3-EA-S4v1-GBPJPY-M5-194,GBPJPYMT4,42,5h 25m,Sell
222.22,237492,12.02.2007 11:29:58,sl 237.492,0.0,-301.7599999999802,0.0,0.0,238162,12.02.2007 02:30:00,122,-0.33334813604083724,-49.47,IS,0.09,0.0,Phase3-EA-B1v1-GBPJPY-M30-1,GBPJPYMT4,20,8h 59m,Buy
205.41,1.62492,12.02.2007 14:45:00,,0.0,-318.5699999999779,0.0,0.0,1.6243,12.02.2007 06:00:00,123,-0.3519178012278934,-16.81,IS,0.34,0.0,Phase3-EA-S4v1-EURCHF-M15-221,EURCHFMT4,34,8h 45m,Sell
278.03,236.91,13.02.2007 03:09:59,tp 236.910,-1.09,-245.94999999998254,0.0,0.0,237.3,12.02.2007 23:00:00,124,-0.271695963876072,72.62,IS,0.23,0.0,Phase3-EA-S4v1-GBPJPY-M5-194,GBPJPYMT4,44,4h 9m,Sell
301.0,121652,13.02.2007 03:15:00,,-1.0,-222.97999999998137,0.0,0.0,121.76,12.02.2007 21:30:00,125,-0.2463214719458661,22.97,IS,0.27,0.0,Phase3-EA-S1v2-USDJPY-M15-0,USDJPYMT4,46,5h 45m,Sell
336.99,1.6242,13.02.2007 04:44:59,tp 1.62420,0.0,-186.98999999997613,0.0,0.0,1.6253,13.02.2007 00:50:00,126,-0.20656405076309747,35.99,IS,0.41,0.0,Phase3-EA-SA2v2-EURCHF-M5-43,EURCHFMT4,58,3h 54m,Sell
283.58,236.69,13.02.2007 08:40:00,,0.0,-240.39999999997963,0.0,0.0,236972,13.02.2007 03:15:00,127,-0.2655649917292409,-53.41,IS,0.23,0.0,Phase3-EA-S4v1-GBPJPY-M5-194,GBPJPYMT4,46,5h 25m,Buy
304.79,1.62452,13.02.2007 10:15:00,,0.0,-219.18999999997322,0.0,0.0,1.6253,13.02.2007 01:30:00,128,-0.24213473601135665,21.21,IS,0.34,0.0,Phase3-EA-S4v1-EURCHF-M15-221,EURCHFMT4,36,8h 45m,Sell
340.95,1.6255,13.02.2007 23:49:59,tp 1.62550,0.0,-183.02999999996973,0.0,0.0,1.6266,13.02.2007 20:40:00,129,-0.20218951928535378,36.16,IS,0.41,0.0,Phase3-EA-SA2v2-EURCHF-M5-43,EURCHFMT4,60,3h 9m,Sell
311.55,1.2468,14.02.2007 03:15:00,,-0.56,-212.4299999999639,0.0,0.0,1.24742,13.02.2007 23:00:00,130,-0.23466710146854344,-29.4,IS,0.58,0.0,Phase3-EA-SA2v2-USDCHF-M15-107,USDCHFMT4,42,4h 15m,Buy
385.65,235.65,14.02.2007 04:34:57,tp 235.650,0.0,-138.3299999999581,0.0,0.0,236.04,14.02.2007 02:30:00,131,-0.15281033821088968,74.1,IS,0.23,0.0,Phase3-EA-S4v1-GBPJPY-M5-194,GBPJPYMT4,48,2h 4m,Sell
384.2,1.6253,14.02.2007 08:15:00,,-0.79,-139.77999999995518,0.0,0.0,1.62532,13.02.2007 23:55:00,132,-0.15441212372672436,-1.45,IS,0.41,0.0,Phase3-EA-SA2v2-EURCHF-M5-43,EURCHFMT4,62,8h 20m,Buy
446.59,1.6273,14.02.2007 13:00:00,,0.0,-77.38999999995576,0.0,0.0,1.62502,14.02.2007 04:15:00,133,-0.08549115935905137,62.39,IS,0.34,0.0,Phase3-EA-S4v1-EURCHF-M15-221,EURCHFMT4,38,8h 45m,Buy
395.62,236012,15.02.2007 02:59:58,sl 236.012,-0.81,-128.35999999995693,0.0,0.0,236682,14.02.2007 14:00:00,134,-0.1417966819399202,-50.97,IS,0.09,0.0,Phase3-EA-B1v1-GBPJPY-M30-1,GBPJPYMT4,22,12h 59m,Buy
434.99,1.2391,15.02.2007 02:59:58,tp 1.23910,-7.44,-88.98999999996158,0.0,0.0,1.2401,14.02.2007 23:30:00,135,-0.09830544348576102,39.37,IS,0.58,0.0,Phase3-EA-SA2v2-USDCHF-M15-107,USDCHFMT4,44,3h 29m,Sell
281.76,235532,15.02.2007 04:19:58,sl 235.532,0.0,-242.2199999999575,0.0,0.0,236332,15.02.2007 03:00:00,136,-0.2675755087215096,-153.23,IS,0.23,0.0,Phase3-EA-S4v1-GBPJPY-M5-194,GBPJPYMT4,50,1h 19m,Buy
313.24,1.6267,15.02.2007 04:54:59,tp 1.62670,-4.96,-210.73999999996158,0.0,0.0,1.6278,14.02.2007 23:25:00,137,-0.23280019283284015,31.48,IS,0.41,0.0,Phase3-EA-SA2v2-EURCHF-M5-43,EURCHFMT4,64,5h 29m,Sell
576.24,1.96632,15.02.2007 09:59:57,tp 1.96632,-1.6,-0.0,0.0,0.0,1.94742,14.02.2007 10:00:00,138,-0.0,263.0,IS,0.14,0.0,Phase3-EA-B1v1-GBPUSD-M30-14,GBPUSDMT4,12,23h 59m,Buy
663.71,1.62472,15.02.2007 10:30:00,,0.0,-0.0,0.0,0.0,1.6279,15.02.2007 01:45:00,139,-0.0,87.47,IS,0.34,0.0,Phase3-EA-S4v1-EURCHF-M15-221,EURCHFMT4,40,8h 45m,Sell
475.77,119242,15.02.2007 23:14:58,sl 119.242,0.0,-187.94000000000233,0.0,0.0,120072,15.02.2007 17:00:00,140,-0.20729352460869108,-187.94,IS,0.27,0.0,Phase3-EA-S1v2-USDJPY-M15-0,USDJPYMT4,48,6h 14m,Buy
522.76,1.23432,15.02.2007 23:59:57,tp 1.23432,0.0,-140.9499999999971,0.0,0.0,1.23332,15.02.2007 23:00:00,141,-0.15546462857078877,46.99,IS,0.58,0.0,Phase3-EA-SA2v2-USDCHF-M15-107,USDCHFMT4,46,59m 57s,Buy
597.87,233142,16.02.2007 03:24:57,tp 233.142,0.0,-65.83999999999651,0.0,0.0,232752,16.02.2007 00:15:00,142,-0.07262001521887479,75.11,IS,0.23,0.0,Phase3-EA-S4v1-GBPJPY-M5-194,GBPJPYMT4,52,3h 9m,Buy
547.36,233.26,16.02.2007 03:29:58,sl 233.260,0.0,-116.34999999999127,0.0,0.0,232.59,16.02.2007 02:00:00,143,-0.12833139080674205,-50.51,IS,0.09,0.0,Phase3-EA-B1v1-GBPJPY-M30-1,GBPJPYMT4,24,1h 29m,Sell
622.49,232.85,16.02.2007 04:34:58,tp 232.850,0.0,-41.21999999998661,0.0,0.0,233.24,16.02.2007 03:40:00,144,-0.04546471791192596,75.13,IS,0.23,0.0,Phase3-EA-S4v1-GBPJPY-M5-194,GBPJPYMT4,54,54m 58s,Sell
574.51,1.6213,16.02.2007 06:25:00,,-0.8,-89.19999999998254,0.0,0.0,1.62272,15.02.2007 22:05:00,145,-0.09838556132324888,-47.98,IS,0.41,0.0,Phase3-EA-SA2v2-EURCHF-M5-43,EURCHFMT4,66,8h 20m,Buy
598.73,1.6224,16.02.2007 13:15:00,,0.0,-64.97999999998137,0.0,0.0,1.62152,16.02.2007 04:30:00,146,-0.07167145487426156,24.22,IS,0.34,0.0,Phase3-EA-S4v1-EURCHF-M15-221,EURCHFMT4,42,8h 45m,Buy
643.28,1233,19.02.2007 02:00:00,tp 1.23300,-2.49,-20.429999999978463,0.0,0.0,1234,16.02.2007 23:00:00,147,-0.022533823069868265,44.55,IS,0.58,0.0,Phase3-EA-SA2v2-USDCHF-M15-107,USDCHFMT4,48,2d 3h 0m,Sell
679.85,1.62222,19.02.2007 03:25:00,tp 1.62222,0.0,-0.0,0.0,0.0,1.62112,19.02.2007 02:15:00,148,-0.0,36.57,IS,0.41,0.0,Phase3-EA-SA2v2-EURCHF-M5-43,EURCHFMT4,68,1h 10m,Buy
755.0,233.07,19.02.2007 03:54:58,tp 233.070,0.0,-0.0,0.0,0.0,233.46,19.02.2007 03:35:00,149,-0.0,75.15,IS,0.23,0.0,Phase3-EA-S4v1-GBPJPY-M5-194,GBPJPYMT4,56,19m 58s,Sell
692.94,1.23362,19.02.2007 06:30:00,,0.0,-62.05999999999767,0.0,0.0,1.2323,19.02.2007 02:15:00,150,-0.06838190733292673,-62.06,IS,0.58,0.0,Phase3-EA-SA2v2-USDCHF-M15-107,USDCHFMT4,50,4h 15m,Sell
750.26,1.62102,19.02.2007 14:45:00,,0.0,-4.739999999990687,0.0,0.0,1.6231,19.02.2007 06:00:00,151,-0.005222852735376217,57.32,IS,0.34,0.0,Phase3-EA-S4v1-EURCHF-M15-221,EURCHFMT4,44,8h 45m,Sell
765.6,119.67,19.02.2007 19:00:00,,0.0,-0.0,0.0,0.0,119602,19.02.2007 17:00:00,152,-0.0,15.34,IS,0.27,0.0,Phase3-EA-S1v2-USDJPY-M15-0,USDJPYMT4,50,2h 0m,Buy
739.97,1.62242,20.02.2007 05:10:00,,-1.66,-25.630000000004657,0.0,0.0,1.6217,19.02.2007 20:50:00,153,-0.02823757018077845,-25.63,IS,0.41,0.0,Phase3-EA-SA2v2-EURCHF-M5-43,EURCHFMT4,70,8h 20m,Sell
678.05,233742,20.02.2007 06:45:00,,0.0,-87.55000000000291,0.0,0.0,233.42,20.02.2007 01:20:00,154,-0.09645724812043646,-61.92,IS,0.23,0.0,Phase3-EA-S4v1-GBPJPY-M5-194,GBPJPYMT4,58,5h 25m,Sell
570.82,1.6264,20.02.2007 11:44:57,sl 1.62640,0.0,-194.77999999999884,0.0,0.0,1.6225,20.02.2007 05:15:00,155,-0.21459671946199743,-107.23,IS,0.34,0.0,Phase3-EA-S4v1-EURCHF-M15-221,EURCHFMT4,46,6h 29m,Sell
579.31,1.6243,21.02.2007 04:50:00,,-0.8,-186.2899999999936,0.0,0.0,1.62402,20.02.2007 20:30:00,156,-0.20524295548092394,8.49,IS,0.41,0.0,Phase3-EA-SA2v2-EURCHF-M5-43,EURCHFMT4,72,8h 20m,Buy
717.19,235552,21.02.2007 05:59:58,tp 235.552,-0.27,-48.40999999998894,0.0,0.0,233702,20.02.2007 04:30:00,157,-0.053335184254815614,137.88,IS,0.09,0.0,Phase3-EA-B1v1-GBPJPY-M30-1,GBPJPYMT4,26,1d 1h 29m,Buy
741.52,119872,21.02.2007 06:45:00,,0.0,-24.079999999987194,0.0,0.0,119.98,21.02.2007 01:00:00,158,-0.026529874754298088,24.33,IS,0.27,0.0,Phase3-EA-S1v2-USDJPY-M15-0,USDJPYMT4,52,5h 45m,Sell
699.52,1.95282,21.02.2007 06:59:58,sl 1.95282,0.0,-66.0799999999872,0.0,0.0,1.95582,21.02.2007 06:30:00,159,-0.07280291211647053,-42.0,IS,0.14,0.0,Phase3-EA-B1v1-GBPUSD-M30-14,GBPUSDMT4,14,29m 58s,Buy
730.99,1.6258,22.02.2007 00:34:58,tp 1.62580,-4.97,-34.60999999998603,0.0,0.0,1.6269,21.02.2007 21:00:00,160,-0.03813118626438432,31.47,IS,0.41,0.0,Phase3-EA-SA2v2-EURCHF-M5-43,EURCHFMT4,74,3h 34m,Sell
724.14,120.9,22.02.2007 02:30:00,,-1.94,-41.45999999999185,0.0,0.0,120922,21.02.2007 19:30:00,161,-0.045678098310364096,-6.85,IS,0.27,0.0,Phase3-EA-S1v2-USDJPY-M15-0,USDJPYMT4,54,7h 0m,Buy
758.99,1.2382,22.02.2007 02:45:00,,-1.69,-6.60999999998603,0.0,0.0,1.23742,21.02.2007 22:30:00,162,-0.007282494689602699,34.85,IS,0.58,0.0,Phase3-EA-SA2v2-USDCHF-M15-107,USDCHFMT4,52,4h 15m,Buy
758.33,1.62642,22.02.2007 09:55:00,,0.0,-7.269999999989523,0.0,0.0,1.6264,22.02.2007 01:35:00,163,-0.008009642419583542,-0.66,IS,0.41,0.0,Phase3-EA-SA2v2-EURCHF-M5-43,EURCHFMT4,76,8h 20m,Sell
768.73,1.62672,22.02.2007 12:15:00,,0.0,-0.0,0.0,0.0,1.6271,22.02.2007 03:30:00,164,-0.0,10.4,IS,0.34,0.0,Phase3-EA-S4v1-EURCHF-M15-221,EURCHFMT4,48,8h 45m,Sell
905.24,237522,22.02.2007 20:29:58,tp 237.522,-0.8,-0.0,0.0,0.0,235672,21.02.2007 11:00:00,165,-0.0,136.51,IS,0.09,0.0,Phase3-EA-B1v1-GBPJPY-M30-1,GBPJPYMT4,28,1d 9h 29m,Buy
883.93,1.6254,23.02.2007 05:05:00,,-0.79,-21.30999999999767,0.0,0.0,1.62602,22.02.2007 20:40:00,166,-0.02344199300282103,-21.31,IS,0.41,0.0,Phase3-EA-SA2v2-EURCHF-M5-43,EURCHFMT4,78,8h 25m,Buy
918.87,1.6226,26.02.2007 05:40:00,tp 1.62260,-1.66,-0.0,0.0,0.0,1.6237,23.02.2007 22:20:00,167,-0.0,34.94,IS,0.41,0.0,Phase3-EA-SA2v2-EURCHF-M5-43,EURCHFMT4,80,2d 7h 20m,Sell
955.4,120852,26.02.2007 06:00:00,,-1.0,-0.0,0.0,0.0,121.02,23.02.2007 22:15:00,168,-0.0,36.53,IS,0.27,0.0,Phase3-EA-S1v2-USDJPY-M15-0,USDJPYMT4,56,2d 7h 45m,Sell
887.81,1.2289,27.02.2007 03:00:00,,-0.57,-67.58999999999651,0.0,0.0,1.23032,26.02.2007 22:45:00,169,-0.0743111459022735,-67.59,IS,0.58,0.0,Phase3-EA-SA2v2-USDCHF-M15-107,USDCHFMT4,54,4h 15m,Buy
924.53,1.6209,27.02.2007 03:44:58,tp 1.62090,0.0,-30.869999999995343,0.0,0.0,1622,27.02.2007 01:55:00,170,-0.03393971111115484,36.72,IS,0.41,0.0,Phase3-EA-SA2v2-EURCHF-M5-43,EURCHFMT4,82,1h 49m,Sell
847.72,236.43,27.02.2007 08:40:00,,0.0,-107.67999999999302,0.0,0.0,236832,27.02.2007 03:15:00,171,-0.11838769330902064,-76.81,IS,0.23,0.0,Phase3-EA-S4v1-GBPJPY-M5-194,GBPJPYMT4,60,5h 25m,Buy
739.8,1.61712,27.02.2007 11:14:58,sl 1.61712,0.0,-215.59999999999127,0.0,0.0,1.62102,27.02.2007 04:30:00,172,-0.2370392522049171,-107.92,IS,0.34,0.0,Phase3-EA-S4v1-EURCHF-M15-221,EURCHFMT4,50,6h 44m,Buy
574.7,1.61032,27.02.2007 23:04:58,sl 1.61032,0.0,-380.6999999999971,0.0,0.0,1.61522,27.02.2007 20:20:00,173,-0.41855678717261086,-165.1,IS,0.41,0.0,Phase3-EA-SA2v2-EURCHF-M5-43,EURCHFMT4,84,2h 44m,Buy
611.75,1.61172,27.02.2007 23:14:58,tp 1.61172,0.0,-343.6499999999942,0.0,0.0,1.61062,27.02.2007 23:05:00,174,-0.37782253719954395,37.05,IS,0.41,0.0,Phase3-EA-SA2v2-EURCHF-M5-43,EURCHFMT4,86,9m 58s,Buy
648.8,1.61172,27.02.2007 23:19:58,tp 1.61172,0.0,-306.59999999999127,0.0,0.0,1.61062,27.02.2007 23:15:00,175,-0.33708828722647705,37.05,IS,0.41,0.0,Phase3-EA-SA2v2-EURCHF-M5-43,EURCHFMT4,88,4m 58s,Buy
696.43,1.21762,27.02.2007 23:29:57,tp 1.21762,0.0,-258.9699999999866,0.0,0.0,1.21662,27.02.2007 23:00:00,176,-0.28472196263222027,47.63,IS,0.58,0.0,Phase3-EA-SA2v2-USDCHF-M15-107,USDCHFMT4,56,29m 57s,Buy
837.29,231.47,27.02.2007 23:29:58,tp 231.470,0.0,-118.10999999998603,0.0,0.0,233.32,27.02.2007 19:00:00,177,-0.12985485193840715,140.86,IS,0.09,0.0,Phase3-EA-B1v1-GBPJPY-M30-1,GBPJPYMT4,30,4h 29m,Sell
913.23,231.66,28.02.2007 02:49:57,tp 231.660,0.0,-42.1699999999837,0.0,0.0,232.05,28.02.2007 02:05:00,178,-0.04636338249294015,75.94,IS,0.23,0.0,Phase3-EA-S4v1-GBPJPY-M5-194,GBPJPYMT4,62,44m 57s,Sell
989.05,232.07,28.02.2007 08:44:57,tp 232.070,0.0,-0.0,0.0,0.0,232.46,28.02.2007 03:50:00,179,-0.0,75.82,IS,0.23,0.0,Phase3-EA-S4v1-GBPJPY-M5-194,GBPJPYMT4,64,4h 54m,Sell
1046.92,1613,28.02.2007 15:15:00,,0.0,-0.0,0.0,0.0,1.61092,28.02.2007 06:30:00,180,-0.0,57.87,IS,0.34,0.0,Phase3-EA-S4v1-EURCHF-M15-221,EURCHFMT4,52,8h 45m,Buy
1081.51,1.61312,01.03.2007 00:44:59,tp 1.61312,-2.42,-0.0,0.0,0.0,1.61202,28.02.2007 20:10:00,181,-0.0,34.59,IS,0.41,0.0,Phase3-EA-SA2v2-EURCHF-M5-43,EURCHFMT4,90,4h 34m,Buy
1127.36,1.21942,01.03.2007 00:59:58,tp 1.21942,-1.71,-0.0,0.0,0.0,1.21842,28.02.2007 23:15:00,182,-0.0,45.85,IS,0.58,0.0,Phase3-EA-SA2v2-USDCHF-M15-107,USDCHFMT4,58,1h 44m,Buy
1149.69,118.52,01.03.2007 01:00:00,,0.0,-0.0,0.0,0.0,118422,01.03.2007 00:30:00,183,-0.0,22.33,IS,0.27,0.0,Phase3-EA-S1v2-USDJPY-M15-0,USDJPYMT4,58,30m 0s,Buy
1186.71,1.6121,01.03.2007 01:49:58,tp 1.61210,0.0,-0.0,0.0,0.0,1.6132,01.03.2007 00:55:00,184,-0.0,37.02,IS,0.41,0.0,Phase3-EA-SA2v2-EURCHF-M5-43,EURCHFMT4,92,54m 58s,Sell
1223.73,1.61322,01.03.2007 02:54:57,tp 1.61322,0.0,-0.0,0.0,0.0,1.61212,01.03.2007 02:35:00,185,-0.0,37.02,IS,0.41,0.0,Phase3-EA-SA2v2-EURCHF-M5-43,EURCHFMT4,94,19m 57s,Buy
1299.3,232.88,01.03.2007 04:49:58,tp 232.880,0.0,-0.0,0.0,0.0,233.27,01.03.2007 02:45:00,186,-0.0,75.57,IS,0.23,0.0,Phase3-EA-S4v1-GBPJPY-M5-194,GBPJPYMT4,66,2h 4m,Sell
1321.05,1.6124,01.03.2007 15:00:00,,0.0,-0.0,0.0,0.0,1.61162,01.03.2007 06:15:00,187,-0.0,21.75,IS,0.34,0.0,Phase3-EA-S4v1-EURCHF-M15-221,EURCHFMT4,54,8h 45m,Buy
1367.93,1.22222,02.03.2007 00:14:58,tp 1.22222,-0.57,-0.0,0.0,0.0,1.22122,01.03.2007 22:30:00,188,-0.0,46.88,IS,0.58,0.0,Phase3-EA-SA2v2-USDCHF-M15-107,USDCHFMT4,60,1h 44m,Buy
1384.82,117522,02.03.2007 00:45:00,,-1.03,-0.0,0.0,0.0,117.6,01.03.2007 19:00:00,189,-0.0,16.89,IS,0.27,0.0,Phase3-EA-S1v2-USDJPY-M15-0,USDJPYMT4,60,5h 45m,Sell
1416.49,117.66,02.03.2007 01:15:00,,0.0,-0.0,0.0,0.0,117522,02.03.2007 00:45:00,190,-0.0,31.67,IS,0.27,0.0,Phase3-EA-S1v2-USDJPY-M15-0,USDJPYMT4,62,30m 0s,Buy
1383.98,1.61112,02.03.2007 04:25:00,,-1.68,-32.50999999999476,0.0,0.0,1.6102,01.03.2007 20:05:00,191,-0.03556251175252379,-32.51,IS,0.41,0.0,Phase3-EA-SA2v2-EURCHF-M5-43,EURCHFMT4,96,8h 20m,Sell
1361.22,1.61262,02.03.2007 11:45:00,,0.0,-55.26999999998952,0.0,0.0,1.6118,02.03.2007 03:00:00,192,-0.060459551662932445,-22.76,IS,0.34,0.0,Phase3-EA-S4v1-EURCHF-M15-221,EURCHFMT4,56,8h 45m,Sell
1453.66,116.83,02.03.2007 19:59:58,tp 116.830,0.0,-0.0,0.0,0.0,117.23,02.03.2007 18:15:00,193,-0.0,92.44,IS,0.27,0.0,Phase3-EA-S1v2-USDJPY-M15-0,USDJPYMT4,64,1h 44m,Sell
1489.93,1.60572,05.03.2007 02:00:00,tp 1.60572,-0.81,-0.0,0.0,0.0,1.60462,02.03.2007 20:30:00,194,-0.0,36.27,IS,0.41,0.0,Phase3-EA-SA2v2-EURCHF-M5-43,EURCHFMT4,98,2d 5h 30m,Buy
1331.75,225812,05.03.2007 02:29:59,sl 225.812,0.0,-158.17999999999302,0.0,0.0,226612,05.03.2007 02:10:00,195,-0.17289334465551875,-158.18,IS,0.23,0.0,Phase3-EA-S4v1-GBPJPY-M5-194,GBPJPYMT4,68,19m 59s,Buy
1474.55,224.88,05.03.2007 02:59:57,tp 224.880,-0.45,-15.379999999990105,0.0,0.0,226.73,02.03.2007 21:30:00,196,-0.016810593253257587,142.8,IS,0.09,0.0,Phase3-EA-B1v1-GBPJPY-M30-1,GBPJPYMT4,32,2d 5h 29m,Sell
1551.98,223642,05.03.2007 03:24:58,tp 223.642,0.0,-0.0,0.0,0.0,223252,05.03.2007 03:20:00,197,-0.0,77.43,IS,0.23,0.0,Phase3-EA-S4v1-GBPJPY-M5-194,GBPJPYMT4,70,4m 58s,Buy
1443.16,1.59882,05.03.2007 05:59:57,sl 1.59882,0.0,-108.82000000000698,0.0,0.0,1.60272,05.03.2007 04:00:00,198,-0.11886143805956668,-108.82,IS,0.34,0.0,Phase3-EA-S4v1-EURCHF-M15-221,EURCHFMT4,58,1h 59m,Buy
1278.22,1.59852,05.03.2007 05:59:58,sl 1.59852,0.0,-273.7600000000093,0.0,0.0,1.60342,05.03.2007 02:30:00,199,-0.29902138653911037,-164.94,IS,0.41,0.0,Phase3-EA-SA2v2-EURCHF-M5-43,EURCHFMT4,100,3h 29m,Buy
1226.03,223.32,05.03.2007 17:59:58,sl 223.320,0.0,-325.95000000001164,0.0,0.0,222.65,05.03.2007 10:00:00,200,-0.35602725358862947,-52.19,IS,0.09,0.0,Phase3-EA-B1v1-GBPJPY-M30-1,GBPJPYMT4,34,7h 59m,Sell
1303.49,222232,06.03.2007 03:04:58,tp 222.232,0.0,-248.49000000000524,0.0,0.0,221842,06.03.2007 01:00:00,201,-0.2714195804394454,77.46,IS,0.23,0.0,Phase3-EA-S4v1-GBPJPY-M5-194,GBPJPYMT4,72,2h 4m,Buy
1350.97,1.22162,06.03.2007 03:14:57,tp 1.22162,0.0,-201.0100000000093,0.0,0.0,1.22062,06.03.2007 01:45:00,202,-0.21955833178049136,47.48,IS,0.58,0.0,Phase3-EA-SA2v2-USDCHF-M15-107,USDCHFMT4,62,1h 29m,Buy
1354.48,115.89,06.03.2007 04:00:00,,-0.68,-197.50000000001455,0.0,0.0,115872,05.03.2007 21:45:00,203,-0.21572444419008124,3.51,IS,0.27,0.0,Phase3-EA-S1v2-USDJPY-M15-0,USDJPYMT4,66,6h 15m,Buy
1353.0,1.5995,06.03.2007 05:00:00,,-0.81,-198.98000000001048,0.0,0.0,1.59952,05.03.2007 20:40:00,204,-0.2173410121769188,-1.48,IS,0.41,0.0,Phase3-EA-SA2v2-EURCHF-M5-43,EURCHFMT4,102,8h 20m,Buy
1194.49,223.7,06.03.2007 05:09:57,sl 223.700,0.0,-357.49000000000524,0.0,0.0,222.9,06.03.2007 03:40:00,205,-0.3904776281190258,-158.51,IS,0.23,0.0,Phase3-EA-S4v1-GBPJPY-M5-194,GBPJPYMT4,74,1h 29m,Sell
1305.7,1.60212,06.03.2007 05:59:57,tp 1.60212,0.0,-246.27999999999884,0.0,0.0,1.59812,06.03.2007 01:30:00,206,-0.26900565121584324,111.21,IS,0.34,0.0,Phase3-EA-S4v1-EURCHF-M15-221,EURCHFMT4,60,4h 29m,Buy
1381.56,224.96,07.03.2007 00:19:58,tp 224.960,-1.14,-170.41999999999825,0.0,0.0,225.35,06.03.2007 23:40:00,207,-0.18614561913352182,75.86,IS,0.23,0.0,Phase3-EA-S4v1-GBPJPY-M5-194,GBPJPYMT4,76,39m 58s,Sell
1335.66,1.60642,07.03.2007 04:25:00,,-1.67,-216.31999999999243,0.0,0.0,1.6051,06.03.2007 20:05:00,208,-0.23628107223895345,-45.9,IS,0.41,0.0,Phase3-EA-SA2v2-EURCHF-M5-43,EURCHFMT4,104,8h 20m,Sell
1412.81,225.04,07.03.2007 04:29:59,tp 225.040,0.0,-139.16999999999825,0.0,0.0,225.43,07.03.2007 01:25:00,209,-0.15201200454648617,77.15,IS,0.23,0.0,Phase3-EA-S4v1-GBPJPY-M5-194,GBPJPYMT4,78,3h 4m,Sell
1407.12,1.2235,07.03.2007 04:45:00,,0.0,-144.86000000000058,0.0,0.0,1.22362,07.03.2007 00:30:00,210,-0.15822705309049617,-5.69,IS,0.58,0.0,Phase3-EA-SA2v2-USDCHF-M15-107,USDCHFMT4,64,4h 15m,Buy
1456.57,1.60512,07.03.2007 12:00:00,,0.0,-95.41000000000349,0.0,0.0,1.6069,07.03.2007 03:15:00,211,-0.10421402136797413,49.45,IS,0.34,0.0,Phase3-EA-S4v1-EURCHF-M15-221,EURCHFMT4,62,8h 45m,Sell
1493.56,1.6042,07.03.2007 22:14:57,tp 1.60420,0.0,-58.419999999998254,0.0,0.0,1.6053,07.03.2007 22:00:00,212,-0.06381074445358603,36.99,IS,0.41,0.0,Phase3-EA-SA2v2-EURCHF-M5-43,EURCHFMT4,106,14m 57s,Sell
1334.72,223512,08.03.2007 01:39:58,sl 223.512,0.0,-217.25999999999476,0.0,0.0,224312,08.03.2007 00:20:00,213,-0.23730781136573403,-158.84,IS,0.23,0.0,Phase3-EA-S4v1-GBPJPY-M5-194,GBPJPYMT4,80,1h 19m,Buy
1291.12,1.92912,08.03.2007 01:59:57,sl 1.92912,-1.6,-260.8600000000006,0.0,0.0,1.93212,07.03.2007 22:00:00,214,-0.2849310304375725,-43.6,IS,0.14,0.0,Phase3-EA-B1v1-GBPUSD-M30-14,GBPUSDMT4,16,3h 59m,Buy
1313.99,1.2175,08.03.2007 06:45:00,,0.0,-237.99000000000524,0.0,0.0,1.21702,08.03.2007 02:30:00,215,-0.2599506859382014,22.87,IS,0.58,0.0,Phase3-EA-SA2v2-USDCHF-M15-107,USDCHFMT4,66,4h 15m,Buy
1351.03,1.60422,08.03.2007 06:45:00,tp 1.60422,0.0,-200.95000000001164,0.0,0.0,1.60312,08.03.2007 01:45:00,216,-0.21949279524048682,37.04,IS,0.41,0.0,Phase3-EA-SA2v2-EURCHF-M5-43,EURCHFMT4,108,5h 0m,Buy
1462.49,1.60702,08.03.2007 09:59:57,tp 1.60702,0.0,-89.49000000000524,0.0,0.0,1.60302,08.03.2007 03:30:00,217,-0.09774774942060799,111.46,IS,0.34,0.0,Phase3-EA-S4v1-EURCHF-M15-221,EURCHFMT4,64,6h 29m,Buy
1410.97,225612,08.03.2007 15:59:57,sl 225.612,0.0,-141.0100000000093,0.0,0.0,226282,08.03.2007 14:00:00,218,-0.1540217917733829,-51.52,IS,0.09,0.0,Phase3-EA-B1v1-GBPJPY-M30-1,GBPJPYMT4,36,1h 59m,Buy
1428.36,1.2275,09.03.2007 02:45:00,,-0.57,-123.6200000000099,0.0,0.0,1.22712,08.03.2007 22:30:00,219,-0.13502711792798994,17.39,IS,0.58,0.0,Phase3-EA-SA2v2-USDCHF-M15-107,USDCHFMT4,68,4h 15m,Buy
1464.31,1.61312,09.03.2007 03:59:59,tp 1.61312,-0.8,-87.6700000000128,0.0,0.0,1.61202,08.03.2007 21:10:00,220,-0.0957598077070673,35.95,IS,0.41,0.0,Phase3-EA-SA2v2-EURCHF-M5-43,EURCHFMT4,110,6h 49m,Buy
1511.47,117.41,09.03.2007 04:00:00,,-0.67,-40.51000000000931,0.0,0.0,117202,08.03.2007 20:45:00,221,-0.044248087261476235,47.16,IS,0.27,0.0,Phase3-EA-S1v2-USDJPY-M15-0,USDJPYMT4,68,7h 15m,Buy
1535.86,1.61252,09.03.2007 13:15:00,,0.0,-16.120000000009895,0.0,0.0,1.6134,09.03.2007 04:30:00,222,-0.017607483748587283,24.39,IS,0.34,0.0,Phase3-EA-S4v1-EURCHF-M15-221,EURCHFMT4,66,8h 45m,Sell
1594.05,118.37,12.03.2007 02:00:00,,-0.66,-0.0,0.0,0.0,118112,09.03.2007 22:30:00,223,-0.0,58.19,IS,0.27,0.0,Phase3-EA-S1v2-USDJPY-M15-0,USDJPYMT4,70,2d 3h 30m,Buy
1669.95,228.5,12.03.2007 03:29:57,tp 228.500,0.0,-0.0,0.0,0.0,228.89,12.03.2007 02:40:00,224,-0.0,75.9,IS,0.23,0.0,Phase3-EA-S4v1-GBPJPY-M5-194,GBPJPYMT4,82,49m 57s,Sell
1647.69,1.61852,12.03.2007 04:20:00,,-1.66,-22.25999999999476,0.0,0.0,1.6179,09.03.2007 20:00:00,225,-0.02428276659908153,-22.26,IS,0.41,0.0,Phase3-EA-SA2v2-EURCHF-M5-43,EURCHFMT4,112,2d 8h 20m,Sell
1685.89,1.61792,12.03.2007 14:30:00,,0.0,-0.0,0.0,0.0,1.6193,12.03.2007 05:45:00,226,-0.0,38.2,IS,0.34,0.0,Phase3-EA-S4v1-EURCHF-M15-221,EURCHFMT4,68,8h 45m,Sell
1643.36,1.92952,12.03.2007 16:29:58,sl 1.92952,-0.53,-42.529999999998836,0.0,0.0,1.93252,09.03.2007 21:30:00,227,-0.04638663593710962,-42.53,IS,0.14,0.0,Phase3-EA-B1v1-GBPUSD-M30-14,GBPUSDMT4,18,2d 18h 59m,Buy
1694.75,117442,13.03.2007 01:30:00,,-1.03,-0.0,0.0,0.0,117.67,12.03.2007 19:15:00,228,-0.0,51.39,IS,0.27,0.0,Phase3-EA-S1v2-USDJPY-M15-0,USDJPYMT4,72,6h 15m,Sell
1770.97,227362,13.03.2007 03:34:57,tp 227.362,0.0,-0.0,0.0,0.0,226972,13.03.2007 01:35:00,229,-0.0,76.22,IS,0.23,0.0,Phase3-EA-S4v1-GBPJPY-M5-194,GBPJPYMT4,84,1h 59m,Buy
1863.61,116.58,13.03.2007 20:29:58,tp 116.580,0.0,-0.0,0.0,0.0,116.98,13.03.2007 18:00:00,230,-0.0,92.64,IS,0.27,0.0,Phase3-EA-S1v2-USDJPY-M15-0,USDJPYMT4,74,2h 29m,Sell
1704.35,223722,14.03.2007 00:24:57,sl 223.722,-0.71,-159.25999999999476,0.0,0.0,224522,13.03.2007 23:15:00,231,-0.17336571031771406,-159.26,IS,0.23,0.0,Phase3-EA-S4v1-GBPJPY-M5-194,GBPJPYMT4,86,1h 9m,Buy
1538.48,1.60462,14.03.2007 02:44:59,sl 1.60462,-0.81,-325.1299999999901,0.0,0.0,1.60952,13.03.2007 20:50:00,232,-0.3539268704985465,-165.87,IS,0.41,0.0,Phase3-EA-SA2v2-EURCHF-M5-43,EURCHFMT4,114,5h 54m,Buy
1575.52,1.60602,14.03.2007 03:19:59,tp 1.60602,0.0,-288.0899999999965,0.0,0.0,1.60492,14.03.2007 02:50:00,233,-0.31360622557724027,37.04,IS,0.41,0.0,Phase3-EA-SA2v2-EURCHF-M5-43,EURCHFMT4,116,29m 59s,Buy
1591.74,1.6055,14.03.2007 11:45:00,,0.0,-271.86999999999534,0.0,0.0,1.60492,14.03.2007 03:00:00,234,-0.29594961486925575,16.22,IS,0.34,0.0,Phase3-EA-S4v1-EURCHF-M15-221,EURCHFMT4,70,8h 45m,Buy
1539.76,223.41,14.03.2007 12:29:57,sl 223.410,0.0,-323.84999999999127,0.0,0.0,222.74,14.03.2007 10:00:00,235,-0.3525335004796687,-51.98,IS,0.09,0.0,Phase3-EA-B1v1-GBPJPY-M30-1,GBPJPYMT4,38,2h 29m,Sell
1599.44,116.73,14.03.2007 21:30:00,,0.0,-264.16999999999825,0.0,0.0,116472,14.03.2007 18:45:00,236,-0.28756762334943947,59.68,IS,0.27,0.0,Phase3-EA-S1v2-USDJPY-M15-0,USDJPYMT4,76,2h 45m,Buy
1543.14,1.60882,15.03.2007 05:50:00,,-5.06,-320.47000000000116,0.0,0.0,1.6073,14.03.2007 21:30:00,237,-0.3488541327735769,-56.3,IS,0.41,0.0,Phase3-EA-SA2v2-EURCHF-M5-43,EURCHFMT4,118,8h 20m,Sell
1503.5,226972,15.03.2007 07:05:00,,0.0,-360.1100000000006,0.0,0.0,226.77,15.03.2007 01:40:00,238,-0.3920050605457376,-39.64,IS,0.23,0.0,Phase3-EA-S4v1-GBPJPY-M5-194,GBPJPYMT4,88,5h 25m,Sell
1511.31,1.60962,15.03.2007 10:45:00,,0.0,-352.3000000000029,0.0,0.0,1.6099,15.03.2007 02:00:00,239,-0.3835033262899233,7.81,IS,0.34,0.0,Phase3-EA-S4v1-EURCHF-M15-221,EURCHFMT4,72,8h 45m,Sell
1652.28,227702,15.03.2007 19:59:58,tp 227.702,-0.83,-211.33000000000175,0.0,0.0,225852,14.03.2007 22:00:00,240,-0.2300475672575915,140.97,IS,0.09,0.0,Phase3-EA-B1v1-GBPJPY-M30-1,GBPJPYMT4,40,21h 59m,Buy
1600.63,227122,16.03.2007 02:59:59,sl 227.122,-0.28,-262.9799999999959,0.0,0.0,227792,15.03.2007 20:00:00,241,-0.2862722246600103,-51.65,IS,0.09,0.0,Phase3-EA-B1v1-GBPJPY-M30-1,GBPJPYMT4,42,6h 59m,Buy
1558.63,1.93582,16.03.2007 03:59:57,sl 1.93582,0.0,-304.9799999999959,0.0,0.0,1.93882,16.03.2007 03:00:00,242,-0.3319921784044799,-42.0,IS,0.14,0.0,Phase3-EA-B1v1-GBPUSD-M30-14,GBPUSDMT4,20,59m 57s,Buy
1401.34,226422,16.03.2007 04:14:58,sl 226.422,0.0,-462.2699999999895,0.0,0.0,227222,16.03.2007 02:00:00,243,-0.5032134051775117,-157.29,IS,0.23,0.0,Phase3-EA-S4v1-GBPJPY-M5-194,GBPJPYMT4,90,2h 14m,Buy
1313.28,117.13,16.03.2007 09:30:00,,0.0,-550.3299999999872,0.0,0.0,117512,16.03.2007 00:15:00,244,-0.5990729081950804,-88.06,IS,0.27,0.0,Phase3-EA-S1v2-USDJPY-M15-0,USDJPYMT4,78,9h 15m,Buy
1224.46,1.6084,16.03.2007 10:05:00,,0.0,-639.1499999999942,0.0,0.0,1.61102,16.03.2007 01:45:00,245,-0.6957597246613687,-88.82,IS,0.41,0.0,Phase3-EA-SA2v2-EURCHF-M5-43,EURCHFMT4,120,8h 20m,Buy
1114.68,1.60632,16.03.2007 12:14:58,sl 1.60632,0.0,-748.929999999993,0.0,0.0,1.61022,16.03.2007 04:00:00,246,-0.815262975186793,-109.78,IS,0.34,0.0,Phase3-EA-S4v1-EURCHF-M15-221,EURCHFMT4,74,8h 14m,Buy
1152.03,1.6069,16.03.2007 21:49:59,tp 1.60690,0.0,-711.5799999999872,0.0,0.0,1608,16.03.2007 20:40:00,247,-0.7746048734640262,37.35,IS,0.41,0.0,Phase3-EA-SA2v2-EURCHF-M5-43,EURCHFMT4,122,1h 9m,Sell
1229.1,226002,19.03.2007 02:44:57,tp 226.002,0.0,-634.5099999999802,0.0,0.0,225612,19.03.2007 02:10:00,248,-0.6907087583429169,77.07,IS,0.23,0.0,Phase3-EA-S4v1-GBPJPY-M5-194,GBPJPYMT4,92,34m 57s,Buy
1276.44,116.97,19.03.2007 04:15:00,,-0.67,-587.1699999999837,0.0,0.0,116762,16.03.2007 21:15:00,249,-0.6391758390509399,47.34,IS,0.27,0.0,Phase3-EA-S1v2-USDJPY-M15-0,USDJPYMT4,80,2d 7h 0m,Buy
1312.97,1.60752,19.03.2007 04:44:57,tp 1.60752,-0.82,-550.6399999999849,0.0,0.0,1.60642,16.03.2007 23:45:00,250,-0.5994103649965251,36.53,IS,0.41,0.0,Phase3-EA-SA2v2-EURCHF-M5-43,EURCHFMT4,124,2d 4h 59m,Buy
1425.49,1.60972,19.03.2007 11:59:58,tp 1.60972,0.0,-438.1199999999808,0.0,0.0,1.60572,19.03.2007 03:30:00,251,-0.4769244317744321,112.52,IS,0.34,0.0,Phase3-EA-S4v1-EURCHF-M15-221,EURCHFMT4,76,8h 29m,Buy
1448.01,117.5,19.03.2007 18:00:00,,0.0,-415.5999999999767,0.0,0.0,117402,19.03.2007 17:30:00,252,-0.452409828004774,22.52,IS,0.27,0.0,Phase3-EA-S1v2-USDJPY-M15-0,USDJPYMT4,82,30m 0s,Buy
1454.44,117.53,19.03.2007 18:15:00,,0.0,-409.1699999999837,0.0,0.0,117502,19.03.2007 18:00:00,253,-0.4454103208005687,6.43,IS,0.27,0.0,Phase3-EA-S1v2-USDJPY-M15-0,USDJPYMT4,84,15m 0s,Buy
1530.02,228692,20.03.2007 00:49:57,tp 228.692,-0.7,-333.58999999998196,0.0,0.0,228302,19.03.2007 23:05:00,254,-0.3631361754670665,75.58,IS,0.23,0.0,Phase3-EA-S4v1-GBPJPY-M5-194,GBPJPYMT4,94,1h 44m,Buy
1567.22,1.61342,20.03.2007 04:04:59,tp 1.61342,0.0,-296.38999999998487,0.0,0.0,1.61232,20.03.2007 00:55:00,255,-0.3226413592933966,37.2,IS,0.41,0.0,Phase3-EA-SA2v2-EURCHF-M5-43,EURCHFMT4,126,3h 9m,Buy
1516.1,229052,20.03.2007 12:29:58,sl 229.052,0.0,-347.5099999999802,0.0,0.0,229722,20.03.2007 11:30:00,256,-0.3782890744223745,-51.12,IS,0.09,0.0,Phase3-EA-B1v1-GBPJPY-M30-1,GBPJPYMT4,44,59m 58s,Buy
1493.17,1.61392,20.03.2007 13:30:00,,0.0,-370.4399999999732,0.0,0.0,1.6131,20.03.2007 04:45:00,257,-0.4032499920261928,-22.93,IS,0.34,0.0,Phase3-EA-S4v1-EURCHF-M15-221,EURCHFMT4,78,8h 45m,Sell
1756.71,1.95672,20.03.2007 14:29:57,tp 1.95672,-1.06,-106.89999999997963,0.0,0.0,1.93782,16.03.2007 04:30:00,258,-0.11636816798292547,263.54,IS,0.14,0.0,Phase3-EA-B1v1-GBPUSD-M30-14,GBPUSDMT4,22,4d 9h 59m,Buy
1705.4,229722,20.03.2007 16:29:58,sl 229.722,0.0,-158.2099999999773,0.0,0.0,230392,20.03.2007 13:00:00,259,-0.17222271147408333,-51.31,IS,0.09,0.0,Phase3-EA-B1v1-GBPJPY-M30-1,GBPJPYMT4,46,3h 29m,Buy
1703.9,117232,21.03.2007 05:15:00,,-1.04,-159.7099999999773,0.0,0.0,117.23,20.03.2007 22:00:00,260,-0.17385556696495724,-1.5,IS,0.27,0.0,Phase3-EA-S1v2-USDJPY-M15-0,USDJPYMT4,86,7h 15m,Sell
1701.53,1.61362,21.03.2007 07:50:00,,-1.69,-162.07999999997264,0.0,0.0,1.6136,20.03.2007 23:25:00,261,-0.17643547864053294,-2.37,IS,0.41,0.0,Phase3-EA-SA2v2-EURCHF-M5-43,EURCHFMT4,128,8h 25m,Sell
1659.53,1.95892,21.03.2007 12:59:57,sl 1.95892,0.0,-204.07999999997264,0.0,0.0,1.96192,21.03.2007 08:30:00,262,-0.22215543238500257,-42.0,IS,0.14,0.0,Phase3-EA-B1v1-GBPUSD-M30-14,GBPUSDMT4,24,4h 29m,Buy
1642.17,1.61452,21.03.2007 14:30:00,,0.0,-221.43999999997322,0.0,0.0,1.6139,21.03.2007 05:45:00,263,-0.24105301326605064,-17.36,IS,0.34,0.0,Phase3-EA-S4v1-EURCHF-M15-221,EURCHFMT4,80,8h 45m,Sell
1718.51,231392,22.03.2007 02:34:58,tp 231.392,0.0,-145.09999999997672,0.0,0.0,231002,22.03.2007 01:30:00,264,-0.15795155448384468,76.34,IS,0.23,0.0,Phase3-EA-S4v1-GBPJPY-M5-194,GBPJPYMT4,96,1h 4m,Buy
1751.11,1.2097,22.03.2007 06:00:00,,0.0,-112.4999999999709,0.0,0.0,1.20902,22.03.2007 01:45:00,265,-0.12246416181551192,32.6,IS,0.58,0.0,Phase3-EA-SA2v2-USDCHF-M15-107,USDCHFMT4,70,4h 15m,Buy
1755.53,1.61822,22.03.2007 07:35:00,,-5.08,-108.07999999997264,0.0,0.0,1.6185,21.03.2007 23:15:00,266,-0.11765268096907203,4.42,IS,0.41,0.0,Phase3-EA-SA2v2-EURCHF-M5-43,EURCHFMT4,130,8h 20m,Sell
1788.42,231172,22.03.2007 08:05:00,,0.0,-75.18999999997322,0.0,0.0,231.34,22.03.2007 02:40:00,267,-0.08184960290584395,32.89,IS,0.23,0.0,Phase3-EA-S4v1-GBPJPY-M5-194,GBPJPYMT4,98,5h 25m,Sell
1807.52,1.61812,22.03.2007 12:00:00,,0.0,-56.089999999967404,0.0,0.0,1.6188,22.03.2007 03:15:00,268,-0.061057909655376434,19.1,IS,0.34,0.0,Phase3-EA-S4v1-EURCHF-M15-221,EURCHFMT4,82,8h 45m,Sell
1855.17,117.86,22.03.2007 19:15:00,,0.0,-8.439999999973224,0.0,0.0,117652,22.03.2007 17:15:00,269,-0.009187533561954746,47.65,IS,0.27,0.0,Phase3-EA-S1v2-USDJPY-M15-0,USDJPYMT4,88,2h 0m,Buy
1811.57,1.96132,22.03.2007 20:29:58,sl 1.96132,-1.6,-52.039999999979045,0.0,0.0,1.96432,21.03.2007 21:30:00,270,-0.056649199830029535,-43.6,IS,0.14,0.0,Phase3-EA-B1v1-GBPUSD-M30-14,GBPUSDMT4,26,22h 59m,Buy
1858.74,1.21482,23.03.2007 01:59:57,tp 1.21482,-0.57,-4.8699999999807915,0.0,0.0,1.21382,22.03.2007 23:15:00,271,-0.005301337493683066,47.17,IS,0.58,0.0,Phase3-EA-SA2v2-USDCHF-M15-107,USDCHFMT4,72,2h 44m,Buy
1860.57,118.11,23.03.2007 03:00:00,,0.0,-3.0399999999790452,0.0,0.0,118102,23.03.2007 00:45:00,272,-0.0033092537948149897,1.83,IS,0.27,0.0,Phase3-EA-S1v2-USDJPY-M15-0,USDJPYMT4,90,2h 15m,Buy
1892.82,1.6195,23.03.2007 07:25:00,,-0.81,-0.0,0.0,0.0,1.61852,22.03.2007 23:05:00,273,-0.0,32.25,IS,0.41,0.0,Phase3-EA-SA2v2-EURCHF-M5-43,EURCHFMT4,132,8h 20m,Buy
1902.17,231.84,23.03.2007 09:20:00,,0.0,-0.0,0.0,0.0,231792,23.03.2007 03:55:00,274,-0.0,9.35,IS,0.23,0.0,Phase3-EA-S4v1-GBPJPY-M5-194,GBPJPYMT4,100,5h 25m,Buy
1939.16,1.6185,26.03.2007 03:24:58,tp 1.61850,0.0,-0.0,0.0,0.0,1.6196,26.03.2007 02:10:00,275,-0.0,36.99,IS,0.41,0.0,Phase3-EA-SA2v2-EURCHF-M5-43,EURCHFMT4,134,1h 14m,Sell
1885.03,117972,26.03.2007 04:45:00,,-1.03,-54.13000000000466,0.0,0.0,117.74,23.03.2007 17:15:00,276,-0.05887589140471219,-54.13,IS,0.27,0.0,Phase3-EA-S1v2-USDJPY-M15-0,USDJPYMT4,92,2d 11h 30m,Sell
1831.96,230.9,26.03.2007 07:40:00,,0.0,-107.20000000001164,0.0,0.0,231172,26.03.2007 02:15:00,277,-0.11659884645455919,-53.07,IS,0.23,0.0,Phase3-EA-S4v1-GBPJPY-M5-194,GBPJPYMT4,102,5h 25m,Buy
1878.75,1.6199,26.03.2007 13:45:00,,0.0,-60.410000000018044,0.0,0.0,1.61822,26.03.2007 05:00:00,278,-0.06570649546941473,46.79,IS,0.34,0.0,Phase3-EA-S4v1-EURCHF-M15-221,EURCHFMT4,84,8h 45m,Buy
2018.13,232732,27.03.2007 02:59:58,tp 232.732,-1.64,-0.0,0.0,0.0,230882,21.03.2007 13:30:00,279,-0.0,139.38,IS,0.09,0.0,Phase3-EA-B1v1-GBPJPY-M30-1,GBPJPYMT4,48,5d 13h 29m,Buy
1971.73,1.21632,27.03.2007 03:30:00,,-2.53,-46.39999999999418,0.0,0.0,1.2154,26.03.2007 23:15:00,280,-0.05042484562552415,-46.4,IS,0.58,0.0,Phase3-EA-SA2v2-USDCHF-M15-107,USDCHFMT4,74,4h 15m,Sell
1964.37,232572,27.03.2007 05:00:00,,-1.13,-53.75999999999476,0.0,0.0,232.54,26.03.2007 23:35:00,281,-0.058423269414402026,-7.36,IS,0.23,0.0,Phase3-EA-S4v1-GBPJPY-M5-194,GBPJPYMT4,104,5h 25m,Sell
1935.45,118112,27.03.2007 08:15:00,,-1.03,-82.67999999999302,0.0,0.0,117.99,26.03.2007 22:45:00,282,-0.08985185854134714,-28.92,IS,0.27,0.0,Phase3-EA-S1v2-USDJPY-M15-0,USDJPYMT4,94,9h 30m,Sell
1884.32,232072,27.03.2007 11:29:57,sl 232.072,0.0,-133.80999999999767,0.0,0.0,232742,27.03.2007 03:30:00,283,-0.14541699554207144,-51.13,IS,0.09,0.0,Phase3-EA-B1v1-GBPJPY-M30-1,GBPJPYMT4,50,7h 59m,Buy
1903.37,1.61972,27.03.2007 13:15:00,,0.0,-114.75999999999476,0.0,0.0,1.6204,27.03.2007 04:30:00,284,-0.1247145535341727,19.05,IS,0.34,0.0,Phase3-EA-S4v1-EURCHF-M15-221,EURCHFMT4,86,8h 45m,Sell
1883.95,118.0,28.03.2007 04:00:00,,-0.66,-134.17999999999302,0.0,0.0,118082,27.03.2007 18:00:00,285,-0.1458190902162355,-19.42,IS,0.27,0.0,Phase3-EA-S1v2-USDJPY-M15-0,USDJPYMT4,96,10h 0m,Buy
1782.46,1.2116,28.03.2007 04:30:00,,0.0,-235.66999999999825,0.0,0.0,1.21372,28.03.2007 00:15:00,286,-0.25611257259846293,-101.49,IS,0.58,0.0,Phase3-EA-SA2v2-USDCHF-M15-107,USDCHFMT4,76,4h 15m,Buy
1923.9,230.18,28.03.2007 08:59:58,tp 230.180,-0.44,-94.22999999999593,0.0,0.0,232.03,27.03.2007 13:30:00,287,-0.10240373282960197,141.44,IS,0.09,0.0,Phase3-EA-B1v1-GBPJPY-M30-1,GBPJPYMT4,52,19h 29m,Sell
1852.07,1616,28.03.2007 09:40:00,,0.0,-166.05999999999767,0.0,0.0,1.61812,28.03.2007 01:20:00,288,-0.18046443673654036,-71.83,IS,0.41,0.0,Phase3-EA-SA2v2-EURCHF-M5-43,EURCHFMT4,136,8h 20m,Buy
1840.3,1.6178,28.03.2007 12:00:00,,0.0,-177.83000000000175,0.0,0.0,1.61822,28.03.2007 03:15:00,289,-0.19325539434457267,-11.77,IS,0.34,0.0,Phase3-EA-S4v1-EURCHF-M15-221,EURCHFMT4,88,8h 45m,Buy
1814.36,1.61992,29.03.2007 04:30:00,,-5.06,-203.77000000000407,0.0,0.0,1.6193,28.03.2007 20:10:00,290,-0.22144549123091703,-25.94,IS,0.41,0.0,Phase3-EA-SA2v2-EURCHF-M5-43,EURCHFMT4,138,8h 20m,Sell
1852.4,116772,29.03.2007 05:00:00,,-3.12,-165.73000000001048,0.0,0.0,116.95,28.03.2007 21:00:00,291,-0.18010581175688994,38.04,IS,0.27,0.0,Phase3-EA-S1v2-USDJPY-M15-0,USDJPYMT4,98,8h 0m,Sell
1799.56,230.13,29.03.2007 07:59:58,sl 230.130,-1.34,-218.57000000000698,0.0,0.0,229.46,28.03.2007 18:00:00,292,-0.2375292781976842,-52.84,IS,0.09,0.0,Phase3-EA-B1v1-GBPJPY-M30-1,GBPJPYMT4,54,13h 59m,Sell
1836.64,1.62332,29.03.2007 20:34:57,tp 1.62332,0.0,-181.49000000000524,0.0,0.0,1.62222,29.03.2007 20:20:00,293,-0.1972328713917627,37.08,IS,0.41,0.0,Phase3-EA-SA2v2-EURCHF-M5-43,EURCHFMT4,140,14m 57s,Buy
1841.67,1.62332,30.03.2007 11:00:00,,0.0,-176.4600000000064,0.0,0.0,1.6235,30.03.2007 02:15:00,294,-0.19176655730778944,5.03,IS,0.34,0.0,Phase3-EA-S4v1-EURCHF-M15-221,EURCHFMT4,90,8h 45m,Sell
1886.95,1.2131,02.04.2007 01:00:00,tp 1.21310,-2.53,-131.18000000000757,0.0,0.0,1.2141,30.03.2007 22:45:00,295,-0.14255886312839372,45.28,IS,0.58,0.0,Phase3-EA-SA2v2-USDCHF-M15-107,USDCHFMT4,78,2d 2h 15m,Sell
1977.85,117.48,02.04.2007 01:14:58,tp 117.480,-1.03,-40.28000000001339,0.0,0.0,117.88,30.03.2007 23:30:00,296,-0.04377398236631557,90.9,IS,0.27,0.0,Phase3-EA-S1v2-USDJPY-M15-0,USDJPYMT4,100,2d 1h 44m,Sell
2054.05,231772,02.04.2007 01:59:57,tp 231.772,0.0,-0.0,0.0,0.0,231382,02.04.2007 01:25:00,297,-0.0,76.2,IS,0.23,0.0,Phase3-EA-S4v1-GBPJPY-M5-194,GBPJPYMT4,106,34m 57s,Buy
2042.13,117742,02.04.2007 03:00:00,,0.0,-11.919999999998254,0.0,0.0,117.69,02.04.2007 01:45:00,298,-0.012948914252005471,-11.92,IS,0.27,0.0,Phase3-EA-S1v2-USDJPY-M15-0,USDJPYMT4,102,1h 15m,Sell
2026.27,1.62312,02.04.2007 07:25:00,,-1.69,-27.779999999998836,0.0,0.0,1.6227,30.03.2007 23:05:00,299,-0.030177922644358188,-15.86,IS,0.41,0.0,Phase3-EA-SA2v2-EURCHF-M5-43,EURCHFMT4,142,2d 8h 20m,Sell
2167.3,232232,02.04.2007 10:59:58,tp 232.232,-0.54,-0.0,0.0,0.0,230382,29.03.2007 10:30:00,300,-0.0,141.03,IS,0.09,0.0,Phase3-EA-B1v1-GBPJPY-M30-1,GBPJPYMT4,56,4d 0h 29m,Buy
2189.12,1.62242,02.04.2007 12:30:00,,0.0,-0.0,0.0,0.0,1.6232,02.04.2007 03:45:00,301,-0.0,21.82,IS,0.34,0.0,Phase3-EA-S4v1-EURCHF-M15-221,EURCHFMT4,92,8h 45m,Sell
2219.06,1.21452,03.04.2007 03:15:00,,-2.53,-0.0,0.0,0.0,1.2152,02.04.2007 23:00:00,302,-0.0,29.94,IS,0.58,0.0,Phase3-EA-SA2v2-USDCHF-M15-107,USDCHFMT4,80,4h 15m,Sell
2203.2,1.62392,03.04.2007 04:30:00,,-1.69,-15.860000000000582,0.0,0.0,1.6235,02.04.2007 20:10:00,303,-0.01719818007253659,-15.86,IS,0.41,0.0,Phase3-EA-SA2v2-EURCHF-M5-43,EURCHFMT4,144,8h 20m,Sell
2161.2,1.97542,03.04.2007 12:29:57,sl 1.97542,0.0,-57.86000000000058,0.0,0.0,1.97842,03.04.2007 04:00:00,304,-0.062741910403338,-42.0,IS,0.14,0.0,Phase3-EA-B1v1-GBPUSD-M30-14,GBPUSDMT4,28,8h 29m,Buy
2208.67,1.2217,04.04.2007 03:59:58,tp 1.22170,0.0,-10.389999999999418,0.0,0.0,1.2227,04.04.2007 02:00:00,305,-0.01126665138421429,47.47,IS,0.58,0.0,Phase3-EA-SA2v2-USDCHF-M15-107,USDCHFMT4,82,1h 59m,Sell
2213.03,1.62922,04.04.2007 05:15:00,,-1.68,-6.029999999998836,0.0,0.0,1.6294,03.04.2007 20:55:00,306,-0.006538778426063797,4.36,IS,0.41,0.0,Phase3-EA-SA2v2-EURCHF-M5-43,EURCHFMT4,146,8h 20m,Sell
2214.58,234.57,04.04.2007 06:45:00,,0.0,-4.4799999999959255,0.0,0.0,234562,04.04.2007 01:20:00,307,-0.004857997901947732,1.55,IS,0.23,0.0,Phase3-EA-S4v1-GBPJPY-M5-194,GBPJPYMT4,108,5h 25m,Buy
2254.58,1.2194,05.04.2007 00:14:58,tp 1.21940,-7.56,-0.0,0.0,0.0,1.2204,04.04.2007 22:45:00,308,-0.0,40.0,IS,0.58,0.0,Phase3-EA-SA2v2-USDCHF-M15-107,USDCHFMT4,84,1h 29m,Sell
2260.16,118622,05.04.2007 00:30:00,,-3.07,-0.0,0.0,0.0,118.66,04.04.2007 21:30:00,309,-0.0,5.58,IS,0.27,0.0,Phase3-EA-S1v2-USDJPY-M15-0,USDJPYMT4,104,3h 0m,Sell
2275.79,234322,05.04.2007 05:05:00,,-3.37,-0.0,0.0,0.0,234.42,04.04.2007 23:40:00,310,-0.0,15.63,IS,0.23,0.0,Phase3-EA-S4v1-GBPJPY-M5-194,GBPJPYMT4,110,5h 25m,Sell
2312.78,1.6301,05.04.2007 05:45:00,tp 1.63010,0.0,-0.0,0.0,0.0,1.6312,05.04.2007 00:50:00,311,-0.0,36.99,IS,0.41,0.0,Phase3-EA-SA2v2-EURCHF-M5-43,EURCHFMT4,148,4h 55m,Sell
2317.16,1.63122,06.04.2007 06:15:00,,-1.69,-0.0,0.0,0.0,1.6314,05.04.2007 21:55:00,312,-0.0,4.38,IS,0.41,0.0,Phase3-EA-SA2v2-EURCHF-M5-43,EURCHFMT4,150,8h 20m,Sell
2311.43,1215,06.04.2007 06:30:00,,0.0,-5.7299999999959255,0.0,0.0,1.21512,06.04.2007 02:15:00,313,-0.006206863382707958,-5.73,IS,0.58,0.0,Phase3-EA-SA2v2-USDCHF-M15-107,USDCHFMT4,86,4h 15m,Buy
2291.76,118732,06.04.2007 10:30:00,,-1.02,-25.39999999999418,0.0,0.0,118.65,05.04.2007 21:45:00,314,-0.027513844663326025,-19.67,IS,0.27,0.0,Phase3-EA-S1v2-USDJPY-M15-0,USDJPYMT4,106,12h 45m,Sell
2313.57,1.6322,06.04.2007 13:00:00,,0.0,-3.5899999999965075,0.0,0.0,1.63142,06.04.2007 04:15:00,315,-0.003888767808711298,21.81,IS,0.34,0.0,Phase3-EA-S4v1-EURCHF-M15-221,EURCHFMT4,94,8h 45m,Buy
2328.96,119292,06.04.2007 22:45:00,,0.0,-0.0,0.0,0.0,119362,06.04.2007 21:45:00,316,-0.0,15.39,IS,0.27,0.0,Phase3-EA-S1v2-USDJPY-M15-0,USDJPYMT4,108,1h 0m,Buy
2325.59,119.35,09.04.2007 02:00:00,,-0.66,-3.3699999999953434,0.0,0.0,119.36,06.04.2007 21:45:00,317,-0.0036499923750850645,-3.37,IS,0.27,0.0,Phase3-EA-S1v2-USDJPY-M15-0,USDJPYMT4,109,2d 4h 15m,Sell
2299.77,1.63442,09.04.2007 04:40:00,,-1.68,-29.19000000000233,0.0,0.0,1.6337,06.04.2007 20:20:00,318,-0.03161521585426966,-25.82,IS,0.41,0.0,Phase3-EA-SA2v2-EURCHF-M5-43,EURCHFMT4,152,2d 8h 20m,Sell
2336.54,1.6372,10.04.2007 03:09:58,tp 1.63720,0.0,-0.0,0.0,0.0,1.6383,10.04.2007 02:00:00,319,-0.0,36.77,IS,0.41,0.0,Phase3-EA-SA2v2-EURCHF-M5-43,EURCHFMT4,154,1h 9m,Sell
2383.86,1.2256,10.04.2007 03:14:58,tp 1.22560,0.0,-0.0,0.0,0.0,1.2266,10.04.2007 02:00:00,320,-0.0,47.32,IS,0.58,0.0,Phase3-EA-SA2v2-USDCHF-M15-107,USDCHFMT4,88,1h 14m,Sell
2459.17,234322,10.04.2007 07:09:57,tp 234.322,0.0,-0.0,0.0,0.0,233932,10.04.2007 02:05:00,321,-0.0,75.31,IS,0.23,0.0,Phase3-EA-S4v1-GBPJPY-M5-194,GBPJPYMT4,112,5h 4m,Buy
2419.61,1.6365,10.04.2007 12:15:00,,0.0,-39.55999999999767,0.0,0.0,1.63792,10.04.2007 03:30:00,322,-0.04278645373952374,-39.56,IS,0.34,0.0,Phase3-EA-S4v1-EURCHF-M15-221,EURCHFMT4,96,8h 45m,Buy
2557.42,235192,10.04.2007 14:29:57,tp 235.192,-1.9,-0.0,0.0,0.0,233342,03.04.2007 07:00:00,323,-0.0,137.81,IS,0.09,0.0,Phase3-EA-B1v1-GBPJPY-M30-1,GBPJPYMT4,58,7d 7h 29m,Buy
2575.26,1.63402,11.04.2007 04:45:00,,-1.69,-0.0,0.0,0.0,1.6346,10.04.2007 20:25:00,324,-0.0,17.84,IS,0.41,0.0,Phase3-EA-SA2v2-EURCHF-M5-43,EURCHFMT4,156,8h 20m,Sell
2624.93,1.6364,11.04.2007 12:15:00,,0.0,-0.0,0.0,0.0,1.63462,11.04.2007 03:30:00,325,-0.0,49.67,IS,0.34,0.0,Phase3-EA-S4v1-EURCHF-M15-221,EURCHFMT4,98,8h 45m,Buy
2672.44,1.22092,12.04.2007 03:14:57,tp 1.22092,0.0,-0.0,0.0,0.0,1.21992,12.04.2007 02:00:00,326,-0.0,47.51,IS,0.58,0.0,Phase3-EA-SA2v2-USDCHF-M15-107,USDCHFMT4,90,1h 14m,Buy
2503.15,1.6436,12.04.2007 04:04:57,sl 1.64360,-5.04,-169.2899999999936,0.0,0.0,1.6387,11.04.2007 20:30:00,327,-0.18267566927124546,-169.29,IS,0.41,0.0,Phase3-EA-SA2v2-EURCHF-M5-43,EURCHFMT4,158,7h 34m,Sell
2558.34,1.64052,12.04.2007 13:15:00,,0.0,-114.09999999999127,0.0,0.0,1.6425,12.04.2007 04:30:00,328,-0.12312182564739972,55.19,IS,0.34,0.0,Phase3-EA-S4v1-EURCHF-M15-221,EURCHFMT4,100,8h 45m,Sell
2506.93,235362,12.04.2007 16:29:57,sl 235.362,-0.81,-165.50999999999476,0.0,0.0,236032,11.04.2007 17:00:00,329,-0.17859678670378654,-51.41,IS,0.09,0.0,Phase3-EA-B1v1-GBPJPY-M30-1,GBPJPYMT4,60,23h 29m,Buy
2525.88,118992,13.04.2007 02:45:00,,-1.02,-146.55999999999767,0.0,0.0,119.08,12.04.2007 20:30:00,330,-0.1581484203933742,18.95,IS,0.27,0.0,Phase3-EA-S1v2-USDJPY-M15-0,USDJPYMT4,112,6h 15m,Sell
2638.15,1.6381,13.04.2007 10:44:58,tp 1.63810,0.0,-34.2899999999936,0.0,0.0,1.6421,13.04.2007 05:00:00,331,-0.0370012918619533,112.27,IS,0.34,0.0,Phase3-EA-S4v1-EURCHF-M15-221,EURCHFMT4,102,5h 44m,Sell
2596.15,1.97872,13.04.2007 18:29:58,sl 1.97872,0.0,-76.2899999999936,0.0,0.0,1.98172,13.04.2007 04:30:00,332,-0.08232220927817753,-42.0,IS,0.14,0.0,Phase3-EA-B1v1-GBPUSD-M30-14,GBPUSDMT4,30,13h 59m,Buy
2660.59,119.45,16.04.2007 01:15:00,,-0.66,-11.849999999991269,0.0,0.0,119162,13.04.2007 23:00:00,333,-0.012786973128139556,64.44,IS,0.27,0.0,Phase3-EA-S1v2-USDJPY-M15-0,USDJPYMT4,114,2d 2h 15m,Buy
2735.7,237.36,16.04.2007 02:19:57,tp 237.360,0.0,-0.0,0.0,0.0,237.75,16.04.2007 01:45:00,334,-0.0,75.11,IS,0.23,0.0,Phase3-EA-S4v1-GBPJPY-M5-194,GBPJPYMT4,114,34m 57s,Sell
2772.91,1.6451,16.04.2007 03:29:58,tp 1.64510,0.0,-0.0,0.0,0.0,1.6462,16.04.2007 01:25:00,335,-0.0,37.21,IS,0.41,0.0,Phase3-EA-SA2v2-EURCHF-M5-43,EURCHFMT4,160,2h 4m,Sell
2825.62,1.64372,16.04.2007 12:00:00,,0.0,-0.0,0.0,0.0,1.6456,16.04.2007 03:15:00,336,-0.0,52.71,IS,0.34,0.0,Phase3-EA-S4v1-EURCHF-M15-221,EURCHFMT4,104,8h 45m,Sell
2862.78,1.6436,16.04.2007 22:29:57,tp 1.64360,0.0,-0.0,0.0,0.0,1.6447,16.04.2007 21:40:00,337,-0.0,37.16,IS,0.41,0.0,Phase3-EA-SA2v2-EURCHF-M5-43,EURCHFMT4,162,49m 57s,Sell
2866.19,119.77,17.04.2007 02:00:00,,-0.65,-0.0,0.0,0.0,119752,16.04.2007 22:15:00,338,-0.0,3.41,IS,0.27,0.0,Phase3-EA-S1v2-USDJPY-M15-0,USDJPYMT4,116,3h 45m,Buy
2835.08,1.6425,17.04.2007 08:50:00,,0.0,-31.110000000000582,0.0,0.0,1.64342,17.04.2007 00:30:00,339,-0.0334998130105268,-31.11,IS,0.41,0.0,Phase3-EA-SA2v2-EURCHF-M5-43,EURCHFMT4,164,8h 20m,Buy
2755.89,1.6398,17.04.2007 14:45:00,,0.0,-110.30000000000291,0.0,0.0,1.64262,17.04.2007 06:00:00,340,-0.118773043235652,-79.19,IS,0.34,0.0,Phase3-EA-S4v1-EURCHF-M15-221,EURCHFMT4,106,8h 45m,Buy
2895.08,239312,17.04.2007 15:29:58,tp 239.312,-0.27,-0.0,0.0,0.0,237462,16.04.2007 09:00:00,341,-0.0,139.19,IS,0.09,0.0,Phase3-EA-B1v1-GBPJPY-M30-1,GBPJPYMT4,62,1d 6h 29m,Buy
3158.62,2.00602,17.04.2007 15:59:58,tp 2.00602,-1.06,-0.0,0.0,0.0,1.98712,13.04.2007 22:00:00,342,-0.0,263.54,IS,0.14,0.0,Phase3-EA-B1v1-GBPUSD-M30-14,GBPUSDMT4,32,3d 17h 59m,Buy
3195.93,1.64022,17.04.2007 22:14:57,tp 1.64022,0.0,-0.0,0.0,0.0,1.63912,17.04.2007 20:10:00,343,-0.0,37.31,IS,0.41,0.0,Phase3-EA-SA2v2-EURCHF-M5-43,EURCHFMT4,166,2h 4m,Buy
3233.26,1.6392,17.04.2007 23:54:58,tp 1.63920,0.0,-0.0,0.0,0.0,1.6403,17.04.2007 23:40:00,344,-0.0,37.33,IS,0.41,0.0,Phase3-EA-SA2v2-EURCHF-M5-43,EURCHFMT4,168,14m 58s,Sell
3308.73,238.4,18.04.2007 02:59:58,tp 238.400,0.0,-0.0,0.0,0.0,238.79,18.04.2007 00:20:00,345,-0.0,75.47,IS,0.23,0.0,Phase3-EA-S4v1-GBPJPY-M5-194,GBPJPYMT4,116,2h 39m,Sell
3337.82,118802,18.04.2007 03:00:00,,0.0,-0.0,0.0,0.0,118.93,18.04.2007 00:45:00,346,-0.0,29.09,IS,0.27,0.0,Phase3-EA-S1v2-USDJPY-M15-0,USDJPYMT4,118,2h 15m,Sell
3310.29,238.28,18.04.2007 08:35:00,,0.0,-27.529999999998836,0.0,0.0,238422,18.04.2007 03:10:00,347,-0.029495010704127005,-27.53,IS,0.23,0.0,Phase3-EA-S4v1-GBPJPY-M5-194,GBPJPYMT4,118,5h 25m,Buy
3227.8,1636,18.04.2007 15:00:00,,0.0,-110.02000000000407,0.0,0.0,1.63892,18.04.2007 06:15:00,348,-0.11787290510963713,-82.49,IS,0.34,0.0,Phase3-EA-S4v1-EURCHF-M15-221,EURCHFMT4,108,8h 45m,Buy
3265.22,1.63692,18.04.2007 21:19:57,tp 1.63692,0.0,-72.60000000000582,0.0,0.0,1.63582,18.04.2007 20:10:00,349,-0.07778197519505567,37.42,IS,0.41,0.0,Phase3-EA-SA2v2-EURCHF-M5-43,EURCHFMT4,170,1h 9m,Buy
3261.69,118342,19.04.2007 03:00:00,,-3.07,-76.13000000000466,0.0,0.0,118.34,18.04.2007 20:00:00,350,-0.08156393624792667,-3.53,IS,0.27,0.0,Phase3-EA-S1v2-USDJPY-M15-0,USDJPYMT4,120,7h 0m,Sell
3106.16,237132,19.04.2007 03:59:58,sl 237.132,0.0,-231.6600000000035,0.0,0.0,237932,19.04.2007 01:00:00,351,-0.2481952117587524,-155.53,IS,0.23,0.0,Phase3-EA-S4v1-GBPJPY-M5-194,GBPJPYMT4,120,2h 59m,Buy
3093.83,1.2033,19.04.2007 04:00:00,,-1.73,-243.99000000000524,0.0,0.0,1.20352,18.04.2007 23:45:00,352,-0.26140529101708704,-12.33,IS,0.58,0.0,Phase3-EA-SA2v2-USDCHF-M15-107,USDCHFMT4,92,4h 15m,Buy
3126.18,1.6361,19.04.2007 05:29:59,tp 1.63610,-5.11,-211.63999999999942,0.0,0.0,1.6372,18.04.2007 22:55:00,353,-0.22674624284132533,32.35,IS,0.41,0.0,Phase3-EA-SA2v2-EURCHF-M5-43,EURCHFMT4,172,6h 34m,Sell
3147.52,118292,20.04.2007 01:15:00,,-1.03,-190.3000000000029,0.0,0.0,118.39,19.04.2007 22:30:00,354,-0.20388305619308725,21.34,IS,0.27,0.0,Phase3-EA-S1v2-USDJPY-M15-0,USDJPYMT4,122,2h 45m,Sell
3094.11,1.64122,20.04.2007 07:00:00,,-1.7,-243.7100000000064,0.0,0.0,1.6397,19.04.2007 22:40:00,355,-0.2611053054378236,-53.41,IS,0.41,0.0,Phase3-EA-SA2v2-EURCHF-M5-43,EURCHFMT4,174,8h 20m,Sell
3062.55,1.64232,20.04.2007 10:45:00,,0.0,-275.2700000000041,0.0,0.0,1.6412,20.04.2007 02:00:00,356,-0.2949179657292228,-31.56,IS,0.34,0.0,Phase3-EA-S4v1-EURCHF-M15-221,EURCHFMT4,110,8h 45m,Sell
3110.61,1.20682,23.04.2007 03:14:57,tp 1.20682,0.0,-227.2100000000064,0.0,0.0,1.20582,23.04.2007 01:45:00,357,-0.24342758380258514,48.06,IS,0.58,0.0,Phase3-EA-SA2v2-USDCHF-M15-107,USDCHFMT4,94,1h 29m,Buy
3112.52,1.6416,23.04.2007 05:00:00,,-0.81,-225.3000000000029,0.0,0.0,1.64152,20.04.2007 20:40:00,358,-0.24138125360116894,1.91,IS,0.41,0.0,Phase3-EA-SA2v2-EURCHF-M5-43,EURCHFMT4,176,2d 8h 20m,Buy
3188.06,237.79,23.04.2007 06:39:58,tp 237.790,0.0,-149.7600000000093,0.0,0.0,238.18,23.04.2007 03:15:00,359,-0.1604494298238475,75.54,IS,0.23,0.0,Phase3-EA-S4v1-GBPJPY-M5-194,GBPJPYMT4,122,3h 24m,Sell
3156.52,1.6397,23.04.2007 10:45:00,,0.0,-181.3000000000029,0.0,0.0,1.64082,23.04.2007 02:00:00,360,-0.19424066257386624,-31.54,IS,0.34,0.0,Phase3-EA-S4v1-EURCHF-M15-221,EURCHFMT4,112,8h 45m,Buy
3193.8,1.64202,23.04.2007 22:59:57,tp 1.64202,0.0,-144.02000000000407,0.0,0.0,1.64092,23.04.2007 20:30:00,361,-0.15429972544891649,37.28,IS,0.41,0.0,Phase3-EA-SA2v2-EURCHF-M5-43,EURCHFMT4,178,2h 29m,Buy
3183.58,118.61,24.04.2007 00:45:00,,-0.66,-154.24000000000524,0.0,0.0,118652,23.04.2007 18:15:00,362,-0.16524919909207758,-10.22,IS,0.27,0.0,Phase3-EA-S1v2-USDJPY-M15-0,USDJPYMT4,124,6h 30m,Buy
3208.87,1.20892,24.04.2007 02:45:00,,-2.54,-128.95000000001164,0.0,0.0,1.2095,23.04.2007 22:30:00,363,-0.13815407302207341,25.29,IS,0.58,0.0,Phase3-EA-SA2v2-USDCHF-M15-107,USDCHFMT4,96,4h 15m,Sell
3233.48,118502,24.04.2007 02:45:00,,0.0,-104.34000000001106,0.0,0.0,118.61,24.04.2007 00:45:00,364,-0.11178748335884736,24.61,IS,0.27,0.0,Phase3-EA-S1v2-USDJPY-M15-0,USDJPYMT4,126,2h 0m,Sell
3269.1,1641,24.04.2007 03:39:58,tp 1.64100,-1.69,-68.72000000001572,0.0,0.0,1.6421,23.04.2007 23:00:00,365,-0.07362503216811322,35.62,IS,0.41,0.0,Phase3-EA-SA2v2-EURCHF-M5-43,EURCHFMT4,180,4h 39m,Sell
3240.36,1.6383,24.04.2007 14:45:00,,0.0,-97.46000000002095,0.0,0.0,1.63932,24.04.2007 06:00:00,366,-0.1044164091254979,-28.74,IS,0.34,0.0,Phase3-EA-S4v1-EURCHF-M15-221,EURCHFMT4,114,8h 45m,Buy
3315.01,237.0,25.04.2007 04:14:57,tp 237.000,-1.12,-22.810000000026776,0.0,0.0,237.39,24.04.2007 23:35:00,367,-0.024438110939409924,74.65,IS,0.23,0.0,Phase3-EA-S4v1-GBPJPY-M5-194,GBPJPYMT4,124,4h 39m,Sell
3266.05,118.51,25.04.2007 10:30:00,,-0.66,-71.77000000003318,0.0,0.0,118722,24.04.2007 17:00:00,368,-0.07689273222797904,-48.96,IS,0.27,0.0,Phase3-EA-S1v2-USDJPY-M15-0,USDJPYMT4,128,17h 30m,Buy
3350.24,1.6412,25.04.2007 11:00:00,,0.0,-0.0,0.0,0.0,1.63822,25.04.2007 02:15:00,369,-0.0,84.19,IS,0.34,0.0,Phase3-EA-S4v1-EURCHF-M15-221,EURCHFMT4,116,8h 45m,Buy
3387.69,1.6432,26.04.2007 04:49:58,tp 1.64320,0.0,-0.0,0.0,0.0,1.6443,26.04.2007 01:25:00,370,-0.0,37.45,IS,0.41,0.0,Phase3-EA-SA2v2-EURCHF-M5-43,EURCHFMT4,182,3h 24m,Sell
3435.86,1.2041,26.04.2007 05:14:57,tp 1.20410,0.0,-0.0,0.0,0.0,1.2051,26.04.2007 02:15:00,371,-0.0,48.17,IS,0.58,0.0,Phase3-EA-SA2v2-USDCHF-M15-107,USDCHFMT4,98,2h 59m,Sell
3431.59,237.5,26.04.2007 05:50:00,,0.0,-4.2700000000040745,0.0,0.0,237522,26.04.2007 00:25:00,372,-0.004569979877109356,-4.27,IS,0.23,0.0,Phase3-EA-S4v1-GBPJPY-M5-194,GBPJPYMT4,126,5h 25m,Buy
3433.41,118.66,26.04.2007 07:45:00,,0.0,-2.4499999999970896,0.0,0.0,118652,26.04.2007 00:30:00,373,-0.002622119601614505,1.82,IS,0.27,0.0,Phase3-EA-S1v2-USDJPY-M15-0,USDJPYMT4,130,7h 15m,Buy
3444.14,1.64322,26.04.2007 11:15:00,,0.0,-0.0,0.0,0.0,1.6436,26.04.2007 02:30:00,374,-0.0,10.73,IS,0.34,0.0,Phase3-EA-S4v1-EURCHF-M15-221,EURCHFMT4,118,8h 45m,Sell
3473.08,119.43,26.04.2007 18:30:00,,0.0,-0.0,0.0,0.0,119302,26.04.2007 17:15:00,375,-0.0,28.94,IS,0.27,0.0,Phase3-EA-S1v2-USDJPY-M15-0,USDJPYMT4,132,1h 15m,Buy
3510.4,1.64372,26.04.2007 23:04:57,tp 1.64372,0.0,-0.0,0.0,0.0,1.64262,26.04.2007 21:40:00,376,-0.0,37.32,IS,0.41,0.0,Phase3-EA-SA2v2-EURCHF-M5-43,EURCHFMT4,184,1h 24m,Buy
3518.98,119.56,27.04.2007 00:30:00,,0.0,-0.0,0.0,0.0,119522,27.04.2007 00:15:00,377,-0.0,8.58,IS,0.27,0.0,Phase3-EA-S1v2-USDJPY-M15-0,USDJPYMT4,134,15m 0s,Buy
3554.59,1.6425,27.04.2007 01:55:00,tp 1.64250,-1.7,-0.0,0.0,0.0,1.6436,26.04.2007 23:05:00,378,-0.0,35.61,IS,0.41,0.0,Phase3-EA-SA2v2-EURCHF-M5-43,EURCHFMT4,186,2h 50m,Sell
3560.91,119.59,27.04.2007 02:45:00,,0.0,-0.0,0.0,0.0,119562,27.04.2007 00:30:00,379,-0.0,6.32,IS,0.27,0.0,Phase3-EA-S1v2-USDJPY-M15-0,USDJPYMT4,136,2h 15m,Buy
3571.81,1.20832,27.04.2007 03:45:00,,-2.54,-0.0,0.0,0.0,1.2086,26.04.2007 23:30:00,380,-0.0,10.9,IS,0.58,0.0,Phase3-EA-SA2v2-USDCHF-M15-107,USDCHFMT4,100,4h 15m,Sell
3585.35,1.64322,27.04.2007 14:00:00,,0.0,-0.0,0.0,0.0,1.6437,27.04.2007 05:15:00,381,-0.0,13.54,IS,0.34,0.0,Phase3-EA-S4v1-EURCHF-M15-221,EURCHFMT4,120,8h 45m,Sell
3542.66,2.0043,27.04.2007 15:59:58,sl 2.00430,-0.69,-42.69000000000233,0.0,0.0,2.0013,26.04.2007 12:30:00,382,-0.04561611406058991,-42.69,IS,0.14,0.0,Phase3-EA-B1v1-GBPUSD-M30-14,GBPUSDMT4,34,1d 3h 29m,Sell
3560.35,1.2065,30.04.2007 02:45:00,,-0.58,-25.0,0.0,0.0,1.20612,27.04.2007 22:30:00,383,-0.026713582841758857,17.69,IS,0.58,0.0,Phase3-EA-SA2v2-USDCHF-M15-107,USDCHFMT4,102,2d 4h 15m,Buy
3487.39,1.6433,30.04.2007 07:15:00,,-0.82,-97.9600000000064,0.0,0.0,1.64542,27.04.2007 22:55:00,384,-0.10467450300715474,-72.96,IS,0.41,0.0,Phase3-EA-SA2v2-EURCHF-M5-43,EURCHFMT4,188,2d 8h 20m,Buy
3484.03,119.51,30.04.2007 09:15:00,,-0.65,-101.32000000000698,0.0,0.0,119522,27.04.2007 22:30:00,385,-0.10826480854108775,-3.36,IS,0.27,0.0,Phase3-EA-S1v2-USDJPY-M15-0,USDJPYMT4,138,2d 10h 45m,Buy
3483.47,1.6432,30.04.2007 11:15:00,,0.0,-101.88000000000466,0.0,0.0,1.64322,30.04.2007 02:30:00,386,-0.10886319279674067,-0.56,IS,0.34,0.0,Phase3-EA-S4v1-EURCHF-M15-221,EURCHFMT4,122,8h 45m,Buy
3519.13,1.6468,01.05.2007 01:09:59,tp 1.64680,-1.7,-66.22000000000116,0.0,0.0,1.6479,30.04.2007 20:45:00,387,-0.0707589382312521,35.66,IS,0.41,0.0,Phase3-EA-SA2v2-EURCHF-M5-43,EURCHFMT4,190,4h 24m,Sell
3535.75,119392,01.05.2007 01:15:00,,-1.02,-49.60000000000582,0.0,0.0,119.47,30.04.2007 21:30:00,388,-0.05299974835805579,16.62,IS,0.27,0.0,Phase3-EA-S1v2-USDJPY-M15-0,USDJPYMT4,140,3h 45m,Sell
3581.29,1.2061,01.05.2007 01:44:58,tp 1.20610,-2.55,-4.060000000012224,0.0,0.0,1.2071,30.04.2007 22:15:00,389,-0.0043382858535147,45.54,IS,0.58,0.0,Phase3-EA-SA2v2-USDCHF-M15-107,USDCHFMT4,104,3h 29m,Sell
3618.65,1.64812,01.05.2007 06:24:57,tp 1.64812,0.0,-0.0,0.0,0.0,1.64702,01.05.2007 01:15:00,390,-0.0,37.36,IS,0.41,0.0,Phase3-EA-SA2v2-EURCHF-M5-43,EURCHFMT4,192,5h 9m,Buy
3682.77,1.6493,01.05.2007 11:00:00,,0.0,-0.0,0.0,0.0,1.64702,01.05.2007 02:15:00,391,-0.0,64.12,IS,0.34,0.0,Phase3-EA-S4v1-EURCHF-M15-221,EURCHFMT4,124,8h 45m,Buy
3706.11,119732,02.05.2007 00:30:00,,-1.01,-0.0,0.0,0.0,119.84,01.05.2007 23:30:00,392,-0.0,23.34,IS,0.27,0.0,Phase3-EA-S1v2-USDJPY-M15-0,USDJPYMT4,142,1h 0m,Sell
3654.8,1.6504,02.05.2007 08:45:00,,0.0,-51.30999999999767,0.0,0.0,1.65192,02.05.2007 00:25:00,393,-0.05475630137671665,-51.31,IS,0.41,0.0,Phase3-EA-SA2v2-EURCHF-M5-43,EURCHFMT4,194,8h 20m,Buy
3637.47,1.6512,02.05.2007 11:00:00,,0.0,-68.63999999999942,0.0,0.0,1.65182,02.05.2007 02:15:00,394,-0.07325029285710329,-17.33,IS,0.34,0.0,Phase3-EA-S4v1-EURCHF-M15-221,EURCHFMT4,126,8h 45m,Buy
3652.75,120.12,02.05.2007 21:30:00,,0.0,-53.36000000000058,0.0,0.0,120052,02.05.2007 17:30:00,395,-0.05694399223273758,15.28,IS,0.27,0.0,Phase3-EA-S1v2-USDJPY-M15-0,USDJPYMT4,144,4h 0m,Buy
3689.91,1.6495,02.05.2007 23:04:58,tp 1.64950,0.0,-16.19999999999709,0.0,0.0,1.6506,02.05.2007 20:00:00,396,-0.017288093593893796,37.16,IS,0.41,0.0,Phase3-EA-SA2v2-EURCHF-M5-43,EURCHFMT4,196,3h 4m,Sell
3724.62,1.65052,03.05.2007 04:19:59,tp 1.65052,-2.43,-0.0,0.0,0.0,1.64942,02.05.2007 23:20:00,397,-0.0,34.71,IS,0.41,0.0,Phase3-EA-SA2v2-EURCHF-M5-43,EURCHFMT4,198,4h 59m,Buy
3816.75,1.64722,03.05.2007 13:45:00,,0.0,-0.0,0.0,0.0,1.6505,03.05.2007 05:00:00,398,-0.0,92.13,IS,0.34,0.0,Phase3-EA-S4v1-EURCHF-M15-221,EURCHFMT4,128,8h 45m,Sell
3774.75,1.98872,03.05.2007 16:59:58,sl 1.98872,0.0,-42.0,0.0,0.0,1.99172,03.05.2007 09:30:00,399,-0.04476812509493236,-42.0,IS,0.14,0.0,Phase3-EA-B1v1-GBPUSD-M30-14,GBPUSDMT4,36,7h 29m,Buy
3810.15,1.6472,04.05.2007 05:14:59,tp 1.64720,-1.69,-6.600000000005821,0.0,0.0,1.6483,03.05.2007 21:40:00,400,-0.0070349910863527175,35.4,IS,0.41,0.0,Phase3-EA-SA2v2-EURCHF-M5-43,EURCHFMT4,200,7h 34m,Sell
3759.79,238782,04.05.2007 11:29:57,sl 238.782,-0.27,-56.9600000000064,0.0,0.0,239452,03.05.2007 11:30:00,401,-0.06071410489065795,-50.36,IS,0.09,0.0,Phase3-EA-B1v1-GBPJPY-M30-1,GBPJPYMT4,64,23h 59m,Buy
3784.41,1.6482,04.05.2007 12:45:00,,0.0,-32.34000000001106,0.0,0.0,1.64732,04.05.2007 04:00:00,402,-0.0344714563231097,24.62,IS,0.34,0.0,Phase3-EA-S4v1-EURCHF-M15-221,EURCHFMT4,130,8h 45m,Buy
3791.95,120052,07.05.2007 01:30:00,,-1.01,-24.800000000017462,0.0,0.0,120.09,04.05.2007 21:45:00,403,-0.026434511960835815,7.54,IS,0.27,0.0,Phase3-EA-S1v2-USDJPY-M15-0,USDJPYMT4,146,2d 3h 45m,Sell
3807.62,1.21042,07.05.2007 03:00:00,,-2.54,-9.130000000019209,0.0,0.0,1.2108,04.05.2007 22:45:00,404,-0.009731737669466485,15.67,IS,0.58,0.0,Phase3-EA-SA2v2-USDCHF-M15-107,USDCHFMT4,106,2d 4h 15m,Sell
3836.81,239362,07.05.2007 04:45:00,,-1.11,-0.0,0.0,0.0,239.52,04.05.2007 23:20:00,405,-0.0,29.19,IS,0.23,0.0,Phase3-EA-S4v1-GBPJPY-M5-194,GBPJPYMT4,128,2d 5h 25m,Sell
3815.78,1.6451,07.05.2007 09:35:00,,0.0,-21.029999999998836,0.0,0.0,1.64572,07.05.2007 01:15:00,406,-0.022411247782185707,-21.03,IS,0.41,0.0,Phase3-EA-SA2v2-EURCHF-M5-43,EURCHFMT4,202,8h 20m,Buy
3834.89,1.6459,07.05.2007 11:45:00,,0.0,-1.9199999999982538,0.0,0.0,1.64522,07.05.2007 03:00:00,407,-0.002046105360996662,19.11,IS,0.34,0.0,Phase3-EA-S4v1-EURCHF-M15-221,EURCHFMT4,132,8h 45m,Buy
3812.25,1.21172,08.05.2007 02:45:00,,-2.54,-24.55999999999767,0.0,0.0,1.2113,07.05.2007 22:30:00,408,-0.026173097742770296,-22.64,IS,0.58,0.0,Phase3-EA-SA2v2-USDCHF-M15-107,USDCHFMT4,108,4h 15m,Sell
3769.26,1.64872,08.05.2007 06:00:00,,-1.69,-67.55000000000291,0.0,0.0,1.6475,07.05.2007 21:40:00,409,-0.07198667559138344,-42.99,IS,0.41,0.0,Phase3-EA-SA2v2-EURCHF-M5-43,EURCHFMT4,204,8h 20m,Sell
3701.41,1.65002,08.05.2007 10:45:00,,0.0,-135.40000000000873,0.0,0.0,1.6476,08.05.2007 02:00:00,410,-0.14429305514542598,-67.85,IS,0.34,0.0,Phase3-EA-S4v1-EURCHF-M15-221,EURCHFMT4,134,8h 45m,Sell
3689.71,119.98,09.05.2007 00:30:00,,0.0,-147.10000000000582,0.0,0.0,120032,09.05.2007 00:15:00,411,-0.15676150968900765,-11.7,IS,0.27,0.0,Phase3-EA-S1v2-USDJPY-M15-0,USDJPYMT4,148,15m 0s,Buy
3671.95,1.21812,09.05.2007 03:15:00,,-2.52,-164.86000000000058,0.0,0.0,1.2178,08.05.2007 23:00:00,412,-0.1756879842782384,-17.76,IS,0.58,0.0,Phase3-EA-SA2v2-USDCHF-M15-107,USDCHFMT4,110,4h 15m,Sell
3672.96,1.64872,09.05.2007 04:25:00,,-1.68,-163.85000000000582,0.0,0.0,1.6488,08.05.2007 20:05:00,413,-0.17461164760396872,1.01,IS,0.41,0.0,Phase3-EA-SA2v2-EURCHF-M5-43,EURCHFMT4,206,8h 20m,Sell
3647.05,1.64932,10.05.2007 04:40:00,,-5.05,-189.7600000000093,0.0,0.0,1.6487,09.05.2007 20:20:00,414,-0.2022234131786973,-25.91,IS,0.41,0.0,Phase3-EA-SA2v2-EURCHF-M5-43,EURCHFMT4,208,8h 20m,Sell
3621.05,119952,10.05.2007 04:45:00,,-3.04,-215.7600000000093,0.0,0.0,119.85,09.05.2007 20:30:00,415,-0.22993108994221897,-26.0,IS,0.27,0.0,Phase3-EA-S1v2-USDJPY-M15-0,USDJPYMT4,150,8h 15m,Sell
3629.62,1.21852,10.05.2007 06:15:00,,0.0,-207.19000000000233,0.0,0.0,1.2187,10.05.2007 02:00:00,416,-0.22079821340900457,8.57,IS,0.58,0.0,Phase3-EA-SA2v2-USDCHF-M15-107,USDCHFMT4,112,4h 15m,Sell
3659.8,1.64772,10.05.2007 12:00:00,,0.0,-177.0100000000093,0.0,0.0,1.6488,10.05.2007 03:15:00,417,-0.1886359947658165,30.18,IS,0.34,0.0,Phase3-EA-S4v1-EURCHF-M15-221,EURCHFMT4,136,8h 45m,Sell
3631.85,237.24,11.05.2007 04:35:00,,-0.69,-204.9600000000064,0.0,0.0,237382,10.05.2007 23:10:00,418,-0.2184217472865992,-27.95,IS,0.23,0.0,Phase3-EA-S4v1-GBPJPY-M5-194,GBPJPYMT4,130,5h 25m,Buy
3597.61,1.2197,11.05.2007 05:00:00,,0.0,-239.20000000001164,0.0,0.0,1.22042,11.05.2007 00:45:00,419,-0.25491062622441174,-34.24,IS,0.58,0.0,Phase3-EA-SA2v2-USDCHF-M15-107,USDCHFMT4,114,4h 15m,Buy
3486.2,119.93,11.05.2007 05:00:00,,-0.65,-350.61000000001513,0.0,0.0,120422,10.05.2007 17:45:00,420,-0.37363802115610584,-111.41,IS,0.27,0.0,Phase3-EA-S1v2-USDJPY-M15-0,USDJPYMT4,152,11h 15m,Buy
3435.95,237.57,11.05.2007 05:29:58,sl 237.570,0.0,-400.86000000001513,0.0,0.0,236.9,11.05.2007 01:00:00,421,-0.42718843490098907,-50.25,IS,0.09,0.0,Phase3-EA-B1v1-GBPJPY-M30-1,GBPJPYMT4,66,4h 29m,Sell
3431.11,1.6444,11.05.2007 08:00:00,,-0.81,-405.70000000001164,0.0,0.0,1.64452,10.05.2007 23:40:00,422,-0.43234632549850244,-4.84,IS,0.41,0.0,Phase3-EA-SA2v2-EURCHF-M5-43,EURCHFMT4,210,8h 20m,Buy
3424.98,1.6441,11.05.2007 10:00:00,,0.0,-411.8300000000163,0.0,0.0,1.64432,11.05.2007 01:15:00,423,-0.4388789431354454,-6.13,IS,0.34,0.0,Phase3-EA-S4v1-EURCHF-M15-221,EURCHFMT4,138,8h 45m,Buy
3374.58,237.53,11.05.2007 16:59:58,sl 237.530,0.0,-462.2300000000105,0.0,0.0,236.86,11.05.2007 10:30:00,424,-0.4925892088616504,-50.4,IS,0.09,0.0,Phase3-EA-B1v1-GBPJPY-M30-1,GBPJPYMT4,68,6h 29m,Sell
3389.21,120.19,14.05.2007 01:15:00,,-0.65,-447.6000000000058,0.0,0.0,120122,11.05.2007 23:15:00,425,-0.47699831228278694,14.63,IS,0.27,0.0,Phase3-EA-S1v2-USDJPY-M15-0,USDJPYMT4,154,2d 2h 0m,Buy
3363.88,1.2179,14.05.2007 02:15:00,,-0.57,-472.93000000000757,0.0,0.0,1.21842,11.05.2007 22:00:00,426,-0.503991983529712,-25.33,IS,0.58,0.0,Phase3-EA-SA2v2-USDCHF-M15-107,USDCHFMT4,116,2d 4h 15m,Buy
3358.16,1.64832,14.05.2007 06:05:00,,-1.68,-478.65000000000873,0.0,0.0,1.6482,11.05.2007 21:45:00,427,-0.510087672417688,-5.72,IS,0.41,0.0,Phase3-EA-SA2v2-EURCHF-M5-43,EURCHFMT4,212,2d 8h 20m,Sell
3395.17,1.6502,15.05.2007 01:29:57,tp 1.65020,0.0,-441.64000000001397,0.0,0.0,1.6513,15.05.2007 00:05:00,428,-0.47064686022469604,37.01,IS,0.41,0.0,Phase3-EA-SA2v2-EURCHF-M5-43,EURCHFMT4,214,1h 24m,Sell
3391.77,238222,15.05.2007 05:15:00,,-1.11,-445.04000000000815,0.0,0.0,238.21,14.05.2007 23:50:00,429,-0.47427017180145803,-3.4,IS,0.23,0.0,Phase3-EA-S4v1-GBPJPY-M5-194,GBPJPYMT4,132,5h 25m,Sell
3371.77,1.2182,15.05.2007 06:45:00,,0.0,-465.04000000000815,0.0,0.0,1.21862,15.05.2007 02:30:00,430,-0.4955837693118593,-20.0,IS,0.58,0.0,Phase3-EA-SA2v2-USDCHF-M15-107,USDCHFMT4,118,4h 15m,Buy
3323.76,1.6488,15.05.2007 10:30:00,,0.0,-513.0500000000029,0.0,0.0,1.65052,15.05.2007 01:45:00,431,-0.5467470601355721,-48.01,IS,0.34,0.0,Phase3-EA-S4v1-EURCHF-M15-221,EURCHFMT4,140,8h 45m,Buy
3297.95,120.19,16.05.2007 04:15:00,,-0.65,-538.8600000000006,0.0,0.0,120302,15.05.2007 17:45:00,432,-0.5742522577227424,-25.81,IS,0.27,0.0,Phase3-EA-S1v2-USDJPY-M15-0,USDJPYMT4,156,10h 30m,Buy
3333.39,1.6509,16.05.2007 04:39:57,tp 1.65090,-1.69,-503.41999999999825,0.0,0.0,1652,15.05.2007 21:00:00,433,-0.5364845629343088,35.44,IS,0.41,0.0,Phase3-EA-SA2v2-EURCHF-M5-43,EURCHFMT4,216,7h 39m,Sell
3283.46,238582,16.05.2007 20:29:58,sl 238.582,0.0,-553.3499999999913,0.0,0.0,239252,16.05.2007 18:00:00,434,-0.5896939591190182,-49.93,IS,0.09,0.0,Phase3-EA-B1v1-GBPJPY-M30-1,GBPJPYMT4,70,2h 29m,Buy
3291.95,120.78,16.05.2007 22:45:00,,0.0,-544.859999999986,0.0,0.0,120742,16.05.2007 21:30:00,435,-0.5806463369758472,8.49,IS,0.27,0.0,Phase3-EA-S1v2-USDJPY-M15-0,USDJPYMT4,158,1h 15m,Buy
3309.31,121.31,17.05.2007 21:00:00,,0.0,-527.4999999999854,0.0,0.0,121232,17.05.2007 20:00:00,436,-0.5621461343368184,17.36,IS,0.27,0.0,Phase3-EA-S1v2-USDJPY-M15-0,USDJPYMT4,160,1h 0m,Buy
3296.95,1.65592,18.05.2007 04:50:00,,-1.67,-539.859999999986,0.0,0.0,1.6556,17.05.2007 20:30:00,437,-0.5753179375982469,-12.36,IS,0.41,0.0,Phase3-EA-SA2v2-EURCHF-M5-43,EURCHFMT4,218,8h 20m,Sell
3321.22,239.52,18.05.2007 06:40:00,,0.0,-515.589999999982,0.0,0.0,239392,18.05.2007 01:15:00,438,-0.5494538870193707,24.27,IS,0.23,0.0,Phase3-EA-S4v1-GBPJPY-M5-194,GBPJPYMT4,134,5h 25m,Buy
3316.32,121102,18.05.2007 23:15:00,,0.0,-520.4899999999761,0.0,0.0,121.08,18.05.2007 18:45:00,439,-0.5546757184094128,-4.9,IS,0.27,0.0,Phase3-EA-S1v2-USDJPY-M15-0,USDJPYMT4,162,4h 30m,Sell
3253.86,1.65942,21.05.2007 06:25:00,,-1.67,-582.9499999999825,0.0,0.0,1.6576,18.05.2007 22:05:00,440,-0.6212380834344028,-62.46,IS,0.41,0.0,Phase3-EA-SA2v2-EURCHF-M5-43,EURCHFMT4,220,2d 8h 20m,Sell
3328.08,1.65742,21.05.2007 11:00:00,,0.0,-508.7299999999814,0.0,0.0,1.6601,21.05.2007 02:15:00,441,-0.5421433230733024,74.22,IS,0.34,0.0,Phase3-EA-S4v1-EURCHF-M15-221,EURCHFMT4,142,8h 45m,Sell
3334.3,121.58,21.05.2007 19:45:00,,0.0,-502.5099999999802,0.0,0.0,121552,21.05.2007 19:15:00,442,-0.5355147942475663,6.22,IS,0.27,0.0,Phase3-EA-S1v2-USDJPY-M15-0,USDJPYMT4,164,30m 0s,Buy
3361.96,1.65542,22.05.2007 04:25:00,,-1.67,-474.8499999999767,0.0,0.0,1.6563,21.05.2007 20:05:00,443,-0.5060380888906777,27.66,IS,0.41,0.0,Phase3-EA-SA2v2-EURCHF-M5-43,EURCHFMT4,222,8h 20m,Sell
3356.7,239452,22.05.2007 05:20:00,,-1.1,-480.1099999999715,0.0,0.0,239.43,21.05.2007 23:55:00,444,-0.5116435650359076,-5.26,IS,0.23,0.0,Phase3-EA-S4v1-GBPJPY-M5-194,GBPJPYMT4,136,5h 25m,Sell
3403.83,1.23072,22.05.2007 05:29:57,tp 1.23072,0.0,-432.9799999999668,0.0,0.0,1.22972,22.05.2007 01:45:00,445,-0.46141807250264205,47.13,IS,0.58,0.0,Phase3-EA-SA2v2-USDCHF-M15-107,USDCHFMT4,120,3h 44m,Buy
3423.39,121.49,22.05.2007 19:30:00,,0.0,-413.41999999996915,0.0,0.0,121402,22.05.2007 17:00:00,446,-0.44057337413747205,19.56,IS,0.27,0.0,Phase3-EA-S1v2-USDJPY-M15-0,USDJPYMT4,166,2h 30m,Buy
3460.07,1.65422,22.05.2007 22:14:59,tp 1.65422,0.0,-376.73999999997613,0.0,0.0,1.65312,22.05.2007 20:35:00,447,-0.4014842363034035,36.68,IS,0.41,0.0,Phase3-EA-SA2v2-EURCHF-M5-43,EURCHFMT4,224,1h 39m,Buy
3496.77,1.6533,22.05.2007 23:09:58,tp 1.65330,0.0,-340.03999999997905,0.0,0.0,1.6544,22.05.2007 22:20:00,448,-0.3623737848718203,36.7,IS,0.41,0.0,Phase3-EA-SA2v2-EURCHF-M5-43,EURCHFMT4,226,49m 58s,Sell
3511.87,121.59,23.05.2007 01:45:00,,0.0,-324.9399999999732,0.0,0.0,121522,23.05.2007 00:30:00,449,-0.34628201875146114,15.1,IS,0.27,0.0,Phase3-EA-S1v2-USDJPY-M15-0,USDJPYMT4,168,1h 15m,Buy
3470.7,1.23002,23.05.2007 02:15:00,,-2.5,-366.1099999999715,0.0,0.0,1.2292,22.05.2007 22:00:00,450,-0.3901560592266203,-41.17,IS,0.58,0.0,Phase3-EA-SA2v2-USDCHF-M15-107,USDCHFMT4,122,4h 15m,Sell
3530.79,240.28,23.05.2007 06:00:00,,0.0,-306.01999999997497,0.0,0.0,239962,23.05.2007 00:35:00,451,-0.32611935550662335,60.09,IS,0.23,0.0,Phase3-EA-S4v1-GBPJPY-M5-194,GBPJPYMT4,138,5h 25m,Buy
3552.42,1.65362,23.05.2007 15:00:00,,0.0,-284.3899999999703,0.0,0.0,1.6544,23.05.2007 06:15:00,452,-0.30306869979911943,21.63,IS,0.34,0.0,Phase3-EA-S4v1-EURCHF-M15-221,EURCHFMT4,144,8h 45m,Sell
3525.98,1.6515,24.05.2007 06:10:00,,-2.4,-310.82999999997264,0.0,0.0,1.65222,23.05.2007 21:50:00,453,-0.3312452757078724,-26.44,IS,0.41,0.0,Phase3-EA-SA2v2-EURCHF-M5-43,EURCHFMT4,228,8h 20m,Buy
3523.31,121.57,24.05.2007 06:30:00,,0.0,-313.4999999999709,0.0,0.0,121582,24.05.2007 00:45:00,454,-0.3340906409755091,-2.67,IS,0.27,0.0,Phase3-EA-S1v2-USDJPY-M15-0,USDJPYMT4,170,5h 45m,Buy
3472.86,240942,24.05.2007 11:29:57,sl 240.942,-0.8,-363.949999999968,0.0,0.0,241612,23.05.2007 20:00:00,455,-0.38785419069549326,-50.45,IS,0.09,0.0,Phase3-EA-B1v1-GBPJPY-M30-1,GBPJPYMT4,72,15h 29m,Buy
3476.86,121362,25.05.2007 01:15:00,,0.0,-359.949999999968,0.0,0.0,121.38,25.05.2007 00:15:00,456,-0.38359147119341297,4.0,IS,0.27,0.0,Phase3-EA-S1v2-USDJPY-M15-0,USDJPYMT4,172,1h 0m,Sell
3485.41,1.6487,25.05.2007 06:10:00,,-0.8,-351.3999999999651,0.0,0.0,1.64842,24.05.2007 21:50:00,457,-0.3744799082577133,8.55,IS,0.41,0.0,Phase3-EA-SA2v2-EURCHF-M5-43,EURCHFMT4,230,8h 20m,Buy
3559.38,240742,25.05.2007 08:34:58,tp 240.742,0.0,-277.4299999999639,0.0,0.0,240352,25.05.2007 03:45:00,458,-0.29565156786549296,73.97,IS,0.23,0.0,Phase3-EA-S4v1-GBPJPY-M5-194,GBPJPYMT4,140,4h 49m,Buy
3578.91,121.69,25.05.2007 18:15:00,,0.0,-257.8999999999651,0.0,0.0,121602,25.05.2007 17:45:00,459,-0.2748388398965873,19.53,IS,0.27,0.0,Phase3-EA-S1v2-USDJPY-M15-0,USDJPYMT4,174,30m 0s,Buy
3544.31,1.2273,28.05.2007 03:45:00,,-0.57,-292.4999999999709,0.0,0.0,1.22802,25.05.2007 23:30:00,460,-0.31171136358958773,-34.6,IS,0.58,0.0,Phase3-EA-SA2v2-USDCHF-M15-107,USDCHFMT4,124,2d 4h 15m,Buy
3546.18,1.6509,28.05.2007 06:45:00,,-0.8,-290.62999999997555,0.0,0.0,1.65082,25.05.2007 22:25:00,461,-0.3097185422223702,1.87,IS,0.41,0.0,Phase3-EA-SA2v2-EURCHF-M5-43,EURCHFMT4,232,2d 8h 20m,Buy
3542.74,1.22832,29.05.2007 02:15:00,,-2.5,-294.0699999999779,0.0,0.0,1.2283,28.05.2007 22:00:00,462,-0.3133844809941617,-3.44,IS,0.58,0.0,Phase3-EA-SA2v2-USDCHF-M15-107,USDCHFMT4,126,4h 15m,Sell
3579.46,1.6518,29.05.2007 03:24:58,tp 1.65180,0.0,-257.3499999999767,0.0,0.0,1.6529,29.05.2007 00:50:00,463,-0.2742527159650637,36.72,IS,0.41,0.0,Phase3-EA-SA2v2-EURCHF-M5-43,EURCHFMT4,234,2h 34m,Sell
3529.33,241112,29.05.2007 04:29:58,sl 241.112,-0.54,-307.4799999999814,0.0,0.0,241782,25.05.2007 23:30:00,464,-0.32767524812488946,-50.13,IS,0.09,0.0,Phase3-EA-B1v1-GBPJPY-M30-1,GBPJPYMT4,74,3d 4h 59m,Buy
3576.51,1.22922,29.05.2007 04:44:57,tp 1.22922,0.0,-260.29999999998836,0.0,0.0,1.22822,29.05.2007 02:45:00,465,-0.2773964715978603,47.18,IS,0.58,0.0,Phase3-EA-SA2v2-USDCHF-M15-107,USDCHFMT4,128,1h 59m,Buy
3514.99,1.6501,29.05.2007 10:45:00,,0.0,-321.81999999999243,0.0,0.0,1.65232,29.05.2007 02:00:00,466,-0.342957097539859,-61.52,IS,0.34,0.0,Phase3-EA-S4v1-EURCHF-M15-221,EURCHFMT4,146,8h 45m,Buy
3562.36,1.2245,30.05.2007 03:14:58,tp 1.22450,0.0,-274.4499999999971,0.0,0.0,1.2255,30.05.2007 00:15:00,467,-0.2924758418364785,47.37,IS,0.58,0.0,Phase3-EA-SA2v2-USDCHF-M15-107,USDCHFMT4,130,2h 59m,Sell
3635.12,240.54,30.05.2007 04:09:59,tp 240.540,-1.1,-201.69000000000233,0.0,0.0,240.93,29.05.2007 23:00:00,468,-0.21493697409364423,72.76,IS,0.23,0.0,Phase3-EA-S4v1-GBPJPY-M5-194,GBPJPYMT4,142,5h 9m,Sell
3637.0,1.6473,30.05.2007 04:55:00,,-0.8,-199.80999999999767,0.0,0.0,1.64722,29.05.2007 20:35:00,469,-0.21293349592766153,1.88,IS,0.41,0.0,Phase3-EA-SA2v2-EURCHF-M5-43,EURCHFMT4,236,8h 20m,Buy
3600.36,1.6459,30.05.2007 11:00:00,,0.0,-236.4499999999971,0.0,0.0,1.64722,30.05.2007 02:15:00,470,-0.2519800065667161,-36.64,IS,0.34,0.0,Phase3-EA-S4v1-EURCHF-M15-221,EURCHFMT4,148,8h 45m,Buy
3617.01,240.27,31.05.2007 08:20:00,,0.0,-219.8000000000029,0.0,0.0,240182,31.05.2007 02:55:00,471,-0.2342364366393132,16.65,IS,0.23,0.0,Phase3-EA-S4v1-GBPJPY-M5-194,GBPJPYMT4,144,5h 25m,Buy
3643.12,1.64512,31.05.2007 09:00:00,,0.0,-193.69000000000233,0.0,0.0,1.6459,31.05.2007 00:40:00,472,-0.2064115350894837,26.11,IS,0.41,0.0,Phase3-EA-SA2v2-EURCHF-M5-43,EURCHFMT4,238,8h 20m,Sell
3612.03,1.64662,31.05.2007 09:45:00,,0.0,-224.77999999999884,0.0,0.0,1.6455,31.05.2007 01:00:00,473,-0.23954352241939877,-31.09,IS,0.34,0.0,Phase3-EA-S4v1-EURCHF-M15-221,EURCHFMT4,150,8h 45m,Sell
3623.95,1.6483,01.06.2007 04:35:00,,-0.8,-212.86000000000058,0.0,0.0,1.64792,31.05.2007 20:15:00,474,-0.22684061830320149,11.92,IS,0.41,0.0,Phase3-EA-SA2v2-EURCHF-M5-43,EURCHFMT4,240,8h 20m,Buy
3634.57,122.09,01.06.2007 23:45:00,,0.0,-202.24000000000524,0.0,0.0,122042,01.06.2007 21:45:00,475,-0.21552309802518335,10.62,IS,0.27,0.0,Phase3-EA-S1v2-USDJPY-M15-0,USDJPYMT4,176,2h 0m,Buy
3618.9,1.2293,04.06.2007 03:15:00,,-0.57,-217.9100000000035,0.0,0.0,1.22962,01.06.2007 23:00:00,476,-0.2322223016745809,-15.67,IS,0.58,0.0,Phase3-EA-SA2v2-USDCHF-M15-107,USDCHFMT4,132,2d 4h 15m,Buy
3576.56,1.65452,04.06.2007 04:20:00,,-1.67,-260.25,0.0,0.0,1.6533,01.06.2007 20:00:00,477,-0.2773431876040967,-42.34,IS,0.41,0.0,Phase3-EA-SA2v2-EURCHF-M5-43,EURCHFMT4,242,2d 8h 20m,Sell
3589.38,241772,04.06.2007 06:25:00,,0.0,-247.42999999999302,0.0,0.0,241.84,04.06.2007 01:00:00,478,-0.26368117159992205,12.82,IS,0.23,0.0,Phase3-EA-S4v1-GBPJPY-M5-194,GBPJPYMT4,146,5h 25m,Sell
3700.21,1.6502,04.06.2007 12:29:58,tp 1.65020,0.0,-136.59999999999127,0.0,0.0,1.6542,04.06.2007 04:15:00,479,-0.14557187099603147,110.83,IS,0.34,0.0,Phase3-EA-S4v1-EURCHF-M15-221,EURCHFMT4,152,8h 14m,Sell
3957.9,1.99122,04.06.2007 17:59:58,tp 1.99122,-6.91,-0.0,0.0,0.0,1.97232,22.05.2007 11:00:00,480,-0.0,257.69,IS,0.14,0.0,Phase3-EA-B1v1-GBPUSD-M30-14,GBPUSDMT4,38,13d 6h 59m,Buy
3974.2,121722,05.06.2007 00:30:00,,-1.0,-0.0,0.0,0.0,121.8,04.06.2007 20:15:00,481,-0.0,16.3,IS,0.27,0.0,Phase3-EA-S1v2-USDJPY-M15-0,USDJPYMT4,178,4h 15m,Sell
4009.4,1.6494,05.06.2007 01:54:59,tp 1.64940,-1.68,-0.0,0.0,0.0,1.6505,04.06.2007 20:30:00,482,-0.0,35.2,IS,0.41,0.0,Phase3-EA-SA2v2-EURCHF-M5-43,EURCHFMT4,244,5h 24m,Sell
3960.44,1.2225,05.06.2007 03:00:00,,-0.57,-48.9600000000064,0.0,0.0,1.22352,04.06.2007 22:45:00,483,-0.05207989839314617,-48.96,IS,0.58,0.0,Phase3-EA-SA2v2-USDCHF-M15-107,USDCHFMT4,134,4h 15m,Buy
3997.33,1.65052,05.06.2007 07:09:58,tp 1.65052,0.0,-12.070000000006985,0.0,0.0,1.64942,05.06.2007 02:05:00,484,-0.012839141617760536,36.89,IS,0.41,0.0,Phase3-EA-SA2v2-EURCHF-M5-43,EURCHFMT4,246,5h 4m,Buy
4133.19,242982,05.06.2007 10:59:57,tp 242.982,-0.81,-0.0,0.0,0.0,241132,31.05.2007 21:00:00,485,-0.0,135.86,IS,0.09,0.0,Phase3-EA-B1v1-GBPJPY-M30-1,GBPJPYMT4,76,4d 13h 59m,Buy
4135.42,1.6495,05.06.2007 12:15:00,,0.0,-0.0,0.0,0.0,1.64942,05.06.2007 03:30:00,486,-0.0,2.23,IS,0.34,0.0,Phase3-EA-S4v1-EURCHF-M15-221,EURCHFMT4,154,8h 45m,Buy
4112.91,1.21842,06.06.2007 03:30:00,,-2.52,-22.50999999999476,0.0,0.0,1218,05.06.2007 23:15:00,487,-0.023912359449816806,-22.51,IS,0.58,0.0,Phase3-EA-SA2v2-USDCHF-M15-107,USDCHFMT4,136,4h 15m,Sell
4124.88,1647,06.06.2007 04:20:00,,-0.81,-10.539999999993597,0.0,0.0,1.64662,05.06.2007 20:00:00,488,-0.011196635655307628,11.97,IS,0.41,0.0,Phase3-EA-SA2v2-EURCHF-M5-43,EURCHFMT4,248,8h 20m,Buy
4144.47,121272,06.06.2007 05:45:00,,0.0,-0.0,0.0,0.0,121.36,06.06.2007 00:30:00,489,-0.0,19.59,IS,0.27,0.0,Phase3-EA-S1v2-USDJPY-M15-0,USDJPYMT4,180,5h 15m,Sell
4175.25,121062,06.06.2007 17:45:00,,0.0,-0.0,0.0,0.0,121.2,06.06.2007 17:00:00,490,-0.0,30.78,IS,0.27,0.0,Phase3-EA-S1v2-USDJPY-M15-0,USDJPYMT4,182,45m 0s,Sell
4199.35,120992,06.06.2007 20:00:00,,0.0,-0.0,0.0,0.0,121.1,06.06.2007 19:15:00,491,-0.0,24.1,IS,0.27,0.0,Phase3-EA-S1v2-USDJPY-M15-0,USDJPYMT4,184,45m 0s,Sell
4189.51,1.6423,07.06.2007 04:50:00,,-2.43,-9.839999999996508,0.0,0.0,1.64252,06.06.2007 20:30:00,492,-0.010445931951756034,-9.84,IS,0.41,0.0,Phase3-EA-SA2v2-EURCHF-M5-43,EURCHFMT4,250,8h 20m,Buy
4229.01,241.38,07.06.2007 06:05:00,,0.0,-0.0,0.0,0.0,241172,07.06.2007 00:40:00,493,-0.0,39.5,IS,0.23,0.0,Phase3-EA-S4v1-GBPJPY-M5-194,GBPJPYMT4,148,5h 25m,Buy
4228.06,1.21672,07.06.2007 06:15:00,,0.0,-0.9499999999970896,0.0,0.0,1.2167,07.06.2007 02:00:00,494,-0.0010081820874453511,-0.95,IS,0.58,0.0,Phase3-EA-SA2v2-USDCHF-M15-107,USDCHFMT4,138,4h 15m,Sell
4339.67,1.64622,07.06.2007 10:29:58,tp 1.64622,0.0,-0.0,0.0,0.0,1.64222,07.06.2007 02:15:00,495,-0.0,111.61,IS,0.34,0.0,Phase3-EA-S4v1-EURCHF-M15-221,EURCHFMT4,156,8h 14m,Buy
4386.46,1.22472,08.06.2007 02:59:58,tp 1.22472,-0.57,-0.0,0.0,0.0,1.22372,07.06.2007 23:45:00,496,-0.0,46.79,IS,0.58,0.0,Phase3-EA-SA2v2-USDCHF-M15-107,USDCHFMT4,140,3h 14m,Buy
4384.99,1.6451,08.06.2007 05:05:00,,-0.8,-1.4700000000011642,0.0,0.0,1.64512,07.06.2007 20:45:00,497,-0.0015574267749856948,-1.47,IS,0.41,0.0,Phase3-EA-SA2v2-EURCHF-M5-43,EURCHFMT4,252,8h 20m,Buy
4310.63,239922,08.06.2007 08:10:00,,0.0,-75.83000000000175,0.0,0.0,239.53,08.06.2007 02:45:00,498,-0.08033991316127512,-74.36,IS,0.23,0.0,Phase3-EA-S4v1-GBPJPY-M5-194,GBPJPYMT4,150,5h 25m,Sell
4346.09,1.6454,08.06.2007 10:15:00,,0.0,-40.36999999999534,0.0,0.0,1.64412,08.06.2007 01:30:00,499,-0.04277096524225541,35.46,IS,0.34,0.0,Phase3-EA-S4v1-EURCHF-M15-221,EURCHFMT4,158,8h 45m,Buy
4396.66,121.74,08.06.2007 21:00:00,,0.0,-0.0,0.0,0.0,121512,08.06.2007 18:15:00,500,-0.0,50.57,IS,0.27,0.0,Phase3-EA-S1v2-USDJPY-M15-0,USDJPYMT4,186,2h 45m,Buy
4470.4,239.3,11.06.2007 02:04:59,tp 239.300,0.0,-0.0,0.0,0.0,239.69,11.06.2007 01:05:00,501,-0.0,73.74,IS,0.23,0.0,Phase3-EA-S4v1-GBPJPY-M5-194,GBPJPYMT4,152,59m 59s,Sell
4544.1,239502,11.06.2007 03:29:57,tp 239.502,0.0,-0.0,0.0,0.0,239112,11.06.2007 02:35:00,502,-0.0,73.7,IS,0.23,0.0,Phase3-EA-S4v1-GBPJPY-M5-194,GBPJPYMT4,154,54m 57s,Buy
4551.72,1.65082,11.06.2007 06:40:00,,-1.66,-0.0,0.0,0.0,1.6511,08.06.2007 22:20:00,503,-0.0,7.62,IS,0.41,0.0,Phase3-EA-SA2v2-EURCHF-M5-43,EURCHFMT4,254,2d 8h 20m,Sell
4527.33,1.23632,11.06.2007 07:00:00,,0.0,-24.389999999999418,0.0,0.0,1.2358,11.06.2007 02:45:00,504,-0.025795405942905525,-24.39,IS,0.58,0.0,Phase3-EA-SA2v2-USDCHF-M15-107,USDCHFMT4,142,4h 15m,Sell
4563.75,1.6536,11.06.2007 22:44:59,tp 1.65360,0.0,-0.0,0.0,0.0,1.6547,11.06.2007 20:05:00,505,-0.0,36.42,IS,0.41,0.0,Phase3-EA-SA2v2-EURCHF-M5-43,EURCHFMT4,256,2h 39m,Sell
4568.92,1.6538,12.06.2007 07:10:00,,-0.79,-0.0,0.0,0.0,1.65362,11.06.2007 22:50:00,506,-0.0,5.17,IS,0.41,0.0,Phase3-EA-SA2v2-EURCHF-M5-43,EURCHFMT4,258,8h 20m,Buy
4526.95,239992,12.06.2007 07:30:00,,0.0,-41.970000000001164,0.0,0.0,239.77,12.06.2007 02:05:00,507,-0.04438033129700658,-41.97,IS,0.23,0.0,Phase3-EA-S4v1-GBPJPY-M5-194,GBPJPYMT4,156,5h 25m,Sell
4504.47,1.65492,12.06.2007 15:30:00,,0.0,-64.44999999999709,0.0,0.0,1.6541,12.06.2007 06:45:00,508,-0.06815135458879833,-22.48,IS,0.34,0.0,Phase3-EA-S4v1-EURCHF-M15-221,EURCHFMT4,160,8h 45m,Sell
4551.15,1.24262,13.06.2007 03:14:58,tp 1.24262,0.0,-17.770000000004075,0.0,0.0,1.24162,13.06.2007 00:30:00,509,-0.018790528643029925,46.68,IS,0.58,0.0,Phase3-EA-SA2v2-USDCHF-M15-107,USDCHFMT4,144,2h 44m,Buy
4483.74,1.6531,13.06.2007 06:10:00,,-0.79,-85.18000000000757,0.0,0.0,1.65512,12.06.2007 21:50:00,510,-0.09007187562256973,-67.41,IS,0.41,0.0,Phase3-EA-SA2v2-EURCHF-M5-43,EURCHFMT4,260,8h 20m,Buy
4540.62,1.6541,13.06.2007 10:00:00,,0.0,-28.30000000000291,0.0,0.0,1.65202,13.06.2007 01:15:00,511,-0.029925265087095084,56.88,IS,0.34,0.0,Phase3-EA-S4v1-EURCHF-M15-221,EURCHFMT4,162,8h 45m,Buy
4387.38,242.9,14.06.2007 01:19:57,sl 242.900,-3.26,-181.54000000000815,0.0,0.0,242.1,13.06.2007 23:10:00,512,-0.19196581709932603,-153.24,IS,0.23,0.0,Phase3-EA-S4v1-GBPJPY-M5-194,GBPJPYMT4,158,2h 9m,Sell
4348.84,1.65592,14.06.2007 04:20:00,,-4.94,-220.08000000000175,0.0,0.0,1.6549,13.06.2007 20:00:00,513,-0.23271916397057457,-38.54,IS,0.41,0.0,Phase3-EA-SA2v2-EURCHF-M5-43,EURCHFMT4,262,8h 20m,Sell
4383.41,1658,15.06.2007 03:49:57,tp 1.65800,-1.64,-185.50999999999476,0.0,0.0,1.6591,14.06.2007 20:20:00,514,-0.19616381365039862,34.57,IS,0.41,0.0,Phase3-EA-SA2v2-EURCHF-M5-43,EURCHFMT4,264,7h 29m,Sell
4340.55,1.2451,15.06.2007 04:45:00,,0.0,-228.36999999999534,0.0,0.0,1.24602,15.06.2007 00:30:00,515,-0.24148525752434846,-42.86,IS,0.58,0.0,Phase3-EA-SA2v2-USDCHF-M15-107,USDCHFMT4,146,4h 15m,Buy
4320.89,1.6574,15.06.2007 12:45:00,,0.0,-248.02999999999884,0.0,0.0,1.65812,15.06.2007 04:00:00,516,-0.2622743286060564,-19.66,IS,0.34,0.0,Phase3-EA-S4v1-EURCHF-M15-221,EURCHFMT4,164,8h 45m,Buy
4302.06,1.66202,18.06.2007 04:30:00,,-1.65,-266.8600000000006,0.0,0.0,1.6615,15.06.2007 20:05:00,517,-0.28218573290252263,-18.83,IS,0.41,0.0,Phase3-EA-SA2v2-EURCHF-M5-43,EURCHFMT4,266,2d 8h 25m,Sell
4262.58,244292,18.06.2007 07:15:00,,0.0,-306.3399999999965,0.0,0.0,244.08,18.06.2007 01:50:00,518,-0.32393306384380427,-39.48,IS,0.23,0.0,Phase3-EA-S4v1-GBPJPY-M5-194,GBPJPYMT4,160,5h 25m,Sell
4256.55,1.66242,18.06.2007 14:15:00,,0.0,-312.36999999999534,0.0,0.0,1.6622,18.06.2007 05:30:00,519,-0.33030936591006327,-6.03,IS,0.34,0.0,Phase3-EA-S4v1-EURCHF-M15-221,EURCHFMT4,166,8h 45m,Sell
4271.4,123.66,18.06.2007 23:30:00,,0.0,-297.5199999999895,0.0,0.0,123592,18.06.2007 21:45:00,520,-0.31460653246329684,14.85,IS,0.27,0.0,Phase3-EA-S1v2-USDJPY-M15-0,USDJPYMT4,188,1h 45m,Buy
4405.78,245502,18.06.2007 23:59:57,tp 245.502,-0.26,-163.13999999998487,0.0,0.0,243652,15.06.2007 16:00:00,521,-0.17250910764338293,134.38,IS,0.09,0.0,Phase3-EA-B1v1-GBPJPY-M30-1,GBPJPYMT4,78,3d 7h 59m,Buy
4421.06,1.24132,19.06.2007 02:15:00,,-2.48,-147.85999999998603,0.0,0.0,1.2417,18.06.2007 22:00:00,522,-0.15635157935607794,15.28,IS,0.58,0.0,Phase3-EA-SA2v2-USDCHF-M15-107,USDCHFMT4,148,4h 15m,Sell
4326.21,1.66592,19.06.2007 04:20:00,,-1.65,-242.70999999999185,0.0,0.0,1.6631,18.06.2007 20:00:00,523,-0.25664880174162036,-94.85,IS,0.41,0.0,Phase3-EA-SA2v2-EURCHF-M5-43,EURCHFMT4,268,8h 20m,Sell
4352.68,245212,19.06.2007 05:20:00,,-1.08,-216.2399999999907,0.0,0.0,245.36,18.06.2007 23:55:00,524,-0.22865863330150163,26.47,IS,0.23,0.0,Phase3-EA-S4v1-GBPJPY-M5-194,GBPJPYMT4,162,5h 25m,Sell
4462.36,1.6626,19.06.2007 11:00:00,tp 1.66260,0.0,-106.55999999999767,0.0,0.0,1.6666,19.06.2007 06:00:00,525,-0.11267972606644715,109.68,IS,0.34,0.0,Phase3-EA-S4v1-EURCHF-M15-221,EURCHFMT4,168,5h 0m,Sell
4475.05,123412,19.06.2007 21:15:00,,0.0,-93.86999999999534,0.0,0.0,123.47,19.06.2007 19:15:00,526,-0.09926094112103134,12.69,IS,0.27,0.0,Phase3-EA-S1v2-USDJPY-M15-0,USDJPYMT4,190,2h 0m,Sell
4521.85,1.2393,20.06.2007 04:30:00,tp 1.23930,0.0,-47.06999999999243,0.0,0.0,1.2403,20.06.2007 00:15:00,527,-0.04977322359184432,46.8,IS,0.58,0.0,Phase3-EA-SA2v2-USDCHF-M15-107,USDCHFMT4,150,4h 15m,Sell
4529.46,1.66452,20.06.2007 04:35:00,,-1.65,-39.45999999999185,0.0,0.0,1.6648,19.06.2007 20:15:00,528,-0.041726182344042635,7.61,IS,0.41,0.0,Phase3-EA-SA2v2-EURCHF-M5-43,EURCHFMT4,270,8h 20m,Sell
4522.47,123.57,20.06.2007 17:30:00,,0.0,-46.44999999999709,0.0,0.0,123602,20.06.2007 17:15:00,529,-0.04911761707757373,-6.99,IS,0.27,0.0,Phase3-EA-S1v2-USDJPY-M15-0,USDJPYMT4,192,15m 0s,Buy
4546.13,246.28,21.06.2007 05:05:00,,-2.01,-22.789999999993597,0.0,0.0,246142,20.06.2007 23:40:00,530,-0.02409882654892704,23.66,IS,0.23,0.0,Phase3-EA-S4v1-GBPJPY-M5-194,GBPJPYMT4,164,5h 25m,Buy
4517.11,1.23912,21.06.2007 06:15:00,,0.0,-51.80999999999767,0.0,0.0,1.2385,21.06.2007 02:00:00,531,-0.05478544113647234,-29.02,IS,0.58,0.0,Phase3-EA-SA2v2-USDCHF-M15-107,USDCHFMT4,152,4h 15m,Sell
4527.29,1.6598,21.06.2007 06:35:00,,-2.39,-41.63000000000466,0.0,0.0,1.65942,20.06.2007 22:15:00,532,-0.04402080514402048,10.18,IS,0.41,0.0,Phase3-EA-SA2v2-EURCHF-M5-43,EURCHFMT4,272,8h 20m,Buy
4570.65,1.6605,21.06.2007 10:00:00,,0.0,-0.0,0.0,0.0,1.65892,21.06.2007 01:15:00,533,-0.0,43.36,IS,0.34,0.0,Phase3-EA-S4v1-EURCHF-M15-221,EURCHFMT4,170,8h 45m,Buy
4578.5,1.2416,22.06.2007 03:45:00,,-0.56,-0.0,0.0,0.0,1.24142,21.06.2007 23:30:00,534,-0.0,7.85,IS,0.58,0.0,Phase3-EA-SA2v2-USDCHF-M15-107,USDCHFMT4,154,4h 15m,Buy
4711.6,247192,22.06.2007 09:29:58,tp 247.192,-1.31,-0.0,0.0,0.0,245342,19.06.2007 01:30:00,535,-0.0,133.1,IS,0.09,0.0,Phase3-EA-B1v1-GBPJPY-M30-1,GBPJPYMT4,80,3d 7h 59m,Buy
4604.36,1.65772,22.06.2007 11:29:57,sl 1.65772,0.0,-107.24000000000524,0.0,0.0,1.66162,22.06.2007 06:45:00,536,-0.1132279467351466,-107.24,IS,0.34,0.0,Phase3-EA-S4v1-EURCHF-M15-221,EURCHFMT4,172,4h 44m,Buy
4641.06,1.65562,22.06.2007 21:39:57,tp 1.65562,0.0,-70.54000000000815,0.0,0.0,1.65452,22.06.2007 20:35:00,537,-0.07447873333362341,36.7,IS,0.41,0.0,Phase3-EA-SA2v2-EURCHF-M5-43,EURCHFMT4,274,1h 4m,Buy
4677.76,1.65532,25.06.2007 08:04:58,tp 1.65532,0.0,-33.84000000001106,0.0,0.0,1.65422,25.06.2007 01:55:00,538,-0.035729519932100204,36.7,IS,0.41,0.0,Phase3-EA-SA2v2-EURCHF-M5-43,EURCHFMT4,276,6h 9m,Buy
4628.81,247142,25.06.2007 10:29:58,sl 247.142,-0.26,-82.79000000000815,0.0,0.0,247812,22.06.2007 15:00:00,539,-0.08741273508208926,-48.95,IS,0.09,0.0,Phase3-EA-B1v1-GBPJPY-M30-1,GBPJPYMT4,82,2d 19h 29m,Buy
4579.99,247.26,25.06.2007 15:59:57,sl 247.260,0.0,-131.61000000001513,0.0,0.0,246.59,25.06.2007 15:00:00,540,-0.13895869143802342,-48.82,IS,0.09,0.0,Phase3-EA-B1v1-GBPJPY-M30-1,GBPJPYMT4,84,59m 57s,Sell
4564.27,123632,25.06.2007 21:45:00,,0.0,-147.3300000000163,0.0,0.0,123.56,25.06.2007 17:00:00,541,-0.15555644715115796,-15.72,IS,0.27,0.0,Phase3-EA-S1v2-USDJPY-M15-0,USDJPYMT4,194,4h 45m,Sell
4636.89,246952,26.06.2007 05:29:58,tp 246.952,0.0,-74.71000000002095,0.0,0.0,246562,26.06.2007 03:45:00,542,-0.07888157311250245,72.62,IS,0.23,0.0,Phase3-EA-S4v1-GBPJPY-M5-194,GBPJPYMT4,166,1h 44m,Buy
4618.73,1.6531,26.06.2007 05:40:00,,-0.8,-92.87000000002445,0.0,0.0,1.65362,25.06.2007 21:20:00,543,-0.09805557080655837,-18.16,IS,0.41,0.0,Phase3-EA-SA2v2-EURCHF-M5-43,EURCHFMT4,278,8h 20m,Buy
4584.7,1.2272,26.06.2007 07:00:00,,0.0,-126.90000000002328,0.0,0.0,1.22792,26.06.2007 02:45:00,544,-0.13398569974535657,-34.03,IS,0.58,0.0,Phase3-EA-SA2v2-USDCHF-M15-107,USDCHFMT4,156,4h 15m,Buy
4614.57,1.6542,26.06.2007 12:00:00,,0.0,-97.03000000002794,0.0,0.0,1.65312,26.06.2007 03:15:00,545,-0.10244785221665331,29.87,IS,0.34,0.0,Phase3-EA-S4v1-EURCHF-M15-221,EURCHFMT4,174,8h 45m,Buy
4431.45,122802,26.06.2007 12:29:58,sl 122.802,-0.63,-280.1500000000233,0.0,0.0,123632,25.06.2007 21:45:00,546,-0.295792701210858,-183.12,IS,0.27,0.0,Phase3-EA-S1v2-USDJPY-M15-0,USDJPYMT4,196,14h 44m,Buy
4468.17,1.6536,26.06.2007 21:29:58,tp 1.65360,0.0,-243.43000000002212,0.0,0.0,1.6547,26.06.2007 20:20:00,547,-0.25702237107178194,36.72,IS,0.41,0.0,Phase3-EA-SA2v2-EURCHF-M5-43,EURCHFMT4,280,1h 9m,Sell
4515.4,1.22812,26.06.2007 23:59:58,tp 1.22812,0.0,-196.2000000000262,0.0,0.0,1.22712,26.06.2007 22:15:00,548,-0.20715519535096646,47.23,IS,0.58,0.0,Phase3-EA-SA2v2-USDCHF-M15-107,USDCHFMT4,158,1h 44m,Buy
4498.63,123192,27.06.2007 00:45:00,,-0.99,-212.97000000003027,0.0,0.0,123.12,26.06.2007 17:00:00,549,-0.22486157978540117,-16.77,IS,0.27,0.0,Phase3-EA-S1v2-USDJPY-M15-0,USDJPYMT4,198,7h 45m,Sell
4423.71,1.6512,27.06.2007 06:05:00,,-0.8,-287.8900000000285,0.0,0.0,1.65342,26.06.2007 21:45:00,550,-0.30396487864213906,-74.92,IS,0.41,0.0,Phase3-EA-SA2v2-EURCHF-M5-43,EURCHFMT4,282,8h 20m,Buy
4365.38,245.77,27.06.2007 06:50:00,,0.0,-346.22000000003027,0.0,0.0,246082,27.06.2007 01:25:00,551,-0.36555184370238686,-58.33,IS,0.23,0.0,Phase3-EA-S4v1-GBPJPY-M5-194,GBPJPYMT4,168,5h 25m,Buy
4312.28,1.6503,27.06.2007 10:15:00,,0.0,-399.3200000000361,0.0,0.0,1.65222,27.06.2007 01:30:00,552,-0.42161678189370216,-53.1,IS,0.34,0.0,Phase3-EA-S4v1-EURCHF-M15-221,EURCHFMT4,176,8h 45m,Buy
4262.01,246.07,28.06.2007 01:29:58,sl 246.070,-1.28,-449.59000000004016,0.0,0.0,245.4,27.06.2007 08:00:00,553,-0.4746937017219006,-50.27,IS,0.09,0.0,Phase3-EA-B1v1-GBPJPY-M30-1,GBPJPYMT4,86,17h 29m,Sell
4109.11,245.95,28.06.2007 01:29:58,sl 245.950,-3.26,-602.4900000000343,0.0,0.0,245.15,27.06.2007 23:00:00,554,-0.6361311602802968,-152.9,IS,0.23,0.0,Phase3-EA-S4v1-GBPJPY-M5-194,GBPJPYMT4,170,2h 29m,Sell
4067.64,1.22932,28.06.2007 03:45:00,,-7.5,-643.9600000000355,0.0,0.0,1.2286,27.06.2007 23:30:00,555,-0.6799167155871454,-41.47,IS,0.58,0.0,Phase3-EA-SA2v2-USDCHF-M15-107,USDCHFMT4,160,4h 15m,Sell
4140.57,245.75,28.06.2007 04:04:57,tp 245.750,0.0,-571.0300000000425,0.0,0.0,246.14,28.06.2007 01:50:00,556,-0.6029145321164903,72.93,IS,0.23,0.0,Phase3-EA-S4v1-GBPJPY-M5-194,GBPJPYMT4,172,2h 14m,Sell
4101.52,1.65352,28.06.2007 07:30:00,,-5.0,-610.0800000000454,0.0,0.0,1.6525,27.06.2007 23:10:00,557,-0.6441449621799702,-39.05,IS,0.41,0.0,Phase3-EA-SA2v2-EURCHF-M5-43,EURCHFMT4,284,8h 20m,Sell
4114.82,1.65272,28.06.2007 09:45:00,,0.0,-596.7800000000425,0.0,0.0,1.6532,28.06.2007 01:00:00,558,-0.6301023317102042,13.3,IS,0.34,0.0,Phase3-EA-S4v1-EURCHF-M15-221,EURCHFMT4,178,8h 45m,Sell
4151.46,1.6555,28.06.2007 21:34:59,tp 1.65550,0.0,-560.1400000000431,0.0,0.0,1.6566,28.06.2007 20:20:00,559,-0.5914164685213241,36.64,IS,0.41,0.0,Phase3-EA-SA2v2-EURCHF-M5-43,EURCHFMT4,286,1h 14m,Sell
4198.54,1232,28.06.2007 22:44:57,tp 1.23200,0.0,-513.0600000000413,0.0,0.0,1233,28.06.2007 22:30:00,560,-0.5417076683321164,47.08,IS,0.58,0.0,Phase3-EA-SA2v2-USDCHF-M15-107,USDCHFMT4,162,14m 57s,Sell
4245.61,1.23222,29.06.2007 02:59:57,tp 1.23222,0.0,-465.99000000003434,0.0,0.0,1.23122,29.06.2007 01:00:00,561,-0.49200942651167734,47.07,IS,0.58,0.0,Phase3-EA-SA2v2-USDCHF-M15-107,USDCHFMT4,164,1h 59m,Buy
4281.4,1.65652,29.06.2007 03:24:59,tp 1.65652,-0.8,-430.20000000004075,0.0,0.0,1.65542,28.06.2007 22:55:00,562,-0.4542210246686153,35.79,IS,0.41,0.0,Phase3-EA-SA2v2-EURCHF-M5-43,EURCHFMT4,288,4h 29m,Buy
4261.49,1.65682,29.06.2007 12:45:00,,0.0,-450.11000000004424,0.0,0.0,1.6561,29.06.2007 04:00:00,563,-0.4752427368981663,-19.91,IS,0.34,0.0,Phase3-EA-S4v1-EURCHF-M15-221,EURCHFMT4,180,8h 45m,Sell
4298.4,1.65442,29.06.2007 23:24:57,tp 1.65442,0.0,-413.20000000004075,0.0,0.0,1.65332,29.06.2007 20:30:00,564,-0.43627179775237696,36.91,IS,0.41,0.0,Phase3-EA-SA2v2-EURCHF-M5-43,EURCHFMT4,290,2h 54m,Buy
4371.35,247.03,02.07.2007 08:09:58,tp 247.030,0.0,-340.25000000004366,0.0,0.0,247.42,02.07.2007 03:15:00,565,-0.3592484975441691,72.95,IS,0.23,0.0,Phase3-EA-S4v1-GBPJPY-M5-194,GBPJPYMT4,174,4h 54m,Sell
4408.31,1.6523,02.07.2007 09:19:57,tp 1.65230,0.0,-303.29000000003725,0.0,0.0,1.6534,02.07.2007 01:00:00,566,-0.3202247665545054,36.96,IS,0.41,0.0,Phase3-EA-SA2v2-EURCHF-M5-43,EURCHFMT4,292,8h 19m,Sell
4668.66,2.01232,02.07.2007 10:59:58,tp 2.01232,-4.25,-42.94000000003143,0.0,0.0,1.99342,22.06.2007 09:00:00,567,-0.045337635516696353,260.35,IS,0.14,0.0,Phase3-EA-B1v1-GBPUSD-M30-14,GBPUSDMT4,40,10d 1h 59m,Buy
4740.96,246.54,03.07.2007 02:09:59,tp 246.540,-1.09,-0.0,0.0,0.0,246.93,02.07.2007 23:20:00,568,-0.0,72.3,IS,0.23,0.0,Phase3-EA-S4v1-GBPJPY-M5-194,GBPJPYMT4,176,2h 49m,Sell
4788.89,1.21022,03.07.2007 02:29:58,tp 1.21022,0.0,-0.0,0.0,0.0,1.20922,03.07.2007 01:30:00,569,-0.0,47.93,IS,0.58,0.0,Phase3-EA-SA2v2-USDCHF-M15-107,USDCHFMT4,166,59m 58s,Buy
4774.22,122362,03.07.2007 03:15:00,,-0.99,-14.669999999998254,0.0,0.0,122.3,02.07.2007 22:00:00,570,-0.015476497298362965,-14.67,IS,0.27,0.0,Phase3-EA-S1v2-USDJPY-M15-0,USDJPYMT4,200,5h 15m,Sell
4847.5,247042,03.07.2007 03:54:58,tp 247.042,0.0,-0.0,0.0,0.0,246652,03.07.2007 02:20:00,571,-0.0,73.28,IS,0.23,0.0,Phase3-EA-S4v1-GBPJPY-M5-194,GBPJPYMT4,178,1h 34m,Buy
4876.48,1.6498,03.07.2007 06:10:00,,-0.81,-0.0,0.0,0.0,1.64892,02.07.2007 21:50:00,572,-0.0,28.98,IS,0.41,0.0,Phase3-EA-SA2v2-EURCHF-M5-43,EURCHFMT4,294,8h 20m,Buy
4988.74,1.65262,03.07.2007 10:14:59,tp 1.65262,0.0,-0.0,0.0,0.0,1.64862,03.07.2007 03:45:00,573,-0.0,112.26,IS,0.34,0.0,Phase3-EA-S4v1-EURCHF-M15-221,EURCHFMT4,182,6h 29m,Buy
5025.04,1.65502,04.07.2007 01:54:57,tp 1.65502,-0.81,-0.0,0.0,0.0,1.65392,03.07.2007 21:15:00,574,-0.0,36.3,IS,0.41,0.0,Phase3-EA-SA2v2-EURCHF-M5-43,EURCHFMT4,296,4h 39m,Buy
5072.78,1.2149,04.07.2007 04:44:57,tp 1.21490,0.0,-0.0,0.0,0.0,1.2159,04.07.2007 02:15:00,575,-0.0,47.74,IS,0.58,0.0,Phase3-EA-SA2v2-USDCHF-M15-107,USDCHFMT4,168,2h 29m,Sell
5085.57,246892,04.07.2007 06:35:00,,0.0,-0.0,0.0,0.0,246.96,04.07.2007 01:10:00,576,-0.0,12.79,IS,0.23,0.0,Phase3-EA-S4v1-GBPJPY-M5-194,GBPJPYMT4,180,5h 25m,Sell
5135.35,1.6562,04.07.2007 13:30:00,,0.0,-0.0,0.0,0.0,1.65442,04.07.2007 04:45:00,577,-0.0,49.78,IS,0.34,0.0,Phase3-EA-S4v1-EURCHF-M15-221,EURCHFMT4,184,8h 45m,Buy
5083.93,1.21712,05.07.2007 03:45:00,,-7.58,-51.419999999998254,0.0,0.0,1.2162,04.07.2007 23:30:00,578,-0.05404930974658549,-51.42,IS,0.58,0.0,Phase3-EA-SA2v2-USDCHF-M15-107,USDCHFMT4,170,4h 15m,Sell
5123.04,122.88,05.07.2007 22:15:00,,0.0,-12.309999999997672,0.0,0.0,122702,05.07.2007 19:45:00,579,-0.012939459412298019,39.11,IS,0.27,0.0,Phase3-EA-S1v2-USDJPY-M15-0,USDJPYMT4,202,2h 30m,Buy
5126.85,1.21762,06.07.2007 04:45:00,,0.0,-8.5,0.0,0.0,1.2177,06.07.2007 00:30:00,580,-0.008934638911824043,3.81,IS,0.58,0.0,Phase3-EA-SA2v2-USDCHF-M15-107,USDCHFMT4,172,4h 15m,Sell
5199.7,247512,06.07.2007 07:04:58,tp 247.512,0.0,-0.0,0.0,0.0,247122,06.07.2007 03:35:00,581,-0.0,72.85,IS,0.23,0.0,Phase3-EA-S4v1-GBPJPY-M5-194,GBPJPYMT4,182,3h 29m,Buy
5178.85,1.65612,06.07.2007 09:10:00,,0.0,-20.85000000000582,0.0,0.0,1.6555,06.07.2007 00:50:00,582,-0.02190132952100249,-20.85,IS,0.41,0.0,Phase3-EA-SA2v2-EURCHF-M5-43,EURCHFMT4,298,8h 20m,Sell
5163.04,1.66022,09.07.2007 06:10:00,,-1.68,-36.66000000000349,0.0,0.0,1.6598,06.07.2007 21:50:00,583,-0.038508524711741175,-15.81,IS,0.41,0.0,Phase3-EA-SA2v2-EURCHF-M5-43,EURCHFMT4,300,2d 8h 20m,Sell
5215.58,1.65782,09.07.2007 13:15:00,,0.0,-0.0,0.0,0.0,1.6597,09.07.2007 04:30:00,584,-0.0,52.54,IS,0.34,0.0,Phase3-EA-S4v1-EURCHF-M15-221,EURCHFMT4,186,8h 45m,Sell
5218.82,1.2163,10.07.2007 02:30:00,,-0.57,-0.0,0.0,0.0,1.21622,09.07.2007 22:15:00,585,-0.0,3.24,IS,0.58,0.0,Phase3-EA-SA2v2-USDCHF-M15-107,USDCHFMT4,174,4h 15m,Buy
5210.6,1.6574,10.07.2007 05:55:00,,-0.81,-8.220000000001164,0.0,0.0,1.65762,09.07.2007 21:35:00,586,-0.008632747181703322,-8.22,IS,0.41,0.0,Phase3-EA-SA2v2-EURCHF-M5-43,EURCHFMT4,302,8h 20m,Buy
5161.02,247482,10.07.2007 15:59:59,sl 247.482,-0.52,-57.80000000000291,0.0,0.0,248152,06.07.2007 23:00:00,587,-0.06070228553557256,-49.58,IS,0.09,0.0,Phase3-EA-B1v1-GBPJPY-M30-1,GBPJPYMT4,88,3d 16h 59m,Buy
5009.59,245952,11.07.2007 00:49:58,sl 245.952,0.0,-209.22999999999593,0.0,0.0,246752,11.07.2007 00:30:00,588,-0.21973597236344222,-151.43,IS,0.23,0.0,Phase3-EA-S4v1-GBPJPY-M5-194,GBPJPYMT4,184,19m 58s,Buy
5146.36,245.15,11.07.2007 01:29:58,tp 245.150,-0.43,-72.45999999999185,0.0,0.0,247.0,10.07.2007 23:30:00,589,-0.07609840155548221,136.77,IS,0.09,0.0,Phase3-EA-B1v1-GBPJPY-M30-1,GBPJPYMT4,90,1h 59m,Sell
5164.1,1.2032,11.07.2007 03:45:00,,-0.58,-54.71999999998661,0.0,0.0,1.20282,10.07.2007 23:30:00,590,-0.057467630873798456,17.74,IS,0.58,0.0,Phase3-EA-SA2v2-USDCHF-M15-107,USDCHFMT4,176,4h 15m,Buy
5101.23,1.6531,11.07.2007 04:55:00,,-0.82,-117.58999999998196,0.0,0.0,1.65492,10.07.2007 20:35:00,591,-0.12349449405063188,-62.87,IS,0.41,0.0,Phase3-EA-SA2v2-EURCHF-M5-43,EURCHFMT4,304,8h 20m,Buy
5174.97,246.3,11.07.2007 08:19:57,tp 246.300,0.0,-43.84999999997672,0.0,0.0,246.69,11.07.2007 03:00:00,592,-0.04605182042791193,73.74,IS,0.23,0.0,Phase3-EA-S4v1-GBPJPY-M5-194,GBPJPYMT4,186,5h 19m,Sell
5158.98,1.65732,12.07.2007 07:25:00,,-5.1,-59.839999999981956,0.0,0.0,1657,11.07.2007 23:00:00,593,-0.0628447191426883,-15.99,IS,0.41,0.0,Phase3-EA-SA2v2-EURCHF-M5-43,EURCHFMT4,306,8h 25m,Sell
5171.77,122.48,12.07.2007 22:15:00,,0.0,-47.04999999998836,0.0,0.0,122422,12.07.2007 20:45:00,594,-0.049412500595983365,12.79,IS,0.27,0.0,Phase3-EA-S1v2-USDJPY-M15-0,USDJPYMT4,204,1h 30m,Buy
5175.74,122.5,12.07.2007 22:30:00,,0.0,-43.079999999987194,0.0,0.0,122482,12.07.2007 22:15:00,595,-0.04524315676248369,3.97,IS,0.27,0.0,Phase3-EA-S1v2-USDJPY-M15-0,USDJPYMT4,206,15m 0s,Buy
5186.99,1.65792,13.07.2007 06:25:00,,-1.7,-31.829999999987194,0.0,0.0,1.6583,12.07.2007 22:00:00,596,-0.03342826554665052,11.25,IS,0.41,0.0,Phase3-EA-SA2v2-EURCHF-M5-43,EURCHFMT4,308,8h 25m,Sell
5210.9,121962,13.07.2007 23:30:00,,0.0,-7.919999999983702,0.0,0.0,122.07,13.07.2007 21:30:00,597,-0.00831768341592943,23.91,IS,0.27,0.0,Phase3-EA-S1v2-USDJPY-M15-0,USDJPYMT4,208,2h 0m,Sell
5246.69,1.6566,16.07.2007 01:05:00,tp 1.65660,-1.7,-0.0,0.0,0.0,1.6577,13.07.2007 20:10:00,598,-0.0,35.79,IS,0.41,0.0,Phase3-EA-SA2v2-EURCHF-M5-43,EURCHFMT4,310,2d 4h 55m,Sell
5195.9,247652,16.07.2007 01:29:57,sl 247.652,-1.32,-50.7899999999936,0.0,0.0,248322,11.07.2007 18:30:00,599,-0.05332468771355052,-50.79,IS,0.09,0.0,Phase3-EA-B1v1-GBPJPY-M30-1,GBPJPYMT4,92,4d 6h 59m,Buy
5269.35,248162,16.07.2007 01:59:58,tp 248.162,0.0,-0.0,0.0,0.0,247772,16.07.2007 01:10:00,600,-0.0,73.45,IS,0.23,0.0,Phase3-EA-S4v1-GBPJPY-M5-194,GBPJPYMT4,188,49m 58s,Buy
5244.8,1.6558,16.07.2007 10:05:00,,0.0,-24.55000000000291,0.0,0.0,1.65652,16.07.2007 01:45:00,601,-0.02576904324423636,-24.55,IS,0.41,0.0,Phase3-EA-SA2v2-EURCHF-M5-43,EURCHFMT4,312,8h 20m,Buy
5213.12,1.6557,16.07.2007 10:45:00,,0.0,-56.229999999995925,0.0,0.0,1.65682,16.07.2007 02:00:00,602,-0.0590221304123476,-31.68,IS,0.34,0.0,Phase3-EA-S4v1-EURCHF-M15-221,EURCHFMT4,188,8h 45m,Buy
5250.65,1.65702,16.07.2007 22:39:57,tp 1.65702,0.0,-18.69999999999709,0.0,0.0,1.65592,16.07.2007 20:55:00,603,-0.019628558397844716,37.53,IS,0.41,0.0,Phase3-EA-SA2v2-EURCHF-M5-43,EURCHFMT4,314,1h 44m,Buy
5286.45,1.6564,17.07.2007 01:59:57,tp 1.65640,-1.7,-0.0,0.0,0.0,1.6575,16.07.2007 23:55:00,604,-0.0,35.8,IS,0.41,0.0,Phase3-EA-SA2v2-EURCHF-M5-43,EURCHFMT4,316,2h 4m,Sell
5316.7,1.20252,17.07.2007 03:45:00,,-2.55,-0.0,0.0,0.0,1.2032,16.07.2007 23:30:00,605,-0.0,30.25,IS,0.58,0.0,Phase3-EA-SA2v2-USDCHF-M15-107,USDCHFMT4,178,4h 15m,Sell
5316.32,248392,17.07.2007 09:10:00,,0.0,-0.3800000000046566,0.0,0.0,248.39,17.07.2007 03:45:00,606,-3.986709569305864E-4,-0.38,IS,0.23,0.0,Phase3-EA-S4v1-GBPJPY-M5-194,GBPJPYMT4,190,5h 25m,Sell
5313.66,121892,17.07.2007 09:15:00,,0.0,-3.040000000008149,0.0,0.0,121.88,17.07.2007 01:00:00,607,-0.0031893676554141577,-2.66,IS,0.27,0.0,Phase3-EA-S1v2-USDJPY-M15-0,USDJPYMT4,210,8h 15m,Sell
5359.34,1.2023,18.07.2007 00:14:59,tp 1.20230,-2.56,-0.0,0.0,0.0,1.2033,17.07.2007 22:00:00,608,-0.0,45.68,IS,0.58,0.0,Phase3-EA-SA2v2-USDCHF-M15-107,USDCHFMT4,180,2h 14m,Sell
5395.16,1.6573,18.07.2007 00:15:00,tp 1.65730,-1.7,-0.0,0.0,0.0,1.6584,17.07.2007 22:05:00,609,-0.0,35.82,IS,0.41,0.0,Phase3-EA-SA2v2-EURCHF-M5-43,EURCHFMT4,318,2h 10m,Sell
5443.4,1.20222,18.07.2007 00:44:57,tp 1.20222,0.0,-0.0,0.0,0.0,1.20122,18.07.2007 00:30:00,610,-0.0,48.24,IS,0.58,0.0,Phase3-EA-SA2v2-USDCHF-M15-107,USDCHFMT4,182,14m 57s,Buy
5516.88,250172,18.07.2007 02:54:59,tp 250.172,0.0,-0.0,0.0,0.0,249782,18.07.2007 01:50:00,611,-0.0,73.48,IS,0.23,0.0,Phase3-EA-S4v1-GBPJPY-M5-194,GBPJPYMT4,192,1h 4m,Buy
5327.8,1.19632,18.07.2007 06:59:57,sl 1.19632,0.0,-189.08000000000175,0.0,0.0,1.20022,18.07.2007 02:45:00,612,-0.19795453955363868,-189.08,IS,0.58,0.0,Phase3-EA-SA2v2-USDCHF-M15-107,USDCHFMT4,184,4h 14m,Buy
5241.46,1.6546,18.07.2007 08:40:00,,0.0,-275.41999999999825,0.0,0.0,1.65712,18.07.2007 00:20:00,613,-0.28834693930538563,-86.34,IS,0.41,0.0,Phase3-EA-SA2v2-EURCHF-M5-43,EURCHFMT4,320,8h 20m,Buy
5238.06,1.6558,18.07.2007 11:00:00,,0.0,-278.81999999999243,0.0,0.0,1.65592,18.07.2007 02:15:00,614,-0.29190651955967595,-3.4,IS,0.34,0.0,Phase3-EA-S4v1-EURCHF-M15-221,EURCHFMT4,190,8h 45m,Buy
5206.63,121.99,18.07.2007 23:00:00,,0.0,-310.24999999998545,0.0,0.0,122132,18.07.2007 17:00:00,615,-0.3248116982045322,-31.43,IS,0.27,0.0,Phase3-EA-S1v2-USDJPY-M15-0,USDJPYMT4,212,6h 0m,Buy
5232.0,121862,19.07.2007 09:45:00,,-2.99,-284.8799999999901,0.0,0.0,121.99,18.07.2007 23:00:00,616,-0.2982509478952724,25.37,IS,0.27,0.0,Phase3-EA-S1v2-USDJPY-M15-0,USDJPYMT4,214,10h 45m,Sell
5269.49,1.6608,19.07.2007 23:59:57,tp 1.66080,0.0,-247.38999999998487,0.0,0.0,1.6619,19.07.2007 22:45:00,617,-0.2590013409148044,37.49,IS,0.41,0.0,Phase3-EA-SA2v2-EURCHF-M5-43,EURCHFMT4,322,1h 14m,Sell
5218.69,249562,20.07.2007 17:29:58,sl 249.562,-1.33,-298.1899999999878,0.0,0.0,250232,17.07.2007 18:30:00,618,-0.3121856576554715,-50.8,IS,0.09,0.0,Phase3-EA-B1v1-GBPJPY-M30-1,GBPJPYMT4,94,2d 22h 59m,Buy
5256.26,1.6589,20.07.2007 22:19:58,tp 1.65890,0.0,-260.6199999999808,0.0,0.0,1.66,20.07.2007 22:05:00,619,-0.27285229584548887,37.57,IS,0.41,0.0,Phase3-EA-SA2v2-EURCHF-M5-43,EURCHFMT4,324,14m 58s,Sell
5280.3,121.28,20.07.2007 23:45:00,,0.0,-236.5799999999872,0.0,0.0,121172,20.07.2007 23:00:00,620,-0.2476839695768821,24.04,IS,0.27,0.0,Phase3-EA-S1v2-USDJPY-M15-0,USDJPYMT4,216,45m 0s,Buy
5354.21,249.43,23.07.2007 01:59:58,tp 249.430,0.0,-162.6699999999837,0.0,0.0,249.82,23.07.2007 01:10:00,621,-0.17030497646068796,73.91,IS,0.23,0.0,Phase3-EA-S4v1-GBPJPY-M5-194,GBPJPYMT4,194,49m 58s,Sell
5391.77,1.6603,23.07.2007 03:40:00,tp 1.66030,0.0,-125.10999999998603,0.0,0.0,1.6614,23.07.2007 01:25:00,622,-0.13098208400440417,37.56,IS,0.41,0.0,Phase3-EA-SA2v2-EURCHF-M5-43,EURCHFMT4,326,2h 15m,Sell
5450.57,121012,23.07.2007 04:00:00,,-1.0,-66.30999999998312,0.0,0.0,121.28,20.07.2007 23:45:00,623,-0.06942228431245144,58.8,IS,0.27,0.0,Phase3-EA-S1v2-USDJPY-M15-0,USDJPYMT4,218,2d 4h 15m,Sell
5483.99,1.65972,23.07.2007 11:00:00,,0.0,-32.889999999984866,0.0,0.0,1.6609,23.07.2007 02:15:00,624,-0.03443370428345737,33.42,IS,0.34,0.0,Phase3-EA-S4v1-EURCHF-M15-221,EURCHFMT4,192,8h 45m,Sell
5503.57,121.33,23.07.2007 18:45:00,,0.0,-13.30999999998312,0.0,0.0,121242,23.07.2007 17:15:00,625,-0.013934709760183864,19.58,IS,0.27,0.0,Phase3-EA-S1v2-USDJPY-M15-0,USDJPYMT4,220,1h 30m,Buy
5540.94,1665,23.07.2007 22:50:00,tp 1.66500,0.0,-0.0,0.0,0.0,1.6661,23.07.2007 20:30:00,626,-0.0,37.37,IS,0.41,0.0,Phase3-EA-SA2v2-EURCHF-M5-43,EURCHFMT4,328,2h 20m,Sell
5388.1,248592,24.07.2007 03:14:58,sl 248.592,-0.68,-152.8399999999965,0.0,0.0,249392,23.07.2007 23:05:00,627,-0.15997330568444937,-152.84,IS,0.23,0.0,Phase3-EA-S4v1-GBPJPY-M5-194,GBPJPYMT4,196,4h 9m,Buy
5256.44,1.2035,24.07.2007 03:45:00,,-0.58,-284.5,0.0,0.0,1.20622,23.07.2007 23:30:00,628,-0.29777810433935414,-131.66,IS,0.58,0.0,Phase3-EA-SA2v2-USDCHF-M15-107,USDCHFMT4,186,4h 15m,Buy
5517.32,2.06172,24.07.2007 03:59:57,tp 2.06172,-3.72,-23.619999999995343,0.0,0.0,2.04282,17.07.2007 12:00:00,629,-0.024722386026341504,260.88,IS,0.14,0.0,Phase3-EA-B1v1-GBPUSD-M30-14,GBPUSDMT4,42,6d 15h 59m,Buy
5562.71,249.03,24.07.2007 08:45:00,,0.0,-0.0,0.0,0.0,248792,24.07.2007 03:20:00,630,-0.0,45.39,IS,0.23,0.0,Phase3-EA-S4v1-GBPJPY-M5-194,GBPJPYMT4,198,5h 25m,Buy
5637.4,247.64,25.07.2007 02:39:58,tp 247.640,0.0,-0.0,0.0,0.0,248.03,25.07.2007 02:15:00,631,-0.0,74.69,IS,0.23,0.0,Phase3-EA-S4v1-GBPJPY-M5-194,GBPJPYMT4,200,24m 58s,Sell
5626.21,1.2028,25.07.2007 02:45:00,,-0.58,-11.190000000002328,0.0,0.0,1.20302,24.07.2007 22:30:00,632,-0.01170044355032897,-11.19,IS,0.58,0.0,Phase3-EA-SA2v2-USDCHF-M15-107,USDCHFMT4,188,4h 15m,Buy
5594.07,1.6626,25.07.2007 06:45:00,,-0.82,-43.330000000001746,0.0,0.0,1.66352,24.07.2007 22:25:00,633,-0.04530654325609197,-32.14,IS,0.41,0.0,Phase3-EA-SA2v2-EURCHF-M5-43,EURCHFMT4,330,8h 20m,Buy
5625.0,120.48,25.07.2007 22:00:00,,0.0,-12.400000000008731,0.0,0.0,120342,25.07.2007 17:30:00,634,-0.012965638965518425,30.93,IS,0.27,0.0,Phase3-EA-S1v2-USDJPY-M15-0,USDJPYMT4,222,4h 30m,Buy
5662.17,1.6643,26.07.2007 03:34:58,tp 1.66430,0.0,-0.0,0.0,0.0,1.6654,26.07.2007 01:20:00,635,-0.0,37.17,IS,0.41,0.0,Phase3-EA-SA2v2-EURCHF-M5-43,EURCHFMT4,332,2h 14m,Sell
5736.59,247.23,26.07.2007 05:04:57,tp 247.230,0.0,-0.0,0.0,0.0,247.62,26.07.2007 03:00:00,636,-0.0,74.42,IS,0.23,0.0,Phase3-EA-S4v1-GBPJPY-M5-194,GBPJPYMT4,202,2h 4m,Sell
5764.05,1.66442,26.07.2007 10:30:00,,0.0,-0.0,0.0,0.0,1.6654,26.07.2007 01:45:00,637,-0.0,27.46,IS,0.34,0.0,Phase3-EA-S4v1-EURCHF-M15-221,EURCHFMT4,194,8h 45m,Sell
5904.31,241.47,27.07.2007 00:59:57,tp 241.470,-0.44,-0.0,0.0,0.0,243.32,26.07.2007 21:30:00,638,-0.0,140.26,IS,0.09,0.0,Phase3-EA-B1v1-GBPJPY-M30-1,GBPJPYMT4,96,3h 29m,Sell
5980.13,242362,27.07.2007 01:39:57,tp 242.362,0.0,-0.0,0.0,0.0,241972,27.07.2007 00:50:00,639,-0.0,75.82,IS,0.23,0.0,Phase3-EA-S4v1-GBPJPY-M5-194,GBPJPYMT4,204,49m 57s,Buy
6028.31,1.20392,27.07.2007 03:29:58,tp 1.20392,0.0,-0.0,0.0,0.0,1.20292,27.07.2007 01:45:00,640,-0.0,48.18,IS,0.58,0.0,Phase3-EA-SA2v2-USDCHF-M15-107,USDCHFMT4,190,1h 44m,Buy
6064.93,1.65542,27.07.2007 04:29:57,tp 1.65542,-0.82,-0.0,0.0,0.0,1.65432,26.07.2007 21:30:00,641,-0.0,36.62,IS,0.41,0.0,Phase3-EA-SA2v2-EURCHF-M5-43,EURCHFMT4,334,6h 59m,Buy
5910.53,244.29,27.07.2007 05:34:57,sl 244.290,0.0,-154.39999999999418,0.0,0.0,243.49,27.07.2007 03:05:00,642,-0.16072462656246567,-154.4,IS,0.23,0.0,Phase3-EA-S4v1-GBPJPY-M5-194,GBPJPYMT4,206,2h 29m,Sell
5859.08,1.6515,27.07.2007 10:00:00,,0.0,-205.84999999999127,0.0,0.0,1.65332,27.07.2007 01:15:00,643,-0.2142821527064987,-51.45,IS,0.34,0.0,Phase3-EA-S4v1-EURCHF-M15-221,EURCHFMT4,196,8h 45m,Buy
5896.41,1.6484,27.07.2007 22:54:57,tp 1.64840,0.0,-168.51999999998952,0.0,0.0,1.6495,27.07.2007 21:30:00,644,-0.17542301857711173,37.33,IS,0.41,0.0,Phase3-EA-SA2v2-EURCHF-M5-43,EURCHFMT4,336,1h 24m,Sell
5900.25,1.2071,30.07.2007 07:00:00,,0.0,-164.67999999999302,0.0,0.0,1.20702,30.07.2007 02:45:00,645,-0.17142572216519897,3.84,IS,0.58,0.0,Phase3-EA-SA2v2-USDCHF-M15-107,USDCHFMT4,192,4h 15m,Buy
5819.37,118.47,30.07.2007 07:15:00,,-0.66,-245.55999999999767,0.0,0.0,118822,27.07.2007 17:00:00,646,-0.2556187778411929,-80.88,IS,0.27,0.0,Phase3-EA-S1v2-USDJPY-M15-0,USDJPYMT4,224,2d 14h 15m,Buy
5835.73,1.6475,30.07.2007 10:45:00,,0.0,-229.1999999999971,0.0,0.0,1.64692,30.07.2007 02:00:00,647,-0.23858862958625682,16.36,IS,0.34,0.0,Phase3-EA-S4v1-EURCHF-M15-221,EURCHFMT4,198,8h 45m,Buy
5680.29,242.0,31.07.2007 02:09:58,sl 242.000,-1.12,-384.6399999999994,0.0,0.0,241.2,30.07.2007 23:40:00,648,-0.40039585726029164,-155.44,IS,0.23,0.0,Phase3-EA-S4v1-GBPJPY-M5-194,GBPJPYMT4,208,2h 29m,Sell
5725.98,1202,31.07.2007 02:14:58,tp 1.20200,-2.56,-338.9499999999971,0.0,0.0,1203,30.07.2007 22:15:00,649,-0.35283427573412773,45.69,IS,0.58,0.0,Phase3-EA-SA2v2-USDCHF-M15-107,USDCHFMT4,194,3h 59m,Sell
5633.71,118952,31.07.2007 04:00:00,,-1.02,-431.22000000000116,0.0,0.0,118.55,30.07.2007 17:15:00,650,-0.44888389550692515,-92.27,IS,0.27,0.0,Phase3-EA-S1v2-USDJPY-M15-0,USDJPYMT4,226,10h 45m,Sell
5535.82,1.64842,31.07.2007 04:55:00,,-1.7,-529.1100000000006,0.0,0.0,1.6456,30.07.2007 20:35:00,651,-0.5507837251325746,-97.89,IS,0.41,0.0,Phase3-EA-SA2v2-EURCHF-M5-43,EURCHFMT4,338,8h 20m,Sell
5453.43,1.65172,31.07.2007 10:30:00,,0.0,-611.5,0.0,0.0,1.6488,31.07.2007 01:45:00,652,-0.6365486343455405,-82.39,IS,0.34,0.0,Phase3-EA-S4v1-EURCHF-M15-221,EURCHFMT4,200,8h 45m,Sell
5384.4,240.39,01.08.2007 04:30:00,,-0.7,-680.5299999999988,0.0,0.0,240742,31.07.2007 23:05:00,653,-0.7084062831253801,-69.03,IS,0.23,0.0,Phase3-EA-S4v1-GBPJPY-M5-194,GBPJPYMT4,210,5h 25m,Buy
5280.54,1.6427,01.08.2007 06:05:00,,-0.82,-784.3899999999994,0.0,0.0,1.64572,31.07.2007 21:45:00,654,-0.816520659516432,-103.86,IS,0.41,0.0,Phase3-EA-SA2v2-EURCHF-M5-43,EURCHFMT4,340,8h 20m,Buy
5238.54,2.02882,01.08.2007 20:29:58,sl 2.02882,0.0,-826.3899999999994,0.0,0.0,2.03182,01.08.2007 16:00:00,655,-0.8602410890217675,-42.0,IS,0.14,0.0,Phase3-EA-B1v1-GBPUSD-M30-14,GBPUSDMT4,44,4h 29m,Buy
5304.02,118.75,01.08.2007 23:00:00,,0.0,-760.9100000000035,0.0,0.0,118462,01.08.2007 19:45:00,656,-0.7920788574977391,65.48,IS,0.27,0.0,Phase3-EA-S1v2-USDJPY-M15-0,USDJPYMT4,228,3h 15m,Buy
5344.55,1.2035,02.08.2007 00:44:59,tp 1.20350,-7.66,-720.3800000000047,0.0,0.0,1.2045,01.08.2007 23:30:00,657,-0.7498886430250915,40.53,IS,0.58,0.0,Phase3-EA-SA2v2-USDCHF-M15-107,USDCHFMT4,196,1h 14m,Sell
5186.66,242.08,02.08.2007 01:19:57,sl 242.080,-3.37,-878.2700000000041,0.0,0.0,241.28,01.08.2007 23:15:00,658,-0.9142462290869345,-157.89,IS,0.23,0.0,Phase3-EA-S4v1-GBPJPY-M5-194,GBPJPYMT4,212,2h 4m,Sell
5219.03,1.6443,02.08.2007 03:04:57,tp 1.64430,-5.11,-845.9000000000087,0.0,0.0,1.6454,01.08.2007 23:00:00,659,-0.8805502694896129,32.37,IS,0.41,0.0,Phase3-EA-SA2v2-EURCHF-M5-43,EURCHFMT4,342,4h 4m,Sell
5294.54,241312,02.08.2007 04:54:59,tp 241.312,0.0,-770.390000000014,0.0,0.0,240922,02.08.2007 03:20:00,660,-0.8019471830146686,75.51,IS,0.23,0.0,Phase3-EA-S4v1-GBPJPY-M5-194,GBPJPYMT4,214,1h 34m,Buy
5407.48,1.6428,02.08.2007 07:29:58,tp 1.64280,0.0,-657.4500000000116,0.0,0.0,1.6468,02.08.2007 01:30:00,661,-0.6843808661496043,112.94,IS,0.34,0.0,Phase3-EA-S4v1-EURCHF-M15-221,EURCHFMT4,202,5h 59m,Sell
5441.01,119.18,02.08.2007 21:15:00,,0.0,-623.9200000000128,0.0,0.0,119032,02.08.2007 20:30:00,662,-0.649477389927846,33.53,IS,0.27,0.0,Phase3-EA-S1v2-USDJPY-M15-0,USDJPYMT4,230,45m 0s,Buy
5478.47,1.65022,02.08.2007 23:49:57,tp 1.65022,0.0,-586.4600000000064,0.0,0.0,1.64912,02.08.2007 21:45:00,663,-0.610482930659509,37.46,IS,0.41,0.0,Phase3-EA-SA2v2-EURCHF-M5-43,EURCHFMT4,344,2h 4m,Buy
5453.4,1203,03.08.2007 06:30:00,,0.0,-611.5300000000134,0.0,0.0,1.20352,03.08.2007 02:15:00,664,-0.6365798632237726,-25.07,IS,0.58,0.0,Phase3-EA-SA2v2-USDCHF-M15-107,USDCHFMT4,198,4h 15m,Buy
5490.87,1.65022,03.08.2007 08:44:57,tp 1.65022,0.0,-574.0600000000122,0.0,0.0,1.64912,03.08.2007 02:55:00,665,-0.5975749943293684,37.47,IS,0.41,0.0,Phase3-EA-SA2v2-EURCHF-M5-43,EURCHFMT4,346,5h 49m,Buy
5582.2,118.25,03.08.2007 22:14:57,tp 118.250,0.0,-482.7300000000105,0.0,0.0,118.65,03.08.2007 21:00:00,666,-0.5025038794074072,91.33,IS,0.27,0.0,Phase3-EA-S1v2-USDJPY-M15-0,USDJPYMT4,232,1h 14m,Sell
5630.96,1.18952,03.08.2007 22:29:57,tp 1.18952,0.0,-433.9700000000157,0.0,0.0,1.18852,03.08.2007 22:15:00,667,-0.4517465426769325,48.76,IS,0.58,0.0,Phase3-EA-SA2v2-USDCHF-M15-107,USDCHFMT4,200,14m 57s,Buy
5462.04,1.63822,03.08.2007 23:14:58,sl 1.63822,0.0,-602.890000000014,0.0,0.0,1.64312,03.08.2007 21:50:00,668,-0.6275859462969613,-168.92,IS,0.41,0.0,Phase3-EA-SA2v2-EURCHF-M5-43,EURCHFMT4,348,1h 24m,Buy
5499.93,1.64002,03.08.2007 23:54:57,tp 1.64002,0.0,-565.0000000000146,0.0,0.0,1.63892,03.08.2007 23:15:00,669,-0.5881438731075056,37.89,IS,0.41,0.0,Phase3-EA-SA2v2-EURCHF-M5-43,EURCHFMT4,350,39m 57s,Buy
5343.34,240082,06.08.2007 01:00:00,sl 240.082,-0.7,-721.5900000000111,0.0,0.0,240882,03.08.2007 23:10:00,670,-0.7511482077798948,-156.59,IS,0.23,0.0,Phase3-EA-S4v1-GBPJPY-M5-194,GBPJPYMT4,216,2d 1h 50m,Buy
5419.67,239742,06.08.2007 01:29:59,tp 239.742,0.0,-645.2600000000093,0.0,0.0,239352,06.08.2007 01:15:00,671,-0.6716915319669818,76.33,IS,0.23,0.0,Phase3-EA-S4v1-GBPJPY-M5-194,GBPJPYMT4,218,14m 59s,Buy
5453.59,1.6365,06.08.2007 09:45:00,,0.0,-611.3400000000111,0.0,0.0,1.63532,06.08.2007 01:00:00,672,-0.6363820803283888,33.92,IS,0.34,0.0,Phase3-EA-S4v1-EURCHF-M15-221,EURCHFMT4,204,8h 45m,Buy
5411.59,2.04162,06.08.2007 12:29:57,sl 2.04162,0.0,-653.3400000000111,0.0,0.0,2.04462,06.08.2007 09:30:00,673,-0.6801025098337244,-42.0,IS,0.14,0.0,Phase3-EA-B1v1-GBPUSD-M30-14,GBPUSDMT4,46,2h 59m,Buy
5485.99,241.2,07.08.2007 02:44:57,tp 241.200,-1.12,-578.9400000000169,0.0,0.0,241.59,06.08.2007 23:05:00,674,-0.6026548918528504,74.4,IS,0.23,0.0,Phase3-EA-S4v1-GBPJPY-M5-194,GBPJPYMT4,220,3h 39m,Sell
5418.14,1.64322,07.08.2007 06:40:00,,-1.72,-646.7900000000227,0.0,0.0,1.6413,06.08.2007 22:20:00,675,-0.6732842047561187,-67.85,IS,0.41,0.0,Phase3-EA-SA2v2-EURCHF-M5-43,EURCHFMT4,352,8h 20m,Sell
5423.28,1.64312,07.08.2007 10:15:00,,0.0,-641.6500000000233,0.0,0.0,1.6433,07.08.2007 01:30:00,676,-0.667933656954752,5.14,IS,0.34,0.0,Phase3-EA-S4v1-EURCHF-M15-221,EURCHFMT4,206,8h 45m,Sell
5687.19,2.0203,07.08.2007 17:29:57,tp 2.02030,-0.69,-377.7400000000198,0.0,0.0,2.0392,06.08.2007 12:30:00,677,-0.3932132152701506,263.91,IS,0.14,0.0,Phase3-EA-B1v1-GBPUSD-M30-14,GBPUSDMT4,48,1d 4h 59m,Sell
5716.39,118342,07.08.2007 21:15:00,,0.0,-348.5400000000227,0.0,0.0,118.47,07.08.2007 19:45:00,678,-0.3628171071378727,29.2,IS,0.27,0.0,Phase3-EA-S1v2-USDJPY-M15-0,USDJPYMT4,234,1h 30m,Sell
5754.19,1.64262,07.08.2007 21:59:57,tp 1.64262,0.0,-310.7400000000198,0.0,0.0,1.64152,07.08.2007 21:25:00,679,-0.32346872058306764,37.8,IS,0.41,0.0,Phase3-EA-SA2v2-EURCHF-M5-43,EURCHFMT4,354,34m 57s,Buy
5791.9,1.6448,07.08.2007 22:54:57,tp 1.64480,0.0,-273.0300000000134,0.0,0.0,1.6459,07.08.2007 22:45:00,680,-0.28421402066291324,37.71,IS,0.41,0.0,Phase3-EA-SA2v2-EURCHF-M5-43,EURCHFMT4,356,9m 57s,Sell
5785.71,240472,08.08.2007 08:00:00,,0.0,-279.2200000000157,0.0,0.0,240.44,08.08.2007 02:35:00,681,-0.2906575792019163,-6.19,IS,0.23,0.0,Phase3-EA-S4v1-GBPJPY-M5-194,GBPJPYMT4,222,5h 25m,Sell
5807.87,119.4,08.08.2007 17:15:00,,0.0,-257.0600000000122,0.0,0.0,119302,08.08.2007 17:00:00,682,-0.2675898478248118,22.16,IS,0.27,0.0,Phase3-EA-S1v2-USDJPY-M15-0,USDJPYMT4,236,15m 0s,Buy
5845.59,1.6495,08.08.2007 22:14:57,tp 1.64950,0.0,-219.34000000001106,0.0,0.0,1.6506,08.08.2007 20:40:00,683,-0.22832473827859018,37.72,IS,0.41,0.0,Phase3-EA-SA2v2-EURCHF-M5-43,EURCHFMT4,358,1h 34m,Sell
5872.51,119.67,09.08.2007 07:15:00,,-1.96,-192.4200000000128,0.0,0.0,119542,08.08.2007 22:15:00,684,-0.20030202489088644,26.92,IS,0.27,0.0,Phase3-EA-S1v2-USDJPY-M15-0,USDJPYMT4,238,9h 0m,Buy
5880.4,1.65032,09.08.2007 08:00:00,,-5.14,-184.5300000000134,0.0,0.0,1.6507,08.08.2007 23:40:00,685,-0.19208882991952758,7.89,IS,0.41,0.0,Phase3-EA-SA2v2-EURCHF-M5-43,EURCHFMT4,360,8h 20m,Sell
5994.13,1.6473,09.08.2007 09:59:58,tp 1.64730,0.0,-70.80000000001746,0.0,0.0,1.6513,09.08.2007 06:15:00,686,-0.07370015259472672,113.73,IS,0.34,0.0,Phase3-EA-S4v1-EURCHF-M15-221,EURCHFMT4,208,3h 44m,Sell
6085.44,118.28,09.08.2007 21:29:59,tp 118.280,0.0,-0.0,0.0,0.0,118.68,09.08.2007 17:45:00,687,-0.0,91.31,IS,0.27,0.0,Phase3-EA-S1v2-USDJPY-M15-0,USDJPYMT4,240,3h 44m,Sell
5974.35,1.6355,10.08.2007 04:20:00,,-0.82,-111.08999999999651,0.0,0.0,1.63872,09.08.2007 20:00:00,688,-0.11561585189181257,-111.09,IS,0.41,0.0,Phase3-EA-SA2v2-EURCHF-M5-43,EURCHFMT4,362,8h 20m,Buy
6050.33,238742,10.08.2007 05:24:58,tp 238.742,0.0,-35.11000000000058,0.0,0.0,238352,10.08.2007 02:55:00,689,-0.03654039571448136,75.98,IS,0.23,0.0,Phase3-EA-S4v1-GBPJPY-M5-194,GBPJPYMT4,224,2h 29m,Buy
5987.07,1.6343,10.08.2007 10:15:00,,0.0,-98.36999999999534,0.0,0.0,1.63652,10.08.2007 01:30:00,690,-0.1023776339058189,-63.26,IS,0.34,0.0,Phase3-EA-S4v1-EURCHF-M15-221,EURCHFMT4,210,8h 45m,Buy
6127.79,237.57,10.08.2007 13:59:58,tp 237.570,-0.44,-0.0,0.0,0.0,239.42,09.08.2007 21:30:00,691,-0.0,140.72,IS,0.09,0.0,Phase3-EA-B1v1-GBPJPY-M30-1,GBPJPYMT4,98,16h 29m,Sell
6076.47,237.97,10.08.2007 16:29:58,sl 237.970,0.0,-51.320000000006985,0.0,0.0,237.3,10.08.2007 14:00:00,692,-0.05338726709519375,-51.32,IS,0.09,0.0,Phase3-EA-B1v1-GBPJPY-M30-1,GBPJPYMT4,100,2h 29m,Sell
5887.61,118.66,10.08.2007 19:29:58,sl 118.660,0.0,-240.18000000000757,0.0,0.0,117.83,10.08.2007 18:45:00,693,-0.24985490668204002,-188.86,IS,0.27,0.0,Phase3-EA-S1v2-USDJPY-M15-0,USDJPYMT4,242,44m 58s,Sell
5925.27,1.64062,10.08.2007 22:34:58,tp 1.64062,0.0,-202.52000000000407,0.0,0.0,1.63952,10.08.2007 22:10:00,694,-0.2106778903374393,37.66,IS,0.41,0.0,Phase3-EA-SA2v2-EURCHF-M5-43,EURCHFMT4,364,24m 58s,Buy
5961.2,1.6403,13.08.2007 02:29:57,tp 1.64030,-1.71,-166.59000000001106,0.0,0.0,1.6414,10.08.2007 23:45:00,695,-0.17330056167941751,35.93,IS,0.41,0.0,Phase3-EA-SA2v2-EURCHF-M5-43,EURCHFMT4,366,2d 2h 44m,Sell
6009.63,1.1975,13.08.2007 03:14:59,tp 1.19750,0.0,-118.16000000001804,0.0,0.0,1.1985,13.08.2007 01:00:00,696,-0.12291970927451673,48.43,IS,0.58,0.0,Phase3-EA-SA2v2-USDCHF-M15-107,USDCHFMT4,202,2h 14m,Sell
6017.02,239.37,13.08.2007 06:45:00,,0.0,-110.77000000001863,0.0,0.0,239332,13.08.2007 01:20:00,697,-0.11523202603536246,7.39,IS,0.23,0.0,Phase3-EA-S4v1-GBPJPY-M5-194,GBPJPYMT4,226,5h 25m,Buy
6130.42,1.6385,13.08.2007 11:29:58,tp 1.63850,0.0,-0.0,0.0,0.0,1.6425,13.08.2007 05:00:00,698,-0.0,113.4,IS,0.34,0.0,Phase3-EA-S4v1-EURCHF-M15-221,EURCHFMT4,212,6h 29m,Sell
6116.27,118.29,13.08.2007 20:15:00,,0.0,-14.14999999999418,0.0,0.0,118352,13.08.2007 20:00:00,699,-0.014719586162209811,-14.15,IS,0.27,0.0,Phase3-EA-S1v2-USDJPY-M15-0,USDJPYMT4,244,15m 0s,Buy
6047.83,1.2034,14.08.2007 06:30:00,,0.0,-82.58999999999651,0.0,0.0,1.20482,14.08.2007 02:15:00,700,-0.08591453152914184,-68.44,IS,0.58,0.0,Phase3-EA-SA2v2-USDCHF-M15-107,USDCHFMT4,204,4h 15m,Buy
5957.76,1639,14.08.2007 06:30:00,,-0.82,-172.6600000000035,0.0,0.0,1.64162,13.08.2007 22:10:00,701,-0.17961015878220798,-90.07,IS,0.41,0.0,Phase3-EA-SA2v2-EURCHF-M5-43,EURCHFMT4,368,8h 20m,Buy
5906.64,237.06,14.08.2007 08:55:00,,0.0,-223.77999999999884,0.0,0.0,237322,14.08.2007 03:30:00,702,-0.23278791458520492,-51.12,IS,0.23,0.0,Phase3-EA-S4v1-GBPJPY-M5-194,GBPJPYMT4,228,5h 25m,Buy
5855.29,1.6389,14.08.2007 10:00:00,,0.0,-275.13000000000466,0.0,0.0,1.64072,14.08.2007 01:15:00,703,-0.2862049286791887,-51.35,IS,0.34,0.0,Phase3-EA-S4v1-EURCHF-M15-221,EURCHFMT4,214,8h 45m,Buy
5774.02,117.9,14.08.2007 10:30:00,,-0.66,-356.40000000000873,0.0,0.0,118252,13.08.2007 20:30:00,704,-0.37074632566882426,-81.27,IS,0.27,0.0,Phase3-EA-S1v2-USDJPY-M15-0,USDJPYMT4,246,14h 0m,Buy
5582.61,117492,15.08.2007 01:29:58,sl 117.492,-0.67,-547.8100000000122,0.0,0.0,118322,14.08.2007 17:00:00,705,-0.5698612364327671,-191.41,IS,0.27,0.0,Phase3-EA-S1v2-USDJPY-M15-0,USDJPYMT4,248,8h 29m,Buy
5425.83,233912,15.08.2007 03:54:57,sl 233.912,0.0,-704.5900000000111,0.0,0.0,234712,15.08.2007 00:10:00,706,-0.7329521706032396,-156.78,IS,0.23,0.0,Phase3-EA-S4v1-GBPJPY-M5-194,GBPJPYMT4,230,3h 44m,Buy
5380.35,1.6385,15.08.2007 05:35:00,,-0.81,-750.070000000007,0.0,0.0,1.63982,14.08.2007 21:15:00,707,-0.7802628970101313,-45.48,IS,0.41,0.0,Phase3-EA-SA2v2-EURCHF-M5-43,EURCHFMT4,370,8h 20m,Buy
5521.82,233.12,15.08.2007 07:29:58,tp 233.120,-0.44,-608.6000000000058,0.0,0.0,234.97,14.08.2007 23:30:00,708,-0.6330982429911423,141.47,IS,0.09,0.0,Phase3-EA-B1v1-GBPJPY-M30-1,GBPJPYMT4,102,7h 59m,Sell
5412.49,1.63442,15.08.2007 09:29:57,sl 1.63442,0.0,-717.9300000000076,0.0,0.0,1.63832,15.08.2007 02:00:00,709,-0.7468291514798409,-109.33,IS,0.34,0.0,Phase3-EA-S4v1-EURCHF-M15-221,EURCHFMT4,216,7h 29m,Buy
5252.5,231662,16.08.2007 00:09:57,sl 231.662,-2.13,-877.9200000000128,0.0,0.0,232462,15.08.2007 23:05:00,710,-0.9132592991895931,-159.99,IS,0.23,0.0,Phase3-EA-S4v1-GBPJPY-M5-194,GBPJPYMT4,232,1h 4m,Buy
5057.93,116382,16.08.2007 00:44:58,sl 116.382,-2.01,-1072.4900000000198,0.0,0.0,117212,15.08.2007 21:45:00,711,-1.1156614108208613,-194.57,IS,0.27,0.0,Phase3-EA-S1v2-USDJPY-M15-0,USDJPYMT4,250,2h 59m,Buy
4890.81,1.63552,16.08.2007 05:44:58,sl 1.63552,-2.42,-1239.6100000000151,0.0,0.0,1.64042,15.08.2007 22:05:00,712,-1.2895085655508576,-167.12,IS,0.41,0.0,Phase3-EA-SA2v2-EURCHF-M5-43,EURCHFMT4,372,7h 39m,Buy
4838.77,231.1,16.08.2007 07:59:57,sl 231.100,0.0,-1291.6500000000087,0.0,0.0,230.43,16.08.2007 06:30:00,713,-1.3436433545177564,-52.04,IS,0.09,0.0,Phase3-EA-B1v1-GBPJPY-M30-1,GBPJPYMT4,104,1h 29m,Sell
4729.73,1.63292,16.08.2007 10:14:58,sl 1.63292,0.0,-1400.6900000000023,0.0,0.0,1.63682,16.08.2007 02:30:00,714,-1.4570725895091292,-109.04,IS,0.34,0.0,Phase3-EA-S4v1-EURCHF-M15-221,EURCHFMT4,218,7h 44m,Buy
4874.45,227.42,16.08.2007 13:59:58,tp 227.420,0.0,-1255.9700000000012,0.0,0.0,229.27,16.08.2007 13:00:00,715,-1.306527111813306,144.72,IS,0.09,0.0,Phase3-EA-B1v1-GBPJPY-M30-1,GBPJPYMT4,106,59m 58s,Sell
5021.25,222.82,16.08.2007 19:59:58,tp 222.820,0.0,-1109.1699999999983,0.0,0.0,224.67,16.08.2007 19:30:00,716,-1.1538179069643073,146.8,IS,0.09,0.0,Phase3-EA-B1v1-GBPJPY-M30-1,GBPJPYMT4,108,29m 58s,Sell
5058.42,1.62712,16.08.2007 20:04:58,tp 1.62712,0.0,-1072.0,0.0,0.0,1.62602,16.08.2007 20:00:00,717,-1.115151686635718,37.17,IS,0.41,0.0,Phase3-EA-SA2v2-EURCHF-M5-43,EURCHFMT4,374,4m 58s,Buy
4897.0,226.82,16.08.2007 23:14:58,sl 226.820,0.0,-1233.4199999999983,0.0,0.0,226.02,16.08.2007 23:10:00,718,-1.2830693967632698,-161.42,IS,0.23,0.0,Phase3-EA-S4v1-GBPJPY-M5-194,GBPJPYMT4,234,4m 58s,Sell
4932.41,1.6322,17.08.2007 00:24:57,tp 1.63220,-1.69,-1198.0099999999948,0.0,0.0,1.6333,16.08.2007 23:25:00,719,-1.2462340224873607,35.41,IS,0.41,0.0,Phase3-EA-SA2v2-EURCHF-M5-43,EURCHFMT4,376,59m 57s,Sell
5026.54,113.45,17.08.2007 02:14:58,tp 113.450,-1.07,-1103.87999999999,0.0,0.0,113.85,16.08.2007 23:00:00,720,-1.148314966271852,94.13,IS,0.27,0.0,Phase3-EA-S1v2-USDJPY-M15-0,USDJPYMT4,252,3h 14m,Sell
5063.58,1.6329,17.08.2007 02:19:57,tp 1.63290,0.0,-1066.8399999999965,0.0,0.0,1634,17.08.2007 00:45:00,721,-1.109783978890341,37.04,IS,0.41,0.0,Phase3-EA-SA2v2-EURCHF-M5-43,EURCHFMT4,378,1h 34m,Sell
5142.49,225712,17.08.2007 02:49:59,tp 225.712,0.0,-987.929999999993,0.0,0.0,225322,17.08.2007 02:25:00,722,-1.0276975800168069,78.91,IS,0.23,0.0,Phase3-EA-S4v1-GBPJPY-M5-194,GBPJPYMT4,236,24m 59s,Buy
5254.5,1.6302,17.08.2007 07:29:58,tp 1.63020,0.0,-875.9199999999983,0.0,0.0,1.6342,17.08.2007 01:30:00,723,-0.9111787923115263,112.01,IS,0.34,0.0,Phase3-EA-S4v1-EURCHF-M15-221,EURCHFMT4,220,5h 59m,Sell
5402.57,219.74,17.08.2007 10:29:57,tp 219.740,0.0,-727.8499999999913,0.0,0.0,221.59,17.08.2007 10:00:00,724,-0.7571484655949604,148.07,IS,0.09,0.0,Phase3-EA-B1v1-GBPJPY-M30-1,GBPJPYMT4,110,29m 57s,Sell
5497.3,114012,17.08.2007 19:14:59,tp 114.012,0.0,-633.1199999999953,0.0,0.0,113612,17.08.2007 17:45:00,725,-0.6586052573160454,94.73,IS,0.27,0.0,Phase3-EA-S1v2-USDJPY-M15-0,USDJPYMT4,254,1h 29m,Buy
5534.69,1.6281,17.08.2007 20:29:57,tp 1.62810,0.0,-595.7299999999959,0.0,0.0,1.6292,17.08.2007 20:20:00,726,-0.6197101812308692,37.39,IS,0.41,0.0,Phase3-EA-SA2v2-EURCHF-M5-43,EURCHFMT4,380,9m 57s,Sell
5629.09,114412,17.08.2007 22:14:59,tp 114.412,0.0,-501.33000000000175,0.0,0.0,114012,17.08.2007 21:15:00,727,-0.5215102565868344,94.4,IS,0.27,0.0,Phase3-EA-S1v2-USDJPY-M15-0,USDJPYMT4,256,59m 59s,Buy
5707.59,226162,20.08.2007 03:14:57,tp 226.162,0.0,-422.83000000000175,0.0,0.0,225772,20.08.2007 02:10:00,728,-0.43985036162330465,78.5,IS,0.23,0.0,Phase3-EA-S4v1-GBPJPY-M5-194,GBPJPYMT4,238,1h 4m,Buy
5744.96,1.62772,20.08.2007 03:29:57,tp 1.62772,0.0,-385.4600000000064,0.0,0.0,1.62662,20.08.2007 02:35:00,729,-0.40097609060691325,37.37,IS,0.41,0.0,Phase3-EA-SA2v2-EURCHF-M5-43,EURCHFMT4,382,54m 57s,Buy
5857.57,1.63052,20.08.2007 10:59:57,tp 1.63052,0.0,-272.8500000000058,0.0,0.0,1.62652,20.08.2007 06:00:00,730,-0.283833150838211,112.61,IS,0.34,0.0,Phase3-EA-S4v1-EURCHF-M15-221,EURCHFMT4,222,4h 59m,Buy
5894.98,1.6241,20.08.2007 23:49:57,tp 1.62410,0.0,-235.44000000000233,0.0,0.0,1.6252,20.08.2007 21:45:00,731,-0.24491726968425004,37.41,IS,0.41,0.0,Phase3-EA-SA2v2-EURCHF-M5-43,EURCHFMT4,384,2h 4m,Sell
5942.48,1.20632,21.08.2007 01:29:58,tp 1.20632,-0.58,-187.94000000000233,0.0,0.0,1.20532,20.08.2007 23:15:00,732,-0.19550523133052186,47.5,IS,0.58,0.0,Phase3-EA-SA2v2-USDCHF-M15-107,USDCHFMT4,206,2h 14m,Buy
6020.59,228.27,21.08.2007 02:09:57,tp 228.270,0.0,-109.83000000000175,0.0,0.0,228.66,21.08.2007 01:45:00,733,-0.11425103520821162,78.11,IS,0.23,0.0,Phase3-EA-S4v1-GBPJPY-M5-194,GBPJPYMT4,240,24m 57s,Sell
6009.65,114802,21.08.2007 03:30:00,,-1.06,-120.77000000000407,0.0,0.0,114.76,20.08.2007 21:30:00,734,-0.12563140783115692,-10.94,IS,0.27,0.0,Phase3-EA-S1v2-USDJPY-M15-0,USDJPYMT4,258,6h 0m,Sell
5955.43,1.6223,21.08.2007 12:45:00,,0.0,-174.99000000000524,0.0,0.0,1.62422,21.08.2007 04:00:00,735,-0.18203394929514005,-54.22,IS,0.34,0.0,Phase3-EA-S4v1-EURCHF-M15-221,EURCHFMT4,224,8h 45m,Buy
5971.5,114282,21.08.2007 21:30:00,,0.0,-158.91999999999825,0.0,0.0,114.35,21.08.2007 21:15:00,736,-0.16531707652998728,16.07,IS,0.27,0.0,Phase3-EA-S1v2-USDJPY-M15-0,USDJPYMT4,260,15m 0s,Sell
6008.88,1.6243,21.08.2007 23:30:00,tp 1.62430,0.0,-121.5399999999936,0.0,0.0,1.6254,21.08.2007 23:15:00,737,-0.12643240297919592,37.38,IS,0.41,0.0,Phase3-EA-SA2v2-EURCHF-M5-43,EURCHFMT4,386,15m 0s,Sell
6047.53,114232,22.08.2007 01:00:00,,-1.06,-82.88999999999942,0.0,0.0,114.4,21.08.2007 22:00:00,738,-0.08622660756085263,38.65,IS,0.27,0.0,Phase3-EA-S1v2-USDJPY-M15-0,USDJPYMT4,262,3h 0m,Sell
6126.03,226542,22.08.2007 02:39:58,tp 226.542,0.0,-4.389999999999418,0.0,0.0,226152,22.08.2007 01:40:00,739,-0.0045667125973229035,78.5,IS,0.23,0.0,Phase3-EA-S4v1-GBPJPY-M5-194,GBPJPYMT4,242,59m 58s,Buy
6073.59,228432,22.08.2007 17:59:57,sl 228.432,0.0,-56.830000000001746,0.0,0.0,229102,22.08.2007 17:00:00,740,-0.05911760293984123,-52.44,IS,0.09,0.0,Phase3-EA-B1v1-GBPJPY-M30-1,GBPJPYMT4,112,59m 57s,Buy
5914.68,230.85,23.08.2007 02:09:58,sl 230.850,0.0,-215.74000000000524,0.0,0.0,230.05,23.08.2007 01:10:00,741,-0.2244242769354437,-158.91,IS,0.23,0.0,Phase3-EA-S4v1-GBPJPY-M5-194,GBPJPYMT4,244,59m 58s,Sell
5992.13,230.76,23.08.2007 02:44:58,tp 230.760,0.0,-138.29000000000815,0.0,0.0,231.15,23.08.2007 02:25:00,742,-0.14385664808289414,77.45,IS,0.23,0.0,Phase3-EA-S4v1-GBPJPY-M5-194,GBPJPYMT4,246,19m 58s,Sell
6134.92,231502,23.08.2007 03:59:58,tp 231.502,-0.84,-0.0,0.0,0.0,229652,22.08.2007 23:30:00,743,-0.0,142.79,IS,0.09,0.0,Phase3-EA-B1v1-GBPJPY-M30-1,GBPJPYMT4,114,4h 29m,Buy
6074.75,1.63482,23.08.2007 06:30:00,,-5.1,-60.169999999998254,0.0,0.0,1.6332,22.08.2007 22:10:00,744,-0.06258911954157578,-60.17,IS,0.41,0.0,Phase3-EA-SA2v2-EURCHF-M5-43,EURCHFMT4,388,8h 20m,Sell
6048.85,1.63532,23.08.2007 10:45:00,,0.0,-86.06999999999243,0.0,0.0,1.6344,23.08.2007 02:00:00,745,-0.0895304224521042,-25.9,IS,0.34,0.0,Phase3-EA-S4v1-EURCHF-M15-221,EURCHFMT4,226,8h 45m,Sell
6191.58,234522,23.08.2007 13:29:58,tp 234.522,0.0,-0.0,0.0,0.0,232672,23.08.2007 12:30:00,746,-0.0,142.73,IS,0.09,0.0,Phase3-EA-B1v1-GBPJPY-M30-1,GBPJPYMT4,116,59m 58s,Buy
6228.99,1.63532,23.08.2007 21:34:57,tp 1.63532,0.0,-0.0,0.0,0.0,1.63422,23.08.2007 20:05:00,747,-0.0,37.41,IS,0.41,0.0,Phase3-EA-SA2v2-EURCHF-M5-43,EURCHFMT4,390,1h 29m,Buy
6226.2,116.22,23.08.2007 23:30:00,,0.0,-2.789999999993597,0.0,0.0,116232,23.08.2007 17:00:00,748,-0.0028993341819275003,-2.79,IS,0.27,0.0,Phase3-EA-S1v2-USDJPY-M15-0,USDJPYMT4,264,6h 30m,Buy
6318.4,115.82,24.08.2007 02:29:57,tp 115.820,-1.05,-0.0,0.0,0.0,116.22,23.08.2007 23:30:00,749,-0.0,92.2,IS,0.27,0.0,Phase3-EA-S1v2-USDJPY-M15-0,USDJPYMT4,266,2h 59m,Sell
6395.67,232812,24.08.2007 03:09:58,tp 232.812,0.0,-0.0,0.0,0.0,232422,24.08.2007 01:55:00,750,-0.0,77.27,IS,0.23,0.0,Phase3-EA-S4v1-GBPJPY-M5-194,GBPJPYMT4,248,1h 14m,Buy
6366.09,1.63682,24.08.2007 06:30:00,,-1.7,-29.580000000001746,0.0,0.0,1636,23.08.2007 22:10:00,751,-0.030686025627501456,-29.58,IS,0.41,0.0,Phase3-EA-SA2v2-EURCHF-M5-43,EURCHFMT4,392,8h 20m,Sell
6401.95,1.6416,27.08.2007 01:00:00,tp 1.64160,-1.71,-0.0,0.0,0.0,1.6427,24.08.2007 22:10:00,752,-0.0,35.86,IS,0.41,0.0,Phase3-EA-SA2v2-EURCHF-M5-43,EURCHFMT4,394,2d 2h 50m,Sell
6243.04,234.98,27.08.2007 01:44:57,sl 234.980,-1.15,-158.9100000000035,0.0,0.0,234.18,24.08.2007 23:05:00,753,-0.1648410638996446,-158.91,IS,0.23,0.0,Phase3-EA-S4v1-GBPJPY-M5-194,GBPJPYMT4,250,2d 2h 39m,Sell
6506.58,2.01522,27.08.2007 02:29:57,tp 2.01522,-1.06,-0.0,0.0,0.0,1.99632,23.08.2007 09:00:00,754,-0.0,263.54,IS,0.14,0.0,Phase3-EA-B1v1-GBPUSD-M30-14,GBPUSDMT4,50,3d 17h 29m,Buy
6583.69,234.59,27.08.2007 04:44:57,tp 234.590,0.0,-0.0,0.0,0.0,234.98,27.08.2007 01:50:00,755,-0.0,77.11,IS,0.23,0.0,Phase3-EA-S4v1-GBPJPY-M5-194,GBPJPYMT4,252,2h 54m,Sell
6541.69,2.01242,27.08.2007 19:29:57,sl 2.01242,0.0,-42.0,0.0,0.0,2.01542,27.08.2007 08:30:00,756,-0.04348560300398544,-42.0,IS,0.14,0.0,Phase3-EA-B1v1-GBPUSD-M30-14,GBPUSDMT4,52,10h 59m,Buy
6579.19,1.6417,27.08.2007 23:04:58,tp 1.64170,0.0,-4.5,0.0,0.0,1.6428,27.08.2007 21:20:00,757,-0.0046591717504270115,37.5,IS,0.41,0.0,Phase3-EA-SA2v2-EURCHF-M5-43,EURCHFMT4,396,1h 44m,Sell
6618.31,115952,27.08.2007 23:15:00,,0.0,-0.0,0.0,0.0,116.12,27.08.2007 21:15:00,758,-0.0,39.12,IS,0.27,0.0,Phase3-EA-S1v2-USDJPY-M15-0,USDJPYMT4,268,2h 0m,Sell
6458.43,232362,28.08.2007 01:34:57,sl 232.362,-0.71,-159.88000000000466,0.0,0.0,233162,27.08.2007 23:45:00,759,-0.16547588133140045,-159.88,IS,0.23,0.0,Phase3-EA-S4v1-GBPJPY-M5-194,GBPJPYMT4,254,1h 49m,Buy
6535.94,232512,28.08.2007 04:44:57,tp 232.512,0.0,-82.3700000000099,0.0,0.0,232122,28.08.2007 01:55:00,760,-0.08525299190185573,77.51,IS,0.23,0.0,Phase3-EA-S4v1-GBPJPY-M5-194,GBPJPYMT4,256,2h 49m,Buy
6539.8,1.2023,28.08.2007 06:00:00,,0.0,-78.51000000000931,0.0,0.0,1.20222,28.08.2007 01:45:00,761,-0.08125788993826252,3.86,IS,0.58,0.0,Phase3-EA-SA2v2-USDCHF-M15-107,USDCHFMT4,208,4h 15m,Buy
6446.23,1.6387,28.08.2007 08:05:00,,-0.82,-172.0800000000163,0.0,0.0,1.64142,27.08.2007 23:45:00,762,-0.17810288753758605,-93.57,IS,0.41,0.0,Phase3-EA-SA2v2-EURCHF-M5-43,EURCHFMT4,398,8h 20m,Buy
6406.11,1.6395,28.08.2007 10:00:00,,0.0,-212.20000000001164,0.0,0.0,1.64092,28.08.2007 01:15:00,763,-0.21962710794673554,-40.12,IS,0.34,0.0,Phase3-EA-S4v1-EURCHF-M15-221,EURCHFMT4,228,8h 45m,Buy
6353.92,232.05,28.08.2007 11:59:58,sl 232.050,0.0,-264.39000000001397,0.0,0.0,231.38,28.08.2007 07:30:00,764,-0.27364378449593446,-52.19,IS,0.09,0.0,Phase3-EA-B1v1-GBPJPY-M30-1,GBPJPYMT4,118,4h 29m,Sell
6499.27,229.27,28.08.2007 22:59:58,tp 229.270,0.0,-119.04000000000815,0.0,0.0,231.12,28.08.2007 16:30:00,765,-0.12320646055598376,145.35,IS,0.09,0.0,Phase3-EA-B1v1-GBPJPY-M30-1,GBPJPYMT4,120,6h 29m,Sell
6375.01,1632,29.08.2007 06:25:00,,-0.82,-243.3000000000029,0.0,0.0,1.63562,28.08.2007 22:05:00,766,-0.25181562376738204,-124.26,IS,0.41,0.0,Phase3-EA-SA2v2-EURCHF-M5-43,EURCHFMT4,400,8h 20m,Buy
6453.62,228302,29.08.2007 06:54:58,tp 228.302,0.0,-164.69000000000233,0.0,0.0,227912,29.08.2007 02:55:00,767,-0.17045423377825825,78.61,IS,0.23,0.0,Phase3-EA-S4v1-GBPJPY-M5-194,GBPJPYMT4,258,3h 59m,Buy
6400.74,228.42,29.08.2007 06:59:58,sl 228.420,0.0,-217.57000000000698,0.0,0.0,227.75,29.08.2007 03:00:00,768,-0.22518506067846447,-52.88,IS,0.09,0.0,Phase3-EA-B1v1-GBPJPY-M30-1,GBPJPYMT4,122,3h 59m,Sell
6411.49,1.6337,29.08.2007 09:45:00,,0.0,-206.82000000000698,0.0,0.0,1.63332,29.08.2007 01:00:00,769,-0.2140588052099099,10.75,IS,0.34,0.0,Phase3-EA-S4v1-EURCHF-M15-221,EURCHFMT4,230,8h 45m,Buy
6488.46,115.06,29.08.2007 18:00:00,,0.0,-129.85000000000582,0.0,0.0,114732,29.08.2007 17:15:00,770,-0.13439481605505807,76.97,IS,0.27,0.0,Phase3-EA-S1v2-USDJPY-M15-0,USDJPYMT4,270,45m 0s,Buy
6562.34,233.88,30.08.2007 01:24:57,tp 233.880,-3.45,-55.970000000001164,0.0,0.0,234.27,29.08.2007 23:05:00,771,-0.057928978472094106,73.88,IS,0.23,0.0,Phase3-EA-S4v1-GBPJPY-M5-194,GBPJPYMT4,260,2h 19m,Sell
6403.35,232942,30.08.2007 03:24:58,sl 232.942,0.0,-214.9600000000064,0.0,0.0,233742,30.08.2007 01:40:00,772,-0.2224837093507497,-158.99,IS,0.23,0.0,Phase3-EA-S4v1-GBPJPY-M5-194,GBPJPYMT4,262,1h 44m,Buy
6390.71,1.63972,30.08.2007 06:00:00,,-5.13,-227.60000000000582,0.0,0.0,1.6395,29.08.2007 21:40:00,773,-0.23556611578075184,-12.64,IS,0.41,0.0,Phase3-EA-SA2v2-EURCHF-M5-43,EURCHFMT4,402,8h 20m,Sell
6441.47,115.96,30.08.2007 23:45:00,,0.0,-176.84000000001106,0.0,0.0,115742,30.08.2007 21:30:00,774,-0.1830294899590057,50.76,IS,0.27,0.0,Phase3-EA-S1v2-USDJPY-M15-0,USDJPYMT4,272,2h 15m,Buy
6405.0,1.64232,31.08.2007 08:05:00,,-1.7,-213.31000000001222,0.0,0.0,1.6413,30.08.2007 23:45:00,775,-0.2207759585113962,-36.47,IS,0.41,0.0,Phase3-EA-SA2v2-EURCHF-M5-43,EURCHFMT4,404,8h 20m,Sell
6294.82,1.6468,31.08.2007 09:59:58,sl 1.64680,0.0,-323.49000000000524,0.0,0.0,1.6429,31.08.2007 03:30:00,776,-0.3348123145602579,-110.18,IS,0.34,0.0,Phase3-EA-S4v1-EURCHF-M15-221,EURCHFMT4,232,6h 29m,Sell
6252.82,2.01182,31.08.2007 17:29:57,sl 2.01182,0.0,-365.49000000000524,0.0,0.0,2.01482,31.08.2007 05:00:00,777,-0.3782823359257734,-42.0,IS,0.14,0.0,Phase3-EA-B1v1-GBPUSD-M30-14,GBPUSDMT4,54,12h 29m,Buy
6290.16,1.64662,31.08.2007 22:34:58,tp 1.64662,0.0,-328.15000000000873,0.0,0.0,1.64552,31.08.2007 21:40:00,778,-0.33963541693081634,37.34,IS,0.41,0.0,Phase3-EA-SA2v2-EURCHF-M5-43,EURCHFMT4,406,54m 58s,Buy
6325.8,1.6461,03.09.2007 01:05:00,tp 1.64610,-1.7,-292.5100000000093,0.0,0.0,1.6472,31.08.2007 22:50:00,779,-0.30274799880065095,35.64,IS,0.41,0.0,Phase3-EA-SA2v2-EURCHF-M5-43,EURCHFMT4,408,2d 2h 15m,Sell
6349.93,115822,03.09.2007 03:00:00,,-1.05,-268.38000000000466,0.0,0.0,115.93,31.08.2007 22:45:00,780,-0.2777734365256488,24.13,IS,0.27,0.0,Phase3-EA-S1v2-USDJPY-M15-0,USDJPYMT4,274,2d 4h 15m,Sell
6427.41,233512,03.09.2007 04:49:57,tp 233.512,0.0,-190.90000000000873,0.0,0.0,233122,03.09.2007 03:15:00,781,-0.19758159711136394,77.48,IS,0.23,0.0,Phase3-EA-S4v1-GBPJPY-M5-194,GBPJPYMT4,264,1h 34m,Buy
6505.7,1.6478,03.09.2007 12:15:00,,0.0,-112.61000000001513,0.0,0.0,1.64502,03.09.2007 03:30:00,782,-0.11655140728503231,78.29,IS,0.34,0.0,Phase3-EA-S4v1-EURCHF-M15-221,EURCHFMT4,234,8h 45m,Buy
6543.0,1.6459,03.09.2007 23:39:58,tp 1.64590,0.0,-75.31000000001222,0.0,0.0,1647,03.09.2007 20:10:00,783,-0.07794588831041672,37.3,IS,0.41,0.0,Phase3-EA-SA2v2-EURCHF-M5-43,EURCHFMT4,410,3h 29m,Sell
6591.0,1.2084,04.09.2007 03:14:58,tp 1.20840,0.0,-27.310000000012224,0.0,0.0,1.2094,04.09.2007 02:15:00,784,-0.028265863892684744,48.0,IS,0.58,0.0,Phase3-EA-SA2v2-USDCHF-M15-107,USDCHFMT4,210,59m 58s,Sell
6576.38,1.6453,04.09.2007 13:00:00,,0.0,-41.93000000000757,0.0,0.0,1.64582,04.09.2007 04:15:00,785,-0.04339757132991413,-14.62,IS,0.34,0.0,Phase3-EA-S4v1-EURCHF-M15-221,EURCHFMT4,236,8h 45m,Buy
6613.62,1.6483,04.09.2007 22:54:59,tp 1.64830,0.0,-4.690000000002328,0.0,0.0,1.6494,04.09.2007 22:15:00,786,-0.004854152385818306,37.24,IS,0.41,0.0,Phase3-EA-SA2v2-EURCHF-M5-43,EURCHFMT4,412,39m 59s,Sell
6631.73,116.31,04.09.2007 23:15:00,,0.0,-0.0,0.0,0.0,116232,04.09.2007 23:00:00,787,-0.0,18.11,IS,0.27,0.0,Phase3-EA-S1v2-USDJPY-M15-0,USDJPYMT4,276,15m 0s,Buy
6708.92,234.29,05.09.2007 03:19:58,tp 234.290,0.0,-0.0,0.0,0.0,234.68,05.09.2007 02:50:00,788,-0.0,77.19,IS,0.23,0.0,Phase3-EA-S4v1-GBPJPY-M5-194,GBPJPYMT4,266,29m 58s,Sell
6688.78,1.2098,05.09.2007 06:00:00,,0.0,-20.139999999999418,0.0,0.0,1.21022,05.09.2007 01:45:00,789,-0.020825379913248347,-20.14,IS,0.58,0.0,Phase3-EA-SA2v2-USDCHF-M15-107,USDCHFMT4,212,4h 15m,Buy
6637.74,1.6462,05.09.2007 10:30:00,,0.0,-71.17999999999302,0.0,0.0,1.64802,05.09.2007 01:45:00,790,-0.07360231093470282,-51.04,IS,0.34,0.0,Phase3-EA-S4v1-EURCHF-M15-221,EURCHFMT4,238,8h 45m,Buy
6666.96,115062,06.09.2007 00:45:00,,-3.16,-41.95999999999185,0.0,0.0,115.2,05.09.2007 23:00:00,791,-0.04338793153722722,29.22,IS,0.27,0.0,Phase3-EA-S1v2-USDJPY-M15-0,USDJPYMT4,278,1h 45m,Sell
6506.81,231882,06.09.2007 02:59:57,sl 231.882,0.0,-202.10999999998603,0.0,0.0,232682,06.09.2007 00:20:00,792,-0.20898796098641778,-160.15,IS,0.23,0.0,Phase3-EA-S4v1-GBPJPY-M5-194,GBPJPYMT4,268,2h 39m,Buy
6554.96,1.20452,06.09.2007 03:29:57,tp 1.20452,0.0,-153.95999999999185,0.0,0.0,1.20352,06.09.2007 02:45:00,793,-0.15919937891974373,48.15,IS,0.58,0.0,Phase3-EA-SA2v2-USDCHF-M15-107,USDCHFMT4,214,44m 57s,Buy
6592.4,1.64412,06.09.2007 05:09:58,tp 1.64412,0.0,-116.51999999998952,0.0,0.0,1.64302,06.09.2007 02:40:00,794,-0.12048526650901437,37.44,IS,0.41,0.0,Phase3-EA-SA2v2-EURCHF-M5-43,EURCHFMT4,414,2h 29m,Buy
6622.92,1.64332,06.09.2007 14:15:00,,0.0,-85.99999999998545,0.0,0.0,1.6444,06.09.2007 05:30:00,795,-0.08892664709727441,30.52,IS,0.34,0.0,Phase3-EA-S4v1-EURCHF-M15-221,EURCHFMT4,240,8h 45m,Sell
6617.77,115.31,06.09.2007 21:30:00,,0.0,-91.14999999997963,0.0,0.0,115332,06.09.2007 21:15:00,796,-0.09425190561530375,-5.15,IS,0.27,0.0,Phase3-EA-S1v2-USDJPY-M15-0,USDJPYMT4,280,15m 0s,Buy
6629.01,115.34,06.09.2007 23:30:00,,0.0,-79.90999999997439,0.0,0.0,115292,06.09.2007 22:00:00,797,-0.08262939964583864,11.24,IS,0.27,0.0,Phase3-EA-S1v2-USDJPY-M15-0,USDJPYMT4,282,1h 30m,Buy
6617.81,1201,07.09.2007 02:45:00,,-0.58,-91.10999999997148,0.0,0.0,1.20122,06.09.2007 22:30:00,798,-0.09421054438408727,-11.2,IS,0.58,0.0,Phase3-EA-SA2v2-USDCHF-M15-107,USDCHFMT4,216,4h 15m,Buy
6533.48,232.56,07.09.2007 09:15:00,,0.0,-175.43999999997322,0.0,0.0,232982,07.09.2007 03:50:00,799,-0.1814103600784428,-84.33,IS,0.23,0.0,Phase3-EA-S4v1-GBPJPY-M5-194,GBPJPYMT4,270,5h 25m,Buy
6544.24,1644,07.09.2007 14:45:00,,0.0,-164.67999999997846,0.0,0.0,1.64362,07.09.2007 06:00:00,800,-0.170284188883485,10.76,IS,0.34,0.0,Phase3-EA-S4v1-EURCHF-M15-221,EURCHFMT4,242,8h 45m,Buy
6638.77,112.97,10.09.2007 01:00:00,tp 112.970,-1.07,-70.14999999997963,0.0,0.0,113.37,07.09.2007 23:00:00,801,-0.0725372592310819,94.53,IS,0.27,0.0,Phase3-EA-S1v2-USDJPY-M15-0,USDJPYMT4,284,2d 2h 0m,Sell
6675.0,1.6354,10.09.2007 01:00:00,tp 1.63540,-1.72,-33.9199999999837,0.0,0.0,1.6365,07.09.2007 23:10:00,802,-0.03507432406440243,36.23,IS,0.41,0.0,Phase3-EA-SA2v2-EURCHF-M5-43,EURCHFMT4,416,2d 1h 50m,Sell
6705.66,112732,10.09.2007 01:15:00,,0.0,-3.2599999999802094,0.0,0.0,112862,10.09.2007 01:00:00,803,-0.003370940343434927,30.66,IS,0.27,0.0,Phase3-EA-S1v2-USDJPY-M15-0,USDJPYMT4,286,15m 0s,Buy
6785.15,228972,10.09.2007 02:39:58,tp 228.972,0.0,-0.0,0.0,0.0,228582,10.09.2007 01:15:00,804,-0.0,79.49,IS,0.23,0.0,Phase3-EA-S4v1-GBPJPY-M5-194,GBPJPYMT4,272,1h 24m,Buy
6823.17,1.63522,10.09.2007 03:14:57,tp 1.63522,0.0,-0.0,0.0,0.0,1.63412,10.09.2007 01:25:00,805,-0.0,38.02,IS,0.41,0.0,Phase3-EA-SA2v2-EURCHF-M5-43,EURCHFMT4,418,1h 49m,Buy
6723.84,1.1866,10.09.2007 03:15:00,,-0.59,-99.33000000000175,0.0,0.0,1.18862,07.09.2007 23:00:00,806,-0.10258908069215425,-99.33,IS,0.58,0.0,Phase3-EA-SA2v2-USDCHF-M15-107,USDCHFMT4,218,2d 4h 15m,Buy
6806.84,113.21,10.09.2007 07:00:00,,0.0,-16.330000000001746,0.0,0.0,112.86,10.09.2007 01:00:00,807,-0.016865797721766117,83.0,IS,0.27,0.0,Phase3-EA-S1v2-USDJPY-M15-0,USDJPYMT4,287,6h 0m,Sell
6852.14,1.6356,10.09.2007 11:00:00,,0.0,-0.0,0.0,0.0,1.63402,10.09.2007 02:15:00,808,-0.0,45.3,IS,0.34,0.0,Phase3-EA-S4v1-EURCHF-M15-221,EURCHFMT4,244,8h 45m,Buy
6894.41,113.71,10.09.2007 22:15:00,,0.0,-0.0,0.0,0.0,113532,10.09.2007 17:15:00,809,-0.0,42.27,IS,0.27,0.0,Phase3-EA-S1v2-USDJPY-M15-0,USDJPYMT4,290,5h 0m,Buy
6943.28,1.1869,10.09.2007 23:14:57,tp 1.18690,0.0,-0.0,0.0,0.0,1.1879,10.09.2007 22:30:00,810,-0.0,48.87,IS,0.58,0.0,Phase3-EA-SA2v2-USDCHF-M15-107,USDCHFMT4,220,44m 57s,Sell
7022.3,230342,11.09.2007 03:04:59,tp 230.342,0.0,-0.0,0.0,0.0,229952,11.09.2007 02:45:00,811,-0.0,79.02,IS,0.23,0.0,Phase3-EA-S4v1-GBPJPY-M5-194,GBPJPYMT4,274,19m 59s,Buy
6999.16,1.63682,11.09.2007 04:45:00,,-1.73,-23.139999999999418,0.0,0.0,1.6362,10.09.2007 20:25:00,812,-0.023850187018859995,-23.14,IS,0.41,0.0,Phase3-EA-SA2v2-EURCHF-M5-43,EURCHFMT4,420,8h 20m,Sell
7008.19,113.58,11.09.2007 07:00:00,,0.0,-14.110000000000582,0.0,0.0,113542,11.09.2007 01:30:00,813,-0.014543048350740575,9.03,IS,0.27,0.0,Phase3-EA-S1v2-USDJPY-M15-0,USDJPYMT4,292,5h 30m,Buy
6971.29,1.64472,12.09.2007 05:20:00,,-1.72,-51.00999999999476,0.0,0.0,1.6437,11.09.2007 21:00:00,814,-0.05257554191149326,-36.9,IS,0.41,0.0,Phase3-EA-SA2v2-EURCHF-M5-43,EURCHFMT4,422,8h 20m,Sell
6893.15,1.6421,12.09.2007 13:45:00,,0.0,-129.14999999999418,0.0,0.0,1.64482,12.09.2007 05:00:00,815,-0.1331137274626494,-78.14,IS,0.34,0.0,Phase3-EA-S4v1-EURCHF-M15-221,EURCHFMT4,246,8h 45m,Buy
6918.68,114.24,12.09.2007 23:30:00,,0.0,-103.61999999999534,0.0,0.0,114132,12.09.2007 20:45:00,816,-0.10680018923484114,25.53,IS,0.27,0.0,Phase3-EA-S1v2-USDJPY-M15-0,USDJPYMT4,294,2h 45m,Buy
6967.63,1.18492,13.09.2007 02:59:59,tp 1.18492,0.0,-54.669999999998254,0.0,0.0,1.18392,13.09.2007 01:15:00,817,-0.05634787054110057,48.95,IS,0.58,0.0,Phase3-EA-SA2v2-USDCHF-M15-107,USDCHFMT4,222,1h 44m,Buy
7000.5,1.6461,13.09.2007 03:34:57,tp 1.64610,-5.19,-21.80000000000291,0.0,0.0,1.6472,12.09.2007 20:45:00,818,-0.02246906123644038,32.87,IS,0.41,0.0,Phase3-EA-SA2v2-EURCHF-M5-43,EURCHFMT4,424,6h 49m,Sell
7079.05,231.46,13.09.2007 06:34:58,tp 231.460,0.0,-0.0,0.0,0.0,231.85,13.09.2007 03:50:00,819,-0.0,78.55,IS,0.23,0.0,Phase3-EA-S4v1-GBPJPY-M5-194,GBPJPYMT4,276,2h 44m,Sell
7058.36,1.6455,13.09.2007 12:45:00,,0.0,-20.69000000000233,0.0,0.0,1.64622,13.09.2007 04:00:00,820,-0.021312528295242193,-20.69,IS,0.34,0.0,Phase3-EA-S4v1-EURCHF-M15-221,EURCHFMT4,248,8h 45m,Buy
6898.36,232242,13.09.2007 23:09:58,sl 232.242,0.0,-180.69000000000233,0.0,0.0,233042,13.09.2007 23:00:00,821,-0.18612666687612026,-160.0,IS,0.23,0.0,Phase3-EA-S4v1-GBPJPY-M5-194,GBPJPYMT4,278,9m 58s,Buy
6728.0,1.64302,14.09.2007 00:59:57,sl 1.64302,-0.83,-351.0500000000029,0.0,0.0,1.64792,13.09.2007 21:55:00,822,-0.36161252093011076,-170.36,IS,0.41,0.0,Phase3-EA-SA2v2-EURCHF-M5-43,EURCHFMT4,426,3h 4m,Buy
6766.07,1.64422,14.09.2007 02:09:57,tp 1.64422,0.0,-312.9799999999959,0.0,0.0,1.64312,14.09.2007 01:00:00,823,-0.32239705683151587,38.07,IS,0.41,0.0,Phase3-EA-SA2v2-EURCHF-M5-43,EURCHFMT4,428,1h 9m,Buy
6760.2,1.1852,14.09.2007 05:00:00,,0.0,-318.84999999999127,0.0,0.0,1.18532,14.09.2007 00:45:00,824,-0.32844367554069703,-5.87,IS,0.58,0.0,Phase3-EA-SA2v2-USDCHF-M15-107,USDCHFMT4,224,4h 15m,Buy
6719.18,115.11,14.09.2007 06:15:00,,-0.68,-359.86999999999534,0.0,0.0,115282,13.09.2007 21:30:00,825,-0.3706979003193739,-41.02,IS,0.27,0.0,Phase3-EA-S1v2-USDJPY-M15-0,USDJPYMT4,296,8h 45m,Buy
6770.19,1.6462,14.09.2007 11:00:00,,0.0,-308.8600000000006,0.0,0.0,1.64442,14.09.2007 02:15:00,826,-0.3181530927630631,51.01,IS,0.34,0.0,Phase3-EA-S4v1-EURCHF-M15-221,EURCHFMT4,250,8h 45m,Buy
6779.09,115.29,14.09.2007 22:00:00,,0.0,-299.9600000000064,0.0,0.0,115252,14.09.2007 21:30:00,827,-0.3089853063045077,8.9,IS,0.27,0.0,Phase3-EA-S1v2-USDJPY-M15-0,USDJPYMT4,298,30m 0s,Buy
6801.01,115192,17.09.2007 01:30:00,,-1.05,-278.04000000000815,0.0,0.0,115.29,14.09.2007 22:00:00,828,-0.28640576931892925,21.92,IS,0.27,0.0,Phase3-EA-S1v2-USDJPY-M15-0,USDJPYMT4,300,2d 3h 30m,Sell
6878.79,231342,17.09.2007 03:09:58,tp 231.342,0.0,-200.2600000000093,0.0,0.0,230952,17.09.2007 01:25:00,829,-0.2062854962013011,77.78,IS,0.23,0.0,Phase3-EA-S4v1-GBPJPY-M5-194,GBPJPYMT4,280,1h 44m,Buy
6887.58,1.18812,17.09.2007 05:30:00,,0.0,-191.47000000001572,0.0,0.0,1.1883,17.09.2007 01:15:00,830,-0.19723101946302068,8.79,IS,0.58,0.0,Phase3-EA-SA2v2-USDCHF-M15-107,USDCHFMT4,226,4h 15m,Sell
6873.08,1.6482,17.09.2007 09:40:00,,0.0,-205.97000000001572,0.0,0.0,1.64862,17.09.2007 01:20:00,831,-0.21216730077191276,-14.5,IS,0.41,0.0,Phase3-EA-SA2v2-EURCHF-M5-43,EURCHFMT4,430,8h 20m,Buy
6832.45,1.6473,17.09.2007 10:45:00,,0.0,-246.60000000002037,0.0,0.0,1.64872,17.09.2007 02:00:00,832,-0.25401979108779926,-40.63,IS,0.34,0.0,Phase3-EA-S4v1-EURCHF-M15-221,EURCHFMT4,252,8h 45m,Buy
6846.05,115.13,17.09.2007 22:30:00,,0.0,-233.00000000001455,0.0,0.0,115072,17.09.2007 21:30:00,833,-0.24001058930841865,13.6,IS,0.27,0.0,Phase3-EA-S1v2-USDJPY-M15-0,USDJPYMT4,302,1h 0m,Buy
6883.22,1.64692,18.09.2007 00:24:57,tp 1.64692,-0.83,-195.8300000000163,0.0,0.0,1.64582,17.09.2007 21:25:00,834,-0.2017222047393502,37.17,IS,0.41,0.0,Phase3-EA-SA2v2-EURCHF-M5-43,EURCHFMT4,432,2h 59m,Buy
6889.43,1.18682,18.09.2007 04:00:00,,-2.59,-189.6200000000099,0.0,0.0,1187,17.09.2007 23:45:00,835,-0.1953253559856733,6.21,IS,0.58,0.0,Phase3-EA-SA2v2-USDCHF-M15-107,USDCHFMT4,228,4h 15m,Sell
6983.09,115.31,18.09.2007 21:29:58,tp 115.310,0.0,-95.9600000000064,0.0,0.0,115.71,18.09.2007 21:15:00,836,-0.09884727961388821,93.66,IS,0.27,0.0,Phase3-EA-S1v2-USDJPY-M15-0,USDJPYMT4,304,14m 58s,Sell
7047.89,115.83,18.09.2007 21:45:00,,0.0,-31.160000000003492,0.0,0.0,115552,18.09.2007 21:30:00,837,-0.032097553488629596,64.8,IS,0.27,0.0,Phase3-EA-S1v2-USDJPY-M15-0,USDJPYMT4,306,15m 0s,Buy
6982.16,115832,18.09.2007 21:45:00,,0.0,-96.88999999999942,0.0,0.0,115.55,18.09.2007 21:30:00,838,-0.09980526179438237,-65.73,IS,0.27,0.0,Phase3-EA-S1v2-USDJPY-M15-0,USDJPYMT4,307,15m 0s,Sell
6956.03,115.72,18.09.2007 22:00:00,,0.0,-123.02000000000407,0.0,0.0,115832,18.09.2007 21:45:00,839,-0.1267214708013768,-26.13,IS,0.27,0.0,Phase3-EA-S1v2-USDJPY-M15-0,USDJPYMT4,310,15m 0s,Buy
6981.23,115722,18.09.2007 22:00:00,,0.0,-97.82000000000698,0.0,0.0,115.83,18.09.2007 21:45:00,840,-0.10076324397489152,25.2,IS,0.27,0.0,Phase3-EA-S1v2-USDJPY-M15-0,USDJPYMT4,311,15m 0s,Sell
6966.77,115782,18.09.2007 22:15:00,,0.0,-112.28000000001339,0.0,0.0,115.72,18.09.2007 22:00:00,841,-0.11565832174914496,-14.46,IS,0.27,0.0,Phase3-EA-S1v2-USDJPY-M15-0,USDJPYMT4,314,15m 0s,Sell
7015.81,1.18282,18.09.2007 22:59:58,tp 1.18282,0.0,-63.24000000001979,0.0,0.0,1.18182,18.09.2007 22:15:00,842,-0.06514278827411243,49.04,IS,0.58,0.0,Phase3-EA-SA2v2-USDCHF-M15-107,USDCHFMT4,230,44m 58s,Buy
7053.98,1.65152,19.09.2007 02:19:57,tp 1.65152,0.0,-25.070000000021537,0.0,0.0,1.65042,19.09.2007 00:40:00,843,-0.025824315338913516,38.17,IS,0.41,0.0,Phase3-EA-SA2v2-EURCHF-M5-43,EURCHFMT4,434,1h 39m,Buy
7043.86,1.6525,20.09.2007 05:40:00,,-2.49,-35.19000000001688,0.0,0.0,1.65272,19.09.2007 21:20:00,844,-0.03624880960414926,-10.12,IS,0.41,0.0,Phase3-EA-SA2v2-EURCHF-M5-43,EURCHFMT4,436,8h 20m,Buy
7049.42,232.02,20.09.2007 05:50:00,,0.0,-29.63000000001921,0.0,0.0,231992,20.09.2007 00:25:00,845,-0.03052151828846614,5.56,IS,0.23,0.0,Phase3-EA-S4v1-GBPJPY-M5-194,GBPJPYMT4,282,5h 25m,Buy
6936.44,1.64862,20.09.2007 11:44:58,sl 1.64862,0.0,-142.61000000001513,0.0,0.0,1.65252,20.09.2007 05:15:00,846,-0.14690090189388447,-112.98,IS,0.34,0.0,Phase3-EA-S4v1-EURCHF-M15-221,EURCHFMT4,254,6h 29m,Buy
6739.72,115102,20.09.2007 14:15:00,sl 115.102,-2.02,-339.3300000000163,0.0,0.0,115932,19.09.2007 20:15:00,847,-0.3495398852790752,-196.72,IS,0.27,0.0,Phase3-EA-S1v2-USDJPY-M15-0,USDJPYMT4,316,18h 0m,Buy
6778.23,1649,20.09.2007 20:24:59,tp 1.64900,0.0,-300.82000000002154,0.0,0.0,1.6501,20.09.2007 20:00:00,848,-0.30987118229939553,38.51,IS,0.41,0.0,Phase3-EA-SA2v2-EURCHF-M5-43,EURCHFMT4,438,24m 59s,Sell
6618.16,231.23,21.09.2007 03:34:58,sl 231.230,0.0,-460.8900000000285,0.0,0.0,230.43,21.09.2007 00:20:00,849,-0.4747574270659099,-160.07,IS,0.23,0.0,Phase3-EA-S4v1-GBPJPY-M5-194,GBPJPYMT4,284,3h 14m,Sell
6565.23,231.26,21.09.2007 03:59:57,sl 231.260,-0.46,-513.8200000000215,0.0,0.0,230.59,20.09.2007 17:30:00,850,-0.5292800042851894,-52.93,IS,0.09,0.0,Phase3-EA-B1v1-GBPJPY-M30-1,GBPJPYMT4,124,10h 29m,Sell
6643.22,230.87,21.09.2007 06:59:58,tp 230.870,0.0,-435.8300000000163,0.0,0.0,231.26,21.09.2007 03:45:00,851,-0.4489434126106673,77.99,IS,0.23,0.0,Phase3-EA-S4v1-GBPJPY-M5-194,GBPJPYMT4,286,3h 14m,Sell
6618.16,114762,21.09.2007 08:15:00,,-1.06,-460.89000000001397,0.0,0.0,114.66,20.09.2007 21:15:00,852,-0.4747574270658949,-25.06,IS,0.27,0.0,Phase3-EA-S1v2-USDJPY-M15-0,USDJPYMT4,318,11h 0m,Sell
6588.62,1.65102,21.09.2007 14:30:00,,0.0,-490.43000000000757,0.0,0.0,1.65,21.09.2007 05:45:00,853,-0.5051862374013829,-29.54,IS,0.34,0.0,Phase3-EA-S4v1-EURCHF-M15-221,EURCHFMT4,256,8h 45m,Sell
6536.33,232882,21.09.2007 21:59:57,sl 232.882,0.0,-542.7200000000012,0.0,0.0,233552,21.09.2007 18:30:00,854,-0.5590495580663396,-52.29,IS,0.09,0.0,Phase3-EA-B1v1-GBPJPY-M30-1,GBPJPYMT4,126,3h 29m,Buy
6490.18,1.1711,24.09.2007 03:45:00,,-0.59,-588.8699999999953,0.0,0.0,1.17202,21.09.2007 23:30:00,855,-0.6065881361632556,-46.15,IS,0.58,0.0,Phase3-EA-SA2v2-USDCHF-M15-107,USDCHFMT4,232,2d 4h 15m,Buy
6460.63,1.6504,24.09.2007 06:15:00,,-0.84,-618.4199999999983,0.0,0.0,1.65122,21.09.2007 21:55:00,856,-0.6370272473824145,-29.55,IS,0.41,0.0,Phase3-EA-SA2v2-EURCHF-M5-43,EURCHFMT4,440,2d 8h 20m,Buy
6337.38,114.99,24.09.2007 13:15:00,,-0.68,-741.6699999999983,0.0,0.0,115512,21.09.2007 17:00:00,857,-0.7639856385079971,-123.25,IS,0.27,0.0,Phase3-EA-S1v2-USDJPY-M15-0,USDJPYMT4,320,2d 20h 15m,Buy
6355.57,1.1734,25.09.2007 02:30:00,,-0.59,-723.4799999999959,0.0,0.0,1.17302,24.09.2007 22:15:00,858,-0.7452483311280811,18.19,IS,0.58,0.0,Phase3-EA-SA2v2-USDCHF-M15-107,USDCHFMT4,234,4h 15m,Buy
6294.59,1.6509,25.09.2007 05:10:00,,-0.84,-784.4599999999919,0.0,0.0,1.65262,24.09.2007 20:45:00,859,-0.8080631196947141,-60.98,IS,0.41,0.0,Phase3-EA-SA2v2-EURCHF-M5-43,EURCHFMT4,442,8h 25m,Buy
6163.77,230.62,25.09.2007 09:05:00,,0.0,-915.2799999999988,0.0,0.0,231272,25.09.2007 03:40:00,860,-0.9428192797519117,-130.82,IS,0.23,0.0,Phase3-EA-S4v1-GBPJPY-M5-194,GBPJPYMT4,288,5h 25m,Buy
6157.39,1651,25.09.2007 11:00:00,,0.0,-921.6600000000035,0.0,0.0,1.65122,25.09.2007 02:15:00,861,-0.949391243527829,-6.38,IS,0.34,0.0,Phase3-EA-S4v1-EURCHF-M15-221,EURCHFMT4,258,8h 45m,Buy
6195.23,1.64962,26.09.2007 01:49:58,tp 1.64962,-0.84,-883.820000000007,0.0,0.0,1.64852,25.09.2007 22:15:00,862,-0.910412699753455,37.84,IS,0.41,0.0,Phase3-EA-SA2v2-EURCHF-M5-43,EURCHFMT4,444,3h 34m,Buy
6244.98,1.16572,26.09.2007 02:59:57,tp 1.16572,0.0,-834.070000000007,0.0,0.0,1.16472,26.09.2007 02:30:00,863,-0.8591658035384632,49.75,IS,0.58,0.0,Phase3-EA-SA2v2-USDCHF-M15-107,USDCHFMT4,236,29m 57s,Buy
6241.42,231592,26.09.2007 04:30:00,,-1.16,-837.6300000000047,0.0,0.0,231.58,25.09.2007 23:05:00,864,-0.8628329181218853,-3.56,IS,0.23,0.0,Phase3-EA-S4v1-GBPJPY-M5-194,GBPJPYMT4,290,5h 25m,Sell
6188.47,231.9,26.09.2007 05:59:58,sl 231.900,-0.45,-890.5800000000017,0.0,0.0,231.23,25.09.2007 03:30:00,865,-0.9173760971084917,-52.95,IS,0.09,0.0,Phase3-EA-B1v1-GBPJPY-M30-1,GBPJPYMT4,128,1d 2h 29m,Sell
5993.0,115.27,26.09.2007 12:29:57,sl 115.270,-1.06,-1086.050000000003,0.0,0.0,114.44,25.09.2007 18:15:00,866,-1.1187274700360192,-195.47,IS,0.27,0.0,Phase3-EA-S1v2-USDJPY-M15-0,USDJPYMT4,322,18h 14m,Sell
6031.53,1.65382,26.09.2007 21:24:59,tp 1.65382,0.0,-1047.520000000004,0.0,0.0,1.65272,26.09.2007 20:40:00,867,-1.0790381652890129,38.53,IS,0.41,0.0,Phase3-EA-SA2v2-EURCHF-M5-43,EURCHFMT4,446,44m 59s,Buy
6081.09,1.17022,27.09.2007 03:29:57,tp 1.17022,0.0,-997.9600000000064,0.0,0.0,1.16922,27.09.2007 01:15:00,868,-1.0279869858635882,49.56,IS,0.58,0.0,Phase3-EA-SA2v2-USDCHF-M15-107,USDCHFMT4,238,2h 14m,Buy
6114.42,1.6526,27.09.2007 05:55:00,tp 1.65260,-5.25,-964.6300000000047,0.0,0.0,1.6537,26.09.2007 22:35:00,869,-0.9936541406204573,33.33,IS,0.41,0.0,Phase3-EA-SA2v2-EURCHF-M5-43,EURCHFMT4,448,7h 20m,Sell
6142.31,115.5,27.09.2007 06:15:00,,-2.03,-936.7400000000052,0.0,0.0,115372,26.09.2007 20:45:00,870,-0.9649249760890786,27.89,IS,0.27,0.0,Phase3-EA-S1v2-USDJPY-M15-0,USDJPYMT4,324,9h 30m,Buy
6180.78,1.65972,27.09.2007 21:54:57,tp 1.65972,0.0,-898.2700000000041,0.0,0.0,1.65862,27.09.2007 20:35:00,871,-0.9252974766440375,38.47,IS,0.41,0.0,Phase3-EA-SA2v2-EURCHF-M5-43,EURCHFMT4,450,1h 19m,Buy
6217.54,1.6583,28.09.2007 04:44:57,tp 1.65830,-1.75,-861.5100000000093,0.0,0.0,1.6594,27.09.2007 22:30:00,872,-0.8874314283050861,36.76,IS,0.41,0.0,Phase3-EA-SA2v2-EURCHF-M5-43,EURCHFMT4,452,6h 14m,Sell
6146.11,115.25,28.09.2007 10:00:00,,-0.68,-932.9400000000023,0.0,0.0,115552,27.09.2007 21:45:00,873,-0.9610106402977797,-71.43,IS,0.27,0.0,Phase3-EA-S1v2-USDJPY-M15-0,USDJPYMT4,326,12h 15m,Buy
6165.88,1.6594,28.09.2007 14:00:00,,0.0,-913.1699999999983,0.0,0.0,1.65872,28.09.2007 05:15:00,874,-0.9406457932993758,19.77,IS,0.34,0.0,Phase3-EA-S4v1-EURCHF-M15-221,EURCHFMT4,260,8h 45m,Buy
6204.66,1.66022,01.10.2007 03:20:00,tp 1.66022,0.0,-874.3899999999994,0.0,0.0,1.65912,01.10.2007 02:00:00,875,-0.9006989664608367,38.78,IS,0.41,0.0,Phase3-EA-SA2v2-EURCHF-M5-43,EURCHFMT4,454,1h 20m,Buy
6254.51,1.16352,01.10.2007 03:30:00,tp 1.16352,0.0,-824.5399999999936,0.0,0.0,1.16252,01.10.2007 01:45:00,876,-0.8493490614092258,49.85,IS,0.58,0.0,Phase3-EA-SA2v2-USDCHF-M15-107,USDCHFMT4,240,1h 45m,Buy
6243.58,114902,01.10.2007 08:00:00,,-1.06,-835.4699999999866,0.0,0.0,114.86,28.09.2007 22:45:00,877,-0.8606079272510249,-10.93,IS,0.27,0.0,Phase3-EA-S1v2-USDJPY-M15-0,USDJPYMT4,328,2d 9h 15m,Sell
6360.25,1.66312,01.10.2007 08:59:59,tp 1.66312,0.0,-718.7999999999884,0.0,0.0,1.65912,01.10.2007 02:00:00,878,-0.7404275175745827,116.67,IS,0.34,0.0,Phase3-EA-S4v1-EURCHF-M15-221,EURCHFMT4,262,6h 59m,Buy
6420.36,115.89,01.10.2007 19:00:00,,0.0,-658.6899999999878,0.0,0.0,115632,01.10.2007 18:00:00,879,-0.6785089058864784,60.11,IS,0.27,0.0,Phase3-EA-S1v2-USDJPY-M15-0,USDJPYMT4,330,1h 0m,Buy
6458.94,1.6629,01.10.2007 23:24:58,tp 1.66290,0.0,-620.109999999986,0.0,0.0,1664,01.10.2007 20:35:00,880,-0.6387680967211624,38.58,IS,0.41,0.0,Phase3-EA-SA2v2-EURCHF-M5-43,EURCHFMT4,456,2h 49m,Sell
6496.7,1.66332,02.10.2007 00:14:59,tp 1.66332,-0.84,-582.3499999999913,0.0,0.0,1.66222,01.10.2007 23:30:00,881,-0.5998719600160806,37.76,IS,0.41,0.0,Phase3-EA-SA2v2-EURCHF-M5-43,EURCHFMT4,458,44m 59s,Buy
6574.19,236672,02.10.2007 01:54:57,tp 236.672,0.0,-504.85999999998603,0.0,0.0,236282,02.10.2007 01:30:00,882,-0.5200504125246237,77.49,IS,0.23,0.0,Phase3-EA-S4v1-GBPJPY-M5-194,GBPJPYMT4,292,24m 57s,Buy
6573.04,115.78,02.10.2007 02:00:00,,-0.68,-506.0099999999802,0.0,0.0,115782,01.10.2007 21:15:00,883,-0.5212350141456678,-1.15,IS,0.27,0.0,Phase3-EA-S1v2-USDJPY-M15-0,USDJPYMT4,332,4h 45m,Buy
6667.87,1.6653,02.10.2007 15:30:00,,0.0,-411.17999999997846,0.0,0.0,1.66202,02.10.2007 06:45:00,884,-0.4235517343855118,94.83,IS,0.34,0.0,Phase3-EA-S4v1-EURCHF-M15-221,EURCHFMT4,264,8h 45m,Buy
6627.76,115.78,02.10.2007 17:30:00,,0.0,-451.28999999997905,0.0,0.0,115952,02.10.2007 17:15:00,885,-0.4648685787510063,-40.11,IS,0.27,0.0,Phase3-EA-S1v2-USDJPY-M15-0,USDJPYMT4,334,15m 0s,Buy
6666.14,1.66352,02.10.2007 21:14:59,tp 1.66352,0.0,-412.9099999999744,0.0,0.0,1.66242,02.10.2007 20:25:00,886,-0.42533378725891335,38.38,IS,0.41,0.0,Phase3-EA-SA2v2-EURCHF-M5-43,EURCHFMT4,460,49m 59s,Buy
6688.97,115.88,02.10.2007 21:15:00,,0.0,-390.07999999997264,0.0,0.0,115782,02.10.2007 17:45:00,887,-0.4018168698601525,22.83,IS,0.27,0.0,Phase3-EA-S1v2-USDJPY-M15-0,USDJPYMT4,336,3h 30m,Buy
6727.35,1.6629,02.10.2007 23:19:57,tp 1.66290,0.0,-351.699999999968,0.0,0.0,1664,02.10.2007 22:05:00,888,-0.3622820783680596,38.38,IS,0.41,0.0,Phase3-EA-SA2v2-EURCHF-M5-43,EURCHFMT4,462,1h 14m,Sell
6743.49,1.17472,03.10.2007 02:30:00,,-2.62,-335.55999999996857,0.0,0.0,1.1751,02.10.2007 22:15:00,889,-0.3456564521387141,16.14,IS,0.58,0.0,Phase3-EA-SA2v2-USDCHF-M15-107,USDCHFMT4,242,4h 15m,Sell
6781.9,1.66402,03.10.2007 04:24:59,tp 1.66402,0.0,-297.1499999999651,0.0,0.0,1.66292,03.10.2007 00:10:00,890,-0.3060907579956385,38.41,IS,0.41,0.0,Phase3-EA-SA2v2-EURCHF-M5-43,EURCHFMT4,464,4h 14m,Buy
6859.47,236402,03.10.2007 04:59:58,tp 236.402,0.0,-219.5799999999581,0.0,0.0,236012,03.10.2007 01:05:00,891,-0.22618680343488934,77.57,IS,0.23,0.0,Phase3-EA-S4v1-GBPJPY-M5-194,GBPJPYMT4,294,3h 54m,Buy
6824.13,1.66492,03.10.2007 13:30:00,,0.0,-254.9199999999546,0.0,0.0,1.6637,03.10.2007 04:45:00,892,-0.2625901262939372,-35.34,IS,0.34,0.0,Phase3-EA-S4v1-EURCHF-M15-221,EURCHFMT4,266,8h 45m,Sell
6966.89,237332,03.10.2007 15:59:58,tp 237.332,-0.56,-112.15999999995984,0.0,0.0,235482,01.10.2007 09:00:00,893,-0.11553471114515414,142.76,IS,0.09,0.0,Phase3-EA-B1v1-GBPJPY-M30-1,GBPJPYMT4,130,2d 6h 59m,Buy
6901.11,1.6629,04.10.2007 04:30:00,,-2.5,-177.93999999995867,0.0,0.0,1.66472,03.10.2007 20:10:00,894,-0.18329392386921645,-65.78,IS,0.41,0.0,Phase3-EA-SA2v2-EURCHF-M5-43,EURCHFMT4,466,8h 20m,Buy
6938.67,1.66082,05.10.2007 03:24:59,tp 1.66082,-0.84,-140.379999999961,0.0,0.0,1.65972,04.10.2007 20:10:00,895,-0.1446038048373577,37.56,IS,0.41,0.0,Phase3-EA-SA2v2-EURCHF-M5-43,EURCHFMT4,468,7h 14m,Buy
6894.79,1.66222,05.10.2007 12:45:00,,0.0,-184.25999999996566,0.0,0.0,1.6607,05.10.2007 04:00:00,896,-0.1898040823431683,-43.88,IS,0.34,0.0,Phase3-EA-S4v1-EURCHF-M15-221,EURCHFMT4,268,8h 45m,Sell
6852.79,2.03662,05.10.2007 15:59:57,sl 2.03662,0.0,-226.25999999996566,0.0,0.0,2.03962,05.10.2007 14:00:00,897,-0.2330677937206488,-42.0,IS,0.14,0.0,Phase3-EA-B1v1-GBPUSD-M30-14,GBPUSDMT4,56,1h 59m,Buy
6889.33,1.6641,08.10.2007 01:00:00,tp 1.66410,-1.74,-189.71999999997206,0.0,0.0,1.6652,05.10.2007 21:35:00,898,-0.19542836482224737,36.54,IS,0.41,0.0,Phase3-EA-SA2v2-EURCHF-M5-43,EURCHFMT4,470,2d 3h 25m,Sell
6859.48,239172,08.10.2007 06:35:00,,0.0,-219.56999999997788,0.0,0.0,239.02,08.10.2007 01:10:00,899,-0.22617650255124844,-29.85,IS,0.23,0.0,Phase3-EA-S4v1-GBPJPY-M5-194,GBPJPYMT4,296,5h 25m,Sell
6877.4,117.53,08.10.2007 17:45:00,,0.0,-201.64999999997963,0.0,0.0,117452,08.10.2007 17:30:00,900,-0.2077173190301919,17.92,IS,0.27,0.0,Phase3-EA-S1v2-USDJPY-M15-0,USDJPYMT4,338,15m 0s,Buy
6953.84,238.77,09.10.2007 01:34:57,tp 238.770,0.0,-125.2099999999773,0.0,0.0,239.16,09.10.2007 00:40:00,901,-0.128977364323175,76.44,IS,0.23,0.0,Phase3-EA-S4v1-GBPJPY-M5-194,GBPJPYMT4,298,54m 57s,Sell
6990.13,1.6656,09.10.2007 04:14:58,tp 1.66560,-1.73,-88.9199999999837,0.0,0.0,1.6667,08.10.2007 23:45:00,902,-0.09159545751630618,36.29,IS,0.41,0.0,Phase3-EA-SA2v2-EURCHF-M5-43,EURCHFMT4,472,4h 29m,Sell
6938.44,238262,09.10.2007 04:29:58,sl 238.262,-0.28,-140.60999999998603,0.0,0.0,238932,08.10.2007 01:30:00,903,-0.1448407251615935,-51.69,IS,0.09,0.0,Phase3-EA-B1v1-GBPJPY-M30-1,GBPJPYMT4,132,1d 2h 59m,Buy
6869.38,238.33,09.10.2007 07:05:00,,0.0,-209.6699999999837,0.0,0.0,238682,09.10.2007 01:40:00,904,-0.2159786277265626,-69.06,IS,0.23,0.0,Phase3-EA-S4v1-GBPJPY-M5-194,GBPJPYMT4,300,5h 25m,Buy
6908.89,1.6668,09.10.2007 15:30:00,,0.0,-170.15999999998894,0.0,0.0,1.66542,09.10.2007 06:45:00,905,-0.17527983638075242,39.51,IS,0.34,0.0,Phase3-EA-S4v1-EURCHF-M15-221,EURCHFMT4,270,8h 45m,Buy
6957.88,1.18392,10.10.2007 04:59:57,tp 1.18392,0.0,-121.1699999999837,0.0,0.0,1.18292,10.10.2007 02:30:00,906,-0.12481580732401443,48.99,IS,0.58,0.0,Phase3-EA-SA2v2-USDCHF-M15-107,USDCHFMT4,244,2h 29m,Buy
6955.46,1.66912,10.10.2007 06:05:00,,-1.73,-123.58999999998196,0.0,0.0,1.6691,09.10.2007 21:45:00,907,-0.1273086211700484,-2.42,IS,0.41,0.0,Phase3-EA-SA2v2-EURCHF-M5-43,EURCHFMT4,474,8h 20m,Sell
6947.04,117132,10.10.2007 07:45:00,,-1.04,-132.0099999999802,0.0,0.0,117.1,09.10.2007 21:15:00,908,-0.13598196521286532,-8.42,IS,0.27,0.0,Phase3-EA-S1v2-USDJPY-M15-0,USDJPYMT4,340,10h 30m,Sell
7023.63,238.64,10.10.2007 07:49:58,tp 238.640,0.0,-55.4199999999837,0.0,0.0,239.03,10.10.2007 03:25:00,909,-0.05708749725093485,76.59,IS,0.23,0.0,Phase3-EA-S4v1-GBPJPY-M5-194,GBPJPYMT4,302,4h 24m,Sell
7005.81,1.66992,10.10.2007 09:45:00,,0.0,-73.23999999999069,0.0,0.0,1.6693,10.10.2007 01:00:00,910,-0.07544367193538734,-17.82,IS,0.34,0.0,Phase3-EA-S4v1-EURCHF-M15-221,EURCHFMT4,272,8h 45m,Sell
7043.94,1.67142,10.10.2007 21:34:59,tp 1.67142,0.0,-35.10999999998603,0.0,0.0,1.67032,10.10.2007 20:35:00,911,-0.03616640253482704,38.13,IS,0.41,0.0,Phase3-EA-SA2v2-EURCHF-M5-43,EURCHFMT4,476,59m 59s,Buy
7092.97,1.1829,10.10.2007 22:44:58,tp 1.18290,0.0,-0.0,0.0,0.0,1.1839,10.10.2007 22:00:00,912,-0.0,49.03,IS,0.58,0.0,Phase3-EA-SA2v2-USDCHF-M15-107,USDCHFMT4,246,44m 58s,Sell
7107.84,117132,11.10.2007 00:30:00,,-3.11,-0.0,0.0,0.0,117.21,10.10.2007 21:30:00,913,-0.0,14.87,IS,0.27,0.0,Phase3-EA-S1v2-USDJPY-M15-0,USDJPYMT4,342,3h 0m,Sell
7067.29,1.67402,11.10.2007 06:20:00,,-5.2,-40.55000000000291,0.0,0.0,1673,10.10.2007 22:00:00,914,-0.04175769948132188,-40.55,IS,0.41,0.0,Phase3-EA-SA2v2-EURCHF-M5-43,EURCHFMT4,478,8h 20m,Sell
7066.71,1.67362,11.10.2007 10:30:00,,0.0,-41.13000000000466,0.0,0.0,1.6736,11.10.2007 01:45:00,915,-0.042354973604607646,-0.58,IS,0.34,0.0,Phase3-EA-S4v1-EURCHF-M15-221,EURCHFMT4,274,8h 45m,Sell
7104.85,1.6808,11.10.2007 21:09:58,tp 1.68080,0.0,-2.9900000000052387,0.0,0.0,1.6819,11.10.2007 20:20:00,916,-0.003079051083831374,38.14,IS,0.41,0.0,Phase3-EA-SA2v2-EURCHF-M5-43,EURCHFMT4,480,49m 58s,Sell
7142.17,1.67882,12.10.2007 01:39:57,tp 1.67882,-0.83,-0.0,0.0,0.0,1.67772,11.10.2007 22:35:00,917,-0.0,37.32,IS,0.41,0.0,Phase3-EA-SA2v2-EURCHF-M5-43,EURCHFMT4,482,3h 4m,Buy
7090.47,117.47,12.10.2007 03:00:00,,-0.67,-51.69999999999709,0.0,0.0,117692,11.10.2007 20:15:00,918,-0.05322096469535018,-51.7,IS,0.27,0.0,Phase3-EA-S1v2-USDJPY-M15-0,USDJPYMT4,344,6h 45m,Buy
7167.01,238.13,12.10.2007 05:04:58,tp 238.130,0.0,-0.0,0.0,0.0,238.52,12.10.2007 00:55:00,919,-0.0,76.54,IS,0.23,0.0,Phase3-EA-S4v1-GBPJPY-M5-194,GBPJPYMT4,304,4h 9m,Sell
7281.61,1.68092,12.10.2007 14:59:58,tp 1.68092,0.0,-0.0,0.0,0.0,1.67692,12.10.2007 06:15:00,920,-0.0,114.6,IS,0.34,0.0,Phase3-EA-S4v1-EURCHF-M15-221,EURCHFMT4,276,8h 44m,Buy
7330.56,1.18492,15.10.2007 03:59:59,tp 1.18492,0.0,-0.0,0.0,0.0,1.18392,15.10.2007 01:30:00,921,-0.0,48.95,IS,0.58,0.0,Phase3-EA-SA2v2-USDCHF-M15-107,USDCHFMT4,248,2h 29m,Buy
7368.63,1.67942,15.10.2007 09:39:57,tp 1.67942,0.0,-0.0,0.0,0.0,1.67832,15.10.2007 01:30:00,922,-0.0,38.07,IS,0.41,0.0,Phase3-EA-SA2v2-EURCHF-M5-43,EURCHFMT4,484,8h 9m,Buy
7405.5,1.6791,15.10.2007 14:45:00,,0.0,-0.0,0.0,0.0,1.67782,15.10.2007 06:00:00,923,-0.0,36.87,IS,0.34,0.0,Phase3-EA-S4v1-EURCHF-M15-221,EURCHFMT4,278,8h 45m,Buy
7443.7,1.67782,15.10.2007 23:59:57,tp 1.67782,0.0,-0.0,0.0,0.0,1.67672,15.10.2007 20:30:00,924,-0.0,38.2,IS,0.41,0.0,Phase3-EA-SA2v2-EURCHF-M5-43,EURCHFMT4,486,3h 29m,Buy
7485.96,117222,16.10.2007 03:45:00,,-1.04,-0.0,0.0,0.0,117.41,15.10.2007 23:30:00,925,-0.0,42.26,IS,0.27,0.0,Phase3-EA-S1v2-USDJPY-M15-0,USDJPYMT4,346,4h 15m,Sell
7562.4,239722,16.10.2007 05:44:58,tp 239.722,0.0,-0.0,0.0,0.0,239332,16.10.2007 03:50:00,926,-0.0,76.44,IS,0.23,0.0,Phase3-EA-S4v1-GBPJPY-M5-194,GBPJPYMT4,306,1h 54m,Buy
7519.34,2.03062,16.10.2007 13:59:58,sl 2.03062,-1.06,-43.05999999999767,0.0,0.0,2.03362,12.10.2007 16:00:00,927,-0.04413585561650558,-43.06,IS,0.14,0.0,Phase3-EA-B1v1-GBPUSD-M30-14,GBPUSDMT4,58,3d 21h 59m,Buy
7361.55,236402,17.10.2007 04:44:57,sl 236.402,0.0,-200.84999999999127,0.0,0.0,237202,17.10.2007 03:30:00,928,-0.20586824432362377,-157.79,IS,0.23,0.0,Phase3-EA-S4v1-GBPJPY-M5-194,GBPJPYMT4,308,1h 14m,Buy
7410.63,1.1817,17.10.2007 04:44:59,tp 1.18170,0.0,-151.76999999998952,0.0,0.0,1.1827,17.10.2007 00:30:00,929,-0.15556197879509873,49.08,IS,0.58,0.0,Phase3-EA-SA2v2-USDCHF-M15-107,USDCHFMT4,250,4h 14m,Sell
7481.04,116392,17.10.2007 04:45:00,,-1.04,-81.35999999998603,0.0,0.0,116.7,16.10.2007 18:45:00,930,-0.08339278246536162,70.41,IS,0.27,0.0,Phase3-EA-S1v2-USDJPY-M15-0,USDJPYMT4,348,10h 0m,Sell
7517.49,1.6744,17.10.2007 04:45:00,tp 1.67440,-1.73,-44.90999999998894,0.0,0.0,1.6755,16.10.2007 23:25:00,931,-0.04603207793165083,36.45,IS,0.41,0.0,Phase3-EA-SA2v2-EURCHF-M5-43,EURCHFMT4,488,5h 20m,Sell
7615.02,1.67202,17.10.2007 09:45:00,,0.0,-0.0,0.0,0.0,1.6754,17.10.2007 01:00:00,932,-0.0,97.53,IS,0.34,0.0,Phase3-EA-S4v1-EURCHF-M15-221,EURCHFMT4,280,8h 45m,Sell
7653.19,1.67662,17.10.2007 22:19:58,tp 1.67662,0.0,-0.0,0.0,0.0,1.67552,17.10.2007 20:20:00,933,-0.0,38.17,IS,0.41,0.0,Phase3-EA-SA2v2-EURCHF-M5-43,EURCHFMT4,490,1h 59m,Buy
7627.27,116.68,17.10.2007 23:15:00,,0.0,-25.919999999998254,0.0,0.0,116792,17.10.2007 17:00:00,934,-0.02654291170621076,-25.92,IS,0.27,0.0,Phase3-EA-S1v2-USDJPY-M15-0,USDJPYMT4,350,6h 15m,Buy
7676.42,1.18,17.10.2007 23:44:58,tp 1.18000,0.0,-0.0,0.0,0.0,1181,17.10.2007 23:15:00,935,-0.0,49.15,IS,0.58,0.0,Phase3-EA-SA2v2-USDCHF-M15-107,USDCHFMT4,252,29m 58s,Sell
7749.95,237.7,18.10.2007 00:14:57,tp 237.700,-3.43,-0.0,0.0,0.0,238.09,17.10.2007 23:45:00,936,-0.0,73.53,IS,0.23,0.0,Phase3-EA-S4v1-GBPJPY-M5-194,GBPJPYMT4,310,29m 57s,Sell
7818.29,116372,18.10.2007 03:00:00,,-3.12,-0.0,0.0,0.0,116.68,17.10.2007 23:15:00,937,-0.0,68.34,IS,0.27,0.0,Phase3-EA-S1v2-USDJPY-M15-0,USDJPYMT4,352,3h 45m,Sell
7743.42,1.1775,18.10.2007 05:45:00,,0.0,-74.86999999999534,0.0,0.0,1.17902,18.10.2007 01:30:00,938,-0.07653987817615222,-74.87,IS,0.58,0.0,Phase3-EA-SA2v2-USDCHF-M15-107,USDCHFMT4,254,4h 15m,Buy
7781.71,1.67682,18.10.2007 09:14:57,tp 1.67682,0.0,-36.580000000001746,0.0,0.0,1.67572,18.10.2007 01:20:00,939,-0.037395869422785576,38.29,IS,0.41,0.0,Phase3-EA-SA2v2-EURCHF-M5-43,EURCHFMT4,492,7h 54m,Buy
7817.6,115482,19.10.2007 00:15:00,,-1.05,-0.6900000000023283,0.0,0.0,115.64,18.10.2007 19:30:00,940,-7.05389554450735E-4,35.89,IS,0.27,0.0,Phase3-EA-S1v2-USDJPY-M15-0,USDJPYMT4,354,4h 45m,Sell
7753.65,1.6696,19.10.2007 09:05:00,,0.0,-64.63999999999942,0.0,0.0,1.67142,19.10.2007 00:45:00,941,-0.06608171130368296,-63.95,IS,0.41,0.0,Phase3-EA-SA2v2-EURCHF-M5-43,EURCHFMT4,494,8h 20m,Buy
7689.26,235.41,19.10.2007 09:20:00,,0.0,-129.02999999999884,0.0,0.0,235732,19.10.2007 03:55:00,942,-0.13190784668184113,-64.39,IS,0.23,0.0,Phase3-EA-S4v1-GBPJPY-M5-194,GBPJPYMT4,312,5h 25m,Buy
7767.07,1.6733,19.10.2007 14:00:00,,0.0,-51.220000000001164,0.0,0.0,1.67062,19.10.2007 05:15:00,943,-0.05236239562151529,77.81,IS,0.34,0.0,Phase3-EA-S4v1-EURCHF-M15-221,EURCHFMT4,282,8h 45m,Buy
7571.99,1.16312,22.10.2007 02:00:00,sl 1.16312,-0.6,-246.3000000000029,0.0,0.0,1.16702,19.10.2007 23:30:00,944,-0.25179340182700266,-195.08,IS,0.58,0.0,Phase3-EA-SA2v2-USDCHF-M15-107,USDCHFMT4,256,2d 2h 30m,Buy
7410.57,234082,22.10.2007 02:00:00,sl 234.082,-0.72,-407.72000000000116,0.0,0.0,234882,19.10.2007 23:15:00,945,-0.4168136654198319,-161.42,IS,0.23,0.0,Phase3-EA-S4v1-GBPJPY-M5-194,GBPJPYMT4,314,2d 2h 45m,Buy
7237.43,1.66532,22.10.2007 02:00:00,sl 1.66532,-0.84,-580.8600000000006,0.0,0.0,1.67022,19.10.2007 21:20:00,946,-0.5938153284012634,-173.14,IS,0.41,0.0,Phase3-EA-SA2v2-EURCHF-M5-43,EURCHFMT4,496,2d 4h 40m,Buy
7287.36,1.16152,22.10.2007 02:14:58,tp 1.16152,0.0,-530.9300000000076,0.0,0.0,1.16052,22.10.2007 02:00:00,947,-0.5427717045554642,49.93,IS,0.58,0.0,Phase3-EA-SA2v2-USDCHF-M15-107,USDCHFMT4,258,14m 58s,Buy
7366.22,233532,22.10.2007 02:29:57,tp 233.532,0.0,-452.070000000007,0.0,0.0,233142,22.10.2007 02:20:00,948,-0.4621528346079314,78.86,IS,0.23,0.0,Phase3-EA-S4v1-GBPJPY-M5-194,GBPJPYMT4,316,9m 57s,Buy
7405.03,1.66542,22.10.2007 02:34:57,tp 1.66542,0.0,-413.2600000000093,0.0,0.0,1.66432,22.10.2007 02:05:00,949,-0.422477227929469,38.81,IS,0.41,0.0,Phase3-EA-SA2v2-EURCHF-M5-43,EURCHFMT4,498,29m 57s,Buy
7401.52,1.6652,22.10.2007 11:45:00,,0.0,-416.7700000000041,0.0,0.0,1.66532,22.10.2007 03:00:00,950,-0.4260655139238314,-3.51,IS,0.34,0.0,Phase3-EA-S4v1-EURCHF-M15-221,EURCHFMT4,284,8h 45m,Buy
7358.46,2.03692,22.10.2007 14:59:57,sl 2.03692,-1.06,-459.83000000000175,0.0,0.0,2.03992,18.10.2007 04:00:00,951,-0.47008591133621475,-43.06,IS,0.14,0.0,Phase3-EA-B1v1-GBPUSD-M30-14,GBPUSDMT4,60,4d 10h 59m,Buy
7273.7,233082,23.10.2007 06:30:00,,0.0,-544.5899999999965,0.0,0.0,232.66,23.10.2007 01:05:00,952,-0.5567363731261261,-84.76,IS,0.23,0.0,Phase3-EA-S4v1-GBPJPY-M5-194,GBPJPYMT4,318,5h 25m,Sell
7156.29,1.67062,23.10.2007 08:05:00,,-1.74,-662.0,0.0,0.0,1.6673,22.10.2007 23:45:00,953,-0.6767650507895809,-117.41,IS,0.41,0.0,Phase3-EA-SA2v2-EURCHF-M5-43,EURCHFMT4,500,8h 20m,Sell
7193.31,1.66822,23.10.2007 11:30:00,,0.0,-624.9799999999959,0.0,0.0,1.6695,23.10.2007 02:45:00,954,-0.6389193677378694,37.02,IS,0.34,0.0,Phase3-EA-S4v1-EURCHF-M15-221,EURCHFMT4,286,8h 45m,Sell
7130.39,114362,23.10.2007 11:30:00,,-1.06,-687.8999999999942,0.0,0.0,114.1,22.10.2007 17:00:00,955,-0.7032427166739407,-62.92,IS,0.27,0.0,Phase3-EA-S1v2-USDJPY-M15-0,USDJPYMT4,356,18h 30m,Sell
7077.74,233252,23.10.2007 14:29:58,sl 233.252,0.0,-740.5499999999884,0.0,0.0,233922,23.10.2007 14:00:00,956,-0.7570670065894505,-52.65,IS,0.09,0.0,Phase3-EA-B1v1-GBPJPY-M30-1,GBPJPYMT4,134,29m 58s,Buy
7124.29,114.85,23.10.2007 23:30:00,,0.0,-693.9999999999854,0.0,0.0,114652,23.10.2007 20:00:00,957,-0.7094787692567361,46.55,IS,0.27,0.0,Phase3-EA-S1v2-USDJPY-M15-0,USDJPYMT4,358,3h 30m,Buy
7201.35,235.19,24.10.2007 02:09:57,tp 235.190,-1.16,-616.9399999999878,0.0,0.0,235.58,23.10.2007 23:40:00,958,-0.6307000459729846,77.06,IS,0.23,0.0,Phase3-EA-S4v1-GBPJPY-M5-194,GBPJPYMT4,320,2h 29m,Sell
7170.95,1.67262,24.10.2007 05:15:00,,-1.75,-647.339999999982,0.0,0.0,1.6718,23.10.2007 20:55:00,959,-0.6617780785167902,-30.4,IS,0.41,0.0,Phase3-EA-SA2v2-EURCHF-M5-43,EURCHFMT4,502,8h 20m,Sell
7117.95,233662,24.10.2007 11:29:58,sl 233.662,-0.28,-700.339999999982,0.0,0.0,234332,23.10.2007 15:30:00,960,-0.7159601747280406,-53.0,IS,0.09,0.0,Phase3-EA-B1v1-GBPJPY-M30-1,GBPJPYMT4,136,19h 59m,Buy
7095.38,1.1715,25.10.2007 02:45:00,,-1.78,-722.9099999999889,0.0,0.0,1.17192,24.10.2007 22:30:00,961,-0.7390335692844237,-22.57,IS,0.58,0.0,Phase3-EA-SA2v2-USDCHF-M15-107,USDCHFMT4,260,4h 15m,Buy
7096.45,114022,25.10.2007 04:30:00,,-3.19,-721.839999999982,0.0,0.0,114.04,24.10.2007 22:45:00,962,-0.7379397043231705,1.07,IS,0.27,0.0,Phase3-EA-S1v2-USDJPY-M15-0,USDJPYMT4,360,5h 45m,Sell
7087.0,1.67092,25.10.2007 07:35:00,,-5.25,-731.289999999979,0.0,0.0,1.6708,24.10.2007 23:15:00,963,-0.7476004743080037,-9.45,IS,0.41,0.0,Phase3-EA-SA2v2-EURCHF-M5-43,EURCHFMT4,504,8h 20m,Sell
7115.45,1.67072,25.10.2007 10:15:00,,0.0,-702.839999999982,0.0,0.0,1.6717,25.10.2007 01:30:00,964,-0.7185159339832883,28.45,IS,0.34,0.0,Phase3-EA-S4v1-EURCHF-M15-221,EURCHFMT4,288,8h 45m,Sell
7073.45,2.04872,25.10.2007 18:29:58,sl 2.04872,0.0,-744.839999999982,0.0,0.0,2.05172,25.10.2007 14:30:00,965,-0.761452689471449,-42.0,IS,0.14,0.0,Phase3-EA-B1v1-GBPUSD-M30-14,GBPUSDMT4,62,3h 59m,Buy
7120.21,114.33,25.10.2007 18:30:00,,0.0,-698.0799999999872,0.0,0.0,114132,25.10.2007 17:00:00,966,-0.713649768361302,46.76,IS,0.27,0.0,Phase3-EA-S1v2-USDJPY-M15-0,USDJPYMT4,362,1h 30m,Buy
7158.89,1.66922,25.10.2007 21:44:58,tp 1.66922,0.0,-659.3999999999942,0.0,0.0,1.66812,25.10.2007 21:25:00,967,-0.6741070611641173,38.68,IS,0.41,0.0,Phase3-EA-SA2v2-EURCHF-M5-43,EURCHFMT4,506,19m 58s,Buy
7208.62,1.16622,25.10.2007 22:29:58,tp 1.16622,0.0,-609.6699999999983,0.0,0.0,1.16522,25.10.2007 22:00:00,968,-0.6232678980587351,49.73,IS,0.58,0.0,Phase3-EA-SA2v2-USDCHF-M15-107,USDCHFMT4,262,29m 58s,Buy
7258.36,1.16612,26.10.2007 04:44:57,tp 1.16612,0.0,-559.929999999993,0.0,0.0,1.16512,26.10.2007 02:00:00,969,-0.5724185119163222,49.74,IS,0.58,0.0,Phase3-EA-SA2v2-USDCHF-M15-107,USDCHFMT4,264,2h 44m,Buy
7336.97,234212,26.10.2007 04:49:58,tp 234.212,0.0,-481.31999999999243,0.0,0.0,233822,26.10.2007 03:15:00,970,-0.4920552178943141,78.61,IS,0.23,0.0,Phase3-EA-S4v1-GBPJPY-M5-194,GBPJPYMT4,322,1h 34m,Buy
7322.19,1.67002,26.10.2007 09:15:00,,0.0,-496.09999999999127,0.0,0.0,1.6696,26.10.2007 00:55:00,971,-0.5071648666113371,-14.78,IS,0.41,0.0,Phase3-EA-SA2v2-EURCHF-M5-43,EURCHFMT4,508,8h 20m,Sell
7245.67,1.67262,26.10.2007 13:30:00,,0.0,-572.6199999999953,0.0,0.0,1.67,26.10.2007 04:45:00,972,-0.5853915458959618,-76.52,IS,0.34,0.0,Phase3-EA-S4v1-EURCHF-M15-221,EURCHFMT4,290,8h 45m,Sell
7175.65,114342,26.10.2007 16:15:00,,-1.07,-642.6399999999994,0.0,0.0,114.05,25.10.2007 23:00:00,973,-0.6569732511169424,-70.02,IS,0.27,0.0,Phase3-EA-S1v2-USDJPY-M15-0,USDJPYMT4,364,17h 15m,Sell
7144.97,1.67502,29.10.2007 06:50:00,,-1.76,-673.3199999999924,0.0,0.0,1.6742,26.10.2007 22:30:00,974,-0.6883375286973346,-30.68,IS,0.41,0.0,Phase3-EA-SA2v2-EURCHF-M5-43,EURCHFMT4,510,2d 8h 20m,Sell
7115.12,1.67582,29.10.2007 11:00:00,,0.0,-703.1699999999983,0.0,0.0,1.6748,29.10.2007 02:15:00,975,-0.7188532942049976,-29.85,IS,0.34,0.0,Phase3-EA-S4v1-EURCHF-M15-221,EURCHFMT4,292,8h 45m,Sell
7118.68,114.7,30.10.2007 02:00:00,,-0.68,-699.6100000000006,0.0,0.0,114682,29.10.2007 19:45:00,976,-0.7152138930255273,3.56,IS,0.27,0.0,Phase3-EA-S1v2-USDJPY-M15-0,USDJPYMT4,366,6h 15m,Buy
7168.46,1.16512,30.10.2007 03:14:58,tp 1.16512,0.0,-649.8300000000017,0.0,0.0,1.16412,30.10.2007 00:45:00,977,-0.6643236147350371,49.78,IS,0.58,0.0,Phase3-EA-SA2v2-USDCHF-M15-107,USDCHFMT4,266,2h 29m,Buy
7205.38,1.6788,30.10.2007 03:54:57,tp 1.67880,-1.76,-612.9100000000035,0.0,0.0,1.6799,29.10.2007 20:10:00,978,-0.6265801620535414,36.92,IS,0.41,0.0,Phase3-EA-SA2v2-EURCHF-M5-43,EURCHFMT4,512,7h 44m,Sell
7198.96,1.6782,30.10.2007 14:00:00,,0.0,-619.3300000000017,0.0,0.0,1.67842,30.10.2007 05:15:00,979,-0.6331433518210156,-6.42,IS,0.34,0.0,Phase3-EA-S4v1-EURCHF-M15-221,EURCHFMT4,294,8h 45m,Buy
7224.35,114.85,30.10.2007 20:15:00,,0.0,-593.9400000000023,0.0,0.0,114742,30.10.2007 17:00:00,980,-0.607187060824721,25.39,IS,0.27,0.0,Phase3-EA-S1v2-USDJPY-M15-0,USDJPYMT4,368,3h 15m,Buy
7273.78,1.15942,31.10.2007 00:29:58,tp 1.15942,-0.6,-544.5100000000093,0.0,0.0,1.15842,30.10.2007 22:30:00,981,-0.5566545888299713,49.43,IS,0.58,0.0,Phase3-EA-SA2v2-USDCHF-M15-107,USDCHFMT4,268,1h 59m,Buy
7277.79,1.1582,31.10.2007 05:30:00,,0.0,-540.5000000000146,0.0,0.0,1.15812,31.10.2007 01:15:00,982,-0.5525551509845594,4.01,IS,0.58,0.0,Phase3-EA-SA2v2-USDCHF-M15-107,USDCHFMT4,270,4h 15m,Buy
7247.91,1673,31.10.2007 06:40:00,,-0.85,-570.3800000000192,0.0,0.0,1.67382,30.10.2007 22:20:00,983,-0.5831015856032842,-29.88,IS,0.41,0.0,Phase3-EA-SA2v2-EURCHF-M5-43,EURCHFMT4,514,8h 20m,Buy
7247.32,1.6726,31.10.2007 10:00:00,,0.0,-570.9700000000157,0.0,0.0,1.67262,31.10.2007 01:15:00,984,-0.5837047447875191,-0.59,IS,0.34,0.0,Phase3-EA-S4v1-EURCHF-M15-221,EURCHFMT4,296,8h 45m,Buy
7286.15,1.6759,31.10.2007 21:19:58,tp 1.67590,0.0,-532.140000000014,0.0,0.0,1677,31.10.2007 20:20:00,985,-0.5440086920350106,38.83,IS,0.41,0.0,Phase3-EA-SA2v2-EURCHF-M5-43,EURCHFMT4,516,59m 58s,Sell
7233.84,238512,31.10.2007 21:29:58,sl 238.512,0.0,-584.4500000000116,0.0,0.0,239182,31.10.2007 18:30:00,986,-0.5974853986918103,-52.31,IS,0.09,0.0,Phase3-EA-B1v1-GBPJPY-M30-1,GBPJPYMT4,138,2h 59m,Buy
7267.48,1.6768,01.11.2007 01:39:58,tp 1.67680,-5.31,-550.8100000000122,0.0,0.0,1.6779,31.10.2007 23:00:00,987,-0.5630951021531984,33.64,IS,0.41,0.0,Phase3-EA-SA2v2-EURCHF-M5-43,EURCHFMT4,518,2h 39m,Sell
7306.38,1.67812,01.11.2007 03:39:57,tp 1.67812,0.0,-511.91000000001804,0.0,0.0,1.67702,01.11.2007 02:10:00,988,-0.5233274881415507,38.9,IS,0.41,0.0,Phase3-EA-SA2v2-EURCHF-M5-43,EURCHFMT4,520,1h 29m,Buy
7240.39,1.16022,01.11.2007 06:45:00,,0.0,-577.9000000000233,0.0,0.0,1.1589,01.11.2007 02:30:00,989,-0.5907893094430734,-65.99,IS,0.58,0.0,Phase3-EA-SA2v2-USDCHF-M15-107,USDCHFMT4,272,4h 15m,Sell
7187.23,239382,01.11.2007 07:59:57,sl 239.382,-0.84,-631.0600000000268,0.0,0.0,240052,31.10.2007 22:00:00,990,-0.6451349742466632,-53.16,IS,0.09,0.0,Phase3-EA-B1v1-GBPJPY-M30-1,GBPJPYMT4,140,9h 59m,Buy
7145.23,2.07752,01.11.2007 11:29:57,sl 2.07752,0.0,-673.0600000000268,0.0,0.0,2.08052,01.11.2007 09:30:00,991,-0.6880717297348239,-42.0,IS,0.14,0.0,Phase3-EA-B1v1-GBPUSD-M30-14,GBPUSDMT4,64,1h 59m,Buy
7168.05,1.67722,01.11.2007 13:00:00,,0.0,-650.2400000000198,0.0,0.0,1678,01.11.2007 04:15:00,992,-0.6647427592529161,22.82,IS,0.34,0.0,Phase3-EA-S4v1-EURCHF-M15-221,EURCHFMT4,298,8h 45m,Sell
7214.66,114692,01.11.2007 22:30:00,,0.0,-603.6300000000192,0.0,0.0,114892,01.11.2007 22:00:00,993,-0.6170931836980781,46.61,IS,0.27,0.0,Phase3-EA-S1v2-USDJPY-M15-0,USDJPYMT4,370,30m 0s,Buy
7262.14,1157,02.11.2007 01:29:57,tp 1.15700,-2.65,-556.1500000000233,0.0,0.0,1158,01.11.2007 23:45:00,994,-0.5685542039224187,47.48,IS,0.58,0.0,Phase3-EA-SA2v2-USDCHF-M15-107,USDCHFMT4,274,1h 44m,Sell
7259.01,238.26,02.11.2007 04:30:00,,-0.72,-559.2800000000279,0.0,0.0,238272,01.11.2007 23:05:00,995,-0.5717540145099935,-3.13,IS,0.23,0.0,Phase3-EA-S4v1-GBPJPY-M5-194,GBPJPYMT4,324,5h 25m,Buy
7246.1,114.84,02.11.2007 05:00:00,,-0.68,-572.1900000000314,0.0,0.0,114.89,01.11.2007 22:00:00,996,-0.584951955304096,-12.91,IS,0.27,0.0,Phase3-EA-S1v2-USDJPY-M15-0,USDJPYMT4,371,7h 0m,Sell
7194.96,1.6707,02.11.2007 05:25:00,,-0.85,-623.3300000000309,0.0,0.0,1.67212,01.11.2007 21:05:00,997,-0.6372325666294416,-51.14,IS,0.41,0.0,Phase3-EA-SA2v2-EURCHF-M5-43,EURCHFMT4,522,8h 20m,Buy
7135.37,1.6677,02.11.2007 11:15:00,,0.0,-682.9200000000274,0.0,0.0,1.66972,02.11.2007 02:30:00,998,-0.6981516442375213,-59.59,IS,0.34,0.0,Phase3-EA-S4v1-EURCHF-M15-221,EURCHFMT4,300,8h 45m,Buy
7174.53,1.6725,02.11.2007 20:44:58,tp 1.67250,0.0,-643.7600000000239,0.0,0.0,1.6736,02.11.2007 20:05:00,999,-0.6581182312633184,39.16,IS,0.41,0.0,Phase3-EA-SA2v2-EURCHF-M5-43,EURCHFMT4,524,39m 58s,Sell
7211.9,1.6724,05.11.2007 02:10:00,tp 1.67240,-1.78,-606.3900000000285,0.0,0.0,1.6735,02.11.2007 22:55:00,1000,-0.619914741915881,37.37,IS,0.41,0.0,Phase3-EA-SA2v2-EURCHF-M5-43,EURCHFMT4,526,2d 3h 15m,Sell
7257.49,114602,05.11.2007 02:15:00,,-1.06,-560.800000000032,0.0,0.0,114.8,02.11.2007 23:00:00,1001,-0.5733079161371882,45.59,IS,0.27,0.0,Phase3-EA-S1v2-USDJPY-M15-0,USDJPYMT4,374,2d 3h 15m,Sell
7335.68,239632,05.11.2007 04:14:58,tp 239.632,0.0,-482.6100000000297,0.0,0.0,239242,05.11.2007 02:30:00,1002,-0.49337398967006,78.19,IS,0.23,0.0,Phase3-EA-S4v1-GBPJPY-M5-194,GBPJPYMT4,326,1h 44m,Buy
7374.81,1.67222,05.11.2007 05:14:57,tp 1.67222,0.0,-443.48000000002503,0.0,0.0,1.67112,05.11.2007 02:25:00,1003,-0.45337124580691884,39.13,IS,0.41,0.0,Phase3-EA-SA2v2-EURCHF-M5-43,EURCHFMT4,528,2h 49m,Buy
7332.81,2.08572,05.11.2007 10:29:58,sl 2.08572,0.0,-485.48000000002503,0.0,0.0,2.08872,05.11.2007 07:30:00,1004,-0.49630800129507957,-42.0,IS,0.14,0.0,Phase3-EA-B1v1-GBPUSD-M30-14,GBPUSDMT4,66,2h 59m,Buy
7326.33,1.6708,05.11.2007 12:45:00,,0.0,-491.96000000002095,0.0,0.0,1.67102,05.11.2007 04:00:00,1005,-0.5029325292846774,-6.48,IS,0.34,0.0,Phase3-EA-S4v1-EURCHF-M15-221,EURCHFMT4,302,8h 45m,Buy
7365.44,1.66872,05.11.2007 23:09:58,tp 1.66872,0.0,-452.8500000000204,0.0,0.0,1.66762,05.11.2007 22:00:00,1006,-0.46295023149558234,39.11,IS,0.41,0.0,Phase3-EA-SA2v2-EURCHF-M5-43,EURCHFMT4,530,1h 9m,Buy
7415.77,1.1524,06.11.2007 01:29:58,tp 1.15240,0.0,-402.5200000000186,0.0,0.0,1.1534,06.11.2007 00:15:00,1007,-0.4114976861689346,50.33,IS,0.58,0.0,Phase3-EA-SA2v2-USDCHF-M15-107,USDCHFMT4,276,1h 14m,Sell
7492.98,237.97,06.11.2007 02:09:59,tp 237.970,-1.17,-325.3100000000122,0.0,0.0,238.36,05.11.2007 23:30:00,1008,-0.3325656173298593,77.21,IS,0.23,0.0,Phase3-EA-S4v1-GBPJPY-M5-194,GBPJPYMT4,328,2h 39m,Sell
7483.37,1.66912,06.11.2007 08:00:00,,-1.78,-334.9200000000128,0.0,0.0,1.6689,05.11.2007 23:40:00,1009,-0.34238995590703186,-9.61,IS,0.41,0.0,Phase3-EA-SA2v2-EURCHF-M5-43,EURCHFMT4,532,8h 20m,Sell
7430.72,238662,06.11.2007 18:59:58,sl 238.662,0.0,-387.570000000007,0.0,0.0,239332,06.11.2007 11:00:00,1010,-0.39621424582254167,-52.65,IS,0.09,0.0,Phase3-EA-B1v1-GBPJPY-M30-1,GBPJPYMT4,142,7h 59m,Buy
7470.11,1.6663,06.11.2007 23:49:57,tp 1.66630,0.0,-348.18000000000757,0.0,0.0,1.6674,06.11.2007 23:00:00,1011,-0.3559457029968601,39.39,IS,0.41,0.0,Phase3-EA-SA2v2-EURCHF-M5-43,EURCHFMT4,534,49m 57s,Sell
7435.6,114612,07.11.2007 05:15:00,,-1.06,-382.6900000000023,0.0,0.0,114.47,06.11.2007 22:00:00,1012,-0.3912254037562935,-34.51,IS,0.27,0.0,Phase3-EA-S1v2-USDJPY-M15-0,USDJPYMT4,376,7h 15m,Sell
7382.78,238772,07.11.2007 08:29:58,sl 238.772,0.0,-435.5100000000093,0.0,0.0,239442,07.11.2007 02:30:00,1013,-0.4452234853011732,-52.82,IS,0.09,0.0,Phase3-EA-B1v1-GBPJPY-M30-1,GBPJPYMT4,144,5h 59m,Buy
7646.85,2.10102,07.11.2007 12:29:58,tp 2.10102,-0.53,-171.44000000000233,0.0,0.0,2.08212,06.11.2007 08:00:00,1014,-0.17526374668786604,264.07,IS,0.14,0.0,Phase3-EA-B1v1-GBPUSD-M30-14,GBPUSDMT4,68,1d 4h 29m,Buy
7593.67,238.45,07.11.2007 17:59:58,sl 238.450,0.0,-224.61999999999534,0.0,0.0,237.78,07.11.2007 14:30:00,1015,-0.22962985756548718,-53.18,IS,0.09,0.0,Phase3-EA-B1v1-GBPJPY-M30-1,GBPJPYMT4,146,3h 29m,Sell
7689.33,112.9,07.11.2007 21:29:58,tp 112.900,0.0,-128.95999999999185,0.0,0.0,113.3,07.11.2007 17:30:00,1016,-0.13183628542268708,95.66,IS,0.27,0.0,Phase3-EA-S1v2-USDJPY-M15-0,USDJPYMT4,378,3h 59m,Sell
7769.13,236112,08.11.2007 02:04:57,tp 236.112,0.0,-49.15999999998894,0.0,0.0,235722,08.11.2007 01:35:00,1017,-0.05025644999517872,79.8,IS,0.23,0.0,Phase3-EA-S4v1-GBPJPY-M5-194,GBPJPYMT4,330,29m 57s,Buy
7697.08,1.6588,08.11.2007 05:30:00,,-2.6,-121.20999999999185,0.0,0.0,1.66072,07.11.2007 21:10:00,1018,-0.12391343173141932,-72.05,IS,0.41,0.0,Phase3-EA-SA2v2-EURCHF-M5-43,EURCHFMT4,536,8h 20m,Buy
7776.68,236.47,08.11.2007 08:09:58,tp 236.470,0.0,-41.60999999998603,0.0,0.0,236.86,08.11.2007 03:35:00,1019,-0.0425380570443278,79.6,IS,0.23,0.0,Phase3-EA-S4v1-GBPJPY-M5-194,GBPJPYMT4,332,4h 34m,Sell
7746.01,1.6573,08.11.2007 10:45:00,,0.0,-72.27999999998428,0.0,0.0,1.65832,08.11.2007 02:00:00,1020,-0.07389211158770434,-30.67,IS,0.34,0.0,Phase3-EA-S4v1-EURCHF-M15-221,EURCHFMT4,304,8h 45m,Buy
7546.33,112232,08.11.2007 22:29:57,sl 112.232,0.0,-271.9599999999773,0.0,0.0,113062,08.11.2007 17:00:00,1021,-0.27802571482283844,-199.68,IS,0.27,0.0,Phase3-EA-S1v2-USDJPY-M15-0,USDJPYMT4,380,5h 29m,Buy
7586.32,1.65512,08.11.2007 23:29:57,tp 1.65512,0.0,-231.96999999997206,0.0,0.0,1.65402,08.11.2007 20:30:00,1022,-0.23714378977589148,39.99,IS,0.41,0.0,Phase3-EA-SA2v2-EURCHF-M5-43,EURCHFMT4,538,2h 59m,Buy
7624.53,1.6535,09.11.2007 00:14:58,tp 1.65350,-1.82,-193.75999999996566,0.0,0.0,1.6546,08.11.2007 23:35:00,1023,-0.19808156531867968,38.21,IS,0.41,0.0,Phase3-EA-SA2v2-EURCHF-M5-43,EURCHFMT4,540,39m 58s,Sell
7704.19,237.48,09.11.2007 04:29:58,tp 237.480,0.0,-114.09999999996217,0.0,0.0,237.87,09.11.2007 03:35:00,1024,-0.11664485240946461,79.66,IS,0.23,0.0,Phase3-EA-S4v1-GBPJPY-M5-194,GBPJPYMT4,334,54m 58s,Sell
7755.47,112422,09.11.2007 05:00:00,,-1.08,-62.81999999996333,0.0,0.0,112.64,08.11.2007 23:30:00,1025,-0.06422111856582575,51.28,IS,0.27,0.0,Phase3-EA-S1v2-USDJPY-M15-0,USDJPYMT4,382,5h 30m,Sell
7713.47,2.10862,09.11.2007 11:29:58,sl 2.10862,0.0,-104.81999999996333,0.0,0.0,2.11162,09.11.2007 07:00:00,1026,-0.10715787405398648,-42.0,IS,0.14,0.0,Phase3-EA-B1v1-GBPUSD-M30-14,GBPUSDMT4,70,4h 29m,Buy
7595.25,1.64842,09.11.2007 14:29:57,sl 1.64842,0.0,-223.0399999999645,0.0,0.0,1.65232,09.11.2007 06:00:00,1027,-0.22801461771613912,-118.22,IS,0.34,0.0,Phase3-EA-S4v1-EURCHF-M15-221,EURCHFMT4,306,8h 29m,Buy
7540.83,232.39,09.11.2007 20:59:57,sl 232.390,0.0,-277.45999999996275,0.0,0.0,231.72,09.11.2007 19:00:00,1028,-0.2836483851843684,-54.42,IS,0.09,0.0,Phase3-EA-B1v1-GBPJPY-M30-1,GBPJPYMT4,148,1h 59m,Sell
7580.99,1.6482,09.11.2007 23:39:57,tp 1.64820,0.0,-237.29999999995925,0.0,0.0,1.6493,09.11.2007 21:35:00,1029,-0.24259266850806643,40.16,IS,0.41,0.0,Phase3-EA-SA2v2-EURCHF-M5-43,EURCHFMT4,542,2h 4m,Sell
7677.58,110.55,12.11.2007 02:00:00,tp 110.550,-1.1,-140.70999999996275,0.0,0.0,110.95,09.11.2007 20:45:00,1030,-0.14384835392232131,96.59,IS,0.27,0.0,Phase3-EA-S1v2-USDJPY-M15-0,USDJPYMT4,384,2d 5h 15m,Sell
7758.74,230532,12.11.2007 02:34:59,tp 230.532,0.0,-59.549999999959255,0.0,0.0,230142,12.11.2007 02:10:00,1031,-0.06087818545995766,81.16,IS,0.23,0.0,Phase3-EA-S4v1-GBPJPY-M5-194,GBPJPYMT4,336,24m 59s,Buy
7798.88,1.64602,12.11.2007 03:04:58,tp 1.64602,0.0,-19.409999999959837,0.0,0.0,1.64492,12.11.2007 02:10:00,1032,-0.019842914857701788,40.14,IS,0.41,0.0,Phase3-EA-SA2v2-EURCHF-M5-43,EURCHFMT4,544,54m 58s,Buy
7950.46,228.55,12.11.2007 06:59:58,tp 228.550,0.0,-0.0,0.0,0.0,230.4,12.11.2007 02:30:00,1033,-0.0,151.58,IS,0.09,0.0,Phase3-EA-B1v1-GBPJPY-M30-1,GBPJPYMT4,150,4h 29m,Sell
7961.95,1.6462,12.11.2007 11:45:00,,0.0,-0.0,0.0,0.0,1.64582,12.11.2007 03:00:00,1034,-0.0,11.49,IS,0.34,0.0,Phase3-EA-S4v1-EURCHF-M15-221,EURCHFMT4,308,8h 45m,Buy
8113.41,226.65,12.11.2007 14:59:58,tp 226.650,0.0,-0.0,0.0,0.0,228.5,12.11.2007 14:00:00,1035,-0.0,151.46,IS,0.09,0.0,Phase3-EA-B1v1-GBPJPY-M30-1,GBPJPYMT4,152,59m 58s,Sell
8058.33,226.11,12.11.2007 19:59:58,sl 226.110,0.0,-55.080000000001746,0.0,0.0,225.44,12.11.2007 18:30:00,1036,-0.05613911492832802,-55.08,IS,0.09,0.0,Phase3-EA-B1v1-GBPJPY-M30-1,GBPJPYMT4,154,1h 29m,Sell
8098.27,1.6413,12.11.2007 23:54:57,tp 1.64130,0.0,-15.139999999999418,0.0,0.0,1.6424,12.11.2007 20:35:00,1037,-0.015431122004626482,39.94,IS,0.41,0.0,Phase3-EA-SA2v2-EURCHF-M5-43,EURCHFMT4,546,3h 19m,Sell
8086.81,109562,13.11.2007 00:30:00,,-1.11,-26.60000000000582,0.0,0.0,109.52,12.11.2007 19:30:00,1038,-0.027111482518042934,-11.46,IS,0.27,0.0,Phase3-EA-S1v2-USDJPY-M15-0,USDJPYMT4,386,5h 0m,Sell
7918.58,224312,13.11.2007 01:04:57,sl 224.312,0.0,-194.83000000000175,0.0,0.0,225112,13.11.2007 00:25:00,1039,-0.19857632101463144,-168.23,IS,0.23,0.0,Phase3-EA-S4v1-GBPJPY-M5-194,GBPJPYMT4,338,39m 57s,Buy
8000.47,224742,13.11.2007 01:19:58,tp 224.742,0.0,-112.94000000000233,0.0,0.0,224352,13.11.2007 01:10:00,1040,-0.11511168554838955,81.89,IS,0.23,0.0,Phase3-EA-S4v1-GBPJPY-M5-194,GBPJPYMT4,340,9m 58s,Buy
8040.42,1.64152,13.11.2007 03:34:58,tp 1.64152,0.0,-72.99000000000524,0.0,0.0,1.64042,13.11.2007 00:15:00,1041,-0.07439350033803244,39.95,IS,0.41,0.0,Phase3-EA-SA2v2-EURCHF-M5-43,EURCHFMT4,548,3h 19m,Buy
7873.47,226.72,13.11.2007 04:34:58,sl 226.720,0.0,-239.94000000000233,0.0,0.0,225.92,13.11.2007 03:45:00,1042,-0.24455372614202486,-166.95,IS,0.23,0.0,Phase3-EA-S4v1-GBPJPY-M5-194,GBPJPYMT4,342,49m 58s,Sell
7994.02,1.64402,13.11.2007 04:59:58,tp 1.64402,0.0,-119.38999999999942,0.0,0.0,1.64002,13.11.2007 01:45:00,1043,-0.1216857104446775,120.55,IS,0.34,0.0,Phase3-EA-S4v1-EURCHF-M15-221,EURCHFMT4,310,3h 14m,Buy
7957.22,1.64462,13.11.2007 14:45:00,,0.0,-156.19000000000233,0.0,0.0,1.6434,13.11.2007 06:00:00,1044,-0.15919332535685196,-36.8,IS,0.34,0.0,Phase3-EA-S4v1-EURCHF-M15-221,EURCHFMT4,312,8h 45m,Sell
8006.0,1.1261,14.11.2007 01:59:58,tp 1.12610,-2.73,-107.41000000000349,0.0,0.0,1.1271,13.11.2007 23:45:00,1045,-0.10947535102490409,48.78,IS,0.58,0.0,Phase3-EA-SA2v2-USDCHF-M15-107,USDCHFMT4,278,2h 14m,Sell
7840.5,230.56,14.11.2007 02:44:58,sl 230.560,0.0,-272.9100000000035,0.0,0.0,229.76,14.11.2007 00:40:00,1046,-0.27815769526306666,-165.5,IS,0.23,0.0,Phase3-EA-S4v1-GBPJPY-M5-194,GBPJPYMT4,344,2h 4m,Sell
7775.86,1.64572,14.11.2007 06:45:00,,-1.82,-337.5500000000029,0.0,0.0,1644,13.11.2007 22:25:00,1047,-0.34404063623922815,-64.64,IS,0.41,0.0,Phase3-EA-SA2v2-EURCHF-M5-43,EURCHFMT4,550,8h 20m,Sell
7925.43,231152,14.11.2007 09:29:58,tp 231.152,-0.29,-187.97999999999593,0.0,0.0,229302,13.11.2007 23:30:00,1048,-0.19159460465189793,149.57,IS,0.09,0.0,Phase3-EA-B1v1-GBPJPY-M30-1,GBPJPYMT4,156,9h 59m,Buy
7883.43,2.06992,14.11.2007 14:29:58,sl 2.06992,0.0,-229.97999999999593,0.0,0.0,2.07292,14.11.2007 01:30:00,1049,-0.23440220862774583,-42.0,IS,0.14,0.0,Phase3-EA-B1v1-GBPUSD-M30-14,GBPUSDMT4,72,12h 59m,Buy
7829.31,230412,14.11.2007 14:29:58,sl 230.412,0.0,-284.09999999999127,0.0,0.0,231082,14.11.2007 09:30:00,1050,-0.28956286403661935,-54.12,IS,0.09,0.0,Phase3-EA-B1v1-GBPJPY-M30-1,GBPJPYMT4,158,4h 59m,Buy
7831.74,1.6451,14.11.2007 14:30:00,,0.0,-281.66999999999825,0.0,0.0,1.64502,14.11.2007 05:45:00,1051,-0.2870861383780239,2.43,IS,0.34,0.0,Phase3-EA-S4v1-EURCHF-M15-221,EURCHFMT4,314,8h 45m,Buy
7871.93,1.6468,14.11.2007 20:59:59,tp 1.64680,0.0,-241.47999999999593,0.0,0.0,1.6479,14.11.2007 20:35:00,1052,-0.24612333828779942,40.19,IS,0.41,0.0,Phase3-EA-SA2v2-EURCHF-M5-43,EURCHFMT4,552,24m 59s,Sell
7888.38,111.59,14.11.2007 22:45:00,,0.0,-225.02999999999884,0.0,0.0,111522,14.11.2007 22:15:00,1053,-0.2293570267305953,16.45,IS,0.27,0.0,Phase3-EA-S1v2-USDJPY-M15-0,USDJPYMT4,388,30m 0s,Buy
7928.49,1.6474,14.11.2007 23:44:57,tp 1.64740,0.0,-184.91999999999825,0.0,0.0,1.6485,14.11.2007 22:40:00,1054,-0.18847576493365994,40.11,IS,0.41,0.0,Phase3-EA-SA2v2-EURCHF-M5-43,EURCHFMT4,554,1h 4m,Sell
7971.95,1.1227,15.11.2007 02:29:57,tp 1.12270,-8.2,-141.45999999999185,0.0,0.0,1.1237,14.11.2007 22:30:00,1055,-0.14418008710531177,43.46,IS,0.58,0.0,Phase3-EA-SA2v2-USDCHF-M15-107,USDCHFMT4,280,3h 59m,Sell
8012.13,1.64732,15.11.2007 08:29:57,tp 1.64732,0.0,-101.27999999999884,0.0,0.0,1.64622,15.11.2007 01:40:00,1056,-0.10322747930175774,40.18,IS,0.41,0.0,Phase3-EA-SA2v2-EURCHF-M5-43,EURCHFMT4,556,6h 49m,Buy
7996.38,1.6454,15.11.2007 12:00:00,,0.0,-117.02999999999884,0.0,0.0,1.64592,15.11.2007 03:15:00,1057,-0.1192803307927007,-15.75,IS,0.34,0.0,Phase3-EA-S4v1-EURCHF-M15-221,EURCHFMT4,316,8h 45m,Buy
8015.43,110572,15.11.2007 22:15:00,,0.0,-97.97999999999593,0.0,0.0,110.65,15.11.2007 17:45:00,1058,-0.09986402470365244,19.05,IS,0.27,0.0,Phase3-EA-S1v2-USDJPY-M15-0,USDJPYMT4,390,4h 30m,Sell
8067.13,1.1218,16.11.2007 03:14:57,tp 1.12180,0.0,-46.279999999998836,0.0,0.0,1.1228,16.11.2007 02:30:00,1059,-0.047169902666718826,51.7,IS,0.58,0.0,Phase3-EA-SA2v2-USDCHF-M15-107,USDCHFMT4,282,44m 57s,Sell
7941.25,1.6403,16.11.2007 04:25:00,,-0.88,-172.1600000000035,0.0,0.0,1.64372,15.11.2007 20:05:00,1060,-0.17547040715433626,-125.88,IS,0.41,0.0,Phase3-EA-SA2v2-EURCHF-M5-43,EURCHFMT4,558,8h 20m,Buy
8038.81,110702,16.11.2007 19:14:58,tp 110.702,0.0,-74.60000000000582,0.0,0.0,110302,16.11.2007 18:00:00,1061,-0.07603445849044053,97.56,IS,0.27,0.0,Phase3-EA-S1v2-USDJPY-M15-0,USDJPYMT4,392,1h 14m,Buy
8087.99,1.1169,19.11.2007 02:00:00,tp 1.11690,-2.75,-25.420000000012806,0.0,0.0,1.1179,16.11.2007 23:00:00,1062,-0.025908792692061946,49.18,IS,0.58,0.0,Phase3-EA-SA2v2-USDCHF-M15-107,USDCHFMT4,284,2d 3h 0m,Sell
8120.9,110.83,19.11.2007 02:00:00,,-0.71,-0.0,0.0,0.0,110692,16.11.2007 21:30:00,1063,-0.0,32.91,IS,0.27,0.0,Phase3-EA-S1v2-USDJPY-M15-0,USDJPYMT4,394,2d 4h 30m,Buy
8133.02,1.63832,19.11.2007 07:10:00,,-1.83,-0.0,0.0,0.0,1.6387,16.11.2007 22:50:00,1064,-0.0,12.12,IS,0.41,0.0,Phase3-EA-SA2v2-EURCHF-M5-43,EURCHFMT4,560,2d 8h 20m,Sell
8196.21,1.63752,19.11.2007 13:00:00,,0.0,-0.0,0.0,0.0,1.6396,19.11.2007 04:15:00,1065,-0.0,63.19,IS,0.34,0.0,Phase3-EA-S4v1-EURCHF-M15-221,EURCHFMT4,318,8h 45m,Sell
8234.93,110172,19.11.2007 18:45:00,,0.0,-0.0,0.0,0.0,110.33,19.11.2007 17:30:00,1066,-0.0,38.72,IS,0.27,0.0,Phase3-EA-S1v2-USDJPY-M15-0,USDJPYMT4,396,1h 15m,Sell
8275.37,1.63682,19.11.2007 22:44:57,tp 1.63682,0.0,-0.0,0.0,0.0,1.63572,19.11.2007 21:25:00,1067,-0.0,40.44,IS,0.41,0.0,Phase3-EA-SA2v2-EURCHF-M5-43,EURCHFMT4,562,1h 19m,Buy
8315.79,1.6358,19.11.2007 23:54:59,tp 1.63580,0.0,-0.0,0.0,0.0,1.6369,19.11.2007 23:35:00,1068,-0.0,40.42,IS,0.41,0.0,Phase3-EA-SA2v2-EURCHF-M5-43,EURCHFMT4,564,19m 59s,Sell
8367.77,1.11592,20.11.2007 04:29:59,tp 1.11592,0.0,-0.0,0.0,0.0,1.11492,20.11.2007 01:30:00,1069,-0.0,51.98,IS,0.58,0.0,Phase3-EA-SA2v2-USDCHF-M15-107,USDCHFMT4,286,2h 59m,Buy
8458.28,109782,20.11.2007 21:15:00,,0.0,-0.0,0.0,0.0,110.15,20.11.2007 18:00:00,1070,-0.0,90.51,IS,0.27,0.0,Phase3-EA-S1v2-USDJPY-M15-0,USDJPYMT4,398,3h 15m,Sell
8499.02,1.63982,20.11.2007 22:54:57,tp 1.63982,0.0,-0.0,0.0,0.0,1.63872,20.11.2007 21:10:00,1071,-0.0,40.74,IS,0.41,0.0,Phase3-EA-SA2v2-EURCHF-M5-43,EURCHFMT4,566,1h 44m,Buy
8560.12,109592,21.11.2007 03:15:00,,0.0,-0.0,0.0,0.0,109.84,21.11.2007 01:15:00,1072,-0.0,61.1,IS,0.27,0.0,Phase3-EA-S1v2-USDJPY-M15-0,USDJPYMT4,400,2h 0m,Sell
8392.16,226082,21.11.2007 07:19:58,sl 226.082,0.0,-167.9600000000064,0.0,0.0,226882,21.11.2007 02:45:00,1073,-0.1704137535546895,-167.96,IS,0.23,0.0,Phase3-EA-S4v1-GBPJPY-M5-194,GBPJPYMT4,346,4h 34m,Buy
8431.14,1.6391,21.11.2007 07:19:59,tp 1.63910,-1.85,-128.98000000001048,0.0,0.0,1.6402,20.11.2007 23:50:00,1074,-0.13086428872043818,38.98,IS,0.41,0.0,Phase3-EA-SA2v2-EURCHF-M5-43,EURCHFMT4,568,7h 29m,Sell
8584.3,223.97,21.11.2007 12:59:58,tp 223.970,0.0,-0.0,0.0,0.0,225.82,21.11.2007 07:30:00,1075,-0.0,153.16,IS,0.09,0.0,Phase3-EA-B1v1-GBPJPY-M30-1,GBPJPYMT4,160,5h 29m,Sell
8598.73,108552,21.11.2007 19:15:00,,0.0,-0.0,0.0,0.0,108.61,21.11.2007 17:00:00,1076,-0.0,14.43,IS,0.27,0.0,Phase3-EA-S1v2-USDJPY-M15-0,USDJPYMT4,402,2h 15m,Sell
8608.19,108512,21.11.2007 19:30:00,,0.0,-0.0,0.0,0.0,108.55,21.11.2007 19:15:00,1077,-0.0,9.46,IS,0.27,0.0,Phase3-EA-S1v2-USDJPY-M15-0,USDJPYMT4,404,15m 0s,Sell
8658.89,1.10262,22.11.2007 00:14:58,tp 1.10262,-1.9,-0.0,0.0,0.0,1.10162,21.11.2007 23:30:00,1078,-0.0,50.7,IS,0.58,0.0,Phase3-EA-SA2v2-USDCHF-M15-107,USDCHFMT4,288,44m 58s,Buy
8694.25,1.6366,22.11.2007 00:44:57,tp 1.63660,-5.58,-0.0,0.0,0.0,1.6377,21.11.2007 23:10:00,1079,-0.0,35.36,IS,0.41,0.0,Phase3-EA-SA2v2-EURCHF-M5-43,EURCHFMT4,570,1h 34m,Sell
8776.91,224052,22.11.2007 01:04:58,tp 224.052,0.0,-0.0,0.0,0.0,223662,22.11.2007 00:25:00,1080,-0.0,82.66,IS,0.23,0.0,Phase3-EA-S4v1-GBPJPY-M5-194,GBPJPYMT4,348,39m 58s,Buy
8731.54,1636,22.11.2007 09:55:00,,0.0,-45.36999999999534,0.0,0.0,1.63722,22.11.2007 01:35:00,1081,-0.045931787094772754,-45.37,IS,0.41,0.0,Phase3-EA-SA2v2-EURCHF-M5-43,EURCHFMT4,572,8h 20m,Buy
8855.06,1.6336,22.11.2007 11:44:58,tp 1.63360,0.0,-0.0,0.0,0.0,1.6376,22.11.2007 06:00:00,1082,-0.0,123.52,IS,0.34,0.0,Phase3-EA-S4v1-EURCHF-M15-221,EURCHFMT4,320,5h 44m,Sell
8813.06,2.06252,22.11.2007 12:29:58,sl 2.06252,0.0,-42.0,0.0,0.0,2.06552,22.11.2007 11:00:00,1083,-0.04248644429531473,-42.0,IS,0.14,0.0,Phase3-EA-B1v1-GBPUSD-M30-14,GBPUSDMT4,74,1h 29m,Buy
8895.69,223982,23.11.2007 03:39:57,tp 223.982,0.0,-0.0,0.0,0.0,223592,23.11.2007 00:50:00,1084,-0.0,82.63,IS,0.23,0.0,Phase3-EA-S4v1-GBPJPY-M5-194,GBPJPYMT4,350,2h 49m,Buy
8948.41,1.1002,23.11.2007 04:14:57,tp 1.10020,0.0,-0.0,0.0,0.0,1.1012,23.11.2007 02:00:00,1085,-0.0,52.72,IS,0.58,0.0,Phase3-EA-SA2v2-USDCHF-M15-107,USDCHFMT4,290,2h 14m,Sell
8941.63,1.6328,23.11.2007 13:45:00,,0.0,-6.779999999998836,0.0,0.0,1.63302,23.11.2007 05:00:00,1086,-0.006852055530754691,-6.78,IS,0.34,0.0,Phase3-EA-S4v1-EURCHF-M15-221,EURCHFMT4,322,8h 45m,Buy
8941.13,107.95,23.11.2007 19:30:00,,0.0,-7.279999999998836,0.0,0.0,107952,23.11.2007 17:15:00,1087,-0.007357369360456451,-0.5,IS,0.27,0.0,Phase3-EA-S1v2-USDJPY-M15-0,USDJPYMT4,406,2h 15m,Buy
8982.05,1.6349,23.11.2007 21:04:57,tp 1.63490,0.0,-0.0,0.0,0.0,1636,23.11.2007 20:45:00,1088,-0.0,40.92,IS,0.41,0.0,Phase3-EA-SA2v2-EURCHF-M5-43,EURCHFMT4,574,19m 57s,Sell
9064.62,223.93,26.11.2007 03:09:57,tp 223.930,0.0,-0.0,0.0,0.0,224.32,26.11.2007 02:50:00,1089,-0.0,82.57,IS,0.23,0.0,Phase3-EA-S4v1-GBPJPY-M5-194,GBPJPYMT4,352,19m 57s,Sell
9013.07,108152,26.11.2007 06:15:00,,-1.12,-51.55000000000291,0.0,0.0,107.95,23.11.2007 19:30:00,1090,-0.052036741270498836,-51.55,IS,0.27,0.0,Phase3-EA-S1v2-USDJPY-M15-0,USDJPYMT4,408,2d 10h 45m,Sell
9008.6,1.63712,26.11.2007 10:45:00,,0.0,-56.020000000004075,0.0,0.0,1637,26.11.2007 02:25:00,1091,-0.056548947545555624,-4.47,IS,0.41,0.0,Phase3-EA-SA2v2-EURCHF-M5-43,EURCHFMT4,576,8h 20m,Sell
8837.42,222392,26.11.2007 23:54:59,sl 222.392,0.0,-227.1999999999971,0.0,0.0,223192,26.11.2007 23:20:00,1092,-0.2293452495956647,-171.18,IS,0.23,0.0,Phase3-EA-S4v1-GBPJPY-M5-194,GBPJPYMT4,354,34m 59s,Buy
8921.0,222472,27.11.2007 00:34:57,tp 222.472,0.0,-143.61999999999534,0.0,0.0,222082,27.11.2007 00:05:00,1093,-0.14497607723120037,83.58,IS,0.23,0.0,Phase3-EA-S4v1-GBPJPY-M5-194,GBPJPYMT4,356,29m 57s,Buy
8973.88,1.09682,27.11.2007 01:44:58,tp 1.09682,0.0,-90.73999999999069,0.0,0.0,1.09582,27.11.2007 00:15:00,1094,-0.09159677794149977,52.88,IS,0.58,0.0,Phase3-EA-SA2v2-USDCHF-M15-107,USDCHFMT4,292,1h 29m,Buy
8957.31,1634,27.11.2007 06:20:00,,-0.9,-107.30999999999767,0.0,0.0,1.63442,26.11.2007 22:00:00,1095,-0.10832323386492325,-16.57,IS,0.41,0.0,Phase3-EA-SA2v2-EURCHF-M5-43,EURCHFMT4,578,8h 20m,Buy
9080.99,1.63512,27.11.2007 06:59:58,tp 1.63512,0.0,-0.0,0.0,0.0,1.63112,27.11.2007 01:30:00,1096,-0.0,123.68,IS,0.34,0.0,Phase3-EA-S4v1-EURCHF-M15-221,EURCHFMT4,324,5h 29m,Buy
9038.99,2.06812,27.11.2007 11:59:57,sl 2.06812,0.0,-42.0,0.0,0.0,2.07112,27.11.2007 00:30:00,1097,-0.04238956433519684,-42.0,IS,0.14,0.0,Phase3-EA-B1v1-GBPUSD-M30-14,GBPUSDMT4,76,11h 29m,Buy
9138.22,108842,27.11.2007 23:59:58,tp 108.842,0.0,-0.0,0.0,0.0,108442,27.11.2007 22:45:00,1098,-0.0,99.23,IS,0.27,0.0,Phase3-EA-S1v2-USDJPY-M15-0,USDJPYMT4,410,1h 14m,Buy
9190.06,1.10532,28.11.2007 00:30:00,tp 1.10532,-0.63,-0.0,0.0,0.0,1.10432,27.11.2007 23:45:00,1099,-0.0,51.84,IS,0.58,0.0,Phase3-EA-SA2v2-USDCHF-M15-107,USDCHFMT4,294,45m 0s,Buy
9272.43,225.19,28.11.2007 01:19:59,tp 225.190,0.0,-0.0,0.0,0.0,225.58,28.11.2007 00:45:00,1100,-0.0,82.37,IS,0.23,0.0,Phase3-EA-S4v1-GBPJPY-M5-194,GBPJPYMT4,358,34m 59s,Sell
9324.95,1.1044,28.11.2007 03:29:58,tp 1.10440,0.0,-0.0,0.0,0.0,1.1054,28.11.2007 00:45:00,1101,-0.0,52.52,IS,0.58,0.0,Phase3-EA-SA2v2-USDCHF-M15-107,USDCHFMT4,296,2h 44m,Sell
9329.77,1.63752,28.11.2007 04:30:00,,-1.86,-0.0,0.0,0.0,1.6377,27.11.2007 20:10:00,1102,-0.0,4.82,IS,0.41,0.0,Phase3-EA-SA2v2-EURCHF-M5-43,EURCHFMT4,580,8h 20m,Sell
9412.31,224692,28.11.2007 04:54:58,tp 224.692,0.0,-0.0,0.0,0.0,224302,28.11.2007 03:50:00,1103,-0.0,82.54,IS,0.23,0.0,Phase3-EA-S4v1-GBPJPY-M5-194,GBPJPYMT4,360,1h 4m,Buy
9457.8,1.63822,28.11.2007 10:15:00,,0.0,-0.0,0.0,0.0,1.6397,28.11.2007 01:30:00,1104,-0.0,45.49,IS,0.34,0.0,Phase3-EA-S4v1-EURCHF-M15-221,EURCHFMT4,326,8h 45m,Sell
9498.2,1.6486,28.11.2007 20:59:57,tp 1.64860,0.0,-0.0,0.0,0.0,1.6497,28.11.2007 20:05:00,1105,-0.0,40.4,IS,0.41,0.0,Phase3-EA-SA2v2-EURCHF-M5-43,EURCHFMT4,582,54m 57s,Sell
9538.68,1.6495,28.11.2007 22:29:58,tp 1.64950,0.0,-0.0,0.0,0.0,1.6506,28.11.2007 22:05:00,1106,-0.0,40.48,IS,0.41,0.0,Phase3-EA-SA2v2-EURCHF-M5-43,EURCHFMT4,584,24m 58s,Sell
9590.85,1.11172,28.11.2007 23:59:57,tp 1.11172,0.0,-0.0,0.0,0.0,1.11072,28.11.2007 23:15:00,1107,-0.0,52.17,IS,0.58,0.0,Phase3-EA-SA2v2-USDCHF-M15-107,USDCHFMT4,298,44m 57s,Buy
9535.14,228122,29.11.2007 02:29:58,sl 228.122,-0.88,-55.7100000000064,0.0,0.0,228792,28.11.2007 22:00:00,1108,-0.05593887390257875,-55.71,IS,0.09,0.0,Phase3-EA-B1v1-GBPJPY-M30-1,GBPJPYMT4,162,4h 29m,Buy
9552.13,110.17,29.11.2007 04:15:00,,-2.13,-38.720000000001164,0.0,0.0,110092,28.11.2007 23:15:00,1109,-0.03887907373016811,16.99,IS,0.27,0.0,Phase3-EA-S1v2-USDJPY-M15-0,USDJPYMT4,412,5h 0m,Buy
9633.52,229062,29.11.2007 04:59:58,tp 229.062,0.0,-0.0,0.0,0.0,228672,29.11.2007 01:25:00,1110,-0.0,81.39,IS,0.23,0.0,Phase3-EA-S4v1-GBPJPY-M5-194,GBPJPYMT4,362,3h 34m,Buy
9671.42,1.65012,29.11.2007 06:14:58,tp 1.65012,-2.66,-0.0,0.0,0.0,1.64902,28.11.2007 23:05:00,1111,-0.0,37.9,IS,0.41,0.0,Phase3-EA-SA2v2-EURCHF-M5-43,EURCHFMT4,586,7h 9m,Buy
9640.23,1.6472,29.11.2007 11:00:00,,0.0,-31.19000000000233,0.0,0.0,1.64822,29.11.2007 02:15:00,1112,-0.03129282195438,-31.19,IS,0.34,0.0,Phase3-EA-S4v1-EURCHF-M15-221,EURCHFMT4,328,8h 45m,Buy
9585.3,226.97,29.11.2007 19:59:57,sl 226.970,0.0,-86.11999999999534,0.0,0.0,226.3,29.11.2007 17:30:00,1113,-0.0864039059541795,-54.93,IS,0.09,0.0,Phase3-EA-B1v1-GBPJPY-M30-1,GBPJPYMT4,164,2h 29m,Sell
9625.67,1.64922,29.11.2007 22:29:57,tp 1.64922,0.0,-45.75,0.0,0.0,1.64812,29.11.2007 22:00:00,1114,-0.04590082091737025,40.37,IS,0.41,0.0,Phase3-EA-SA2v2-EURCHF-M5-43,EURCHFMT4,588,29m 57s,Buy
9665.12,1.64902,30.11.2007 01:29:58,tp 1.64902,-0.88,-6.30000000000291,0.0,0.0,1.64792,29.11.2007 23:20:00,1115,-0.00632076878206702,39.45,IS,0.41,0.0,Phase3-EA-SA2v2-EURCHF-M5-43,EURCHFMT4,590,2h 9m,Buy
9714.3,1.1168,30.11.2007 02:59:58,tp 1.11680,-2.75,-0.0,0.0,0.0,1.1178,29.11.2007 23:45:00,1116,-0.0,49.18,IS,0.58,0.0,Phase3-EA-SA2v2-USDCHF-M15-107,USDCHFMT4,300,3h 14m,Sell
9619.56,110162,30.11.2007 10:45:00,,-1.11,-94.74000000000524,0.0,0.0,109.78,29.11.2007 22:45:00,1117,-0.09501144770610148,-94.74,IS,0.27,0.0,Phase3-EA-S1v2-USDJPY-M15-0,USDJPYMT4,414,12h 0m,Sell
9500.97,1.6538,30.11.2007 13:29:59,sl 1.65380,0.0,-213.33000000000175,0.0,0.0,1.6499,30.11.2007 05:30:00,1118,-0.21394123009438118,-118.59,IS,0.34,0.0,Phase3-EA-S4v1-EURCHF-M15-221,EURCHFMT4,330,7h 59m,Sell
9539.4,111.0,30.11.2007 20:00:00,,0.0,-174.90000000000873,0.0,0.0,110842,30.11.2007 19:30:00,1119,-0.17540112100271332,38.43,IS,0.27,0.0,Phase3-EA-S1v2-USDJPY-M15-0,USDJPYMT4,416,30m 0s,Buy
9575.38,111.06,30.11.2007 22:30:00,,0.0,-138.9200000000128,0.0,0.0,110912,30.11.2007 20:30:00,1120,-0.13931803161634057,35.98,IS,0.27,0.0,Phase3-EA-S1v2-USDJPY-M15-0,USDJPYMT4,418,2h 0m,Buy
9486.49,1.6534,03.12.2007 05:15:00,,-0.87,-227.81000000001222,0.0,0.0,1.65582,30.11.2007 20:55:00,1121,-0.228462717985296,-88.89,IS,0.41,0.0,Phase3-EA-SA2v2-EURCHF-M5-43,EURCHFMT4,592,2d 8h 20m,Buy
9415.34,227.41,03.12.2007 09:15:00,,0.0,-298.9600000000064,0.0,0.0,227752,03.12.2007 03:50:00,1122,-0.29981657595751676,-71.15,IS,0.23,0.0,Phase3-EA-S4v1-GBPJPY-M5-194,GBPJPYMT4,364,5h 25m,Buy
9471.91,1.6554,03.12.2007 15:15:00,,0.0,-242.38999999999942,0.0,0.0,1.65352,03.12.2007 06:30:00,1123,-0.24308449239477106,56.57,IS,0.34,0.0,Phase3-EA-S4v1-EURCHF-M15-221,EURCHFMT4,332,8h 45m,Buy
9523.35,1.12742,04.12.2007 01:44:58,tp 1.12742,0.0,-190.9499999999971,0.0,0.0,1.12642,04.12.2007 00:15:00,1124,-0.19149710723536836,51.44,IS,0.58,0.0,Phase3-EA-SA2v2-USDCHF-M15-107,USDCHFMT4,302,1h 29m,Buy
9522.86,110.44,04.12.2007 02:15:00,,0.0,-191.44000000000233,0.0,0.0,110442,04.12.2007 00:45:00,1125,-0.19198851117643323,-0.49,IS,0.27,0.0,Phase3-EA-S1v2-USDJPY-M15-0,USDJPYMT4,420,1h 30m,Buy
9506.73,1.6538,04.12.2007 06:20:00,,-0.87,-207.57000000000698,0.0,0.0,1.65422,03.12.2007 22:00:00,1126,-0.20816472662397148,-16.13,IS,0.41,0.0,Phase3-EA-SA2v2-EURCHF-M5-43,EURCHFMT4,594,8h 20m,Buy
9464.73,2.06412,04.12.2007 11:29:58,sl 2.06412,0.0,-249.57000000000698,0.0,0.0,2.06712,04.12.2007 11:00:00,1127,-0.2502850644290806,-42.0,IS,0.14,0.0,Phase3-EA-B1v1-GBPUSD-M30-14,GBPUSDMT4,78,29m 58s,Buy
9422.73,2.0638,04.12.2007 14:29:58,sl 2.06380,0.0,-291.570000000007,0.0,0.0,2.0608,04.12.2007 12:30:00,1128,-0.2924054022341898,-42.0,IS,0.14,0.0,Phase3-EA-B1v1-GBPUSD-M30-14,GBPUSDMT4,80,1h 59m,Sell
9446.83,109772,04.12.2007 19:15:00,,0.0,-267.47000000000116,0.0,0.0,109.87,04.12.2007 18:45:00,1129,-0.26823635125553796,24.1,IS,0.27,0.0,Phase3-EA-S1v2-USDJPY-M15-0,USDJPYMT4,422,30m 0s,Sell
9487.22,1.6489,04.12.2007 23:19:57,tp 1.64890,0.0,-227.08000000000175,0.0,0.0,1.65,04.12.2007 22:55:00,1130,-0.22773062639962527,40.39,IS,0.41,0.0,Phase3-EA-SA2v2-EURCHF-M5-43,EURCHFMT4,596,24m 57s,Sell
9527.62,1.64882,05.12.2007 01:14:58,tp 1.64882,0.0,-186.68000000000757,0.0,0.0,1.64772,05.12.2007 00:10:00,1131,-0.18721487289185942,40.4,IS,0.41,0.0,Phase3-EA-SA2v2-EURCHF-M5-43,EURCHFMT4,598,1h 4m,Buy
9535.86,109732,05.12.2007 01:15:00,,-1.11,-178.44000000000233,0.0,0.0,109.77,04.12.2007 19:15:00,1132,-0.1789512637605661,8.24,IS,0.27,0.0,Phase3-EA-S1v2-USDJPY-M15-0,USDJPYMT4,424,6h 0m,Sell
9576.21,1.6481,05.12.2007 04:09:57,tp 1.64810,0.0,-138.0899999999965,0.0,0.0,1.6492,05.12.2007 02:35:00,1133,-0.1384856535120804,40.35,IS,0.41,0.0,Phase3-EA-SA2v2-EURCHF-M5-43,EURCHFMT4,600,1h 34m,Sell
9628.19,1.1158,05.12.2007 06:59:58,tp 1.11580,0.0,-86.11000000000058,0.0,0.0,1.1168,05.12.2007 02:45:00,1134,-0.08635672115233271,51.98,IS,0.58,0.0,Phase3-EA-SA2v2-USDCHF-M15-107,USDCHFMT4,304,4h 14m,Sell
9668.31,1.6491,05.12.2007 20:59:58,tp 1.64910,0.0,-45.99000000000524,0.0,0.0,1.6502,05.12.2007 20:30:00,1135,-0.04612176989659978,40.12,IS,0.41,0.0,Phase3-EA-SA2v2-EURCHF-M5-43,EURCHFMT4,602,29m 58s,Sell
9705.69,1.64902,06.12.2007 04:09:58,tp 1.64902,-2.62,-8.610000000000582,0.0,0.0,1.64792,05.12.2007 21:15:00,1136,-0.00863466925004796,37.38,IS,0.41,0.0,Phase3-EA-SA2v2-EURCHF-M5-43,EURCHFMT4,604,6h 54m,Buy
9800.84,111032,06.12.2007 04:14:58,tp 111.032,-2.12,-0.0,0.0,0.0,110632,05.12.2007 21:00:00,1137,-0.0,95.15,IS,0.27,0.0,Phase3-EA-S1v2-USDJPY-M15-0,USDJPYMT4,426,7h 14m,Buy
9827.3,1.64772,06.12.2007 13:30:00,,0.0,-0.0,0.0,0.0,1.6486,06.12.2007 04:45:00,1138,-0.0,26.46,IS,0.34,0.0,Phase3-EA-S4v1-EURCHF-M15-221,EURCHFMT4,334,8h 45m,Sell
9907.85,225.61,06.12.2007 23:49:59,tp 225.610,0.0,-0.0,0.0,0.0,226.0,06.12.2007 23:00:00,1139,-0.0,80.55,IS,0.23,0.0,Phase3-EA-S4v1-GBPJPY-M5-194,GBPJPYMT4,366,49m 59s,Sell
9931.61,111.38,07.12.2007 03:00:00,,0.0,-0.0,0.0,0.0,111282,07.12.2007 00:15:00,1140,-0.0,23.76,IS,0.27,0.0,Phase3-EA-S1v2-USDJPY-M15-0,USDJPYMT4,428,2h 45m,Buy
9871.01,1.65382,07.12.2007 05:15:00,,-1.81,-60.60000000000582,0.0,0.0,1.6522,06.12.2007 20:55:00,1141,-0.060641472703187475,-60.6,IS,0.41,0.0,Phase3-EA-SA2v2-EURCHF-M5-43,EURCHFMT4,606,8h 20m,Sell
9892.29,111.64,07.12.2007 18:45:00,,0.0,-39.320000000006985,0.0,0.0,111552,07.12.2007 18:00:00,1142,-0.03934690935131231,21.28,IS,0.27,0.0,Phase3-EA-S1v2-USDJPY-M15-0,USDJPYMT4,430,45m 0s,Buy
9891.81,111.64,07.12.2007 19:00:00,,0.0,-39.80000000000291,0.0,0.0,111642,07.12.2007 18:45:00,1143,-0.0398272378479671,-0.48,IS,0.27,0.0,Phase3-EA-S1v2-USDJPY-M15-0,USDJPYMT4,432,15m 0s,Buy
9931.74,1.6554,07.12.2007 20:59:57,tp 1.65540,0.0,-0.0,0.0,0.0,1.6565,07.12.2007 20:00:00,1144,-0.0,39.93,IS,0.41,0.0,Phase3-EA-SA2v2-EURCHF-M5-43,EURCHFMT4,608,59m 57s,Sell
9983.14,1.12842,10.12.2007 02:59:57,tp 1.12842,0.0,-0.0,0.0,0.0,1.12742,10.12.2007 02:45:00,1145,-0.0,51.4,IS,0.58,0.0,Phase3-EA-SA2v2-USDCHF-M15-107,USDCHFMT4,306,14m 57s,Buy
9967.02,1.6534,10.12.2007 05:50:00,,-0.87,-16.119999999995343,0.0,0.0,1.65382,07.12.2007 21:30:00,1146,-0.016122718290299078,-16.12,IS,0.41,0.0,Phase3-EA-SA2v2-EURCHF-M5-43,EURCHFMT4,610,2d 8h 20m,Buy
10038.67,1.6554,10.12.2007 11:45:00,,0.0,-0.0,0.0,0.0,1.65302,10.12.2007 03:00:00,1147,-0.0,71.65,IS,0.34,0.0,Phase3-EA-S4v1-EURCHF-M15-221,EURCHFMT4,336,8h 45m,Buy
10028.85,1.65962,11.12.2007 05:10:00,,-1.82,-9.820000000006985,0.0,0.0,1.6594,10.12.2007 20:50:00,1148,-0.009816204073891605,-9.82,IS,0.41,0.0,Phase3-EA-SA2v2-EURCHF-M5-43,EURCHFMT4,612,8h 20m,Sell
9981.49,1.1268,11.12.2007 06:30:00,,0.0,-57.18000000000757,0.0,0.0,1.12772,11.12.2007 02:15:00,1149,-0.057157897041221685,-47.36,IS,0.58,0.0,Phase3-EA-SA2v2-USDCHF-M15-107,USDCHFMT4,308,4h 15m,Buy
9927.67,229082,11.12.2007 14:29:58,sl 229.082,0.0,-111.00000000001455,0.0,0.0,229752,11.12.2007 13:00:00,1150,-0.11095709289219306,-53.82,IS,0.09,0.0,Phase3-EA-B1v1-GBPJPY-M30-1,GBPJPYMT4,166,1h 29m,Buy
9967.48,1.6654,11.12.2007 21:25:00,tp 1.66540,0.0,-71.19000000001688,0.0,0.0,1.6665,11.12.2007 20:25:00,1151,-0.07116248146843299,39.81,IS,0.41,0.0,Phase3-EA-SA2v2-EURCHF-M5-43,EURCHFMT4,614,1h 0m,Sell
10116.51,226.7,11.12.2007 22:29:58,tp 226.700,0.0,-0.0,0.0,0.0,228.55,11.12.2007 17:30:00,1152,-0.0,149.03,IS,0.09,0.0,Phase3-EA-B1v1-GBPJPY-M30-1,GBPJPYMT4,168,4h 59m,Sell
10213.51,111.34,11.12.2007 22:29:58,tp 111.340,0.0,-0.0,0.0,0.0,111.74,11.12.2007 20:15:00,1153,-0.0,97.0,IS,0.27,0.0,Phase3-EA-S1v2-USDJPY-M15-0,USDJPYMT4,434,2h 14m,Sell
10264.74,1.13212,11.12.2007 22:44:57,tp 1.13212,0.0,-0.0,0.0,0.0,1.13112,11.12.2007 22:30:00,1154,-0.0,51.23,IS,0.58,0.0,Phase3-EA-SA2v2-USDCHF-M15-107,USDCHFMT4,310,14m 57s,Buy
10087.07,1.65732,11.12.2007 23:44:57,sl 1.65732,0.0,-177.66999999999825,0.0,0.0,1.66222,11.12.2007 22:30:00,1155,-0.17720087839453647,-177.67,IS,0.41,0.0,Phase3-EA-SA2v2-EURCHF-M5-43,EURCHFMT4,616,1h 14m,Buy
10126.96,1.65842,12.12.2007 01:04:57,tp 1.65842,0.0,-137.77999999999884,0.0,0.0,1.65732,12.12.2007 00:30:00,1156,-0.1374162043406274,39.89,IS,0.41,0.0,Phase3-EA-SA2v2-EURCHF-M5-43,EURCHFMT4,618,34m 57s,Buy
10166.89,1.65642,12.12.2007 02:34:58,tp 1.65642,0.0,-97.85000000000582,0.0,0.0,1.65532,12.12.2007 01:35:00,1157,-0.09759163590311586,39.93,IS,0.41,0.0,Phase3-EA-SA2v2-EURCHF-M5-43,EURCHFMT4,620,59m 58s,Buy
10218.23,1.12982,12.12.2007 02:44:57,tp 1.12982,0.0,-46.51000000000931,0.0,0.0,1.12882,12.12.2007 01:45:00,1158,-0.04638719454118097,51.34,IS,0.58,0.0,Phase3-EA-SA2v2-USDCHF-M15-107,USDCHFMT4,312,59m 57s,Buy
10338.5,1.66012,12.12.2007 08:59:57,tp 1.66012,0.0,-0.0,0.0,0.0,1.65612,12.12.2007 02:15:00,1159,-0.0,120.27,IS,0.34,0.0,Phase3-EA-S4v1-EURCHF-M15-221,EURCHFMT4,338,6h 44m,Buy
10238.66,226382,12.12.2007 09:15:00,,0.0,-99.83999999999651,0.0,0.0,225.9,12.12.2007 03:50:00,1160,-0.09950318172984095,-99.84,IS,0.23,0.0,Phase3-EA-S4v1-GBPJPY-M5-194,GBPJPYMT4,368,5h 25m,Sell
10386.76,229522,12.12.2007 17:29:58,tp 229.522,0.0,-0.0,0.0,0.0,227672,12.12.2007 16:30:00,1161,-0.0,148.1,IS,0.09,0.0,Phase3-EA-B1v1-GBPJPY-M30-1,GBPJPYMT4,170,59m 58s,Buy
10426.51,1.66742,12.12.2007 21:14:57,tp 1.66742,0.0,-0.0,0.0,0.0,1.66632,12.12.2007 20:50:00,1162,-0.0,39.75,IS,0.41,0.0,Phase3-EA-SA2v2-EURCHF-M5-43,EURCHFMT4,622,24m 57s,Buy
10506.56,229562,12.12.2007 23:59:57,tp 229.562,0.0,-0.0,0.0,0.0,229172,12.12.2007 23:10:00,1163,-0.0,80.05,IS,0.23,0.0,Phase3-EA-S4v1-GBPJPY-M5-194,GBPJPYMT4,370,49m 57s,Buy
10543.74,1.66802,13.12.2007 00:04:57,tp 1.66802,-2.6,-0.0,0.0,0.0,1.66692,12.12.2007 23:30:00,1164,-0.0,37.18,IS,0.41,0.0,Phase3-EA-SA2v2-EURCHF-M5-43,EURCHFMT4,624,34m 57s,Buy
10583.51,1.6679,13.12.2007 03:09:57,tp 1.66790,0.0,-0.0,0.0,0.0,1669,13.12.2007 02:20:00,1165,-0.0,39.77,IS,0.41,0.0,Phase3-EA-SA2v2-EURCHF-M5-43,EURCHFMT4,626,49m 57s,Sell
10663.61,229242,13.12.2007 06:09:58,tp 229.242,0.0,-0.0,0.0,0.0,228852,13.12.2007 03:15:00,1166,-0.0,80.1,IS,0.23,0.0,Phase3-EA-S4v1-GBPJPY-M5-194,GBPJPYMT4,372,2h 54m,Buy
10639.32,111.9,13.12.2007 14:00:00,,-2.09,-24.289999999993597,0.0,0.0,111992,12.12.2007 21:00:00,1167,-0.024129871758020185,-24.29,IS,0.27,0.0,Phase3-EA-S1v2-USDJPY-M15-0,USDJPYMT4,436,17h 0m,Buy
10679.03,112.25,14.12.2007 01:15:00,,-0.7,-0.0,0.0,0.0,112082,13.12.2007 20:45:00,1168,-0.0,39.71,IS,0.27,0.0,Phase3-EA-S1v2-USDJPY-M15-0,USDJPYMT4,438,4h 30m,Buy
10654.95,1.66972,14.12.2007 07:35:00,,-1.8,-24.080000000001746,0.0,0.0,1.6691,13.12.2007 23:15:00,1169,-0.023917592372514642,-24.08,IS,0.41,0.0,Phase3-EA-SA2v2-EURCHF-M5-43,EURCHFMT4,628,8h 20m,Sell
10734.78,229.0,14.12.2007 07:54:58,tp 229.000,0.0,-0.0,0.0,0.0,229.39,14.12.2007 03:00:00,1170,-0.0,79.83,IS,0.23,0.0,Phase3-EA-S4v1-GBPJPY-M5-194,GBPJPYMT4,374,4h 54m,Sell
10778.82,1.66862,14.12.2007 11:30:00,,0.0,-0.0,0.0,0.0,1.6701,14.12.2007 02:45:00,1171,-0.0,44.04,IS,0.34,0.0,Phase3-EA-S4v1-EURCHF-M15-221,EURCHFMT4,340,8h 45m,Sell
10874.24,113182,14.12.2007 18:29:58,tp 113.182,0.0,-0.0,0.0,0.0,112782,14.12.2007 17:15:00,1172,-0.0,95.42,IS,0.27,0.0,Phase3-EA-S1v2-USDJPY-M15-0,USDJPYMT4,440,1h 14m,Buy
10912.52,1.66422,17.12.2007 02:00:00,tp 1.66422,-0.85,-0.0,0.0,0.0,1.66312,14.12.2007 23:20:00,1173,-0.0,38.28,IS,0.41,0.0,Phase3-EA-SA2v2-EURCHF-M5-43,EURCHFMT4,630,2d 2h 40m,Buy
10875.59,1.1497,18.12.2007 02:30:00,,-0.61,-36.929999999993015,0.0,0.0,1.15042,17.12.2007 22:15:00,1174,-0.03659605369085322,-36.93,IS,0.58,0.0,Phase3-EA-SA2v2-USDCHF-M15-107,USDCHFMT4,314,4h 15m,Buy
10809.93,113.04,18.12.2007 04:30:00,,-0.69,-102.58999999999651,0.0,0.0,113312,17.12.2007 17:15:00,1175,-0.10166231107893892,-65.66,IS,0.27,0.0,Phase3-EA-S1v2-USDJPY-M15-0,USDJPYMT4,442,11h 15m,Buy
10808.36,1.6562,18.12.2007 04:30:00,,-0.86,-104.16000000000349,0.0,0.0,1.65622,17.12.2007 20:10:00,1176,-0.10321811406553263,-1.57,IS,0.41,0.0,Phase3-EA-SA2v2-EURCHF-M5-43,EURCHFMT4,632,8h 20m,Buy
10805.5,113.32,18.12.2007 23:30:00,,0.0,-107.02000000000407,0.0,0.0,113332,18.12.2007 17:00:00,1177,-0.10605225199014355,-2.86,IS,0.27,0.0,Phase3-EA-S1v2-USDJPY-M15-0,USDJPYMT4,444,6h 30m,Buy
10767.41,1.66082,19.12.2007 07:10:00,,-1.78,-145.11000000000058,0.0,0.0,1.6598,18.12.2007 22:50:00,1178,-0.14379781616790513,-38.09,IS,0.41,0.0,Phase3-EA-SA2v2-EURCHF-M5-43,EURCHFMT4,634,8h 20m,Sell
10819.98,1.65852,19.12.2007 14:45:00,,0.0,-92.5399999999936,0.0,0.0,1.6603,19.12.2007 06:00:00,1179,-0.09170319005014793,52.57,IS,0.34,0.0,Phase3-EA-S4v1-EURCHF-M15-221,EURCHFMT4,342,8h 45m,Sell
10859.02,1.65982,19.12.2007 22:09:58,tp 1.65982,0.0,-53.5,0.0,0.0,1.65872,19.12.2007 20:05:00,1180,-0.053016216421906785,39.04,IS,0.41,0.0,Phase3-EA-SA2v2-EURCHF-M5-43,EURCHFMT4,636,2h 4m,Buy
10779.07,113312,20.12.2007 01:15:00,,-3.22,-133.4499999999971,0.0,0.0,112.99,19.12.2007 17:00:00,1181,-0.13224325385987487,-79.95,IS,0.27,0.0,Phase3-EA-S1v2-USDJPY-M15-0,USDJPYMT4,446,8h 15m,Sell
10776.59,1.66052,20.12.2007 06:40:00,,-5.32,-135.92999999999302,0.0,0.0,1.6606,19.12.2007 22:20:00,1182,-0.1347008280042882,-2.48,IS,0.41,0.0,Phase3-EA-SA2v2-EURCHF-M5-43,EURCHFMT4,638,8h 20m,Sell
10794.46,226.28,20.12.2007 07:15:00,,0.0,-118.05999999999767,0.0,0.0,226192,20.12.2007 01:50:00,1183,-0.11699242076205965,17.87,IS,0.23,0.0,Phase3-EA-S4v1-GBPJPY-M5-194,GBPJPYMT4,376,5h 25m,Buy
11057.0,1.9882,20.12.2007 11:29:58,tp 1.98820,-2.06,-0.0,0.0,0.0,2.0071,19.12.2007 13:00:00,1184,-0.0,262.54,IS,0.14,0.0,Phase3-EA-B1v1-GBPUSD-M30-14,GBPUSDMT4,82,22h 29m,Sell
11107.16,1.15622,20.12.2007 22:59:59,tp 1.15622,0.0,-0.0,0.0,0.0,1.15522,20.12.2007 22:30:00,1185,-0.0,50.16,IS,0.58,0.0,Phase3-EA-SA2v2-USDCHF-M15-107,USDCHFMT4,316,29m 59s,Buy
11146.12,1.65892,20.12.2007 23:04:58,tp 1.65892,0.0,-0.0,0.0,0.0,1.65782,20.12.2007 22:30:00,1186,-0.0,38.96,IS,0.41,0.0,Phase3-EA-SA2v2-EURCHF-M5-43,EURCHFMT4,640,34m 58s,Buy
11152.49,1.15792,21.12.2007 03:30:00,,-2.65,-0.0,0.0,0.0,1.1581,20.12.2007 23:15:00,1187,-0.0,6.37,IS,0.58,0.0,Phase3-EA-SA2v2-USDCHF-M15-107,USDCHFMT4,318,4h 15m,Sell
11134.03,1.66052,21.12.2007 09:40:00,,0.0,-18.460000000006403,0.0,0.0,1.66,21.12.2007 01:20:00,1188,-0.018249674328339707,-18.46,IS,0.41,0.0,Phase3-EA-SA2v2-EURCHF-M5-43,EURCHFMT4,642,8h 20m,Sell
11145.24,1.65932,21.12.2007 10:30:00,,0.0,-7.25,0.0,0.0,1.6597,21.12.2007 01:45:00,1189,-0.0071673964723952864,11.21,IS,0.34,0.0,Phase3-EA-S4v1-EURCHF-M15-221,EURCHFMT4,344,8h 45m,Sell
11091.61,225.57,21.12.2007 15:59:57,sl 225.570,-0.46,-60.88000000000466,0.0,0.0,224.9,20.12.2007 12:30:00,1190,-0.0601863582399253,-53.63,IS,0.09,0.0,Phase3-EA-B1v1-GBPJPY-M30-1,GBPJPYMT4,172,1d 3h 29m,Sell
11129.79,1.66122,24.12.2007 02:04:57,tp 1.66122,-0.85,-22.70000000001164,0.0,0.0,1.66012,21.12.2007 20:50:00,1191,-0.022441365506683648,38.18,IS,0.41,0.0,Phase3-EA-SA2v2-EURCHF-M5-43,EURCHFMT4,644,2d 5h 14m,Buy
11061.72,1.66332,24.12.2007 11:15:00,,0.0,-90.77000000001863,0.0,0.0,1.6614,24.12.2007 02:55:00,1192,-0.08973580383440741,-68.07,IS,0.41,0.0,Phase3-EA-SA2v2-EURCHF-M5-43,EURCHFMT4,646,8h 20m,Sell
11005.25,1.66372,24.12.2007 13:00:00,,0.0,-147.2400000000198,0.0,0.0,1.6618,24.12.2007 04:15:00,1193,-0.14556240780629295,-56.47,IS,0.34,0.0,Phase3-EA-S4v1-EURCHF-M15-221,EURCHFMT4,346,8h 45m,Sell
10948.86,1.15202,27.12.2007 04:30:00,,0.0,-203.6300000000192,0.0,0.0,1.1509,27.12.2007 00:15:00,1194,-0.20130992326537792,-56.39,IS,0.58,0.0,Phase3-EA-SA2v2-USDCHF-M15-107,USDCHFMT4,320,4h 15m,Sell
10902.15,227012,27.12.2007 09:10:00,,0.0,-250.3400000000256,0.0,0.0,226.78,27.12.2007 03:45:00,1195,-0.2474877286758096,-46.71,IS,0.23,0.0,Phase3-EA-S4v1-GBPJPY-M5-194,GBPJPYMT4,378,5h 25m,Sell
10928.15,1.6679,27.12.2007 12:30:00,,0.0,-224.3400000000256,0.0,0.0,1.66702,27.12.2007 03:45:00,1196,-0.22178396201618514,26.0,IS,0.34,0.0,Phase3-EA-S4v1-EURCHF-M15-221,EURCHFMT4,348,8h 45m,Buy
11072.08,228052,27.12.2007 15:29:58,tp 228.052,-1.69,-80.4100000000326,0.0,0.0,226202,21.12.2007 20:30:00,1197,-0.07949384142697084,143.93,IS,0.09,0.0,Phase3-EA-B1v1-GBPJPY-M30-1,GBPJPYMT4,174,5d 18h 59m,Buy
11111.69,1.6653,27.12.2007 23:05:00,tp 1.66530,0.0,-40.800000000032014,0.0,0.0,1.6664,27.12.2007 22:00:00,1198,-0.040335141527442366,39.61,IS,0.41,0.0,Phase3-EA-SA2v2-EURCHF-M5-43,EURCHFMT4,648,1h 5m,Sell
11162.6,1.1392,28.12.2007 00:29:58,tp 1.13920,0.0,-0.0,0.0,0.0,1.1402,28.12.2007 00:15:00,1199,-0.0,50.91,IS,0.58,0.0,Phase3-EA-SA2v2-USDCHF-M15-107,USDCHFMT4,322,14m 58s,Sell
11221.54,113612,28.12.2007 05:00:00,,0.0,-0.0,0.0,0.0,113.86,28.12.2007 01:45:00,1200,-0.0,58.94,IS,0.27,0.0,Phase3-EA-S1v2-USDJPY-M15-0,USDJPYMT4,448,3h 15m,Sell
11300.49,226.69,28.12.2007 05:14:58,tp 226.690,0.0,-0.0,0.0,0.0,227.08,28.12.2007 01:55:00,1201,-0.0,78.95,IS,0.23,0.0,Phase3-EA-S4v1-GBPJPY-M5-194,GBPJPYMT4,380,3h 19m,Sell
11340.48,1.65972,28.12.2007 22:34:57,tp 1.65972,0.0,-0.0,0.0,0.0,1.65862,28.12.2007 20:25:00,1202,-0.0,39.99,IS,0.41,0.0,Phase3-EA-SA2v2-EURCHF-M5-43,EURCHFMT4,650,2h 9m,Buy
11380.57,1.6584,31.12.2007 03:05:00,tp 1.65840,0.0,-0.0,0.0,0.0,1.6595,31.12.2007 02:15:00,1203,-0.0,40.09,IS,0.41,0.0,Phase3-EA-SA2v2-EURCHF-M5-43,EURCHFMT4,652,50m 0s,Sell
11376.95,1.6567,31.12.2007 13:15:00,,0.0,-3.6199999999953434,0.0,0.0,1.65682,31.12.2007 04:30:00,1204,-0.0035707039327115067,-3.62,IS,0.34,0.0,Phase3-EA-S4v1-EURCHF-M15-221,EURCHFMT4,350,8h 45m,Buy
11323.15,224.75,31.12.2007 14:59:57,sl 224.750,0.0,-57.419999999998254,0.0,0.0,224.08,31.12.2007 04:00:00,1205,-0.05663807177252824,-53.8,IS,0.09,0.0,Phase3-EA-B1v1-GBPJPY-M30-1,GBPJPYMT4,176,10h 59m,Sell
11586.69,2.00652,31.12.2007 15:59:58,tp 2.00652,-1.06,-0.0,0.0,0.0,1.98762,27.12.2007 11:00:00,1206,-0.0,263.54,IS,0.14,0.0,Phase3-EA-B1v1-GBPUSD-M30-14,GBPUSDMT4,84,4d 4h 59m,Buy
11532.76,224022,31.12.2007 17:59:57,sl 224.022,0.0,-53.929999999993015,0.0,0.0,224692,31.12.2007 16:00:00,1207,-0.053087663354316396,-53.93,IS,0.09,0.0,Phase3-EA-B1v1-GBPJPY-M30-1,GBPJPYMT4,178,1h 59m,Buy
11681.07,221.44,02.01.2008 11:00:00,tp 221.440,-0.47,-0.0,0.0,0.0,223.29,31.12.2007 18:00:00,1208,-0.0,148.31,IS,0.09,0.0,Phase3-EA-B1v1-GBPJPY-M30-1,GBPJPYMT4,180,1d 17h 0m,Sell
11778.17,111.23,02.01.2008 17:29:58,tp 111.230,0.0,-0.0,0.0,0.0,111.63,02.01.2008 17:00:00,1209,-0.0,97.1,IS,0.27,0.0,Phase3-EA-S1v2-USDJPY-M15-0,USDJPYMT4,450,29m 58s,Sell
11928.05,218.97,02.01.2008 18:29:58,tp 218.970,0.0,-0.0,0.0,0.0,220.82,02.01.2008 16:00:00,1210,-0.0,149.88,IS,0.09,0.0,Phase3-EA-B1v1-GBPJPY-M30-1,GBPJPYMT4,182,2h 29m,Sell
11968.44,1.64532,02.01.2008 21:55:00,tp 1.64532,0.0,-0.0,0.0,0.0,1.64422,02.01.2008 21:05:00,1211,-0.0,40.39,IS,0.41,0.0,Phase3-EA-SA2v2-EURCHF-M5-43,EURCHFMT4,654,50m 0s,Buy
11995.02,109.69,03.01.2008 01:30:00,,0.0,-0.0,0.0,0.0,109582,03.01.2008 00:15:00,1212,-0.0,26.58,IS,0.27,0.0,Phase3-EA-S1v2-USDJPY-M15-0,USDJPYMT4,452,1h 15m,Buy
12076.99,216.69,03.01.2008 02:49:58,tp 216.690,0.0,-0.0,0.0,0.0,217.08,03.01.2008 00:15:00,1213,-0.0,81.97,IS,0.23,0.0,Phase3-EA-S4v1-GBPJPY-M5-194,GBPJPYMT4,382,2h 34m,Sell
12160.53,109242,03.01.2008 03:00:00,,0.0,-0.0,0.0,0.0,109.58,03.01.2008 00:15:00,1214,-0.0,83.54,IS,0.27,0.0,Phase3-EA-S1v2-USDJPY-M15-0,USDJPYMT4,453,2h 45m,Sell
12242.51,216952,03.01.2008 03:54:57,tp 216.952,0.0,-0.0,0.0,0.0,216562,03.01.2008 02:55:00,1215,-0.0,81.98,IS,0.23,0.0,Phase3-EA-S4v1-GBPJPY-M5-194,GBPJPYMT4,384,59m 57s,Buy
12282.8,1.6461,03.01.2008 04:39:57,tp 1.64610,0.0,-0.0,0.0,0.0,1.6472,03.01.2008 00:25:00,1216,-0.0,40.29,IS,0.41,0.0,Phase3-EA-SA2v2-EURCHF-M5-43,EURCHFMT4,656,4h 14m,Sell
12227.72,217.13,03.01.2008 06:59:58,sl 217.130,0.0,-55.080000000001746,0.0,0.0,216.46,03.01.2008 03:00:00,1217,-0.053850696304756744,-55.08,IS,0.09,0.0,Phase3-EA-B1v1-GBPJPY-M30-1,GBPJPYMT4,184,3h 59m,Sell
12345.8,1.64352,03.01.2008 11:30:00,,0.0,-0.0,0.0,0.0,1.6474,03.01.2008 02:45:00,1218,-0.0,118.08,IS,0.34,0.0,Phase3-EA-S4v1-EURCHF-M15-221,EURCHFMT4,352,8h 45m,Sell
12606.97,1.9721,03.01.2008 12:59:58,tp 1.97210,-3.43,-0.0,0.0,0.0,1991,31.12.2007 19:00:00,1219,-0.0,261.17,IS,0.14,0.0,Phase3-EA-B1v1-GBPUSD-M30-14,GBPUSDMT4,86,2d 17h 59m,Sell
12659.13,1.11202,03.01.2008 22:29:58,tp 1.11202,0.0,-0.0,0.0,0.0,1.11102,03.01.2008 22:00:00,1220,-0.0,52.16,IS,0.58,0.0,Phase3-EA-SA2v2-USDCHF-M15-107,USDCHFMT4,324,29m 58s,Buy
12661.11,109322,03.01.2008 23:15:00,,0.0,-0.0,0.0,0.0,109.33,03.01.2008 17:00:00,1221,-0.0,1.98,IS,0.27,0.0,Phase3-EA-S1v2-USDJPY-M15-0,USDJPYMT4,456,6h 15m,Sell
12742.35,215792,04.01.2008 01:24:57,tp 215.792,-0.76,-0.0,0.0,0.0,215402,03.01.2008 23:40:00,1222,-0.0,81.24,IS,0.23,0.0,Phase3-EA-S4v1-GBPJPY-M5-194,GBPJPYMT4,386,1h 44m,Buy
12824.34,215.63,04.01.2008 03:14:58,tp 215.630,0.0,-0.0,0.0,0.0,216.02,04.01.2008 01:55:00,1223,-0.0,81.99,IS,0.23,0.0,Phase3-EA-S4v1-GBPJPY-M5-194,GBPJPYMT4,388,1h 19m,Sell
12906.42,215572,04.01.2008 03:34:57,tp 215.572,0.0,-0.0,0.0,0.0,215182,04.01.2008 03:25:00,1224,-0.0,82.08,IS,0.23,0.0,Phase3-EA-S4v1-GBPJPY-M5-194,GBPJPYMT4,390,9m 57s,Buy
12808.77,1.6377,04.01.2008 05:40:00,,-0.89,-97.64999999999418,0.0,0.0,1.64032,03.01.2008 21:20:00,1225,-0.09489203880573645,-97.65,IS,0.41,0.0,Phase3-EA-SA2v2-EURCHF-M5-43,EURCHFMT4,658,8h 20m,Buy
12786.78,1.6372,04.01.2008 13:00:00,,0.0,-119.63999999999942,0.0,0.0,1.63792,04.01.2008 04:15:00,1226,-0.11626096797459222,-21.99,IS,0.34,0.0,Phase3-EA-S4v1-EURCHF-M15-221,EURCHFMT4,354,8h 45m,Buy
12839.21,1.10622,04.01.2008 22:44:57,tp 1.10622,0.0,-67.2100000000064,0.0,0.0,1.10522,04.01.2008 22:30:00,1227,-0.06531176577710737,52.43,IS,0.58,0.0,Phase3-EA-SA2v2-USDCHF-M15-107,USDCHFMT4,326,14m 57s,Buy
12890.98,1.10682,07.01.2008 02:00:00,tp 1.10682,-0.63,-15.440000000002328,0.0,0.0,1.10582,04.01.2008 23:15:00,1228,-0.01500392298167823,51.77,IS,0.58,0.0,Phase3-EA-SA2v2-USDCHF-M15-107,USDCHFMT4,328,2d 2h 45m,Buy
12973.61,214.05,07.01.2008 03:04:58,tp 214.050,0.0,-0.0,0.0,0.0,214.44,07.01.2008 02:00:00,1229,-0.0,82.63,IS,0.23,0.0,Phase3-EA-S4v1-GBPJPY-M5-194,GBPJPYMT4,392,1h 4m,Sell
12935.01,1.6344,07.01.2008 05:15:00,,-0.89,-38.60000000000582,0.0,0.0,1.63542,04.01.2008 20:55:00,1230,-0.037485332407017485,-38.6,IS,0.41,0.0,Phase3-EA-SA2v2-EURCHF-M5-43,EURCHFMT4,660,2d 8h 20m,Buy
12729.31,109.54,07.01.2008 13:14:59,sl 109.540,-1.12,-244.3000000000029,0.0,0.0,108.71,04.01.2008 20:15:00,1231,-0.23724525147754147,-205.7,IS,0.27,0.0,Phase3-EA-S1v2-USDJPY-M15-0,USDJPYMT4,458,2d 16h 59m,Sell
12769.71,1.6409,07.01.2008 21:54:58,tp 1.64090,0.0,-203.90000000000873,0.0,0.0,1642,07.01.2008 21:00:00,1232,-0.19801189838834302,40.4,IS,0.41,0.0,Phase3-EA-SA2v2-EURCHF-M5-43,EURCHFMT4,662,54m 58s,Sell
12809.23,1.64072,08.01.2008 00:10:00,tp 1.64072,-0.88,-164.38000000000466,0.0,0.0,1.63962,07.01.2008 23:10:00,1233,-0.15963313318820674,39.52,IS,0.41,0.0,Phase3-EA-SA2v2-EURCHF-M5-43,EURCHFMT4,664,1h 0m,Buy
12891.39,215052,08.01.2008 04:05:00,tp 215.052,0.0,-82.22000000000116,0.0,0.0,214662,08.01.2008 03:15:00,1234,-0.07984570027213878,82.16,IS,0.23,0.0,Phase3-EA-S4v1-GBPJPY-M5-194,GBPJPYMT4,394,50m 0s,Buy
12813.22,109322,08.01.2008 16:45:00,,-1.11,-160.38999999999942,0.0,0.0,109.01,07.01.2008 20:15:00,1235,-0.15575835400934213,-78.17,IS,0.27,0.0,Phase3-EA-S1v2-USDJPY-M15-0,USDJPYMT4,460,20h 30m,Sell
12853.66,1.6401,08.01.2008 22:49:58,tp 1.64010,0.0,-119.94999999999709,0.0,0.0,1.6412,08.01.2008 22:15:00,1236,-0.11648615601608706,40.44,IS,0.41,0.0,Phase3-EA-SA2v2-EURCHF-M5-43,EURCHFMT4,666,34m 58s,Sell
12684.89,214752,08.01.2008 23:59:57,sl 214.752,0.0,-288.72000000000116,0.0,0.0,215552,08.01.2008 23:05:00,1237,-0.2803825174236399,-168.77,IS,0.23,0.0,Phase3-EA-S4v1-GBPJPY-M5-194,GBPJPYMT4,396,54m 57s,Buy
12568.95,1.1106,09.01.2008 04:30:00,,0.0,-404.6600000000035,0.0,0.0,1.11282,09.01.2008 00:15:00,1238,-0.3929744718088482,-115.94,IS,0.58,0.0,Phase3-EA-SA2v2-USDCHF-M15-107,USDCHFMT4,330,4h 15m,Buy
12500.96,1.6367,09.01.2008 07:50:00,,-0.88,-472.65000000000873,0.0,0.0,1.63852,08.01.2008 23:30:00,1239,-0.45900109746565987,-67.99,IS,0.41,0.0,Phase3-EA-SA2v2-EURCHF-M5-43,EURCHFMT4,668,8h 20m,Buy
12623.11,1.63972,09.01.2008 10:29:57,tp 1.63972,0.0,-350.50000000001455,0.0,0.0,1.63572,09.01.2008 02:45:00,1240,-0.3403784717268962,122.15,IS,0.34,0.0,Phase3-EA-S4v1-EURCHF-M15-221,EURCHFMT4,356,7h 44m,Buy
12615.21,109402,09.01.2008 20:00:00,,0.0,-358.40000000000873,0.0,0.0,109.37,09.01.2008 17:30:00,1241,-0.34805034027651216,-7.9,IS,0.27,0.0,Phase3-EA-S1v2-USDJPY-M15-0,USDJPYMT4,462,2h 30m,Sell
12655.66,1.63452,09.01.2008 22:44:57,tp 1.63452,0.0,-317.95000000001164,0.0,0.0,1.63342,09.01.2008 22:05:00,1242,-0.30876843105725,40.45,IS,0.41,0.0,Phase3-EA-SA2v2-EURCHF-M5-43,EURCHFMT4,670,39m 57s,Buy
12707.68,1115,10.01.2008 03:44:57,tp 1.11500,0.0,-265.93000000000757,0.0,0.0,1116,10.01.2008 02:00:00,1243,-0.2582506333418897,52.02,IS,0.58,0.0,Phase3-EA-SA2v2-USDCHF-M15-107,USDCHFMT4,332,1h 44m,Sell
12753.39,214682,10.01.2008 05:30:00,,0.0,-220.22000000000116,0.0,0.0,214.9,10.01.2008 00:05:00,1244,-0.21386061924021219,45.71,IS,0.23,0.0,Phase3-EA-S4v1-GBPJPY-M5-194,GBPJPYMT4,398,5h 25m,Sell
12686.47,1.63752,10.01.2008 08:25:00,,0.0,-287.1399999999994,0.0,0.0,1.6357,10.01.2008 00:05:00,1245,-0.2788481437137139,-66.92,IS,0.41,0.0,Phase3-EA-SA2v2-EURCHF-M5-43,EURCHFMT4,672,8h 20m,Sell
12676.71,1.63712,10.01.2008 11:30:00,,0.0,-296.8999999999942,0.0,0.0,1.6368,10.01.2008 02:45:00,1246,-0.28832630030159573,-9.76,IS,0.34,0.0,Phase3-EA-S4v1-EURCHF-M15-221,EURCHFMT4,358,8h 45m,Sell
12717.57,1632,10.01.2008 20:34:58,tp 1.63200,0.0,-256.0399999999936,0.0,0.0,1.6331,10.01.2008 20:30:00,1247,-0.24864623081583084,40.86,IS,0.41,0.0,Phase3-EA-SA2v2-EURCHF-M5-43,EURCHFMT4,674,4m 58s,Sell
12758.48,1.63242,10.01.2008 21:34:58,tp 1.63242,0.0,-215.1299999999901,0.0,0.0,1.63132,10.01.2008 21:00:00,1248,-0.20891760520000222,40.91,IS,0.41,0.0,Phase3-EA-SA2v2-EURCHF-M5-43,EURCHFMT4,676,34m 58s,Buy
12797.49,1.6333,11.01.2008 00:14:58,tp 1.63330,-1.86,-176.11999999999534,0.0,0.0,1.6344,10.01.2008 23:15:00,1249,-0.1710341125264961,39.01,IS,0.41,0.0,Phase3-EA-SA2v2-EURCHF-M5-43,EURCHFMT4,678,59m 58s,Sell
12878.29,214.52,11.01.2008 00:29:57,tp 214.520,-1.22,-95.31999999999243,0.0,0.0,214.91,10.01.2008 23:15:00,1250,-0.0925674063480851,80.8,IS,0.23,0.0,Phase3-EA-S4v1-GBPJPY-M5-194,GBPJPYMT4,400,1h 14m,Sell
12919.13,1.6334,11.01.2008 05:04:59,tp 1.63340,0.0,-54.479999999995925,0.0,0.0,1.6345,11.01.2008 02:45:00,1251,-0.052906759314348496,40.84,IS,0.41,0.0,Phase3-EA-SA2v2-EURCHF-M5-43,EURCHFMT4,680,2h 19m,Sell
12944.7,109292,11.01.2008 06:45:00,,-1.11,-28.90999999998894,0.0,0.0,109.4,10.01.2008 22:45:00,1252,-0.02807515440119942,25.57,IS,0.27,0.0,Phase3-EA-S1v2-USDJPY-M15-0,USDJPYMT4,464,8h 0m,Sell
13026.77,214.39,11.01.2008 06:49:58,tp 214.390,0.0,-0.0,0.0,0.0,214.78,11.01.2008 02:20:00,1253,-0.0,82.07,IS,0.23,0.0,Phase3-EA-S4v1-GBPJPY-M5-194,GBPJPYMT4,402,4h 29m,Sell
13150.07,1.6305,11.01.2008 06:59:58,tp 1.63050,0.0,-0.0,0.0,0.0,1.6345,11.01.2008 02:45:00,1254,-0.0,123.3,IS,0.34,0.0,Phase3-EA-S4v1-EURCHF-M15-221,EURCHFMT4,360,4h 14m,Sell
13411.92,1.9505,11.01.2008 09:59:58,tp 1.95050,-2.75,-0.0,0.0,0.0,1.9694,09.01.2008 10:30:00,1255,-0.0,261.85,IS,0.14,0.0,Phase3-EA-B1v1-GBPUSD-M30-14,GBPUSDMT4,88,1d 23h 29m,Sell
13369.92,1.95812,11.01.2008 20:29:58,sl 1.95812,0.0,-42.0,0.0,0.0,1.96112,11.01.2008 19:30:00,1256,-0.04061427348027188,-42.0,IS,0.14,0.0,Phase3-EA-B1v1-GBPUSD-M30-14,GBPUSDMT4,90,59m 58s,Buy
13386.91,1.6296,14.01.2008 06:15:00,,-0.89,-25.00999999999476,0.0,0.0,1.62912,11.01.2008 21:55:00,1257,-0.0241848328509854,16.99,IS,0.41,0.0,Phase3-EA-SA2v2-EURCHF-M5-43,EURCHFMT4,682,2d 8h 20m,Buy
13510.59,1.63112,14.01.2008 09:14:58,tp 1.63112,0.0,-0.0,0.0,0.0,1.62712,14.01.2008 02:30:00,1258,-0.0,123.68,IS,0.34,0.0,Phase3-EA-S4v1-EURCHF-M15-221,EURCHFMT4,362,6h 44m,Buy
13426.58,108142,15.01.2008 03:15:00,,-1.12,-84.00999999999476,0.0,0.0,107.81,14.01.2008 17:00:00,1259,-0.0811607778489087,-84.01,IS,0.27,0.0,Phase3-EA-S1v2-USDJPY-M15-0,USDJPYMT4,466,10h 15m,Sell
13479.69,1092,15.01.2008 03:59:58,tp 1.09200,0.0,-30.89999999999418,0.0,0.0,1093,15.01.2008 01:00:00,1260,-0.029852018039887667,53.11,IS,0.58,0.0,Phase3-EA-SA2v2-USDCHF-M15-107,USDCHFMT4,334,2h 59m,Sell
13353.91,1.6217,15.01.2008 04:40:00,,-0.9,-156.67999999999302,0.0,0.0,1.62502,14.01.2008 20:20:00,1261,-0.1513661549025978,-125.78,IS,0.41,0.0,Phase3-EA-SA2v2-EURCHF-M5-43,EURCHFMT4,684,8h 20m,Buy
13311.91,1.95582,15.01.2008 10:29:58,sl 1.95582,0.0,-198.67999999999302,0.0,0.0,1.95882,15.01.2008 10:00:00,1262,-0.19194171340342364,-42.0,IS,0.14,0.0,Phase3-EA-B1v1-GBPUSD-M30-14,GBPUSDMT4,92,29m 58s,Buy
13286.34,1.6217,15.01.2008 14:45:00,,0.0,-224.25,0.0,0.0,1.62252,15.01.2008 06:00:00,1263,-0.21664449985262363,-25.57,IS,0.34,0.0,Phase3-EA-S4v1-EURCHF-M15-221,EURCHFMT4,364,8h 45m,Buy
13333.8,106942,15.01.2008 23:30:00,,0.0,-176.7899999999936,0.0,0.0,107.13,15.01.2008 20:15:00,1264,-0.17079411874668426,47.46,IS,0.27,0.0,Phase3-EA-S1v2-USDJPY-M15-0,USDJPYMT4,468,3h 15m,Sell
13417.66,210292,15.01.2008 23:39:57,tp 210.292,0.0,-92.92999999999302,0.0,0.0,209902,15.01.2008 23:25:00,1265,-0.08977825360670146,83.86,IS,0.23,0.0,Phase3-EA-S4v1-GBPJPY-M5-194,GBPJPYMT4,404,14m 57s,Buy
13232.64,1.61482,16.01.2008 04:19:58,sl 1.61482,-0.9,-277.9499999999971,0.0,0.0,1.61972,15.01.2008 22:30:00,1266,-0.26852324965010527,-185.02,IS,0.41,0.0,Phase3-EA-SA2v2-EURCHF-M5-43,EURCHFMT4,686,5h 49m,Buy
13111.11,1.61412,16.01.2008 04:29:58,sl 1.61412,0.0,-399.4799999999959,0.0,0.0,1.61802,16.01.2008 01:15:00,1267,-0.3859315264264223,-121.53,IS,0.34,0.0,Phase3-EA-S4v1-EURCHF-M15-221,EURCHFMT4,366,3h 14m,Buy
13054.61,209.56,16.01.2008 05:59:58,sl 209.560,0.0,-455.9799999999959,0.0,0.0,208.89,16.01.2008 04:00:00,1268,-0.44051531345729517,-56.5,IS,0.09,0.0,Phase3-EA-B1v1-GBPJPY-M30-1,GBPJPYMT4,186,1h 59m,Sell
12932.6,1.61042,16.01.2008 06:59:58,sl 1.61042,0.0,-577.9899999999907,0.0,0.0,1.61432,16.01.2008 05:00:00,1269,-0.5583873109021892,-122.01,IS,0.34,0.0,Phase3-EA-S4v1-EURCHF-M15-221,EURCHFMT4,368,1h 59m,Buy
12720.68,106112,16.01.2008 07:44:57,sl 106.112,-0.73,-789.9099999999889,0.0,0.0,106942,15.01.2008 23:30:00,1270,-0.76311998608064,-211.92,IS,0.27,0.0,Phase3-EA-S1v2-USDJPY-M15-0,USDJPYMT4,470,8h 14m,Buy
12678.15,1.95562,16.01.2008 13:59:58,sl 1.95562,-0.53,-832.4399999999878,0.0,0.0,1.95862,15.01.2008 12:00:00,1271,-0.8042075694863562,-42.53,IS,0.14,0.0,Phase3-EA-B1v1-GBPUSD-M30-14,GBPUSDMT4,94,1d 1h 59m,Buy
12778.57,107552,16.01.2008 22:44:58,tp 107.552,0.0,-732.0199999999895,0.0,0.0,107152,16.01.2008 22:15:00,1272,-0.7071933412803357,100.42,IS,0.27,0.0,Phase3-EA-S1v2-USDJPY-M15-0,USDJPYMT4,472,29m 58s,Buy
12819.57,1.6129,16.01.2008 23:44:59,tp 1.61290,0.0,-691.0199999999895,0.0,0.0,1614,16.01.2008 22:35:00,1273,-0.66758386750572,41.0,IS,0.41,0.0,Phase3-EA-SA2v2-EURCHF-M5-43,EURCHFMT4,688,1h 9m,Sell
12903.14,210862,17.01.2008 03:19:58,tp 210.862,0.0,-607.4499999999825,0.0,0.0,210472,17.01.2008 02:10:00,1274,-0.5868481669363319,83.57,IS,0.23,0.0,Phase3-EA-S4v1-GBPJPY-M5-194,GBPJPYMT4,406,1h 9m,Buy
12943.03,106932,17.01.2008 22:45:00,,0.0,-567.5599999999831,0.0,0.0,107.09,17.01.2008 19:00:00,1275,-0.5483110472078101,39.89,IS,0.27,0.0,Phase3-EA-S1v2-USDJPY-M15-0,USDJPYMT4,474,3h 45m,Sell
13026.28,210442,18.01.2008 00:14:58,tp 210.442,-0.78,-484.3099999999831,0.0,0.0,210052,17.01.2008 23:55:00,1276,-0.46788449375081603,83.25,IS,0.23,0.0,Phase3-EA-S4v1-GBPJPY-M5-194,GBPJPYMT4,408,19m 58s,Buy
12953.93,1.10082,18.01.2008 02:45:00,,-2.8,-556.6599999999889,0.0,0.0,1.0995,17.01.2008 22:30:00,1277,-0.5377807236921252,-72.35,IS,0.58,0.0,Phase3-EA-SA2v2-USDCHF-M15-107,USDCHFMT4,336,4h 15m,Sell
12907.17,106.75,18.01.2008 06:15:00,,-0.73,-603.4199999999837,0.0,0.0,106932,17.01.2008 22:45:00,1278,-0.5829548454897062,-46.76,IS,0.27,0.0,Phase3-EA-S1v2-USDJPY-M15-0,USDJPYMT4,476,7h 30m,Buy
12947.17,1.61492,18.01.2008 06:59:58,tp 1.61492,-0.89,-563.4199999999837,0.0,0.0,1.61382,17.01.2008 22:45:00,1279,-0.5443114564413006,40.0,IS,0.41,0.0,Phase3-EA-SA2v2-EURCHF-M5-43,EURCHFMT4,690,8h 14m,Buy
13070.47,1.61572,18.01.2008 07:29:57,tp 1.61572,0.0,-440.1199999999808,0.0,0.0,1.61172,18.01.2008 01:45:00,1280,-0.42519320969958774,123.3,IS,0.34,0.0,Phase3-EA-S4v1-EURCHF-M15-221,EURCHFMT4,370,5h 44m,Buy
13111.47,1.60942,18.01.2008 20:29:57,tp 1.60942,0.0,-399.1199999999808,0.0,0.0,1.60832,18.01.2008 20:15:00,1281,-0.385583735924972,41.0,IS,0.41,0.0,Phase3-EA-SA2v2-EURCHF-M5-43,EURCHFMT4,692,14m 57s,Buy
13195.36,208.73,21.01.2008 03:14:58,tp 208.730,0.0,-315.2299999999814,0.0,0.0,209.12,21.01.2008 02:20:00,1282,-0.3045388882432041,83.89,IS,0.23,0.0,Phase3-EA-S4v1-GBPJPY-M5-194,GBPJPYMT4,410,54m 58s,Sell
13111.93,1.6058,21.01.2008 06:10:00,,-0.9,-398.6599999999744,0.0,0.0,1.60802,18.01.2008 21:50:00,1283,-0.3851393369509092,-83.43,IS,0.41,0.0,Phase3-EA-SA2v2-EURCHF-M5-43,EURCHFMT4,694,2d 8h 20m,Buy
12991.66,1.60272,21.01.2008 10:44:58,sl 1.60272,0.0,-518.9299999999785,0.0,0.0,1.60662,21.01.2008 02:15:00,1284,-0.5013303469722066,-120.27,IS,0.34,0.0,Phase3-EA-S4v1-EURCHF-M15-221,EURCHFMT4,372,8h 29m,Buy
13030.47,1.6007,22.01.2008 01:54:57,tp 1.60070,-1.85,-480.1199999999808,0.0,0.0,1.6018,21.01.2008 20:00:00,1285,-0.46383659874799327,38.81,IS,0.41,0.0,Phase3-EA-SA2v2-EURCHF-M5-43,EURCHFMT4,696,5h 54m,Sell
13071.11,1.60152,22.01.2008 02:49:59,tp 1.60152,0.0,-439.4799999999814,0.0,0.0,1.60042,22.01.2008 02:25:00,1286,-0.4245749154748138,40.64,IS,0.41,0.0,Phase3-EA-SA2v2-EURCHF-M5-43,EURCHFMT4,698,24m 59s,Buy
13155.84,205532,22.01.2008 03:19:58,tp 205.532,0.0,-354.74999999998545,0.0,0.0,205142,22.01.2008 02:05:00,1287,-0.3427185566230327,84.73,IS,0.23,0.0,Phase3-EA-S4v1-GBPJPY-M5-194,GBPJPYMT4,412,1h 14m,Buy
13215.55,106.3,22.01.2008 04:45:00,,-0.74,-295.03999999997905,0.0,0.0,106062,21.01.2008 22:00:00,1288,-0.28503363762101913,59.71,IS,0.27,0.0,Phase3-EA-S1v2-USDJPY-M15-0,USDJPYMT4,478,6h 45m,Buy
13158.19,206.45,22.01.2008 04:59:58,sl 206.450,-0.49,-352.3999999999796,0.0,0.0,205.78,21.01.2008 19:00:00,1289,-0.34044825751643326,-57.36,IS,0.09,0.0,Phase3-EA-B1v1-GBPJPY-M30-1,GBPJPYMT4,188,9h 59m,Sell
13116.19,1.9414,22.01.2008 08:59:58,sl 1.94140,0.0,-394.3999999999796,0.0,0.0,1.9384,22.01.2008 07:30:00,1290,-0.38102381601725904,-42.0,IS,0.14,0.0,Phase3-EA-B1v1-GBPUSD-M30-14,GBPUSDMT4,96,1h 29m,Sell
12996.62,1.59672,22.01.2008 10:44:59,sl 1.59672,0.0,-513.9699999999866,0.0,0.0,1.60062,22.01.2008 02:45:00,1291,-0.4965385667302121,-119.57,IS,0.34,0.0,Phase3-EA-S4v1-EURCHF-M15-221,EURCHFMT4,374,7h 59m,Buy
13098.04,106492,22.01.2008 17:44:58,tp 106.492,0.0,-412.54999999998836,0.0,0.0,106092,22.01.2008 17:00:00,1292,-0.39855825379798154,101.42,IS,0.27,0.0,Phase3-EA-S1v2-USDJPY-M15-0,USDJPYMT4,480,44m 58s,Buy
13100.07,106.46,22.01.2008 18:00:00,,0.0,-410.5199999999895,0.0,0.0,106452,22.01.2008 17:45:00,1293,-0.39659710180377605,2.03,IS,0.27,0.0,Phase3-EA-S1v2-USDJPY-M15-0,USDJPYMT4,482,15m 0s,Buy
12892.43,1.09272,23.01.2008 01:29:57,sl 1.09272,-0.63,-618.1599999999889,0.0,0.0,1.09662,22.01.2008 23:15:00,1294,-0.5971949343540487,-207.64,IS,0.58,0.0,Phase3-EA-SA2v2-USDCHF-M15-107,USDCHFMT4,338,2h 14m,Buy
12945.48,1.09332,23.01.2008 02:14:59,tp 1.09332,0.0,-565.109999999986,0.0,0.0,1.09232,23.01.2008 02:00:00,1295,-0.545944139628598,53.05,IS,0.58,0.0,Phase3-EA-SA2v2-USDCHF-M15-107,USDCHFMT4,340,14m 59s,Buy
12985.73,1.60572,23.01.2008 02:39:58,tp 1.60572,-0.9,-524.859999999986,0.0,0.0,1.60462,22.01.2008 22:15:00,1296,-0.50705922939864,40.25,IS,0.41,0.0,Phase3-EA-SA2v2-EURCHF-M5-43,EURCHFMT4,700,4h 24m,Buy
13109.85,1.60622,23.01.2008 02:44:58,tp 1.60622,0.0,-400.7399999999907,0.0,0.0,1.60222,23.01.2008 01:30:00,1297,-0.387148793181442,124.12,IS,0.34,0.0,Phase3-EA-S4v1-EURCHF-M15-221,EURCHFMT4,376,1h 14m,Buy
13210.04,107012,23.01.2008 02:44:58,tp 107.012,-0.73,-300.54999999998836,0.0,0.0,106612,22.01.2008 22:00:00,1298,-0.29035676446244596,100.19,IS,0.27,0.0,Phase3-EA-S1v2-USDJPY-M15-0,USDJPYMT4,484,4h 44m,Buy
13038.37,210.06,23.01.2008 02:54:57,sl 210.060,0.0,-472.2199999999866,0.0,0.0,209.26,23.01.2008 01:50:00,1299,-0.4562045294109388,-171.67,IS,0.23,0.0,Phase3-EA-S4v1-GBPJPY-M5-194,GBPJPYMT4,414,1h 4m,Sell
13141.07,105.16,23.01.2008 20:44:58,tp 105.160,0.0,-369.5199999999895,0.0,0.0,105.56,23.01.2008 18:30:00,1300,-0.3569876280291604,102.7,IS,0.27,0.0,Phase3-EA-S1v2-USDJPY-M15-0,USDJPYMT4,486,2h 14m,Sell
12956.55,1.5941,23.01.2008 23:39:58,sl 1.59410,0.0,-554.0399999999936,0.0,0.0,1.5892,23.01.2008 21:55:00,1301,-0.5352495817094591,-184.52,IS,0.41,0.0,Phase3-EA-SA2v2-EURCHF-M5-43,EURCHFMT4,702,1h 44m,Sell
12745.69,106.28,23.01.2008 23:44:58,sl 106.280,0.0,-764.8999999999942,0.0,0.0,105.45,23.01.2008 21:45:00,1302,-0.7389582070781295,-210.86,IS,0.27,0.0,Phase3-EA-S1v2-USDJPY-M15-0,USDJPYMT4,488,1h 59m,Sell
12829.78,208.52,24.01.2008 02:54:57,tp 208.520,0.0,-680.8099999999977,0.0,0.0,208.91,24.01.2008 02:30:00,1303,-0.6577201424511223,84.09,IS,0.23,0.0,Phase3-EA-S4v1-GBPJPY-M5-194,GBPJPYMT4,416,24m 57s,Sell
12882.94,1.0911,24.01.2008 04:44:57,tp 1.09110,0.0,-627.6499999999942,0.0,0.0,1.0921,24.01.2008 02:30:00,1304,-0.606363078405788,53.16,IS,0.58,0.0,Phase3-EA-SA2v2-USDCHF-M15-107,USDCHFMT4,342,2h 14m,Sell
12918.66,1.5935,24.01.2008 05:09:57,tp 1.59350,-5.64,-591.929999999993,0.0,0.0,1.5946,23.01.2008 23:45:00,1305,-0.5718545319855607,35.72,IS,0.41,0.0,Phase3-EA-SA2v2-EURCHF-M5-43,EURCHFMT4,704,5h 24m,Sell
13043.32,1.5925,24.01.2008 05:14:58,tp 1.59250,0.0,-467.2699999999895,0.0,0.0,1.5965,24.01.2008 01:45:00,1306,-0.4514224100162014,124.66,IS,0.34,0.0,Phase3-EA-S4v1-EURCHF-M15-221,EURCHFMT4,378,3h 29m,Sell
13168.01,1.59692,24.01.2008 14:14:58,tp 1.59692,0.0,-342.5799999999872,0.0,0.0,1.59292,24.01.2008 06:30:00,1307,-0.330961305505057,124.69,IS,0.34,0.0,Phase3-EA-S4v1-EURCHF-M15-221,EURCHFMT4,380,7h 44m,Buy
13122.51,211932,25.01.2008 06:05:00,,0.0,-388.0799999999872,0.0,0.0,211.72,25.01.2008 00:40:00,1308,-0.3749181605476183,-45.5,IS,0.23,0.0,Phase3-EA-S4v1-GBPJPY-M5-194,GBPJPYMT4,418,5h 25m,Sell
13018.11,1.60602,25.01.2008 06:50:00,,-1.89,-492.4799999999814,0.0,0.0,1.6033,24.01.2008 22:30:00,1309,-0.4757774059639512,-104.4,IS,0.41,0.0,Phase3-EA-SA2v2-EURCHF-M5-43,EURCHFMT4,706,8h 20m,Sell
12896.46,1.6092,25.01.2008 08:59:58,sl 1.60920,0.0,-614.1299999999756,0.0,0.0,1.6053,25.01.2008 02:00:00,1310,-0.5933016129074089,-121.65,IS,0.34,0.0,Phase3-EA-S4v1-EURCHF-M15-221,EURCHFMT4,382,6h 59m,Sell
13051.17,213762,25.01.2008 11:29:57,tp 213.762,0.0,-459.41999999996915,0.0,0.0,211912,25.01.2008 03:00:00,1311,-0.4438386449154322,154.71,IS,0.09,0.0,Phase3-EA-B1v1-GBPJPY-M30-1,GBPJPYMT4,190,8h 29m,Buy
12995.1,212992,25.01.2008 18:59:58,sl 212.992,0.0,-515.4899999999761,0.0,0.0,213662,25.01.2008 17:00:00,1312,-0.4980070155140414,-56.07,IS,0.09,0.0,Phase3-EA-B1v1-GBPJPY-M30-1,GBPJPYMT4,192,1h 59m,Buy
13036.19,1.61022,25.01.2008 23:04:57,tp 1.61022,0.0,-474.3999999999796,0.0,0.0,1.60912,25.01.2008 21:05:00,1313,-0.45831059411407016,41.09,IS,0.41,0.0,Phase3-EA-SA2v2-EURCHF-M5-43,EURCHFMT4,708,1h 59m,Buy
12994.19,1.98132,28.01.2008 03:29:57,sl 1.98132,0.0,-516.3999999999796,0.0,0.0,1.98432,28.01.2008 02:30:00,1314,-0.498886152614896,-42.0,IS,0.14,0.0,Phase3-EA-B1v1-GBPUSD-M30-14,GBPUSDMT4,98,59m 57s,Buy
13047.12,1.09582,28.01.2008 03:59:57,tp 1.09582,0.0,-463.4699999999866,0.0,0.0,1.09482,28.01.2008 02:00:00,1315,-0.4477512880566001,52.93,IS,0.58,0.0,Phase3-EA-SA2v2-USDCHF-M15-107,USDCHFMT4,344,1h 59m,Buy
12925.87,1.60452,28.01.2008 08:29:58,sl 1.60452,0.0,-584.7199999999866,0.0,0.0,1.60842,28.01.2008 02:45:00,1316,-0.5648890611095795,-121.25,IS,0.34,0.0,Phase3-EA-S4v1-EURCHF-M15-221,EURCHFMT4,384,5h 44m,Buy
12973.39,106.81,28.01.2008 21:15:00,,0.0,-537.1999999999825,0.0,0.0,106622,28.01.2008 20:30:00,1317,-0.5189807149200697,47.52,IS,0.27,0.0,Phase3-EA-S1v2-USDJPY-M15-0,USDJPYMT4,490,45m 0s,Buy
13057.27,212.13,29.01.2008 02:19:57,tp 212.130,0.0,-453.3199999999779,0.0,0.0,212.52,29.01.2008 01:45:00,1318,-0.43794552808555876,83.88,IS,0.23,0.0,Phase3-EA-S4v1-GBPJPY-M5-194,GBPJPYMT4,420,34m 57s,Sell
13098.62,1.6104,29.01.2008 04:29:59,tp 1.61040,0.0,-411.96999999997206,0.0,0.0,1.6115,29.01.2008 01:30:00,1319,-0.39799792465676387,41.35,IS,0.41,0.0,Phase3-EA-SA2v2-EURCHF-M5-43,EURCHFMT4,710,2h 59m,Sell
13079.29,1.61182,29.01.2008 10:45:00,,0.0,-431.2999999999738,0.0,0.0,1.6112,29.01.2008 02:00:00,1320,-0.41667234241440754,-19.33,IS,0.34,0.0,Phase3-EA-S4v1-EURCHF-M15-221,EURCHFMT4,386,8h 45m,Sell
13106.53,107.03,29.01.2008 19:15:00,,0.0,-404.05999999996857,0.0,0.0,106922,29.01.2008 18:15:00,1321,-0.3903561944724383,27.24,IS,0.27,0.0,Phase3-EA-S1v2-USDJPY-M15-0,USDJPYMT4,492,1h 0m,Buy
13146.88,1.61572,30.01.2008 00:09:57,tp 1.61572,-0.9,-363.70999999996275,0.0,0.0,1.61462,29.01.2008 21:20:00,1322,-0.3513746757698536,40.35,IS,0.41,0.0,Phase3-EA-SA2v2-EURCHF-M5-43,EURCHFMT4,712,2h 49m,Buy
13188.11,1.6151,30.01.2008 03:19:59,tp 1.61510,0.0,-322.4799999999668,0.0,0.0,1.6162,30.01.2008 00:50:00,1323,-0.3115430025082135,41.23,IS,0.41,0.0,Phase3-EA-SA2v2-EURCHF-M5-43,EURCHFMT4,714,2h 29m,Sell
13129.51,212.5,30.01.2008 07:40:00,,0.0,-381.07999999997264,0.0,0.0,212772,30.01.2008 02:15:00,1324,-0.36815556746413325,-58.6,IS,0.23,0.0,Phase3-EA-S4v1-GBPJPY-M5-194,GBPJPYMT4,422,5h 25m,Buy
13254.05,1.6122,30.01.2008 10:29:58,tp 1.61220,0.0,-256.53999999997905,0.0,0.0,1.6162,30.01.2008 01:45:00,1325,-0.24783937566192876,124.54,IS,0.34,0.0,Phase3-EA-S4v1-EURCHF-M15-221,EURCHFMT4,388,8h 44m,Sell
13251.03,107.2,30.01.2008 22:30:00,,0.0,-259.5599999999831,0.0,0.0,107212,30.01.2008 21:15:00,1326,-0.2507569515350873,-3.02,IS,0.27,0.0,Phase3-EA-S1v2-USDJPY-M15-0,USDJPYMT4,494,1h 15m,Buy
13292.57,1.6149,30.01.2008 22:39:58,tp 1.61490,0.0,-218.01999999998952,0.0,0.0,1616,30.01.2008 22:35:00,1327,-0.21062579200832435,41.54,IS,0.41,0.0,Phase3-EA-SA2v2-EURCHF-M5-43,EURCHFMT4,716,4m 58s,Sell
13365.3,106912,30.01.2008 22:45:00,,0.0,-145.2899999999936,0.0,0.0,107202,30.01.2008 22:30:00,1328,-0.1403624498710649,72.73,IS,0.27,0.0,Phase3-EA-S1v2-USDJPY-M15-0,USDJPYMT4,496,15m 0s,Buy
13154.62,106372,30.01.2008 23:59:58,sl 106.372,0.0,-355.9699999999866,0.0,0.0,107.2,30.01.2008 22:30:00,1329,-0.3438971799890102,-210.68,IS,0.27,0.0,Phase3-EA-S1v2-USDJPY-M15-0,USDJPYMT4,497,1h 29m,Sell
12981.59,211292,31.01.2008 00:49:58,sl 211.292,0.0,-528.9999999999854,0.0,0.0,212092,31.01.2008 00:05:00,1330,-0.5110588201651494,-173.03,IS,0.23,0.0,Phase3-EA-S4v1-GBPJPY-M5-194,GBPJPYMT4,424,44m 58s,Buy
12808.27,210482,31.01.2008 02:29:57,sl 210.482,0.0,-702.3199999999924,0.0,0.0,211282,31.01.2008 00:55:00,1331,-0.6785006249118973,-173.32,IS,0.23,0.0,Phase3-EA-S4v1-GBPJPY-M5-194,GBPJPYMT4,426,1h 34m,Buy
12861.76,1.08432,31.01.2008 02:59:58,tp 1.08432,0.0,-648.8299999999872,0.0,0.0,1.08332,31.01.2008 01:30:00,1332,-0.626824752906912,53.49,IS,0.58,0.0,Phase3-EA-SA2v2-USDCHF-M15-107,USDCHFMT4,346,1h 29m,Buy
12868.58,1.6105,31.01.2008 08:50:00,,0.0,-642.0099999999802,0.0,0.0,1.61032,31.01.2008 00:30:00,1333,-0.6202360550741521,6.82,IS,0.41,0.0,Phase3-EA-SA2v2-EURCHF-M5-43,EURCHFMT4,718,8h 20m,Buy
12921.24,1.6093,31.01.2008 11:45:00,,0.0,-589.3499999999767,0.0,0.0,1.60762,31.01.2008 03:00:00,1334,-0.5693620333919228,52.66,IS,0.34,0.0,Phase3-EA-S4v1-EURCHF-M15-221,EURCHFMT4,390,8h 45m,Buy
12962.87,1.6081,31.01.2008 20:44:58,tp 1.60810,0.0,-547.7199999999721,0.0,0.0,1.6092,31.01.2008 20:00:00,1335,-0.5291439262397902,41.63,IS,0.41,0.0,Phase3-EA-SA2v2-EURCHF-M5-43,EURCHFMT4,720,44m 58s,Sell
12923.13,106332,01.02.2008 01:30:00,,-1.14,-587.4599999999773,0.0,0.0,106.18,31.01.2008 18:30:00,1336,-0.5675361332593862,-39.74,IS,0.27,0.0,Phase3-EA-S1v2-USDJPY-M15-0,USDJPYMT4,500,7h 0m,Sell
12940.39,106.4,01.02.2008 04:00:00,,0.0,-570.1999999999825,0.0,0.0,106332,01.02.2008 01:30:00,1337,-0.5508615108850042,17.26,IS,0.27,0.0,Phase3-EA-S1v2-USDJPY-M15-0,USDJPYMT4,502,2h 30m,Buy
12957.82,1.08842,04.02.2008 03:15:00,,-2.82,-552.7699999999895,0.0,0.0,1.0888,01.02.2008 23:00:00,1338,-0.5340226541071683,17.43,IS,0.58,0.0,Phase3-EA-SA2v2-USDCHF-M15-107,USDCHFMT4,348,2d 4h 15m,Sell
12771.59,1.6132,04.02.2008 04:39:57,sl 1.61320,-1.88,-738.9999999999854,0.0,0.0,1.6083,01.02.2008 21:55:00,1339,-0.7139366126692785,-186.23,IS,0.41,0.0,Phase3-EA-SA2v2-EURCHF-M5-43,EURCHFMT4,722,2d 6h 44m,Sell
12686.48,106752,04.02.2008 09:45:00,,-1.14,-824.109999999986,0.0,0.0,106.42,01.02.2008 22:15:00,1340,-0.796160083717024,-85.11,IS,0.27,0.0,Phase3-EA-S1v2-USDJPY-M15-0,USDJPYMT4,504,2d 11h 30m,Sell
12564.83,1.6158,04.02.2008 10:29:58,sl 1.61580,0.0,-945.7599999999802,0.0,0.0,1.6119,04.02.2008 02:15:00,1341,-0.9136842906604817,-121.65,IS,0.34,0.0,Phase3-EA-S4v1-EURCHF-M15-221,EURCHFMT4,392,8h 14m,Sell
12583.43,106672,05.02.2008 00:45:00,,-1.14,-927.1599999999744,0.0,0.0,106.75,04.02.2008 23:30:00,1342,-0.8957151147529676,18.6,IS,0.27,0.0,Phase3-EA-S1v2-USDJPY-M15-0,USDJPYMT4,506,1h 15m,Sell
12581.78,1.6133,05.02.2008 05:15:00,,-0.9,-928.8099999999686,0.0,0.0,1.61332,04.02.2008 20:55:00,1343,-0.8973091545512086,-1.65,IS,0.41,0.0,Phase3-EA-SA2v2-EURCHF-M5-43,EURCHFMT4,724,8h 20m,Buy
12622.8,1.61112,05.02.2008 20:54:58,tp 1.61112,0.0,-887.7899999999645,0.0,0.0,1.61002,05.02.2008 20:30:00,1344,-0.8576803590820649,41.02,IS,0.41,0.0,Phase3-EA-SA2v2-EURCHF-M5-43,EURCHFMT4,726,24m 58s,Buy
12663.83,1.6105,05.02.2008 23:04:57,tp 1.61050,0.0,-846.7599999999657,0.0,0.0,1.6116,05.02.2008 22:40:00,1345,-0.8180419027656639,41.03,IS,0.41,0.0,Phase3-EA-SA2v2-EURCHF-M5-43,EURCHFMT4,728,24m 57s,Sell
12700.13,106732,06.02.2008 00:30:00,,-1.14,-810.4599999999627,0.0,0.0,106.88,05.02.2008 22:30:00,1346,-0.7829730272042331,36.3,IS,0.27,0.0,Phase3-EA-S1v2-USDJPY-M15-0,USDJPYMT4,508,2h 0m,Sell
12784.24,209592,06.02.2008 03:49:58,tp 209.592,0.0,-726.3499999999622,0.0,0.0,209202,06.02.2008 02:20:00,1347,-0.7017156408826978,84.11,IS,0.23,0.0,Phase3-EA-S4v1-GBPJPY-M5-194,GBPJPYMT4,428,1h 29m,Buy
12633.97,1.6055,06.02.2008 10:40:00,,0.0,-876.6199999999662,0.0,0.0,1.60952,06.02.2008 02:20:00,1348,-0.8468891926902993,-150.27,IS,0.41,0.0,Phase3-EA-SA2v2-EURCHF-M5-43,EURCHFMT4,730,8h 20m,Buy
12513.08,1.60562,06.02.2008 10:44:57,sl 1.60562,0.0,-997.5099999999657,0.0,0.0,1.60952,06.02.2008 03:15:00,1349,-0.9636791752418424,-120.89,IS,0.34,0.0,Phase3-EA-S4v1-EURCHF-M15-221,EURCHFMT4,394,7h 29m,Buy
12551.47,1.60752,07.02.2008 00:49:59,tp 1.60752,-2.69,-959.1199999999662,0.0,0.0,1.60642,06.02.2008 21:20:00,1350,-0.9265911826026357,38.39,IS,0.41,0.0,Phase3-EA-SA2v2-EURCHF-M5-43,EURCHFMT4,732,3h 29m,Buy
12592.57,1.6059,07.02.2008 01:04:58,tp 1.60590,0.0,-918.0199999999604,0.0,0.0,1607,07.02.2008 00:55:00,1351,-0.8868851003553934,41.1,IS,0.41,0.0,Phase3-EA-SA2v2-EURCHF-M5-43,EURCHFMT4,734,9m 58s,Sell
12676.88,208.64,07.02.2008 01:24:58,tp 208.640,0.0,-833.7099999999627,0.0,0.0,209.03,07.02.2008 00:55:00,1352,-0.8054344970886188,84.31,IS,0.23,0.0,Phase3-EA-S4v1-GBPJPY-M5-194,GBPJPYMT4,430,29m 58s,Sell
12729.72,1.09762,07.02.2008 02:44:59,tp 1.09762,0.0,-780.8699999999662,0.0,0.0,1.09662,07.02.2008 01:30:00,1353,-0.7543865801556785,52.84,IS,0.58,0.0,Phase3-EA-SA2v2-USDCHF-M15-107,USDCHFMT4,350,1h 14m,Buy
12770.81,1.60522,07.02.2008 08:34:59,tp 1.60522,0.0,-739.7799999999697,0.0,0.0,1.60412,07.02.2008 01:45:00,1354,-0.7146901587557073,41.09,IS,0.41,0.0,Phase3-EA-SA2v2-EURCHF-M5-43,EURCHFMT4,736,6h 49m,Buy
12838.28,1.6061,07.02.2008 12:00:00,,0.0,-672.3099999999686,0.0,0.0,1.60392,07.02.2008 03:15:00,1355,-0.6495084222783081,67.47,IS,0.34,0.0,Phase3-EA-S4v1-EURCHF-M15-221,EURCHFMT4,396,8h 45m,Buy
12879.04,1.6009,07.02.2008 22:14:58,tp 1.60090,0.0,-631.5499999999738,0.0,0.0,1602,07.02.2008 21:35:00,1356,-0.6101308088379879,40.76,IS,0.41,0.0,Phase3-EA-SA2v2-EURCHF-M5-43,EURCHFMT4,738,39m 58s,Sell
12919.03,1.59842,08.02.2008 00:14:57,tp 1.59842,-0.89,-591.5599999999686,0.0,0.0,1.59732,07.02.2008 22:45:00,1357,-0.5714970806368393,39.99,IS,0.41,0.0,Phase3-EA-SA2v2-EURCHF-M5-43,EURCHFMT4,740,1h 29m,Buy
12959.91,1.5977,08.02.2008 02:44:58,tp 1.59770,0.0,-550.6799999999639,0.0,0.0,1.5988,08.02.2008 01:45:00,1358,-0.5320035370293644,40.88,IS,0.41,0.0,Phase3-EA-SA2v2-EURCHF-M5-43,EURCHFMT4,742,59m 58s,Sell
13000.79,1.59852,08.02.2008 04:04:57,tp 1.59852,0.0,-509.79999999995925,0.0,0.0,1.59742,08.02.2008 02:55:00,1359,-0.4925099934218894,40.88,IS,0.41,0.0,Phase3-EA-SA2v2-EURCHF-M5-43,EURCHFMT4,744,1h 9m,Buy
13010.34,107.38,08.02.2008 09:45:00,,0.0,-500.24999999995634,0.0,0.0,107342,08.02.2008 01:30:00,1360,-0.48328388428657976,9.55,IS,0.27,0.0,Phase3-EA-S1v2-USDJPY-M15-0,USDJPYMT4,510,8h 15m,Buy
13029.96,107332,08.02.2008 21:15:00,,0.0,-480.629999999961,0.0,0.0,107.41,08.02.2008 18:30:00,1361,-0.4643293019583413,19.62,IS,0.27,0.0,Phase3-EA-S1v2-USDJPY-M15-0,USDJPYMT4,512,2h 45m,Sell
13069.98,1.60072,11.02.2008 02:10:00,tp 1.60072,-0.89,-440.6099999999569,0.0,0.0,1.59962,08.02.2008 22:20:00,1362,-0.4256665912154077,40.02,IS,0.41,0.0,Phase3-EA-SA2v2-EURCHF-M5-43,EURCHFMT4,746,2d 3h 50m,Buy
13110.92,1.6005,11.02.2008 04:24:57,tp 1.60050,0.0,-399.6699999999546,0.0,0.0,1.6016,11.02.2008 02:35:00,1363,-0.38611508252436233,40.94,IS,0.41,0.0,Phase3-EA-SA2v2-EURCHF-M5-43,EURCHFMT4,748,1h 49m,Sell
13234.7,1.5975,11.02.2008 10:59:58,tp 1.59750,0.0,-275.88999999995576,0.0,0.0,1.6015,11.02.2008 04:00:00,1364,-0.26653311511407246,123.78,IS,0.34,0.0,Phase3-EA-S4v1-EURCHF-M15-221,EURCHFMT4,398,6h 59m,Sell
13336.08,106.53,11.02.2008 17:59:58,tp 106.530,0.0,-174.5099999999511,0.0,0.0,106.93,11.02.2008 17:00:00,1365,-0.1685914455708841,101.38,IS,0.27,0.0,Phase3-EA-S1v2-USDJPY-M15-0,USDJPYMT4,514,59m 58s,Sell
13334.4,1.1014,12.02.2008 02:30:00,,-0.63,-176.18999999994412,0.0,0.0,1.10142,11.02.2008 22:15:00,1366,-0.17021446791091038,-1.68,IS,0.58,0.0,Phase3-EA-SA2v2-USDCHF-M15-107,USDCHFMT4,352,4h 15m,Buy
13369.24,106.96,12.02.2008 04:30:00,,0.0,-141.3499999999476,0.0,0.0,106822,12.02.2008 01:15:00,1367,-0.1365560760497525,34.84,IS,0.27,0.0,Phase3-EA-S1v2-USDJPY-M15-0,USDJPYMT4,516,3h 15m,Buy
13410.18,1.60022,12.02.2008 09:09:58,tp 1.60022,0.0,-100.40999999994528,0.0,0.0,1.59912,12.02.2008 02:30:00,1368,-0.09700456735870717,40.94,IS,0.41,0.0,Phase3-EA-SA2v2-EURCHF-M5-43,EURCHFMT4,750,6h 39m,Buy
13439.83,107.44,12.02.2008 22:00:00,,0.0,-70.7599999999511,0.0,0.0,107322,12.02.2008 20:30:00,1369,-0.06836015522658219,29.65,IS,0.27,0.0,Phase3-EA-S1v2-USDJPY-M15-0,USDJPYMT4,518,1h 30m,Buy
13480.78,1.6075,12.02.2008 23:04:59,tp 1.60750,0.0,-29.809999999954016,0.0,0.0,1.6086,12.02.2008 21:55:00,1370,-0.028798985688279814,40.95,IS,0.41,0.0,Phase3-EA-SA2v2-EURCHF-M5-43,EURCHFMT4,752,1h 9m,Sell
13564.33,210.13,13.02.2008 03:19:59,tp 210.130,0.0,-0.0,0.0,0.0,210.52,13.02.2008 02:40:00,1371,-0.0,83.55,IS,0.23,0.0,Phase3-EA-S4v1-GBPJPY-M5-194,GBPJPYMT4,432,39m 59s,Sell
13643.86,1.6087,13.02.2008 14:45:00,,0.0,-0.0,0.0,0.0,1.60612,13.02.2008 06:00:00,1372,-0.0,79.53,IS,0.34,0.0,Phase3-EA-S4v1-EURCHF-M15-221,EURCHFMT4,400,8h 45m,Buy
13670.8,108.24,13.02.2008 23:45:00,,0.0,-0.0,0.0,0.0,108132,13.02.2008 22:15:00,1373,-0.0,26.94,IS,0.27,0.0,Phase3-EA-S1v2-USDJPY-M15-0,USDJPYMT4,520,1h 30m,Buy
13705.95,1.6141,14.02.2008 01:44:58,tp 1.61410,-5.55,-0.0,0.0,0.0,1.6152,13.02.2008 21:15:00,1374,-0.0,35.15,IS,0.41,0.0,Phase3-EA-SA2v2-EURCHF-M5-43,EURCHFMT4,754,4h 29m,Sell
13697.02,212.25,14.02.2008 06:40:00,,0.0,-8.929999999993015,0.0,0.0,212292,14.02.2008 01:15:00,1375,-0.008610884910646887,-8.93,IS,0.23,0.0,Phase3-EA-S4v1-GBPJPY-M5-194,GBPJPYMT4,434,5h 25m,Buy
13737.73,1.61432,14.02.2008 09:54:58,tp 1.61432,0.0,-0.0,0.0,0.0,1.61322,14.02.2008 02:20:00,1376,-0.0,40.71,IS,0.41,0.0,Phase3-EA-SA2v2-EURCHF-M5-43,EURCHFMT4,756,7h 34m,Buy
13860.34,1.61742,14.02.2008 10:59:58,tp 1.61742,0.0,-0.0,0.0,0.0,1.61342,14.02.2008 03:15:00,1377,-0.0,122.61,IS,0.34,0.0,Phase3-EA-S4v1-EURCHF-M15-221,EURCHFMT4,402,7h 44m,Buy
13923.8,107842,15.02.2008 01:00:00,,-1.13,-0.0,0.0,0.0,108.1,14.02.2008 23:30:00,1378,-0.0,63.46,IS,0.27,0.0,Phase3-EA-S1v2-USDJPY-M15-0,USDJPYMT4,522,1h 30m,Sell
13976.68,1.0969,15.02.2008 01:29:58,tp 1.09690,0.0,-0.0,0.0,0.0,1.0979,15.02.2008 00:15:00,1379,-0.0,52.88,IS,0.58,0.0,Phase3-EA-SA2v2-USDCHF-M15-107,USDCHFMT4,354,1h 14m,Sell
13915.25,1.6063,15.02.2008 04:30:00,,-0.9,-61.429999999993015,0.0,0.0,1.60792,14.02.2008 20:10:00,1380,-0.05908055537067824,-61.43,IS,0.41,0.0,Phase3-EA-SA2v2-EURCHF-M5-43,EURCHFMT4,758,8h 20m,Buy
13954.94,1.6069,15.02.2008 10:30:00,,0.0,-21.739999999990687,0.0,0.0,1.60562,15.02.2008 01:45:00,1381,-0.020908534490609487,39.69,IS,0.34,0.0,Phase3-EA-S4v1-EURCHF-M15-221,EURCHFMT4,404,8h 45m,Buy
13869.86,1.60562,18.02.2008 06:20:00,,-1.87,-106.81999999999243,0.0,0.0,1.6034,15.02.2008 22:00:00,1382,-0.10273457471424581,-85.08,IS,0.41,0.0,Phase3-EA-SA2v2-EURCHF-M5-43,EURCHFMT4,760,2d 8h 20m,Sell
13828.16,107812,18.02.2008 07:15:00,,-1.13,-148.51999999998952,0.0,0.0,107.65,15.02.2008 18:45:00,1383,-0.14283972136828116,-41.7,IS,0.27,0.0,Phase3-EA-S1v2-USDJPY-M15-0,USDJPYMT4,524,2d 12h 30m,Sell
14092.07,1.9476,18.02.2008 14:29:57,tp 1.94760,-0.69,-0.0,0.0,0.0,1.9665,15.02.2008 11:00:00,1384,-0.0,263.91,IS,0.14,0.0,Phase3-EA-B1v1-GBPUSD-M30-14,GBPUSDMT4,100,3d 3h 29m,Sell
14109.04,108.16,18.02.2008 22:00:00,,0.0,-0.0,0.0,0.0,108092,18.02.2008 17:00:00,1385,-0.0,16.97,IS,0.27,0.0,Phase3-EA-S1v2-USDJPY-M15-0,USDJPYMT4,526,5h 0m,Buy
14149.98,1.61502,19.02.2008 07:04:57,tp 1.61502,0.0,-0.0,0.0,0.0,1.61392,19.02.2008 02:45:00,1386,-0.0,40.94,IS,0.41,0.0,Phase3-EA-SA2v2-EURCHF-M5-43,EURCHFMT4,762,4h 19m,Buy
14147.43,211.0,19.02.2008 07:35:00,,0.0,-2.5500000000029104,0.0,0.0,211012,19.02.2008 02:10:00,1387,-0.0024483922128481508,-2.55,IS,0.23,0.0,Phase3-EA-S4v1-GBPJPY-M5-194,GBPJPYMT4,436,5h 25m,Buy
14090.95,1.6127,19.02.2008 12:00:00,,0.0,-59.029999999998836,0.0,0.0,1.61452,19.02.2008 03:15:00,1388,-0.05667787934284648,-56.48,IS,0.34,0.0,Phase3-EA-S4v1-EURCHF-M15-221,EURCHFMT4,406,8h 45m,Buy
14153.08,107.78,19.02.2008 21:30:00,,0.0,-0.0,0.0,0.0,107532,19.02.2008 21:00:00,1389,-0.0,62.13,IS,0.27,0.0,Phase3-EA-S1v2-USDJPY-M15-0,USDJPYMT4,528,30m 0s,Buy
14193.35,1.61272,20.02.2008 05:39:58,tp 1.61272,-0.9,-0.0,0.0,0.0,1.61162,19.02.2008 23:40:00,1390,-0.0,40.27,IS,0.41,0.0,Phase3-EA-SA2v2-EURCHF-M5-43,EURCHFMT4,764,5h 59m,Buy
14160.94,210292,20.02.2008 07:55:00,,0.0,-32.41000000000349,0.0,0.0,210.14,20.02.2008 02:30:00,1391,-0.03110563198131497,-32.41,IS,0.23,0.0,Phase3-EA-S4v1-GBPJPY-M5-194,GBPJPYMT4,438,5h 25m,Sell
14232.85,108.13,20.02.2008 20:15:00,,0.0,-0.0,0.0,0.0,107842,20.02.2008 18:15:00,1392,-0.0,71.91,IS,0.27,0.0,Phase3-EA-S1v2-USDJPY-M15-0,USDJPYMT4,530,2h 0m,Buy
14285.62,1.09912,21.02.2008 03:59:59,tp 1.09912,0.0,-0.0,0.0,0.0,1.09812,21.02.2008 02:30:00,1393,-0.0,52.77,IS,0.58,0.0,Phase3-EA-SA2v2-USDCHF-M15-107,USDCHFMT4,356,1h 29m,Buy
14130.13,1.61812,21.02.2008 04:30:00,,-5.59,-155.49000000000524,0.0,0.0,1.6141,20.02.2008 20:10:00,1394,-0.14910013480286638,-155.49,IS,0.41,0.0,Phase3-EA-SA2v2-EURCHF-M5-43,EURCHFMT4,766,8h 20m,Sell
14018.48,1.62202,21.02.2008 14:45:00,,0.0,-267.1399999999994,0.0,0.0,1.6184,21.02.2008 06:00:00,1395,-0.25616187543402336,-111.65,IS,0.34,0.0,Phase3-EA-S4v1-EURCHF-M15-221,EURCHFMT4,408,8h 45m,Sell
14101.97,210.68,22.02.2008 04:34:58,tp 210.680,0.0,-183.64999999999418,0.0,0.0,211.07,22.02.2008 03:50:00,1396,-0.1761028989423411,83.49,IS,0.23,0.0,Phase3-EA-S4v1-GBPJPY-M5-194,GBPJPYMT4,440,44m 58s,Sell
13987.55,1.6132,22.02.2008 04:35:00,,-0.9,-298.06999999999243,0.0,0.0,1.61622,21.02.2008 20:15:00,1397,-0.2858208063585295,-114.42,IS,0.41,0.0,Phase3-EA-SA2v2-EURCHF-M5-43,EURCHFMT4,768,8h 20m,Buy
13974.48,107442,22.02.2008 10:00:00,,0.0,-311.1399999999994,0.0,0.0,107.39,22.02.2008 00:45:00,1398,-0.29835369440196924,-13.07,IS,0.27,0.0,Phase3-EA-S1v2-USDJPY-M15-0,USDJPYMT4,532,9h 15m,Sell
13998.87,1.61392,22.02.2008 12:30:00,,0.0,-286.75,0.0,0.0,1.6147,22.02.2008 03:45:00,1399,-0.27496600202405613,24.39,IS,0.34,0.0,Phase3-EA-S4v1-EURCHF-M15-221,EURCHFMT4,410,8h 45m,Sell
14099.89,106.91,22.02.2008 18:29:57,tp 106.910,0.0,-185.72999999999593,0.0,0.0,107.31,22.02.2008 17:00:00,1400,-0.17809742129355477,101.02,IS,0.27,0.0,Phase3-EA-S1v2-USDJPY-M15-0,USDJPYMT4,534,1h 29m,Sell
14141.48,1.60842,22.02.2008 23:39:57,tp 1.60842,0.0,-144.13999999999942,0.0,0.0,1.60732,22.02.2008 22:45:00,1401,-0.13821656331908386,41.59,IS,0.41,0.0,Phase3-EA-SA2v2-EURCHF-M5-43,EURCHFMT4,770,54m 57s,Buy
14225.07,210.93,25.02.2008 04:14:59,tp 210.930,0.0,-60.55000000000291,0.0,0.0,211.32,25.02.2008 02:55:00,1402,-0.05806169632975554,83.59,IS,0.23,0.0,Phase3-EA-S4v1-GBPJPY-M5-194,GBPJPYMT4,442,1h 19m,Sell
14064.21,1.61282,25.02.2008 08:10:00,,-1.89,-221.4100000000035,0.0,0.0,1.6086,22.02.2008 23:50:00,1403,-0.21231115085665994,-160.86,IS,0.41,0.0,Phase3-EA-SA2v2-EURCHF-M5-43,EURCHFMT4,772,2d 8h 20m,Sell
14016.74,1.61192,25.02.2008 11:45:00,,0.0,-268.88000000000466,0.0,0.0,1.6104,25.02.2008 03:00:00,1404,-0.25783037009321536,-47.47,IS,0.34,0.0,Phase3-EA-S4v1-EURCHF-M15-221,EURCHFMT4,412,8h 45m,Sell
13974.74,1.9684,25.02.2008 16:59:58,sl 1.96840,0.0,-310.88000000000466,0.0,0.0,1.9654,25.02.2008 08:30:00,1405,-0.29810437910807275,-42.0,IS,0.14,0.0,Phase3-EA-B1v1-GBPUSD-M30-14,GBPUSDMT4,102,8h 29m,Sell
14034.27,107.94,25.02.2008 18:30:00,,0.0,-251.35000000000582,0.0,0.0,107702,25.02.2008 17:00:00,1406,-0.24102076585439622,59.53,IS,0.27,0.0,Phase3-EA-S1v2-USDJPY-M15-0,USDJPYMT4,536,1h 30m,Buy
14075.7,1.61202,25.02.2008 22:29:59,tp 1.61202,0.0,-209.9200000000128,0.0,0.0,1.61092,25.02.2008 21:00:00,1407,-0.20129333267617572,41.43,IS,0.41,0.0,Phase3-EA-SA2v2-EURCHF-M5-43,EURCHFMT4,774,1h 29m,Buy
13975.27,1.61632,26.02.2008 06:55:00,,-1.88,-310.3500000000058,0.0,0.0,1.6137,25.02.2008 22:35:00,1408,-0.29759615947050544,-100.43,IS,0.41,0.0,Phase3-EA-SA2v2-EURCHF-M5-43,EURCHFMT4,776,8h 20m,Sell
14027.82,1.61442,26.02.2008 12:45:00,,0.0,-257.8000000000029,0.0,0.0,1.6161,26.02.2008 04:00:00,1409,-0.24720570295310368,52.55,IS,0.34,0.0,Phase3-EA-S4v1-EURCHF-M15-221,EURCHFMT4,414,8h 45m,Sell
14068.86,1.61352,27.02.2008 01:19:58,tp 1.61352,-0.91,-216.7600000000093,0.0,0.0,1.61242,26.02.2008 20:45:00,1410,-0.20785224271573488,41.04,IS,0.41,0.0,Phase3-EA-SA2v2-EURCHF-M5-43,EURCHFMT4,778,4h 34m,Buy
13857.34,1.07272,27.02.2008 01:29:58,sl 1.07272,-0.65,-428.2800000000134,0.0,0.0,1.07662,26.02.2008 22:45:00,1411,-0.410679823354373,-211.52,IS,0.58,0.0,Phase3-EA-SA2v2-USDCHF-M15-107,USDCHFMT4,358,2h 44m,Buy
13872.08,106262,27.02.2008 17:30:00,,0.0,-413.54000000000815,0.0,0.0,106.32,27.02.2008 17:15:00,1412,-0.3965455640001061,14.74,IS,0.27,0.0,Phase3-EA-S1v2-USDJPY-M15-0,USDJPYMT4,538,15m 0s,Sell
13779.82,1.6061,28.02.2008 06:30:00,,-2.78,-505.8000000000029,0.0,0.0,1.60842,27.02.2008 22:10:00,1413,-0.48501413713607117,-92.26,IS,0.41,0.0,Phase3-EA-SA2v2-EURCHF-M5-43,EURCHFMT4,780,8h 20m,Buy
13766.62,106.39,28.02.2008 11:00:00,,0.0,-519.0,0.0,0.0,106442,28.02.2008 00:45:00,1414,-0.49767168282645213,-13.2,IS,0.27,0.0,Phase3-EA-S1v2-USDJPY-M15-0,USDJPYMT4,540,10h 15m,Buy
13679.51,1.6031,28.02.2008 14:30:00,,0.0,-606.1100000000006,0.0,0.0,1.60582,28.02.2008 05:45:00,1415,-0.58120189533322,-87.11,IS,0.34,0.0,Phase3-EA-S4v1-EURCHF-M15-221,EURCHFMT4,416,8h 45m,Buy
13722.46,1.59812,28.02.2008 23:04:57,tp 1.59812,0.0,-563.1600000000035,0.0,0.0,1.59702,28.02.2008 20:30:00,1416,-0.5400169265906484,42.95,IS,0.41,0.0,Phase3-EA-SA2v2-EURCHF-M5-43,EURCHFMT4,782,2h 34m,Buy
13791.33,105072,29.02.2008 02:45:00,,0.0,-494.29000000000815,0.0,0.0,105.34,29.02.2008 01:00:00,1417,-0.4739771408560522,68.87,IS,0.27,0.0,Phase3-EA-S1v2-USDJPY-M15-0,USDJPYMT4,542,1h 45m,Sell
13616.25,208472,29.02.2008 02:49:58,sl 208.472,0.0,-669.3700000000099,0.0,0.0,209272,29.02.2008 01:45:00,1418,-0.6418622241494165,-175.08,IS,0.23,0.0,Phase3-EA-S4v1-GBPJPY-M5-194,GBPJPYMT4,444,1h 4m,Buy
13772.37,209.08,29.02.2008 02:59:58,tp 209.080,-1.97,-513.2500000000146,0.0,0.0,210.93,27.02.2008 23:30:00,1419,-0.4921579792113368,156.12,IS,0.09,0.0,Phase3-EA-B1v1-GBPJPY-M30-1,GBPJPYMT4,194,1d 3h 29m,Sell
13827.6,1.0502,29.02.2008 04:29:58,tp 1.05020,0.0,-458.0200000000186,0.0,0.0,1.0512,29.02.2008 01:15:00,1420,-0.4391976573568032,55.23,IS,0.58,0.0,Phase3-EA-SA2v2-USDCHF-M15-107,USDCHFMT4,360,3h 14m,Sell
13651.75,207942,29.02.2008 04:59:58,sl 207.942,0.0,-633.8700000000244,0.0,0.0,208742,29.02.2008 03:00:00,1421,-0.6078210974821106,-175.85,IS,0.23,0.0,Phase3-EA-S4v1-GBPJPY-M5-194,GBPJPYMT4,446,1h 59m,Buy
13524.86,1.59002,29.02.2008 13:59:58,sl 1.59002,0.0,-760.7600000000239,0.0,0.0,1.59392,29.02.2008 06:30:00,1422,-0.7294965499558066,-126.89,IS,0.34,0.0,Phase3-EA-S4v1-EURCHF-M15-221,EURCHFMT4,418,7h 29m,Buy
13684.6,205.96,29.02.2008 14:29:57,tp 205.960,0.0,-601.0200000000186,0.0,0.0,207.81,29.02.2008 11:00:00,1423,-0.5763210690026273,159.74,IS,0.09,0.0,Phase3-EA-B1v1-GBPJPY-M30-1,GBPJPYMT4,196,3h 29m,Sell
13642.6,1.98662,29.02.2008 19:29:57,sl 1.98662,0.0,-643.0200000000186,0.0,0.0,1.98962,29.02.2008 19:00:00,1424,-0.6165950780174846,-42.0,IS,0.14,0.0,Phase3-EA-B1v1-GBPUSD-M30-14,GBPUSDMT4,104,29m 57s,Buy
13681.04,103942,29.02.2008 22:00:00,,0.0,-604.5800000000163,0.0,0.0,104.09,29.02.2008 19:00:00,1425,-0.5797347707191224,38.44,IS,0.27,0.0,Phase3-EA-S1v2-USDJPY-M15-0,USDJPYMT4,544,3h 0m,Sell
13487.1,1.57932,03.03.2008 02:00:00,sl 1.57932,-0.94,-798.5200000000186,0.0,0.0,1.58422,29.02.2008 20:20:00,1426,-0.7657048018701114,-193.94,IS,0.41,0.0,Phase3-EA-SA2v2-EURCHF-M5-43,EURCHFMT4,784,2d 5h 40m,Buy
13530.75,1.57272,03.03.2008 02:04:57,tp 1.57272,0.0,-754.8700000000244,0.0,0.0,1.57162,03.03.2008 02:00:00,1427,-0.7238485996439616,43.65,IS,0.41,0.0,Phase3-EA-SA2v2-EURCHF-M5-43,EURCHFMT4,786,4m 57s,Buy
13586.84,1.03412,03.03.2008 02:29:57,tp 1.03412,0.0,-698.7800000000279,0.0,0.0,1.03312,03.03.2008 02:00:00,1428,-0.6700636195095995,56.09,IS,0.58,0.0,Phase3-EA-SA2v2-USDCHF-M15-107,USDCHFMT4,362,29m 57s,Buy
13630.44,1.57182,03.03.2008 02:39:58,tp 1.57182,0.0,-655.1800000000221,0.0,0.0,1.57072,03.03.2008 02:20:00,1429,-0.6282553625322658,43.6,IS,0.41,0.0,Phase3-EA-SA2v2-EURCHF-M5-43,EURCHFMT4,788,19m 58s,Buy
13686.46,1.03542,03.03.2008 03:29:58,tp 1.03542,0.0,-599.160000000018,0.0,0.0,1.03442,03.03.2008 02:30:00,1430,-0.5745375057462544,56.02,IS,0.58,0.0,Phase3-EA-SA2v2-USDCHF-M15-107,USDCHFMT4,364,59m 58s,Buy
13648.12,204.67,03.03.2008 07:45:00,,0.0,-637.5000000000146,0.0,0.0,204842,03.03.2008 02:20:00,1431,-0.6113019225469566,-38.34,IS,0.23,0.0,Phase3-EA-S4v1-GBPJPY-M5-194,GBPJPYMT4,448,5h 25m,Buy
13699.86,1.5755,03.03.2008 12:15:00,,0.0,-585.7600000000093,0.0,0.0,1.57392,03.03.2008 03:30:00,1432,-0.5616881790605535,51.74,IS,0.34,0.0,Phase3-EA-S4v1-EURCHF-M15-221,EURCHFMT4,420,8h 45m,Buy
13641.29,204.82,03.03.2008 12:59:58,sl 204.820,0.0,-644.3300000000163,0.0,0.0,204.15,03.03.2008 09:30:00,1433,-0.6178512435367554,-58.57,IS,0.09,0.0,Phase3-EA-B1v1-GBPJPY-M30-1,GBPJPYMT4,198,3h 29m,Sell
13681.76,103.46,04.03.2008 09:45:00,,-0.76,-603.8600000000151,0.0,0.0,103302,03.03.2008 22:30:00,1434,-0.5790443591360095,40.47,IS,0.27,0.0,Phase3-EA-S1v2-USDJPY-M15-0,USDJPYMT4,546,11h 15m,Buy
13602.14,1.5804,04.03.2008 11:15:00,,0.0,-683.4800000000105,0.0,0.0,1.58242,04.03.2008 02:55:00,1435,-0.6553923733684561,-79.62,IS,0.41,0.0,Phase3-EA-SA2v2-EURCHF-M5-43,EURCHFMT4,790,8h 20m,Buy
13522.93,1.5783,04.03.2008 13:30:00,,0.0,-762.6900000000169,0.0,0.0,1.58072,04.03.2008 04:45:00,1436,-0.7313472365605302,-79.21,IS,0.34,0.0,Phase3-EA-S4v1-EURCHF-M15-221,EURCHFMT4,422,8h 45m,Buy
13566.48,1.5753,04.03.2008 23:04:57,tp 1.57530,0.0,-719.140000000014,0.0,0.0,1.5764,04.03.2008 22:55:00,1437,-0.6895869248320264,43.55,IS,0.41,0.0,Phase3-EA-SA2v2-EURCHF-M5-43,EURCHFMT4,792,9m 57s,Sell
13547.93,1.57902,05.03.2008 08:00:00,,-1.98,-737.6900000000169,0.0,0.0,1.5786,04.03.2008 23:40:00,1438,-0.7073746121469247,-18.55,IS,0.41,0.0,Phase3-EA-SA2v2-EURCHF-M5-43,EURCHFMT4,794,8h 20m,Sell
13678.8,1.5765,05.03.2008 10:44:57,tp 1.57650,0.0,-606.8200000000215,0.0,0.0,1.5805,05.03.2008 03:00:00,1439,-0.5818827178665865,130.87,IS,0.34,0.0,Phase3-EA-S4v1-EURCHF-M15-221,EURCHFMT4,424,7h 44m,Sell
13722.74,104.02,06.03.2008 00:15:00,,-2.26,-562.8800000000192,0.0,0.0,103842,05.03.2008 23:15:00,1440,-0.5397484331972311,43.94,IS,0.27,0.0,Phase3-EA-S1v2-USDJPY-M15-0,USDJPYMT4,548,1h 0m,Buy
13809.12,206.81,06.03.2008 03:14:57,tp 206.810,0.0,-476.50000000001455,0.0,0.0,207.2,06.03.2008 00:35:00,1441,-0.4569182213233366,86.38,IS,0.23,0.0,Phase3-EA-S4v1-GBPJPY-M5-194,GBPJPYMT4,450,2h 39m,Sell
13744.99,1.58402,06.03.2008 08:45:00,,0.0,-540.6300000000192,0.0,0.0,1.5824,06.03.2008 00:25:00,1442,-0.518412797469122,-64.13,IS,0.41,0.0,Phase3-EA-SA2v2-EURCHF-M5-43,EURCHFMT4,796,8h 20m,Sell
13786.65,206.85,06.03.2008 09:00:00,,0.0,-498.9700000000157,0.0,0.0,206662,06.03.2008 03:35:00,1443,-0.4784648161462864,41.66,IS,0.23,0.0,Phase3-EA-S4v1-GBPJPY-M5-194,GBPJPYMT4,452,5h 25m,Buy
13865.11,1.58122,06.03.2008 13:00:00,,0.0,-420.5100000000093,0.0,0.0,1.5836,06.03.2008 04:15:00,1444,-0.40322913168662045,78.46,IS,0.34,0.0,Phase3-EA-S4v1-EURCHF-M15-221,EURCHFMT4,426,8h 45m,Sell
13856.74,103262,06.03.2008 17:30:00,,0.0,-428.88000000000466,0.0,0.0,103.23,06.03.2008 17:15:00,1445,-0.41125516634029113,-8.37,IS,0.27,0.0,Phase3-EA-S1v2-USDJPY-M15-0,USDJPYMT4,550,15m 0s,Sell
13900.67,1.57792,06.03.2008 21:14:58,tp 1.57792,0.0,-384.95000000001164,0.0,0.0,1.57682,06.03.2008 20:55:00,1446,-0.3691304707207101,43.93,IS,0.41,0.0,Phase3-EA-SA2v2-EURCHF-M5-43,EURCHFMT4,798,19m 58s,Buy
13923.78,102832,06.03.2008 23:15:00,,0.0,-361.84000000001106,0.0,0.0,102.92,06.03.2008 23:00:00,1447,-0.3469701767127725,23.11,IS,0.27,0.0,Phase3-EA-S1v2-USDJPY-M15-0,USDJPYMT4,552,15m 0s,Sell
13701.62,1.02132,07.03.2008 00:14:57,sl 1.02132,-0.68,-584.0000000000146,0.0,0.0,1.02522,06.03.2008 22:30:00,1448,-0.5600005063018406,-222.16,IS,0.58,0.0,Phase3-EA-SA2v2-USDCHF-M15-107,USDCHFMT4,366,1h 44m,Buy
13789.05,206672,07.03.2008 02:14:57,tp 206.672,0.0,-496.57000000002154,0.0,0.0,206282,07.03.2008 00:05:00,1449,-0.47616344420258583,87.43,IS,0.23,0.0,Phase3-EA-S4v1-GBPJPY-M5-194,GBPJPYMT4,454,2h 9m,Buy
13782.24,1.0226,07.03.2008 04:30:00,,0.0,-503.3800000000192,0.0,0.0,1.02272,07.03.2008 00:15:00,1450,-0.48269358709284976,-6.81,IS,0.58,0.0,Phase3-EA-SA2v2-USDCHF-M15-107,USDCHFMT4,368,4h 15m,Buy
13644.2,1.5732,07.03.2008 06:05:00,,-0.96,-641.4200000000128,0.0,0.0,1.57662,06.03.2008 21:45:00,1451,-0.6150608300550082,-138.04,IS,0.41,0.0,Phase3-EA-SA2v2-EURCHF-M5-43,EURCHFMT4,800,8h 20m,Buy
13590.05,206772,07.03.2008 07:45:00,,0.0,-695.570000000007,0.0,0.0,206.53,07.03.2008 02:20:00,1452,-0.6669855345348724,-54.15,IS,0.23,0.0,Phase3-EA-S4v1-GBPJPY-M5-194,GBPJPYMT4,456,5h 25m,Sell
13722.95,1.57662,07.03.2008 09:59:57,tp 1.57662,0.0,-562.6700000000128,0.0,0.0,1.57262,07.03.2008 01:45:00,1453,-0.5395470631521506,132.9,IS,0.34,0.0,Phase3-EA-S4v1-EURCHF-M15-221,EURCHFMT4,428,8h 14m,Buy
13505.17,102.9,07.03.2008 18:44:58,sl 102.900,0.0,-780.4500000000116,0.0,0.0,102.07,07.03.2008 17:00:00,1454,-0.7483773889439506,-217.78,IS,0.27,0.0,Phase3-EA-S1v2-USDJPY-M15-0,USDJPYMT4,554,1h 44m,Sell
13549.19,1.57182,07.03.2008 20:34:58,tp 1.57182,0.0,-736.4300000000076,0.0,0.0,1.57072,07.03.2008 20:25:00,1455,-0.7061663918764699,44.02,IS,0.41,0.0,Phase3-EA-SA2v2-EURCHF-M5-43,EURCHFMT4,802,9m 58s,Buy
13654.13,102912,07.03.2008 23:29:57,tp 102.912,0.0,-631.4900000000052,0.0,0.0,102512,07.03.2008 21:45:00,1456,-0.6055389036379168,104.94,IS,0.27,0.0,Phase3-EA-S1v2-USDJPY-M15-0,USDJPYMT4,556,1h 44m,Buy
13740.21,206.71,10.03.2008 02:00:00,tp 206.710,-1.3,-545.4100000000035,0.0,0.0,207.1,07.03.2008 23:30:00,1457,-0.5229963632569884,86.08,IS,0.23,0.0,Phase3-EA-S4v1-GBPJPY-M5-194,GBPJPYMT4,458,2d 2h 30m,Sell
13844.48,102.42,10.03.2008 02:00:00,tp 102.420,-1.18,-441.1399999999994,0.0,0.0,102.82,07.03.2008 23:45:00,1458,-0.4230113413527183,104.27,IS,0.27,0.0,Phase3-EA-S1v2-USDJPY-M15-0,USDJPYMT4,558,2d 2h 15m,Sell
13901.3,1.02082,10.03.2008 03:14:57,tp 1.02082,0.0,-384.31999999999243,0.0,0.0,1.01982,10.03.2008 02:30:00,1459,-0.36852636058546884,56.82,IS,0.58,0.0,Phase3-EA-SA2v2-USDCHF-M15-107,USDCHFMT4,370,44m 57s,Buy
13905.35,206.46,10.03.2008 07:35:00,,0.0,-380.2699999999895,0.0,0.0,206442,10.03.2008 02:10:00,1460,-0.3646427954304619,4.05,IS,0.23,0.0,Phase3-EA-S4v1-GBPJPY-M5-194,GBPJPYMT4,460,5h 25m,Buy
13888.47,1.5701,10.03.2008 10:35:00,,0.0,-397.1499999999942,0.0,0.0,1.57052,10.03.2008 02:15:00,1461,-0.38082911143453285,-16.88,IS,0.41,0.0,Phase3-EA-SA2v2-EURCHF-M5-43,EURCHFMT4,804,8h 20m,Buy
13845.94,2.01082,10.03.2008 19:59:59,sl 2.01082,-0.53,-439.679999999993,0.0,0.0,2.01382,07.03.2008 12:00:00,1462,-0.4216113400869576,-42.53,IS,0.14,0.0,Phase3-EA-B1v1-GBPUSD-M30-14,GBPUSDMT4,106,3d 7h 59m,Buy
13934.1,204422,11.03.2008 01:54:57,tp 204.422,0.0,-351.5199999999895,0.0,0.0,204032,11.03.2008 01:05:00,1463,-0.3370742773548155,88.16,IS,0.23,0.0,Phase3-EA-S4v1-GBPJPY-M5-194,GBPJPYMT4,462,49m 57s,Buy
13944.19,101692,11.03.2008 02:30:00,,0.0,-341.429999999993,0.0,0.0,101.73,11.03.2008 00:45:00,1464,-0.32739892614148763,10.09,IS,0.27,0.0,Phase3-EA-S1v2-USDJPY-M15-0,USDJPYMT4,560,1h 45m,Sell
14032.48,204152,11.03.2008 03:49:58,tp 204.152,0.0,-253.13999999999942,0.0,0.0,203762,11.03.2008 03:00:00,1465,-0.24273720576240423,88.29,IS,0.23,0.0,Phase3-EA-S4v1-GBPJPY-M5-194,GBPJPYMT4,464,49m 58s,Buy
14075.77,1.56522,11.03.2008 04:39:57,tp 1.56522,-0.97,-209.85000000000582,0.0,0.0,1.56412,10.03.2008 20:20:00,1466,-0.20122620932781093,43.29,IS,0.41,0.0,Phase3-EA-SA2v2-EURCHF-M5-43,EURCHFMT4,806,8h 19m,Buy
14132.67,1.01942,11.03.2008 04:44:57,tp 1.01942,0.0,-152.95000000001164,0.0,0.0,1.01842,11.03.2008 02:15:00,1467,-0.1466645161624502,56.9,IS,0.58,0.0,Phase3-EA-SA2v2-USDCHF-M15-107,USDCHFMT4,372,2h 29m,Buy
14073.4,204.68,11.03.2008 08:59:58,sl 204.680,0.0,-212.22000000001572,0.0,0.0,204.01,11.03.2008 01:00:00,1468,-0.20349881412223023,-59.27,IS,0.09,0.0,Phase3-EA-B1v1-GBPJPY-M30-1,GBPJPYMT4,200,7h 59m,Sell
14206.69,1.56642,11.03.2008 09:29:57,tp 1.56642,0.0,-78.93000000002212,0.0,0.0,1.56242,11.03.2008 03:30:00,1469,-0.0756863697986568,133.29,IS,0.34,0.0,Phase3-EA-S4v1-EURCHF-M15-221,EURCHFMT4,430,5h 59m,Buy
14148.31,206332,11.03.2008 18:59:57,sl 206.332,0.0,-137.31000000002678,0.0,0.0,207002,11.03.2008 16:00:00,1470,-0.13166724232931304,-58.38,IS,0.09,0.0,Phase3-EA-B1v1-GBPJPY-M30-1,GBPJPYMT4,202,2h 59m,Buy
14252.81,103352,11.03.2008 21:59:58,tp 103.352,0.0,-32.810000000026776,0.0,0.0,102952,11.03.2008 20:00:00,1471,-0.03146167228044166,104.5,IS,0.27,0.0,Phase3-EA-S1v2-USDJPY-M15-0,USDJPYMT4,562,1h 59m,Buy
14056.74,1.5875,12.03.2008 01:24:58,sl 1.58750,-1.98,-228.88000000003376,0.0,0.0,1.5826,11.03.2008 21:45:00,1472,-0.2194741710314743,-196.07,IS,0.41,0.0,Phase3-EA-SA2v2-EURCHF-M5-43,EURCHFMT4,808,3h 39m,Sell
14100.37,1.5861,12.03.2008 01:49:59,tp 1.58610,0.0,-185.2500000000291,0.0,0.0,1.5872,12.03.2008 01:25:00,1473,-0.17763714690484536,43.63,IS,0.41,0.0,Phase3-EA-SA2v2-EURCHF-M5-43,EURCHFMT4,810,24m 59s,Sell
14153.57,1.0325,12.03.2008 02:15:00,tp 1.03250,-2.97,-132.05000000003201,0.0,0.0,1.0335,11.03.2008 22:00:00,1474,-0.12662340215269544,53.2,IS,0.58,0.0,Phase3-EA-SA2v2-USDCHF-M15-107,USDCHFMT4,374,4h 15m,Sell
14285.53,1.5815,12.03.2008 03:59:57,tp 1.58150,0.0,-0.09000000002561137,0.0,0.0,1.5855,12.03.2008 02:00:00,1475,-8.630144791353901E-5,131.96,IS,0.34,0.0,Phase3-EA-S4v1-EURCHF-M15-221,EURCHFMT4,432,1h 59m,Sell
14226.63,206632,12.03.2008 03:59:58,sl 206.632,-0.31,-58.99000000001979,0.0,0.0,207302,11.03.2008 23:00:00,1476,-0.05656580456636274,-58.9,IS,0.09,0.0,Phase3-EA-B1v1-GBPJPY-M30-1,GBPJPYMT4,204,4h 59m,Buy
14332.18,102.32,12.03.2008 19:29:57,tp 102.320,0.0,-0.0,0.0,0.0,102.72,12.03.2008 18:15:00,1477,-0.0,105.55,IS,0.27,0.0,Phase3-EA-S1v2-USDJPY-M15-0,USDJPYMT4,564,1h 14m,Sell
14376.44,1.58082,12.03.2008 21:04:57,tp 1.58082,0.0,-0.0,0.0,0.0,1.57972,12.03.2008 20:25:00,1478,-0.0,44.26,IS,0.41,0.0,Phase3-EA-SA2v2-EURCHF-M5-43,EURCHFMT4,812,39m 57s,Buy
14433.6,1.01472,12.03.2008 23:44:59,tp 1.01472,0.0,-0.0,0.0,0.0,1.01372,12.03.2008 23:15:00,1479,-0.0,57.16,IS,0.58,0.0,Phase3-EA-SA2v2-USDCHF-M15-107,USDCHFMT4,376,29m 59s,Buy
14478.01,1.5775,13.03.2008 02:39:58,tp 1.57750,0.0,-0.0,0.0,0.0,1.5786,13.03.2008 02:10:00,1480,-0.0,44.41,IS,0.41,0.0,Phase3-EA-SA2v2-EURCHF-M5-43,EURCHFMT4,814,29m 58s,Sell
14566.32,205882,13.03.2008 03:10:00,tp 205.882,0.0,-0.0,0.0,0.0,205492,13.03.2008 00:55:00,1481,-0.0,88.31,IS,0.23,0.0,Phase3-EA-S4v1-GBPJPY-M5-194,GBPJPYMT4,466,2h 15m,Buy
14435.22,1.57282,13.03.2008 07:44:58,sl 1.57282,0.0,-131.10000000000582,0.0,0.0,1.57672,13.03.2008 05:00:00,1482,-0.12537497733496372,-131.1,IS,0.34,0.0,Phase3-EA-S4v1-EURCHF-M15-221,EURCHFMT4,434,2h 44m,Buy
14477.89,1.5771,14.03.2008 00:29:58,tp 1.57710,-2.03,-88.43000000000757,0.0,0.0,1.5782,13.03.2008 20:35:00,1483,-0.08456833902159647,42.67,IS,0.41,0.0,Phase3-EA-SA2v2-EURCHF-M5-43,EURCHFMT4,816,3h 54m,Sell
14522.56,1.57742,14.03.2008 01:49:57,tp 1.57742,0.0,-43.76000000000931,0.0,0.0,1.57632,14.03.2008 00:55:00,1484,-0.04184903896398883,44.67,IS,0.41,0.0,Phase3-EA-SA2v2-EURCHF-M5-43,EURCHFMT4,818,54m 57s,Buy
14579.21,1.01152,14.03.2008 03:29:59,tp 1.01152,-0.69,-0.0,0.0,0.0,1.01052,13.03.2008 23:30:00,1485,-0.0,56.65,IS,0.58,0.0,Phase3-EA-SA2v2-USDCHF-M15-107,USDCHFMT4,378,3h 59m,Buy
14667.27,204992,14.03.2008 03:34:57,tp 204.992,-0.82,-0.0,0.0,0.0,204602,13.03.2008 23:25:00,1486,-0.0,88.06,IS,0.23,0.0,Phase3-EA-S4v1-GBPJPY-M5-194,GBPJPYMT4,468,4h 9m,Buy
14754.19,100.98,14.03.2008 04:00:00,,-0.78,-0.0,0.0,0.0,100652,13.03.2008 23:15:00,1487,-0.0,86.92,IS,0.27,0.0,Phase3-EA-S1v2-USDJPY-M15-0,USDJPYMT4,566,4h 45m,Buy
14843.08,204.53,14.03.2008 04:14:57,tp 204.530,0.0,-0.0,0.0,0.0,204.92,14.03.2008 03:40:00,1488,-0.0,88.89,IS,0.23,0.0,Phase3-EA-S4v1-GBPJPY-M5-194,GBPJPYMT4,470,34m 57s,Sell
14642.32,1.56412,14.03.2008 21:29:58,sl 1.56412,0.0,-200.75999999999476,0.0,0.0,1.56902,14.03.2008 20:30:00,1489,-0.19148617152414305,-200.76,IS,0.41,0.0,Phase3-EA-SA2v2-EURCHF-M5-43,EURCHFMT4,820,59m 58s,Buy
14687.4,1.56522,14.03.2008 21:44:58,tp 1.56522,0.0,-155.67999999999302,0.0,0.0,1.56412,14.03.2008 21:35:00,1490,-0.14848857931300075,45.08,IS,0.41,0.0,Phase3-EA-SA2v2-EURCHF-M5-43,EURCHFMT4,822,9m 58s,Buy
14778.59,199072,17.03.2008 02:14:58,tp 199.072,0.0,-64.48999999999069,0.0,0.0,198682,17.03.2008 02:10:00,1491,-0.061510974305591375,91.19,IS,0.23,0.0,Phase3-EA-S4v1-GBPJPY-M5-194,GBPJPYMT4,472,4m 58s,Buy
14824.12,1.55952,17.03.2008 02:19:58,tp 1.55952,0.0,-18.95999999999185,0.0,0.0,1.55842,17.03.2008 02:15:00,1492,-0.018084169217455103,45.53,IS,0.41,0.0,Phase3-EA-SA2v2-EURCHF-M5-43,EURCHFMT4,824,4m 58s,Buy
14916.18,196142,17.03.2008 03:49:59,tp 196.142,0.0,-0.0,0.0,0.0,195752,17.03.2008 03:45:00,1493,-0.0,92.06,IS,0.23,0.0,Phase3-EA-S4v1-GBPJPY-M5-194,GBPJPYMT4,474,4m 59s,Buy
14780.86,1.54812,17.03.2008 04:44:57,sl 1.54812,0.0,-135.32000000000698,0.0,0.0,1.55202,17.03.2008 04:30:00,1494,-0.12897915269123103,-135.32,IS,0.34,0.0,Phase3-EA-S4v1-EURCHF-M15-221,EURCHFMT4,436,14m 57s,Buy
14920.4,1.54522,17.03.2008 07:14:57,tp 1.54522,0.0,-0.0,0.0,0.0,1.54122,17.03.2008 06:00:00,1495,-0.0,139.54,IS,0.34,0.0,Phase3-EA-S4v1-EURCHF-M15-221,EURCHFMT4,438,1h 14m,Buy
14857.98,193.85,17.03.2008 15:29:57,sl 193.850,0.0,-62.419999999998254,0.0,0.0,193.18,17.03.2008 14:00:00,1496,-0.05949272019549885,-62.42,IS,0.09,0.0,Phase3-EA-B1v1-GBPJPY-M30-1,GBPJPYMT4,206,1h 29m,Sell
14903.67,1.5536,17.03.2008 22:54:58,tp 1.55360,0.0,-16.729999999995925,0.0,0.0,1.5547,17.03.2008 22:40:00,1497,-0.015945421481423923,45.69,IS,0.41,0.0,Phase3-EA-SA2v2-EURCHF-M5-43,EURCHFMT4,826,14m 58s,Sell
14995.76,194632,17.03.2008 23:49:57,tp 194.632,0.0,-0.0,0.0,0.0,194242,17.03.2008 23:30:00,1498,-0.0,92.09,IS,0.23,0.0,Phase3-EA-S4v1-GBPJPY-M5-194,GBPJPYMT4,476,19m 57s,Buy
14993.95,97082,18.03.2008 03:00:00,,-1.25,-1.8099999999976717,0.0,0.0,97.08,17.03.2008 17:15:00,1499,-0.001723879135688593,-1.81,IS,0.27,0.0,Phase3-EA-S1v2-USDJPY-M15-0,USDJPYMT4,568,9h 45m,Sell
14788.12,1.54512,18.03.2008 05:19:58,sl 1.54512,-1.0,-207.63999999999942,0.0,0.0,1.55002,17.03.2008 23:25:00,1500,-0.19776036670433086,-205.83,IS,0.41,0.0,Phase3-EA-SA2v2-EURCHF-M5-43,EURCHFMT4,828,5h 54m,Buy
14880.55,194412,18.03.2008 06:54:58,tp 194.412,0.0,-115.2100000000064,0.0,0.0,194022,18.03.2008 03:05:00,1501,-0.10972824045466813,92.43,IS,0.23,0.0,Phase3-EA-S4v1-GBPJPY-M5-194,GBPJPYMT4,478,3h 49m,Buy
15018.86,1.55242,18.03.2008 10:14:58,tp 1.55242,0.0,-0.0,0.0,0.0,1.54842,18.03.2008 04:00:00,1502,-0.0,138.31,IS,0.34,0.0,Phase3-EA-S4v1-EURCHF-M15-221,EURCHFMT4,440,6h 14m,Buy
15064.27,1.5625,18.03.2008 21:19:58,tp 1.56250,0.0,-0.0,0.0,0.0,1.5636,18.03.2008 20:30:00,1503,-0.0,45.41,IS,0.41,0.0,Phase3-EA-SA2v2-EURCHF-M5-43,EURCHFMT4,830,49m 58s,Sell
15003.23,199162,18.03.2008 21:29:58,sl 199.162,0.0,-61.0399999999936,0.0,0.0,199832,18.03.2008 20:30:00,1504,-0.05809777196376421,-61.04,IS,0.09,0.0,Phase3-EA-B1v1-GBPJPY-M30-1,GBPJPYMT4,208,59m 58s,Buy
15048.62,1.56112,18.03.2008 21:49:59,tp 1.56112,0.0,-15.64999999999418,0.0,0.0,1.56002,18.03.2008 21:40:00,1505,-0.014895644351780259,45.39,IS,0.41,0.0,Phase3-EA-SA2v2-EURCHF-M5-43,EURCHFMT4,832,9m 59s,Buy
15158.06,98682,18.03.2008 21:59:59,tp 98.682,0.0,-0.0,0.0,0.0,98282,18.03.2008 21:30:00,1506,-0.0,109.44,IS,0.27,0.0,Phase3-EA-S1v2-USDJPY-M15-0,USDJPYMT4,570,29m 59s,Buy
15216.28,0.9962,18.03.2008 22:29:57,tp 0.99620,0.0,-0.0,0.0,0.0,0.9972,18.03.2008 22:15:00,1507,-0.0,58.22,IS,0.58,0.0,Phase3-EA-SA2v2-USDCHF-M15-107,USDCHFMT4,380,14m 57s,Sell
15382.44,201682,19.03.2008 01:29:58,tp 201.682,-0.32,-0.0,0.0,0.0,199832,18.03.2008 22:00:00,1508,-0.0,166.16,IS,0.09,0.0,Phase3-EA-B1v1-GBPJPY-M30-1,GBPJPYMT4,210,3h 29m,Buy
15472.03,201.16,19.03.2008 01:49:58,tp 201.160,0.0,-0.0,0.0,0.0,201.55,19.03.2008 01:30:00,1509,-0.0,89.59,IS,0.23,0.0,Phase3-EA-S4v1-GBPJPY-M5-194,GBPJPYMT4,480,19m 58s,Sell
15411.76,200882,19.03.2008 02:29:57,sl 200.882,0.0,-60.270000000004075,0.0,0.0,201552,19.03.2008 01:30:00,1510,-0.05714311178044454,-60.27,IS,0.09,0.0,Phase3-EA-B1v1-GBPJPY-M30-1,GBPJPYMT4,212,59m 57s,Buy
15454.83,1.5656,19.03.2008 02:49:58,tp 1.56560,-2.05,-17.19999999999709,0.0,0.0,1.5667,18.03.2008 23:20:00,1511,-0.016307640992590234,43.07,IS,0.41,0.0,Phase3-EA-SA2v2-EURCHF-M5-43,EURCHFMT4,834,3h 29m,Sell
15509.73,1.0005,19.03.2008 02:59:57,tp 1.00050,-3.07,-0.0,0.0,0.0,1.0015,18.03.2008 23:00:00,1512,-0.0,54.9,IS,0.58,0.0,Phase3-EA-SA2v2-USDCHF-M15-107,USDCHFMT4,382,3h 59m,Sell
15645.96,1.5636,19.03.2008 03:29:57,tp 1.56360,0.0,-0.0,0.0,0.0,1.5676,19.03.2008 01:30:00,1513,-0.0,136.23,IS,0.34,0.0,Phase3-EA-S4v1-EURCHF-M15-221,EURCHFMT4,442,1h 59m,Sell
15736.03,200342,19.03.2008 03:44:58,tp 200.342,0.0,-0.0,0.0,0.0,199952,19.03.2008 03:20:00,1514,-0.0,90.07,IS,0.23,0.0,Phase3-EA-S4v1-GBPJPY-M5-194,GBPJPYMT4,482,24m 58s,Buy
15781.09,1.56622,19.03.2008 04:24:59,tp 1.56622,0.0,-0.0,0.0,0.0,1.56512,19.03.2008 02:55:00,1515,-0.0,45.06,IS,0.41,0.0,Phase3-EA-SA2v2-EURCHF-M5-43,EURCHFMT4,836,1h 29m,Buy
15826.21,1.56242,19.03.2008 21:34:58,tp 1.56242,0.0,-0.0,0.0,0.0,1.56132,19.03.2008 20:55:00,1516,-0.0,45.12,IS,0.41,0.0,Phase3-EA-SA2v2-EURCHF-M5-43,EURCHFMT4,838,39m 58s,Buy
15934.99,99282,19.03.2008 21:59:58,tp 99.282,0.0,-0.0,0.0,0.0,98882,19.03.2008 19:45:00,1517,-0.0,108.78,IS,0.27,0.0,Phase3-EA-S1v2-USDJPY-M15-0,USDJPYMT4,572,2h 14m,Buy
15980.18,1.55982,19.03.2008 23:44:58,tp 1.55982,0.0,-0.0,0.0,0.0,1.55872,19.03.2008 23:30:00,1518,-0.0,45.19,IS,0.41,0.0,Phase3-EA-SA2v2-EURCHF-M5-43,EURCHFMT4,840,14m 58s,Buy
16025.44,1.55952,20.03.2008 01:09:58,tp 1.55952,0.0,-0.0,0.0,0.0,1.55842,20.03.2008 00:45:00,1519,-0.0,45.26,IS,0.41,0.0,Phase3-EA-SA2v2-EURCHF-M5-43,EURCHFMT4,842,24m 58s,Buy
16083.58,0.99762,20.03.2008 01:44:58,tp 0.99762,0.0,-0.0,0.0,0.0,0.99662,20.03.2008 00:15:00,1520,-0.0,58.14,IS,0.58,0.0,Phase3-EA-SA2v2-USDCHF-M15-107,USDCHFMT4,384,1h 29m,Buy
16048.88,1.5588,20.03.2008 10:00:00,,0.0,-34.69999999999709,0.0,0.0,1.55982,20.03.2008 01:15:00,1521,-0.032710057484859625,-34.7,IS,0.34,0.0,Phase3-EA-S4v1-EURCHF-M15-221,EURCHFMT4,444,8h 45m,Buy
16093.56,1.55952,20.03.2008 22:04:58,tp 1.55952,0.0,-0.0,0.0,0.0,1.55842,20.03.2008 20:05:00,1522,-0.0,44.68,IS,0.41,0.0,Phase3-EA-SA2v2-EURCHF-M5-43,EURCHFMT4,844,1h 59m,Buy
16138.16,1.5589,20.03.2008 22:54:59,tp 1.55890,0.0,-0.0,0.0,0.0,1.56,20.03.2008 22:30:00,1523,-0.0,44.6,IS,0.41,0.0,Phase3-EA-SA2v2-EURCHF-M5-43,EURCHFMT4,846,24m 59s,Sell
16162.08,99.35,20.03.2008 23:30:00,,0.0,-0.0,0.0,0.0,99262,20.03.2008 17:00:00,1524,-0.0,23.92,IS,0.27,0.0,Phase3-EA-S1v2-USDJPY-M15-0,USDJPYMT4,574,6h 30m,Buy
16219.47,1.0106,20.03.2008 23:44:58,tp 1.01060,0.0,-0.0,0.0,0.0,1.0116,20.03.2008 23:15:00,1525,-0.0,57.39,IS,0.58,0.0,Phase3-EA-SA2v2-USDCHF-M15-107,USDCHFMT4,386,29m 58s,Sell
16309.79,196.96,21.03.2008 01:04:58,tp 196.960,0.0,-0.0,0.0,0.0,197.35,21.03.2008 00:20:00,1526,-0.0,90.32,IS,0.23,0.0,Phase3-EA-S4v1-GBPJPY-M5-194,GBPJPYMT4,484,44m 58s,Sell
16367.42,1.00642,21.03.2008 02:59:59,tp 1.00642,0.0,-0.0,0.0,0.0,1.00542,21.03.2008 02:30:00,1527,-0.0,57.63,IS,0.58,0.0,Phase3-EA-SA2v2-USDCHF-M15-107,USDCHFMT4,388,29m 59s,Buy
16448.37,99.39,21.03.2008 03:15:00,,0.0,-0.0,0.0,0.0,99092,21.03.2008 01:45:00,1528,-0.0,80.95,IS,0.27,0.0,Phase3-EA-S1v2-USDJPY-M15-0,USDJPYMT4,576,1h 30m,Buy
16538.58,197.1,21.03.2008 04:04:57,tp 197.100,0.0,-0.0,0.0,0.0,197.49,21.03.2008 03:30:00,1529,-0.0,90.21,IS,0.23,0.0,Phase3-EA-S4v1-GBPJPY-M5-194,GBPJPYMT4,486,34m 57s,Sell
16583.27,1.55672,21.03.2008 06:49:57,tp 1.55672,0.0,-0.0,0.0,0.0,1.55562,21.03.2008 01:00:00,1530,-0.0,44.69,IS,0.41,0.0,Phase3-EA-SA2v2-EURCHF-M5-43,EURCHFMT4,848,5h 49m,Buy
16717.97,1.55852,21.03.2008 09:14:58,tp 1.55852,0.0,-0.0,0.0,0.0,1.55452,21.03.2008 03:00:00,1531,-0.0,134.7,IS,0.34,0.0,Phase3-EA-S4v1-EURCHF-M15-221,EURCHFMT4,446,6h 14m,Buy
16675.97,1.98252,21.03.2008 09:59:57,sl 1.98252,0.0,-42.0,0.0,0.0,1.98552,21.03.2008 02:00:00,1532,-0.03935607095974553,-42.0,IS,0.14,0.0,Phase3-EA-B1v1-GBPUSD-M30-14,GBPUSDMT4,108,7h 59m,Buy
16720.61,1.55862,21.03.2008 23:39:59,tp 1.55862,0.0,-0.0,0.0,0.0,1.55752,21.03.2008 21:55:00,1533,-0.0,44.64,IS,0.41,0.0,Phase3-EA-SA2v2-EURCHF-M5-43,EURCHFMT4,850,1h 44m,Buy
16765.29,1.5577,21.03.2008 23:50:00,tp 1.55770,0.0,-0.0,0.0,0.0,1.5588,21.03.2008 23:45:00,1534,-0.0,44.68,IS,0.41,0.0,Phase3-EA-SA2v2-EURCHF-M5-43,EURCHFMT4,852,5m 0s,Sell
16809.86,1.5587,24.03.2008 02:14:57,tp 1.55870,0.0,-0.0,0.0,0.0,1.5598,24.03.2008 02:10:00,1535,-0.0,44.57,IS,0.41,0.0,Phase3-EA-SA2v2-EURCHF-M5-43,EURCHFMT4,854,4m 57s,Sell
16734.33,197472,24.03.2008 05:05:00,,-1.34,-75.52999999999884,0.0,0.0,197.15,21.03.2008 23:40:00,1536,-0.07071444527686745,-75.53,IS,0.23,0.0,Phase3-EA-S4v1-GBPJPY-M5-194,GBPJPYMT4,488,2d 5h 25m,Sell
16603.92,1.5663,24.03.2008 12:59:59,sl 1.56630,0.0,-205.94000000000233,0.0,0.0,1.5624,24.03.2008 05:15:00,1537,-0.19280991474008305,-130.41,IS,0.34,0.0,Phase3-EA-S4v1-EURCHF-M15-221,EURCHFMT4,448,7h 44m,Sell
16502.03,99772,24.03.2008 14:00:00,,-1.22,-307.83000000000175,0.0,0.0,99.4,21.03.2008 18:45:00,1538,-0.2882037295058727,-101.89,IS,0.27,0.0,Phase3-EA-S1v2-USDJPY-M15-0,USDJPYMT4,578,2d 19h 15m,Sell
16460.03,1.97982,24.03.2008 17:29:58,sl 1.97982,0.0,-349.83000000000175,0.0,0.0,1.98282,24.03.2008 13:00:00,1539,-0.3275259418933807,-42.0,IS,0.14,0.0,Phase3-EA-B1v1-GBPUSD-M30-14,GBPUSDMT4,110,4h 29m,Buy
16504.13,1.57572,24.03.2008 21:19:58,tp 1.57572,0.0,-305.7299999999959,0.0,0.0,1.57462,24.03.2008 21:15:00,1540,-0.28623761888649185,44.1,IS,0.41,0.0,Phase3-EA-SA2v2-EURCHF-M5-43,EURCHFMT4,856,4m 58s,Buy
16560.97,1.02042,24.03.2008 23:44:58,tp 1.02042,0.0,-248.88999999999942,0.0,0.0,1.01942,24.03.2008 23:30:00,1541,-0.23302155812206765,56.84,IS,0.58,0.0,Phase3-EA-SA2v2-USDCHF-M15-107,USDCHFMT4,390,14m 58s,Buy
16588.72,100682,25.03.2008 00:45:00,,-1.21,-221.13999999999942,0.0,0.0,100.79,24.03.2008 23:00:00,1542,-0.20704081065174987,27.75,IS,0.27,0.0,Phase3-EA-S1v2-USDJPY-M15-0,USDJPYMT4,580,1h 45m,Sell
16632.03,1.57512,25.03.2008 04:04:57,tp 1.57512,-0.96,-177.83000000000175,0.0,0.0,1.57402,24.03.2008 22:35:00,1543,-0.16649211973501465,43.31,IS,0.41,0.0,Phase3-EA-SA2v2-EURCHF-M5-43,EURCHFMT4,858,5h 29m,Buy
16765.19,1.57642,25.03.2008 04:44:57,tp 1.57642,0.0,-44.669999999998254,0.0,0.0,1.57242,25.03.2008 01:15:00,1544,-0.04182198160356937,133.16,IS,0.34,0.0,Phase3-EA-S4v1-EURCHF-M15-221,EURCHFMT4,450,3h 29m,Buy
16734.29,1.57552,25.03.2008 13:45:00,,0.0,-75.56999999999243,0.0,0.0,1.5746,25.03.2008 05:00:00,1545,-0.07075189500294479,-30.9,IS,0.34,0.0,Phase3-EA-S4v1-EURCHF-M15-221,EURCHFMT4,452,8h 45m,Sell
16778.97,1.5736,25.03.2008 21:19:58,tp 1.57360,0.0,-30.889999999999418,0.0,0.0,1.5747,25.03.2008 20:05:00,1546,-0.0289205509678595,44.68,IS,0.41,0.0,Phase3-EA-SA2v2-EURCHF-M5-43,EURCHFMT4,860,1h 14m,Sell
16817.68,100082,26.03.2008 00:15:00,,-1.22,-0.0,0.0,0.0,100.23,25.03.2008 19:30:00,1547,-0.0,38.71,IS,0.27,0.0,Phase3-EA-S1v2-USDJPY-M15-0,USDJPYMT4,582,4h 45m,Sell
16875.22,1008,26.03.2008 03:29:57,tp 1.00800,0.0,-0.0,0.0,0.0,1009,26.03.2008 02:30:00,1548,-0.0,57.54,IS,0.58,0.0,Phase3-EA-SA2v2-USDCHF-M15-107,USDCHFMT4,392,59m 57s,Sell
16920.09,1.5741,26.03.2008 03:39:59,tp 1.57410,0.0,-0.0,0.0,0.0,1.5752,26.03.2008 01:35:00,1549,-0.0,44.87,IS,0.41,0.0,Phase3-EA-SA2v2-EURCHF-M5-43,EURCHFMT4,862,2h 4m,Sell
16914.15,100.06,26.03.2008 09:00:00,,0.0,-5.940000000002328,0.0,0.0,100082,26.03.2008 00:15:00,1550,-0.005555550879168098,-5.94,IS,0.27,0.0,Phase3-EA-S1v2-USDJPY-M15-0,USDJPYMT4,584,8h 45m,Buy
16923.58,1.57462,26.03.2008 10:30:00,,0.0,-0.0,0.0,0.0,1.5749,26.03.2008 01:45:00,1551,-0.0,9.43,IS,0.34,0.0,Phase3-EA-S4v1-EURCHF-M15-221,EURCHFMT4,454,8h 45m,Sell
16881.58,2.00642,26.03.2008 12:59:58,sl 2.00642,0.0,-42.0,0.0,0.0,2.00942,26.03.2008 12:30:00,1552,-0.03928039072391698,-42.0,IS,0.14,0.0,Phase3-EA-B1v1-GBPUSD-M30-14,GBPUSDMT4,112,29m 58s,Buy
16820.3,198842,26.03.2008 13:29:58,sl 198.842,-0.64,-103.27999999999884,0.0,0.0,199512,24.03.2008 17:30:00,1553,-0.09659235128490713,-61.28,IS,0.09,0.0,Phase3-EA-B1v1-GBPJPY-M30-1,GBPJPYMT4,214,1d 19h 59m,Buy
16884.99,99.33,26.03.2008 19:45:00,,0.0,-38.58999999999651,0.0,0.0,99092,26.03.2008 18:15:00,1554,-0.036091197096090925,64.69,IS,0.27,0.0,Phase3-EA-S1v2-USDJPY-M15-0,USDJPYMT4,586,1h 30m,Buy
16930.34,1.56912,26.03.2008 20:09:57,tp 1.56912,0.0,-0.0,0.0,0.0,1.56802,26.03.2008 20:05:00,1555,-0.0,45.35,IS,0.41,0.0,Phase3-EA-SA2v2-EURCHF-M5-43,EURCHFMT4,864,4m 57s,Buy
16975.76,1.5696,26.03.2008 20:39:58,tp 1.56960,0.0,-0.0,0.0,0.0,1.5707,26.03.2008 20:25:00,1556,-0.0,45.42,IS,0.41,0.0,Phase3-EA-SA2v2-EURCHF-M5-43,EURCHFMT4,866,14m 58s,Sell
17021.22,1.56742,26.03.2008 21:14:59,tp 1.56742,0.0,-0.0,0.0,0.0,1.56632,26.03.2008 21:05:00,1557,-0.0,45.46,IS,0.41,0.0,Phase3-EA-SA2v2-EURCHF-M5-43,EURCHFMT4,868,9m 59s,Buy
17066.78,1.56732,27.03.2008 02:00:00,tp 1.56732,0.0,-0.0,0.0,0.0,1.56622,27.03.2008 00:30:00,1558,-0.0,45.56,IS,0.41,0.0,Phase3-EA-SA2v2-EURCHF-M5-43,EURCHFMT4,870,1h 30m,Buy
17123.22,0.99062,27.03.2008 02:14:57,tp 0.99062,-2.11,-0.0,0.0,0.0,0.98962,26.03.2008 23:15:00,1559,-0.0,56.44,IS,0.58,0.0,Phase3-EA-SA2v2-USDCHF-M15-107,USDCHFMT4,394,2h 59m,Buy
17054.33,1.57072,27.03.2008 12:00:00,,0.0,-68.88999999999942,0.0,0.0,1.5687,27.03.2008 03:15:00,1560,-0.0643091199088296,-68.89,IS,0.34,0.0,Phase3-EA-S4v1-EURCHF-M15-221,EURCHFMT4,456,8h 45m,Sell
16993.98,200732,27.03.2008 17:29:58,sl 200.732,0.0,-129.24000000000524,0.0,0.0,201402,27.03.2008 16:00:00,1561,-0.12064611201941566,-60.35,IS,0.09,0.0,Phase3-EA-B1v1-GBPJPY-M30-1,GBPJPYMT4,216,1h 29m,Buy
17102.1,99892,27.03.2008 18:59:58,tp 99.892,0.0,-21.120000000009895,0.0,0.0,99492,27.03.2008 17:30:00,1562,-0.019715613477647394,108.12,IS,0.27,0.0,Phase3-EA-S1v2-USDJPY-M15-0,USDJPYMT4,588,1h 29m,Buy
17210.0,100092,27.03.2008 21:44:58,tp 100.092,0.0,-0.0,0.0,0.0,99692,27.03.2008 20:45:00,1563,-0.0,107.9,IS,0.27,0.0,Phase3-EA-S1v2-USDJPY-M15-0,USDJPYMT4,590,59m 58s,Buy
17156.23,0.9924,28.03.2008 04:45:00,,0.0,-53.770000000004075,0.0,0.0,0.99332,28.03.2008 00:30:00,1564,-0.05015390355377671,-53.77,IS,0.58,0.0,Phase3-EA-SA2v2-USDCHF-M15-107,USDCHFMT4,396,4h 15m,Buy
17125.14,99.81,28.03.2008 06:45:00,,-0.79,-84.86000000000058,0.0,0.0,99922,27.03.2008 22:15:00,1565,-0.07915306407984375,-31.09,IS,0.27,0.0,Phase3-EA-S1v2-USDJPY-M15-0,USDJPYMT4,592,8h 30m,Buy
17106.81,1.5682,28.03.2008 07:05:00,,-0.99,-103.19000000000233,0.0,0.0,1.56862,27.03.2008 22:45:00,1566,-0.09625034978080609,-18.33,IS,0.41,0.0,Phase3-EA-SA2v2-EURCHF-M5-43,EURCHFMT4,872,8h 20m,Buy
17243.35,1.57152,28.03.2008 10:44:58,tp 1.57152,0.0,-0.0,0.0,0.0,1.56752,28.03.2008 04:15:00,1567,-0.0,136.54,IS,0.34,0.0,Phase3-EA-S4v1-EURCHF-M15-221,EURCHFMT4,458,6h 29m,Buy
17286.62,1.5714,31.03.2008 01:00:00,tp 1.57140,-2.06,-0.0,0.0,0.0,1.5725,28.03.2008 23:20:00,1568,-0.0,43.27,IS,0.41,0.0,Phase3-EA-SA2v2-EURCHF-M5-43,EURCHFMT4,874,2d 1h 40m,Sell
17377.32,197372,31.03.2008 01:49:58,tp 197.372,0.0,-0.0,0.0,0.0,196982,31.03.2008 01:30:00,1569,-0.0,90.7,IS,0.23,0.0,Phase3-EA-S4v1-GBPJPY-M5-194,GBPJPYMT4,490,19m 58s,Buy
17422.66,1.57052,31.03.2008 01:59:59,tp 1.57052,0.0,-0.0,0.0,0.0,1.56942,31.03.2008 01:25:00,1570,-0.0,45.34,IS,0.41,0.0,Phase3-EA-SA2v2-EURCHF-M5-43,EURCHFMT4,876,34m 59s,Buy
17558.98,1.57392,31.03.2008 03:14:57,tp 1.57392,0.0,-0.0,0.0,0.0,1.56992,31.03.2008 01:45:00,1571,-0.0,136.32,IS,0.34,0.0,Phase3-EA-S4v1-EURCHF-M15-221,EURCHFMT4,460,1h 29m,Buy
17374.19,198.77,31.03.2008 03:24:58,sl 198.770,0.0,-184.7899999999936,0.0,0.0,197.97,31.03.2008 03:10:00,1572,-0.17180341427558482,-184.79,IS,0.23,0.0,Phase3-EA-S4v1-GBPJPY-M5-194,GBPJPYMT4,492,14m 58s,Sell
17312.87,198.43,31.03.2008 03:29:58,sl 198.430,-0.53,-246.11000000000058,0.0,0.0,197.76,28.03.2008 23:00:00,1573,-0.22881399581885245,-61.32,IS,0.09,0.0,Phase3-EA-B1v1-GBPJPY-M30-1,GBPJPYMT4,218,2d 4h 29m,Sell
17358.13,1.5721,31.03.2008 10:04:57,tp 1.57210,0.0,-200.85000000000582,0.0,0.0,1.5732,31.03.2008 02:55:00,1574,-0.186734757060736,45.26,IS,0.41,0.0,Phase3-EA-SA2v2-EURCHF-M5-43,EURCHFMT4,878,7h 9m,Sell
17494.77,1.5694,31.03.2008 10:44:58,tp 1.56940,0.0,-64.2100000000064,0.0,0.0,1.5734,31.03.2008 03:15:00,1575,-0.05969747946662039,136.64,IS,0.34,0.0,Phase3-EA-S4v1-EURCHF-M15-221,EURCHFMT4,462,7h 29m,Sell
17540.13,1.5678,31.03.2008 21:54:57,tp 1.56780,0.0,-18.85000000000582,0.0,0.0,1.5689,31.03.2008 21:40:00,1576,-0.017525268462015724,45.36,IS,0.41,0.0,Phase3-EA-SA2v2-EURCHF-M5-43,EURCHFMT4,880,14m 57s,Sell
17598.25,99.92,01.04.2008 00:30:00,,-0.79,-0.0,0.0,0.0,99702,31.03.2008 22:45:00,1577,-0.0,58.12,IS,0.27,0.0,Phase3-EA-S1v2-USDJPY-M15-0,USDJPYMT4,594,1h 45m,Buy
17592.3,99.9,01.04.2008 00:45:00,,0.0,-5.94999999999709,0.0,0.0,99922,01.04.2008 00:30:00,1578,-0.005529829713770516,-5.95,IS,0.27,0.0,Phase3-EA-S1v2-USDJPY-M15-0,USDJPYMT4,596,15m 0s,Buy
17636.6,1.56892,01.04.2008 01:19:57,tp 1.56892,-0.99,-0.0,0.0,0.0,1.56782,31.03.2008 23:00:00,1579,-0.0,44.3,IS,0.41,0.0,Phase3-EA-SA2v2-EURCHF-M5-43,EURCHFMT4,882,2h 19m,Buy
17681.93,1.5676,01.04.2008 01:54:59,tp 1.56760,0.0,-0.0,0.0,0.0,1.5687,01.04.2008 01:20:00,1580,-0.0,45.33,IS,0.41,0.0,Phase3-EA-SA2v2-EURCHF-M5-43,EURCHFMT4,884,34m 59s,Sell
17740.26,0.9944,01.04.2008 02:14:57,tp 0.99440,0.0,-0.0,0.0,0.0,0.9954,01.04.2008 01:30:00,1581,-0.0,58.33,IS,0.58,0.0,Phase3-EA-SA2v2-USDCHF-M15-107,USDCHFMT4,398,44m 57s,Sell
17607.95,1.5727,01.04.2008 11:44:58,sl 1.57270,0.0,-132.30999999999767,0.0,0.0,1.5688,01.04.2008 05:00:00,1582,-0.12280460433267708,-132.31,IS,0.34,0.0,Phase3-EA-S4v1-EURCHF-M15-221,EURCHFMT4,464,6h 44m,Sell
17565.95,1.98242,01.04.2008 15:59:58,sl 1.98242,0.0,-174.30999999999767,0.0,0.0,1.98542,01.04.2008 15:00:00,1583,-0.16178724647592044,-42.0,IS,0.14,0.0,Phase3-EA-B1v1-GBPUSD-M30-14,GBPUSDMT4,114,59m 58s,Buy
17627.96,101682,02.04.2008 01:15:00,,-1.19,-112.30000000000291,0.0,0.0,101.92,01.04.2008 23:15:00,1584,-0.10423215982586528,62.01,IS,0.27,0.0,Phase3-EA-S1v2-USDJPY-M15-0,USDJPYMT4,598,2h 0m,Sell
17670.53,1.5789,02.04.2008 03:19:58,tp 1.57890,-2.03,-69.72999999999593,0.0,0.0,1.58,01.04.2008 22:00:00,1585,-0.06472046753924286,42.57,IS,0.41,0.0,Phase3-EA-SA2v2-EURCHF-M5-43,EURCHFMT4,886,5h 19m,Sell
17758.65,201382,02.04.2008 03:49:57,tp 201.382,0.0,-0.0,0.0,0.0,200992,02.04.2008 01:20:00,1586,-0.0,88.12,IS,0.23,0.0,Phase3-EA-S4v1-GBPJPY-M5-194,GBPJPYMT4,494,2h 29m,Buy
17763.24,1.0119,02.04.2008 05:30:00,,0.0,-0.0,0.0,0.0,1.01182,02.04.2008 01:15:00,1587,-0.0,4.59,IS,0.58,0.0,Phase3-EA-SA2v2-USDCHF-M15-107,USDCHFMT4,400,4h 15m,Buy
17853.4,1.5817,02.04.2008 12:15:00,,0.0,-0.0,0.0,0.0,1.57902,02.04.2008 03:30:00,1588,-0.0,90.16,IS,0.34,0.0,Phase3-EA-S4v1-EURCHF-M15-221,EURCHFMT4,466,8h 45m,Buy
17821.56,102.36,03.04.2008 04:15:00,,-2.3,-31.839999999996508,0.0,0.0,102472,02.04.2008 20:15:00,1589,-0.02952155425790608,-31.84,IS,0.27,0.0,Phase3-EA-S1v2-USDJPY-M15-0,USDJPYMT4,600,8h 0m,Buy
17834.03,1.5825,03.04.2008 06:10:00,,-2.93,-19.369999999995343,0.0,0.0,1.58212,02.04.2008 21:50:00,1590,-0.017959563629885867,12.47,IS,0.41,0.0,Phase3-EA-SA2v2-EURCHF-M5-43,EURCHFMT4,888,8h 20m,Buy
17968.24,1.58512,03.04.2008 07:29:58,tp 1.58512,0.0,-0.0,0.0,0.0,1.58112,03.04.2008 02:00:00,1591,-0.0,134.21,IS,0.34,0.0,Phase3-EA-S4v1-EURCHF-M15-221,EURCHFMT4,468,5h 29m,Buy
18129.38,204532,03.04.2008 09:29:58,tp 204.532,-0.95,-0.0,0.0,0.0,202682,02.04.2008 15:30:00,1592,-0.0,161.14,IS,0.09,0.0,Phase3-EA-B1v1-GBPJPY-M30-1,GBPJPYMT4,220,17h 59m,Buy
18087.38,1.98472,03.04.2008 10:59:57,sl 1.98472,0.0,-42.0,0.0,0.0,1.98772,03.04.2008 03:30:00,1593,-0.03884235718358872,-42.0,IS,0.14,0.0,Phase3-EA-B1v1-GBPUSD-M30-14,GBPUSDMT4,116,7h 29m,Buy
18138.48,102242,04.04.2008 01:15:00,,-1.19,-0.0,0.0,0.0,102.44,03.04.2008 19:45:00,1594,-0.0,51.1,IS,0.27,0.0,Phase3-EA-S1v2-USDJPY-M15-0,USDJPYMT4,602,5h 30m,Sell
18018.13,1.58482,04.04.2008 05:20:00,,-2.03,-120.35000000000582,0.0,0.0,1.5819,03.04.2008 21:00:00,1595,-0.11129248348969367,-120.35,IS,0.41,0.0,Phase3-EA-SA2v2-EURCHF-M5-43,EURCHFMT4,890,8h 20m,Sell
17965.41,1.01222,04.04.2008 07:00:00,,0.0,-173.07000000000698,0.0,0.0,1.0113,04.04.2008 02:45:00,1596,-0.16004478701754157,-52.72,IS,0.58,0.0,Phase3-EA-SA2v2-USDCHF-M15-107,USDCHFMT4,402,4h 15m,Sell
17951.29,1.58412,04.04.2008 09:45:00,,0.0,-187.19000000000233,0.0,0.0,1.5837,04.04.2008 01:00:00,1597,-0.173102118690777,-14.12,IS,0.34,0.0,Phase3-EA-S4v1-EURCHF-M15-221,EURCHFMT4,470,8h 45m,Sell
18057.51,101.68,04.04.2008 22:14:58,tp 101.680,0.0,-80.97000000000116,0.0,0.0,102.08,04.04.2008 20:00:00,1598,-0.0748762142763622,106.22,IS,0.27,0.0,Phase3-EA-S1v2-USDJPY-M15-0,USDJPYMT4,604,2h 14m,Sell
18102.35,1.5823,04.04.2008 22:49:57,tp 1.58230,0.0,-36.13000000000466,0.0,0.0,1.5834,04.04.2008 20:30:00,1599,-0.033410863551997974,44.84,IS,0.41,0.0,Phase3-EA-SA2v2-EURCHF-M5-43,EURCHFMT4,892,2h 19m,Sell
18146.07,1.58382,07.04.2008 04:54:58,tp 1.58382,-0.98,-0.0,0.0,0.0,1.58272,04.04.2008 23:20:00,1600,-0.0,43.72,IS,0.41,0.0,Phase3-EA-SA2v2-EURCHF-M5-43,EURCHFMT4,894,2d 5h 34m,Buy
18015.17,1.5878,07.04.2008 09:14:58,sl 1.58780,0.0,-130.89999999999418,0.0,0.0,1.5839,07.04.2008 06:15:00,1601,-0.12103999710761014,-130.9,IS,0.34,0.0,Phase3-EA-S4v1-EURCHF-M15-221,EURCHFMT4,472,2h 59m,Sell
17790.37,1.00932,08.04.2008 03:29:58,sl 1.00932,-0.69,-355.6999999999971,0.0,0.0,1.01322,07.04.2008 23:30:00,1602,-0.32890700512741394,-224.8,IS,0.58,0.0,Phase3-EA-SA2v2-USDCHF-M15-107,USDCHFMT4,404,3h 59m,Buy
17678.79,1591,08.04.2008 05:20:00,,-0.97,-467.27999999999884,0.0,0.0,1.59372,07.04.2008 21:00:00,1603,-0.4320822753892012,-111.58,IS,0.41,0.0,Phase3-EA-SA2v2-EURCHF-M5-43,EURCHFMT4,896,8h 20m,Buy
17636.79,1.98752,08.04.2008 07:59:58,sl 1.98752,0.0,-509.27999999999884,0.0,0.0,1.99052,08.04.2008 03:30:00,1604,-0.47091863809752704,-42.0,IS,0.14,0.0,Phase3-EA-B1v1-GBPUSD-M30-14,GBPUSDMT4,118,4h 29m,Buy
17652.92,1.5915,08.04.2008 09:45:00,,0.0,-493.1499999999942,0.0,0.0,1.59102,08.04.2008 01:00:00,1605,-0.45600362546692047,16.13,IS,0.34,0.0,Phase3-EA-S4v1-EURCHF-M15-221,EURCHFMT4,474,8h 45m,Buy
17697.49,1.59202,08.04.2008 21:54:57,tp 1.59202,0.0,-448.5799999999872,0.0,0.0,1.59092,08.04.2008 21:20:00,1606,-0.41479084723095966,44.57,IS,0.41,0.0,Phase3-EA-SA2v2-EURCHF-M5-43,EURCHFMT4,898,34m 57s,Buy
17738.29,102.64,09.04.2008 00:15:00,,-0.76,-407.7799999999843,0.0,0.0,102482,08.04.2008 20:15:00,1607,-0.3770640948857262,40.8,IS,0.27,0.0,Phase3-EA-S1v2-USDJPY-M15-0,USDJPYMT4,606,4h 0m,Buy
17825.75,201.78,09.04.2008 00:44:57,tp 201.780,0.0,-320.3199999999779,0.0,0.0,202.17,09.04.2008 00:05:00,1608,-0.2961919929221446,87.46,IS,0.23,0.0,Phase3-EA-S4v1-GBPJPY-M5-194,GBPJPYMT4,496,39m 57s,Sell
17868.23,1.5922,09.04.2008 05:04:58,tp 1.59220,-2.02,-277.83999999998196,0.0,0.0,1.5933,08.04.2008 23:00:00,1609,-0.2569117860685845,42.48,IS,0.41,0.0,Phase3-EA-SA2v2-EURCHF-M5-43,EURCHFMT4,900,6h 4m,Sell
17826.23,1.9689,09.04.2008 09:29:57,sl 1.96890,0.0,-319.83999999998196,0.0,0.0,1.9659,09.04.2008 06:30:00,1610,-0.29574814877691036,-42.0,IS,0.14,0.0,Phase3-EA-B1v1-GBPUSD-M30-14,GBPUSDMT4,120,2h 59m,Sell
17960.55,1.5905,09.04.2008 10:59:58,tp 1.59050,0.0,-185.51999999997497,0.0,0.0,1.5945,09.04.2008 02:30:00,1611,-0.17154576213446754,134.32,IS,0.34,0.0,Phase3-EA-S4v1-EURCHF-M15-221,EURCHFMT4,476,8h 29m,Sell
18012.23,101622,10.04.2008 03:15:00,,-3.58,-133.83999999998196,0.0,0.0,101.83,09.04.2008 23:15:00,1612,-0.12375854249718164,51.68,IS,0.27,0.0,Phase3-EA-S1v2-USDJPY-M15-0,USDJPYMT4,608,4h 0m,Sell
18051.14,1.5841,10.04.2008 03:24:58,tp 1.58410,-6.14,-94.92999999997846,0.0,0.0,1.5852,09.04.2008 22:45:00,1613,-0.08777942647382227,38.91,IS,0.41,0.0,Phase3-EA-SA2v2-EURCHF-M5-43,EURCHFMT4,902,4h 39m,Sell
17824.63,0.99862,10.04.2008 03:44:57,sl 0.99862,0.0,-321.4399999999732,0.0,0.0,1.00252,10.04.2008 01:15:00,1614,-0.29722762926102897,-226.51,IS,0.58,0.0,Phase3-EA-SA2v2-USDCHF-M15-107,USDCHFMT4,406,2h 29m,Buy
17960.77,1.5826,10.04.2008 03:44:57,tp 1.58260,0.0,-185.2999999999738,0.0,0.0,1.5866,10.04.2008 01:45:00,1615,-0.17134233356789905,136.14,IS,0.34,0.0,Phase3-EA-S4v1-EURCHF-M15-221,EURCHFMT4,478,1h 59m,Sell
17827.84,1.57862,10.04.2008 07:59:57,sl 1.57862,0.0,-318.2299999999668,0.0,0.0,1.58252,10.04.2008 04:45:00,1616,-0.2942594215397438,-132.93,IS,0.34,0.0,Phase3-EA-S4v1-EURCHF-M15-221,EURCHFMT4,480,3h 14m,Buy
17905.04,100.73,10.04.2008 17:45:00,,0.0,-241.02999999996973,0.0,0.0,100442,10.04.2008 17:00:00,1617,-0.22287448818063335,77.2,IS,0.27,0.0,Phase3-EA-S1v2-USDJPY-M15-0,USDJPYMT4,610,45m 0s,Buy
17683.75,101.27,10.04.2008 18:29:58,sl 101.270,0.0,-462.31999999996333,0.0,0.0,100.44,10.04.2008 17:00:00,1618,-0.4274958858883756,-221.29,IS,0.27,0.0,Phase3-EA-S1v2-USDJPY-M15-0,USDJPYMT4,611,1h 29m,Sell
17771.8,200.79,11.04.2008 02:29:57,tp 200.790,0.0,-374.2699999999604,0.0,0.0,201.18,11.04.2008 02:05:00,1619,-0.34607822549627554,88.05,IS,0.23,0.0,Phase3-EA-S4v1-GBPJPY-M5-194,GBPJPYMT4,498,24m 57s,Sell
17819.07,101682,11.04.2008 03:00:00,,0.0,-326.99999999995634,0.0,0.0,101.86,11.04.2008 00:15:00,1620,-0.3023688239433536,47.27,IS,0.27,0.0,Phase3-EA-S1v2-USDJPY-M15-0,USDJPYMT4,614,2h 45m,Sell
17751.08,1.58712,11.04.2008 04:30:00,,-2.03,-394.9899999999616,0.0,0.0,1.5855,10.04.2008 20:10:00,1621,-0.36523749776571734,-67.99,IS,0.41,0.0,Phase3-EA-SA2v2-EURCHF-M5-43,EURCHFMT4,904,8h 20m,Sell
17886.34,1.5837,11.04.2008 13:44:58,tp 1.58370,0.0,-259.7299999999668,0.0,0.0,1.5877,11.04.2008 05:15:00,1622,-0.24016591633886145,135.26,IS,0.34,0.0,Phase3-EA-S4v1-EURCHF-M15-221,EURCHFMT4,482,8h 29m,Sell
17842.21,1.96852,11.04.2008 16:29:58,sl 1.96852,-2.13,-303.8599999999715,0.0,0.0,1.97152,09.04.2008 14:30:00,1623,-0.28097183744168525,-44.13,IS,0.14,0.0,Phase3-EA-B1v1-GBPUSD-M30-14,GBPUSDMT4,122,2d 1h 59m,Buy
17847.03,100932,11.04.2008 21:00:00,,0.0,-299.0399999999645,0.0,0.0,100.95,11.04.2008 19:15:00,1624,-0.2765149024832471,4.82,IS,0.27,0.0,Phase3-EA-S1v2-USDJPY-M15-0,USDJPYMT4,616,1h 45m,Sell
17873.28,100802,11.04.2008 21:45:00,,0.0,-272.7899999999645,0.0,0.0,100.9,11.04.2008 21:15:00,1625,-0.2522421757905435,26.25,IS,0.27,0.0,Phase3-EA-S1v2-USDJPY-M15-0,USDJPYMT4,618,30m 0s,Sell
17918.39,1582,11.04.2008 23:14:57,tp 1.58200,0.0,-227.6799999999639,0.0,0.0,1.5831,11.04.2008 22:25:00,1626,-0.21053007289119582,45.11,IS,0.41,0.0,Phase3-EA-SA2v2-EURCHF-M5-43,EURCHFMT4,906,49m 57s,Sell
17718.21,1.57652,14.04.2008 07:44:57,sl 1.57652,0.0,-427.8599999999569,0.0,0.0,1.58142,14.04.2008 02:35:00,1627,-0.39563157496149093,-200.18,IS,0.41,0.0,Phase3-EA-SA2v2-EURCHF-M5-43,EURCHFMT4,908,5h 9m,Buy
17792.24,1581,14.04.2008 13:00:00,,0.0,-353.8299999999581,0.0,0.0,1.57882,14.04.2008 04:15:00,1628,-0.3271778623115548,74.03,IS,0.34,0.0,Phase3-EA-S4v1-EURCHF-M15-221,EURCHFMT4,484,8h 45m,Buy
17837.35,1.5814,14.04.2008 23:14:57,tp 1.58140,0.0,-308.7199999999575,0.0,0.0,1.5825,14.04.2008 21:30:00,1629,-0.2854657594122072,45.11,IS,0.41,0.0,Phase3-EA-SA2v2-EURCHF-M5-43,EURCHFMT4,910,1h 44m,Sell
17895.37,0.9997,14.04.2008 23:14:58,tp 0.99970,0.0,-250.69999999995343,0.0,0.0,1.0007,14.04.2008 22:00:00,1630,-0.231816098356559,58.02,IS,0.58,0.0,Phase3-EA-SA2v2-USDCHF-M15-107,USDCHFMT4,408,1h 14m,Sell
17982.72,199.53,15.04.2008 02:09:58,tp 199.530,-1.32,-163.3499999999476,0.0,0.0,199.92,14.04.2008 23:45:00,1631,-0.15104571067626169,87.35,IS,0.23,0.0,Phase3-EA-S4v1-GBPJPY-M5-194,GBPJPYMT4,500,2h 24m,Sell
17959.6,101012,15.04.2008 03:30:00,,-1.2,-186.46999999994296,0.0,0.0,100.93,14.04.2008 19:30:00,1632,-0.17242420367188815,-23.12,IS,0.27,0.0,Phase3-EA-S1v2-USDJPY-M15-0,USDJPYMT4,620,8h 0m,Sell
18004.71,1.5817,15.04.2008 03:54:58,tp 1.58170,0.0,-141.35999999994237,0.0,0.0,1.5828,15.04.2008 01:20:00,1633,-0.13071210077254053,45.11,IS,0.41,0.0,Phase3-EA-SA2v2-EURCHF-M5-43,EURCHFMT4,912,2h 34m,Sell
18062.77,999,15.04.2008 03:59:58,tp 0.99900,0.0,-83.2999999999447,0.0,0.0,1.0,15.04.2008 02:00:00,1634,-0.0770254527047951,58.06,IS,0.58,0.0,Phase3-EA-SA2v2-USDCHF-M15-107,USDCHFMT4,410,1h 59m,Sell
18151.5,199772,15.04.2008 04:34:58,tp 199.772,0.0,-0.0,0.0,0.0,199382,15.04.2008 02:25:00,1635,-0.0,88.73,IS,0.23,0.0,Phase3-EA-S4v1-GBPJPY-M5-194,GBPJPYMT4,502,2h 9m,Buy
18218.95,1.58112,15.04.2008 13:45:00,,0.0,-0.0,0.0,0.0,1.5831,15.04.2008 05:00:00,1636,-0.0,67.45,IS,0.34,0.0,Phase3-EA-S4v1-EURCHF-M15-221,EURCHFMT4,486,8h 45m,Sell
18279.42,101.8,15.04.2008 23:30:00,,0.0,-0.0,0.0,0.0,101572,15.04.2008 22:15:00,1637,-0.0,60.47,IS,0.27,0.0,Phase3-EA-S1v2-USDJPY-M15-0,USDJPYMT4,622,1h 15m,Buy
18077.98,1.5915,16.04.2008 01:14:57,sl 1.59150,-2.04,-201.44000000000233,0.0,0.0,1.5866,15.04.2008 20:05:00,1638,-0.18603719894325443,-201.44,IS,0.41,0.0,Phase3-EA-SA2v2-EURCHF-M5-43,EURCHFMT4,914,5h 9m,Sell
18098.82,199582,16.04.2008 05:05:00,,-1.31,-180.60000000000582,0.0,0.0,199.68,15.04.2008 23:40:00,1639,-0.16679069762287752,20.84,IS,0.23,0.0,Phase3-EA-S4v1-GBPJPY-M5-194,GBPJPYMT4,504,5h 25m,Sell
18143.77,1.5901,16.04.2008 09:09:58,tp 1.59010,0.0,-135.65000000000873,0.0,0.0,1.5912,16.04.2008 01:20:00,1640,-0.12527773052349978,44.95,IS,0.41,0.0,Phase3-EA-SA2v2-EURCHF-M5-43,EURCHFMT4,916,7h 49m,Sell
18149.86,1.59092,16.04.2008 10:30:00,,0.0,-129.56000000001222,0.0,0.0,1.5911,16.04.2008 01:45:00,1641,-0.11965339304552243,6.09,IS,0.34,0.0,Phase3-EA-S4v1-EURCHF-M15-221,EURCHFMT4,488,8h 45m,Sell
18194.99,1.59432,16.04.2008 21:34:58,tp 1.59432,0.0,-84.43000000000757,0.0,0.0,1.59322,16.04.2008 21:20:00,1642,-0.07797418937043386,45.13,IS,0.41,0.0,Phase3-EA-SA2v2-EURCHF-M5-43,EURCHFMT4,918,14m 58s,Buy
18240.1,1.5937,16.04.2008 22:29:57,tp 1.59370,0.0,-39.320000000006985,0.0,0.0,1.5948,16.04.2008 21:50:00,1643,-0.03631345642598282,45.11,IS,0.41,0.0,Phase3-EA-SA2v2-EURCHF-M5-43,EURCHFMT4,920,39m 57s,Sell
18279.06,1.5939,17.04.2008 01:39:57,tp 1.59390,-6.15,-0.3600000000005821,0.0,0.0,1595,16.04.2008 23:45:00,1644,-3.324731514082561E-4,38.96,IS,0.41,0.0,Phase3-EA-SA2v2-EURCHF-M5-43,EURCHFMT4,922,1h 54m,Sell
18337.06,0.99992,17.04.2008 03:44:57,tp 0.99992,0.0,-0.0,0.0,0.0,0.99892,17.04.2008 02:15:00,1645,-0.0,58.0,IS,0.58,0.0,Phase3-EA-SA2v2-USDCHF-M15-107,USDCHFMT4,412,1h 29m,Buy
18168.53,101812,17.04.2008 06:45:00,,-3.58,-168.52999999999884,0.0,0.0,101.19,16.04.2008 17:30:00,1646,-0.15556080255454463,-168.53,IS,0.27,0.0,Phase3-EA-S1v2-USDJPY-M15-0,USDJPYMT4,624,13h 15m,Sell
18213.63,1.59382,17.04.2008 08:39:57,tp 1.59382,0.0,-123.42999999999302,0.0,0.0,1.59272,17.04.2008 02:25:00,1647,-0.11393146537296915,45.1,IS,0.41,0.0,Phase3-EA-SA2v2-EURCHF-M5-43,EURCHFMT4,924,6h 14m,Buy
18236.77,1.5936,17.04.2008 11:30:00,,0.0,-100.2899999999936,0.0,0.0,1.59292,17.04.2008 02:45:00,1648,-0.09257220013169402,23.14,IS,0.34,0.0,Phase3-EA-S4v1-EURCHF-M15-221,EURCHFMT4,490,8h 45m,Buy
18302.05,102.58,17.04.2008 20:15:00,,0.0,-35.00999999999476,0.0,0.0,102332,17.04.2008 17:15:00,1649,-0.03231581141300558,65.28,IS,0.27,0.0,Phase3-EA-S1v2-USDJPY-M15-0,USDJPYMT4,626,3h 0m,Buy
18346.89,1.5982,17.04.2008 21:24:58,tp 1.59820,0.0,-0.0,0.0,0.0,1.5993,17.04.2008 20:45:00,1650,-0.0,44.84,IS,0.41,0.0,Phase3-EA-SA2v2-EURCHF-M5-43,EURCHFMT4,926,39m 58s,Sell
18404.52,1.0064,17.04.2008 23:59:58,tp 1.00640,0.0,-0.0,0.0,0.0,1.0074,17.04.2008 22:30:00,1651,-0.0,57.63,IS,0.58,0.0,Phase3-EA-SA2v2-USDCHF-M15-107,USDCHFMT4,414,1h 29m,Sell
18447.3,1.5996,18.04.2008 01:09:59,tp 1.59960,-2.04,-0.0,0.0,0.0,1.6007,17.04.2008 22:45:00,1652,-0.0,42.78,IS,0.41,0.0,Phase3-EA-SA2v2-EURCHF-M5-43,EURCHFMT4,928,2h 24m,Sell
18381.72,203.71,18.04.2008 06:35:00,,0.0,-65.58000000000175,0.0,0.0,204002,18.04.2008 01:10:00,1653,-0.06047176831511862,-65.58,IS,0.23,0.0,Phase3-EA-S4v1-GBPJPY-M5-194,GBPJPYMT4,506,5h 25m,Buy
18426.56,1.60042,18.04.2008 08:59:57,tp 1.60042,0.0,-20.74000000000524,0.0,0.0,1.59932,18.04.2008 01:25:00,1654,-0.019124496414392247,44.84,IS,0.41,0.0,Phase3-EA-SA2v2-EURCHF-M5-43,EURCHFMT4,930,7h 34m,Buy
18561.96,1.60232,18.04.2008 10:14:58,tp 1.60232,0.0,-0.0,0.0,0.0,1.59832,18.04.2008 06:30:00,1655,-0.0,135.4,IS,0.34,0.0,Phase3-EA-S4v1-EURCHF-M15-221,EURCHFMT4,492,3h 44m,Buy
18548.26,102.45,18.04.2008 10:45:00,,0.0,-13.69999999999709,0.0,0.0,102502,18.04.2008 01:00:00,1656,-0.012619521607750145,-13.7,IS,0.27,0.0,Phase3-EA-S1v2-USDJPY-M15-0,USDJPYMT4,628,9h 45m,Buy
18604.83,104042,18.04.2008 21:00:00,,0.0,-0.0,0.0,0.0,104262,18.04.2008 20:30:00,1657,-0.0,56.57,IS,0.27,0.0,Phase3-EA-S1v2-USDJPY-M15-0,USDJPYMT4,630,30m 0s,Buy
18542.64,1.6104,21.04.2008 04:30:00,,-0.97,-62.19000000000233,0.0,0.0,1.61192,18.04.2008 20:10:00,1658,-0.057262646606050786,-62.19,IS,0.41,0.0,Phase3-EA-SA2v2-EURCHF-M5-43,EURCHFMT4,932,2d 8h 20m,Buy
18588.74,207612,21.04.2008 07:20:00,,0.0,-16.089999999996508,0.0,0.0,207.82,21.04.2008 01:55:00,1659,-0.014815179030247993,46.1,IS,0.23,0.0,Phase3-EA-S4v1-GBPJPY-M5-194,GBPJPYMT4,508,5h 25m,Sell
18509.55,103.96,21.04.2008 09:15:00,,-0.76,-95.27999999999884,0.0,0.0,104.26,18.04.2008 20:30:00,1660,-0.08773090478572516,-79.19,IS,0.27,0.0,Phase3-EA-S1v2-USDJPY-M15-0,USDJPYMT4,631,2d 12h 45m,Sell
18467.55,1.99552,21.04.2008 09:29:58,sl 1.99552,0.0,-137.27999999999884,0.0,0.0,1.99852,21.04.2008 04:00:00,1661,-0.12640321797842566,-42.0,IS,0.14,0.0,Phase3-EA-B1v1-GBPUSD-M30-14,GBPUSDMT4,124,5h 29m,Buy
18409.6,207312,21.04.2008 09:59:58,sl 207.312,0.0,-195.22999999999593,0.0,0.0,207982,21.04.2008 02:00:00,1662,-0.17976180249073234,-57.95,IS,0.09,0.0,Phase3-EA-B1v1-GBPJPY-M30-1,GBPJPYMT4,222,7h 59m,Buy
18543.46,1.6073,21.04.2008 10:59:59,tp 1.60730,0.0,-61.36999999999534,0.0,0.0,1.6113,21.04.2008 03:45:00,1663,-0.05650761572942497,133.86,IS,0.34,0.0,Phase3-EA-S4v1-EURCHF-M15-221,EURCHFMT4,494,7h 14m,Sell
18648.16,103.15,21.04.2008 17:29:58,tp 103.150,0.0,-0.0,0.0,0.0,103.55,21.04.2008 17:00:00,1664,-0.0,104.7,IS,0.27,0.0,Phase3-EA-S1v2-USDJPY-M15-0,USDJPYMT4,634,29m 58s,Sell
18713.12,103082,21.04.2008 21:30:00,,0.0,-0.0,0.0,0.0,103.33,21.04.2008 18:45:00,1665,-0.0,64.96,IS,0.27,0.0,Phase3-EA-S1v2-USDJPY-M15-0,USDJPYMT4,636,2h 45m,Sell
18605.55,1603,22.04.2008 05:00:00,,-0.98,-107.57000000000698,0.0,0.0,1.60562,21.04.2008 20:40:00,1666,-0.09894849858049037,-107.57,IS,0.41,0.0,Phase3-EA-SA2v2-EURCHF-M5-43,EURCHFMT4,934,8h 20m,Buy
18740.0,1.60762,22.04.2008 10:59:57,tp 1.60762,0.0,-0.0,0.0,0.0,1.60362,22.04.2008 05:30:00,1667,-0.0,134.45,IS,0.34,0.0,Phase3-EA-S4v1-EURCHF-M15-221,EURCHFMT4,496,5h 29m,Buy
18681.14,205.21,22.04.2008 14:29:58,sl 205.210,-0.51,-58.86000000000058,0.0,0.0,204.54,21.04.2008 17:30:00,1668,-0.0541291153209495,-58.86,IS,0.09,0.0,Phase3-EA-B1v1-GBPJPY-M30-1,GBPJPYMT4,224,20h 59m,Sell
18695.18,102902,23.04.2008 03:00:00,,-1.18,-44.820000000006985,0.0,0.0,102.96,22.04.2008 22:30:00,1669,-0.04121758322605013,14.04,IS,0.27,0.0,Phase3-EA-S1v2-USDJPY-M15-0,USDJPYMT4,638,4h 30m,Sell
18830.38,1.60702,23.04.2008 11:59:58,tp 1.60702,0.0,-0.0,0.0,0.0,1.60302,23.04.2008 06:00:00,1670,-0.0,135.2,IS,0.34,0.0,Phase3-EA-S4v1-EURCHF-M15-221,EURCHFMT4,498,5h 59m,Buy
18874.82,1.6128,23.04.2008 23:54:59,tp 1.61280,0.0,-0.0,0.0,0.0,1.6139,23.04.2008 20:20:00,1671,-0.0,44.44,IS,0.41,0.0,Phase3-EA-SA2v2-EURCHF-M5-43,EURCHFMT4,936,3h 34m,Sell
18885.07,103.51,24.04.2008 04:30:00,,-2.27,-0.0,0.0,0.0,103462,23.04.2008 20:30:00,1672,-0.0,10.25,IS,0.27,0.0,Phase3-EA-S1v2-USDJPY-M15-0,USDJPYMT4,640,8h 0m,Buy
18929.36,1.61382,24.04.2008 04:59:59,tp 1.61382,0.0,-0.0,0.0,0.0,1.61272,24.04.2008 00:20:00,1673,-0.0,44.29,IS,0.41,0.0,Phase3-EA-SA2v2-EURCHF-M5-43,EURCHFMT4,938,4h 39m,Buy
18997.76,204.98,24.04.2008 05:35:00,,0.0,-0.0,0.0,0.0,204672,24.04.2008 00:10:00,1674,-0.0,68.4,IS,0.23,0.0,Phase3-EA-S4v1-GBPJPY-M5-194,GBPJPYMT4,510,5h 25m,Buy
19053.83,1.6145,24.04.2008 10:15:00,,0.0,-0.0,0.0,0.0,1.61282,24.04.2008 01:30:00,1675,-0.0,56.07,IS,0.34,0.0,Phase3-EA-S4v1-EURCHF-M15-221,EURCHFMT4,500,8h 45m,Buy
19095.44,1.6228,25.04.2008 02:19:57,tp 1.62280,-1.98,-0.0,0.0,0.0,1.6239,24.04.2008 23:05:00,1676,-0.0,41.61,IS,0.41,0.0,Phase3-EA-SA2v2-EURCHF-M5-43,EURCHFMT4,940,3h 14m,Sell
19101.93,104.36,25.04.2008 03:15:00,,-0.75,-0.0,0.0,0.0,104332,24.04.2008 23:30:00,1677,-0.0,6.49,IS,0.27,0.0,Phase3-EA-S1v2-USDJPY-M15-0,USDJPYMT4,642,3h 45m,Buy
19145.5,1.62412,25.04.2008 03:34:57,tp 1.62412,0.0,-0.0,0.0,0.0,1.62302,25.04.2008 02:20:00,1678,-0.0,43.57,IS,0.41,0.0,Phase3-EA-SA2v2-EURCHF-M5-43,EURCHFMT4,942,1h 14m,Buy
19189.07,1.6172,28.04.2008 03:10:00,tp 1.61720,0.0,-0.0,0.0,0.0,1.6183,28.04.2008 02:45:00,1679,-0.0,43.57,IS,0.41,0.0,Phase3-EA-SA2v2-EURCHF-M5-43,EURCHFMT4,944,25m 0s,Sell
19212.84,207372,28.04.2008 08:30:00,,0.0,-0.0,0.0,0.0,207.48,28.04.2008 03:05:00,1680,-0.0,23.77,IS,0.23,0.0,Phase3-EA-S4v1-GBPJPY-M5-194,GBPJPYMT4,512,5h 25m,Sell
19256.44,1.6181,28.04.2008 22:54:57,tp 1.61810,0.0,-0.0,0.0,0.0,1.6192,28.04.2008 20:20:00,1681,-0.0,43.6,IS,0.41,0.0,Phase3-EA-SA2v2-EURCHF-M5-43,EURCHFMT4,946,2h 34m,Sell
19300.09,1.61892,28.04.2008 23:54:57,tp 1.61892,0.0,-0.0,0.0,0.0,1.61782,28.04.2008 23:20:00,1682,-0.0,43.65,IS,0.41,0.0,Phase3-EA-SA2v2-EURCHF-M5-43,EURCHFMT4,948,34m 57s,Buy
19343.7,1.61912,29.04.2008 01:15:00,tp 1.61912,0.0,-0.0,0.0,0.0,1.61802,29.04.2008 00:15:00,1683,-0.0,43.61,IS,0.41,0.0,Phase3-EA-SA2v2-EURCHF-M5-43,EURCHFMT4,950,1h 0m,Buy
19399.11,1.03432,29.04.2008 01:29:58,tp 1.03432,-0.67,-0.0,0.0,0.0,1.03332,28.04.2008 23:45:00,1684,-0.0,55.41,IS,0.58,0.0,Phase3-EA-SA2v2-USDCHF-M15-107,USDCHFMT4,416,1h 44m,Buy
19341.11,204.71,29.04.2008 22:59:57,sl 204.710,0.0,-58.0,0.0,0.0,204.04,29.04.2008 17:30:00,1685,-0.053016884689464014,-58.0,IS,0.09,0.0,Phase3-EA-B1v1-GBPJPY-M30-1,GBPJPYMT4,226,5h 29m,Sell
19397.06,1.0367,29.04.2008 23:44:57,tp 1.03670,0.0,-2.0500000000029104,0.0,0.0,1.0377,29.04.2008 22:00:00,1686,-0.001873872648509578,55.95,IS,0.58,0.0,Phase3-EA-SA2v2-USDCHF-M15-107,USDCHFMT4,418,1h 44m,Sell
19482.13,204.44,30.04.2008 02:14:58,tp 204.440,-1.28,-0.0,0.0,0.0,204.83,29.04.2008 23:40:00,1687,-0.0,85.07,IS,0.23,0.0,Phase3-EA-S4v1-GBPJPY-M5-194,GBPJPYMT4,514,2h 34m,Sell
19430.73,1.03812,30.04.2008 05:45:00,,0.0,-51.39999999999418,0.0,0.0,1.0372,30.04.2008 01:30:00,1688,-0.04694830106063345,-51.4,IS,0.58,0.0,Phase3-EA-SA2v2-USDCHF-M15-107,USDCHFMT4,420,4h 15m,Sell
19384.51,1.61582,30.04.2008 06:10:00,,-1.98,-97.61999999999534,0.0,0.0,1.6147,29.04.2008 21:50:00,1689,-0.08916523637236065,-46.22,IS,0.41,0.0,Phase3-EA-SA2v2-EURCHF-M5-43,EURCHFMT4,952,8h 20m,Sell
19315.3,103972,30.04.2008 08:00:00,,-1.17,-166.83000000000175,0.0,0.0,103.71,29.04.2008 20:30:00,1690,-0.1523810324114095,-69.21,IS,0.27,0.0,Phase3-EA-S1v2-USDJPY-M15-0,USDJPYMT4,644,11h 30m,Sell
19291.51,104.42,30.04.2008 21:30:00,,0.0,-190.61999999999534,0.0,0.0,104512,30.04.2008 18:00:00,1691,-0.1741106059956954,-23.79,IS,0.27,0.0,Phase3-EA-S1v2-USDJPY-M15-0,USDJPYMT4,646,3h 30m,Buy
19233.81,206822,30.04.2008 21:59:58,sl 206.822,0.0,-248.31999999999243,0.0,0.0,207492,30.04.2008 21:30:00,1692,-0.22681327080500902,-57.7,IS,0.09,0.0,Phase3-EA-B1v1-GBPJPY-M30-1,GBPJPYMT4,228,29m 58s,Buy
19289.82,1.03552,30.04.2008 22:29:57,tp 1.03552,0.0,-192.30999999999767,0.0,0.0,1.03452,30.04.2008 22:15:00,1693,-0.17565423690605703,56.01,IS,0.58,0.0,Phase3-EA-SA2v2-USDCHF-M15-107,USDCHFMT4,422,14m 57s,Buy
19270.32,1.6168,01.05.2008 06:15:00,,-2.85,-211.80999999999767,0.0,0.0,1.61722,30.04.2008 21:55:00,1694,-0.19346536279482077,-19.5,IS,0.41,0.0,Phase3-EA-SA2v2-EURCHF-M5-43,EURCHFMT4,954,8h 20m,Buy
19401.01,1.62082,01.05.2008 10:59:58,tp 1.62082,0.0,-81.11999999999534,0.0,0.0,1.61682,01.05.2008 06:00:00,1695,-0.07409428369725288,130.69,IS,0.34,0.0,Phase3-EA-S4v1-EURCHF-M15-221,EURCHFMT4,502,4h 59m,Buy
19444.0,1.6205,01.05.2008 21:14:59,tp 1.62050,0.0,-38.129999999990105,0.0,0.0,1.6216,01.05.2008 20:10:00,1696,-0.0348276015455582,42.99,IS,0.41,0.0,Phase3-EA-SA2v2-EURCHF-M5-43,EURCHFMT4,956,1h 4m,Sell
19485.06,1.6212,02.05.2008 00:19:57,tp 1.62120,-1.96,-0.0,0.0,0.0,1.6223,01.05.2008 21:50:00,1697,-0.0,41.06,IS,0.41,0.0,Phase3-EA-SA2v2-EURCHF-M5-43,EURCHFMT4,958,2h 29m,Sell
19528.11,1.62162,02.05.2008 01:29:57,tp 1.62162,0.0,-0.0,0.0,0.0,1.62052,02.05.2008 00:35:00,1698,-0.0,43.05,IS,0.41,0.0,Phase3-EA-SA2v2-EURCHF-M5-43,EURCHFMT4,960,54m 57s,Buy
19553.44,104.48,02.05.2008 03:30:00,,0.0,-0.0,0.0,0.0,104382,02.05.2008 01:00:00,1699,-0.0,25.33,IS,0.27,0.0,Phase3-EA-S1v2-USDJPY-M15-0,USDJPYMT4,648,2h 30m,Buy
19608.71,1.04942,02.05.2008 04:29:57,tp 1.04942,0.0,-0.0,0.0,0.0,1.04842,02.05.2008 00:15:00,1700,-0.0,55.27,IS,0.58,0.0,Phase3-EA-SA2v2-USDCHF-M15-107,USDCHFMT4,424,4h 14m,Buy
19767.73,208892,02.05.2008 15:59:57,tp 208.892,0.0,-0.0,0.0,0.0,207042,02.05.2008 09:30:00,1701,-0.0,159.02,IS,0.09,0.0,Phase3-EA-B1v1-GBPJPY-M30-1,GBPJPYMT4,230,6h 29m,Buy
19710.65,208112,02.05.2008 16:29:58,sl 208.112,0.0,-57.080000000001746,0.0,0.0,208782,02.05.2008 16:00:00,1702,-0.05200071095576235,-57.08,IS,0.09,0.0,Phase3-EA-B1v1-GBPJPY-M30-1,GBPJPYMT4,232,29m 58s,Buy
19748.57,105.37,02.05.2008 23:15:00,,0.0,-19.160000000003492,0.0,0.0,105222,02.05.2008 20:00:00,1703,-0.01745503892628868,37.92,IS,0.27,0.0,Phase3-EA-S1v2-USDJPY-M15-0,USDJPYMT4,650,3h 15m,Buy
19791.25,1.62992,02.05.2008 23:39:58,tp 1.62992,0.0,-0.0,0.0,0.0,1.62882,02.05.2008 20:10:00,1704,-0.0,42.68,IS,0.41,0.0,Phase3-EA-SA2v2-EURCHF-M5-43,EURCHFMT4,962,3h 29m,Buy
19831.97,1.6293,05.05.2008 01:00:00,tp 1.62930,-1.94,-0.0,0.0,0.0,1.6304,02.05.2008 23:40:00,1705,-0.0,40.72,IS,0.41,0.0,Phase3-EA-SA2v2-EURCHF-M5-43,EURCHFMT4,964,2d 1h 20m,Sell
19858.36,1.05482,05.05.2008 05:15:00,,0.0,-0.0,0.0,0.0,1.0553,05.05.2008 01:00:00,1706,-0.0,26.39,IS,0.58,0.0,Phase3-EA-SA2v2-USDCHF-M15-107,USDCHFMT4,426,4h 15m,Sell
19869.52,105262,05.05.2008 05:30:00,,-1.15,-0.0,0.0,0.0,105.31,02.05.2008 23:30:00,1707,-0.0,11.16,IS,0.27,0.0,Phase3-EA-S1v2-USDJPY-M15-0,USDJPYMT4,652,2d 6h 0m,Sell
19818.15,1.63012,05.05.2008 09:25:00,,0.0,-51.36999999999534,0.0,0.0,1.6288,05.05.2008 01:05:00,1708,-0.04675546047711435,-51.37,IS,0.41,0.0,Phase3-EA-SA2v2-EURCHF-M5-43,EURCHFMT4,966,8h 20m,Sell
19833.65,1.62952,05.05.2008 13:00:00,,0.0,-35.86999999999534,0.0,0.0,1.63,05.05.2008 04:15:00,1709,-0.032647817156200624,15.5,IS,0.34,0.0,Phase3-EA-S4v1-EURCHF-M15-221,EURCHFMT4,504,8h 45m,Sell
19876.46,1.63252,05.05.2008 22:20:00,tp 1.63252,0.0,-0.0,0.0,0.0,1.63142,05.05.2008 21:20:00,1710,-0.0,42.81,IS,0.41,0.0,Phase3-EA-SA2v2-EURCHF-M5-43,EURCHFMT4,968,1h 0m,Buy
19833.77,1.9739,06.05.2008 02:29:57,sl 1.97390,-0.69,-42.69000000000233,0.0,0.0,1.9709,05.05.2008 13:00:00,1711,-0.03885272605251593,-42.69,IS,0.14,0.0,Phase3-EA-B1v1-GBPUSD-M30-14,GBPUSDMT4,126,13h 29m,Sell
19885.97,1.0523,06.05.2008 03:14:57,tp 1.05230,-2.92,-0.0,0.0,0.0,1.0533,05.05.2008 23:15:00,1712,-0.0,52.2,IS,0.58,0.0,Phase3-EA-SA2v2-USDCHF-M15-107,USDCHFMT4,428,3h 59m,Sell
19903.48,104842,06.05.2008 03:30:00,,0.0,-0.0,0.0,0.0,104.91,06.05.2008 00:30:00,1713,-0.0,17.51,IS,0.27,0.0,Phase3-EA-S1v2-USDJPY-M15-0,USDJPYMT4,654,3h 0m,Sell
19989.07,206.7,06.05.2008 04:04:57,tp 206.700,0.0,-0.0,0.0,0.0,207.09,06.05.2008 02:10:00,1714,-0.0,85.59,IS,0.23,0.0,Phase3-EA-S4v1-GBPJPY-M5-194,GBPJPYMT4,516,1h 54m,Sell
19947.07,1.97042,06.05.2008 09:59:58,sl 1.97042,0.0,-42.0,0.0,0.0,1.97342,06.05.2008 08:30:00,1715,-0.03818561244312724,-42.0,IS,0.14,0.0,Phase3-EA-B1v1-GBPUSD-M30-14,GBPUSDMT4,128,1h 29m,Buy
19821.03,1.62762,06.05.2008 11:59:58,sl 1.62762,0.0,-168.0399999999936,0.0,0.0,1.63152,06.05.2008 05:00:00,1716,-0.15277881702244894,-126.04,IS,0.34,0.0,Phase3-EA-S4v1-EURCHF-M15-221,EURCHFMT4,506,6h 59m,Buy
19864.02,1.6299,06.05.2008 20:49:57,tp 1.62990,0.0,-125.04999999998836,0.0,0.0,1631,06.05.2008 20:00:00,1717,-0.11369311514315752,42.99,IS,0.41,0.0,Phase3-EA-SA2v2-EURCHF-M5-43,EURCHFMT4,970,49m 57s,Sell
19821.49,1.97212,07.05.2008 02:29:57,sl 1.97212,-0.53,-167.5799999999872,0.0,0.0,1.97512,06.05.2008 17:00:00,1718,-0.15236059364806603,-42.53,IS,0.14,0.0,Phase3-EA-B1v1-GBPUSD-M30-14,GBPUSDMT4,130,9h 29m,Buy
19876.62,1.05212,07.05.2008 02:29:57,tp 1.05212,0.0,-112.44999999998254,0.0,0.0,1.05112,07.05.2008 01:45:00,1719,-0.10223743141021406,55.13,IS,0.58,0.0,Phase3-EA-SA2v2-USDCHF-M15-107,USDCHFMT4,430,44m 57s,Buy
19962.15,206.39,07.05.2008 05:49:57,tp 206.390,0.0,-26.919999999983702,0.0,0.0,206.78,07.05.2008 02:35:00,1720,-0.02447515921353245,85.53,IS,0.23,0.0,Phase3-EA-S4v1-GBPJPY-M5-194,GBPJPYMT4,518,3h 14m,Sell
19947.74,1.63272,07.05.2008 06:50:00,,-1.95,-41.329999999987194,0.0,0.0,1.6324,06.05.2008 22:30:00,1721,-0.03757646100652285,-14.41,IS,0.41,0.0,Phase3-EA-SA2v2-EURCHF-M5-43,EURCHFMT4,972,8h 20m,Sell
19881.61,104732,07.05.2008 07:00:00,,-1.16,-107.45999999999185,0.0,0.0,104.48,06.05.2008 18:15:00,1722,-0.09770061697947956,-66.13,IS,0.27,0.0,Phase3-EA-S1v2-USDJPY-M15-0,USDJPYMT4,656,12h 45m,Sell
19806.94,1.6297,07.05.2008 14:45:00,,0.0,-182.1299999999901,0.0,0.0,1.63202,07.05.2008 06:00:00,1723,-0.16558918081586632,-74.67,IS,0.34,0.0,Phase3-EA-S4v1-EURCHF-M15-221,EURCHFMT4,508,8h 45m,Buy
19842.28,105.44,07.05.2008 17:45:00,,0.0,-146.7899999999936,0.0,0.0,105302,07.05.2008 17:00:00,1724,-0.13345871548872387,35.34,IS,0.27,0.0,Phase3-EA-S1v2-USDJPY-M15-0,USDJPYMT4,658,45m 0s,Buy
19721.12,104.89,08.05.2008 03:00:00,,-2.24,-267.9499999999971,0.0,0.0,105352,07.05.2008 18:00:00,1725,-0.24361511557466264,-121.16,IS,0.27,0.0,Phase3-EA-S1v2-USDJPY-M15-0,USDJPYMT4,660,9h 0m,Buy
19574.03,1623,08.05.2008 04:40:00,,-2.8,-415.0399999999936,0.0,0.0,1.62672,07.05.2008 20:20:00,1726,-0.37734658543798294,-147.09,IS,0.41,0.0,Phase3-EA-SA2v2-EURCHF-M5-43,EURCHFMT4,974,8h 20m,Buy
19502.61,1.6216,08.05.2008 10:00:00,,0.0,-486.45999999999185,0.0,0.0,1.62382,08.05.2008 01:15:00,1727,-0.44228031021627057,-71.42,IS,0.34,0.0,Phase3-EA-S4v1-EURCHF-M15-221,EURCHFMT4,510,8h 45m,Buy
19444.75,204.39,08.05.2008 14:29:58,sl 204.390,0.0,-544.3199999999924,0.0,0.0,203.72,08.05.2008 05:30:00,1728,-0.49488553726292206,-57.86,IS,0.09,0.0,Phase3-EA-B1v1-GBPJPY-M30-1,GBPJPYMT4,234,8h 59m,Sell
19387.02,203572,08.05.2008 15:59:58,sl 203.572,0.0,-602.0499999999884,0.0,0.0,204242,08.05.2008 14:30:00,1729,-0.5473725707472454,-57.73,IS,0.09,0.0,Phase3-EA-B1v1-GBPJPY-M30-1,GBPJPYMT4,236,1h 29m,Buy
19429.91,1.6195,08.05.2008 23:09:58,tp 1.61950,0.0,-559.1599999999889,0.0,0.0,1.6206,08.05.2008 21:45:00,1730,-0.5083777869928239,42.89,IS,0.41,0.0,Phase3-EA-SA2v2-EURCHF-M5-43,EURCHFMT4,976,1h 24m,Sell
19490.72,103672,09.05.2008 00:15:00,,-1.17,-498.34999999999127,0.0,0.0,103.91,08.05.2008 20:30:00,1731,-0.4530904752626696,60.81,IS,0.27,0.0,Phase3-EA-S1v2-USDJPY-M15-0,USDJPYMT4,662,3h 45m,Sell
19576.32,203012,09.05.2008 01:24:57,tp 203.012,-0.8,-412.74999999998545,0.0,0.0,202622,08.05.2008 23:35:00,1732,-0.3752645603785764,85.6,IS,0.23,0.0,Phase3-EA-S4v1-GBPJPY-M5-194,GBPJPYMT4,520,1h 49m,Buy
19425.76,1.0478,09.05.2008 04:30:00,,0.0,-563.3099999999831,0.0,0.0,1.05052,09.05.2008 00:15:00,1733,-0.512150889174699,-150.56,IS,0.58,0.0,Phase3-EA-SA2v2-USDCHF-M15-107,USDCHFMT4,432,4h 15m,Buy
19342.85,1616,09.05.2008 08:25:00,,0.0,-646.2199999999866,0.0,0.0,1.61812,09.05.2008 00:05:00,1734,-0.5875311064999327,-82.91,IS,0.41,0.0,Phase3-EA-SA2v2-EURCHF-M5-43,EURCHFMT4,978,8h 20m,Buy
19300.32,1.95172,09.05.2008 09:29:58,sl 1.95172,-0.53,-688.7499999999854,0.0,0.0,1.95472,08.05.2008 11:30:00,1735,-0.6261985850048412,-42.53,IS,0.14,0.0,Phase3-EA-B1v1-GBPUSD-M30-14,GBPUSDMT4,132,21h 59m,Buy
19173.09,1.61372,09.05.2008 11:14:58,sl 1.61372,0.0,-815.9799999999814,0.0,0.0,1.61762,09.05.2008 04:15:00,1736,-0.7418737152700535,-127.23,IS,0.34,0.0,Phase3-EA-S4v1-EURCHF-M15-221,EURCHFMT4,512,6h 59m,Buy
19114.65,201.16,09.05.2008 17:29:57,sl 201.160,0.0,-874.4199999999837,0.0,0.0,200.49,09.05.2008 14:30:00,1737,-0.7950062674409213,-58.44,IS,0.09,0.0,Phase3-EA-B1v1-GBPJPY-M30-1,GBPJPYMT4,238,2h 59m,Sell
19163.14,103.06,12.05.2008 01:15:00,,-0.76,-825.9299999999785,0.0,0.0,102872,09.05.2008 21:45:00,1738,-0.7509200686940775,48.49,IS,0.27,0.0,Phase3-EA-S1v2-USDJPY-M15-0,USDJPYMT4,664,2d 3h 30m,Buy
19209.85,102882,12.05.2008 02:00:00,,0.0,-779.2199999999721,0.0,0.0,103.06,12.05.2008 01:15:00,1739,-0.7084522125698223,46.71,IS,0.27,0.0,Phase3-EA-S1v2-USDJPY-M15-0,USDJPYMT4,666,45m 0s,Sell
19083.37,1.6166,12.05.2008 10:59:58,sl 1.61660,0.0,-905.699999999968,0.0,0.0,1.6127,12.05.2008 04:30:00,1740,-0.8234454568985503,-126.48,IS,0.34,0.0,Phase3-EA-S4v1-EURCHF-M15-221,EURCHFMT4,514,6h 29m,Sell
19040.84,1.95402,13.05.2008 02:29:57,sl 1.95402,-0.53,-948.2299999999668,0.0,0.0,1.95702,12.05.2008 12:00:00,1741,-0.8621129354034588,-42.53,IS,0.14,0.0,Phase3-EA-B1v1-GBPUSD-M30-14,GBPUSDMT4,134,14h 29m,Buy
19096.41,1.0438,13.05.2008 03:29:59,tp 1.04380,0.0,-892.6599999999598,0.0,0.0,1.0448,13.05.2008 02:15:00,1742,-0.8115897334162006,55.57,IS,0.58,0.0,Phase3-EA-SA2v2-USDCHF-M15-107,USDCHFMT4,434,1h 14m,Sell
19086.91,103752,13.05.2008 03:30:00,,-1.17,-902.1599999999598,0.0,0.0,103.72,12.05.2008 21:15:00,1743,-0.8202269552783364,-9.5,IS,0.27,0.0,Phase3-EA-S1v2-USDJPY-M15-0,USDJPYMT4,668,6h 15m,Sell
19128.1,1.6212,13.05.2008 04:39:57,tp 1.62120,-1.96,-860.9699999999575,0.0,0.0,1.6223,12.05.2008 21:50:00,1744,-0.7827777796466103,41.19,IS,0.41,0.0,Phase3-EA-SA2v2-EURCHF-M5-43,EURCHFMT4,980,6h 49m,Sell
19134.3,202.81,13.05.2008 07:35:00,,0.0,-854.7699999999604,0.0,0.0,202782,13.05.2008 02:10:00,1745,-0.7771408559050085,6.2,IS,0.23,0.0,Phase3-EA-S4v1-GBPJPY-M5-194,GBPJPYMT4,522,5h 25m,Buy
19045.95,1.6194,13.05.2008 12:45:00,,0.0,-943.1199999999662,0.0,0.0,1.62212,13.05.2008 04:00:00,1746,-0.8574670192228778,-88.35,IS,0.34,0.0,Phase3-EA-S4v1-EURCHF-M15-221,EURCHFMT4,516,8h 45m,Buy
19093.32,104592,14.05.2008 02:30:00,,-1.16,-895.7499999999709,0.0,0.0,104.78,13.05.2008 21:45:00,1747,-0.8143991034745264,47.37,IS,0.27,0.0,Phase3-EA-S1v2-USDJPY-M15-0,USDJPYMT4,670,4h 45m,Sell
19148.43,1.05242,14.05.2008 02:59:57,tp 1.05242,0.0,-840.6399999999703,0.0,0.0,1.05142,14.05.2008 02:45:00,1748,-0.764294124861651,55.11,IS,0.58,0.0,Phase3-EA-SA2v2-USDCHF-M15-107,USDCHFMT4,436,14m 57s,Buy
19191.27,1.62872,14.05.2008 06:19:58,tp 1.62872,0.0,-797.7999999999738,0.0,0.0,1.62762,14.05.2008 02:05:00,1749,-0.7253448001696645,42.84,IS,0.41,0.0,Phase3-EA-SA2v2-EURCHF-M5-43,EURCHFMT4,982,4h 14m,Buy
19319.95,1.63222,14.05.2008 11:44:58,tp 1.63222,0.0,-669.1199999999808,0.0,0.0,1.62822,14.05.2008 03:00:00,1750,-0.6083513570939182,128.68,IS,0.34,0.0,Phase3-EA-S4v1-EURCHF-M15-221,EURCHFMT4,518,8h 44m,Buy
19359.91,1.63232,15.05.2008 00:44:57,tp 1.63232,-2.8,-629.1599999999744,0.0,0.0,1.63122,14.05.2008 22:50:00,1751,-0.5720204743980227,39.96,IS,0.41,0.0,Phase3-EA-SA2v2-EURCHF-M5-43,EURCHFMT4,984,1h 54m,Buy
19414.89,1.05492,15.05.2008 01:59:57,tp 1.05492,0.0,-574.1799999999785,0.0,0.0,1.05392,15.05.2008 00:15:00,1752,-0.5220336893474755,54.98,IS,0.58,0.0,Phase3-EA-SA2v2-USDCHF-M15-107,USDCHFMT4,438,1h 44m,Buy
19351.57,1.6297,15.05.2008 10:30:00,,0.0,-637.4999999999854,0.0,0.0,1.63132,15.05.2008 02:10:00,1753,-0.5796030460117394,-63.32,IS,0.41,0.0,Phase3-EA-SA2v2-EURCHF-M5-43,EURCHFMT4,986,8h 20m,Buy
19480.83,1.63432,15.05.2008 12:14:58,tp 1.63432,0.0,-508.2399999999907,0.0,0.0,1.63032,15.05.2008 05:15:00,1754,-0.4620822778117769,129.26,IS,0.34,0.0,Phase3-EA-S4v1-EURCHF-M15-221,EURCHFMT4,520,6h 59m,Buy
19521.59,104662,15.05.2008 22:45:00,,0.0,-467.4799999999959,0.0,0.0,104.82,15.05.2008 21:30:00,1755,-0.42502405011697536,40.76,IS,0.27,0.0,Phase3-EA-S1v2-USDJPY-M15-0,USDJPYMT4,672,1h 15m,Sell
19564.25,1.6318,16.05.2008 00:09:57,tp 1.63180,0.0,-424.81999999999243,0.0,0.0,1.6329,16.05.2008 00:05:00,1756,-0.38623837804973865,42.66,IS,0.41,0.0,Phase3-EA-SA2v2-EURCHF-M5-43,EURCHFMT4,988,4m 57s,Sell
19606.98,1.63212,16.05.2008 01:49:59,tp 1.63212,0.0,-382.0899999999965,0.0,0.0,1.63102,16.05.2008 00:15:00,1757,-0.3473890632951036,42.73,IS,0.41,0.0,Phase3-EA-SA2v2-EURCHF-M5-43,EURCHFMT4,990,1h 34m,Buy
19616.87,1.05572,16.05.2008 04:30:00,,0.0,-372.1999999999971,0.0,0.0,1.0559,16.05.2008 00:15:00,1758,-0.33839726074599635,9.89,IS,0.58,0.0,Phase3-EA-SA2v2-USDCHF-M15-107,USDCHFMT4,440,4h 15m,Sell
19677.96,203812,16.05.2008 07:00:00,,0.0,-311.1100000000006,0.0,0.0,204.09,16.05.2008 01:35:00,1759,-0.2828553782662223,61.09,IS,0.23,0.0,Phase3-EA-S4v1-GBPJPY-M5-194,GBPJPYMT4,524,5h 25m,Sell
19720.75,1.6319,16.05.2008 08:24:59,tp 1.63190,0.0,-268.320000000007,0.0,0.0,1633,16.05.2008 02:50:00,1760,-0.24395151263667064,42.79,IS,0.41,0.0,Phase3-EA-SA2v2-EURCHF-M5-43,EURCHFMT4,992,5h 34m,Sell
19813.86,1.63022,16.05.2008 11:45:00,,0.0,-175.2100000000064,0.0,0.0,1.6331,16.05.2008 03:00:00,1761,-0.1592976465752516,93.11,IS,0.34,0.0,Phase3-EA-S4v1-EURCHF-M15-221,EURCHFMT4,522,8h 45m,Sell
19597.55,103602,16.05.2008 18:29:58,sl 103.602,0.0,-391.5200000000041,0.0,0.0,104432,16.05.2008 17:15:00,1762,-0.3559626424698412,-216.31,IS,0.27,0.0,Phase3-EA-S1v2-USDJPY-M15-0,USDJPYMT4,674,1h 14m,Buy
19650.06,1.0461,19.05.2008 01:00:00,tp 1.04610,-2.93,-339.0100000000093,0.0,0.0,1.0471,16.05.2008 23:00:00,1763,-0.30822153510345046,52.51,IS,0.58,0.0,Phase3-EA-SA2v2-USDCHF-M15-107,USDCHFMT4,442,2d 2h 0m,Sell
19565.16,1.63192,19.05.2008 05:25:00,,-1.96,-423.9100000000035,0.0,0.0,1.6298,16.05.2008 21:05:00,1764,-0.38541102311348097,-84.9,IS,0.41,0.0,Phase3-EA-SA2v2-EURCHF-M5-43,EURCHFMT4,994,2d 8h 20m,Sell
19651.42,203.53,19.05.2008 08:44:58,tp 203.530,0.0,-337.65000000000873,0.0,0.0,203.92,19.05.2008 03:20:00,1765,-0.3069850486052915,86.26,IS,0.23,0.0,Phase3-EA-S4v1-GBPJPY-M5-194,GBPJPYMT4,526,5h 24m,Sell
19678.28,104022,19.05.2008 08:45:00,,-1.17,-310.79000000000815,0.0,0.0,104.13,16.05.2008 22:00:00,1766,-0.2825644402666625,26.86,IS,0.27,0.0,Phase3-EA-S1v2-USDJPY-M15-0,USDJPYMT4,676,2d 10h 45m,Sell
19808.37,1.6292,19.05.2008 09:29:58,tp 1.62920,0.0,-180.70000000001164,0.0,0.0,1.6332,19.05.2008 03:45:00,1767,-0.16428905163032229,130.09,IS,0.34,0.0,Phase3-EA-S4v1-EURCHF-M15-221,EURCHFMT4,524,5h 44m,Sell
19851.21,1.63362,19.05.2008 22:59:57,tp 1.63362,0.0,-137.86000000001513,0.0,0.0,1.63252,19.05.2008 22:45:00,1768,-0.12533972693833567,42.84,IS,0.41,0.0,Phase3-EA-SA2v2-EURCHF-M5-43,EURCHFMT4,996,14m 57s,Buy
19852.53,104.4,20.05.2008 02:45:00,,-0.75,-136.54000000000815,0.0,0.0,104392,19.05.2008 21:15:00,1769,-0.12413960769011675,1.32,IS,0.27,0.0,Phase3-EA-S1v2-USDJPY-M15-0,USDJPYMT4,678,5h 30m,Buy
19907.61,1.05292,20.05.2008 03:29:57,tp 1.05292,0.0,-81.4600000000064,0.0,0.0,1.05192,20.05.2008 02:00:00,1770,-0.07406190451469974,55.08,IS,0.58,0.0,Phase3-EA-SA2v2-USDCHF-M15-107,USDCHFMT4,444,1h 29m,Buy
19780.04,1.62772,20.05.2008 13:14:59,sl 1.62772,0.0,-209.0300000000134,0.0,0.0,1.63162,20.05.2008 06:00:00,1771,-0.19004615640446185,-127.57,IS,0.34,0.0,Phase3-EA-S4v1-EURCHF-M15-221,EURCHFMT4,526,7h 14m,Buy
19784.73,103682,20.05.2008 22:30:00,,0.0,-204.34000000001106,0.0,0.0,103.7,20.05.2008 21:00:00,1772,-0.1857820963483105,4.69,IS,0.27,0.0,Phase3-EA-S1v2-USDJPY-M15-0,USDJPYMT4,680,1h 30m,Sell
19606.51,202952,21.05.2008 05:04:58,sl 202.952,0.0,-382.5600000000122,0.0,0.0,203752,21.05.2008 02:25:00,1773,-0.3478163784819815,-178.22,IS,0.23,0.0,Phase3-EA-S4v1-GBPJPY-M5-194,GBPJPYMT4,528,2h 39m,Buy
19596.85,1.6232,21.05.2008 06:40:00,,-0.95,-392.2200000000157,0.0,0.0,1.62342,20.05.2008 22:20:00,1774,-0.3565990693439039,-9.66,IS,0.41,0.0,Phase3-EA-SA2v2-EURCHF-M5-43,EURCHFMT4,998,8h 20m,Buy
19727.74,1.62622,21.05.2008 11:14:58,tp 1.62622,0.0,-261.3300000000163,0.0,0.0,1.62222,21.05.2008 04:30:00,1775,-0.23759633570864436,130.89,IS,0.34,0.0,Phase3-EA-S4v1-EURCHF-M15-221,EURCHFMT4,528,6h 44m,Buy
19528.83,1.61742,22.05.2008 03:14:57,sl 1.61742,-2.88,-460.2400000000198,0.0,0.0,1.62232,21.05.2008 21:25:00,1776,-0.4184415778768008,-198.91,IS,0.41,0.0,Phase3-EA-SA2v2-EURCHF-M5-43,EURCHFMT4,1000,5h 49m,Buy
19446.34,1.0237,22.05.2008 03:15:00,,-2.04,-542.730000000025,0.0,0.0,1.02512,21.05.2008 23:00:00,1777,-0.49343993907760475,-82.49,IS,0.58,0.0,Phase3-EA-SA2v2-USDCHF-M15-107,USDCHFMT4,446,4h 15m,Buy
19533.44,203192,22.05.2008 07:24:58,tp 203.192,0.0,-455.6300000000192,0.0,0.0,202802,22.05.2008 03:20:00,1778,-0.41425025232054274,87.1,IS,0.23,0.0,Phase3-EA-S4v1-GBPJPY-M5-194,GBPJPYMT4,530,4h 4m,Buy
19529.46,1.6186,22.05.2008 10:00:00,,0.0,-459.61000000001513,0.0,0.0,1.61872,22.05.2008 01:15:00,1779,-0.4178687936901497,-3.98,IS,0.34,0.0,Phase3-EA-S4v1-EURCHF-M15-221,EURCHFMT4,530,8h 45m,Buy
19550.15,1.0313,23.05.2008 04:00:00,,-0.68,-438.9200000000128,0.0,0.0,1.03092,22.05.2008 23:45:00,1780,-0.39905783365566416,20.69,IS,0.58,0.0,Phase3-EA-SA2v2-USDCHF-M15-107,USDCHFMT4,448,4h 15m,Buy
19572.2,104.19,23.05.2008 04:15:00,,-0.75,-416.8700000000099,0.0,0.0,104102,22.05.2008 23:45:00,1781,-0.3790103871230197,22.05,IS,0.27,0.0,Phase3-EA-S1v2-USDJPY-M15-0,USDJPYMT4,682,4h 30m,Buy
19559.92,206.02,23.05.2008 04:45:00,,-0.8,-429.15000000000873,0.0,0.0,206072,22.05.2008 23:20:00,1782,-0.39017513285639016,-12.28,IS,0.23,0.0,Phase3-EA-S4v1-GBPJPY-M5-194,GBPJPYMT4,532,5h 25m,Buy
19501.72,205692,23.05.2008 09:59:58,sl 205.692,-0.31,-487.3500000000058,0.0,0.0,206362,22.05.2008 21:30:00,1783,-0.4430894815275781,-58.2,IS,0.09,0.0,Phase3-EA-B1v1-GBPJPY-M30-1,GBPJPYMT4,240,12h 29m,Buy
19545.8,1.61452,23.05.2008 21:19:58,tp 1.61452,0.0,-443.2700000000041,0.0,0.0,1.61342,23.05.2008 20:05:00,1784,-0.4030127720872658,44.08,IS,0.41,0.0,Phase3-EA-SA2v2-EURCHF-M5-43,EURCHFMT4,1002,1h 14m,Buy
19485.05,1.02442,26.05.2008 02:30:00,,-3.0,-504.0200000000041,0.0,0.0,1.0234,23.05.2008 22:15:00,1785,-0.4582455329425034,-60.75,IS,0.58,0.0,Phase3-EA-SA2v2-USDCHF-M15-107,USDCHFMT4,450,2d 4h 15m,Sell
19504.28,103182,26.05.2008 03:00:00,,-1.18,-484.79000000000815,0.0,0.0,103.26,23.05.2008 20:45:00,1786,-0.44076197753104673,19.23,IS,0.27,0.0,Phase3-EA-S1v2-USDJPY-M15-0,USDJPYMT4,684,2d 6h 15m,Sell
19591.15,204772,26.05.2008 05:04:57,tp 204.772,0.0,-397.9200000000128,0.0,0.0,204382,26.05.2008 03:10:00,1787,-0.36178140246118284,86.87,IS,0.23,0.0,Phase3-EA-S4v1-GBPJPY-M5-194,GBPJPYMT4,534,1h 54m,Buy
19548.35,1.61572,26.05.2008 07:00:00,,-2.0,-440.7200000000157,0.0,0.0,1.6147,23.05.2008 22:40:00,1788,-0.40069435990322944,-42.8,IS,0.41,0.0,Phase3-EA-SA2v2-EURCHF-M5-43,EURCHFMT4,1004,2d 8h 20m,Sell
19534.41,1.61642,26.05.2008 10:45:00,,0.0,-454.66000000001804,0.0,0.0,1616,26.05.2008 02:00:00,1789,-0.41336834650935517,-13.94,IS,0.34,0.0,Phase3-EA-S4v1-EURCHF-M15-221,EURCHFMT4,532,8h 45m,Sell
19458.9,1.0231,27.05.2008 03:45:00,,-0.68,-530.1700000000128,0.0,0.0,1.02442,26.05.2008 23:30:00,1790,-0.4820206225946013,-75.51,IS,0.58,0.0,Phase3-EA-SA2v2-USDCHF-M15-107,USDCHFMT4,452,4h 15m,Buy
19366.33,1.61852,27.05.2008 10:00:00,,0.0,-622.7400000000198,0.0,0.0,1.6162,27.05.2008 01:40:00,1791,-0.5661835307817574,-92.57,IS,0.41,0.0,Phase3-EA-SA2v2-EURCHF-M5-43,EURCHFMT4,1006,8h 20m,Sell
19365.67,1.61642,27.05.2008 11:45:00,,0.0,-623.4000000000233,0.0,0.0,1.6164,27.05.2008 03:00:00,1792,-0.5667835904058668,-0.66,IS,0.34,0.0,Phase3-EA-S4v1-EURCHF-M15-221,EURCHFMT4,534,8h 45m,Sell
19404.04,104.15,27.05.2008 21:30:00,,0.0,-585.0300000000279,0.0,0.0,104002,27.05.2008 18:30:00,1793,-0.5318983058953284,38.37,IS,0.27,0.0,Phase3-EA-S1v2-USDJPY-M15-0,USDJPYMT4,686,3h 0m,Buy
19457.21,1.0331,28.05.2008 02:14:59,tp 1.03310,-2.97,-531.8600000000297,0.0,0.0,1.0341,27.05.2008 23:00:00,1794,-0.4835571389048282,53.17,IS,0.58,0.0,Phase3-EA-SA2v2-USDCHF-M15-107,USDCHFMT4,454,3h 14m,Sell
19479.99,104.3,28.05.2008 03:15:00,,0.0,-509.08000000003085,0.0,0.0,104212,28.05.2008 01:45:00,1795,-0.46284599006067595,22.78,IS,0.27,0.0,Phase3-EA-S1v2-USDJPY-M15-0,USDJPYMT4,688,1h 30m,Buy
19421.82,205412,28.05.2008 04:29:58,sl 205.412,-0.31,-567.2500000000291,0.0,0.0,206082,27.05.2008 22:00:00,1796,-0.5157330632944056,-58.17,IS,0.09,0.0,Phase3-EA-B1v1-GBPJPY-M30-1,GBPJPYMT4,242,6h 29m,Buy
19403.15,1.61952,28.05.2008 05:45:00,,-1.98,-585.9200000000274,0.0,0.0,1.6191,27.05.2008 21:25:00,1797,-0.5327074772066227,-18.67,IS,0.41,0.0,Phase3-EA-SA2v2-EURCHF-M5-43,EURCHFMT4,1008,8h 20m,Sell
19283.94,1.0315,28.05.2008 06:45:00,,0.0,-705.1300000000338,0.0,0.0,1.03362,28.05.2008 02:30:00,1798,-0.6410909738577046,-119.21,IS,0.58,0.0,Phase3-EA-SA2v2-USDCHF-M15-107,USDCHFMT4,456,4h 15m,Buy
19378.55,1.6226,28.05.2008 14:00:00,,0.0,-610.5200000000332,0.0,0.0,1.61972,28.05.2008 05:15:00,1799,-0.5550733359233169,94.61,IS,0.34,0.0,Phase3-EA-S4v1-EURCHF-M15-221,EURCHFMT4,536,8h 45m,Buy
19427.01,104.74,28.05.2008 23:45:00,,0.0,-562.0600000000268,0.0,0.0,104552,28.05.2008 17:30:00,1800,-0.5110144126139313,48.46,IS,0.27,0.0,Phase3-EA-S1v2-USDJPY-M15-0,USDJPYMT4,690,6h 15m,Buy
19341.3,1.62512,29.05.2008 05:40:00,,-5.93,-647.7700000000332,0.0,0.0,1.6231,28.05.2008 21:20:00,1801,-0.5889403374353761,-85.71,IS,0.41,0.0,Phase3-EA-SA2v2-EURCHF-M5-43,EURCHFMT4,1010,8h 20m,Sell
19214.29,1.6274,29.05.2008 11:29:57,sl 1.62740,0.0,-774.7800000000279,0.0,0.0,1.6235,29.05.2008 02:45:00,1802,-0.7044154478258854,-127.01,IS,0.34,0.0,Phase3-EA-S4v1-EURCHF-M15-221,EURCHFMT4,538,8h 44m,Sell
19257.23,1.6282,29.05.2008 20:49:58,tp 1.62820,0.0,-731.8400000000256,0.0,0.0,1.6293,29.05.2008 20:10:00,1803,-0.6653752050090289,42.94,IS,0.41,0.0,Phase3-EA-SA2v2-EURCHF-M5-43,EURCHFMT4,1012,39m 58s,Sell
19300.2,1.62852,29.05.2008 23:59:58,tp 1.62852,0.0,-688.8700000000244,0.0,0.0,1.62742,29.05.2008 22:25:00,1804,-0.626307686754714,42.97,IS,0.41,0.0,Phase3-EA-SA2v2-EURCHF-M5-43,EURCHFMT4,1014,1h 34m,Buy
19342.37,105.7,30.05.2008 03:45:00,,-0.74,-646.7000000000262,0.0,0.0,105532,29.05.2008 22:15:00,1805,-0.5879675134993186,42.17,IS,0.27,0.0,Phase3-EA-S1v2-USDJPY-M15-0,USDJPYMT4,692,5h 30m,Buy
19377.33,1.62742,30.05.2008 12:30:00,,0.0,-611.7400000000198,0.0,0.0,1.6285,30.05.2008 03:45:00,1806,-0.5561825370466527,34.96,IS,0.34,0.0,Phase3-EA-S4v1-EURCHF-M15-221,EURCHFMT4,540,8h 45m,Sell
19409.0,105312,02.06.2008 01:15:00,,-1.15,-580.0700000000215,0.0,0.0,105.44,30.05.2008 23:15:00,1807,-0.527388766902039,31.67,IS,0.27,0.0,Phase3-EA-S1v2-USDJPY-M15-0,USDJPYMT4,694,2d 2h 0m,Sell
19451.3,1.62212,02.06.2008 02:49:59,tp 1.62212,-0.94,-537.7700000000186,0.0,0.0,1.62102,30.05.2008 21:10:00,1808,-0.4889304000843153,42.3,IS,0.41,0.0,Phase3-EA-SA2v2-EURCHF-M5-43,EURCHFMT4,1016,2d 5h 39m,Buy
19494.59,1.6209,02.06.2008 03:24:59,tp 1.62090,0.0,-494.48000000002503,0.0,0.0,1622,02.06.2008 02:55:00,1809,-0.44957194383044075,43.29,IS,0.41,0.0,Phase3-EA-SA2v2-EURCHF-M5-43,EURCHFMT4,1018,29m 59s,Sell
19410.11,1.04362,02.06.2008 06:00:00,,0.0,-578.960000000021,0.0,0.0,1.0421,02.06.2008 01:45:00,1810,-0.5263795757160415,-84.48,IS,0.58,0.0,Phase3-EA-SA2v2-USDCHF-M15-107,USDCHFMT4,458,4h 15m,Sell
19418.4,208.12,02.06.2008 06:40:00,,0.0,-570.6700000000274,0.0,0.0,208082,02.06.2008 01:15:00,1811,-0.518842463164773,8.29,IS,0.23,0.0,Phase3-EA-S4v1-GBPJPY-M5-194,GBPJPYMT4,536,5h 25m,Buy
19336.21,1.6189,02.06.2008 09:45:00,,0.0,-652.8600000000297,0.0,0.0,1.62142,02.06.2008 01:00:00,1812,-0.5935680699909804,-82.19,IS,0.34,0.0,Phase3-EA-S4v1-EURCHF-M15-221,EURCHFMT4,542,8h 45m,Buy
19287.83,1.96562,02.06.2008 10:29:58,sl 1.96562,-6.38,-701.2400000000343,0.0,0.0,1.96862,21.05.2008 23:00:00,1813,-0.6375542588004727,-48.38,IS,0.14,0.0,Phase3-EA-B1v1-GBPUSD-M30-14,GBPUSDMT4,136,11d 11h 29m,Buy
19320.89,104532,02.06.2008 17:30:00,,0.0,-668.1800000000367,0.0,0.0,104.66,02.06.2008 17:15:00,1814,-0.6074967267202418,33.06,IS,0.27,0.0,Phase3-EA-S1v2-USDJPY-M15-0,USDJPYMT4,696,15m 0s,Sell
19405.51,205.14,03.06.2008 02:39:57,tp 205.140,-1.28,-583.5600000000413,0.0,0.0,205.53,02.06.2008 23:00:00,1815,-0.5305618094598311,84.62,IS,0.23,0.0,Phase3-EA-S4v1-GBPJPY-M5-194,GBPJPYMT4,538,3h 39m,Sell
19423.81,1.03652,03.06.2008 03:00:00,,-2.96,-565.2600000000384,0.0,0.0,1.0369,02.06.2008 22:45:00,1816,-0.5139237926096087,18.3,IS,0.58,0.0,Phase3-EA-SA2v2-USDCHF-M15-107,USDCHFMT4,460,4h 15m,Sell
19455.77,104352,03.06.2008 03:00:00,,-1.16,-533.300000000032,0.0,0.0,104.48,02.06.2008 22:30:00,1817,-0.4848663599028804,31.96,IS,0.27,0.0,Phase3-EA-S1v2-USDJPY-M15-0,USDJPYMT4,698,4h 30m,Sell
19497.28,1.6106,03.06.2008 03:24:58,tp 1.61060,-1.98,-491.79000000003725,0.0,0.0,1.6117,02.06.2008 23:05:00,1818,-0.4471262462715944,41.51,IS,0.41,0.0,Phase3-EA-SA2v2-EURCHF-M5-43,EURCHFMT4,1020,4h 19m,Sell
19455.28,1.96462,03.06.2008 12:59:57,sl 1.96462,0.0,-533.7900000000373,0.0,0.0,1.96762,03.06.2008 11:30:00,1819,-0.48531185871472166,-42.0,IS,0.14,0.0,Phase3-EA-B1v1-GBPUSD-M30-14,GBPUSDMT4,138,1h 29m,Buy
19397.09,206.3,03.06.2008 15:29:58,sl 206.300,-0.5,-591.9800000000396,0.0,0.0,205.63,02.06.2008 14:30:00,1820,-0.5382171155734279,-58.19,IS,0.09,0.0,Phase3-EA-B1v1-GBPJPY-M30-1,GBPJPYMT4,244,1d 0h 59m,Sell
19452.81,1041,04.06.2008 02:29:58,tp 1.04100,0.0,-536.2600000000384,0.0,0.0,1042,04.06.2008 00:15:00,1821,-0.48755753639887806,55.72,IS,0.58,0.0,Phase3-EA-SA2v2-USDCHF-M15-107,USDCHFMT4,462,2h 14m,Sell
19474.65,105.18,04.06.2008 04:00:00,,-0.75,-514.4200000000419,0.0,0.0,105092,03.06.2008 20:45:00,1822,-0.4677010179284551,21.84,IS,0.27,0.0,Phase3-EA-S1v2-USDJPY-M15-0,USDJPYMT4,700,7h 15m,Buy
19433.58,1.6105,04.06.2008 04:35:00,,-0.94,-555.4900000000489,0.0,0.0,1.61152,03.06.2008 20:15:00,1823,-0.505041091810348,-41.07,IS,0.41,0.0,Phase3-EA-SA2v2-EURCHF-M5-43,EURCHFMT4,1022,8h 20m,Buy
19453.63,105.02,04.06.2008 22:00:00,,0.0,-535.440000000046,0.0,0.0,104942,04.06.2008 20:15:00,1824,-0.4868120077749953,20.05,IS,0.27,0.0,Phase3-EA-S1v2-USDJPY-M15-0,USDJPYMT4,702,1h 45m,Buy
19489.06,105.16,04.06.2008 22:15:00,,0.0,-500.01000000005297,0.0,0.0,105022,04.06.2008 22:00:00,1825,-0.4545997161354779,35.43,IS,0.27,0.0,Phase3-EA-S1v2-USDJPY-M15-0,USDJPYMT4,704,15m 0s,Buy
19362.05,1.6132,05.06.2008 10:44:57,sl 1.61320,0.0,-627.0200000000477,0.0,0.0,1.6093,05.06.2008 06:30:00,1826,-0.5700748265259872,-127.01,IS,0.34,0.0,Phase3-EA-S4v1-EURCHF-M15-221,EURCHFMT4,544,4h 14m,Sell
19320.05,1.9561,05.06.2008 16:59:58,sl 1.95610,0.0,-669.0200000000477,0.0,0.0,1.9531,05.06.2008 03:30:00,1827,-0.6082604389691144,-42.0,IS,0.14,0.0,Phase3-EA-B1v1-GBPUSD-M30-14,GBPUSDMT4,140,13h 29m,Sell
19375.95,1.0375,06.06.2008 02:59:58,tp 1.03750,0.0,-613.1200000000536,0.0,0.0,1.0385,06.06.2008 01:15:00,1828,-0.5574372071698146,55.9,IS,0.58,0.0,Phase3-EA-SA2v2-USDCHF-M15-107,USDCHFMT4,464,1h 44m,Sell
19397.6,106.12,06.06.2008 04:00:00,,-0.74,-591.4700000000594,0.0,0.0,106032,05.06.2008 17:00:00,1829,-0.5377534331366365,21.65,IS,0.27,0.0,Phase3-EA-S1v2-USDJPY-M15-0,USDJPYMT4,706,11h 0m,Buy
19386.94,1.61902,06.06.2008 07:25:00,,-1.98,-602.1300000000629,0.0,0.0,1.6188,05.06.2008 23:05:00,1830,-0.5474453052472048,-10.66,IS,0.41,0.0,Phase3-EA-SA2v2-EURCHF-M5-43,EURCHFMT4,1024,8h 20m,Sell
19353.58,1.62072,06.06.2008 13:15:00,,0.0,-635.4900000000634,0.0,0.0,1.6197,06.06.2008 04:30:00,1831,-0.5777755917020321,-33.36,IS,0.34,0.0,Phase3-EA-S4v1-EURCHF-M15-221,EURCHFMT4,546,8h 45m,Sell
19295.49,206582,09.06.2008 01:00:00,sl 206.582,-0.62,-693.58000000006,0.0,0.0,207252,05.06.2008 17:00:00,1832,-0.6305899304358685,-58.09,IS,0.09,0.0,Phase3-EA-B1v1-GBPJPY-M30-1,GBPJPYMT4,246,3d 8h 0m,Buy
19119.33,205992,09.06.2008 01:00:00,sl 205.992,-0.79,-869.7400000000634,0.0,0.0,206792,06.06.2008 23:00:00,1833,-0.790751299197331,-176.16,IS,0.23,0.0,Phase3-EA-S4v1-GBPJPY-M5-194,GBPJPYMT4,540,2d 2h 0m,Buy
19204.97,206432,09.06.2008 02:14:57,tp 206.432,0.0,-784.100000000064,0.0,0.0,206042,09.06.2008 01:15:00,1834,-0.7128890170632979,85.64,IS,0.23,0.0,Phase3-EA-S4v1-GBPJPY-M5-194,GBPJPYMT4,542,59m 57s,Buy
19338.34,1.60952,09.06.2008 03:59:58,tp 1.60952,0.0,-650.7300000000687,0.0,0.0,1.60552,09.06.2008 02:45:00,1835,-0.5916315139314002,133.37,IS,0.34,0.0,Phase3-EA-S4v1-EURCHF-M15-221,EURCHFMT4,548,1h 14m,Buy
19381.57,1.60972,09.06.2008 04:09:57,tp 1.60972,-0.97,-607.5000000000728,0.0,0.0,1.60862,06.06.2008 21:45:00,1836,-0.5523276085524422,43.23,IS,0.41,0.0,Phase3-EA-SA2v2-EURCHF-M5-43,EURCHFMT4,1026,2d 6h 24m,Buy
19437.66,1.60822,09.06.2008 14:15:00,,0.0,-551.4100000000763,0.0,0.0,1.6099,09.06.2008 05:30:00,1837,-0.5013316323158976,56.09,IS,0.34,0.0,Phase3-EA-S4v1-EURCHF-M15-221,EURCHFMT4,550,8h 45m,Sell
19481.6,1.60792,09.06.2008 20:14:58,tp 1.60792,0.0,-507.4700000000739,0.0,0.0,1.60682,09.06.2008 20:10:00,1838,-0.4613822082503953,43.94,IS,0.41,0.0,Phase3-EA-SA2v2-EURCHF-M5-43,EURCHFMT4,1028,4m 58s,Buy
19547.13,106.3,09.06.2008 22:45:00,,0.0,-441.9400000000751,0.0,0.0,106042,09.06.2008 21:15:00,1839,-0.4018035610266314,65.53,IS,0.27,0.0,Phase3-EA-S1v2-USDJPY-M15-0,USDJPYMT4,708,1h 30m,Buy
19591.0,1.60762,09.06.2008 23:44:58,tp 1.60762,0.0,-398.07000000007974,0.0,0.0,1.60652,09.06.2008 21:15:00,1840,-0.36191777964854055,43.87,IS,0.41,0.0,Phase3-EA-SA2v2-EURCHF-M5-43,EURCHFMT4,1030,2h 29m,Buy
19647.42,1.02802,10.06.2008 03:14:58,tp 1.02802,0.0,-341.6500000000815,0.0,0.0,1.02702,10.06.2008 02:45:00,1841,-0.31062177359994125,56.42,IS,0.58,0.0,Phase3-EA-SA2v2-USDCHF-M15-107,USDCHFMT4,466,29m 58s,Buy
19473.74,210.63,10.06.2008 03:29:58,sl 210.630,-1.25,-515.3300000000745,0.0,0.0,209.83,09.06.2008 23:15:00,1842,-0.46852837286475246,-173.68,IS,0.23,0.0,Phase3-EA-S4v1-GBPJPY-M5-194,GBPJPYMT4,544,4h 14m,Sell
19557.78,210.15,10.06.2008 06:04:58,tp 210.150,0.0,-431.2900000000809,0.0,0.0,210.54,10.06.2008 03:35:00,1843,-0.392120780728558,84.04,IS,0.23,0.0,Phase3-EA-S4v1-GBPJPY-M5-194,GBPJPYMT4,546,2h 29m,Sell
19500.95,209092,10.06.2008 10:59:57,sl 209.092,-0.3,-488.12000000008265,0.0,0.0,209762,09.06.2008 18:30:00,1844,-0.4437895510891053,-56.83,IS,0.09,0.0,Phase3-EA-B1v1-GBPJPY-M30-1,GBPJPYMT4,248,16h 29m,Buy
19544.19,1.6118,10.06.2008 20:49:58,tp 1.61180,0.0,-444.8800000000774,0.0,0.0,1.6129,10.06.2008 20:35:00,1845,-0.4044765538976524,43.24,IS,0.41,0.0,Phase3-EA-SA2v2-EURCHF-M5-43,EURCHFMT4,1032,14m 58s,Sell
19566.31,107.42,11.06.2008 02:30:00,,0.0,-422.7600000000821,0.0,0.0,107332,11.06.2008 01:00:00,1846,-0.3843654646776096,22.12,IS,0.27,0.0,Phase3-EA-S1v2-USDJPY-M15-0,USDJPYMT4,710,1h 30m,Buy
19609.63,1.6116,11.06.2008 05:59:59,tp 1.61160,0.0,-379.4400000000751,0.0,0.0,1.6127,11.06.2008 02:40:00,1847,-0.34497973298626344,43.32,IS,0.41,0.0,Phase3-EA-SA2v2-EURCHF-M5-43,EURCHFMT4,1034,3h 19m,Sell
19586.13,1.61292,11.06.2008 12:00:00,,0.0,-402.9400000000751,0.0,0.0,1.6122,11.06.2008 03:15:00,1848,-0.3663454923294418,-23.5,IS,0.34,0.0,Phase3-EA-S4v1-EURCHF-M15-221,EURCHFMT4,552,8h 45m,Sell
19569.58,106882,12.06.2008 02:45:00,,-3.41,-419.490000000078,0.0,0.0,106.83,11.06.2008 19:30:00,1849,-0.38139244199453387,-16.55,IS,0.27,0.0,Phase3-EA-S1v2-USDJPY-M15-0,USDJPYMT4,712,7h 15m,Sell
19625.77,1.03222,12.06.2008 04:29:57,tp 1.03222,0.0,-363.30000000007567,0.0,0.0,1.03122,12.06.2008 00:30:00,1850,-0.33030554763311937,56.19,IS,0.58,0.0,Phase3-EA-SA2v2-USDCHF-M15-107,USDCHFMT4,468,3h 59m,Buy
19598.38,1.6044,12.06.2008 07:35:00,,-2.86,-390.6900000000751,0.0,0.0,1.60502,11.06.2008 23:15:00,1851,-0.3552080220335297,-27.39,IS,0.41,0.0,Phase3-EA-SA2v2-EURCHF-M5-43,EURCHFMT4,1036,8h 20m,Buy
19672.72,1.6066,12.06.2008 10:15:00,,0.0,-316.3500000000786,0.0,0.0,1.60432,12.06.2008 01:30:00,1852,-0.2876194880091977,74.34,IS,0.34,0.0,Phase3-EA-S4v1-EURCHF-M15-221,EURCHFMT4,554,8h 45m,Buy
19653.97,107.89,13.06.2008 03:00:00,,-0.73,-335.1000000000786,0.0,0.0,107962,12.06.2008 20:15:00,1853,-0.30466663642130803,-18.75,IS,0.27,0.0,Phase3-EA-S1v2-USDJPY-M15-0,USDJPYMT4,714,6h 45m,Buy
19709.62,1.04222,13.06.2008 03:29:58,tp 1.04222,0.0,-279.4500000000844,0.0,0.0,1.04122,13.06.2008 00:15:00,1854,-0.25407069993416975,55.65,IS,0.58,0.0,Phase3-EA-SA2v2-USDCHF-M15-107,USDCHFMT4,470,3h 14m,Buy
19629.03,1.6077,13.06.2008 04:35:00,,-0.94,-360.0400000000809,0.0,0.0,1.60972,12.06.2008 20:15:00,1855,-0.32734161676253853,-80.59,IS,0.41,0.0,Phase3-EA-SA2v2-EURCHF-M5-43,EURCHFMT4,1038,8h 20m,Buy
19677.23,1.6091,13.06.2008 10:00:00,,0.0,-311.8400000000838,0.0,0.0,1.60762,13.06.2008 01:15:00,1856,-0.28351908057780945,48.2,IS,0.34,0.0,Phase3-EA-S4v1-EURCHF-M15-221,EURCHFMT4,556,8h 45m,Buy
19706.68,108.19,13.06.2008 21:45:00,,0.0,-282.39000000008673,0.0,0.0,108072,13.06.2008 17:00:00,1857,-0.25674369280519077,29.45,IS,0.27,0.0,Phase3-EA-S1v2-USDJPY-M15-0,USDJPYMT4,716,4h 45m,Buy
19788.36,210.36,16.06.2008 01:00:00,tp 210.360,-1.23,-200.71000000009371,0.0,0.0,210.75,13.06.2008 23:15:00,1858,-0.1824817684158011,81.68,IS,0.23,0.0,Phase3-EA-S4v1-GBPJPY-M5-194,GBPJPYMT4,548,2d 1h 45m,Sell
19784.25,108202,16.06.2008 07:45:00,,-1.12,-204.8200000000943,0.0,0.0,108.19,13.06.2008 21:45:00,1859,-0.1862185033477362,-4.11,IS,0.27,0.0,Phase3-EA-S1v2-USDJPY-M15-0,USDJPYMT4,718,2d 10h 0m,Sell
19914.15,1.61382,16.06.2008 09:29:58,tp 1.61382,0.0,-74.92000000010012,0.0,0.0,1.60982,16.06.2008 01:00:00,1860,-0.06811585914864085,129.9,IS,0.34,0.0,Phase3-EA-S4v1-EURCHF-M15-221,EURCHFMT4,558,8h 29m,Buy
20067.69,212612,16.06.2008 13:59:58,tp 212.612,-0.3,-0.0,0.0,0.0,210762,13.06.2008 23:30:00,1861,-0.0,153.54,IS,0.09,0.0,Phase3-EA-B1v1-GBPJPY-M30-1,GBPJPYMT4,250,2d 14h 29m,Buy
20112.16,108062,16.06.2008 19:15:00,,0.0,-0.0,0.0,0.0,108.24,16.06.2008 17:15:00,1862,-0.0,44.47,IS,0.27,0.0,Phase3-EA-S1v2-USDJPY-M15-0,USDJPYMT4,720,2h 0m,Sell
20155.37,1.6168,16.06.2008 22:09:59,tp 1.61680,0.0,-0.0,0.0,0.0,1.6179,16.06.2008 20:25:00,1863,-0.0,43.21,IS,0.41,0.0,Phase3-EA-SA2v2-EURCHF-M5-43,EURCHFMT4,1040,1h 44m,Sell
20198.53,1.61752,16.06.2008 23:54:57,tp 1.61752,0.0,-0.0,0.0,0.0,1.61642,16.06.2008 23:20:00,1864,-0.0,43.16,IS,0.41,0.0,Phase3-EA-SA2v2-EURCHF-M5-43,EURCHFMT4,1042,34m 57s,Buy
20142.34,211972,17.06.2008 06:59:58,sl 211.972,-0.3,-56.19000000000233,0.0,0.0,212642,16.06.2008 14:00:00,1865,-0.050989790880152645,-56.19,IS,0.09,0.0,Phase3-EA-B1v1-GBPJPY-M30-1,GBPJPYMT4,252,16h 59m,Buy
20054.87,1.6135,17.06.2008 11:10:00,,0.0,-143.6600000000035,0.0,0.0,1.61572,17.06.2008 02:50:00,1866,-0.1303647153913971,-87.47,IS,0.41,0.0,Phase3-EA-SA2v2-EURCHF-M5-43,EURCHFMT4,1044,8h 20m,Buy
20012.87,1.96262,17.06.2008 11:59:58,sl 1.96262,0.0,-185.6600000000035,0.0,0.0,1.96562,17.06.2008 04:30:00,1867,-0.16847774648173922,-42.0,IS,0.14,0.0,Phase3-EA-B1v1-GBPUSD-M30-14,GBPUSDMT4,142,7h 29m,Buy
20018.74,1.6161,17.06.2008 12:00:00,,0.0,-179.79000000000815,0.0,0.0,1.61592,17.06.2008 03:15:00,1868,-0.16315099666030752,5.87,IS,0.34,0.0,Phase3-EA-S4v1-EURCHF-M15-221,EURCHFMT4,560,8h 45m,Buy
19989.1,1041,18.06.2008 03:30:00,,-0.67,-209.43000000000757,0.0,0.0,1.04152,17.06.2008 23:15:00,1869,-0.19004790717263415,-29.64,IS,0.58,0.0,Phase3-EA-SA2v2-USDCHF-M15-107,USDCHFMT4,472,4h 15m,Buy
19937.86,107.97,18.06.2008 03:45:00,,-0.73,-260.6700000000128,0.0,0.0,108172,17.06.2008 17:00:00,1870,-0.23654580510285625,-51.24,IS,0.27,0.0,Phase3-EA-S1v2-USDJPY-M15-0,USDJPYMT4,722,10h 45m,Buy
19877.07,1.6155,18.06.2008 04:30:00,,-0.94,-321.4600000000064,0.0,0.0,1.61702,17.06.2008 20:10:00,1871,-0.29170988034051465,-60.79,IS,0.41,0.0,Phase3-EA-SA2v2-EURCHF-M5-43,EURCHFMT4,1046,8h 20m,Buy
19919.19,107682,19.06.2008 03:15:00,,0.0,-279.34000000001106,0.0,0.0,107.85,19.06.2008 01:30:00,1872,-0.2534879548756329,42.12,IS,0.27,0.0,Phase3-EA-S1v2-USDJPY-M15-0,USDJPYMT4,724,1h 45m,Sell
19772.72,1.6076,19.06.2008 04:35:00,,-2.85,-425.8100000000122,0.0,0.0,1.61122,18.06.2008 20:15:00,1873,-0.3864026135375961,-146.47,IS,0.41,0.0,Phase3-EA-SA2v2-EURCHF-M5-43,EURCHFMT4,1048,8h 20m,Buy
19738.09,210.89,19.06.2008 08:55:00,,0.0,-460.4400000000169,0.0,0.0,211052,19.06.2008 03:30:00,1874,-0.41782771512470857,-34.63,IS,0.23,0.0,Phase3-EA-S4v1-GBPJPY-M5-194,GBPJPYMT4,550,5h 25m,Buy
19869.74,1.61272,19.06.2008 10:44:58,tp 1.61272,0.0,-328.7900000000227,0.0,0.0,1.60872,19.06.2008 03:45:00,1875,-0.29836151171891534,131.65,IS,0.34,0.0,Phase3-EA-S4v1-EURCHF-M15-221,EURCHFMT4,562,6h 59m,Buy
19876.74,107.96,19.06.2008 23:45:00,,0.0,-321.7900000000227,0.0,0.0,107932,19.06.2008 20:30:00,1876,-0.29200933987052496,7.0,IS,0.27,0.0,Phase3-EA-S1v2-USDJPY-M15-0,USDJPYMT4,726,3h 15m,Buy
19959.83,212.65,20.06.2008 04:19:58,tp 212.650,0.0,-238.7000000000262,0.0,0.0,213.04,20.06.2008 02:45:00,1877,-0.2166090600301347,83.09,IS,0.23,0.0,Phase3-EA-S4v1-GBPJPY-M5-194,GBPJPYMT4,552,1h 34m,Sell
19891.97,1.0427,20.06.2008 06:30:00,,0.0,-306.5600000000268,0.0,0.0,1.04392,20.06.2008 02:15:00,1878,-0.27818882883467366,-67.86,IS,0.58,0.0,Phase3-EA-SA2v2-USDCHF-M15-107,USDCHFMT4,474,4h 15m,Buy
19824.35,1.6189,20.06.2008 08:30:00,,0.0,-374.1800000000221,0.0,0.0,1.62062,20.06.2008 00:10:00,1879,-0.33955080889012024,-67.62,IS,0.41,0.0,Phase3-EA-SA2v2-EURCHF-M5-43,EURCHFMT4,1050,8h 20m,Buy
19807.34,1.6185,20.06.2008 11:15:00,,0.0,-391.1900000000169,0.0,0.0,1.61902,20.06.2008 02:30:00,1880,-0.354986586481704,-17.01,IS,0.34,0.0,Phase3-EA-S4v1-EURCHF-M15-221,EURCHFMT4,564,8h 45m,Buy
20069.81,1.97622,20.06.2008 13:29:58,tp 1.97622,-2.13,-128.72000000001572,0.0,0.0,1.95732,18.06.2008 17:30:00,1881,-0.1168073657607008,262.47,IS,0.14,0.0,Phase3-EA-B1v1-GBPUSD-M30-14,GBPUSDMT4,144,1d 19h 59m,Buy
20112.1,107262,20.06.2008 20:45:00,,0.0,-86.43000000002212,0.0,0.0,107.43,20.06.2008 19:15:00,1882,-0.07843117326521691,42.29,IS,0.27,0.0,Phase3-EA-S1v2-USDJPY-M15-0,USDJPYMT4,728,1h 30m,Sell
20155.69,1.6163,20.06.2008 21:14:58,tp 1.61630,0.0,-42.84000000002561,0.0,0.0,1.6174,20.06.2008 20:15:00,1883,-0.03887529171217218,43.59,IS,0.41,0.0,Phase3-EA-SA2v2-EURCHF-M5-43,EURCHFMT4,1052,59m 58s,Sell
20198.27,1.61742,23.06.2008 01:59:57,tp 1.61742,-0.95,-0.26000000002386514,0.0,0.0,1.61632,20.06.2008 22:05:00,1884,-2.3593781153329806E-4,42.58,IS,0.41,0.0,Phase3-EA-SA2v2-EURCHF-M5-43,EURCHFMT4,1054,2d 3h 54m,Buy
20254.31,1035,23.06.2008 03:14:57,tp 1.03500,0.0,-0.0,0.0,0.0,1036,23.06.2008 02:15:00,1885,-0.0,56.04,IS,0.58,0.0,Phase3-EA-SA2v2-USDCHF-M15-107,USDCHFMT4,476,59m 57s,Sell
20272.83,107192,23.06.2008 04:30:00,,-1.13,-0.0,0.0,0.0,107.27,20.06.2008 23:00:00,1886,-0.0,18.52,IS,0.27,0.0,Phase3-EA-S1v2-USDJPY-M15-0,USDJPYMT4,730,2d 5h 30m,Sell
20203.73,1.61932,23.06.2008 11:15:00,,0.0,-69.10000000000582,0.0,0.0,1.6172,23.06.2008 02:30:00,1887,-0.0626627610808626,-69.1,IS,0.34,0.0,Phase3-EA-S4v1-EURCHF-M15-221,EURCHFMT4,566,8h 45m,Sell
20194.99,107.87,24.06.2008 03:00:00,,-0.73,-77.84000000001106,0.0,0.0,107902,23.06.2008 20:45:00,1888,-0.07058855748964728,-8.74,IS,0.27,0.0,Phase3-EA-S1v2-USDJPY-M15-0,USDJPYMT4,732,6h 15m,Buy
20174.59,1622,24.06.2008 08:25:00,,0.0,-98.24000000000524,0.0,0.0,1.62252,24.06.2008 00:05:00,1889,-0.08908812805475762,-20.4,IS,0.41,0.0,Phase3-EA-SA2v2-EURCHF-M5-43,EURCHFMT4,1056,8h 20m,Buy
20157.61,1.6213,24.06.2008 11:00:00,,0.0,-115.22000000000116,0.0,0.0,1.62182,24.06.2008 02:15:00,1890,-0.10448630002512957,-16.98,IS,0.34,0.0,Phase3-EA-S4v1-EURCHF-M15-221,EURCHFMT4,568,8h 45m,Buy
20200.97,1.6199,24.06.2008 21:49:58,tp 1.61990,0.0,-71.86000000000058,0.0,0.0,1621,24.06.2008 20:20:00,1891,-0.06516564415731467,43.36,IS,0.41,0.0,Phase3-EA-SA2v2-EURCHF-M5-43,EURCHFMT4,1058,1h 29m,Sell
20213.62,1.04082,25.06.2008 03:15:00,,-2.95,-59.2100000000064,0.0,0.0,1.0411,24.06.2008 23:00:00,1892,-0.05369409672355953,12.65,IS,0.58,0.0,Phase3-EA-SA2v2-USDCHF-M15-107,USDCHFMT4,478,4h 15m,Sell
20256.97,1.6204,25.06.2008 04:39:57,tp 1.62040,0.0,-15.860000000000582,0.0,0.0,1.6215,25.06.2008 00:10:00,1893,-0.014382509272683554,43.35,IS,0.41,0.0,Phase3-EA-SA2v2-EURCHF-M5-43,EURCHFMT4,1060,4h 29m,Sell
20243.95,107.8,25.06.2008 06:15:00,,0.0,-28.880000000004657,0.0,0.0,107852,25.06.2008 00:30:00,1894,-0.026189588133363983,-13.02,IS,0.27,0.0,Phase3-EA-S1v2-USDJPY-M15-0,USDJPYMT4,734,5h 45m,Buy
20269.13,212.43,25.06.2008 06:55:00,,0.0,-3.7000000000116415,0.0,0.0,212312,25.06.2008 01:30:00,1895,-0.003355314269173684,25.18,IS,0.23,0.0,Phase3-EA-S4v1-GBPJPY-M5-194,GBPJPYMT4,554,5h 25m,Buy
20325.06,1.03692,25.06.2008 22:14:57,tp 1.03692,0.0,-0.0,0.0,0.0,1.03592,25.06.2008 22:00:00,1896,-0.0,55.93,IS,0.58,0.0,Phase3-EA-SA2v2-USDCHF-M15-107,USDCHFMT4,480,14m 57s,Buy
20368.63,1.62232,26.06.2008 02:44:58,tp 1.62232,0.0,-0.0,0.0,0.0,1.62122,26.06.2008 00:50:00,1897,-0.0,43.57,IS,0.41,0.0,Phase3-EA-SA2v2-EURCHF-M5-43,EURCHFMT4,1062,1h 54m,Buy
20424.61,1.03612,26.06.2008 04:59:58,tp 1.03612,0.0,-0.0,0.0,0.0,1.03512,26.06.2008 00:45:00,1898,-0.0,55.98,IS,0.58,0.0,Phase3-EA-SA2v2-USDCHF-M15-107,USDCHFMT4,482,4h 14m,Buy
20525.58,1.6245,26.06.2008 09:45:00,,0.0,-0.0,0.0,0.0,1.62142,26.06.2008 01:00:00,1899,-0.0,100.97,IS,0.34,0.0,Phase3-EA-S4v1-EURCHF-M15-221,EURCHFMT4,570,8h 45m,Buy
20582.25,1.0234,27.06.2008 02:29:57,tp 1.02340,0.0,-0.0,0.0,0.0,1.0244,27.06.2008 01:15:00,1900,-0.0,56.67,IS,0.58,0.0,Phase3-EA-SA2v2-USDCHF-M15-107,USDCHFMT4,484,1h 14m,Sell
20666.35,212.14,27.06.2008 03:09:58,tp 212.140,0.0,-0.0,0.0,0.0,212.53,27.06.2008 01:10:00,1901,-0.0,84.1,IS,0.23,0.0,Phase3-EA-S4v1-GBPJPY-M5-194,GBPJPYMT4,556,1h 59m,Sell
20568.54,1.6122,27.06.2008 05:10:00,,-0.96,-97.80999999999767,0.0,0.0,1.61462,26.06.2008 20:50:00,1902,-0.08838278302302156,-97.81,IS,0.41,0.0,Phase3-EA-SA2v2-EURCHF-M5-43,EURCHFMT4,1064,8h 20m,Buy
20580.67,106822,27.06.2008 09:30:00,,0.0,-85.67999999999302,0.0,0.0,106.87,27.06.2008 01:00:00,1903,-0.07742190828557459,12.13,IS,0.27,0.0,Phase3-EA-S1v2-USDJPY-M15-0,USDJPYMT4,736,8h 30m,Sell
20450.91,1.60772,27.06.2008 10:59:57,sl 1.60772,0.0,-215.43999999998778,0.0,0.0,1.61162,27.06.2008 03:30:00,1904,-0.1946752558478595,-129.76,IS,0.34,0.0,Phase3-EA-S4v1-EURCHF-M15-221,EURCHFMT4,572,7h 29m,Buy
20470.72,106.3,27.06.2008 17:15:00,,0.0,-195.6299999999901,0.0,0.0,106222,27.06.2008 17:00:00,1905,-0.1767746022164732,19.81,IS,0.27,0.0,Phase3-EA-S1v2-USDJPY-M15-0,USDJPYMT4,738,15m 0s,Buy
20508.36,106152,27.06.2008 18:00:00,,0.0,-157.9899999999907,0.0,0.0,106.3,27.06.2008 17:15:00,1906,-0.14276245669979232,37.64,IS,0.27,0.0,Phase3-EA-S1v2-USDJPY-M15-0,USDJPYMT4,740,45m 0s,Sell
20482.44,106252,27.06.2008 18:15:00,,0.0,-183.90999999998894,0.0,0.0,106.15,27.06.2008 18:00:00,1907,-0.16618421046685722,-25.92,IS,0.27,0.0,Phase3-EA-S1v2-USDJPY-M15-0,USDJPYMT4,742,15m 0s,Sell
20526.77,1.60642,27.06.2008 21:04:57,tp 1.60642,0.0,-139.5799999999872,0.0,0.0,1.60532,27.06.2008 20:35:00,1908,-0.12612686692927627,44.33,IS,0.41,0.0,Phase3-EA-SA2v2-EURCHF-M5-43,EURCHFMT4,1066,29m 57s,Buy
20611.25,211.57,30.06.2008 06:04:57,tp 211.570,0.0,-55.09999999999127,0.0,0.0,211.96,30.06.2008 01:35:00,1909,-0.04978929909587805,84.48,IS,0.23,0.0,Phase3-EA-S4v1-GBPJPY-M5-194,GBPJPYMT4,558,4h 29m,Sell
20653.54,1.6072,30.06.2008 07:34:57,tp 1.60720,-2.01,-12.809999999997672,0.0,0.0,1.6083,27.06.2008 23:50:00,1910,-0.011575334327008765,42.29,IS,0.41,0.0,Phase3-EA-SA2v2-EURCHF-M5-43,EURCHFMT4,1068,2d 7h 44m,Sell
20787.52,1.6046,30.06.2008 11:29:57,tp 1.60460,0.0,-0.0,0.0,0.0,1.6086,30.06.2008 04:00:00,1911,-0.0,133.98,IS,0.34,0.0,Phase3-EA-S4v1-EURCHF-M15-221,EURCHFMT4,574,7h 29m,Sell
20831.79,1.60462,30.06.2008 21:04:58,tp 1.60462,0.0,-0.0,0.0,0.0,1.60352,30.06.2008 20:50:00,1912,-0.0,44.27,IS,0.41,0.0,Phase3-EA-SA2v2-EURCHF-M5-43,EURCHFMT4,1070,14m 58s,Buy
20858.52,106.17,01.07.2008 02:45:00,,-0.74,-0.0,0.0,0.0,106062,30.06.2008 21:30:00,1913,-0.0,26.73,IS,0.27,0.0,Phase3-EA-S1v2-USDJPY-M15-0,USDJPYMT4,744,5h 15m,Buy
20915.29,1.02162,01.07.2008 04:29:57,tp 1.02162,0.0,-0.0,0.0,0.0,1.02062,01.07.2008 01:30:00,1914,-0.0,56.77,IS,0.58,0.0,Phase3-EA-SA2v2-USDCHF-M15-107,USDCHFMT4,486,2h 59m,Buy
20904.44,1.60762,01.07.2008 06:40:00,,-2.01,-10.85000000000582,0.0,0.0,1.6074,30.06.2008 22:20:00,1915,-0.00978224012217415,-10.85,IS,0.41,0.0,Phase3-EA-SA2v2-EURCHF-M5-43,EURCHFMT4,1072,8h 20m,Sell
20773.92,1.60382,01.07.2008 13:59:58,sl 1.60382,0.0,-141.3700000000099,0.0,0.0,1.60772,01.07.2008 06:15:00,1916,-0.1274576300526373,-130.52,IS,0.34,0.0,Phase3-EA-S4v1-EURCHF-M15-221,EURCHFMT4,576,7h 44m,Buy
20827.81,1.0193,02.07.2008 00:44:57,tp 1.01930,-3.01,-87.48000000001048,0.0,0.0,1.0203,01.07.2008 23:15:00,1917,-0.07887100146428001,53.89,IS,0.58,0.0,Phase3-EA-SA2v2-USDCHF-M15-107,USDCHFMT4,488,1h 29m,Sell
20747.15,105942,02.07.2008 03:45:00,,-1.14,-168.14000000001397,0.0,0.0,105.63,01.07.2008 17:15:00,1918,-0.15159316628033326,-80.66,IS,0.27,0.0,Phase3-EA-S1v2-USDJPY-M15-0,USDJPYMT4,746,10h 30m,Sell
20831.8,211.24,02.07.2008 04:09:58,tp 211.240,0.0,-83.49000000001979,0.0,0.0,211.63,02.07.2008 02:45:00,1919,-0.07527366154839403,84.65,IS,0.23,0.0,Phase3-EA-S4v1-GBPJPY-M5-194,GBPJPYMT4,560,1h 24m,Sell
20756.56,1.61042,02.07.2008 05:40:00,,-2.01,-158.73000000002503,0.0,0.0,1.6086,01.07.2008 21:20:00,1920,-0.14310921424812117,-75.24,IS,0.41,0.0,Phase3-EA-SA2v2-EURCHF-M5-43,EURCHFMT4,1074,8h 20m,Sell
20745.89,1.61172,02.07.2008 12:00:00,,0.0,-169.40000000002328,0.0,0.0,1.6114,02.07.2008 03:15:00,1921,-0.15272916835904515,-10.67,IS,0.34,0.0,Phase3-EA-S4v1-EURCHF-M15-221,EURCHFMT4,578,8h 45m,Sell
20790.32,1.6113,02.07.2008 21:34:57,tp 1.61130,0.0,-124.97000000003027,0.0,0.0,1.6124,02.07.2008 21:20:00,1922,-0.11267157125048331,44.43,IS,0.41,0.0,Phase3-EA-SA2v2-EURCHF-M5-43,EURCHFMT4,1076,14m 57s,Sell
20840.8,105912,02.07.2008 23:15:00,,0.0,-74.49000000003434,0.0,0.0,106.11,02.07.2008 21:00:00,1923,-0.0671593609862394,50.48,IS,0.27,0.0,Phase3-EA-S1v2-USDJPY-M15-0,USDJPYMT4,748,2h 15m,Sell
20903.94,1.60912,03.07.2008 14:45:00,,0.0,-11.350000000034925,0.0,0.0,1611,03.07.2008 06:00:00,1924,-0.010233034597876377,63.14,IS,0.34,0.0,Phase3-EA-S4v1-EURCHF-M15-221,EURCHFMT4,580,8h 45m,Sell
20920.41,106.77,04.07.2008 00:45:00,,-0.73,-0.0,0.0,0.0,106702,03.07.2008 21:30:00,1925,-0.0,16.47,IS,0.27,0.0,Phase3-EA-S1v2-USDJPY-M15-0,USDJPYMT4,750,3h 15m,Buy
20964.52,1.02562,04.07.2008 05:00:00,,0.0,-0.0,0.0,0.0,1.0264,04.07.2008 00:45:00,1926,-0.0,44.11,IS,0.58,0.0,Phase3-EA-SA2v2-USDCHF-M15-107,USDCHFMT4,490,4h 15m,Sell
20974.75,1.6117,04.07.2008 05:50:00,,-0.96,-0.0,0.0,0.0,1.61142,03.07.2008 21:30:00,1927,-0.0,10.23,IS,0.41,0.0,Phase3-EA-SA2v2-EURCHF-M5-43,EURCHFMT4,1078,8h 20m,Buy
20970.77,1.6103,04.07.2008 12:15:00,,0.0,-3.9799999999959255,0.0,0.0,1.61042,04.07.2008 03:30:00,1928,-0.003586401411128139,-3.98,IS,0.34,0.0,Phase3-EA-S4v1-EURCHF-M15-221,EURCHFMT4,582,8h 45m,Buy
21012.77,1.6089,07.07.2008 01:00:00,tp 1.60890,-2.0,-0.0,0.0,0.0,1.61,04.07.2008 23:25:00,1929,-0.0,42.0,IS,0.41,0.0,Phase3-EA-SA2v2-EURCHF-M5-43,EURCHFMT4,1080,2d 1h 35m,Sell
21096.58,211772,07.07.2008 04:54:57,tp 211.772,0.0,-0.0,0.0,0.0,211382,07.07.2008 03:25:00,1930,-0.0,83.81,IS,0.23,0.0,Phase3-EA-S4v1-GBPJPY-M5-194,GBPJPYMT4,562,1h 29m,Buy
21228.44,1.61212,07.07.2008 08:14:58,tp 1.61212,0.0,-0.0,0.0,0.0,1.60812,07.07.2008 04:00:00,1931,-0.0,131.86,IS,0.34,0.0,Phase3-EA-S4v1-EURCHF-M15-221,EURCHFMT4,584,4h 14m,Buy
21104.31,1.61192,07.07.2008 09:20:00,,0.0,-124.13000000000466,0.0,0.0,1.6088,07.07.2008 01:00:00,1932,-0.1115991557554926,-124.13,IS,0.41,0.0,Phase3-EA-SA2v2-EURCHF-M5-43,EURCHFMT4,1082,8h 20m,Sell
21148.3,1.61312,07.07.2008 21:24:57,tp 1.61312,0.0,-80.13999999999942,0.0,0.0,1.61202,07.07.2008 20:00:00,1933,-0.07204991816841035,43.99,IS,0.41,0.0,Phase3-EA-SA2v2-EURCHF-M5-43,EURCHFMT4,1084,1h 24m,Buy
21192.24,1.6134,08.07.2008 01:59:57,tp 1.61340,0.0,-36.19999999999709,0.0,0.0,1.6145,08.07.2008 00:05:00,1934,-0.032545633113255104,43.94,IS,0.41,0.0,Phase3-EA-SA2v2-EURCHF-M5-43,EURCHFMT4,1086,1h 54m,Sell
21248.66,106962,08.07.2008 03:15:00,,-1.13,-0.0,0.0,0.0,107.19,07.07.2008 22:45:00,1935,-0.0,56.42,IS,0.27,0.0,Phase3-EA-S1v2-USDJPY-M15-0,USDJPYMT4,752,4h 30m,Sell
21265.75,107.45,08.07.2008 22:15:00,,0.0,-0.0,0.0,0.0,107382,08.07.2008 21:15:00,1936,-0.0,17.09,IS,0.27,0.0,Phase3-EA-S1v2-USDJPY-M15-0,USDJPYMT4,754,1h 0m,Buy
21318.91,1.0334,09.07.2008 00:29:58,tp 1.03340,-2.97,-0.0,0.0,0.0,1.0344,08.07.2008 23:00:00,1937,-0.0,53.16,IS,0.58,0.0,Phase3-EA-SA2v2-USDCHF-M15-107,USDCHFMT4,492,1h 29m,Sell
21338.5,107.5,09.07.2008 02:30:00,,0.0,-0.0,0.0,0.0,107422,09.07.2008 00:30:00,1938,-0.0,19.59,IS,0.27,0.0,Phase3-EA-S1v2-USDJPY-M15-0,USDJPYMT4,756,2h 0m,Buy
21280.21,1.61862,09.07.2008 04:35:00,,-1.98,-58.2899999999936,0.0,0.0,1.6172,08.07.2008 20:15:00,1939,-0.05235385782994524,-58.29,IS,0.41,0.0,Phase3-EA-SA2v2-EURCHF-M5-43,EURCHFMT4,1088,8h 20m,Sell
21296.05,1.61852,09.07.2008 09:45:00,,0.0,-42.44999999999709,0.0,0.0,1619,09.07.2008 01:00:00,1940,-0.03812697314944703,15.84,IS,0.34,0.0,Phase3-EA-S4v1-EURCHF-M15-221,EURCHFMT4,586,8h 45m,Sell
21298.53,1029,10.07.2008 02:15:00,,-2.03,-39.970000000001164,0.0,0.0,1.02892,09.07.2008 22:00:00,1941,-0.035899531608564114,2.48,IS,0.58,0.0,Phase3-EA-SA2v2-USDCHF-M15-107,USDCHFMT4,494,4h 15m,Buy
21203.18,1.6181,10.07.2008 06:10:00,,-2.87,-135.32000000000698,0.0,0.0,1.62042,09.07.2008 21:50:00,1942,-0.12153926988418827,-95.35,IS,0.41,0.0,Phase3-EA-SA2v2-EURCHF-M5-43,EURCHFMT4,1090,8h 20m,Buy
21199.02,106992,11.07.2008 03:00:00,,-1.13,-139.48000000001048,0.0,0.0,106.98,10.07.2008 21:30:00,1943,-0.1252756234366463,-4.16,IS,0.27,0.0,Phase3-EA-S1v2-USDJPY-M15-0,USDJPYMT4,758,5h 30m,Sell
21148.43,1.62312,11.07.2008 07:25:00,,-1.99,-190.07000000000698,0.0,0.0,1.6219,10.07.2008 23:05:00,1944,-0.17071363454690602,-50.59,IS,0.41,0.0,Phase3-EA-SA2v2-EURCHF-M5-43,EURCHFMT4,1092,8h 20m,Sell
21114.71,1.62362,11.07.2008 10:15:00,,0.0,-223.79000000000815,0.0,0.0,1.6226,11.07.2008 01:30:00,1945,-0.2009996542076713,-33.72,IS,0.34,0.0,Phase3-EA-S4v1-EURCHF-M15-221,EURCHFMT4,588,8h 45m,Sell
21159.06,1.61752,11.07.2008 21:49:59,tp 1.61752,0.0,-179.44000000000233,0.0,0.0,1.61642,11.07.2008 20:15:00,1946,-0.16116617342608558,44.35,IS,0.41,0.0,Phase3-EA-SA2v2-EURCHF-M5-43,EURCHFMT4,1094,1h 34m,Buy
21067.7,1.62052,14.07.2008 06:15:00,,-2.02,-270.8000000000029,0.0,0.0,1.6183,11.07.2008 21:55:00,1947,-0.24322224567423026,-91.36,IS,0.41,0.0,Phase3-EA-SA2v2-EURCHF-M5-43,EURCHFMT4,1096,2d 8h 20m,Sell
21035.6,106402,14.07.2008 07:30:00,,-1.14,-302.90000000000873,0.0,0.0,106.28,11.07.2008 20:30:00,1948,-0.2720532430381303,-32.1,IS,0.27,0.0,Phase3-EA-S1v2-USDJPY-M15-0,USDJPYMT4,760,2d 11h 0m,Sell
21001.65,1.62272,14.07.2008 10:30:00,,0.0,-336.8500000000058,0.0,0.0,1.6217,14.07.2008 01:45:00,1949,-0.30254583993857087,-33.95,IS,0.34,0.0,Phase3-EA-S4v1-EURCHF-M15-221,EURCHFMT4,590,8h 45m,Sell
21046.0,1.61772,14.07.2008 20:49:57,tp 1.61772,0.0,-292.5,0.0,0.0,1.61662,14.07.2008 20:15:00,1950,-0.26271235915698515,44.35,IS,0.41,0.0,Phase3-EA-SA2v2-EURCHF-M5-43,EURCHFMT4,1098,34m 57s,Buy
21090.32,1.6177,14.07.2008 21:44:57,tp 1.61770,0.0,-248.17999999999302,0.0,0.0,1.6188,14.07.2008 21:40:00,1951,-0.22290582323274785,44.32,IS,0.41,0.0,Phase3-EA-SA2v2-EURCHF-M5-43,EURCHFMT4,1100,4m 57s,Sell
21106.49,106092,15.07.2008 03:15:00,,-1.14,-232.00999999999476,0.0,0.0,106.16,14.07.2008 23:45:00,1952,-0.20838254512140428,16.17,IS,0.27,0.0,Phase3-EA-S1v2-USDJPY-M15-0,USDJPYMT4,762,3h 30m,Sell
21163.57,1.0161,15.07.2008 03:44:57,tp 1.01610,0.0,-174.92999999999302,0.0,0.0,1.0171,15.07.2008 02:00:00,1953,-0.15711546320454559,57.08,IS,0.58,0.0,Phase3-EA-SA2v2-USDCHF-M15-107,USDCHFMT4,496,1h 44m,Sell
21097.06,1.6151,15.07.2008 07:55:00,,-0.97,-241.43999999998778,0.0,0.0,1.61672,14.07.2008 23:35:00,1954,-0.2168522119482369,-66.51,IS,0.41,0.0,Phase3-EA-SA2v2-EURCHF-M5-43,EURCHFMT4,1102,8h 20m,Buy
20965.79,1.61142,15.07.2008 10:59:58,sl 1.61142,0.0,-372.70999999999185,0.0,0.0,1.61532,15.07.2008 05:15:00,1955,-0.3347539260902489,-131.27,IS,0.34,0.0,Phase3-EA-S4v1-EURCHF-M15-221,EURCHFMT4,592,5h 44m,Buy
20951.21,104612,16.07.2008 00:30:00,,-1.16,-387.2899999999936,0.0,0.0,104.56,15.07.2008 18:15:00,1956,-0.3478491267620756,-14.58,IS,0.27,0.0,Phase3-EA-S1v2-USDJPY-M15-0,USDJPYMT4,764,6h 15m,Sell
21008.69,1.00902,16.07.2008 01:14:57,tp 1.00902,0.0,-329.8099999999977,0.0,0.0,1.00802,16.07.2008 00:30:00,1957,-0.29622278008056296,57.48,IS,0.58,0.0,Phase3-EA-SA2v2-USDCHF-M15-107,USDCHFMT4,498,44m 57s,Buy
21053.34,1.60592,16.07.2008 01:39:58,tp 1.60592,0.0,-285.1600000000035,0.0,0.0,1.60482,16.07.2008 00:45:00,1958,-0.25611985072549337,44.65,IS,0.41,0.0,Phase3-EA-SA2v2-EURCHF-M5-43,EURCHFMT4,1104,54m 58s,Buy
21109.49,104.83,16.07.2008 04:30:00,,0.0,-229.0100000000093,0.0,0.0,104612,16.07.2008 00:30:00,1959,-0.20568805938647391,56.15,IS,0.27,0.0,Phase3-EA-S1v2-USDJPY-M15-0,USDJPYMT4,766,4h 0m,Buy
21096.86,1.01002,16.07.2008 06:30:00,,0.0,-241.64000000001397,0.0,0.0,1.0098,16.07.2008 02:15:00,1960,-0.21703184433058997,-12.63,IS,0.58,0.0,Phase3-EA-SA2v2-USDCHF-M15-107,USDCHFMT4,500,4h 15m,Sell
21232.05,1.6032,16.07.2008 10:59:57,tp 1.60320,0.0,-106.45000000001164,0.0,0.0,1.6072,16.07.2008 04:15:00,1961,-0.09560933549492011,135.19,IS,0.34,0.0,Phase3-EA-S4v1-EURCHF-M15-221,EURCHFMT4,594,6h 44m,Sell
21282.66,209832,17.07.2008 04:35:00,,-3.81,-55.84000000001106,0.0,0.0,210.08,16.07.2008 23:10:00,1962,-0.05015336114642379,50.61,IS,0.23,0.0,Phase3-EA-S4v1-GBPJPY-M5-194,GBPJPYMT4,564,5h 25m,Sell
21283.88,1.60892,17.07.2008 04:35:00,,-6.05,-54.620000000009895,0.0,0.0,1.6091,16.07.2008 20:15:00,1963,-0.04905760361421241,1.22,IS,0.41,0.0,Phase3-EA-SA2v2-EURCHF-M5-43,EURCHFMT4,1106,8h 20m,Sell
21417.78,1.61262,17.07.2008 12:14:58,tp 1.61262,0.0,-0.0,0.0,0.0,1.60862,17.07.2008 05:30:00,1964,-0.0,133.9,IS,0.34,0.0,Phase3-EA-S4v1-EURCHF-M15-221,EURCHFMT4,596,6h 44m,Buy
21463.19,105.84,17.07.2008 20:00:00,,0.0,-0.0,0.0,0.0,105662,17.07.2008 18:30:00,1965,-0.0,45.41,IS,0.27,0.0,Phase3-EA-S1v2-USDJPY-M15-0,USDJPYMT4,768,1h 30m,Buy
21619.38,213582,17.07.2008 21:29:58,tp 213.582,0.0,-0.0,0.0,0.0,211732,17.07.2008 16:00:00,1966,-0.0,156.19,IS,0.09,0.0,Phase3-EA-B1v1-GBPJPY-M30-1,GBPJPYMT4,254,5h 29m,Buy
21663.56,1617,17.07.2008 23:24:58,tp 1.61700,0.0,-0.0,0.0,0.0,1.6181,17.07.2008 20:10:00,1967,-0.0,44.18,IS,0.41,0.0,Phase3-EA-SA2v2-EURCHF-M5-43,EURCHFMT4,1108,3h 14m,Sell
21706.75,1.61802,18.07.2008 03:19:57,tp 1.61802,-0.97,-0.0,0.0,0.0,1.61692,17.07.2008 23:30:00,1968,-0.0,43.19,IS,0.41,0.0,Phase3-EA-SA2v2-EURCHF-M5-43,EURCHFMT4,1110,3h 49m,Buy
21648.8,1.02082,18.07.2008 07:00:00,,0.0,-57.94999999999709,0.0,0.0,1.0198,18.07.2008 02:45:00,1969,-0.05187690090347905,-57.95,IS,0.58,0.0,Phase3-EA-SA2v2-USDCHF-M15-107,USDCHFMT4,502,4h 15m,Sell
21706.65,106.42,18.07.2008 11:15:00,,0.0,-0.09999999999126885,0.0,0.0,106192,18.07.2008 00:15:00,1970,-8.952010508878724E-5,57.85,IS,0.27,0.0,Phase3-EA-S1v2-USDJPY-M15-0,USDJPYMT4,770,11h 0m,Buy
21786.97,106.9,18.07.2008 21:30:00,,0.0,-0.0,0.0,0.0,106582,18.07.2008 17:00:00,1971,-0.0,80.32,IS,0.27,0.0,Phase3-EA-S1v2-USDJPY-M15-0,USDJPYMT4,772,4h 30m,Buy
21760.07,1.62032,21.07.2008 07:45:00,,-2.0,-26.89999999999418,0.0,0.0,1.6197,18.07.2008 23:25:00,1972,-0.02406362745138738,-26.9,IS,0.41,0.0,Phase3-EA-SA2v2-EURCHF-M5-43,EURCHFMT4,1112,2d 8h 20m,Sell
21723.03,212.81,21.07.2008 09:15:00,,0.0,-63.939999999987776,0.0,0.0,212982,21.07.2008 03:50:00,1973,-0.05719807952571553,-37.04,IS,0.23,0.0,Phase3-EA-S4v1-GBPJPY-M5-194,GBPJPYMT4,566,5h 25m,Buy
21666.26,212602,21.07.2008 09:29:57,sl 212.602,-0.3,-120.70999999999185,0.0,0.0,213272,18.07.2008 18:30:00,1974,-0.10798217359321201,-56.77,IS,0.09,0.0,Phase3-EA-B1v1-GBPJPY-M30-1,GBPJPYMT4,256,2d 14h 59m,Buy
21582.49,1.62212,21.07.2008 10:00:00,,0.0,-204.47999999999593,0.0,0.0,1.6196,21.07.2008 01:15:00,1975,-0.18291935097623263,-83.77,IS,0.34,0.0,Phase3-EA-S4v1-EURCHF-M15-221,EURCHFMT4,598,8h 45m,Sell
21626.8,1.6206,21.07.2008 23:40:00,tp 1.62060,0.0,-160.16999999999825,0.0,0.0,1.6217,21.07.2008 20:20:00,1976,-0.14328145757953564,44.31,IS,0.41,0.0,Phase3-EA-SA2v2-EURCHF-M5-43,EURCHFMT4,1114,3h 20m,Sell
21596.81,1.6199,22.07.2008 08:05:00,,-0.97,-190.1600000000035,0.0,0.0,1.62062,21.07.2008 23:45:00,1977,-0.17010927123259845,-29.99,IS,0.41,0.0,Phase3-EA-SA2v2-EURCHF-M5-43,EURCHFMT4,1116,8h 20m,Buy
21483.98,106.47,22.07.2008 08:45:00,,-0.74,-302.99000000000524,0.0,0.0,106912,21.07.2008 17:45:00,1978,-0.27104232273225154,-112.83,IS,0.27,0.0,Phase3-EA-S1v2-USDJPY-M15-0,USDJPYMT4,774,15h 0m,Buy
21476.62,1.6197,22.07.2008 09:45:00,,0.0,-310.3500000000058,0.0,0.0,1.61992,22.07.2008 01:00:00,1979,-0.27762627433233567,-7.36,IS,0.34,0.0,Phase3-EA-S4v1-EURCHF-M15-221,EURCHFMT4,600,8h 45m,Buy
21498.03,107.31,23.07.2008 03:15:00,,-0.73,-288.9400000000023,0.0,0.0,107222,22.07.2008 23:15:00,1980,-0.2584737738217632,21.41,IS,0.27,0.0,Phase3-EA-S1v2-USDJPY-M15-0,USDJPYMT4,776,4h 0m,Buy
21554.0,1.03632,24.07.2008 23:29:57,tp 1.03632,0.0,-232.97000000000116,0.0,0.0,1.03532,24.07.2008 23:00:00,1981,-0.2084053266673219,55.97,IS,0.58,0.0,Phase3-EA-SA2v2-USDCHF-M15-107,USDCHFMT4,504,29m 57s,Buy
21597.5,1.62612,24.07.2008 23:29:58,tp 1.62612,0.0,-189.47000000000116,0.0,0.0,1.62502,24.07.2008 20:15:00,1982,-0.16949202577008854,43.5,IS,0.41,0.0,Phase3-EA-SA2v2-EURCHF-M5-43,EURCHFMT4,1118,3h 14m,Buy
21681.12,212.97,25.07.2008 03:09:57,tp 212.970,0.0,-105.85000000000582,0.0,0.0,213.36,25.07.2008 00:20:00,1983,-0.09468903218327306,83.62,IS,0.23,0.0,Phase3-EA-S4v1-GBPJPY-M5-194,GBPJPYMT4,568,2h 49m,Sell
21688.25,1.6251,25.07.2008 11:15:00,,0.0,-98.72000000000116,0.0,0.0,1.62492,25.07.2008 02:55:00,1984,-0.0883108290706879,7.13,IS,0.41,0.0,Phase3-EA-SA2v2-EURCHF-M5-43,EURCHFMT4,1120,8h 20m,Buy
21631.46,214.07,25.07.2008 13:29:58,sl 214.070,-0.49,-155.50999999999476,0.0,0.0,213.4,24.07.2008 18:00:00,1985,-0.1391128143110013,-56.79,IS,0.09,0.0,Phase3-EA-B1v1-GBPJPY-M30-1,GBPJPYMT4,258,19h 29m,Sell
21637.34,107872,28.07.2008 01:00:00,,-1.13,-149.6299999999901,0.0,0.0,107.9,25.07.2008 21:45:00,1986,-0.13385280950006076,5.88,IS,0.27,0.0,Phase3-EA-S1v2-USDJPY-M15-0,USDJPYMT4,778,2d 3h 15m,Sell
21647.45,1.6288,28.07.2008 04:55:00,,-0.95,-139.51999999998952,0.0,0.0,1.62852,25.07.2008 20:35:00,1987,-0.12480882163635842,10.11,IS,0.41,0.0,Phase3-EA-SA2v2-EURCHF-M5-43,EURCHFMT4,1122,2d 8h 20m,Buy
21703.39,1.0368,28.07.2008 05:44:57,tp 1.03680,0.0,-83.5799999999872,0.0,0.0,1.0378,28.07.2008 02:45:00,1988,-0.07476721124115555,55.94,IS,0.58,0.0,Phase3-EA-SA2v2-USDCHF-M15-107,USDCHFMT4,506,2h 59m,Sell
21786.56,214.26,28.07.2008 09:04:58,tp 214.260,0.0,-0.40999999998894054,0.0,0.0,214.65,28.07.2008 03:40:00,1989,-3.667690429295476E-4,83.17,IS,0.23,0.0,Phase3-EA-S4v1-GBPJPY-M5-194,GBPJPYMT4,570,5h 24m,Sell
21799.05,1.62832,28.07.2008 12:15:00,,0.0,-0.0,0.0,0.0,1.6287,28.07.2008 03:30:00,1990,-0.0,12.49,IS,0.34,0.0,Phase3-EA-S4v1-EURCHF-M15-221,EURCHFMT4,602,8h 45m,Sell
21842.69,1.6271,28.07.2008 21:59:58,tp 1.62710,0.0,-0.0,0.0,0.0,1.6282,28.07.2008 21:00:00,1991,-0.0,43.64,IS,0.41,0.0,Phase3-EA-SA2v2-EURCHF-M5-43,EURCHFMT4,1124,59m 58s,Sell
21849.73,107412,29.07.2008 02:45:00,,0.0,-0.0,0.0,0.0,107.44,29.07.2008 00:15:00,1992,-0.0,7.04,IS,0.27,0.0,Phase3-EA-S1v2-USDJPY-M15-0,USDJPYMT4,780,2h 30m,Sell
21792.44,1.0327,29.07.2008 06:00:00,,0.0,-57.2899999999936,0.0,0.0,1.03372,29.07.2008 01:45:00,1993,-0.05122050808704998,-57.29,IS,0.58,0.0,Phase3-EA-SA2v2-USDCHF-M15-107,USDCHFMT4,508,4h 15m,Buy
21836.03,1.62822,29.07.2008 09:14:57,tp 1.62822,0.0,-13.69999999999709,0.0,0.0,1.62712,29.07.2008 02:30:00,1994,-0.012248576728792357,43.59,IS,0.41,0.0,Phase3-EA-SA2v2-EURCHF-M5-43,EURCHFMT4,1126,6h 44m,Buy
21887.95,1.6279,29.07.2008 13:30:00,,0.0,-0.0,0.0,0.0,1.62632,29.07.2008 04:45:00,1995,-0.0,51.92,IS,0.34,0.0,Phase3-EA-S4v1-EURCHF-M15-221,EURCHFMT4,604,8h 45m,Buy
21931.07,1.63012,29.07.2008 23:49:59,tp 1.63012,0.0,-0.0,0.0,0.0,1.62902,29.07.2008 21:30:00,1996,-0.0,43.12,IS,0.41,0.0,Phase3-EA-SA2v2-EURCHF-M5-43,EURCHFMT4,1128,2h 19m,Buy
21929.41,214042,30.07.2008 04:25:00,,-1.23,-1.6600000000034925,0.0,0.0,214.04,29.07.2008 23:00:00,1997,-0.0014830555984173936,-1.66,IS,0.23,0.0,Phase3-EA-S4v1-GBPJPY-M5-194,GBPJPYMT4,572,5h 25m,Sell
21913.2,108.07,30.07.2008 09:00:00,,-0.72,-17.870000000009895,0.0,0.0,108132,29.07.2008 21:30:00,1998,-0.015965182857637195,-16.21,IS,0.27,0.0,Phase3-EA-S1v2-USDJPY-M15-0,USDJPYMT4,782,11h 30m,Buy
21956.35,1.63072,30.07.2008 11:04:58,tp 1.63072,0.0,-0.0,0.0,0.0,1.62962,30.07.2008 02:45:00,1999,-0.0,43.15,IS,0.41,0.0,Phase3-EA-SA2v2-EURCHF-M5-43,EURCHFMT4,1130,8h 19m,Buy
22011.71,1.0477,30.07.2008 23:29:57,tp 1.04770,0.0,-0.0,0.0,0.0,1.0487,30.07.2008 22:15:00,2000,-0.0,55.36,IS,0.58,0.0,Phase3-EA-SA2v2-USDCHF-M15-107,USDCHFMT4,510,1h 14m,Sell
22009.04,108.11,31.07.2008 02:15:00,,-2.17,-2.6699999999982538,0.0,0.0,108112,30.07.2008 19:45:00,2001,-0.0023836793492379087,-2.67,IS,0.27,0.0,Phase3-EA-S1v2-USDJPY-M15-0,USDJPYMT4,784,6h 30m,Buy
22138.76,1.63572,31.07.2008 14:14:58,tp 1.63572,0.0,-0.0,0.0,0.0,1.63172,31.07.2008 06:00:00,2002,-0.0,129.72,IS,0.34,0.0,Phase3-EA-S4v1-EURCHF-M15-221,EURCHFMT4,606,8h 14m,Buy
22158.28,107872,31.07.2008 22:45:00,,0.0,-0.0,0.0,0.0,107.95,31.07.2008 22:15:00,2003,-0.0,19.52,IS,0.27,0.0,Phase3-EA-S1v2-USDJPY-M15-0,USDJPYMT4,786,30m 0s,Sell
22109.63,1.6325,01.08.2008 07:15:00,,-0.94,-48.64999999999418,0.0,0.0,1.63372,31.07.2008 22:55:00,2004,-0.04337620013430499,-48.65,IS,0.41,0.0,Phase3-EA-SA2v2-EURCHF-M5-43,EURCHFMT4,1132,8h 20m,Buy
22053.59,213.25,01.08.2008 08:40:00,,0.0,-104.68999999998778,0.0,0.0,213512,01.08.2008 03:15:00,2005,-0.0933413030228243,-56.04,IS,0.23,0.0,Phase3-EA-S4v1-GBPJPY-M5-194,GBPJPYMT4,574,5h 25m,Buy
21927.14,1.62972,01.08.2008 10:29:58,sl 1.62972,0.0,-231.13999999998487,0.0,0.0,1.63362,01.08.2008 02:15:00,2006,-0.20608375948702565,-126.45,IS,0.34,0.0,Phase3-EA-S4v1-EURCHF-M15-221,EURCHFMT4,608,8h 14m,Buy
21843.05,107.54,01.08.2008 15:45:00,,-0.73,-315.2299999999814,0.0,0.0,107872,31.07.2008 22:45:00,2007,-0.28105816173356196,-84.09,IS,0.27,0.0,Phase3-EA-S1v2-USDJPY-M15-0,USDJPYMT4,788,17h 0m,Buy
21886.06,1.63302,04.08.2008 03:04:57,tp 1.63302,0.0,-272.2199999999866,0.0,0.0,1.63192,04.08.2008 02:15:00,2008,-0.24271056938461122,43.01,IS,0.41,0.0,Phase3-EA-SA2v2-EURCHF-M5-43,EURCHFMT4,1134,49m 57s,Buy
21801.85,1.0469,04.08.2008 05:45:00,,0.0,-356.429999999993,0.0,0.0,1.04842,04.08.2008 01:30:00,2009,-0.3177919632861639,-84.21,IS,0.58,0.0,Phase3-EA-SA2v2-USDCHF-M15-107,USDCHFMT4,512,4h 15m,Buy
21885.23,212622,04.08.2008 06:19:58,tp 212.622,0.0,-273.04999999998836,0.0,0.0,212232,04.08.2008 02:15:00,2010,-0.24345059499841498,83.38,IS,0.23,0.0,Phase3-EA-S4v1-GBPJPY-M5-194,GBPJPYMT4,576,4h 4m,Buy
21942.98,1.6335,04.08.2008 14:30:00,,0.0,-215.29999999998836,0.0,0.0,1.63172,04.08.2008 05:45:00,2011,-0.1919608610260324,57.75,IS,0.34,0.0,Phase3-EA-S4v1-EURCHF-M15-221,EURCHFMT4,610,8h 45m,Buy
21982.43,108.15,04.08.2008 18:45:00,,0.0,-175.84999999999127,0.0,0.0,107992,04.08.2008 17:15:00,2012,-0.15678735444230352,39.45,IS,0.27,0.0,Phase3-EA-S1v2-USDJPY-M15-0,USDJPYMT4,790,1h 30m,Buy
22037.78,1.04792,04.08.2008 23:44:57,tp 1.04792,0.0,-120.49999999998545,0.0,0.0,1.04692,04.08.2008 22:45:00,2013,-0.1074374535700667,55.35,IS,0.58,0.0,Phase3-EA-SA2v2-USDCHF-M15-107,USDCHFMT4,514,59m 57s,Buy
22052.24,108.27,05.08.2008 04:45:00,,0.0,-106.03999999997905,0.0,0.0,108212,05.08.2008 01:00:00,2014,-0.09454495914165144,14.46,IS,0.27,0.0,Phase3-EA-S1v2-USDJPY-M15-0,USDJPYMT4,792,3h 45m,Buy
22031.0,1.6317,05.08.2008 07:00:00,,-0.94,-127.27999999998428,0.0,0.0,1.63222,04.08.2008 22:40:00,2015,-0.11348248207799214,-21.24,IS,0.41,0.0,Phase3-EA-SA2v2-EURCHF-M5-43,EURCHFMT4,1136,8h 20m,Buy
21998.67,211.88,05.08.2008 08:50:00,,0.0,-159.60999999998603,0.0,0.0,212032,05.08.2008 03:25:00,2016,-0.14230781713127733,-32.33,IS,0.23,0.0,Phase3-EA-S4v1-GBPJPY-M5-194,GBPJPYMT4,578,5h 25m,Buy
22151.76,211.35,05.08.2008 09:59:58,tp 211.350,-0.96,-6.519999999989523,0.0,0.0,213.2,01.08.2008 09:30:00,2017,-0.005813213255400779,153.09,IS,0.09,0.0,Phase3-EA-B1v1-GBPJPY-M30-1,GBPJPYMT4,260,4d 0h 29m,Sell
22118.8,1.6307,05.08.2008 13:00:00,,0.0,-39.479999999995925,0.0,0.0,1.63172,05.08.2008 04:15:00,2018,-0.03520025449747973,-32.96,IS,0.34,0.0,Phase3-EA-S4v1-EURCHF-M15-221,EURCHFMT4,612,8h 45m,Buy
22138.25,108.28,05.08.2008 23:45:00,,0.0,-20.029999999998836,0.0,0.0,108202,05.08.2008 21:30:00,2019,-0.01785869041500889,19.45,IS,0.27,0.0,Phase3-EA-S1v2-USDJPY-M15-0,USDJPYMT4,794,2h 15m,Buy
22193.32,1.0533,06.08.2008 03:29:57,tp 1.05330,0.0,-0.0,0.0,0.0,1.0543,06.08.2008 01:15:00,2020,-0.0,55.07,IS,0.58,0.0,Phase3-EA-SA2v2-USDCHF-M15-107,USDCHFMT4,516,2h 14m,Sell
22191.61,1.6304,06.08.2008 04:30:00,,-0.93,-1.7100000000064028,0.0,0.0,1.63042,05.08.2008 20:10:00,2021,-0.0015241549140415866,-1.71,IS,0.41,0.0,Phase3-EA-SA2v2-EURCHF-M5-43,EURCHFMT4,1138,8h 20m,Buy
22225.18,211902,06.08.2008 08:40:00,,0.0,-0.0,0.0,0.0,212.06,06.08.2008 03:15:00,2022,-0.0,33.57,IS,0.23,0.0,Phase3-EA-S4v1-GBPJPY-M5-194,GBPJPYMT4,580,5h 25m,Sell
22289.14,1.62842,06.08.2008 13:15:00,,0.0,-0.0,0.0,0.0,1.6304,06.08.2008 04:30:00,2023,-0.0,63.96,IS,0.34,0.0,Phase3-EA-S4v1-EURCHF-M15-221,EURCHFMT4,614,8h 45m,Sell
22331.69,1.6335,06.08.2008 22:39:58,tp 1.63350,0.0,-0.0,0.0,0.0,1.6346,06.08.2008 21:55:00,2024,-0.0,42.55,IS,0.41,0.0,Phase3-EA-SA2v2-EURCHF-M5-43,EURCHFMT4,1140,44m 58s,Sell
22312.35,213.21,07.08.2008 06:35:00,,0.0,-19.339999999996508,0.0,0.0,213302,07.08.2008 01:10:00,2025,-0.017216869077636508,-19.34,IS,0.23,0.0,Phase3-EA-S4v1-GBPJPY-M5-194,GBPJPYMT4,582,5h 25m,Buy
22297.07,109.52,07.08.2008 07:45:00,,0.0,-34.61999999999534,0.0,0.0,109582,07.08.2008 01:00:00,2026,-0.030819441958004307,-15.28,IS,0.27,0.0,Phase3-EA-S1v2-USDJPY-M15-0,USDJPYMT4,796,6h 45m,Buy
22280.75,1.6325,07.08.2008 10:20:00,,0.0,-50.94000000000233,0.0,0.0,1.63292,07.08.2008 02:00:00,2027,-0.04534784440615316,-16.32,IS,0.41,0.0,Phase3-EA-SA2v2-EURCHF-M5-43,EURCHFMT4,1142,8h 20m,Buy
22296.21,1.6325,07.08.2008 14:15:00,,0.0,-35.479999999995925,0.0,0.0,1.63202,07.08.2008 05:30:00,2028,-0.031585031792894694,15.46,IS,0.34,0.0,Phase3-EA-S4v1-EURCHF-M15-221,EURCHFMT4,616,8h 45m,Buy
22240.07,212912,07.08.2008 15:59:58,sl 212.912,-0.89,-91.61999999999534,0.0,0.0,213582,06.08.2008 22:30:00,2029,-0.08156202403791424,-56.14,IS,0.09,0.0,Phase3-EA-B1v1-GBPJPY-M30-1,GBPJPYMT4,262,17h 29m,Buy
22265.98,109.51,08.08.2008 03:15:00,,-0.72,-65.70999999999185,0.0,0.0,109402,07.08.2008 22:30:00,2030,-0.058496404710008214,25.91,IS,0.27,0.0,Phase3-EA-S1v2-USDJPY-M15-0,USDJPYMT4,798,4h 45m,Buy
22347.77,212462,08.08.2008 04:34:58,tp 212.462,0.0,-0.0,0.0,0.0,212072,08.08.2008 03:35:00,2031,-0.0,81.79,IS,0.23,0.0,Phase3-EA-S4v1-GBPJPY-M5-194,GBPJPYMT4,584,59m 58s,Buy
22242.35,1.6257,08.08.2008 04:40:00,,-0.93,-105.41999999999825,0.0,0.0,1.62842,07.08.2008 20:20:00,2032,-0.0938336381754602,-105.42,IS,0.41,0.0,Phase3-EA-SA2v2-EURCHF-M5-43,EURCHFMT4,1144,8h 20m,Buy
22283.07,1.6275,08.08.2008 09:45:00,,0.0,-64.69999999999709,0.0,0.0,1.62622,08.08.2008 01:00:00,2033,-0.05758903803786855,40.72,IS,0.34,0.0,Phase3-EA-S4v1-EURCHF-M15-221,EURCHFMT4,618,8h 45m,Buy
22336.73,1.0808,08.08.2008 22:59:59,tp 1.08080,0.0,-11.039999999993597,0.0,0.0,1.0818,08.08.2008 22:30:00,2034,-0.009826630292700598,53.66,IS,0.58,0.0,Phase3-EA-SA2v2-USDCHF-M15-107,USDCHFMT4,518,29m 59s,Sell
22360.02,110.27,11.08.2008 01:15:00,,-0.71,-0.0,0.0,0.0,110172,08.08.2008 23:30:00,2035,-0.0,23.29,IS,0.27,0.0,Phase3-EA-S1v2-USDJPY-M15-0,USDJPYMT4,800,2d 1h 45m,Buy
22192.46,210052,11.08.2008 02:49:58,sl 210.052,0.0,-167.55999999999767,0.0,0.0,210852,11.08.2008 01:45:00,2036,-0.14912777694414578,-167.56,IS,0.23,0.0,Phase3-EA-S4v1-GBPJPY-M5-194,GBPJPYMT4,586,1h 4m,Buy
22005.93,1.61872,11.08.2008 02:49:59,sl 1.61872,-0.91,-354.0899999999965,0.0,0.0,1.62362,08.08.2008 20:15:00,2037,-0.3151387833501599,-186.53,IS,0.41,0.0,Phase3-EA-SA2v2-EURCHF-M5-43,EURCHFMT4,1146,2d 6h 34m,Buy
22087.7,210282,11.08.2008 03:14:57,tp 210.282,0.0,-272.31999999999243,0.0,0.0,209892,11.08.2008 03:00:00,2038,-0.24236378740408937,81.77,IS,0.23,0.0,Phase3-EA-S4v1-GBPJPY-M5-194,GBPJPYMT4,588,14m 57s,Buy
22172.21,1.6213,11.08.2008 13:00:00,,0.0,-187.80999999999767,0.0,0.0,1.61862,11.08.2008 04:15:00,2039,-0.16715020164645536,84.51,IS,0.34,0.0,Phase3-EA-S4v1-EURCHF-M15-221,EURCHFMT4,620,8h 45m,Buy
22213.74,1.62,11.08.2008 22:09:58,tp 1.62000,0.0,-146.27999999999884,0.0,0.0,1.6211,11.08.2008 21:30:00,2040,-0.13018865607179383,41.53,IS,0.41,0.0,Phase3-EA-SA2v2-EURCHF-M5-43,EURCHFMT4,1148,39m 58s,Sell
22254.33,1.61992,12.08.2008 02:09:58,tp 1.61992,-0.91,-105.69000000000233,0.0,0.0,1.61882,11.08.2008 23:50:00,2041,-0.09406370700183417,40.59,IS,0.41,0.0,Phase3-EA-SA2v2-EURCHF-M5-43,EURCHFMT4,1150,2h 19m,Buy
22203.68,110062,12.08.2008 03:15:00,,-1.1,-156.3399999999965,0.0,0.0,109.86,11.08.2008 17:00:00,2042,-0.13914201866464285,-50.65,IS,0.27,0.0,Phase3-EA-S1v2-USDJPY-M15-0,USDJPYMT4,802,10h 15m,Sell
22196.81,1.6185,12.08.2008 09:45:00,,0.0,-163.20999999999185,0.0,0.0,1.61872,12.08.2008 01:00:00,2043,-0.14525629311920002,-6.87,IS,0.34,0.0,Phase3-EA-S4v1-EURCHF-M15-221,EURCHFMT4,622,8h 45m,Buy
22238.28,1.6217,12.08.2008 22:14:58,tp 1.62170,0.0,-121.73999999999069,0.0,0.0,1.6228,12.08.2008 20:25:00,2044,-0.10834814732143215,41.47,IS,0.41,0.0,Phase3-EA-SA2v2-EURCHF-M5-43,EURCHFMT4,1152,1h 49m,Sell
22390.24,206.9,13.08.2008 01:59:57,tp 206.900,-0.48,-0.0,0.0,0.0,208.75,12.08.2008 17:30:00,2045,-0.0,151.96,IS,0.09,0.0,Phase3-EA-B1v1-GBPJPY-M30-1,GBPJPYMT4,264,8h 29m,Sell
22443.59,1.08722,13.08.2008 02:29:58,tp 1.08722,0.0,-0.0,0.0,0.0,1.08622,13.08.2008 01:30:00,2046,-0.0,53.35,IS,0.58,0.0,Phase3-EA-SA2v2-USDCHF-M15-107,USDCHFMT4,520,59m 58s,Buy
22332.25,1.6191,13.08.2008 07:10:00,,-0.91,-111.33999999999651,0.0,0.0,1.62202,12.08.2008 22:50:00,2047,-0.09901853898474466,-111.34,IS,0.41,0.0,Phase3-EA-SA2v2-EURCHF-M5-43,EURCHFMT4,1154,8h 20m,Buy
22347.31,1.6209,13.08.2008 10:15:00,,0.0,-96.27999999999884,0.0,0.0,1.62042,13.08.2008 01:30:00,2048,-0.08562515657851086,15.06,IS,0.34,0.0,Phase3-EA-S4v1-EURCHF-M15-221,EURCHFMT4,624,8h 45m,Buy
22291.93,207.12,13.08.2008 12:29:58,sl 207.120,0.0,-151.6600000000035,0.0,0.0,206.45,13.08.2008 04:00:00,2049,-0.13487651897276084,-55.38,IS,0.09,0.0,Phase3-EA-B1v1-GBPJPY-M30-1,GBPJPYMT4,266,8h 29m,Sell
22444.91,203.27,13.08.2008 16:59:58,tp 203.270,0.0,-0.0,0.0,0.0,205.12,13.08.2008 13:00:00,2050,-0.0,152.98,IS,0.09,0.0,Phase3-EA-B1v1-GBPJPY-M30-1,GBPJPYMT4,268,3h 59m,Sell
22240.48,109.62,13.08.2008 20:44:57,sl 109.620,0.0,-204.42999999999302,0.0,0.0,108.79,13.08.2008 19:15:00,2051,-0.1818045832399109,-204.43,IS,0.27,0.0,Phase3-EA-S1v2-USDJPY-M15-0,USDJPYMT4,804,1h 29m,Sell
22281.99,1.6211,13.08.2008 20:49:58,tp 1.62110,0.0,-162.91999999999825,0.0,0.0,1.6222,13.08.2008 20:40:00,2052,-0.14488872817809018,41.51,IS,0.41,0.0,Phase3-EA-SA2v2-EURCHF-M5-43,EURCHFMT4,1156,9m 58s,Sell
22326.97,1.0846,14.08.2008 00:15:00,tp 1.08460,-8.5,-117.94000000000233,0.0,0.0,1.0856,13.08.2008 23:45:00,2053,-0.1048869175136538,44.98,IS,0.58,0.0,Phase3-EA-SA2v2-USDCHF-M15-107,USDCHFMT4,522,30m 0s,Sell
22409.06,204182,14.08.2008 03:09:57,tp 204.182,0.0,-35.85000000000582,0.0,0.0,203792,14.08.2008 02:15:00,2054,-0.031882279064482155,82.09,IS,0.23,0.0,Phase3-EA-S4v1-GBPJPY-M5-194,GBPJPYMT4,590,54m 57s,Buy
22428.31,109.43,14.08.2008 07:00:00,,0.0,-16.60000000000582,0.0,0.0,109352,14.08.2008 01:15:00,2055,-0.014762784727210694,19.25,IS,0.27,0.0,Phase3-EA-S1v2-USDJPY-M15-0,USDJPYMT4,806,5h 45m,Buy
22421.07,1.6187,14.08.2008 07:45:00,,-2.72,-23.84000000001106,0.0,0.0,1.61882,13.08.2008 23:25:00,2056,-0.021201493246791735,-7.24,IS,0.41,0.0,Phase3-EA-SA2v2-EURCHF-M5-43,EURCHFMT4,1158,8h 20m,Buy
22454.28,109.84,15.08.2008 02:45:00,,-0.71,-0.0,0.0,0.0,109702,14.08.2008 22:45:00,2057,-0.0,33.21,IS,0.27,0.0,Phase3-EA-S1v2-USDJPY-M15-0,USDJPYMT4,808,4h 0m,Buy
22536.04,204882,15.08.2008 03:54:59,tp 204.882,0.0,-0.0,0.0,0.0,204492,15.08.2008 03:35:00,2058,-0.0,81.76,IS,0.23,0.0,Phase3-EA-S4v1-GBPJPY-M5-194,GBPJPYMT4,592,19m 59s,Buy
22526.91,1.6205,15.08.2008 05:45:00,,-0.9,-9.130000000004657,0.0,0.0,1.62072,14.08.2008 21:25:00,2059,-0.00811295652486497,-9.13,IS,0.41,0.0,Phase3-EA-SA2v2-EURCHF-M5-43,EURCHFMT4,1160,8h 20m,Buy
22513.91,1.6192,15.08.2008 10:00:00,,0.0,-22.130000000004657,0.0,0.0,1.61962,15.08.2008 01:15:00,2060,-0.019664811379540854,-13.0,IS,0.34,0.0,Phase3-EA-S4v1-EURCHF-M15-221,EURCHFMT4,626,8h 45m,Buy
22471.91,1.86332,15.08.2008 17:59:58,sl 1.86332,0.0,-64.13000000000466,0.0,0.0,1.86632,15.08.2008 17:30:00,2061,-0.056986188602339866,-42.0,IS,0.14,0.0,Phase3-EA-B1v1-GBPUSD-M30-14,GBPUSDMT4,146,29m 58s,Buy
22483.63,110.57,15.08.2008 20:45:00,,0.0,-52.41000000000349,0.0,0.0,110522,15.08.2008 17:00:00,2062,-0.046571747148738726,11.72,IS,0.27,0.0,Phase3-EA-S1v2-USDJPY-M15-0,USDJPYMT4,810,3h 45m,Buy
22535.86,1.09712,18.08.2008 02:15:00,tp 1.09712,-0.64,-0.180000000007567,0.0,0.0,1.09612,15.08.2008 23:45:00,2063,-1.5994875953300553E-4,52.23,IS,0.58,0.0,Phase3-EA-SA2v2-USDCHF-M15-107,USDCHFMT4,524,2d 2h 30m,Buy
22617.19,206072,18.08.2008 04:14:57,tp 206.072,0.0,-0.0,0.0,0.0,205682,18.08.2008 02:25:00,2064,-0.0,81.33,IS,0.23,0.0,Phase3-EA-S4v1-GBPJPY-M5-194,GBPJPYMT4,594,1h 49m,Buy
22623.04,1.6105,18.08.2008 04:20:00,,-0.9,-0.0,0.0,0.0,1.61032,15.08.2008 20:00:00,2065,-0.0,5.85,IS,0.41,0.0,Phase3-EA-SA2v2-EURCHF-M5-43,EURCHFMT4,1162,2d 8h 20m,Buy
22502.08,1.6151,18.08.2008 13:29:57,sl 1.61510,0.0,-120.9600000000064,0.0,0.0,1.6112,18.08.2008 05:00:00,2066,-0.10740253504079302,-120.96,IS,0.34,0.0,Phase3-EA-S4v1-EURCHF-M15-221,EURCHFMT4,628,8h 29m,Sell
22487.65,1.09762,19.08.2008 02:30:00,,-2.8,-135.38999999999942,0.0,0.0,1.0974,18.08.2008 22:15:00,2067,-0.12021518865056328,-14.43,IS,0.58,0.0,Phase3-EA-SA2v2-USDCHF-M15-107,USDCHFMT4,526,4h 15m,Sell
22445.65,1.8646,19.08.2008 02:59:57,sl 1.86460,0.0,-177.38999999999942,0.0,0.0,1.8616,19.08.2008 01:00:00,2068,-0.15750773553972555,-42.0,IS,0.14,0.0,Phase3-EA-B1v1-GBPUSD-M30-14,GBPUSDMT4,148,1h 59m,Sell
22277.25,204372,19.08.2008 04:24:58,sl 204.372,-0.75,-345.7899999999936,0.0,0.0,205172,18.08.2008 23:05:00,2069,-0.30703309020959957,-168.4,IS,0.23,0.0,Phase3-EA-S4v1-GBPJPY-M5-194,GBPJPYMT4,596,5h 19m,Buy
22212.06,1.6115,19.08.2008 05:45:00,,-0.9,-410.9799999999959,0.0,0.0,1.61322,18.08.2008 21:25:00,2070,-0.3649164504882799,-65.19,IS,0.41,0.0,Phase3-EA-SA2v2-EURCHF-M5-43,EURCHFMT4,1164,8h 20m,Buy
22171.23,1.6113,19.08.2008 10:15:00,,0.0,-451.8099999999977,0.0,0.0,1.61262,19.08.2008 01:30:00,2071,-0.40117013357124565,-40.83,IS,0.34,0.0,Phase3-EA-S4v1-EURCHF-M15-221,EURCHFMT4,630,8h 45m,Buy
22125.51,1.61472,20.08.2008 09:55:00,,0.0,-497.52999999999884,0.0,0.0,1.6135,20.08.2008 01:35:00,2072,-0.44176573461344903,-45.72,IS,0.41,0.0,Phase3-EA-SA2v2-EURCHF-M5-43,EURCHFMT4,1166,8h 20m,Sell
22166.82,109802,20.08.2008 21:15:00,,0.0,-456.22000000000116,0.0,0.0,109.97,20.08.2008 19:00:00,2073,-0.4050858509946108,41.31,IS,0.27,0.0,Phase3-EA-S1v2-USDJPY-M15-0,USDJPYMT4,812,2h 15m,Sell
22207.86,1.6197,20.08.2008 22:39:57,tp 1.61970,0.0,-415.18000000000757,0.0,0.0,1.6208,20.08.2008 21:45:00,2074,-0.3686457051772065,41.04,IS,0.41,0.0,Phase3-EA-SA2v2-EURCHF-M5-43,EURCHFMT4,1168,54m 57s,Sell
22258.71,1.09962,21.08.2008 00:29:57,tp 1.09962,-1.9,-364.33000000000175,0.0,0.0,1.09862,20.08.2008 23:00:00,2075,-0.3234950859078227,50.85,IS,0.58,0.0,Phase3-EA-SA2v2-USDCHF-M15-107,USDCHFMT4,528,1h 29m,Buy
22299.75,1.6199,21.08.2008 00:59:58,tp 1.61990,0.0,-323.29000000000815,0.0,0.0,1621,21.08.2008 00:25:00,2076,-0.28705494009041843,41.04,IS,0.41,0.0,Phase3-EA-SA2v2-EURCHF-M5-43,EURCHFMT4,1170,34m 58s,Sell
22257.75,1.86512,21.08.2008 10:59:58,sl 1.86512,0.0,-365.29000000000815,0.0,0.0,1.86812,21.08.2008 09:30:00,2077,-0.3243474869795807,-42.0,IS,0.14,0.0,Phase3-EA-B1v1-GBPUSD-M30-14,GBPUSDMT4,150,1h 29m,Buy
22263.6,108392,22.08.2008 00:15:00,,-1.12,-359.4400000000023,0.0,0.0,108.42,21.08.2008 19:15:00,2078,-0.31915316794858506,5.85,IS,0.27,0.0,Phase3-EA-S1v2-USDJPY-M15-0,USDJPYMT4,814,5h 0m,Sell
22316.3,1.08732,22.08.2008 01:59:57,tp 1.08732,-0.64,-306.74000000000524,0.0,0.0,1.08632,21.08.2008 23:45:00,2079,-0.27235990078051975,52.7,IS,0.58,0.0,Phase3-EA-SA2v2-USDCHF-M15-107,USDCHFMT4,530,2h 14m,Buy
22370.48,108.63,22.08.2008 03:45:00,,0.0,-252.56000000001222,0.0,0.0,108412,22.08.2008 00:30:00,2080,-0.22425251529350662,54.18,IS,0.27,0.0,Phase3-EA-S1v2-USDJPY-M15-0,USDJPYMT4,816,3h 15m,Buy
22288.74,1.61922,22.08.2008 05:05:00,,-1.89,-334.30000000001746,0.0,0.0,1.6171,21.08.2008 20:45:00,2081,-0.2968309148820857,-81.74,IS,0.41,0.0,Phase3-EA-SA2v2-EURCHF-M5-43,EURCHFMT4,1172,8h 20m,Sell
22191.82,1.08912,22.08.2008 06:15:00,,0.0,-431.2200000000157,0.0,0.0,1.0873,22.08.2008 02:00:00,2082,-0.3828879064177414,-96.92,IS,0.58,0.0,Phase3-EA-SA2v2-USDCHF-M15-107,USDCHFMT4,532,4h 15m,Sell
22135.11,1.62072,22.08.2008 11:30:00,,0.0,-487.9300000000221,0.0,0.0,1.6189,22.08.2008 02:45:00,2083,-0.4332417238959469,-56.71,IS,0.34,0.0,Phase3-EA-S4v1-EURCHF-M15-221,EURCHFMT4,632,8h 45m,Sell
22141.98,109.97,22.08.2008 21:30:00,,0.0,-481.0600000000268,0.0,0.0,109942,22.08.2008 20:15:00,2084,-0.4271417287262238,6.87,IS,0.27,0.0,Phase3-EA-S1v2-USDJPY-M15-0,USDJPYMT4,818,1h 15m,Buy
22183.05,1.6233,25.08.2008 01:49:59,tp 1.62330,0.0,-439.9900000000198,0.0,0.0,1.6244,25.08.2008 01:05:00,2085,-0.39067494537531533,41.07,IS,0.41,0.0,Phase3-EA-SA2v2-EURCHF-M5-43,EURCHFMT4,1174,44m 59s,Sell
22235.82,1.09912,25.08.2008 03:14:58,tp 1.09912,0.0,-387.2200000000157,0.0,0.0,1.09812,25.08.2008 01:45:00,2086,-0.34381952396242854,52.77,IS,0.58,0.0,Phase3-EA-SA2v2-USDCHF-M15-107,USDCHFMT4,534,1h 29m,Buy
22099.61,202.74,25.08.2008 07:45:00,,0.0,-523.4300000000221,0.0,0.0,203392,25.08.2008 02:20:00,2087,-0.4647628051951198,-136.21,IS,0.23,0.0,Phase3-EA-S4v1-GBPJPY-M5-194,GBPJPYMT4,598,5h 25m,Buy
22009.37,1.6205,25.08.2008 10:15:00,,0.0,-613.6700000000274,0.0,0.0,1.62292,25.08.2008 01:55:00,2088,-0.5448885059398388,-90.24,IS,0.41,0.0,Phase3-EA-SA2v2-EURCHF-M5-43,EURCHFMT4,1176,8h 20m,Buy
21922.13,1.6204,25.08.2008 12:15:00,,0.0,-700.9100000000326,0.0,0.0,1.62322,25.08.2008 03:30:00,2089,-0.6223504533353319,-87.24,IS,0.34,0.0,Phase3-EA-S4v1-EURCHF-M15-221,EURCHFMT4,634,8h 45m,Buy
21937.83,109252,26.08.2008 02:00:00,,-1.11,-685.2100000000355,0.0,0.0,109.32,25.08.2008 23:45:00,2090,-0.6084101441410524,15.7,IS,0.27,0.0,Phase3-EA-S1v2-USDJPY-M15-0,USDJPYMT4,820,2h 15m,Sell
21990.72,1.09662,26.08.2008 02:44:59,tp 1.09662,0.0,-632.3200000000361,0.0,0.0,1.09562,26.08.2008 01:30:00,2091,-0.5614481725942008,52.89,IS,0.58,0.0,Phase3-EA-SA2v2-USDCHF-M15-107,USDCHFMT4,536,1h 14m,Buy
22072.6,202352,26.08.2008 03:49:58,tp 202.352,0.0,-550.4400000000314,0.0,0.0,201962,26.08.2008 02:55:00,2092,-0.4887454645159917,81.88,IS,0.23,0.0,Phase3-EA-S4v1-GBPJPY-M5-194,GBPJPYMT4,600,54m 58s,Buy
22078.42,1.6169,26.08.2008 04:20:00,,-0.9,-544.6200000000244,0.0,0.0,1.61672,25.08.2008 20:00:00,2093,-0.4835777830184873,5.82,IS,0.41,0.0,Phase3-EA-SA2v2-EURCHF-M5-43,EURCHFMT4,1178,8h 20m,Buy
22118.61,1.61192,27.08.2008 03:19:58,tp 1.61192,-0.9,-504.4300000000221,0.0,0.0,1.61082,26.08.2008 20:20:00,2094,-0.44789236731668924,40.19,IS,0.41,0.0,Phase3-EA-SA2v2-EURCHF-M5-43,EURCHFMT4,1180,6h 59m,Buy
22136.63,1.61102,27.08.2008 12:30:00,,0.0,-486.41000000001804,0.0,0.0,1.6116,27.08.2008 03:45:00,2095,-0.4318920888656689,18.02,IS,0.34,0.0,Phase3-EA-S4v1-EURCHF-M15-221,EURCHFMT4,636,8h 45m,Sell
22177.73,1.61632,27.08.2008 23:44:59,tp 1.61632,0.0,-445.3100000000122,0.0,0.0,1.61522,27.08.2008 22:15:00,2096,-0.39539866798126916,41.1,IS,0.41,0.0,Phase3-EA-SA2v2-EURCHF-M5-43,EURCHFMT4,1182,1h 29m,Buy
22213.22,1.6153,28.08.2008 00:59:57,tp 1.61530,-5.6,-409.820000000007,0.0,0.0,1.6164,27.08.2008 23:50:00,2097,-0.3638864658599224,35.49,IS,0.41,0.0,Phase3-EA-SA2v2-EURCHF-M5-43,EURCHFMT4,1184,1h 9m,Sell
22157.39,1097,28.08.2008 02:15:00,,-1.9,-465.65000000000873,0.0,0.0,1.09802,27.08.2008 22:00:00,2098,-0.41345891568901755,-55.83,IS,0.58,0.0,Phase3-EA-SA2v2-USDCHF-M15-107,USDCHFMT4,538,4h 15m,Buy
22239.36,201002,28.08.2008 04:44:58,tp 201.002,0.0,-383.68000000000757,0.0,0.0,200612,28.08.2008 03:25:00,2099,-0.3406762950103348,81.97,IS,0.23,0.0,Phase3-EA-S4v1-GBPJPY-M5-194,GBPJPYMT4,602,1h 19m,Buy
22047.25,1.0929,28.08.2008 07:00:00,,0.0,-575.7900000000081,0.0,0.0,1.09652,28.08.2008 02:45:00,2100,-0.5112541803169297,-192.11,IS,0.58,0.0,Phase3-EA-SA2v2-USDCHF-M15-107,USDCHFMT4,540,4h 15m,Buy
21839.22,108852,28.08.2008 09:59:57,sl 108.852,-2.15,-783.820000000007,0.0,0.0,109682,27.08.2008 21:30:00,2101,-0.6959677167300816,-208.03,IS,0.27,0.0,Phase3-EA-S1v2-USDJPY-M15-0,USDJPYMT4,822,12h 29m,Buy
21963.81,1613,28.08.2008 10:44:57,tp 1.61300,0.0,-659.2300000000105,0.0,0.0,1617,28.08.2008 05:30:00,2102,-0.5853420401367341,124.59,IS,0.34,0.0,Phase3-EA-S4v1-EURCHF-M15-221,EURCHFMT4,638,5h 14m,Sell
22012.68,109.4,28.08.2008 18:00:00,,0.0,-610.3600000000151,0.0,0.0,109202,28.08.2008 17:15:00,2103,-0.5419494980778488,48.87,IS,0.27,0.0,Phase3-EA-S1v2-USDJPY-M15-0,USDJPYMT4,824,45m 0s,Buy
22068.87,109.55,28.08.2008 19:00:00,,0.0,-554.1700000000128,0.0,0.0,109322,28.08.2008 18:30:00,2104,-0.492057397846846,56.19,IS,0.27,0.0,Phase3-EA-S1v2-USDJPY-M15-0,USDJPYMT4,826,30m 0s,Buy
22121.65,1.0988,28.08.2008 23:59:57,tp 1.09880,0.0,-501.39000000001397,0.0,0.0,1.0998,28.08.2008 23:30:00,2105,-0.4451930972561331,52.78,IS,0.58,0.0,Phase3-EA-SA2v2-USDCHF-M15-107,USDCHFMT4,542,29m 57s,Sell
22160.89,1.6143,29.08.2008 03:54:59,tp 1.61430,-1.87,-462.15000000000873,0.0,0.0,1.6154,28.08.2008 23:05:00,2106,-0.410351203448254,39.24,IS,0.41,0.0,Phase3-EA-SA2v2-EURCHF-M5-43,EURCHFMT4,1186,4h 49m,Sell
22088.79,199.73,29.08.2008 06:10:00,,0.0,-534.2500000000146,0.0,0.0,200072,29.08.2008 00:45:00,2107,-0.4743700756079877,-72.1,IS,0.23,0.0,Phase3-EA-S4v1-GBPJPY-M5-194,GBPJPYMT4,604,5h 25m,Buy
21882.54,108652,29.08.2008 11:14:58,sl 108.652,0.0,-740.5000000000146,0.0,0.0,109482,29.08.2008 00:15:00,2108,-0.6575031183672667,-206.25,IS,0.27,0.0,Phase3-EA-S1v2-USDJPY-M15-0,USDJPYMT4,828,10h 59m,Buy
21925.35,1.6159,29.08.2008 13:00:00,,0.0,-697.6900000000169,0.0,0.0,1.61452,29.08.2008 04:15:00,2109,-0.6194913580738155,42.81,IS,0.34,0.0,Phase3-EA-S4v1-EURCHF-M15-221,EURCHFMT4,640,8h 45m,Buy
22077.92,196.51,01.09.2008 01:00:00,tp 196.510,-0.48,-545.1200000000099,0.0,0.0,198.36,29.08.2008 17:30:00,2110,-0.484021741910012,152.57,IS,0.09,0.0,Phase3-EA-B1v1-GBPJPY-M30-1,GBPJPYMT4,270,2d 7h 30m,Sell
22160.71,196262,01.09.2008 01:49:58,tp 196.262,0.0,-462.3300000000163,0.0,0.0,195872,01.09.2008 01:35:00,2111,-0.4105110286492143,82.79,IS,0.23,0.0,Phase3-EA-S4v1-GBPJPY-M5-194,GBPJPYMT4,606,14m 58s,Buy
22213.54,1.09792,01.09.2008 01:59:57,tp 1.09792,0.0,-409.50000000001455,0.0,0.0,1.09692,01.09.2008 01:30:00,2112,-0.36360233216934507,52.83,IS,0.58,0.0,Phase3-EA-SA2v2-USDCHF-M15-107,USDCHFMT4,544,29m 57s,Buy
22158.0,196.42,01.09.2008 02:29:58,sl 196.420,0.0,-465.04000000000815,0.0,0.0,195.75,01.09.2008 01:30:00,2113,-0.4129172858413411,-55.54,IS,0.09,0.0,Phase3-EA-B1v1-GBPJPY-M30-1,GBPJPYMT4,272,59m 58s,Sell
22096.87,1.6141,01.09.2008 06:50:00,,-0.89,-526.1700000000128,0.0,0.0,1.61572,29.08.2008 22:30:00,2114,-0.46719569992073784,-61.13,IS,0.41,0.0,Phase3-EA-SA2v2-EURCHF-M5-43,EURCHFMT4,1188,2d 8h 20m,Buy
22052.99,1612,01.09.2008 10:30:00,,0.0,-570.0500000000175,0.0,0.0,1.61342,01.09.2008 01:45:00,2115,-0.5061575322420858,-43.88,IS,0.34,0.0,Phase3-EA-S4v1-EURCHF-M15-221,EURCHFMT4,642,8h 45m,Buy
22082.44,108.2,01.09.2008 23:30:00,,0.0,-540.6000000000204,0.0,0.0,108082,01.09.2008 20:30:00,2116,-0.480008353530521,29.45,IS,0.27,0.0,Phase3-EA-S1v2-USDJPY-M15-0,USDJPYMT4,830,3h 0m,Buy
22165.54,193332,02.09.2008 01:54:57,tp 193.332,0.0,-457.50000000001455,0.0,0.0,192942,02.09.2008 01:35:00,2117,-0.40622238575695907,83.1,IS,0.23,0.0,Phase3-EA-S4v1-GBPJPY-M5-194,GBPJPYMT4,608,19m 57s,Buy
22206.43,1.60802,02.09.2008 03:49:58,tp 1.60802,0.0,-416.61000000001513,0.0,0.0,1.60692,02.09.2008 01:25:00,2118,-0.3699154276070109,40.89,IS,0.41,0.0,Phase3-EA-SA2v2-EURCHF-M5-43,EURCHFMT4,1190,2h 24m,Buy
22328.75,1.61102,02.09.2008 11:29:58,tp 1.61102,0.0,-294.29000000000815,0.0,0.0,1.60702,02.09.2008 03:00:00,2119,-0.26130532438123494,122.32,IS,0.34,0.0,Phase3-EA-S4v1-EURCHF-M15-221,EURCHFMT4,644,8h 29m,Buy
22411.29,193592,03.09.2008 03:29:58,tp 193.592,0.0,-211.75000000001455,0.0,0.0,193202,03.09.2008 03:05:00,2120,-0.18801659056620604,82.54,IS,0.23,0.0,Phase3-EA-S4v1-GBPJPY-M5-194,GBPJPYMT4,610,24m 58s,Buy
22405.11,108.76,03.09.2008 03:45:00,,-0.72,-217.93000000000757,0.0,0.0,108782,02.09.2008 17:30:00,2121,-0.19350392246560513,-6.18,IS,0.27,0.0,Phase3-EA-S1v2-USDJPY-M15-0,USDJPYMT4,832,10h 15m,Buy
22373.86,1.6064,03.09.2008 05:20:00,,-0.89,-249.18000000000757,0.0,0.0,1.60722,02.09.2008 21:00:00,2122,-0.221251353186708,-31.25,IS,0.41,0.0,Phase3-EA-SA2v2-EURCHF-M5-43,EURCHFMT4,1192,8h 20m,Buy
22385.82,108332,03.09.2008 17:30:00,,0.0,-237.22000000000116,0.0,0.0,108.38,03.09.2008 17:15:00,2123,-0.21063185650112182,11.96,IS,0.27,0.0,Phase3-EA-S1v2-USDJPY-M15-0,USDJPYMT4,834,15m 0s,Sell
22415.21,108422,03.09.2008 18:00:00,,0.0,-207.83000000000175,0.0,0.0,108.54,03.09.2008 17:45:00,2124,-0.1845359528565395,29.39,IS,0.27,0.0,Phase3-EA-S1v2-USDJPY-M15-0,USDJPYMT4,836,15m 0s,Sell
22429.67,108322,03.09.2008 21:15:00,,0.0,-193.36999999999534,0.0,0.0,108.38,03.09.2008 20:45:00,2125,-0.17169666171326511,14.46,IS,0.27,0.0,Phase3-EA-S1v2-USDJPY-M15-0,USDJPYMT4,838,30m 0s,Sell
22451.62,108232,03.09.2008 21:30:00,,0.0,-171.41999999999825,0.0,0.0,108.32,03.09.2008 21:15:00,2126,-0.15220686637476502,21.95,IS,0.27,0.0,Phase3-EA-S1v2-USDJPY-M15-0,USDJPYMT4,840,15m 0s,Sell
22530.75,191.99,04.09.2008 01:59:57,tp 191.990,-3.7,-92.2899999999936,0.0,0.0,192.38,03.09.2008 23:35:00,2127,-0.08194593220001302,79.13,IS,0.23,0.0,Phase3-EA-S4v1-GBPJPY-M5-194,GBPJPYMT4,612,2h 24m,Sell
22583.24,1.1049,04.09.2008 02:44:58,tp 1.10490,0.0,-39.79999999998836,0.0,0.0,1.1059,04.09.2008 01:00:00,2128,-0.03533912776638629,52.49,IS,0.58,0.0,Phase3-EA-SA2v2-USDCHF-M15-107,USDCHFMT4,546,1h 44m,Sell
22615.17,108222,04.09.2008 03:45:00,,0.0,-7.869999999995343,0.0,0.0,108.35,04.09.2008 00:15:00,2129,-0.006987912952798415,31.93,IS,0.27,0.0,Phase3-EA-S1v2-USDJPY-M15-0,USDJPYMT4,842,3h 30m,Sell
22655.97,1.6024,04.09.2008 04:09:58,tp 1.60240,0.0,-0.0,0.0,0.0,1.6035,04.09.2008 00:05:00,2130,-0.0,40.8,IS,0.41,0.0,Phase3-EA-SA2v2-EURCHF-M5-43,EURCHFMT4,1194,4h 4m,Sell
22710.8,1.60192,04.09.2008 12:15:00,,0.0,-0.0,0.0,0.0,1.6037,04.09.2008 03:30:00,2131,-0.0,54.83,IS,0.34,0.0,Phase3-EA-S4v1-EURCHF-M15-221,EURCHFMT4,646,8h 45m,Sell
22529.33,1.58452,05.09.2008 01:05:00,sl 1.58452,-0.89,-181.47000000000116,0.0,0.0,1.58942,04.09.2008 20:35:00,2132,-0.16100497911469092,-181.47,IS,0.41,0.0,Phase3-EA-SA2v2-EURCHF-M5-43,EURCHFMT4,1196,4h 30m,Buy
22355.29,186502,05.09.2008 01:09:58,sl 186.502,0.0,-355.50999999999476,0.0,0.0,187302,05.09.2008 00:35:00,2133,-0.3154178659010446,-174.04,IS,0.23,0.0,Phase3-EA-S4v1-GBPJPY-M5-194,GBPJPYMT4,614,34m 58s,Buy
22395.84,1.58472,05.09.2008 01:14:58,tp 1.58472,0.0,-314.95999999999185,0.0,0.0,1.58362,05.09.2008 01:10:00,2134,-0.2794408344186996,40.55,IS,0.41,0.0,Phase3-EA-SA2v2-EURCHF-M5-43,EURCHFMT4,1198,4m 58s,Buy
22480.1,187042,05.09.2008 01:44:58,tp 187.042,0.0,-230.6999999999971,0.0,0.0,186652,05.09.2008 01:15:00,2135,-0.20468313595502557,84.26,IS,0.23,0.0,Phase3-EA-S4v1-GBPJPY-M5-194,GBPJPYMT4,616,29m 58s,Buy
22602.74,1.58872,05.09.2008 09:29:58,tp 1.58872,0.0,-108.05999999999767,0.0,0.0,1.58472,05.09.2008 02:30:00,2136,-0.09587368734850397,122.64,IS,0.34,0.0,Phase3-EA-S4v1-EURCHF-M15-221,EURCHFMT4,648,6h 59m,Buy
22546.19,188032,05.09.2008 17:29:58,sl 188.032,0.0,-164.61000000000058,0.0,0.0,188702,05.09.2008 16:30:00,2137,-0.14604634161056482,-56.55,IS,0.09,0.0,Phase3-EA-B1v1-GBPJPY-M30-1,GBPJPYMT4,274,59m 58s,Buy
22337.61,107.44,05.09.2008 23:44:58,sl 107.440,0.0,-373.1900000000023,0.0,0.0,106.61,05.09.2008 17:00:00,2138,-0.3311040290726373,-208.58,IS,0.27,0.0,Phase3-EA-S1v2-USDJPY-M15-0,USDJPYMT4,844,6h 44m,Sell
22157.83,1.5947,05.09.2008 23:54:57,sl 1.59470,0.0,-552.9700000000012,0.0,0.0,1.5898,05.09.2008 20:05:00,2139,-0.4906095955312187,-179.78,IS,0.41,0.0,Phase3-EA-SA2v2-EURCHF-M5-43,EURCHFMT4,1200,3h 49m,Sell
22240.64,193.14,08.09.2008 01:19:57,tp 193.140,0.0,-470.1600000000035,0.0,0.0,193.53,08.09.2008 01:15:00,2140,-0.41713837538195386,82.81,IS,0.23,0.0,Phase3-EA-S4v1-GBPJPY-M5-194,GBPJPYMT4,618,4m 57s,Sell
22280.87,1.6061,08.09.2008 01:19:58,tp 1.60610,0.0,-429.93000000000757,0.0,0.0,1.6072,08.09.2008 01:10:00,2141,-0.38144525635520937,40.23,IS,0.41,0.0,Phase3-EA-SA2v2-EURCHF-M5-43,EURCHFMT4,1202,9m 58s,Sell
22225.42,194332,08.09.2008 09:29:58,sl 194.332,0.0,-485.38000000000466,0.0,0.0,195002,08.09.2008 08:00:00,2142,-0.4306419615511596,-55.45,IS,0.09,0.0,Phase3-EA-B1v1-GBPJPY-M30-1,GBPJPYMT4,276,1h 29m,Buy
22288.15,1.60232,08.09.2008 12:30:00,,0.0,-422.65000000000873,0.0,0.0,1.6044,08.09.2008 03:45:00,2143,-0.37498624799043967,62.73,IS,0.34,0.0,Phase3-EA-S4v1-EURCHF-M15-221,EURCHFMT4,650,8h 45m,Sell
22370.98,190.34,08.09.2008 23:59:57,tp 190.340,0.0,-339.820000000007,0.0,0.0,190.73,08.09.2008 23:35:00,2144,-0.30149728331269654,82.83,IS,0.23,0.0,Phase3-EA-S4v1-GBPJPY-M5-194,GBPJPYMT4,620,24m 57s,Sell
22429.46,107812,09.09.2008 03:30:00,,-1.12,-281.34000000001106,0.0,0.0,108.05,08.09.2008 22:45:00,2145,-0.2496122820528387,58.48,IS,0.27,0.0,Phase3-EA-S1v2-USDJPY-M15-0,USDJPYMT4,846,4h 45m,Sell
22446.88,1.5966,09.09.2008 10:45:00,,0.0,-263.9200000000128,0.0,0.0,1.59612,09.09.2008 02:25:00,2146,-0.2341567977514246,17.42,IS,0.41,0.0,Phase3-EA-SA2v2-EURCHF-M5-43,EURCHFMT4,1204,8h 20m,Buy
22567.27,1.59792,09.09.2008 10:59:57,tp 1.59792,0.0,-143.5300000000134,0.0,0.0,1.59392,09.09.2008 04:15:00,2147,-0.12734360859830052,120.39,IS,0.34,0.0,Phase3-EA-S4v1-EURCHF-M15-221,EURCHFMT4,652,6h 44m,Buy
22358.17,107172,09.09.2008 18:29:57,sl 107.172,0.0,-352.6300000000192,0.0,0.0,108002,09.09.2008 17:00:00,2148,-0.3128626538007174,-209.1,IS,0.27,0.0,Phase3-EA-S1v2-USDJPY-M15-0,USDJPYMT4,848,1h 29m,Buy
22398.21,1.59412,09.09.2008 22:14:57,tp 1.59412,0.0,-312.5900000000256,0.0,0.0,1.59302,09.09.2008 21:40:00,2149,-0.27733810779448415,40.04,IS,0.41,0.0,Phase3-EA-SA2v2-EURCHF-M5-43,EURCHFMT4,1206,34m 57s,Buy
22449.67,1127,09.09.2008 23:44:58,tp 1.12700,0.0,-261.1300000000192,0.0,0.0,1128,09.09.2008 22:45:00,2150,-0.2316814360292173,51.46,IS,0.58,0.0,Phase3-EA-SA2v2-USDCHF-M15-107,USDCHFMT4,548,59m 58s,Sell
22533.42,188.41,10.09.2008 02:34:58,tp 188.410,0.0,-177.3800000000192,0.0,0.0,188.8,10.09.2008 02:10:00,2151,-0.15737622304164206,83.75,IS,0.23,0.0,Phase3-EA-S4v1-GBPJPY-M5-194,GBPJPYMT4,622,24m 58s,Sell
22572.57,1.59502,10.09.2008 04:29:58,tp 1.59502,-0.87,-138.23000000002503,0.0,0.0,1.59392,09.09.2008 22:25:00,2152,-0.12264130855252997,39.15,IS,0.41,0.0,Phase3-EA-SA2v2-EURCHF-M5-43,EURCHFMT4,1208,6h 4m,Buy
22523.93,1.59642,10.09.2008 14:00:00,,0.0,-186.87000000002445,0.0,0.0,1.5948,10.09.2008 05:15:00,2153,-0.1657960018028657,-48.64,IS,0.34,0.0,Phase3-EA-S4v1-EURCHF-M15-221,EURCHFMT4,654,8h 45m,Sell
22563.68,1.59262,10.09.2008 21:39:57,tp 1.59262,0.0,-147.12000000002445,0.0,0.0,1.59152,10.09.2008 21:10:00,2154,-0.1305287514595091,39.75,IS,0.41,0.0,Phase3-EA-SA2v2-EURCHF-M5-43,EURCHFMT4,1210,29m 57s,Buy
22553.15,107.73,10.09.2008 21:45:00,,0.0,-157.65000000002328,0.0,0.0,107772,10.09.2008 21:15:00,2155,-0.13987124570140855,-10.53,IS,0.27,0.0,Phase3-EA-S1v2-USDJPY-M15-0,USDJPYMT4,850,30m 0s,Buy
22595.32,107552,10.09.2008 23:00:00,,0.0,-115.48000000002503,0.0,0.0,107722,10.09.2008 22:00:00,2156,-0.10245690741262148,42.17,IS,0.27,0.0,Phase3-EA-S1v2-USDJPY-M15-0,USDJPYMT4,852,1h 0m,Buy
22634.99,1.59272,10.09.2008 23:39:57,tp 1.59272,0.0,-75.81000000002678,0.0,0.0,1.59162,10.09.2008 22:55:00,2157,-0.067260635183165,39.67,IS,0.41,0.0,Phase3-EA-SA2v2-EURCHF-M5-43,EURCHFMT4,1212,44m 57s,Buy
22644.84,107.77,11.09.2008 01:00:00,,-2.18,-65.96000000002095,0.0,0.0,107.72,10.09.2008 22:00:00,2158,-0.05852145490939725,9.85,IS,0.27,0.0,Phase3-EA-S1v2-USDJPY-M15-0,USDJPYMT4,853,3h 0m,Sell
22471.31,187892,11.09.2008 02:59:57,sl 187.892,-2.31,-239.4900000000198,0.0,0.0,188692,10.09.2008 23:20:00,2159,-0.21248185621965213,-173.53,IS,0.23,0.0,Phase3-EA-S4v1-GBPJPY-M5-194,GBPJPYMT4,624,3h 39m,Buy
22510.96,1.59022,11.09.2008 04:34:58,tp 1.59022,0.0,-199.8400000000256,0.0,0.0,1.58912,11.09.2008 01:40:00,2160,-0.1773033285186739,39.65,IS,0.41,0.0,Phase3-EA-SA2v2-EURCHF-M5-43,EURCHFMT4,1214,2h 54m,Buy
22394.3,1.58532,11.09.2008 10:44:58,sl 1.58532,0.0,-316.5000000000291,0.0,0.0,1.58922,11.09.2008 02:00:00,2161,-0.2808071631112803,-116.66,IS,0.34,0.0,Phase3-EA-S4v1-EURCHF-M15-221,EURCHFMT4,656,8h 44m,Buy
22352.3,1.75272,11.09.2008 16:59:58,sl 1.75272,0.0,-358.5000000000291,0.0,0.0,1.75572,11.09.2008 15:00:00,2162,-0.3180706729080345,-42.0,IS,0.14,0.0,Phase3-EA-B1v1-GBPUSD-M30-14,GBPUSDMT4,152,1h 59m,Buy
22295.69,186.74,11.09.2008 18:59:57,sl 186.740,0.0,-415.1100000000297,0.0,0.0,186.07,11.09.2008 17:00:00,2163,-0.3682965607555172,-56.61,IS,0.09,0.0,Phase3-EA-B1v1-GBPJPY-M30-1,GBPJPYMT4,278,1h 59m,Sell
22335.25,1.5883,11.09.2008 22:39:58,tp 1.58830,0.0,-375.550000000032,0.0,0.0,1.5894,11.09.2008 21:15:00,2164,-0.33319788343267176,39.56,IS,0.41,0.0,Phase3-EA-SA2v2-EURCHF-M5-43,EURCHFMT4,1216,1h 24m,Sell
22125.32,107.33,12.09.2008 00:29:58,sl 107.330,-1.13,-585.480000000025,0.0,0.0,106.5,11.09.2008 18:00:00,2165,-0.519453326566775,-209.93,IS,0.27,0.0,Phase3-EA-S1v2-USDJPY-M15-0,USDJPYMT4,856,6h 29m,Sell
21946.94,1.5951,12.09.2008 00:29:58,sl 1.59510,-1.8,-763.8600000000297,0.0,0.0,1.5902,11.09.2008 23:05:00,2166,-0.6777167760321364,-178.38,IS,0.41,0.0,Phase3-EA-SA2v2-EURCHF-M5-43,EURCHFMT4,1218,1h 24m,Sell
22030.62,187.97,12.09.2008 03:44:58,tp 187.970,0.0,-680.1800000000367,0.0,0.0,188.36,12.09.2008 03:25:00,2167,-0.6034736688942287,83.68,IS,0.23,0.0,Phase3-EA-S4v1-GBPJPY-M5-194,GBPJPYMT4,626,19m 58s,Sell
21985.09,1.59492,12.09.2008 09:45:00,,0.0,-725.7100000000355,0.0,0.0,1.5934,12.09.2008 01:00:00,2168,-0.6438690879667566,-45.53,IS,0.34,0.0,Phase3-EA-S4v1-EURCHF-M15-221,EURCHFMT4,658,8h 45m,Sell
22140.33,192742,12.09.2008 18:29:58,tp 192.742,0.0,-570.4700000000303,0.0,0.0,190892,12.09.2008 17:30:00,2169,-0.5061360579465588,155.24,IS,0.09,0.0,Phase3-EA-B1v1-GBPJPY-M30-1,GBPJPYMT4,280,59m 58s,Buy
22178.42,1.6062,15.09.2008 01:00:00,tp 1.60620,-1.81,-532.3800000000338,0.0,0.0,1.6073,12.09.2008 21:00:00,2170,-0.47234160346660076,38.09,IS,0.41,0.0,Phase3-EA-SA2v2-EURCHF-M5-43,EURCHFMT4,1220,2d 4h 0m,Sell
22262.65,191822,15.09.2008 01:19:57,tp 191.822,0.0,-448.15000000003783,0.0,0.0,191432,15.09.2008 01:10:00,2171,-0.39761052179563766,84.23,IS,0.23,0.0,Phase3-EA-S4v1-GBPJPY-M5-194,GBPJPYMT4,628,9m 57s,Buy
22314.52,1.11822,15.09.2008 01:59:59,tp 1.11822,0.0,-396.2800000000425,0.0,0.0,1.11722,15.09.2008 01:45:00,2172,-0.3515900871966504,51.87,IS,0.58,0.0,Phase3-EA-SA2v2-USDCHF-M15-107,USDCHFMT4,550,14m 59s,Buy
22195.12,1.59872,15.09.2008 06:29:58,sl 1.59872,0.0,-515.6800000000367,0.0,0.0,1.60262,15.09.2008 02:15:00,2173,-0.4575249221902749,-119.4,IS,0.34,0.0,Phase3-EA-S4v1-EURCHF-M15-221,EURCHFMT4,660,4h 14m,Buy
22353.8,187.72,15.09.2008 11:59:57,tp 187.720,0.0,-357.00000000004366,0.0,0.0,189.57,15.09.2008 11:00:00,2174,-0.31673983327244903,158.68,IS,0.09,0.0,Phase3-EA-B1v1-GBPJPY-M30-1,GBPJPYMT4,282,59m 57s,Sell
22296.74,188.12,15.09.2008 14:59:58,sl 188.120,0.0,-414.0600000000413,0.0,0.0,187.45,15.09.2008 14:30:00,2175,-0.36736497301060866,-57.06,IS,0.09,0.0,Phase3-EA-B1v1-GBPJPY-M30-1,GBPJPYMT4,284,29m 58s,Sell
22339.6,105.83,15.09.2008 22:00:00,,0.0,-371.20000000004075,0.0,0.0,105662,15.09.2008 19:00:00,2176,-0.32933844848944427,42.86,IS,0.27,0.0,Phase3-EA-S1v2-USDJPY-M15-0,USDJPYMT4,858,3h 0m,Buy
22391.91,1.10882,15.09.2008 23:14:57,tp 1.10882,0.0,-318.8900000000431,0.0,0.0,1.10782,15.09.2008 23:00:00,2177,-0.28292763426401274,52.31,IS,0.58,0.0,Phase3-EA-SA2v2-USDCHF-M15-107,USDCHFMT4,552,14m 57s,Buy
22477.92,187592,16.09.2008 02:34:57,tp 187.592,0.0,-232.8800000000483,0.0,0.0,187202,16.09.2008 02:10:00,2178,-0.20661728955880732,86.01,IS,0.23,0.0,Phase3-EA-S4v1-GBPJPY-M5-194,GBPJPYMT4,630,24m 57s,Buy
22297.08,1.58122,16.09.2008 08:59:58,sl 1.58122,0.0,-413.7200000000448,0.0,0.0,1.58612,16.09.2008 02:05:00,2179,-0.3670633160265428,-180.84,IS,0.41,0.0,Phase3-EA-SA2v2-EURCHF-M5-43,EURCHFMT4,1222,6h 54m,Buy
22177.46,1.58102,16.09.2008 09:14:57,sl 1.58102,0.0,-533.3400000000402,0.0,0.0,1.58492,16.09.2008 04:00:00,2180,-0.47319334083338943,-119.62,IS,0.34,0.0,Phase3-EA-S4v1-EURCHF-M15-221,EURCHFMT4,662,5h 14m,Buy
22279.87,105462,16.09.2008 21:44:58,tp 105.462,0.0,-430.93000000003667,0.0,0.0,105062,16.09.2008 21:30:00,2181,-0.3823324827789674,102.41,IS,0.27,0.0,Phase3-EA-S1v2-USDJPY-M15-0,USDJPYMT4,860,14m 58s,Buy
22320.02,1587,16.09.2008 23:54:58,tp 1.58700,0.0,-390.7800000000425,0.0,0.0,1.5881,16.09.2008 23:10:00,2182,-0.3467103418661231,40.15,IS,0.41,0.0,Phase3-EA-SA2v2-EURCHF-M5-43,EURCHFMT4,1224,44m 58s,Sell
22360.18,1.58482,17.09.2008 00:59:59,tp 1.58482,0.0,-350.620000000039,0.0,0.0,1.58372,17.09.2008 00:50:00,2183,-0.31107932868903315,40.16,IS,0.41,0.0,Phase3-EA-SA2v2-EURCHF-M5-43,EURCHFMT4,1226,9m 59s,Buy
22400.41,1.58392,17.09.2008 01:49:58,tp 1.58392,0.0,-310.3900000000431,0.0,0.0,1.58282,17.09.2008 01:30:00,2184,-0.2753862096622887,40.23,IS,0.41,0.0,Phase3-EA-SA2v2-EURCHF-M5-43,EURCHFMT4,1228,19m 58s,Buy
22502.57,105712,17.09.2008 02:14:58,tp 105.712,0.0,-208.23000000003958,0.0,0.0,105312,17.09.2008 00:45:00,2185,-0.1847471582137998,102.16,IS,0.27,0.0,Phase3-EA-S1v2-USDJPY-M15-0,USDJPYMT4,862,1h 29m,Buy
22623.72,1.58742,17.09.2008 02:29:59,tp 1.58742,0.0,-87.0800000000454,0.0,0.0,1.58342,17.09.2008 01:45:00,2186,-0.07725967697864389,121.15,IS,0.34,0.0,Phase3-EA-S4v1-EURCHF-M15-221,EURCHFMT4,664,44m 59s,Buy
22450.23,190.08,17.09.2008 03:09:58,sl 190.080,0.0,-260.57000000005064,0.0,0.0,189.28,17.09.2008 02:50:00,2187,-0.23118458923195515,-173.49,IS,0.23,0.0,Phase3-EA-S4v1-GBPJPY-M5-194,GBPJPYMT4,632,19m 58s,Sell
22534.6,190.06,17.09.2008 03:54:58,tp 190.060,0.0,-176.2000000000553,0.0,0.0,190.45,17.09.2008 03:25:00,2188,-0.15632929586167005,84.37,IS,0.23,0.0,Phase3-EA-S4v1-GBPJPY-M5-194,GBPJPYMT4,634,29m 58s,Sell
22574.81,1.5881,17.09.2008 07:54:58,tp 1.58810,0.0,-135.9900000000489,0.0,0.0,1.5892,17.09.2008 02:50:00,2189,-0.12065392136339093,40.21,IS,0.41,0.0,Phase3-EA-SA2v2-EURCHF-M5-43,EURCHFMT4,1230,5h 4m,Sell
22565.09,1.59112,17.09.2008 12:45:00,,0.0,-145.71000000005006,0.0,0.0,1.5908,17.09.2008 04:00:00,2190,-0.12927776220206935,-9.72,IS,0.34,0.0,Phase3-EA-S4v1-EURCHF-M15-221,EURCHFMT4,666,8h 45m,Sell
22523.09,1.79252,17.09.2008 18:29:58,sl 1.79252,0.0,-187.71000000005006,0.0,0.0,1.79552,17.09.2008 18:00:00,2191,-0.1665412719988235,-42.0,IS,0.14,0.0,Phase3-EA-B1v1-GBPUSD-M30-14,GBPUSDMT4,154,29m 58s,Buy
22563.61,1.58382,17.09.2008 20:19:58,tp 1.58382,0.0,-147.19000000004598,0.0,0.0,1.58272,17.09.2008 20:05:00,2192,-0.13059085730918946,40.52,IS,0.41,0.0,Phase3-EA-SA2v2-EURCHF-M5-43,EURCHFMT4,1232,14m 58s,Buy
22604.38,1.58212,17.09.2008 20:44:58,tp 1.58212,0.0,-106.42000000004191,0.0,0.0,1.58102,17.09.2008 20:40:00,2193,-0.09441863601362234,40.77,IS,0.41,0.0,Phase3-EA-SA2v2-EURCHF-M5-43,EURCHFMT4,1234,4m 58s,Buy
22868.98,1.81772,17.09.2008 21:59:58,tp 1.81772,0.0,-0.0,0.0,0.0,1.79882,17.09.2008 20:00:00,2194,-0.0,264.6,IS,0.14,0.0,Phase3-EA-B1v1-GBPUSD-M30-14,GBPUSDMT4,156,1h 59m,Buy
22909.88,1.58112,17.09.2008 23:04:58,tp 1.58112,0.0,-0.0,0.0,0.0,1.58002,17.09.2008 23:00:00,2195,-0.0,40.9,IS,0.41,0.0,Phase3-EA-SA2v2-EURCHF-M5-43,EURCHFMT4,1236,4m 58s,Buy
23013.21,104.52,17.09.2008 23:44:57,tp 104.520,0.0,-0.0,0.0,0.0,104.92,17.09.2008 21:30:00,2196,-0.0,103.33,IS,0.27,0.0,Phase3-EA-S1v2-USDJPY-M15-0,USDJPYMT4,864,2h 14m,Sell
23051.4,1.58092,18.09.2008 01:50:00,tp 1.58092,-2.68,-0.0,0.0,0.0,1.57982,17.09.2008 23:35:00,2197,-0.0,38.19,IS,0.41,0.0,Phase3-EA-SA2v2-EURCHF-M5-43,EURCHFMT4,1238,2h 15m,Buy
23137.09,190.04,18.09.2008 04:24:57,tp 190.040,0.0,-0.0,0.0,0.0,190.43,18.09.2008 03:40:00,2198,-0.0,85.69,IS,0.23,0.0,Phase3-EA-S4v1-GBPJPY-M5-194,GBPJPYMT4,636,44m 57s,Sell
23178.09,1.58202,18.09.2008 08:54:59,tp 1.58202,0.0,-0.0,0.0,0.0,1.58092,18.09.2008 01:55:00,2199,-0.0,41.0,IS,0.41,0.0,Phase3-EA-SA2v2-EURCHF-M5-43,EURCHFMT4,1240,6h 59m,Buy
23219.38,1.58032,18.09.2008 20:09:58,tp 1.58032,0.0,-0.0,0.0,0.0,1.57922,18.09.2008 20:05:00,2200,-0.0,41.29,IS,0.41,0.0,Phase3-EA-SA2v2-EURCHF-M5-43,EURCHFMT4,1242,4m 58s,Buy
23322.17,105072,18.09.2008 22:14:58,tp 105.072,0.0,-0.0,0.0,0.0,104672,18.09.2008 19:30:00,2201,-0.0,102.79,IS,0.27,0.0,Phase3-EA-S1v2-USDJPY-M15-0,USDJPYMT4,866,2h 44m,Buy
23362.9,1.5846,18.09.2008 22:59:58,tp 1.58460,0.0,-0.0,0.0,0.0,1.5857,18.09.2008 22:50:00,2202,-0.0,40.73,IS,0.41,0.0,Phase3-EA-SA2v2-EURCHF-M5-43,EURCHFMT4,1244,9m 58s,Sell
23415.36,1.1057,18.09.2008 23:14:58,tp 1.10570,0.0,-0.0,0.0,0.0,1.1067,18.09.2008 22:30:00,2203,-0.0,52.46,IS,0.58,0.0,Phase3-EA-SA2v2-USDCHF-M15-107,USDCHFMT4,554,44m 58s,Sell
23467.74,1.1073,19.09.2008 02:29:59,tp 1.10730,0.0,-0.0,0.0,0.0,1.1083,19.09.2008 02:00:00,2204,-0.0,52.38,IS,0.58,0.0,Phase3-EA-SA2v2-USDCHF-M15-107,USDCHFMT4,556,29m 59s,Sell
23508.41,1.58552,19.09.2008 02:54:58,tp 1.58552,0.0,-0.0,0.0,0.0,1.58442,19.09.2008 02:45:00,2205,-0.0,40.67,IS,0.41,0.0,Phase3-EA-SA2v2-EURCHF-M5-43,EURCHFMT4,1246,9m 58s,Buy
23466.41,1.8097,19.09.2008 09:29:58,sl 1.80970,0.0,-42.0,0.0,0.0,1.8067,19.09.2008 03:30:00,2206,-0.03700166357717458,-42.0,IS,0.14,0.0,Phase3-EA-B1v1-GBPUSD-M30-14,GBPUSDMT4,158,5h 59m,Sell
23347.52,1.5895,19.09.2008 09:44:58,sl 1.58950,0.0,-160.88999999999942,0.0,0.0,1.5856,19.09.2008 01:30:00,2207,-0.1417428012602761,-118.89,IS,0.34,0.0,Phase3-EA-S4v1-EURCHF-M15-221,EURCHFMT4,668,8h 14m,Sell
23502.23,195452,19.09.2008 15:59:58,tp 195.452,0.0,-6.179999999993015,0.0,0.0,193602,19.09.2008 14:30:00,2208,-0.0054445304977781064,154.71,IS,0.09,0.0,Phase3-EA-B1v1-GBPJPY-M30-1,GBPJPYMT4,286,1h 29m,Buy
23543.17,1.59652,19.09.2008 22:29:58,tp 1.59652,0.0,-0.0,0.0,0.0,1.59542,19.09.2008 21:45:00,2209,-0.0,40.94,IS,0.41,0.0,Phase3-EA-SA2v2-EURCHF-M5-43,EURCHFMT4,1248,44m 58s,Buy
23584.0,1.5999,19.09.2008 23:24:57,tp 1.59990,0.0,-0.0,0.0,0.0,1601,19.09.2008 23:20:00,2210,-0.0,40.83,IS,0.41,0.0,Phase3-EA-SA2v2-EURCHF-M5-43,EURCHFMT4,1250,4m 57s,Sell
23555.82,107.3,19.09.2008 23:30:00,,0.0,-28.179999999993015,0.0,0.0,107412,19.09.2008 17:15:00,2211,-0.02480983237075029,-28.18,IS,0.27,0.0,Phase3-EA-S1v2-USDJPY-M15-0,USDJPYMT4,868,6h 15m,Buy
23499.4,195972,22.09.2008 01:00:00,sl 195.972,-0.3,-84.59999999999127,0.0,0.0,196642,19.09.2008 19:30:00,2212,-0.07448232145371816,-56.42,IS,0.09,0.0,Phase3-EA-B1v1-GBPJPY-M30-1,GBPJPYMT4,288,2d 5h 30m,Buy
23599.3,106.9,22.09.2008 01:00:00,tp 106.900,-1.13,-0.0,0.0,0.0,107.3,19.09.2008 23:30:00,2213,-0.0,99.9,IS,0.27,0.0,Phase3-EA-S1v2-USDJPY-M15-0,USDJPYMT4,870,2d 1h 30m,Sell
23683.45,195732,22.09.2008 02:29:57,tp 195.732,0.0,-0.0,0.0,0.0,195342,22.09.2008 02:25:00,2214,-0.0,84.15,IS,0.23,0.0,Phase3-EA-S4v1-GBPJPY-M5-194,GBPJPYMT4,638,4m 57s,Buy
23736.06,1.10252,22.09.2008 03:29:58,tp 1.10252,0.0,-0.0,0.0,0.0,1.10152,22.09.2008 02:30:00,2215,-0.0,52.61,IS,0.58,0.0,Phase3-EA-SA2v2-USDCHF-M15-107,USDCHFMT4,558,59m 58s,Buy
23777.92,1.59142,22.09.2008 20:59:57,tp 1.59142,0.0,-0.0,0.0,0.0,1.59032,22.09.2008 20:20:00,2216,-0.0,41.86,IS,0.41,0.0,Phase3-EA-SA2v2-EURCHF-M5-43,EURCHFMT4,1252,39m 57s,Buy
23819.95,1.5905,22.09.2008 22:34:58,tp 1.59050,0.0,-0.0,0.0,0.0,1.5916,22.09.2008 21:35:00,2217,-0.0,42.03,IS,0.41,0.0,Phase3-EA-SA2v2-EURCHF-M5-43,EURCHFMT4,1254,59m 58s,Sell
23874.01,1.07292,22.09.2008 23:14:58,tp 1.07292,0.0,-0.0,0.0,0.0,1.07192,22.09.2008 22:45:00,2218,-0.0,54.06,IS,0.58,0.0,Phase3-EA-SA2v2-USDCHF-M15-107,USDCHFMT4,560,29m 58s,Buy
23915.1,1.58942,23.09.2008 01:54:57,tp 1.58942,-0.92,-0.0,0.0,0.0,1.58832,22.09.2008 23:25:00,2219,-0.0,41.09,IS,0.41,0.0,Phase3-EA-SA2v2-EURCHF-M5-43,EURCHFMT4,1256,2h 29m,Buy
24000.2,195.6,23.09.2008 03:39:57,tp 195.600,0.0,-0.0,0.0,0.0,195.99,23.09.2008 02:15:00,2220,-0.0,85.1,IS,0.23,0.0,Phase3-EA-S4v1-GBPJPY-M5-194,GBPJPYMT4,640,1h 24m,Sell
24126.45,1.59232,23.09.2008 08:29:58,tp 1.59232,0.0,-0.0,0.0,0.0,1.58832,23.09.2008 01:30:00,2221,-0.0,126.25,IS,0.34,0.0,Phase3-EA-S4v1-EURCHF-M15-221,EURCHFMT4,670,6h 59m,Buy
23940.52,1.5945,23.09.2008 10:04:57,sl 1.59450,0.0,-185.92999999999302,0.0,0.0,1.5896,23.09.2008 02:50:00,2222,-0.1629157833262955,-185.93,IS,0.41,0.0,Phase3-EA-SA2v2-EURCHF-M5-43,EURCHFMT4,1258,7h 14m,Sell
23952.76,105.91,23.09.2008 20:15:00,,0.0,-173.68999999998778,0.0,0.0,105862,23.09.2008 20:00:00,2223,-0.1521908374438947,12.24,IS,0.27,0.0,Phase3-EA-S1v2-USDJPY-M15-0,USDJPYMT4,872,15m 0s,Buy
23994.21,1.59292,23.09.2008 20:59:58,tp 1.59292,0.0,-132.2399999999907,0.0,0.0,1.59182,23.09.2008 20:55:00,2224,-0.11587147414117469,41.45,IS,0.41,0.0,Phase3-EA-SA2v2-EURCHF-M5-43,EURCHFMT4,1260,4m 58s,Buy
24035.88,1.5913,23.09.2008 23:04:58,tp 1.59130,0.0,-90.56999999999243,0.0,0.0,1.5924,23.09.2008 22:15:00,2225,-0.07935934220331256,41.67,IS,0.41,0.0,Phase3-EA-SA2v2-EURCHF-M5-43,EURCHFMT4,1262,49m 58s,Sell
24089.3,1.0857,24.09.2008 00:59:59,tp 1.08570,0.0,-37.14999999999418,0.0,0.0,1.0867,24.09.2008 00:15:00,2226,-0.03255161270677759,53.42,IS,0.58,0.0,Phase3-EA-SA2v2-USDCHF-M15-107,USDCHFMT4,562,44m 59s,Sell
24118.66,105.83,24.09.2008 01:15:00,,-0.74,-7.789999999993597,0.0,0.0,105712,23.09.2008 20:45:00,2227,-0.006825762126127287,29.36,IS,0.27,0.0,Phase3-EA-S1v2-USDJPY-M15-0,USDJPYMT4,874,4h 30m,Buy
24203.8,195.5,24.09.2008 04:04:58,tp 195.500,0.0,-0.0,0.0,0.0,195.89,24.09.2008 01:20:00,2228,-0.0,85.14,IS,0.23,0.0,Phase3-EA-S4v1-GBPJPY-M5-194,GBPJPYMT4,642,2h 44m,Sell
24146.44,1.59522,24.09.2008 09:35:00,,0.0,-57.36000000000058,0.0,0.0,1.5937,24.09.2008 01:15:00,2229,-0.05022599948513147,-57.36,IS,0.41,0.0,Phase3-EA-SA2v2-EURCHF-M5-43,EURCHFMT4,1264,8h 20m,Sell
24089.49,1.59482,24.09.2008 11:15:00,,0.0,-114.30999999999767,0.0,0.0,1593,24.09.2008 02:30:00,2230,-0.10009299165176434,-56.95,IS,0.34,0.0,Phase3-EA-S4v1-EURCHF-M15-221,EURCHFMT4,672,8h 45m,Sell
24130.84,1.5954,24.09.2008 22:44:57,tp 1.59540,0.0,-72.95999999999185,0.0,0.0,1.5965,24.09.2008 20:30:00,2231,-0.06388579014007575,41.35,IS,0.41,0.0,Phase3-EA-SA2v2-EURCHF-M5-43,EURCHFMT4,1266,2h 14m,Sell
24153.22,106.16,24.09.2008 23:15:00,,0.0,-50.579999999987194,0.0,0.0,106072,24.09.2008 23:00:00,2232,-0.044289244315852176,22.38,IS,0.27,0.0,Phase3-EA-S1v2-USDJPY-M15-0,USDJPYMT4,876,15m 0s,Buy
24197.95,1.0906,25.09.2008 01:59:57,tp 1.09060,-8.45,-5.849999999991269,0.0,0.0,1.0916,24.09.2008 23:45:00,2233,-0.00512242149559933,44.73,IS,0.58,0.0,Phase3-EA-SA2v2-USDCHF-M15-107,USDCHFMT4,564,2h 14m,Sell
23989.84,1.08692,25.09.2008 04:29:57,sl 1.08692,0.0,-213.95999999999185,0.0,0.0,1.09082,25.09.2008 02:00:00,2234,-0.18734928259829517,-208.11,IS,0.58,0.0,Phase3-EA-SA2v2-USDCHF-M15-107,USDCHFMT4,566,2h 29m,Buy
24031.45,1.59592,25.09.2008 08:29:58,tp 1.59592,0.0,-172.34999999999127,0.0,0.0,1.59482,25.09.2008 02:45:00,2235,-0.15091441790902863,41.61,IS,0.41,0.0,Phase3-EA-SA2v2-EURCHF-M5-43,EURCHFMT4,1268,5h 44m,Buy
24040.24,1.5945,25.09.2008 12:30:00,,0.0,-163.55999999999767,0.0,0.0,1.59422,25.09.2008 03:45:00,2236,-0.14321765125153246,8.79,IS,0.34,0.0,Phase3-EA-S4v1-EURCHF-M15-221,EURCHFMT4,674,8h 45m,Buy
24141.77,106372,25.09.2008 17:14:58,tp 106.372,0.0,-62.029999999998836,0.0,0.0,105972,25.09.2008 17:00:00,2237,-0.05431518040555465,101.53,IS,0.27,0.0,Phase3-EA-S1v2-USDJPY-M15-0,USDJPYMT4,878,14m 58s,Buy
23933.1,1.08402,26.09.2008 03:44:58,sl 1.08402,0.0,-270.6999999999971,0.0,0.0,1.08792,26.09.2008 01:45:00,2238,-0.23703239296765696,-208.67,IS,0.58,0.0,Phase3-EA-SA2v2-USDCHF-M15-107,USDCHFMT4,568,1h 59m,Buy
23720.16,105602,26.09.2008 08:14:58,sl 105.602,-0.73,-483.6399999999994,0.0,0.0,106432,25.09.2008 22:00:00,2239,-0.4234885354077529,-212.94,IS,0.27,0.0,Phase3-EA-S1v2-USDJPY-M15-0,USDJPYMT4,880,10h 14m,Buy
23602.39,1.5898,26.09.2008 09:15:00,,0.0,-601.4100000000035,0.0,0.0,1.59292,26.09.2008 00:55:00,2240,-0.5266111985765827,-117.77,IS,0.41,0.0,Phase3-EA-SA2v2-EURCHF-M5-43,EURCHFMT4,1270,8h 20m,Buy
23480.39,1.58822,26.09.2008 10:29:58,sl 1.58822,0.0,-723.4100000000035,0.0,0.0,1.59212,26.09.2008 01:45:00,2241,-0.6334377665191555,-122.0,IS,0.34,0.0,Phase3-EA-S4v1-EURCHF-M15-221,EURCHFMT4,676,8h 44m,Buy
23423.2,194.5,26.09.2008 16:59:58,sl 194.500,0.0,-780.6000000000058,0.0,0.0,193.83,26.09.2008 10:30:00,2242,-0.6835149093112538,-57.19,IS,0.09,0.0,Phase3-EA-B1v1-GBPJPY-M30-1,GBPJPYMT4,290,6h 29m,Sell
23464.64,1.5908,26.09.2008 21:09:59,tp 1.59080,0.0,-739.1600000000035,0.0,0.0,1.5919,26.09.2008 20:50:00,2243,-0.6472289013150204,41.44,IS,0.41,0.0,Phase3-EA-SA2v2-EURCHF-M5-43,EURCHFMT4,1272,19m 59s,Sell
23506.05,1.5917,26.09.2008 23:34:57,tp 1.59170,0.0,-697.75,0.0,0.0,1.5928,26.09.2008 22:35:00,2244,-0.6109691621469687,41.41,IS,0.41,0.0,Phase3-EA-SA2v2-EURCHF-M5-43,EURCHFMT4,1274,59m 57s,Sell
23538.54,106.37,29.09.2008 01:15:00,,0.0,-665.2599999999948,0.0,0.0,106242,29.09.2008 01:00:00,2245,-0.5825200212252085,32.49,IS,0.27,0.0,Phase3-EA-S1v2-USDJPY-M15-0,USDJPYMT4,882,15m 0s,Buy
23622.82,194982,29.09.2008 03:24:57,tp 194.982,0.0,-580.9799999999959,0.0,0.0,194592,29.09.2008 01:10:00,2246,-0.5087221265842256,84.28,IS,0.23,0.0,Phase3-EA-S4v1-GBPJPY-M5-194,GBPJPYMT4,644,2h 14m,Buy
23663.92,1.59042,29.09.2008 03:49:59,tp 1.59042,0.0,-539.8799999999901,0.0,0.0,1.58932,29.09.2008 01:30:00,2247,-0.47273383197405866,41.1,IS,0.41,0.0,Phase3-EA-SA2v2-EURCHF-M5-43,EURCHFMT4,1276,2h 19m,Buy
23543.11,1.58522,29.09.2008 09:44:57,sl 1.58522,0.0,-660.6899999999878,0.0,0.0,1.58912,29.09.2008 03:00:00,2248,-0.5785184030653863,-120.81,IS,0.34,0.0,Phase3-EA-S4v1-EURCHF-M15-221,EURCHFMT4,678,6h 44m,Buy
23701.41,189.21,29.09.2008 19:29:58,tp 189.210,0.0,-502.38999999998487,0.0,0.0,191.06,29.09.2008 14:30:00,2249,-0.4399065530218651,158.3,IS,0.09,0.0,Phase3-EA-B1v1-GBPJPY-M30-1,GBPJPYMT4,292,4h 59m,Sell
23742.91,1.57402,29.09.2008 22:04:58,tp 1.57402,0.0,-460.88999999998487,0.0,0.0,1.57292,29.09.2008 22:00:00,2250,-0.4035680073692686,41.5,IS,0.41,0.0,Phase3-EA-SA2v2-EURCHF-M5-43,EURCHFMT4,1278,4m 58s,Buy
23784.5,1.57132,29.09.2008 22:44:58,tp 1.57132,0.0,-419.29999999998836,0.0,0.0,1.57022,29.09.2008 22:35:00,2251,-0.36715065523212737,41.59,IS,0.41,0.0,Phase3-EA-SA2v2-EURCHF-M5-43,EURCHFMT4,1280,9m 58s,Buy
23944.42,186.8,30.09.2008 01:59:57,tp 186.800,-0.5,-259.3799999999901,0.0,0.0,188.65,29.09.2008 22:30:00,2252,-0.22712028846674984,159.92,IS,0.09,0.0,Phase3-EA-B1v1-GBPJPY-M30-1,GBPJPYMT4,294,3h 29m,Sell
24030.7,187312,30.09.2008 02:39:58,tp 187.312,0.0,-173.09999999999127,0.0,0.0,186922,30.09.2008 01:40:00,2253,-0.15157113861359361,86.28,IS,0.23,0.0,Phase3-EA-S4v1-GBPJPY-M5-194,GBPJPYMT4,646,59m 58s,Buy
23909.7,1.5774,30.09.2008 10:14:57,sl 1.57740,0.0,-294.09999999999127,0.0,0.0,1.5735,30.09.2008 06:00:00,2254,-0.2575220789500798,-121.0,IS,0.34,0.0,Phase3-EA-S4v1-EURCHF-M15-221,EURCHFMT4,680,4h 14m,Sell
23852.9,188722,30.09.2008 18:29:57,sl 188.722,0.0,-350.8999999999942,0.0,0.0,189392,30.09.2008 10:30:00,2255,-0.3072577269758047,-56.8,IS,0.09,0.0,Phase3-EA-B1v1-GBPJPY-M30-1,GBPJPYMT4,296,7h 59m,Buy
23904.62,1.12142,01.10.2008 01:44:58,tp 1.12142,0.0,-299.179999999993,0.0,0.0,1.12042,01.10.2008 00:45:00,2256,-0.26197026718900157,51.72,IS,0.58,0.0,Phase3-EA-SA2v2-USDCHF-M15-107,USDCHFMT4,570,59m 58s,Buy
24006.04,106492,01.10.2008 03:59:57,tp 106.492,0.0,-197.75999999999476,0.0,0.0,106092,01.10.2008 01:45:00,2257,-0.17316411537969378,101.42,IS,0.27,0.0,Phase3-EA-S1v2-USDJPY-M15-0,USDJPYMT4,884,2h 14m,Buy
24044.49,1579,01.10.2008 04:49:57,tp 1.57900,-1.83,-159.30999999999767,0.0,0.0,1.5801,30.09.2008 21:05:00,2258,-0.13949623392566415,38.45,IS,0.41,0.0,Phase3-EA-SA2v2-EURCHF-M5-43,EURCHFMT4,1282,7h 44m,Sell
24166.18,1.58192,01.10.2008 12:29:57,tp 1.58192,0.0,-37.61999999999534,0.0,0.0,1.57792,01.10.2008 06:00:00,2259,-0.03294111054097616,121.69,IS,0.34,0.0,Phase3-EA-S4v1-EURCHF-M15-221,EURCHFMT4,682,6h 29m,Buy
24206.26,1.5756,01.10.2008 23:39:57,tp 1.57560,0.0,-0.0,0.0,0.0,1.5767,01.10.2008 20:50:00,2260,-0.0,40.08,IS,0.41,0.0,Phase3-EA-SA2v2-EURCHF-M5-43,EURCHFMT4,1284,2h 49m,Sell
24243.13,105792,02.10.2008 00:15:00,,-3.45,-0.0,0.0,0.0,105.95,01.10.2008 21:30:00,2261,-0.0,36.87,IS,0.27,0.0,Phase3-EA-S1v2-USDJPY-M15-0,USDJPYMT4,886,2h 45m,Sell
24280.58,1.57832,02.10.2008 02:09:59,tp 1.57832,-2.62,-0.0,0.0,0.0,1.57722,01.10.2008 23:55:00,2262,-0.0,37.45,IS,0.41,0.0,Phase3-EA-SA2v2-EURCHF-M5-43,EURCHFMT4,1286,2h 14m,Buy
24346.27,106.05,02.10.2008 02:15:00,,0.0,-0.0,0.0,0.0,105792,02.10.2008 00:15:00,2263,-0.0,65.69,IS,0.27,0.0,Phase3-EA-S1v2-USDJPY-M15-0,USDJPYMT4,888,2h 0m,Buy
24430.87,187.26,02.10.2008 03:04:58,tp 187.260,0.0,-0.0,0.0,0.0,187.65,02.10.2008 02:35:00,2264,-0.0,84.6,IS,0.23,0.0,Phase3-EA-S4v1-GBPJPY-M5-194,GBPJPYMT4,648,29m 58s,Sell
24470.81,1577,02.10.2008 03:04:58,tp 1.57700,0.0,-0.0,0.0,0.0,1.5781,02.10.2008 02:20:00,2265,-0.0,39.94,IS,0.41,0.0,Phase3-EA-SA2v2-EURCHF-M5-43,EURCHFMT4,1288,44m 58s,Sell
24522.34,1.1256,02.10.2008 04:44:58,tp 1.12560,0.0,-0.0,0.0,0.0,1.1266,02.10.2008 02:30:00,2266,-0.0,51.53,IS,0.58,0.0,Phase3-EA-SA2v2-USDCHF-M15-107,USDCHFMT4,572,2h 14m,Sell
24643.05,1.5738,02.10.2008 05:14:58,tp 1.57380,0.0,-0.0,0.0,0.0,1.5778,02.10.2008 02:30:00,2267,-0.0,120.71,IS,0.34,0.0,Phase3-EA-S4v1-EURCHF-M15-221,EURCHFMT4,684,2h 44m,Sell
24555.37,1.5714,02.10.2008 14:15:00,,0.0,-87.67999999999302,0.0,0.0,1.57432,02.10.2008 05:30:00,2268,-0.07648086822532459,-87.68,IS,0.34,0.0,Phase3-EA-S4v1-EURCHF-M15-221,EURCHFMT4,686,8h 45m,Buy
24595.08,1.5711,02.10.2008 21:09:58,tp 1.57110,0.0,-47.96999999998661,0.0,0.0,1.5722,02.10.2008 20:50:00,2269,-0.04184292026423459,39.71,IS,0.41,0.0,Phase3-EA-SA2v2-EURCHF-M5-43,EURCHFMT4,1290,19m 58s,Sell
24609.97,105152,02.10.2008 23:15:00,,0.0,-33.079999999987194,0.0,0.0,105.21,02.10.2008 23:00:00,2270,-0.028854780119673355,14.89,IS,0.27,0.0,Phase3-EA-S1v2-USDJPY-M15-0,USDJPYMT4,890,15m 0s,Sell
24431.91,1.56472,03.10.2008 02:44:58,sl 1.56472,-0.87,-211.13999999998487,0.0,0.0,1.56962,02.10.2008 22:25:00,2271,-0.18417165279533718,-178.06,IS,0.41,0.0,Phase3-EA-SA2v2-EURCHF-M5-43,EURCHFMT4,1292,4h 19m,Buy
24471.67,1.56562,03.10.2008 03:09:57,tp 1.56562,0.0,-171.3799999999901,0.0,0.0,1.56452,03.10.2008 02:45:00,2272,-0.14949009120046095,39.76,IS,0.41,0.0,Phase3-EA-SA2v2-EURCHF-M5-43,EURCHFMT4,1294,24m 57s,Buy
24557.15,185392,03.10.2008 03:54:58,tp 185.392,0.0,-85.89999999999418,0.0,0.0,185002,03.10.2008 02:55:00,2273,-0.0749282228621745,85.48,IS,0.23,0.0,Phase3-EA-S4v1-GBPJPY-M5-194,GBPJPYMT4,650,59m 58s,Buy
24357.05,1.13042,03.10.2008 04:44:58,sl 1.13042,0.0,-286.0,0.0,0.0,1.13432,03.10.2008 02:45:00,2274,-0.2494699853152894,-200.1,IS,0.58,0.0,Phase3-EA-SA2v2-USDCHF-M15-107,USDCHFMT4,574,1h 59m,Buy
24477.24,1.56912,03.10.2008 07:14:57,tp 1.56912,0.0,-165.80999999999767,0.0,0.0,1.56512,03.10.2008 03:15:00,2275,-0.1446315323955509,120.19,IS,0.34,0.0,Phase3-EA-S4v1-EURCHF-M15-221,EURCHFMT4,688,3h 59m,Buy
24517.23,1.56082,03.10.2008 20:54:57,tp 1.56082,0.0,-125.81999999999243,0.0,0.0,1.55972,03.10.2008 20:50:00,2276,-0.10974934808520219,39.99,IS,0.41,0.0,Phase3-EA-SA2v2-EURCHF-M5-43,EURCHFMT4,1296,4m 57s,Buy
24619.54,105562,03.10.2008 20:59:57,tp 105.562,0.0,-23.50999999999476,0.0,0.0,105162,03.10.2008 20:45:00,2277,-0.020507130611052964,102.31,IS,0.27,0.0,Phase3-EA-S1v2-USDJPY-M15-0,USDJPYMT4,892,14m 57s,Buy
24440.63,1.55102,06.10.2008 01:00:00,sl 1.55102,-0.87,-202.41999999999825,0.0,0.0,1.55592,03.10.2008 23:10:00,2278,-0.1765654350612603,-178.91,IS,0.41,0.0,Phase3-EA-SA2v2-EURCHF-M5-43,EURCHFMT4,1298,2d 1h 50m,Buy
24526.06,185622,06.10.2008 01:34:58,tp 185.622,0.0,-116.99000000000524,0.0,0.0,185232,06.10.2008 01:15:00,2279,-0.10204718035677278,85.43,IS,0.23,0.0,Phase3-EA-S4v1-GBPJPY-M5-194,GBPJPYMT4,652,19m 58s,Buy
24349.01,1.54662,06.10.2008 02:04:57,sl 1.54662,0.0,-294.04000000000815,0.0,0.0,1.55152,06.10.2008 01:05:00,2280,-0.2564830576297543,-177.05,IS,0.41,0.0,Phase3-EA-SA2v2-EURCHF-M5-43,EURCHFMT4,1300,59m 57s,Buy
24134.01,104592,06.10.2008 02:44:57,sl 104.592,-0.74,-509.04000000000815,0.0,0.0,105422,03.10.2008 21:00:00,2281,-0.44402168295418515,-215.0,IS,0.27,0.0,Phase3-EA-S1v2-USDJPY-M15-0,USDJPYMT4,894,2d 5h 44m,Buy
23956.12,1.53932,06.10.2008 02:59:57,sl 1.53932,0.0,-686.9300000000076,0.0,0.0,1.54422,06.10.2008 02:25:00,2282,-0.5991902692749428,-177.89,IS,0.41,0.0,Phase3-EA-SA2v2-EURCHF-M5-43,EURCHFMT4,1302,34m 57s,Buy
23779.79,183822,06.10.2008 05:59:58,sl 183.822,0.0,-863.2600000000093,0.0,0.0,184622,06.10.2008 03:00:00,2283,-0.7529981102212555,-176.33,IS,0.23,0.0,Phase3-EA-S4v1-GBPJPY-M5-194,GBPJPYMT4,654,2h 59m,Buy
23941.93,178.76,06.10.2008 17:29:58,tp 178.760,0.0,-701.1200000000099,0.0,0.0,180.61,06.10.2008 16:30:00,2284,-0.6115678185463573,162.14,IS,0.09,0.0,Phase3-EA-B1v1-GBPJPY-M30-1,GBPJPYMT4,298,59m 58s,Sell
23722.22,102.0,06.10.2008 23:29:58,sl 102.000,0.0,-920.8300000000163,0.0,0.0,101.17,06.10.2008 22:30:00,2285,-0.8032148481744127,-219.71,IS,0.27,0.0,Phase3-EA-S1v2-USDJPY-M15-0,USDJPYMT4,896,59m 58s,Sell
23827.44,101.49,07.10.2008 00:29:58,tp 101.490,-1.19,-815.6100000000151,0.0,0.0,101.89,06.10.2008 23:30:00,2286,-0.7114343172133111,105.22,IS,0.27,0.0,Phase3-EA-S1v2-USDJPY-M15-0,USDJPYMT4,898,59m 58s,Sell
23865.09,1.5467,07.10.2008 03:54:58,tp 1.54670,-1.79,-777.960000000021,0.0,0.0,1.5478,06.10.2008 22:40:00,2287,-0.6785932509646426,37.65,IS,0.41,0.0,Phase3-EA-SA2v2-EURCHF-M5-43,EURCHFMT4,1304,5h 14m,Sell
23823.09,1.75812,07.10.2008 16:59:58,sl 1.75812,0.0,-819.960000000021,0.0,0.0,1.76112,07.10.2008 16:30:00,2288,-0.7152287033536012,-42.0,IS,0.14,0.0,Phase3-EA-B1v1-GBPUSD-M30-14,GBPUSDMT4,160,29m 58s,Buy
23862.59,1.55122,07.10.2008 20:54:57,tp 1.55122,0.0,-780.460000000021,0.0,0.0,1.55012,07.10.2008 20:50:00,2289,-0.6807739326544615,39.5,IS,0.41,0.0,Phase3-EA-SA2v2-EURCHF-M5-43,EURCHFMT4,1306,4m 57s,Buy
23641.44,101332,07.10.2008 22:44:58,sl 101.332,0.0,-1001.6100000000151,0.0,0.0,102162,07.10.2008 19:15:00,2290,-0.873677034935842,-221.15,IS,0.27,0.0,Phase3-EA-S1v2-USDJPY-M15-0,USDJPYMT4,900,3h 29m,Buy
23681.05,1.55022,07.10.2008 23:19:57,tp 1.55022,0.0,-962.0000000000146,0.0,0.0,1.54912,07.10.2008 23:15:00,2291,-0.8391263142423498,39.61,IS,0.41,0.0,Phase3-EA-SA2v2-EURCHF-M5-43,EURCHFMT4,1308,4m 57s,Buy
23720.7,1.54972,08.10.2008 00:44:57,tp 1.54972,0.0,-922.3500000000204,0.0,0.0,1.54862,08.10.2008 00:30:00,2292,-0.8045407026418261,39.65,IS,0.41,0.0,Phase3-EA-SA2v2-EURCHF-M5-43,EURCHFMT4,1310,14m 57s,Buy
23808.44,177512,08.10.2008 00:44:59,tp 177.512,-0.82,-834.6100000000151,0.0,0.0,177122,07.10.2008 23:00:00,2293,-0.7280074980559352,87.74,IS,0.23,0.0,Phase3-EA-S4v1-GBPJPY-M5-194,GBPJPYMT4,656,1h 44m,Buy
23896.84,177.58,08.10.2008 01:14:57,tp 177.580,0.0,-746.210000000021,0.0,0.0,177.97,08.10.2008 00:55:00,2294,-0.6508985935039417,88.4,IS,0.23,0.0,Phase3-EA-S4v1-GBPJPY-M5-194,GBPJPYMT4,658,19m 57s,Sell
24003.6,101.16,08.10.2008 02:59:58,tp 101.160,0.0,-639.4500000000262,0.0,0.0,101.56,08.10.2008 01:00:00,2295,-0.5577747626219173,106.76,IS,0.27,0.0,Phase3-EA-S1v2-USDJPY-M15-0,USDJPYMT4,902,1h 59m,Sell
24123.0,1.5469,08.10.2008 08:29:58,tp 1.54690,0.0,-520.050000000032,0.0,0.0,1.5509,08.10.2008 03:45:00,2296,-0.4536254051161687,119.4,IS,0.34,0.0,Phase3-EA-S4v1-EURCHF-M15-221,EURCHFMT4,690,4h 44m,Sell
24231.22,99.8,08.10.2008 17:29:58,tp 99.800,0.0,-411.83000000003085,0.0,0.0,100.2,08.10.2008 17:00:00,2297,-0.35922805612728437,108.22,IS,0.27,0.0,Phase3-EA-S1v2-USDJPY-M15-0,USDJPYMT4,904,29m 58s,Sell
24271.27,1.54202,08.10.2008 20:04:58,tp 1.54202,0.0,-371.78000000002794,0.0,0.0,1.54092,08.10.2008 20:00:00,2298,-0.32429353545638206,40.05,IS,0.41,0.0,Phase3-EA-SA2v2-EURCHF-M5-43,EURCHFMT4,1312,4m 58s,Buy
24379.45,99832,08.10.2008 20:14:58,tp 99.832,0.0,-263.6000000000349,0.0,0.0,99432,08.10.2008 19:30:00,2299,-0.22993107737454196,108.18,IS,0.27,0.0,Phase3-EA-S1v2-USDJPY-M15-0,USDJPYMT4,906,44m 58s,Buy
24487.67,99.8,08.10.2008 22:59:58,tp 99.800,0.0,-155.38000000003376,0.0,0.0,100.2,08.10.2008 21:30:00,2300,-0.13553372838565766,108.22,IS,0.27,0.0,Phase3-EA-S1v2-USDJPY-M15-0,USDJPYMT4,908,1h 29m,Sell
24299.12,171112,09.10.2008 00:04:58,sl 171.112,-2.51,-343.93000000003667,0.0,0.0,171912,08.10.2008 23:55:00,2301,-0.30000074143180644,-188.55,IS,0.23,0.0,Phase3-EA-S4v1-GBPJPY-M5-194,GBPJPYMT4,660,9m 58s,Buy
24339.12,1.53772,09.10.2008 01:04:57,tp 1.53772,0.0,-303.93000000003667,0.0,0.0,1.53662,09.10.2008 00:15:00,2302,-0.265109834394703,40.0,IS,0.41,0.0,Phase3-EA-SA2v2-EURCHF-M5-43,EURCHFMT4,1314,49m 57s,Buy
24429.3,172032,09.10.2008 01:59:57,tp 172.032,0.0,-213.75000000004366,0.0,0.0,171642,09.10.2008 00:15:00,2303,-0.18644828447955944,90.18,IS,0.23,0.0,Phase3-EA-S4v1-GBPJPY-M5-194,GBPJPYMT4,662,1h 44m,Buy
24549.68,1.54122,09.10.2008 05:44:58,tp 1.54122,0.0,-93.370000000039,0.0,0.0,1.53722,09.10.2008 01:00:00,2304,-0.08144409975139266,120.38,IS,0.34,0.0,Phase3-EA-S4v1-EURCHF-M15-221,EURCHFMT4,692,4h 44m,Buy
24601.17,1.1264,09.10.2008 06:44:57,tp 1.12640,0.0,-41.88000000003376,0.0,0.0,1.1274,09.10.2008 02:45:00,2305,-0.036530779667876725,51.49,IS,0.58,0.0,Phase3-EA-SA2v2-USDCHF-M15-107,USDCHFMT4,576,3h 59m,Sell
24708.62,100.51,09.10.2008 19:44:58,tp 100.510,0.0,-0.0,0.0,0.0,100.91,09.10.2008 18:45:00,2306,-0.0,107.45,IS,0.27,0.0,Phase3-EA-S1v2-USDJPY-M15-0,USDJPYMT4,910,59m 58s,Sell
24748.58,1.54242,09.10.2008 20:29:58,tp 1.54242,0.0,-0.0,0.0,0.0,1.54132,09.10.2008 20:25:00,2307,-0.0,39.96,IS,0.41,0.0,Phase3-EA-SA2v2-EURCHF-M5-43,EURCHFMT4,1316,4m 58s,Buy
24570.54,1.53642,09.10.2008 22:44:58,sl 1.53642,0.0,-178.0399999999936,0.0,0.0,1.54132,09.10.2008 22:10:00,2308,-0.15515660411657692,-178.04,IS,0.41,0.0,Phase3-EA-SA2v2-EURCHF-M5-43,EURCHFMT4,1318,34m 58s,Buy
24610.47,1.53902,09.10.2008 22:59:57,tp 1.53902,0.0,-138.11000000000058,0.0,0.0,1.53792,09.10.2008 22:55:00,2309,-0.12035878788216862,39.93,IS,0.41,0.0,Phase3-EA-SA2v2-EURCHF-M5-43,EURCHFMT4,1320,4m 57s,Buy
24661.84,1.12902,10.10.2008 01:59:57,tp 1.12902,0.0,-86.74000000000524,0.0,0.0,1.12802,10.10.2008 01:30:00,2310,-0.07559134936572219,51.37,IS,0.58,0.0,Phase3-EA-SA2v2-USDCHF-M15-107,USDCHFMT4,578,29m 57s,Buy
24475.55,167862,10.10.2008 03:14:58,sl 167.862,0.0,-273.02999999999884,0.0,0.0,168662,10.10.2008 03:00:00,2311,-0.23793758493569053,-186.29,IS,0.23,0.0,Phase3-EA-S4v1-GBPJPY-M5-194,GBPJPYMT4,664,14m 58s,Buy
24566.68,167942,10.10.2008 03:29:58,tp 167.942,0.0,-181.89999999999418,0.0,0.0,167552,10.10.2008 03:20:00,2312,-0.15852048016628542,91.13,IS,0.23,0.0,Phase3-EA-S4v1-GBPJPY-M5-194,GBPJPYMT4,666,9m 58s,Buy
24388.66,1.53102,10.10.2008 03:39:58,sl 1.53102,0.0,-359.91999999999825,0.0,0.0,1.53592,10.10.2008 00:15:00,2313,-0.3136596548732875,-178.02,IS,0.41,0.0,Phase3-EA-SA2v2-EURCHF-M5-43,EURCHFMT4,1322,3h 24m,Buy
24271.19,1.53042,10.10.2008 04:14:57,sl 1.53042,0.0,-477.3899999999994,0.0,0.0,1.53432,10.10.2008 01:30:00,2314,-0.4160312920647901,-117.47,IS,0.34,0.0,Phase3-EA-S4v1-EURCHF-M15-221,EURCHFMT4,694,2h 44m,Buy
24210.11,167.56,10.10.2008 07:59:57,sl 167.560,0.0,-538.4700000000012,0.0,0.0,166.89,10.10.2008 07:30:00,2315,-0.469260708934264,-61.08,IS,0.09,0.0,Phase3-EA-B1v1-GBPJPY-M30-1,GBPJPYMT4,300,29m 57s,Sell
24250.09,1518,10.10.2008 20:09:59,tp 1.51800,0.0,-498.49000000000524,0.0,0.0,1.5191,10.10.2008 20:05:00,2316,-0.4344193191758932,39.98,IS,0.41,0.0,Phase3-EA-SA2v2-EURCHF-M5-43,EURCHFMT4,1324,4m 59s,Sell
24358.45,99672,10.10.2008 21:14:58,tp 99.672,0.0,-390.13000000000466,0.0,0.0,99272,10.10.2008 21:00:00,2317,-0.3399867780498936,108.36,IS,0.27,0.0,Phase3-EA-S1v2-USDJPY-M15-0,USDJPYMT4,912,14m 58s,Buy
24444.29,100.02,10.10.2008 22:00:00,,0.0,-304.29000000000815,0.0,0.0,99702,10.10.2008 21:15:00,2318,-0.2651797521154581,85.84,IS,0.27,0.0,Phase3-EA-S1v2-USDJPY-M15-0,USDJPYMT4,914,45m 0s,Buy
24483.98,1.51322,10.10.2008 22:04:58,tp 1.51322,0.0,-264.6000000000058,0.0,0.0,1.51212,10.10.2008 22:00:00,2319,-0.2305910887960494,39.69,IS,0.41,0.0,Phase3-EA-SA2v2-EURCHF-M5-43,EURCHFMT4,1326,4m 58s,Buy
24523.71,1.5232,10.10.2008 22:44:57,tp 1.52320,0.0,-224.8700000000099,0.0,0.0,1.5243,10.10.2008 22:40:00,2320,-0.19596756665747836,39.73,IS,0.41,0.0,Phase3-EA-SA2v2-EURCHF-M5-43,EURCHFMT4,1328,4m 57s,Sell
24612.58,172.77,13.10.2008 01:34:59,tp 172.770,0.0,-136.00000000001455,0.0,0.0,173.16,13.10.2008 01:25:00,2321,-0.11851998517107099,88.87,IS,0.23,0.0,Phase3-EA-S4v1-GBPJPY-M5-194,GBPJPYMT4,668,9m 59s,Sell
24663.92,1.12972,13.10.2008 02:59:58,tp 1.12972,0.0,-84.66000000001804,0.0,0.0,1.12872,13.10.2008 01:45:00,2322,-0.07377869076899952,51.34,IS,0.58,0.0,Phase3-EA-SA2v2-USDCHF-M15-107,USDCHFMT4,580,1h 14m,Buy
24703.74,1.5349,13.10.2008 05:39:58,tp 1.53490,0.0,-44.84000000001106,0.0,0.0,1536,13.10.2008 01:30:00,2323,-0.03907673628729092,39.82,IS,0.41,0.0,Phase3-EA-SA2v2-EURCHF-M5-43,EURCHFMT4,1330,4h 9m,Sell
24586.77,1541,13.10.2008 09:14:58,sl 1.54100,0.0,-161.81000000001222,0.0,0.0,1.5371,13.10.2008 04:15:00,2324,-0.14101263823919408,-116.97,IS,0.34,0.0,Phase3-EA-S4v1-EURCHF-M15-221,EURCHFMT4,696,4h 59m,Sell
24544.77,1.71562,13.10.2008 09:59:58,sl 1.71562,0.0,-203.81000000001222,0.0,0.0,1.71862,13.10.2008 09:30:00,2325,-0.17761439836555032,-42.0,IS,0.14,0.0,Phase3-EA-B1v1-GBPUSD-M30-14,GBPUSDMT4,162,29m 58s,Buy
24323.46,101.26,13.10.2008 19:59:57,sl 101.260,0.0,-425.1200000000099,0.0,0.0,100.43,13.10.2008 17:00:00,2326,-0.37047953011706974,-221.31,IS,0.27,0.0,Phase3-EA-S1v2-USDJPY-M15-0,USDJPYMT4,916,2h 59m,Sell
24143.1,177.48,13.10.2008 23:24:58,sl 177.480,0.0,-605.4800000000105,0.0,0.0,176.68,13.10.2008 23:05:00,2327,-0.5276579457453943,-180.36,IS,0.23,0.0,Phase3-EA-S4v1-GBPJPY-M5-194,GBPJPYMT4,670,19m 58s,Sell
24182.75,1.5446,13.10.2008 23:29:58,tp 1.54460,0.0,-565.8300000000163,0.0,0.0,1.5457,13.10.2008 22:50:00,2328,-0.4931041412451607,39.65,IS,0.41,0.0,Phase3-EA-SA2v2-EURCHF-M5-43,EURCHFMT4,1332,39m 58s,Sell
24345.63,177622,14.10.2008 00:59:57,tp 177.622,-0.32,-402.95000000001164,0.0,0.0,175772,13.10.2008 22:30:00,2329,-0.3511590295932303,162.88,IS,0.09,0.0,Phase3-EA-B1v1-GBPJPY-M30-1,GBPJPYMT4,302,2h 29m,Buy
24165.84,178.76,14.10.2008 02:49:58,sl 178.760,0.0,-582.7400000000052,0.0,0.0,177.96,14.10.2008 01:40:00,2330,-0.5078407070484054,-179.79,IS,0.23,0.0,Phase3-EA-S4v1-GBPJPY-M5-194,GBPJPYMT4,672,1h 9m,Sell
24253.0,179.37,14.10.2008 03:54:58,tp 179.370,0.0,-495.58000000000175,0.0,0.0,179.76,14.10.2008 03:30:00,2331,-0.4318833400814212,87.16,IS,0.23,0.0,Phase3-EA-S4v1-GBPJPY-M5-194,GBPJPYMT4,674,24m 58s,Sell
24517.07,1.75212,14.10.2008 06:59:58,tp 1.75212,-0.53,-231.50999999999476,0.0,0.0,1.73322,13.10.2008 22:30:00,2332,-0.20175413063934625,264.07,IS,0.14,0.0,Phase3-EA-B1v1-GBPUSD-M30-14,GBPUSDMT4,164,8h 29m,Buy
24339.66,1.5518,14.10.2008 08:54:58,sl 1.55180,0.0,-408.91999999999825,0.0,0.0,1.5469,14.10.2008 02:20:00,2333,-0.35636170835403647,-177.41,IS,0.41,0.0,Phase3-EA-SA2v2-EURCHF-M5-43,EURCHFMT4,1334,6h 34m,Sell
24222.55,1.5507,14.10.2008 08:59:58,sl 1.55070,0.0,-526.0299999999988,0.0,0.0,1.5468,14.10.2008 01:15:00,2334,-0.45841961617302696,-117.11,IS,0.34,0.0,Phase3-EA-S4v1-EURCHF-M15-221,EURCHFMT4,698,7h 44m,Sell
24163.81,179392,14.10.2008 17:29:58,sl 179.392,0.0,-584.7700000000041,0.0,0.0,180062,14.10.2008 13:30:00,2335,-0.5096097921211783,-58.74,IS,0.09,0.0,Phase3-EA-B1v1-GBPJPY-M30-1,GBPJPYMT4,304,3h 59m,Buy
24203.64,1.5486,14.10.2008 21:09:58,tp 1.54860,0.0,-544.9400000000023,0.0,0.0,1.5497,14.10.2008 20:40:00,2336,-0.4748991229346823,39.83,IS,0.41,0.0,Phase3-EA-SA2v2-EURCHF-M5-43,EURCHFMT4,1336,29m 58s,Sell
24243.43,1.54772,14.10.2008 22:14:58,tp 1.54772,0.0,-505.15000000000873,0.0,0.0,1.54662,14.10.2008 21:50:00,2337,-0.4402233125673613,39.79,IS,0.41,0.0,Phase3-EA-SA2v2-EURCHF-M5-43,EURCHFMT4,1338,24m 58s,Buy
24061.53,176082,15.10.2008 04:14:58,sl 176.082,0.0,-687.0500000000029,0.0,0.0,176882,15.10.2008 02:50:00,2338,-0.5987437927336468,-181.9,IS,0.23,0.0,Phase3-EA-S4v1-GBPJPY-M5-194,GBPJPYMT4,676,1h 24m,Buy
24101.17,1.54762,15.10.2008 09:04:58,tp 1.54762,0.0,-647.4100000000035,0.0,0.0,1.54652,15.10.2008 02:15:00,2339,-0.5641987029382005,39.64,IS,0.41,0.0,Phase3-EA-SA2v2-EURCHF-M5-43,EURCHFMT4,1340,6h 49m,Buy
24220.6,1.54962,15.10.2008 11:44:57,tp 1.54962,0.0,-527.9800000000105,0.0,0.0,1.54562,15.10.2008 03:30:00,2340,-0.46011898360747505,119.43,IS,0.34,0.0,Phase3-EA-S4v1-EURCHF-M15-221,EURCHFMT4,700,8h 14m,Buy
24327.62,100.92,15.10.2008 20:44:58,tp 100.920,0.0,-420.9600000000064,0.0,0.0,101.32,15.10.2008 17:00:00,2341,-0.366854212923599,107.02,IS,0.27,0.0,Phase3-EA-S1v2-USDJPY-M15-0,USDJPYMT4,918,3h 44m,Sell
24367.39,1.53492,15.10.2008 21:24:58,tp 1.53492,0.0,-381.1900000000023,0.0,0.0,1.53382,15.10.2008 20:30:00,2342,-0.3321958319658529,39.77,IS,0.41,0.0,Phase3-EA-SA2v2-EURCHF-M5-43,EURCHFMT4,1342,54m 58s,Buy
24456.99,173262,15.10.2008 23:34:57,tp 173.262,0.0,-291.5899999999965,0.0,0.0,172872,15.10.2008 23:20:00,2343,-0.2541120770296212,89.6,IS,0.23,0.0,Phase3-EA-S4v1-GBPJPY-M5-194,GBPJPYMT4,678,14m 57s,Buy
24719.53,1.7187,16.10.2008 00:29:57,tp 1.71870,-2.06,-29.05000000000291,0.0,0.0,1.7376,15.10.2008 19:30:00,2344,-0.02531621742073227,262.54,IS,0.14,0.0,Phase3-EA-B1v1-GBPUSD-M30-14,GBPUSDMT4,166,4h 59m,Sell
24539.65,1.52512,16.10.2008 00:30:00,sl 1.52512,-2.61,-208.93000000000757,0.0,0.0,1.53002,15.10.2008 23:05:00,2345,-0.18207632721904493,-179.88,IS,0.41,0.0,Phase3-EA-SA2v2-EURCHF-M5-43,EURCHFMT4,1344,1h 25m,Buy
24355.16,170932,16.10.2008 00:54:57,sl 170.932,0.0,-393.4200000000128,0.0,0.0,171732,16.10.2008 00:35:00,2346,-0.3428539159264653,-184.49,IS,0.23,0.0,Phase3-EA-S4v1-GBPJPY-M5-194,GBPJPYMT4,680,19m 57s,Buy
24394.97,1.52752,16.10.2008 03:34:58,tp 1.52752,0.0,-353.61000000001513,0.0,0.0,1.52642,16.10.2008 00:35:00,2347,-0.3081606761495568,39.81,IS,0.41,0.0,Phase3-EA-SA2v2-EURCHF-M5-43,EURCHFMT4,1346,2h 59m,Buy
24515.01,1.52932,16.10.2008 03:44:58,tp 1.52932,0.0,-233.57000000002154,0.0,0.0,1.52532,16.10.2008 01:30:00,2348,-0.20354935982651942,120.04,IS,0.34,0.0,Phase3-EA-S4v1-EURCHF-M15-221,EURCHFMT4,702,2h 14m,Buy
24330.97,173.15,16.10.2008 04:59:59,sl 173.150,0.0,-417.61000000001513,0.0,0.0,172.35,16.10.2008 03:50:00,2349,-0.3639347868182901,-184.04,IS,0.23,0.0,Phase3-EA-S4v1-GBPJPY-M5-194,GBPJPYMT4,682,1h 9m,Sell
24370.66,1.5224,16.10.2008 20:39:58,tp 1.52240,0.0,-377.9200000000128,0.0,0.0,1.5235,16.10.2008 20:25:00,2350,-0.3293461234988814,39.69,IS,0.41,0.0,Phase3-EA-SA2v2-EURCHF-M5-43,EURCHFMT4,1348,14m 58s,Sell
24477.59,101002,16.10.2008 21:59:58,tp 101.002,0.0,-270.9900000000198,0.0,0.0,100602,16.10.2008 19:45:00,2351,-0.23615978515814293,106.93,IS,0.27,0.0,Phase3-EA-S1v2-USDJPY-M15-0,USDJPYMT4,920,2h 14m,Buy
24300.76,1.5303,16.10.2008 23:09:59,sl 1.53030,0.0,-447.82000000002154,0.0,0.0,1.5254,16.10.2008 21:25:00,2352,-0.39026190999489624,-176.83,IS,0.41,0.0,Phase3-EA-SA2v2-EURCHF-M5-43,EURCHFMT4,1350,1h 44m,Sell
24389.27,175802,17.10.2008 02:09:57,tp 175.802,0.0,-359.3100000000268,0.0,0.0,175412,17.10.2008 01:55:00,2353,-0.313128057881001,88.51,IS,0.23,0.0,Phase3-EA-S4v1-GBPJPY-M5-194,GBPJPYMT4,684,14m 57s,Buy
24427.2,1.5285,17.10.2008 04:29:58,tp 1.52850,-1.8,-321.38000000003376,0.0,0.0,1.5296,16.10.2008 23:15:00,2354,-0.2800731826049906,37.93,IS,0.41,0.0,Phase3-EA-SA2v2-EURCHF-M5-43,EURCHFMT4,1352,5h 14m,Sell
24381.7,1.53192,17.10.2008 09:45:00,,0.0,-366.88000000003376,0.0,0.0,1.5304,17.10.2008 01:00:00,2355,-0.3197250894085432,-45.5,IS,0.34,0.0,Phase3-EA-S4v1-EURCHF-M15-221,EURCHFMT4,704,8h 45m,Sell
24339.7,1.72862,17.10.2008 10:59:59,sl 1.72862,0.0,-408.88000000003376,0.0,0.0,1.73162,17.10.2008 05:00:00,2356,-0.35632684953489946,-42.0,IS,0.14,0.0,Phase3-EA-B1v1-GBPUSD-M30-14,GBPUSDMT4,168,5h 59m,Buy
24379.47,1.5262,17.10.2008 20:04:58,tp 1.52620,0.0,-369.1100000000297,0.0,0.0,1.5273,17.10.2008 20:00:00,2357,-0.3216684685771533,39.77,IS,0.41,0.0,Phase3-EA-SA2v2-EURCHF-M5-43,EURCHFMT4,1354,4m 58s,Sell
24419.26,1.5282,17.10.2008 20:54:58,tp 1.52820,0.0,-329.3200000000361,0.0,0.0,1.5293,17.10.2008 20:45:00,2358,-0.28699265820983233,39.79,IS,0.41,0.0,Phase3-EA-SA2v2-EURCHF-M5-43,EURCHFMT4,1356,9m 58s,Sell
24459.0,1.52432,17.10.2008 22:34:58,tp 1.52432,0.0,-289.58000000003085,0.0,0.0,1.52322,17.10.2008 22:25:00,2359,-0.2523604213664612,39.74,IS,0.41,0.0,Phase3-EA-SA2v2-EURCHF-M5-43,EURCHFMT4,1358,9m 58s,Buy
24348.21,101502,20.10.2008 03:15:00,,-1.2,-400.37000000002445,0.0,0.0,101.09,17.10.2008 17:00:00,2360,-0.34891063575690817,-110.79,IS,0.27,0.0,Phase3-EA-S1v2-USDJPY-M15-0,USDJPYMT4,922,2d 10h 15m,Sell
24171.25,1.5299,20.10.2008 08:54:58,sl 1.52990,0.0,-577.3300000000309,0.0,0.0,1525,20.10.2008 02:35:00,2361,-0.5031260517559614,-176.96,IS,0.41,0.0,Phase3-EA-SA2v2-EURCHF-M5-43,EURCHFMT4,1360,6h 19m,Sell
24054.44,1.5304,20.10.2008 08:59:59,sl 1.53040,0.0,-694.1400000000285,0.0,0.0,1.5265,20.10.2008 04:30:00,2362,-0.6049225184311897,-116.81,IS,0.34,0.0,Phase3-EA-S4v1-EURCHF-M15-221,EURCHFMT4,706,4h 29m,Sell
23995.43,178242,20.10.2008 13:29:58,sl 178.242,0.0,-753.1500000000233,0.0,0.0,178912,20.10.2008 12:30:00,2363,-0.6563479914087156,-59.01,IS,0.09,0.0,Phase3-EA-B1v1-GBPJPY-M30-1,GBPJPYMT4,306,59m 58s,Buy
24048.1,101502,20.10.2008 18:15:00,,0.0,-700.480000000025,0.0,0.0,101.7,20.10.2008 17:15:00,2364,-0.6104476412693081,52.67,IS,0.27,0.0,Phase3-EA-S1v2-USDJPY-M15-0,USDJPYMT4,924,1h 0m,Sell
24087.31,1533,20.10.2008 23:09:57,tp 1.53300,0.0,-661.2700000000186,0.0,0.0,1.5341,20.10.2008 22:45:00,2365,-0.5762772837799113,39.21,IS,0.41,0.0,Phase3-EA-SA2v2-EURCHF-M5-43,EURCHFMT4,1362,24m 57s,Sell
24175.24,174.98,21.10.2008 03:39:58,tp 174.980,0.0,-573.3400000000256,0.0,0.0,175.37,21.10.2008 03:10:00,2366,-0.499648884543953,87.93,IS,0.23,0.0,Phase3-EA-S4v1-GBPJPY-M5-194,GBPJPYMT4,686,29m 58s,Sell
24139.07,101892,21.10.2008 04:00:00,,-1.19,-609.5100000000239,0.0,0.0,101.76,20.10.2008 19:00:00,2367,-0.5311699717765778,-36.17,IS,0.27,0.0,Phase3-EA-S1v2-USDJPY-M15-0,USDJPYMT4,926,9h 0m,Sell
24079.2,171.72,21.10.2008 16:29:58,sl 171.720,0.0,-669.3800000000192,0.0,0.0,171.05,21.10.2008 16:00:00,2368,-0.5833449093662153,-59.87,IS,0.09,0.0,Phase3-EA-B1v1-GBPJPY-M30-1,GBPJPYMT4,308,29m 58s,Sell
24343.8,1.6928,21.10.2008 18:59:59,tp 1.69280,0.0,-404.7800000000134,0.0,0.0,1.7117,21.10.2008 10:00:00,2369,-0.35275382057016597,264.6,IS,0.14,0.0,Phase3-EA-B1v1-GBPUSD-M30-14,GBPUSDMT4,170,8h 59m,Sell
24283.72,169.7,21.10.2008 19:59:57,sl 169.700,0.0,-464.86000000001513,0.0,0.0,169.03,21.10.2008 19:00:00,2370,-0.4051117669604409,-60.08,IS,0.09,0.0,Phase3-EA-B1v1-GBPJPY-M30-1,GBPJPYMT4,310,59m 57s,Sell
24322.74,1.51432,21.10.2008 20:29:58,tp 1.51432,0.0,-425.84000000001106,0.0,0.0,1.51322,21.10.2008 20:00:00,2371,-0.371106988862094,39.02,IS,0.41,0.0,Phase3-EA-SA2v2-EURCHF-M5-43,EURCHFMT4,1364,29m 58s,Buy
24361.84,1.51352,21.10.2008 21:29:57,tp 1.51352,0.0,-386.74000000000524,0.0,0.0,1.51242,21.10.2008 21:05:00,2372,-0.33703249312540967,39.1,IS,0.41,0.0,Phase3-EA-SA2v2-EURCHF-M5-43,EURCHFMT4,1366,24m 57s,Buy
24187.24,1.50642,21.10.2008 22:24:58,sl 1.50642,0.0,-561.3400000000111,0.0,0.0,1.51132,21.10.2008 22:00:00,2373,-0.4891912387935528,-174.6,IS,0.41,0.0,Phase3-EA-SA2v2-EURCHF-M5-43,EURCHFMT4,1368,24m 58s,Buy
24237.55,1.15292,21.10.2008 22:59:58,tp 1.15292,0.0,-511.0300000000134,0.0,0.0,1.15192,21.10.2008 22:15:00,2374,-0.44534755898505524,50.31,IS,0.58,0.0,Phase3-EA-SA2v2-USDCHF-M15-107,USDCHFMT4,582,44m 58s,Buy
24345.27,100.26,21.10.2008 22:59:58,tp 100.260,0.0,-403.3100000000122,0.0,0.0,100.66,21.10.2008 22:15:00,2375,-0.3514727589657425,107.72,IS,0.27,0.0,Phase3-EA-S1v2-USDJPY-M15-0,USDJPYMT4,928,44m 58s,Sell
24384.42,1.50652,21.10.2008 22:59:58,tp 1.50652,0.0,-364.16000000001804,0.0,0.0,1.50542,21.10.2008 22:35:00,2376,-0.31735468970510833,39.15,IS,0.41,0.0,Phase3-EA-SA2v2-EURCHF-M5-43,EURCHFMT4,1370,24m 58s,Buy
24422.72,1.50532,22.10.2008 00:19:58,tp 1.50532,-0.85,-325.86000000001513,0.0,0.0,1.50422,21.10.2008 23:50:00,2377,-0.2839773703517857,38.3,IS,0.41,0.0,Phase3-EA-SA2v2-EURCHF-M5-43,EURCHFMT4,1372,29m 58s,Buy
24512.0,167552,22.10.2008 02:19:57,tp 167.552,0.0,-236.5800000000163,0.0,0.0,167162,22.10.2008 02:10:00,2378,-0.20617248596890372,89.28,IS,0.23,0.0,Phase3-EA-S4v1-GBPJPY-M5-194,GBPJPYMT4,688,9m 57s,Buy
24677.09,166.74,22.10.2008 02:59:58,tp 166.740,-0.52,-71.49000000001979,0.0,0.0,168.59,21.10.2008 22:30:00,2379,-0.06230142455795076,165.09,IS,0.09,0.0,Phase3-EA-B1v1-GBPJPY-M30-1,GBPJPYMT4,312,4h 29m,Sell
24738.5,100252,22.10.2008 03:00:00,,0.0,-10.080000000016298,0.0,0.0,100.48,22.10.2008 00:45:00,2380,-0.008784422430339701,61.41,IS,0.27,0.0,Phase3-EA-S1v2-USDJPY-M15-0,USDJPYMT4,930,2h 15m,Sell
24828.04,166222,22.10.2008 03:44:58,tp 166.222,0.0,-0.0,0.0,0.0,165832,22.10.2008 03:15:00,2381,-0.0,89.54,IS,0.23,0.0,Phase3-EA-S4v1-GBPJPY-M5-194,GBPJPYMT4,690,29m 58s,Buy
24768.0,166.35,22.10.2008 03:59:58,sl 166.350,0.0,-60.0399999999936,0.0,0.0,165.68,22.10.2008 03:00:00,2382,-0.05228688045184225,-60.04,IS,0.09,0.0,Phase3-EA-B1v1-GBPJPY-M30-1,GBPJPYMT4,314,59m 58s,Sell
24653.46,1.50082,22.10.2008 06:29:58,sl 1.50082,0.0,-174.5799999999872,0.0,0.0,1.50472,22.10.2008 01:45:00,2383,-0.15203603579751707,-114.54,IS,0.34,0.0,Phase3-EA-S4v1-EURCHF-M15-221,EURCHFMT4,708,4h 44m,Buy
24819.54,164.17,22.10.2008 06:59:57,tp 164.170,0.0,-8.499999999985448,0.0,0.0,166.02,22.10.2008 04:30:00,2384,-0.0074023731485667165,166.08,IS,0.09,0.0,Phase3-EA-B1v1-GBPJPY-M30-1,GBPJPYMT4,316,2h 29m,Sell
24758.66,162.68,22.10.2008 11:59:58,sl 162.680,0.0,-69.3799999999901,0.0,0.0,162.01,22.10.2008 10:30:00,2385,-0.06042078224098409,-60.88,IS,0.09,0.0,Phase3-EA-B1v1-GBPJPY-M30-1,GBPJPYMT4,318,1h 29m,Sell
24868.25,98.55,22.10.2008 18:44:57,tp 98.550,0.0,-0.0,0.0,0.0,98.95,22.10.2008 17:00:00,2386,-0.0,109.59,IS,0.27,0.0,Phase3-EA-S1v2-USDJPY-M15-0,USDJPYMT4,932,1h 44m,Sell
24919.81,98452,22.10.2008 19:15:00,,0.0,-0.0,0.0,0.0,98.64,22.10.2008 19:00:00,2387,-0.0,51.56,IS,0.27,0.0,Phase3-EA-S1v2-USDJPY-M15-0,USDJPYMT4,934,15m 0s,Sell
25089.57,158.45,22.10.2008 22:29:58,tp 158.450,0.0,-0.0,0.0,0.0,160.3,22.10.2008 18:30:00,2388,-0.0,169.76,IS,0.09,0.0,Phase3-EA-B1v1-GBPJPY-M30-1,GBPJPYMT4,320,3h 59m,Sell
25128.36,1.49232,22.10.2008 23:04:57,tp 1.49232,0.0,-0.0,0.0,0.0,1.49122,22.10.2008 22:30:00,2389,-0.0,38.79,IS,0.41,0.0,Phase3-EA-SA2v2-EURCHF-M5-43,EURCHFMT4,1374,34m 57s,Buy
25066.56,159.04,22.10.2008 23:29:58,sl 159.040,0.0,-61.80000000000291,0.0,0.0,158.37,22.10.2008 22:30:00,2390,-0.053679215095223214,-61.8,IS,0.09,0.0,Phase3-EA-B1v1-GBPJPY-M30-1,GBPJPYMT4,322,59m 58s,Sell
25100.07,1.4927,23.10.2008 00:24:57,tp 1.49270,-5.29,-28.29000000000815,0.0,0.0,1.4938,22.10.2008 23:25:00,2391,-0.024572572735343537,33.51,IS,0.41,0.0,Phase3-EA-SA2v2-EURCHF-M5-43,EURCHFMT4,1376,59m 57s,Sell
25138.71,1.49122,23.10.2008 02:19:58,tp 1.49122,0.0,-0.0,0.0,0.0,1.49012,23.10.2008 02:15:00,2392,-0.0,38.64,IS,0.41,0.0,Phase3-EA-SA2v2-EURCHF-M5-43,EURCHFMT4,1378,4m 58s,Buy
24945.13,1.1685,23.10.2008 02:29:59,sl 1.16850,0.0,-193.58000000000175,0.0,0.0,1.1646,23.10.2008 02:00:00,2393,-0.16812764360483265,-193.58,IS,0.58,0.0,Phase3-EA-SA2v2-USDCHF-M15-107,USDCHFMT4,584,29m 59s,Sell
24883.29,158.37,23.10.2008 02:59:58,sl 158.370,0.0,-255.41999999999825,0.0,0.0,157.7,23.10.2008 02:30:00,2394,-0.2218367740962169,-61.84,IS,0.09,0.0,Phase3-EA-B1v1-GBPJPY-M30-1,GBPJPYMT4,324,29m 58s,Sell
24933.05,1.1655,23.10.2008 02:59:58,tp 1.16550,0.0,-205.6600000000035,0.0,0.0,1.1665,23.10.2008 02:45:00,2395,-0.17861933662449714,49.76,IS,0.58,0.0,Phase3-EA-SA2v2-USDCHF-M15-107,USDCHFMT4,586,14m 58s,Sell
24971.74,1.49042,23.10.2008 03:09:59,tp 1.49042,0.0,-166.97000000000116,0.0,0.0,1.48932,23.10.2008 02:40:00,2396,-0.1450163893620149,38.69,IS,0.41,0.0,Phase3-EA-SA2v2-EURCHF-M5-43,EURCHFMT4,1380,29m 59s,Buy
25082.53,97.48,23.10.2008 03:44:58,tp 97.480,0.0,-56.18000000000757,0.0,0.0,97.88,23.10.2008 01:15:00,2397,-0.04879332068251206,110.79,IS,0.27,0.0,Phase3-EA-S1v2-USDJPY-M15-0,USDJPYMT4,936,2h 29m,Sell
25020.36,157.83,23.10.2008 07:59:58,sl 157.830,0.0,-118.35000000000582,0.0,0.0,157.16,23.10.2008 07:00:00,2398,-0.10278906199314362,-62.17,IS,0.09,0.0,Phase3-EA-B1v1-GBPJPY-M30-1,GBPJPYMT4,326,59m 58s,Sell
25131.56,97.12,23.10.2008 19:29:57,tp 97.120,0.0,-7.150000000008731,0.0,0.0,97.52,23.10.2008 18:00:00,2399,-0.006209901083665722,111.2,IS,0.27,0.0,Phase3-EA-S1v2-USDJPY-M15-0,USDJPYMT4,938,1h 29m,Sell
25170.38,1.49232,23.10.2008 20:54:59,tp 1.49232,0.0,-0.0,0.0,0.0,1.49122,23.10.2008 20:40:00,2400,-0.0,38.82,IS,0.41,0.0,Phase3-EA-SA2v2-EURCHF-M5-43,EURCHFMT4,1382,14m 59s,Buy
25209.25,1.49112,23.10.2008 22:09:59,tp 1.49112,0.0,-0.0,0.0,0.0,1.49002,23.10.2008 22:00:00,2401,-0.0,38.87,IS,0.41,0.0,Phase3-EA-SA2v2-EURCHF-M5-43,EURCHFMT4,1384,9m 59s,Buy
25146.45,155.6,23.10.2008 22:29:58,sl 155.600,0.0,-62.80000000000291,0.0,0.0,154.93,23.10.2008 22:00:00,2402,-0.0545095120400514,-62.8,IS,0.09,0.0,Phase3-EA-B1v1-GBPJPY-M30-1,GBPJPYMT4,328,29m 58s,Sell
25185.29,1.4978,23.10.2008 23:24:58,tp 1.49780,0.0,-23.960000000006403,0.0,0.0,1.4989,23.10.2008 23:05:00,2403,-0.020796941217833122,38.84,IS,0.41,0.0,Phase3-EA-SA2v2-EURCHF-M5-43,EURCHFMT4,1386,19m 58s,Sell
24994.81,158.67,24.10.2008 00:04:59,sl 158.670,-1.37,-214.44000000000233,0.0,0.0,157.87,23.10.2008 23:35:00,2404,-0.18613088792783772,-190.48,IS,0.23,0.0,Phase3-EA-S4v1-GBPJPY-M5-194,GBPJPYMT4,692,29m 59s,Sell
25033.83,1.5012,24.10.2008 00:24:58,tp 1.50120,0.0,-175.41999999999825,0.0,0.0,1.5023,24.10.2008 00:15:00,2405,-0.152262079650721,39.02,IS,0.41,0.0,Phase3-EA-SA2v2-EURCHF-M5-43,EURCHFMT4,1388,9m 58s,Sell
25125.56,159.2,24.10.2008 01:04:58,tp 159.200,0.0,-83.69000000000233,0.0,0.0,159.59,24.10.2008 00:25:00,2406,-0.07264173666611175,91.73,IS,0.23,0.0,Phase3-EA-S4v1-GBPJPY-M5-194,GBPJPYMT4,694,39m 58s,Sell
25175.62,1.15872,24.10.2008 01:14:58,tp 1.15872,0.0,-33.63000000000466,0.0,0.0,1.15772,24.10.2008 00:15:00,2407,-0.029190364488966523,50.06,IS,0.58,0.0,Phase3-EA-SA2v2-USDCHF-M15-107,USDCHFMT4,588,59m 58s,Buy
25133.62,1.62752,24.10.2008 01:29:58,sl 1.62752,0.0,-75.63000000000466,0.0,0.0,1.63052,24.10.2008 00:30:00,2408,-0.06564577063040049,-42.0,IS,0.14,0.0,Phase3-EA-B1v1-GBPUSD-M30-14,GBPUSDMT4,172,59m 58s,Buy
24939.47,1.1651,24.10.2008 03:29:57,sl 1.16510,0.0,-269.77999999999884,0.0,0.0,1.1612,24.10.2008 02:45:00,2409,-0.23416522544847648,-194.15,IS,0.58,0.0,Phase3-EA-SA2v2-USDCHF-M15-107,USDCHFMT4,590,44m 57s,Sell
25055.96,1.4967,24.10.2008 05:44:58,tp 1.49670,0.0,-153.2899999999936,0.0,0.0,1.5007,24.10.2008 01:30:00,2410,-0.1330535525576233,116.49,IS,0.34,0.0,Phase3-EA-S4v1-EURCHF-M15-221,EURCHFMT4,710,4h 14m,Sell
24817.0,93.78,24.10.2008 18:44:58,sl 93.780,0.0,-392.25,0.0,0.0,92.95,24.10.2008 17:00:00,2411,-0.3404674537851779,-238.96,IS,0.27,0.0,Phase3-EA-S1v2-USDJPY-M15-0,USDJPYMT4,940,1h 44m,Sell
24855.76,1.4747,24.10.2008 20:29:58,tp 1.47470,0.0,-353.49000000000524,0.0,0.0,1.4758,24.10.2008 20:25:00,2412,-0.30682432183180197,38.76,IS,0.41,0.0,Phase3-EA-SA2v2-EURCHF-M5-43,EURCHFMT4,1390,4m 58s,Sell
24905.42,1168,24.10.2008 23:44:58,tp 1.16800,0.0,-303.83000000000175,0.0,0.0,1169,24.10.2008 23:15:00,2413,-0.26372014399885585,49.66,IS,0.58,0.0,Phase3-EA-SA2v2-USDCHF-M15-107,USDCHFMT4,592,29m 58s,Sell
24841.13,150032,27.10.2008 02:00:00,sl 150.032,-0.34,-368.11999999999534,0.0,0.0,150702,24.10.2008 22:30:00,2414,-0.31952295497105954,-64.29,IS,0.09,0.0,Phase3-EA-B1v1-GBPJPY-M30-1,GBPJPYMT4,330,2d 3h 30m,Buy
24600.32,93382,27.10.2008 02:00:00,sl 93.382,-0.83,-608.929999999993,0.0,0.0,94212,24.10.2008 23:45:00,2415,-0.5285426300405507,-240.81,IS,0.27,0.0,Phase3-EA-S1v2-USDJPY-M15-0,USDJPYMT4,942,2d 2h 15m,Buy
24696.71,146292,27.10.2008 02:14:57,tp 146.292,0.0,-512.5399999999936,0.0,0.0,145902,27.10.2008 02:10:00,2416,-0.44487747294596025,96.39,IS,0.23,0.0,Phase3-EA-S4v1-GBPJPY-M5-194,GBPJPYMT4,696,4m 57s,Buy
24735.48,1.46332,27.10.2008 02:39:58,tp 1.46332,0.0,-473.7699999999895,0.0,0.0,1.46222,27.10.2008 02:15:00,2417,-0.41122566113397113,38.77,IS,0.41,0.0,Phase3-EA-SA2v2-EURCHF-M5-43,EURCHFMT4,1392,24m 58s,Buy
24852.42,1.46842,27.10.2008 03:14:57,tp 1.46842,0.0,-356.8299999999872,0.0,0.0,1.46442,27.10.2008 02:45:00,2418,-0.3097233946058908,116.94,IS,0.34,0.0,Phase3-EA-S4v1-EURCHF-M15-221,EURCHFMT4,712,29m 57s,Buy
24891.43,1.4493,27.10.2008 20:09:57,tp 1.44930,0.0,-317.81999999999243,0.0,0.0,1.4504,27.10.2008 20:05:00,2419,-0.2758632661873873,39.01,IS,0.41,0.0,Phase3-EA-SA2v2-EURCHF-M5-43,EURCHFMT4,1394,4m 57s,Sell
25006.75,93652,27.10.2008 20:14:57,tp 93.652,0.0,-202.49999999998545,0.0,0.0,93252,27.10.2008 19:30:00,2420,-0.1757671367533297,115.32,IS,0.27,0.0,Phase3-EA-S1v2-USDJPY-M15-0,USDJPYMT4,944,44m 57s,Buy
25045.72,1.4477,27.10.2008 20:19:58,tp 1.44770,0.0,-163.52999999998428,0.0,0.0,1.4488,27.10.2008 20:15:00,2421,-0.14194172776924102,38.97,IS,0.41,0.0,Phase3-EA-SA2v2-EURCHF-M5-43,EURCHFMT4,1396,4m 58s,Sell
24846.56,144232,28.10.2008 00:04:57,sl 144.232,-0.89,-362.6899999999878,0.0,0.0,145032,27.10.2008 23:40:00,2422,-0.3148097917484819,-199.16,IS,0.23,0.0,Phase3-EA-S4v1-GBPJPY-M5-194,GBPJPYMT4,698,24m 57s,Buy
24604.06,92732,28.10.2008 00:14:57,sl 92.732,-0.84,-605.1899999999878,0.0,0.0,93562,27.10.2008 23:00:00,2423,-0.5252963629222375,-242.5,IS,0.27,0.0,Phase3-EA-S1v2-USDJPY-M15-0,USDJPYMT4,946,1h 14m,Buy
24700.65,144322,28.10.2008 00:29:59,tp 144.322,0.0,-508.59999999999127,0.0,0.0,143932,28.10.2008 00:20:00,2424,-0.4414576086555475,96.59,IS,0.23,0.0,Phase3-EA-S4v1-GBPJPY-M5-194,GBPJPYMT4,700,9m 59s,Buy
24797.12,144.91,28.10.2008 02:24:58,tp 144.910,0.0,-412.1299999999901,0.0,0.0,145.3,28.10.2008 02:20:00,2425,-0.35772301269211476,96.47,IS,0.23,0.0,Phase3-EA-S4v1-GBPJPY-M5-194,GBPJPYMT4,702,4m 58s,Sell
24914.74,1.44532,28.10.2008 03:29:58,tp 1.44532,0.0,-294.50999999999476,0.0,0.0,1.44132,28.10.2008 01:00:00,2426,-0.25563051577889345,117.62,IS,0.34,0.0,Phase3-EA-S4v1-EURCHF-M15-221,EURCHFMT4,714,2h 29m,Buy
25010.45,145.08,28.10.2008 03:34:58,tp 145.080,0.0,-198.79999999998836,0.0,0.0,145.47,28.10.2008 03:25:00,2427,-0.172555589069444,95.71,IS,0.23,0.0,Phase3-EA-S4v1-GBPJPY-M5-194,GBPJPYMT4,704,9m 58s,Sell
24836.29,1.43992,28.10.2008 03:59:59,sl 1.43992,-0.85,-372.95999999999185,0.0,0.0,1.44482,27.10.2008 23:35:00,2428,-0.32372400653592653,-174.16,IS,0.41,0.0,Phase3-EA-SA2v2-EURCHF-M5-43,EURCHFMT4,1398,4h 24m,Buy
24953.8,1.43992,28.10.2008 05:44:58,tp 1.43992,0.0,-255.4499999999971,0.0,0.0,1.43592,28.10.2008 05:30:00,2429,-0.2217269880673619,117.51,IS,0.34,0.0,Phase3-EA-S4v1-EURCHF-M15-221,EURCHFMT4,716,14m 58s,Buy
25066.76,95612,28.10.2008 18:44:58,tp 95.612,0.0,-142.4899999999907,0.0,0.0,95212,28.10.2008 18:15:00,2430,-0.1236793052641092,112.96,IS,0.27,0.0,Phase3-EA-S1v2-USDJPY-M15-0,USDJPYMT4,948,29m 58s,Buy
25105.57,1.45,28.10.2008 20:44:58,tp 1.45000,0.0,-103.67999999999302,0.0,0.0,1.4511,28.10.2008 20:00:00,2431,-0.08999277401770521,38.81,IS,0.41,0.0,Phase3-EA-SA2v2-EURCHF-M5-43,EURCHFMT4,1400,44m 58s,Sell
24932.45,1.4587,28.10.2008 21:54:58,sl 1.45870,0.0,-276.79999999998836,0.0,0.0,1.4538,28.10.2008 21:30:00,2432,-0.24025848618924991,-173.12,IS,0.41,0.0,Phase3-EA-SA2v2-EURCHF-M5-43,EURCHFMT4,1402,24m 58s,Sell
24758.77,1.4695,28.10.2008 23:04:58,sl 1.46950,0.0,-450.4799999999814,0.0,0.0,1.4646,28.10.2008 22:25:00,2433,-0.3910102704426784,-173.68,IS,0.41,0.0,Phase3-EA-SA2v2-EURCHF-M5-43,EURCHFMT4,1404,39m 58s,Sell
24849.82,156.77,29.10.2008 00:34:58,tp 156.770,0.0,-359.42999999997846,0.0,0.0,157.16,29.10.2008 00:20:00,2434,-0.3119801578432101,91.05,IS,0.23,0.0,Phase3-EA-S4v1-GBPJPY-M5-194,GBPJPYMT4,706,14m 58s,Sell
24673.96,1.4734,29.10.2008 00:49:59,sl 1.47340,-1.77,-535.289999999979,0.0,0.0,1.4685,28.10.2008 23:15:00,2435,-0.4646241512725577,-175.86,IS,0.41,0.0,Phase3-EA-SA2v2-EURCHF-M5-43,EURCHFMT4,1406,1h 34m,Sell
24712.97,1.4732,29.10.2008 01:09:57,tp 1.47320,0.0,-496.2799999999843,0.0,0.0,1.4743,29.10.2008 01:05:00,2436,-0.4307640228540542,39.01,IS,0.41,0.0,Phase3-EA-SA2v2-EURCHF-M5-43,EURCHFMT4,1408,4m 57s,Sell
24803.62,158.34,29.10.2008 01:14:57,tp 158.340,0.0,-405.6299999999901,0.0,0.0,158.73,29.10.2008 01:05:00,2437,-0.3520811045987976,90.65,IS,0.23,0.0,Phase3-EA-S4v1-GBPJPY-M5-194,GBPJPYMT4,708,9m 57s,Sell
24688.81,1.4768,29.10.2008 01:59:58,sl 1.47680,0.0,-520.4399999999878,0.0,0.0,1.4729,29.10.2008 01:15:00,2438,-0.4517345612439868,-114.81,IS,0.34,0.0,Phase3-EA-S4v1-EURCHF-M15-221,EURCHFMT4,718,44m 58s,Sell
24727.96,1.4755,29.10.2008 02:24:59,tp 1.47550,0.0,-481.2899999999936,0.0,0.0,1.4766,29.10.2008 02:00:00,2439,-0.41775291480501237,39.15,IS,0.41,0.0,Phase3-EA-SA2v2-EURCHF-M5-43,EURCHFMT4,1410,24m 59s,Sell
24613.05,1.46462,29.10.2008 06:14:58,sl 1.46462,0.0,-596.1999999999971,0.0,0.0,1.46852,29.10.2008 05:30:00,2440,-0.5174931700362577,-114.91,IS,0.34,0.0,Phase3-EA-S4v1-EURCHF-M15-221,EURCHFMT4,720,44m 58s,Buy
24723.51,97772,29.10.2008 17:29:58,tp 97.772,0.0,-485.7399999999907,0.0,0.0,97372,29.10.2008 17:15:00,2441,-0.4216154518842808,110.46,IS,0.27,0.0,Phase3-EA-S1v2-USDJPY-M15-0,USDJPYMT4,950,14m 58s,Buy
24763.21,1.46262,29.10.2008 20:34:58,tp 1.46262,0.0,-446.0399999999936,0.0,0.0,1.46152,29.10.2008 20:30:00,2442,-0.38715641322202315,39.7,IS,0.41,0.0,Phase3-EA-SA2v2-EURCHF-M5-43,EURCHFMT4,1412,4m 58s,Buy
24803.03,1.46142,29.10.2008 21:04:58,tp 1.46142,0.0,-406.2199999999866,0.0,0.0,1.46032,29.10.2008 20:55:00,2443,-0.35259321625649565,39.82,IS,0.41,0.0,Phase3-EA-SA2v2-EURCHF-M5-43,EURCHFMT4,1414,9m 58s,Buy
24842.97,1.46162,29.10.2008 21:24:57,tp 1.46162,0.0,-366.2799999999843,0.0,0.0,1.46052,29.10.2008 21:15:00,2444,-0.3179258609877109,39.94,IS,0.41,0.0,Phase3-EA-SA2v2-EURCHF-M5-43,EURCHFMT4,1416,9m 57s,Buy
24953.78,97462,29.10.2008 22:29:58,tp 97.462,0.0,-255.4699999999866,0.0,0.0,97062,29.10.2008 21:00:00,2445,-0.221744347784563,110.81,IS,0.27,0.0,Phase3-EA-S1v2-USDJPY-M15-0,USDJPYMT4,952,1h 29m,Buy
24993.48,1.4687,29.10.2008 22:29:58,tp 1.46870,0.0,-215.76999999998952,0.0,0.0,1.4698,29.10.2008 22:25:00,2446,-0.18728530912230534,39.7,IS,0.41,0.0,Phase3-EA-SA2v2-EURCHF-M5-43,EURCHFMT4,1418,4m 58s,Sell
25044.87,1.12872,30.10.2008 00:44:58,tp 1.12872,0.0,-164.3799999999901,0.0,0.0,1.12772,30.10.2008 00:15:00,2447,-0.14267951575067986,51.39,IS,0.58,0.0,Phase3-EA-SA2v2-USDCHF-M15-107,USDCHFMT4,594,29m 58s,Buy
25119.33,97.64,30.10.2008 02:45:00,,-2.41,-89.9199999999837,0.0,0.0,97362,29.10.2008 23:00:00,2448,-0.07804928857707495,74.46,IS,0.27,0.0,Phase3-EA-S1v2-USDJPY-M15-0,USDJPYMT4,954,3h 45m,Buy
25210.68,161.0,30.10.2008 03:34:59,tp 161.000,0.0,-0.0,0.0,0.0,161.39,30.10.2008 03:30:00,2449,-0.0,91.35,IS,0.23,0.0,Phase3-EA-S4v1-GBPJPY-M5-194,GBPJPYMT4,710,4m 59s,Sell
25250.31,1.4746,30.10.2008 21:44:58,tp 1.47460,0.0,-0.0,0.0,0.0,1.4757,30.10.2008 21:40:00,2450,-0.0,39.63,IS,0.41,0.0,Phase3-EA-SA2v2-EURCHF-M5-43,EURCHFMT4,1420,4m 58s,Sell
25289.01,1.47272,31.10.2008 00:05:00,tp 1.47272,-0.86,-0.0,0.0,0.0,1.47162,30.10.2008 23:45:00,2451,-0.0,38.7,IS,0.41,0.0,Phase3-EA-SA2v2-EURCHF-M5-43,EURCHFMT4,1422,20m 0s,Buy
25328.6,1.46712,31.10.2008 03:04:57,tp 1.46712,0.0,-0.0,0.0,0.0,1.46602,31.10.2008 02:30:00,2452,-0.0,39.59,IS,0.41,0.0,Phase3-EA-SA2v2-EURCHF-M5-43,EURCHFMT4,1424,34m 57s,Buy
25285.66,98402,31.10.2008 03:15:00,,-1.23,-42.94000000000233,0.0,0.0,98.25,30.10.2008 21:00:00,2453,-0.03723274192178032,-42.94,IS,0.27,0.0,Phase3-EA-S1v2-USDJPY-M15-0,USDJPYMT4,956,6h 15m,Sell
25377.26,159602,31.10.2008 03:49:58,tp 159.602,0.0,-0.0,0.0,0.0,159212,31.10.2008 03:45:00,2454,-0.0,91.6,IS,0.23,0.0,Phase3-EA-S4v1-GBPJPY-M5-194,GBPJPYMT4,712,4m 58s,Buy
25496.55,1.46392,31.10.2008 06:44:58,tp 1.46392,0.0,-0.0,0.0,0.0,1.45992,31.10.2008 04:30:00,2455,-0.0,119.29,IS,0.34,0.0,Phase3-EA-S4v1-EURCHF-M15-221,EURCHFMT4,722,2h 14m,Buy
25606.32,98392,31.10.2008 20:14:58,tp 98.392,0.0,-0.0,0.0,0.0,97992,31.10.2008 19:15:00,2456,-0.0,109.77,IS,0.27,0.0,Phase3-EA-S1v2-USDJPY-M15-0,USDJPYMT4,958,59m 58s,Buy
25645.35,1.47462,31.10.2008 21:59:57,tp 1.47462,0.0,-0.0,0.0,0.0,1.47352,31.10.2008 21:45:00,2457,-0.0,39.03,IS,0.41,0.0,Phase3-EA-SA2v2-EURCHF-M5-43,EURCHFMT4,1426,14m 57s,Buy
25695.46,1.15742,31.10.2008 22:44:58,tp 1.15742,0.0,-0.0,0.0,0.0,1.15642,31.10.2008 22:15:00,2458,-0.0,50.11,IS,0.58,0.0,Phase3-EA-SA2v2-USDCHF-M15-107,USDCHFMT4,596,29m 58s,Buy
25786.98,98.85,03.11.2008 04:45:00,,-0.8,-0.0,0.0,0.0,98512,31.10.2008 20:15:00,2459,-0.0,91.52,IS,0.27,0.0,Phase3-EA-S1v2-USDJPY-M15-0,USDJPYMT4,960,2d 8h 30m,Buy
25896.64,98.49,03.11.2008 19:29:57,tp 98.490,0.0,-0.0,0.0,0.0,98.89,03.11.2008 19:00:00,2460,-0.0,109.66,IS,0.27,0.0,Phase3-EA-S1v2-USDJPY-M15-0,USDJPYMT4,962,29m 57s,Sell
25935.12,1.48332,03.11.2008 21:04:58,tp 1.48332,0.0,-0.0,0.0,0.0,1.48222,03.11.2008 20:50:00,2461,-0.0,38.48,IS,0.41,0.0,Phase3-EA-SA2v2-EURCHF-M5-43,EURCHFMT4,1428,14m 58s,Buy
25984.57,1173,03.11.2008 22:59:58,tp 1.17300,0.0,-0.0,0.0,0.0,1174,03.11.2008 22:15:00,2462,-0.0,49.45,IS,0.58,0.0,Phase3-EA-SA2v2-USDCHF-M15-107,USDCHFMT4,598,44m 58s,Sell
26021.23,1.4837,04.11.2008 00:49:57,tp 1.48370,-1.75,-0.0,0.0,0.0,1.4848,03.11.2008 23:55:00,2463,-0.0,36.66,IS,0.41,0.0,Phase3-EA-SA2v2-EURCHF-M5-43,EURCHFMT4,1430,54m 57s,Sell
26059.5,1.4852,04.11.2008 01:14:58,tp 1.48520,0.0,-0.0,0.0,0.0,1.4863,04.11.2008 01:10:00,2464,-0.0,38.27,IS,0.41,0.0,Phase3-EA-SA2v2-EURCHF-M5-43,EURCHFMT4,1432,4m 58s,Sell
26097.76,1.4858,04.11.2008 01:44:59,tp 1.48580,0.0,-0.0,0.0,0.0,1.4869,04.11.2008 01:25:00,2465,-0.0,38.26,IS,0.41,0.0,Phase3-EA-SA2v2-EURCHF-M5-43,EURCHFMT4,1434,19m 59s,Sell
26136.04,1.4847,04.11.2008 01:54:57,tp 1.48470,0.0,-0.0,0.0,0.0,1.4858,04.11.2008 01:45:00,2466,-0.0,38.28,IS,0.41,0.0,Phase3-EA-SA2v2-EURCHF-M5-43,EURCHFMT4,1436,9m 57s,Sell
26185.31,1.1771,04.11.2008 02:59:58,tp 1.17710,0.0,-0.0,0.0,0.0,1.1781,04.11.2008 02:15:00,2467,-0.0,49.27,IS,0.58,0.0,Phase3-EA-SA2v2-USDCHF-M15-107,USDCHFMT4,600,44m 58s,Sell
26120.83,99042,04.11.2008 03:15:00,,-1.23,-64.47999999999593,0.0,0.0,98.81,03.11.2008 19:45:00,2468,-0.055497549561124314,-64.48,IS,0.27,0.0,Phase3-EA-S1v2-USDJPY-M15-0,USDJPYMT4,964,7h 30m,Sell
26059.62,155.67,04.11.2008 04:59:58,sl 155.670,0.0,-125.69000000000233,0.0,0.0,155.0,04.11.2008 04:30:00,2469,-0.10818062971988655,-61.21,IS,0.09,0.0,Phase3-EA-B1v1-GBPJPY-M30-1,GBPJPYMT4,332,29m 58s,Sell
25947.13,1.47852,04.11.2008 07:29:58,sl 1.47852,0.0,-238.18000000000757,0.0,0.0,1.48242,04.11.2008 04:45:00,2470,-0.2050000985494703,-112.49,IS,0.34,0.0,Phase3-EA-S4v1-EURCHF-M15-221,EURCHFMT4,724,2h 44m,Buy
25885.94,154.54,04.11.2008 07:59:59,sl 154.540,0.0,-299.3700000000099,0.0,0.0,153.87,04.11.2008 07:30:00,2471,-0.2576659648280922,-61.19,IS,0.09,0.0,Phase3-EA-B1v1-GBPJPY-M30-1,GBPJPYMT4,334,29m 59s,Sell
25994.19,99772,04.11.2008 18:44:58,tp 99.772,0.0,-191.1200000000099,0.0,0.0,99372,04.11.2008 17:00:00,2472,-0.16449583858752012,108.25,IS,0.27,0.0,Phase3-EA-S1v2-USDJPY-M15-0,USDJPYMT4,966,1h 44m,Buy
26032.97,1.5106,04.11.2008 20:09:58,tp 1.51060,0.0,-152.34000000001106,0.0,0.0,1.5117,04.11.2008 20:05:00,2473,-0.13111812500221504,38.78,IS,0.41,0.0,Phase3-EA-SA2v2-EURCHF-M5-43,EURCHFMT4,1438,4m 58s,Sell
25972.88,160262,04.11.2008 21:59:58,sl 160.262,0.0,-212.43000000000757,0.0,0.0,160932,04.11.2008 21:30:00,2474,-0.1828372278733065,-60.09,IS,0.09,0.0,Phase3-EA-B1v1-GBPJPY-M30-1,GBPJPYMT4,336,29m 58s,Buy
26062.94,159252,04.11.2008 23:34:58,tp 159.252,0.0,-122.3700000000099,0.0,0.0,158862,04.11.2008 23:00:00,2475,-0.10532312561717991,90.06,IS,0.23,0.0,Phase3-EA-S4v1-GBPJPY-M5-194,GBPJPYMT4,714,34m 58s,Buy
26101.77,1.50962,04.11.2008 23:39:57,tp 1.50962,0.0,-83.54000000000815,0.0,0.0,1.50852,04.11.2008 23:00:00,2476,-0.07190237733153025,38.83,IS,0.41,0.0,Phase3-EA-SA2v2-EURCHF-M5-43,EURCHFMT4,1440,39m 57s,Buy
26140.66,1.5105,05.11.2008 00:34:57,tp 1.51050,0.0,-44.65000000000873,0.0,0.0,1.5116,05.11.2008 00:15:00,2477,-0.03842998740547211,38.89,IS,0.41,0.0,Phase3-EA-SA2v2-EURCHF-M5-43,EURCHFMT4,1442,19m 57s,Sell
26230.67,158612,05.11.2008 03:44:58,tp 158.612,0.0,-0.0,0.0,0.0,158222,05.11.2008 03:35:00,2478,-0.0,90.01,IS,0.23,0.0,Phase3-EA-S4v1-GBPJPY-M5-194,GBPJPYMT4,716,9m 58s,Buy
26210.42,99.83,05.11.2008 06:15:00,,-0.78,-20.25,0.0,0.0,99902,04.11.2008 22:30:00,2479,-0.01742225180324608,-20.25,IS,0.27,0.0,Phase3-EA-S1v2-USDJPY-M15-0,USDJPYMT4,968,7h 45m,Buy
26319.89,98.66,05.11.2008 17:44:58,tp 98.660,0.0,-0.0,0.0,0.0,99.06,05.11.2008 17:00:00,2480,-0.0,109.47,IS,0.27,0.0,Phase3-EA-S1v2-USDJPY-M15-0,USDJPYMT4,970,44m 58s,Sell
26146.88,1.50672,05.11.2008 22:24:58,sl 1.50672,0.0,-173.00999999999476,0.0,0.0,1.51162,05.11.2008 21:00:00,2481,-0.14873638549692128,-173.01,IS,0.41,0.0,Phase3-EA-SA2v2-EURCHF-M5-43,EURCHFMT4,1444,1h 24m,Buy
26185.81,1.50732,05.11.2008 22:34:59,tp 1.50732,0.0,-134.08000000000175,0.0,0.0,1.50622,05.11.2008 22:25:00,2482,-0.11526833459007033,38.93,IS,0.41,0.0,Phase3-EA-SA2v2-EURCHF-M5-43,EURCHFMT4,1446,9m 59s,Buy
25957.61,98202,05.11.2008 23:59:58,sl 98.202,0.0,-362.27999999999884,0.0,0.0,99032,05.11.2008 19:45:00,2483,-0.31145146371785504,-228.2,IS,0.27,0.0,Phase3-EA-S1v2-USDJPY-M15-0,USDJPYMT4,972,4h 14m,Buy
26048.74,156872,06.11.2008 00:14:59,tp 156.872,0.0,-271.1499999999942,0.0,0.0,156482,06.11.2008 00:05:00,2484,-0.23310716679666238,91.13,IS,0.23,0.0,Phase3-EA-S4v1-GBPJPY-M5-194,GBPJPYMT4,718,9m 59s,Buy
25872.85,1.49872,06.11.2008 01:10:00,sl 1.49872,-2.54,-447.0399999999936,0.0,0.0,1.50362,05.11.2008 23:45:00,2485,-0.3843194831081715,-175.89,IS,0.41,0.0,Phase3-EA-SA2v2-EURCHF-M5-43,EURCHFMT4,1448,1h 25m,Buy
25811.19,155.14,06.11.2008 07:29:59,sl 155.140,0.0,-508.6999999999971,0.0,0.0,154.47,06.11.2008 06:30:00,2486,-0.4373284740898544,-61.66,IS,0.09,0.0,Phase3-EA-B1v1-GBPJPY-M30-1,GBPJPYMT4,338,59m 59s,Sell
25712.01,1.4963,06.11.2008 09:35:00,,0.0,-607.8799999999901,0.0,0.0,1.49912,06.11.2008 01:15:00,2487,-0.5225933415170786,-99.18,IS,0.41,0.0,Phase3-EA-SA2v2-EURCHF-M5-43,EURCHFMT4,1450,8h 20m,Buy
25828.62,1.50232,06.11.2008 10:59:58,tp 1.50232,0.0,-491.2699999999895,0.0,0.0,1.49832,06.11.2008 03:00:00,2488,-0.42234393447241875,116.61,IS,0.34,0.0,Phase3-EA-S4v1-EURCHF-M15-221,EURCHFMT4,726,7h 59m,Buy
25767.32,156542,06.11.2008 15:59:58,sl 156.542,0.0,-552.5699999999924,0.0,0.0,157212,06.11.2008 15:30:00,2489,-0.47504343410227823,-61.3,IS,0.09,0.0,Phase3-EA-B1v1-GBPJPY-M30-1,GBPJPYMT4,340,29m 58s,Buy
25805.64,1.4974,06.11.2008 23:29:59,tp 1.49740,0.0,-514.2499999999854,0.0,0.0,1.4985,06.11.2008 22:50:00,2490,-0.4420997990971153,38.32,IS,0.41,0.0,Phase3-EA-SA2v2-EURCHF-M5-43,EURCHFMT4,1452,39m 59s,Sell
25616.58,152272,07.11.2008 00:24:57,sl 152.272,-0.85,-703.3099999999831,0.0,0.0,153072,06.11.2008 23:45:00,2491,-0.6046343406961469,-189.06,IS,0.23,0.0,Phase3-EA-S4v1-GBPJPY-M5-194,GBPJPYMT4,720,39m 57s,Buy
25665.89,1.1763,07.11.2008 01:29:57,tp 1.17630,0.0,-653.9999999999854,0.0,0.0,1.1773,07.11.2008 00:45:00,2492,-0.5622426224783961,49.31,IS,0.58,0.0,Phase3-EA-SA2v2-USDCHF-M15-107,USDCHFMT4,602,44m 57s,Sell
25434.61,97232,07.11.2008 02:29:57,sl 97.232,-0.8,-885.2799999999843,0.0,0.0,98062,06.11.2008 20:15:00,2493,-0.7610736220606676,-231.28,IS,0.27,0.0,Phase3-EA-S1v2-USDJPY-M15-0,USDJPYMT4,974,6h 14m,Buy
25245.33,151242,07.11.2008 03:44:59,sl 151.242,0.0,-1074.5599999999831,0.0,0.0,152042,07.11.2008 01:50:00,2494,-0.923797297263592,-189.28,IS,0.23,0.0,Phase3-EA-S4v1-GBPJPY-M5-194,GBPJPYMT4,722,1h 54m,Buy
25416.54,151.31,07.11.2008 03:59:58,tp 151.310,-0.53,-903.3499999999767,0.0,0.0,153.16,06.11.2008 23:30:00,2495,-0.7766083685257756,171.21,IS,0.09,0.0,Phase3-EA-B1v1-GBPJPY-M30-1,GBPJPYMT4,342,4h 29m,Sell
25454.83,1.49682,07.11.2008 05:24:58,tp 1.49682,0.0,-865.0599999999831,0.0,0.0,1.49572,07.11.2008 01:45:00,2496,-0.7436905244666094,38.29,IS,0.41,0.0,Phase3-EA-SA2v2-EURCHF-M5-43,EURCHFMT4,1454,3h 39m,Buy
25570.53,1.49942,07.11.2008 06:59:58,tp 1.49942,0.0,-749.359999999986,0.0,0.0,1.49542,07.11.2008 02:15:00,2497,-0.6442234427835052,115.7,IS,0.34,0.0,Phase3-EA-S4v1-EURCHF-M15-221,EURCHFMT4,728,4h 44m,Buy
25528.53,1.57782,07.11.2008 18:59:59,sl 1.57782,0.0,-791.359999999986,0.0,0.0,1.58082,07.11.2008 18:30:00,2498,-0.6803307671628525,-42.0,IS,0.14,0.0,Phase3-EA-B1v1-GBPUSD-M30-14,GBPUSDMT4,174,29m 59s,Buy
25577.79,1.1775,07.11.2008 22:59:58,tp 1.17750,0.0,-742.0999999999913,0.0,0.0,1.1785,07.11.2008 22:00:00,2499,-0.6379820338550796,49.26,IS,0.58,0.0,Phase3-EA-SA2v2-USDCHF-M15-107,USDCHFMT4,604,59m 58s,Sell
25616.11,1.5016,07.11.2008 22:59:59,tp 1.50160,0.0,-703.7799999999843,0.0,0.0,1.5027,07.11.2008 22:50:00,2500,-0.6050383988499167,38.32,IS,0.41,0.0,Phase3-EA-SA2v2-EURCHF-M5-43,EURCHFMT4,1456,9m 59s,Sell
25724.87,98572,10.11.2008 02:00:00,tp 98.572,-0.8,-595.0199999999895,0.0,0.0,98172,07.11.2008 23:15:00,2501,-0.5115376226714018,108.76,IS,0.27,0.0,Phase3-EA-S1v2-USDJPY-M15-0,USDJPYMT4,976,2d 2h 45m,Buy
25815.51,156.01,10.11.2008 02:44:58,tp 156.010,0.0,-504.3799999999901,0.0,0.0,156.4,10.11.2008 02:30:00,2502,-0.4336145778679727,90.64,IS,0.23,0.0,Phase3-EA-S4v1-GBPJPY-M5-194,GBPJPYMT4,724,14m 58s,Sell
25893.26,1.50692,10.11.2008 13:00:00,,0.0,-426.6299999999901,0.0,0.0,1.5096,10.11.2008 04:15:00,2503,-0.3667730428562047,77.75,IS,0.34,0.0,Phase3-EA-S4v1-EURCHF-M15-221,EURCHFMT4,730,8h 45m,Sell
25931.61,1.50472,10.11.2008 22:09:58,tp 1.50472,0.0,-388.2799999999843,0.0,0.0,1.50362,10.11.2008 20:00:00,2504,-0.33380361690505755,38.35,IS,0.41,0.0,Phase3-EA-SA2v2-EURCHF-M5-43,EURCHFMT4,1458,2h 9m,Buy
25969.05,1.50282,11.11.2008 00:34:58,tp 1.50282,-0.83,-350.83999999998196,0.0,0.0,1.50172,10.11.2008 23:45:00,2505,-0.30161651631546593,37.44,IS,0.41,0.0,Phase3-EA-SA2v2-EURCHF-M5-43,EURCHFMT4,1460,49m 58s,Buy
26012.65,97842,11.11.2008 03:30:00,,0.0,-307.23999999997613,0.0,0.0,98002,11.11.2008 01:00:00,2506,-0.2641336748169003,43.6,IS,0.27,0.0,Phase3-EA-S1v2-USDJPY-M15-0,USDJPYMT4,978,2h 30m,Buy
26017.61,98.02,11.11.2008 06:45:00,,0.0,-302.27999999996973,0.0,0.0,98.0,11.11.2008 01:00:00,2507,-0.2598695717473338,4.96,IS,0.27,0.0,Phase3-EA-S1v2-USDJPY-M15-0,USDJPYMT4,979,5h 45m,Sell
25904.79,1.49702,11.11.2008 12:59:58,sl 1.49702,0.0,-415.0999999999767,0.0,0.0,1.50092,11.11.2008 04:30:00,2508,-0.3568607226158628,-112.82,IS,0.34,0.0,Phase3-EA-S4v1-EURCHF-M15-221,EURCHFMT4,732,8h 29m,Buy
25942.88,1.4899,11.11.2008 22:39:58,tp 1.48990,0.0,-377.0099999999802,0.0,0.0,1491,11.11.2008 22:35:00,2509,-0.3241148181965958,38.09,IS,0.41,0.0,Phase3-EA-SA2v2-EURCHF-M5-43,EURCHFMT4,1462,4m 58s,Sell
25968.74,97622,12.11.2008 02:15:00,,-1.24,-351.1499999999796,0.0,0.0,97.72,11.11.2008 23:45:00,2510,-0.3018830227573115,25.86,IS,0.27,0.0,Phase3-EA-S1v2-USDJPY-M15-0,USDJPYMT4,982,2h 30m,Sell
26006.73,1.48732,12.11.2008 03:09:57,tp 1.48732,0.0,-313.1599999999744,0.0,0.0,1.48622,12.11.2008 01:15:00,2511,-0.2692230881579878,37.99,IS,0.41,0.0,Phase3-EA-SA2v2-EURCHF-M5-43,EURCHFMT4,1464,1h 54m,Buy
26055.62,1.1863,12.11.2008 03:14:58,tp 1.18630,0.0,-264.26999999997497,0.0,0.0,1.1873,12.11.2008 00:15:00,2512,-0.22719244318402898,48.89,IS,0.58,0.0,Phase3-EA-SA2v2-USDCHF-M15-107,USDCHFMT4,606,2h 59m,Sell
26170.2,1.48972,12.11.2008 05:14:58,tp 1.48972,0.0,-149.68999999997322,0.0,0.0,1.48572,12.11.2008 02:00:00,2513,-0.1286882234843699,114.58,IS,0.34,0.0,Phase3-EA-S4v1-EURCHF-M15-221,EURCHFMT4,734,3h 14m,Buy
26208.33,1.4823,12.11.2008 21:24:58,tp 1.48230,0.0,-111.55999999996857,0.0,0.0,1.4834,12.11.2008 21:05:00,2514,-0.09590793113711557,38.13,IS,0.41,0.0,Phase3-EA-SA2v2-EURCHF-M5-43,EURCHFMT4,1466,19m 58s,Sell
26246.35,1.48202,13.11.2008 00:29:57,tp 1.48202,0.0,-73.5399999999645,0.0,0.0,1.48092,13.11.2008 00:05:00,2515,-0.06322220559180765,38.02,IS,0.41,0.0,Phase3-EA-SA2v2-EURCHF-M5-43,EURCHFMT4,1468,24m 57s,Buy
26295.22,1.1869,13.11.2008 01:59:58,tp 1.18690,0.0,-24.66999999996915,0.0,0.0,1.1879,13.11.2008 01:30:00,2516,-0.021208754581842498,48.87,IS,0.58,0.0,Phase3-EA-SA2v2-USDCHF-M15-107,USDCHFMT4,608,29m 58s,Sell
26333.22,1.48012,13.11.2008 02:39:58,tp 1.48012,0.0,-0.0,0.0,0.0,1.47902,13.11.2008 01:55:00,2517,-0.0,38.0,IS,0.41,0.0,Phase3-EA-SA2v2-EURCHF-M5-43,EURCHFMT4,1470,44m 58s,Buy
26269.61,142.13,13.11.2008 03:29:58,sl 142.130,0.0,-63.61000000000058,0.0,0.0,141.46,13.11.2008 01:30:00,2518,-0.05467913636362905,-63.61,IS,0.09,0.0,Phase3-EA-B1v1-GBPJPY-M30-1,GBPJPYMT4,344,1h 59m,Sell
26360.29,1.4821,13.11.2008 11:15:00,,0.0,-0.0,0.0,0.0,1.47892,13.11.2008 02:30:00,2519,-0.0,90.68,IS,0.34,0.0,Phase3-EA-S4v1-EURCHF-M15-221,EURCHFMT4,736,8h 45m,Buy
26472.58,96182,13.11.2008 17:44:57,tp 96.182,0.0,-0.0,0.0,0.0,95782,13.11.2008 17:00:00,2520,-0.0,112.29,IS,0.27,0.0,Phase3-EA-S1v2-USDJPY-M15-0,USDJPYMT4,984,44m 57s,Buy
26510.29,1.49472,13.11.2008 21:14:58,tp 1.49472,0.0,-0.0,0.0,0.0,1.49362,13.11.2008 21:05:00,2521,-0.0,37.71,IS,0.41,0.0,Phase3-EA-SA2v2-EURCHF-M5-43,EURCHFMT4,1472,9m 58s,Buy
26341.96,1.5102,13.11.2008 22:44:58,sl 1.51020,0.0,-168.33000000000175,0.0,0.0,1.5053,13.11.2008 22:35:00,2522,-0.1444765093280617,-168.33,IS,0.41,0.0,Phase3-EA-SA2v2-EURCHF-M5-43,EURCHFMT4,1474,9m 58s,Sell
26379.86,1.5111,13.11.2008 23:04:58,tp 1.51110,0.0,-130.43000000000757,0.0,0.0,1.5122,13.11.2008 22:50:00,2523,-0.11194719367706282,37.9,IS,0.41,0.0,Phase3-EA-SA2v2-EURCHF-M5-43,EURCHFMT4,1476,14m 58s,Sell
26210.79,1.5165,13.11.2008 23:54:58,sl 1.51650,0.0,-299.50000000001455,0.0,0.0,1.5116,13.11.2008 23:40:00,2524,-0.2570588400389481,-169.07,IS,0.41,0.0,Phase3-EA-SA2v2-EURCHF-M5-43,EURCHFMT4,1478,14m 58s,Sell
26259.61,1.18812,13.11.2008 23:59:57,tp 1.18812,0.0,-250.68000000000757,0.0,0.0,1.18712,13.11.2008 23:45:00,2525,-0.21515696167266218,48.82,IS,0.58,0.0,Phase3-EA-SA2v2-USDCHF-M15-107,USDCHFMT4,610,14m 57s,Buy
26308.53,1.18562,14.11.2008 00:29:58,tp 1.18562,0.0,-201.7600000000093,0.0,0.0,1.18462,14.11.2008 00:15:00,2526,-0.17316925397748928,48.92,IS,0.58,0.0,Phase3-EA-SA2v2-USDCHF-M15-107,USDCHFMT4,612,14m 58s,Buy
26400.19,144.58,14.11.2008 01:29:57,tp 144.580,0.0,-110.10000000000582,0.0,0.0,144.97,14.11.2008 00:05:00,2527,-0.09449809111281571,91.66,IS,0.23,0.0,Phase3-EA-S4v1-GBPJPY-M5-194,GBPJPYMT4,726,1h 24m,Sell
26491.95,145.73,14.11.2008 02:59:57,tp 145.730,0.0,-18.34000000001106,0.0,0.0,146.12,14.11.2008 02:40:00,2528,-0.015741098919255164,91.76,IS,0.23,0.0,Phase3-EA-S4v1-GBPJPY-M5-194,GBPJPYMT4,728,19m 57s,Sell
26606.38,1.5138,14.11.2008 04:14:58,tp 1.51380,0.0,-0.0,0.0,0.0,1.5178,14.11.2008 02:15:00,2529,-0.0,114.43,IS,0.34,0.0,Phase3-EA-S4v1-EURCHF-M15-221,EURCHFMT4,738,1h 59m,Sell
26718.31,96.49,14.11.2008 20:14:57,tp 96.490,0.0,-0.0,0.0,0.0,96.89,14.11.2008 19:45:00,2530,-0.0,111.93,IS,0.27,0.0,Phase3-EA-S1v2-USDJPY-M15-0,USDJPYMT4,986,29m 57s,Sell
26488.37,97.46,14.11.2008 22:59:58,sl 97.460,0.0,-229.94000000000233,0.0,0.0,96.63,14.11.2008 20:30:00,2531,-0.19700422324483827,-229.94,IS,0.27,0.0,Phase3-EA-S1v2-USDJPY-M15-0,USDJPYMT4,988,2h 29m,Sell
26318.96,1.5185,14.11.2008 23:24:58,sl 1.51850,0.0,-399.3500000000058,0.0,0.0,1.5136,14.11.2008 22:10:00,2532,-0.34214854550242024,-169.41,IS,0.41,0.0,Phase3-EA-SA2v2-EURCHF-M5-43,EURCHFMT4,1480,1h 14m,Sell
26367.14,1.18942,17.11.2008 02:00:00,tp 1.18942,-0.58,-351.1700000000128,0.0,0.0,1.18842,14.11.2008 23:30:00,2533,-0.3008696750321461,48.18,IS,0.58,0.0,Phase3-EA-SA2v2-USDCHF-M15-107,USDCHFMT4,614,2d 2h 30m,Buy
26404.73,1.50512,17.11.2008 02:19:58,tp 1.50512,0.0,-313.5800000000163,0.0,0.0,1.50402,17.11.2008 02:00:00,2534,-0.2686639311347263,37.59,IS,0.41,0.0,Phase3-EA-SA2v2-EURCHF-M5-43,EURCHFMT4,1482,19m 58s,Buy
26212.97,140932,17.11.2008 02:44:58,sl 140.932,0.0,-505.34000000001106,0.0,0.0,141732,17.11.2008 02:15:00,2535,-0.4329569199554133,-191.76,IS,0.23,0.0,Phase3-EA-S4v1-GBPJPY-M5-194,GBPJPYMT4,730,29m 58s,Buy
26306.2,141322,17.11.2008 03:04:58,tp 141.322,0.0,-412.11000000001513,0.0,0.0,140932,17.11.2008 02:50:00,2536,-0.3530808490972969,93.23,IS,0.23,0.0,Phase3-EA-S4v1-GBPJPY-M5-194,GBPJPYMT4,732,14m 58s,Buy
26419.72,1.50612,17.11.2008 06:44:58,tp 1.50612,0.0,-298.59000000001106,0.0,0.0,1.50212,17.11.2008 04:30:00,2537,-0.2558210447015649,113.52,IS,0.34,0.0,Phase3-EA-S4v1-EURCHF-M15-221,EURCHFMT4,740,2h 14m,Buy
26457.44,1.5205,17.11.2008 21:09:57,tp 1.52050,0.0,-260.8700000000099,0.0,0.0,1.5216,17.11.2008 20:00:00,2538,-0.22350392153554138,37.72,IS,0.41,0.0,Phase3-EA-SA2v2-EURCHF-M5-43,EURCHFMT4,1484,1h 9m,Sell
26479.21,96742,17.11.2008 23:45:00,,0.0,-239.10000000000582,0.0,0.0,96.82,17.11.2008 17:30:00,2539,-0.20485217786310123,21.77,IS,0.27,0.0,Phase3-EA-S1v2-USDJPY-M15-0,USDJPYMT4,990,6h 15m,Sell
26572.05,144992,18.11.2008 03:19:58,tp 144.992,0.0,-146.2600000000093,0.0,0.0,144602,18.11.2008 00:20:00,2540,-0.12531024481078362,92.84,IS,0.23,0.0,Phase3-EA-S4v1-GBPJPY-M5-194,GBPJPYMT4,734,2h 59m,Buy
26484.03,1.19932,18.11.2008 04:30:00,,0.0,-234.2800000000134,0.0,0.0,1.1975,18.11.2008 00:15:00,2541,-0.20072257728887047,-88.02,IS,0.58,0.0,Phase3-EA-SA2v2-USDCHF-M15-107,USDCHFMT4,616,4h 15m,Sell
26315.6,1.51292,18.11.2008 06:39:59,sl 1.51292,-0.82,-402.7100000000064,0.0,0.0,1.51782,17.11.2008 23:45:00,2542,-0.34502727121392224,-168.43,IS,0.41,0.0,Phase3-EA-SA2v2-EURCHF-M5-43,EURCHFMT4,1486,6h 54m,Buy
26204.97,1.51212,18.11.2008 06:44:58,sl 1.51212,0.0,-513.3400000000111,0.0,0.0,1.51602,18.11.2008 01:00:00,2543,-0.4398110287923216,-110.63,IS,0.34,0.0,Phase3-EA-S4v1-EURCHF-M15-221,EURCHFMT4,742,5h 44m,Buy
26315.39,97092,19.11.2008 00:29:58,tp 97.092,-0.81,-402.9200000000128,0.0,0.0,96692,18.11.2008 21:15:00,2544,-0.3452071915708965,110.42,IS,0.27,0.0,Phase3-EA-S1v2-USDJPY-M15-0,USDJPYMT4,992,3h 14m,Buy
26352.89,1.5177,19.11.2008 00:34:57,tp 1.51770,0.0,-365.4200000000128,0.0,0.0,1.5188,19.11.2008 00:30:00,2545,-0.31307855639788895,37.5,IS,0.41,0.0,Phase3-EA-SA2v2-EURCHF-M5-43,EURCHFMT4,1488,4m 57s,Sell
26445.29,145.0,19.11.2008 00:34:58,tp 145.000,0.0,-273.0200000000186,0.0,0.0,145.39,19.11.2008 00:30:00,2546,-0.23391359933160333,92.4,IS,0.23,0.0,Phase3-EA-S4v1-GBPJPY-M5-194,GBPJPYMT4,736,4m 58s,Sell
26557.18,96.52,19.11.2008 03:44:58,tp 96.520,0.0,-161.1300000000192,0.0,0.0,96.92,19.11.2008 01:45:00,2547,-0.13805031961139538,111.89,IS,0.27,0.0,Phase3-EA-S1v2-USDJPY-M15-0,USDJPYMT4,994,1h 59m,Sell
26594.7,1.5171,19.11.2008 03:49:57,tp 1.51710,0.0,-123.61000000001513,0.0,0.0,1.5182,19.11.2008 01:25:00,2548,-0.10590454916629204,37.52,IS,0.41,0.0,Phase3-EA-SA2v2-EURCHF-M5-43,EURCHFMT4,1490,2h 24m,Sell
26484.66,1.5227,19.11.2008 09:44:57,sl 1.52270,0.0,-233.65000000000873,0.0,0.0,1.5188,19.11.2008 02:15:00,2549,-0.20018281621795997,-110.04,IS,0.34,0.0,Phase3-EA-S4v1-EURCHF-M15-221,EURCHFMT4,744,7h 29m,Sell
26521.93,1.52312,19.11.2008 22:34:57,tp 1.52312,0.0,-196.38000000000466,0.0,0.0,1.52202,19.11.2008 22:30:00,2550,-0.16825123667401,37.27,IS,0.41,0.0,Phase3-EA-SA2v2-EURCHF-M5-43,EURCHFMT4,1492,4m 57s,Buy
26356.24,1.51302,20.11.2008 07:54:57,sl 1.51302,0.0,-362.070000000007,0.0,0.0,1.51792,20.11.2008 00:10:00,2551,-0.31020839832242864,-165.69,IS,0.41,0.0,Phase3-EA-SA2v2-EURCHF-M5-43,EURCHFMT4,1494,7h 44m,Buy
26531.28,140.3,20.11.2008 17:29:58,tp 140.300,0.0,-187.0300000000134,0.0,0.0,142.15,20.11.2008 09:30:00,2552,-0.16024049697088094,175.04,IS,0.09,0.0,Phase3-EA-B1v1-GBPJPY-M30-1,GBPJPYMT4,346,7h 59m,Sell
26467.63,141.24,20.11.2008 20:29:58,sl 141.240,0.0,-250.68000000000757,0.0,0.0,140.57,20.11.2008 17:30:00,2553,-0.21477350040452747,-63.65,IS,0.09,0.0,Phase3-EA-B1v1-GBPJPY-M30-1,GBPJPYMT4,348,2h 59m,Sell
26504.57,1.5337,20.11.2008 21:04:58,tp 1.53370,0.0,-213.74000000000524,0.0,0.0,1.5348,20.11.2008 20:55:00,2554,-0.1831246528501015,36.94,IS,0.41,0.0,Phase3-EA-SA2v2-EURCHF-M5-43,EURCHFMT4,1496,9m 58s,Sell
26307.72,137922,21.11.2008 00:39:58,sl 137.922,-0.88,-410.59000000001106,0.0,0.0,138722,20.11.2008 23:50:00,2555,-0.35177856841828087,-196.85,IS,0.23,0.0,Phase3-EA-S4v1-GBPJPY-M5-194,GBPJPYMT4,738,49m 58s,Buy
26355.05,1.2255,21.11.2008 00:59:58,tp 1.22550,0.0,-363.2600000000093,0.0,0.0,1.2265,21.11.2008 00:45:00,2556,-0.31122794701192075,47.33,IS,0.58,0.0,Phase3-EA-SA2v2-USDCHF-M15-107,USDCHFMT4,618,14m 58s,Sell
26450.29,138.76,21.11.2008 02:34:58,tp 138.760,0.0,-268.0200000000041,0.0,0.0,139.15,21.11.2008 02:25:00,2557,-0.22962978130852318,95.24,IS,0.23,0.0,Phase3-EA-S4v1-GBPJPY-M5-194,GBPJPYMT4,740,9m 58s,Sell
26486.28,1.52752,21.11.2008 06:34:57,tp 1.52752,-0.8,-232.02999999999884,0.0,0.0,1.52642,20.11.2008 23:50:00,2558,-0.19879485917847756,35.99,IS,0.41,0.0,Phase3-EA-SA2v2-EURCHF-M5-43,EURCHFMT4,1498,6h 44m,Buy
26597.23,1.52792,21.11.2008 06:44:57,tp 1.52792,0.0,-121.08000000000175,0.0,0.0,1.52392,21.11.2008 01:45:00,2559,-0.10373693724660833,110.95,IS,0.34,0.0,Phase3-EA-S4v1-EURCHF-M15-221,EURCHFMT4,746,4h 59m,Buy
26363.23,95.77,21.11.2008 23:14:58,sl 95.770,0.0,-355.08000000000175,0.0,0.0,94.94,21.11.2008 18:45:00,2560,-0.30421962072617553,-234.0,IS,0.27,0.0,Phase3-EA-S1v2-USDJPY-M15-0,USDJPYMT4,996,4h 29m,Sell
26400.14,1536,21.11.2008 23:44:58,tp 1.53600,0.0,-318.16999999999825,0.0,0.0,1.5371,21.11.2008 23:40:00,2561,-0.27259647607988696,36.91,IS,0.41,0.0,Phase3-EA-SA2v2-EURCHF-M5-43,EURCHFMT4,1500,4m 58s,Sell
26207.0,142.88,24.11.2008 02:00:00,sl 142.880,-1.39,-511.3099999999977,0.0,0.0,142.08,21.11.2008 23:45:00,2562,-0.43807179867494467,-193.14,IS,0.23,0.0,Phase3-EA-S4v1-GBPJPY-M5-194,GBPJPYMT4,742,2d 2h 15m,Sell
26300.42,143.17,24.11.2008 02:54:58,tp 143.170,0.0,-417.8899999999994,0.0,0.0,143.56,24.11.2008 02:10:00,2563,-0.3580329427319497,93.42,IS,0.23,0.0,Phase3-EA-S4v1-GBPJPY-M5-194,GBPJPYMT4,744,44m 58s,Sell
26347.97,1.21982,24.11.2008 03:14:57,tp 1.21982,0.0,-370.3399999999965,0.0,0.0,1.21882,24.11.2008 02:45:00,2564,-0.3172938333325736,47.55,IS,0.58,0.0,Phase3-EA-SA2v2-USDCHF-M15-107,USDCHFMT4,620,29m 57s,Buy
26384.97,1.5388,24.11.2008 03:44:58,tp 1.53880,0.0,-333.3399999999965,0.0,0.0,1.5399,24.11.2008 02:15:00,2565,-0.2855935799618728,37.0,IS,0.41,0.0,Phase3-EA-SA2v2-EURCHF-M5-43,EURCHFMT4,1502,1h 29m,Sell
26496.28,1.5368,24.11.2008 04:14:58,tp 1.53680,0.0,-222.02999999999884,0.0,0.0,1.5408,24.11.2008 03:15:00,2566,-0.1902272231323422,111.31,IS,0.34,0.0,Phase3-EA-S4v1-EURCHF-M15-221,EURCHFMT4,748,59m 58s,Sell
26533.9,1.5438,24.11.2008 21:39:58,tp 1.54380,0.0,-184.4100000000035,0.0,0.0,1.5449,24.11.2008 21:35:00,2567,-0.157995776326785,37.62,IS,0.41,0.0,Phase3-EA-SA2v2-EURCHF-M5-43,EURCHFMT4,1504,4m 58s,Sell
26705.9,147072,24.11.2008 23:29:58,tp 147.072,0.0,-12.410000000003492,0.0,0.0,145222,24.11.2008 18:30:00,2568,-0.010632436333256962,172.0,IS,0.09,0.0,Phase3-EA-B1v1-GBPJPY-M30-1,GBPJPYMT4,350,4h 59m,Buy
26743.68,1.5458,25.11.2008 01:09:58,tp 1.54580,0.0,-0.0,0.0,0.0,1.5469,25.11.2008 01:05:00,2569,-0.0,37.78,IS,0.41,0.0,Phase3-EA-SA2v2-EURCHF-M5-43,EURCHFMT4,1506,4m 58s,Sell
26836.17,147.19,25.11.2008 02:05:00,tp 147.190,0.0,-0.0,0.0,0.0,147.58,25.11.2008 01:10:00,2570,-0.0,92.49,IS,0.23,0.0,Phase3-EA-S4v1-GBPJPY-M5-194,GBPJPYMT4,746,55m 0s,Sell
26774.04,147112,25.11.2008 02:29:57,sl 147.112,0.0,-62.13000000000466,0.0,0.0,147782,25.11.2008 01:00:00,2571,-0.05317702557350576,-62.13,IS,0.09,0.0,Phase3-EA-B1v1-GBPJPY-M30-1,GBPJPYMT4,352,1h 29m,Buy
26887.71,1.5421,25.11.2008 03:44:57,tp 1.54210,0.0,-0.0,0.0,0.0,1.5461,25.11.2008 01:15:00,2572,-0.0,113.67,IS,0.34,0.0,Phase3-EA-S4v1-EURCHF-M15-221,EURCHFMT4,750,2h 29m,Sell
26697.43,145952,25.11.2008 04:09:59,sl 145.952,0.0,-190.27999999999884,0.0,0.0,146752,25.11.2008 03:05:00,2573,-0.16278871405727674,-190.28,IS,0.23,0.0,Phase3-EA-S4v1-GBPJPY-M5-194,GBPJPYMT4,748,1h 4m,Buy
26655.43,1.51252,25.11.2008 05:59:58,sl 1.51252,0.0,-232.27999999999884,0.0,0.0,1.51552,25.11.2008 05:30:00,2574,-0.19872063538587495,-42.0,IS,0.14,0.0,Phase3-EA-B1v1-GBPUSD-M30-14,GBPUSDMT4,176,29m 58s,Buy
26768.81,1.54712,25.11.2008 10:59:58,tp 1.54712,0.0,-118.89999999999418,0.0,0.0,1.54312,25.11.2008 04:00:00,2575,-0.10172155823738373,113.38,IS,0.34,0.0,Phase3-EA-S4v1-EURCHF-M15-221,EURCHFMT4,752,6h 59m,Buy
26841.76,95492,25.11.2008 18:00:00,,0.0,-45.94999999999709,0.0,0.0,95.75,25.11.2008 17:45:00,2576,-0.03931123297735673,72.95,IS,0.27,0.0,Phase3-EA-S1v2-USDJPY-M15-0,USDJPYMT4,998,15m 0s,Sell
26879.74,1544,25.11.2008 22:14:58,tp 1.54400,0.0,-7.970000000001164,0.0,0.0,1.5451,25.11.2008 22:00:00,2577,-0.006818509833070702,37.98,IS,0.41,0.0,Phase3-EA-SA2v2-EURCHF-M5-43,EURCHFMT4,1508,14m 58s,Sell
26991.9,95.21,26.11.2008 00:29:58,tp 95.210,-1.27,-0.0,0.0,0.0,95.61,25.11.2008 23:00:00,2578,-0.0,112.16,IS,0.27,0.0,Phase3-EA-S1v2-USDJPY-M15-0,USDJPYMT4,1000,1h 29m,Sell
27040.84,1.18502,26.11.2008 01:29:57,tp 1.18502,0.0,-0.0,0.0,0.0,1.18402,26.11.2008 00:30:00,2579,-0.0,48.94,IS,0.58,0.0,Phase3-EA-SA2v2-USDCHF-M15-107,USDCHFMT4,622,59m 57s,Buy
27077.15,1.5452,26.11.2008 02:19:58,tp 1.54520,-1.73,-0.0,0.0,0.0,1.5463,25.11.2008 22:55:00,2580,-0.0,36.31,IS,0.41,0.0,Phase3-EA-SA2v2-EURCHF-M5-43,EURCHFMT4,1510,3h 24m,Sell
27171.52,146502,26.11.2008 03:44:57,tp 146.502,0.0,-0.0,0.0,0.0,146112,26.11.2008 03:35:00,2581,-0.0,94.37,IS,0.23,0.0,Phase3-EA-S4v1-GBPJPY-M5-194,GBPJPYMT4,750,9m 57s,Buy
27285.47,1.54742,26.11.2008 08:29:57,tp 1.54742,0.0,-0.0,0.0,0.0,1.54342,26.11.2008 04:00:00,2582,-0.0,113.95,IS,0.34,0.0,Phase3-EA-S4v1-EURCHF-M15-221,EURCHFMT4,754,4h 29m,Buy
27243.47,1.53982,26.11.2008 18:59:57,sl 1.53982,0.0,-42.0,0.0,0.0,1.54282,26.11.2008 18:30:00,2583,-0.035810062405854715,-42.0,IS,0.14,0.0,Phase3-EA-B1v1-GBPUSD-M30-14,GBPUSDMT4,178,29m 57s,Buy
27356.52,95532,26.11.2008 19:29:57,tp 95.532,0.0,-0.0,0.0,0.0,95132,26.11.2008 17:30:00,2584,-0.0,113.05,IS,0.27,0.0,Phase3-EA-S1v2-USDJPY-M15-0,USDJPYMT4,1002,1h 59m,Buy
27394.01,1.5493,26.11.2008 21:04:58,tp 1.54930,0.0,-0.0,0.0,0.0,1.5504,26.11.2008 20:45:00,2585,-0.0,37.49,IS,0.41,0.0,Phase3-EA-SA2v2-EURCHF-M5-43,EURCHFMT4,1512,19m 58s,Sell
27426.37,1.5501,27.11.2008 01:04:58,tp 1.55010,-5.11,-0.0,0.0,0.0,1.5512,26.11.2008 22:40:00,2586,-0.0,32.36,IS,0.41,0.0,Phase3-EA-SA2v2-EURCHF-M5-43,EURCHFMT4,1514,2h 24m,Sell
27463.85,1.55052,27.11.2008 02:24:59,tp 1.55052,0.0,-0.0,0.0,0.0,1.54942,27.11.2008 01:35:00,2587,-0.0,37.48,IS,0.41,0.0,Phase3-EA-SA2v2-EURCHF-M5-43,EURCHFMT4,1516,49m 59s,Buy
27421.85,1.53762,27.11.2008 10:29:58,sl 1.53762,0.0,-42.0,0.0,0.0,1.54062,27.11.2008 09:30:00,2588,-0.03575568142879704,-42.0,IS,0.14,0.0,Phase3-EA-B1v1-GBPUSD-M30-14,GBPUSDMT4,180,59m 58s,Buy
27287.96,95.18,27.11.2008 10:45:00,,0.0,-175.88999999999942,0.0,0.0,95652,27.11.2008 01:00:00,2589,-0.14973968586931166,-133.89,IS,0.27,0.0,Phase3-EA-S1v2-USDJPY-M15-0,USDJPYMT4,1004,9h 45m,Buy
27325.55,1.5473,27.11.2008 21:14:58,tp 1.54730,0.0,-138.3000000000029,0.0,0.0,1.5484,27.11.2008 20:25:00,2590,-0.1177383509905413,37.59,IS,0.41,0.0,Phase3-EA-SA2v2-EURCHF-M5-43,EURCHFMT4,1518,49m 58s,Sell
27362.7,1.54162,28.11.2008 22:59:58,tp 1.54162,0.0,-101.15000000000873,0.0,0.0,1.54052,28.11.2008 22:10:00,2591,-0.08611159944102696,37.15,IS,0.41,0.0,Phase3-EA-SA2v2-EURCHF-M5-43,EURCHFMT4,1520,49m 58s,Buy
27333.23,146.09,01.12.2008 08:55:00,,0.0,-130.6200000000099,0.0,0.0,146212,01.12.2008 03:30:00,2592,-0.11120016924356721,-29.47,IS,0.23,0.0,Phase3-EA-S4v1-GBPJPY-M5-194,GBPJPYMT4,752,5h 25m,Buy
27223.66,1.52992,01.12.2008 13:14:58,sl 1.52992,0.0,-240.19000000001688,0.0,0.0,1.53382,01.12.2008 05:00:00,2593,-0.20447993148531818,-109.57,IS,0.34,0.0,Phase3-EA-S4v1-EURCHF-M15-221,EURCHFMT4,756,8h 14m,Buy
27338.9,93.72,01.12.2008 17:59:58,tp 93.720,0.0,-124.95000000001164,0.0,0.0,94.12,01.12.2008 17:15:00,2594,-0.1063731522506811,115.24,IS,0.27,0.0,Phase3-EA-S1v2-USDJPY-M15-0,USDJPYMT4,1006,44m 58s,Sell
27364.22,93842,01.12.2008 19:15:00,,0.0,-99.63000000000466,0.0,0.0,93.93,01.12.2008 18:30:00,2595,-0.08481758430360037,25.32,IS,0.27,0.0,Phase3-EA-S1v2-USDJPY-M15-0,USDJPYMT4,1008,45m 0s,Sell
27197.4,1.51972,01.12.2008 20:59:57,sl 1.51972,0.0,-266.45000000001164,0.0,0.0,1.52462,01.12.2008 20:25:00,2596,-0.22683574563579492,-166.82,IS,0.41,0.0,Phase3-EA-SA2v2-EURCHF-M5-43,EURCHFMT4,1522,34m 57s,Buy
27234.91,1.52082,01.12.2008 21:14:57,tp 1.52082,0.0,-228.94000000001688,0.0,0.0,1.51972,01.12.2008 21:05:00,2597,-0.19490251681689041,37.51,IS,0.41,0.0,Phase3-EA-SA2v2-EURCHF-M5-43,EURCHFMT4,1524,9m 57s,Buy
27283.04,1.20502,02.12.2008 02:29:58,tp 1.20502,0.0,-180.81000000001222,0.0,0.0,1.20402,02.12.2008 02:00:00,2598,-0.15392820855098166,48.13,IS,0.58,0.0,Phase3-EA-SA2v2-USDCHF-M15-107,USDCHFMT4,624,29m 58s,Buy
27320.48,1.51842,02.12.2008 02:54:57,tp 1.51842,0.0,-143.3700000000099,0.0,0.0,1.51732,02.12.2008 02:40:00,2599,-0.12205457253445202,37.44,IS,0.41,0.0,Phase3-EA-SA2v2-EURCHF-M5-43,EURCHFMT4,1526,14m 57s,Buy
27433.38,1.52122,02.12.2008 03:59:57,tp 1.52122,0.0,-30.470000000015716,0.0,0.0,1.51722,02.12.2008 03:00:00,2600,-0.025939895550857326,112.9,IS,0.34,0.0,Phase3-EA-S4v1-EURCHF-M15-221,EURCHFMT4,758,59m 57s,Buy
27529.35,139.27,02.12.2008 06:59:58,tp 139.270,0.0,-0.0,0.0,0.0,139.66,02.12.2008 03:55:00,2601,-0.0,95.97,IS,0.23,0.0,Phase3-EA-S4v1-GBPJPY-M5-194,GBPJPYMT4,754,3h 4m,Sell
27708.52,137.99,02.12.2008 11:29:59,tp 137.990,-0.56,-0.0,0.0,0.0,139.84,01.12.2008 18:00:00,2602,-0.0,179.17,IS,0.09,0.0,Phase3-EA-B1v1-GBPJPY-M30-1,GBPJPYMT4,354,17h 29m,Sell
27643.56,137.77,02.12.2008 12:29:58,sl 137.770,0.0,-64.9600000000064,0.0,0.0,137.1,02.12.2008 11:30:00,2603,-0.055187169119114254,-64.96,IS,0.09,0.0,Phase3-EA-B1v1-GBPJPY-M30-1,GBPJPYMT4,356,59m 58s,Sell
27680.96,1.5338,02.12.2008 20:04:57,tp 1.53380,0.0,-27.560000000012224,0.0,0.0,1.5349,02.12.2008 20:00:00,2604,-0.023413768179238202,37.4,IS,0.41,0.0,Phase3-EA-SA2v2-EURCHF-M5-43,EURCHFMT4,1528,4m 57s,Sell
27616.4,138592,02.12.2008 22:29:58,sl 138.592,0.0,-92.1200000000099,0.0,0.0,139262,02.12.2008 15:30:00,2605,-0.07826111482839979,-64.56,IS,0.09,0.0,Phase3-EA-B1v1-GBPJPY-M30-1,GBPJPYMT4,358,6h 59m,Buy
27652.07,1.5323,03.12.2008 01:04:58,tp 1.53230,-1.7,-56.45000000001164,0.0,0.0,1.5334,02.12.2008 23:50:00,2606,-0.047957446071033485,35.67,IS,0.41,0.0,Phase3-EA-SA2v2-EURCHF-M5-43,EURCHFMT4,1530,1h 14m,Sell
27748.31,138902,03.12.2008 04:54:57,tp 138.902,0.0,-0.0,0.0,0.0,138512,03.12.2008 03:20:00,2607,-0.0,96.24,IS,0.23,0.0,Phase3-EA-S4v1-GBPJPY-M5-194,GBPJPYMT4,756,1h 34m,Buy
27720.87,93.37,03.12.2008 05:15:00,,-0.84,-27.44000000000233,0.0,0.0,93462,02.12.2008 21:45:00,2608,-0.023303943810320794,-27.44,IS,0.27,0.0,Phase3-EA-S1v2-USDJPY-M15-0,USDJPYMT4,1010,7h 30m,Buy
27833.2,1.53582,03.12.2008 07:59:58,tp 1.53582,0.0,-0.0,0.0,0.0,1.53182,03.12.2008 04:30:00,2609,-0.0,112.33,IS,0.34,0.0,Phase3-EA-S4v1-EURCHF-M15-221,EURCHFMT4,760,3h 29m,Buy
27870.44,1.53392,03.12.2008 22:04:57,tp 1.53392,0.0,-0.0,0.0,0.0,1.53282,03.12.2008 21:45:00,2610,-0.0,37.24,IS,0.41,0.0,Phase3-EA-SA2v2-EURCHF-M5-43,EURCHFMT4,1532,19m 57s,Buy
27902.75,1.5361,04.12.2008 01:19:58,tp 1.53610,-5.08,-0.0,0.0,0.0,1.5372,03.12.2008 23:40:00,2611,-0.0,32.31,IS,0.41,0.0,Phase3-EA-SA2v2-EURCHF-M5-43,EURCHFMT4,1534,1h 39m,Sell
27715.21,1.20612,04.12.2008 01:29:57,sl 1.20612,0.0,-187.5399999999936,0.0,0.0,1.21002,04.12.2008 00:15:00,2612,-0.15906329580946474,-187.54,IS,0.58,0.0,Phase3-EA-SA2v2-USDCHF-M15-107,USDCHFMT4,626,1h 14m,Buy
27811.55,137.53,04.12.2008 03:04:57,tp 137.530,0.0,-91.19999999999709,0.0,0.0,137.92,04.12.2008 00:10:00,2613,-0.0773518853461833,96.34,IS,0.23,0.0,Phase3-EA-S4v1-GBPJPY-M5-194,GBPJPYMT4,758,2h 54m,Sell
27746.45,136542,04.12.2008 20:59:58,sl 136.542,0.0,-156.3000000000029,0.0,0.0,137212,04.12.2008 19:30:00,2614,-0.13256688245185375,-65.1,IS,0.09,0.0,Phase3-EA-B1v1-GBPJPY-M30-1,GBPJPYMT4,360,1h 29m,Buy
27578.6,1.52972,04.12.2008 22:49:58,sl 1.52972,0.0,-324.15000000000873,0.0,0.0,1.53462,04.12.2008 20:35:00,2615,-0.2749299740676183,-167.85,IS,0.41,0.0,Phase3-EA-SA2v2-EURCHF-M5-43,EURCHFMT4,1536,2h 14m,Buy
27410.49,1.52512,04.12.2008 23:19:57,sl 1.52512,0.0,-492.2600000000093,0.0,0.0,1.53002,04.12.2008 22:55:00,2616,-0.41751358640914615,-168.11,IS,0.41,0.0,Phase3-EA-SA2v2-EURCHF-M5-43,EURCHFMT4,1538,24m 57s,Buy
27448.25,1.52722,04.12.2008 23:29:57,tp 1.52722,0.0,-454.50000000001455,0.0,0.0,1.52612,04.12.2008 23:20:00,2617,-0.38548719177458945,37.76,IS,0.41,0.0,Phase3-EA-SA2v2-EURCHF-M5-43,EURCHFMT4,1540,9m 57s,Buy
27486.07,1.52452,04.12.2008 23:44:59,tp 1.52452,0.0,-416.68000000000757,0.0,0.0,1.52342,04.12.2008 23:40:00,2618,-0.35340990774176834,37.82,IS,0.41,0.0,Phase3-EA-SA2v2-EURCHF-M5-43,EURCHFMT4,1542,4m 59s,Buy
27429.98,135.51,05.12.2008 04:45:00,,-0.9,-472.7700000000041,0.0,0.0,135732,04.12.2008 23:20:00,2619,-0.40098301354294474,-56.09,IS,0.23,0.0,Phase3-EA-S4v1-GBPJPY-M5-194,GBPJPYMT4,760,5h 25m,Buy
27543.4,1.53092,05.12.2008 06:14:58,tp 1.53092,0.0,-359.3500000000058,0.0,0.0,1.52692,05.12.2008 01:45:00,2620,-0.30478508771000334,113.42,IS,0.34,0.0,Phase3-EA-S4v1-EURCHF-M15-221,EURCHFMT4,762,4h 29m,Buy
27432.81,1.5343,05.12.2008 11:29:58,sl 1.53430,0.0,-469.9400000000023,0.0,0.0,1.5304,05.12.2008 06:45:00,2621,-0.39858273025862634,-110.59,IS,0.34,0.0,Phase3-EA-S4v1-EURCHF-M15-221,EURCHFMT4,764,4h 44m,Sell
27362.89,117.42,05.12.2008 22:29:58,sl 117.420,0.0,-539.8600000000006,0.0,0.0,116.7,05.12.2008 17:30:00,2622,-0.45788584235736723,-69.92,IS,0.09,0.0,Phase3-EA-TR1v1-EURJPY-M30-91,EURJPYMT4,2,4h 59m,Sell
27410.31,1.2232,05.12.2008 22:44:57,tp 1.22320,0.0,-492.4400000000023,0.0,0.0,1.2242,05.12.2008 22:15:00,2623,-0.4176662546039024,47.42,IS,0.58,0.0,Phase3-EA-SA2v2-USDCHF-M15-107,USDCHFMT4,628,29m 57s,Sell
27535.09,118612,05.12.2008 22:59:58,tp 118.612,0.0,-367.6600000000035,0.0,0.0,117322,05.12.2008 22:30:00,2624,-0.31183326936819,124.78,IS,0.09,0.0,Phase3-EA-TR1v1-EURJPY-M30-91,EURJPYMT4,4,29m 58s,Buy
27572.02,1.5505,05.12.2008 23:04:58,tp 1.55050,0.0,-330.7300000000105,0.0,0.0,1.5516,05.12.2008 22:45:00,2625,-0.2805108447428161,36.93,IS,0.41,0.0,Phase3-EA-SA2v2-EURCHF-M5-43,EURCHFMT4,1544,19m 58s,Sell
27607.3,1.5529,08.12.2008 02:00:00,tp 1.55290,-1.68,-295.45000000001164,0.0,0.0,1554,05.12.2008 23:40:00,2626,-0.25058787856942416,35.28,IS,0.41,0.0,Phase3-EA-SA2v2-EURCHF-M5-43,EURCHFMT4,1546,2d 2h 20m,Sell
27703.75,136852,08.12.2008 03:14:58,tp 136.852,0.0,-199.00000000001455,0.0,0.0,136462,08.12.2008 02:00:00,2627,-0.1687831708760098,96.45,IS,0.23,0.0,Phase3-EA-S4v1-GBPJPY-M5-194,GBPJPYMT4,762,1h 14m,Buy
27594.65,1.5577,08.12.2008 09:29:58,sl 1.55770,0.0,-308.1000000000204,0.0,0.0,1.5538,08.12.2008 04:15:00,2628,-0.2613170600346646,-109.1,IS,0.34,0.0,Phase3-EA-S4v1-EURCHF-M15-221,EURCHFMT4,766,5h 14m,Sell
27859.25,1.49102,08.12.2008 10:59:57,tp 1.49102,0.0,-43.50000000001455,0.0,0.0,1.47212,08.12.2008 03:30:00,2629,-0.03689481373421279,264.6,IS,0.14,0.0,Phase3-EA-B1v1-GBPUSD-M30-14,GBPUSDMT4,182,7h 29m,Buy
27783.74,120.56,08.12.2008 18:59:58,sl 120.560,0.0,-119.01000000000931,0.0,0.0,119.78,08.12.2008 15:30:00,2630,-0.10093912143695492,-75.51,IS,0.09,0.0,Phase3-EA-TR1v1-EURJPY-M30-91,EURJPYMT4,6,3h 29m,Sell
27821.16,1.55552,08.12.2008 21:44:58,tp 1.55552,0.0,-81.59000000001106,0.0,0.0,1.55442,08.12.2008 21:20:00,2631,-0.06920110005916834,37.42,IS,0.41,0.0,Phase3-EA-SA2v2-EURCHF-M5-43,EURCHFMT4,1548,24m 58s,Buy
27858.61,1.5578,08.12.2008 23:49:58,tp 1.55780,0.0,-44.14000000001397,0.0,0.0,1.5589,08.12.2008 23:00:00,2632,-0.037437633982255705,37.45,IS,0.41,0.0,Phase3-EA-SA2v2-EURCHF-M5-43,EURCHFMT4,1550,49m 58s,Sell
27816.55,120142,08.12.2008 23:59:57,sl 120.142,0.0,-86.20000000001164,0.0,0.0,120372,08.12.2008 23:15:00,2633,-0.0731111021583565,-42.06,IS,0.17,0.0,Phase3-EA-T1v2-EURJPY-M15-322,EURJPYMT4,2,44m 57s,Buy
27853.99,1.5584,09.12.2008 02:09:59,tp 1.55840,0.0,-48.76000000000931,0.0,0.0,1.5595,09.12.2008 01:00:00,2634,-0.04135611764781511,37.44,IS,0.41,0.0,Phase3-EA-SA2v2-EURCHF-M5-43,EURCHFMT4,1552,1h 9m,Sell
27777.12,93.04,09.12.2008 02:45:00,,-0.84,-125.63000000000466,0.0,0.0,93302,08.12.2008 17:00:00,2635,-0.10655391837764998,-76.87,IS,0.27,0.0,Phase3-EA-S1v2-USDJPY-M15-0,USDJPYMT4,1012,9h 45m,Buy
27902.46,118.89,09.12.2008 10:59:57,tp 118.890,0.0,-0.2900000000081491,0.0,0.0,120.18,09.12.2008 02:00:00,2636,-2.459654249015814E-4,125.34,IS,0.09,0.0,Phase3-EA-TR1v1-EURJPY-M30-91,EURJPYMT4,8,8h 59m,Sell
27980.48,1.5599,09.12.2008 14:00:00,,0.0,-0.0,0.0,0.0,1.55712,09.12.2008 05:15:00,2637,-0.0,78.02,IS,0.34,0.0,Phase3-EA-S4v1-EURCHF-M15-221,EURCHFMT4,768,8h 45m,Buy
27915.27,136.71,09.12.2008 18:59:58,sl 136.710,0.0,-65.2100000000064,0.0,0.0,136.04,09.12.2008 16:30:00,2638,-0.05527185514078806,-65.21,IS,0.09,0.0,Phase3-EA-B1v1-GBPJPY-M30-1,GBPJPYMT4,362,2h 29m,Sell
27845.23,119.72,09.12.2008 19:59:58,sl 119.720,0.0,-135.25,0.0,0.0,119.0,09.12.2008 08:30:00,2639,-0.1146376078483492,-70.04,IS,0.09,0.0,Phase3-EA-TR1v1-EURJPY-M30-91,EURJPYMT4,9,11h 29m,Sell
27882.64,1.55982,09.12.2008 21:44:57,tp 1.55982,0.0,-97.83999999999651,0.0,0.0,1.55872,09.12.2008 21:25:00,2640,-0.08292897265716884,37.41,IS,0.41,0.0,Phase3-EA-SA2v2-EURCHF-M5-43,EURCHFMT4,1554,19m 57s,Buy
27840.2,118.96,09.12.2008 22:59:58,sl 118.960,0.0,-140.27999999999884,0.0,0.0,118.73,09.12.2008 22:30:00,2641,-0.11890102498311492,-42.44,IS,0.17,0.0,Phase3-EA-T1v2-EURJPY-M15-322,EURJPYMT4,4,29m 58s,Sell
27876.84,1.55952,10.12.2008 03:09:59,tp 1.55952,-0.82,-103.63999999999942,0.0,0.0,1.55842,09.12.2008 22:10:00,2642,-0.08784504012867168,36.64,IS,0.41,0.0,Phase3-EA-SA2v2-EURCHF-M5-43,EURCHFMT4,1556,4h 59m,Buy
27810.92,136.32,10.12.2008 03:29:58,sl 136.320,-0.57,-169.55999999999767,0.0,0.0,135.65,09.12.2008 23:30:00,2643,-0.1437186897357917,-65.92,IS,0.09,0.0,Phase3-EA-B1v1-GBPJPY-M30-1,GBPJPYMT4,364,3h 59m,Sell
27775.62,136632,10.12.2008 08:50:00,,0.0,-204.86000000000058,0.0,0.0,136.49,10.12.2008 03:25:00,2644,-0.1736388934847533,-35.3,IS,0.23,0.0,Phase3-EA-S4v1-GBPJPY-M5-194,GBPJPYMT4,764,5h 25m,Sell
27667.03,92492,10.12.2008 12:00:00,,0.0,-313.4499999999971,0.0,0.0,92.12,10.12.2008 01:00:00,2645,-0.2656795429209961,-108.59,IS,0.27,0.0,Phase3-EA-S1v2-USDJPY-M15-0,USDJPYMT4,1014,11h 0m,Sell
27624.81,119782,10.12.2008 16:14:58,sl 119.782,0.0,-355.66999999999825,0.0,0.0,120012,10.12.2008 15:30:00,2646,-0.30146512372216017,-42.22,IS,0.17,0.0,Phase3-EA-T1v2-EURJPY-M15-322,EURJPYMT4,6,44m 58s,Buy
27662.54,1.55642,10.12.2008 21:04:58,tp 1.55642,0.0,-317.9400000000023,0.0,0.0,1.55532,10.12.2008 20:55:00,2647,-0.2694852572222138,37.73,IS,0.41,0.0,Phase3-EA-SA2v2-EURCHF-M5-43,EURCHFMT4,1558,9m 58s,Buy
27700.33,1.5561,10.12.2008 21:54:57,tp 1.55610,0.0,-280.15000000000873,0.0,0.0,1.5572,10.12.2008 21:45:00,2648,-0.23745453485187454,37.79,IS,0.41,0.0,Phase3-EA-SA2v2-EURCHF-M5-43,EURCHFMT4,1560,9m 57s,Sell
27622.5,1.56102,11.12.2008 07:40:00,,-5.14,-357.9800000000105,0.0,0.0,1.5589,10.12.2008 23:20:00,2649,-0.3034230747323715,-77.83,IS,0.41,0.0,Phase3-EA-SA2v2-EURCHF-M5-43,EURCHFMT4,1562,8h 20m,Sell
27545.39,121.24,11.12.2008 09:29:58,sl 121.240,-1.02,-435.09000000001106,0.0,0.0,120.46,10.12.2008 23:00:00,2650,-0.3687813441681296,-77.11,IS,0.09,0.0,Phase3-EA-TR1v1-EURJPY-M30-91,EURJPYMT4,12,10h 29m,Sell
27433.91,1.5643,11.12.2008 09:44:58,sl 1.56430,0.0,-546.570000000007,0.0,0.0,1.5604,11.12.2008 01:15:00,2651,-0.46327155136172293,-111.48,IS,0.34,0.0,Phase3-EA-S4v1-EURCHF-M15-221,EURCHFMT4,770,8h 29m,Sell
27471.96,1.5779,11.12.2008 20:14:58,tp 1.57790,0.0,-508.5200000000041,0.0,0.0,1579,11.12.2008 20:10:00,2652,-0.4310204535529982,38.05,IS,0.41,0.0,Phase3-EA-SA2v2-EURCHF-M5-43,EURCHFMT4,1564,4m 58s,Sell
27570.45,91432,12.12.2008 00:45:00,,-1.32,-410.02999999999884,0.0,0.0,91.77,11.12.2008 19:00:00,2653,-0.34754054229987796,98.49,IS,0.27,0.0,Phase3-EA-S1v2-USDJPY-M15-0,USDJPYMT4,1016,5h 45m,Sell
27606.73,1.5789,12.12.2008 03:39:59,tp 1.57890,-1.73,-373.75,0.0,0.0,1.58,11.12.2008 22:00:00,2654,-0.31678969266780416,36.28,IS,0.41,0.0,Phase3-EA-SA2v2-EURCHF-M5-43,EURCHFMT4,1566,5h 39m,Sell
27564.03,121962,12.12.2008 06:29:58,sl 121.962,0.0,-416.4499999999971,0.0,0.0,122192,12.12.2008 05:45:00,2655,-0.3529821204321234,-42.7,IS,0.17,0.0,Phase3-EA-T1v2-EURJPY-M15-322,EURJPYMT4,8,44m 58s,Buy
27692.11,120.77,12.12.2008 07:29:58,tp 120.770,0.0,-288.36999999999534,0.0,0.0,122.06,12.12.2008 02:00:00,2656,-0.2444217890959551,128.08,IS,0.09,0.0,Phase3-EA-TR1v1-EURJPY-M30-91,EURJPYMT4,14,5h 29m,Sell
27580.16,1.57572,12.12.2008 07:29:58,sl 1.57572,0.0,-400.31999999999243,0.0,0.0,1.57962,12.12.2008 04:15:00,2657,-0.33931036727430897,-111.95,IS,0.34,0.0,Phase3-EA-S4v1-EURCHF-M15-221,EURCHFMT4,772,3h 14m,Buy
27609.45,90.33,12.12.2008 17:15:00,,0.0,-371.02999999999884,0.0,0.0,90232,12.12.2008 17:00:00,2658,-0.3144842265432375,29.29,IS,0.27,0.0,Phase3-EA-S1v2-USDJPY-M15-0,USDJPYMT4,1018,15m 0s,Buy
27638.71,90.43,12.12.2008 17:45:00,,0.0,-341.7700000000041,0.0,0.0,90332,12.12.2008 17:15:00,2659,-0.28968351374736245,29.26,IS,0.27,0.0,Phase3-EA-S1v2-USDJPY-M15-0,USDJPYMT4,1020,30m 0s,Buy
27392.88,91.16,12.12.2008 18:59:58,sl 91.160,0.0,-587.6000000000058,0.0,0.0,90.33,12.12.2008 17:15:00,2660,-0.4980484907333875,-245.83,IS,0.27,0.0,Phase3-EA-S1v2-USDJPY-M15-0,USDJPYMT4,1021,1h 44m,Sell
27199.59,1.17382,15.12.2008 02:14:57,sl 1.17382,-0.59,-780.8899999999994,0.0,0.0,1.17772,12.12.2008 22:00:00,2661,-0.6618806772103316,-193.29,IS,0.58,0.0,Phase3-EA-SA2v2-USDCHF-M15-107,USDCHFMT4,630,2d 4h 14m,Buy
27281.01,91.22,15.12.2008 03:45:00,,-0.86,-699.4700000000012,0.0,0.0,90942,12.12.2008 22:00:00,2662,-0.5928692610845467,81.42,IS,0.27,0.0,Phase3-EA-S1v2-USDJPY-M15-0,USDJPYMT4,1024,2d 5h 45m,Buy
27379.41,136.62,15.12.2008 03:59:57,tp 136.620,0.0,-601.070000000007,0.0,0.0,137.01,15.12.2008 03:45:00,2663,-0.5094656336370281,98.4,IS,0.23,0.0,Phase3-EA-S4v1-GBPJPY-M5-194,GBPJPYMT4,766,14m 57s,Sell
27393.34,1.57742,15.12.2008 12:45:00,,0.0,-587.140000000014,0.0,0.0,1.5779,15.12.2008 04:00:00,2664,-0.497658595727034,13.93,IS,0.34,0.0,Phase3-EA-S4v1-EURCHF-M15-221,EURCHFMT4,774,8h 45m,Sell
27351.34,1.50072,15.12.2008 12:59:58,sl 1.50072,0.0,-629.140000000014,0.0,0.0,1.50372,15.12.2008 10:00:00,2665,-0.5332577050034161,-42.0,IS,0.14,0.0,Phase3-EA-B1v1-GBPUSD-M30-14,GBPUSDMT4,184,2h 59m,Buy
27308.27,122142,15.12.2008 15:14:57,sl 122.142,0.0,-672.210000000021,0.0,0.0,122372,15.12.2008 14:45:00,2666,-0.5697637439685118,-43.07,IS,0.17,0.0,Phase3-EA-T1v2-EURJPY-M15-322,EURJPYMT4,10,29m 57s,Buy
27572.87,1.52702,15.12.2008 17:59:58,tp 1.52702,0.0,-407.61000000001513,0.0,0.0,1.50812,15.12.2008 16:30:00,2667,-0.3454893555273002,264.6,IS,0.14,0.0,Phase3-EA-B1v1-GBPUSD-M30-14,GBPUSDMT4,186,1h 29m,Buy
27697.85,123522,15.12.2008 18:29:58,tp 123.522,0.0,-282.6300000000192,0.0,0.0,122262,15.12.2008 04:30:00,2668,-0.23955657749486978,124.98,IS,0.09,0.0,Phase3-EA-TR1v1-EURJPY-M30-91,EURJPYMT4,16,13h 59m,Buy
28016.62,124172,15.12.2008 23:44:57,tp 124.172,0.0,-0.0,0.0,0.0,122472,15.12.2008 17:00:00,2669,-0.0,318.77,IS,0.17,0.0,Phase3-EA-T1v2-EURJPY-M15-322,EURJPYMT4,12,6h 44m,Buy
28053.87,1.5835,16.12.2008 05:54:57,tp 1.58350,-1.77,-0.0,0.0,0.0,1.5846,15.12.2008 21:35:00,2670,-0.0,37.25,IS,0.41,0.0,Phase3-EA-SA2v2-EURCHF-M5-43,EURCHFMT4,1568,8h 19m,Sell
28015.86,123.93,16.12.2008 09:15:00,,0.0,-38.00999999999476,0.0,0.0,124132,16.12.2008 07:15:00,2671,-0.032197165582114995,-38.01,IS,0.17,0.0,Phase3-EA-T1v2-EURJPY-M15-322,EURJPYMT4,14,2h 0m,Buy
27901.03,1.58072,16.12.2008 11:44:58,sl 1.58072,0.0,-152.8399999999965,0.0,0.0,1.58462,16.12.2008 06:30:00,2672,-0.12946631906264197,-114.83,IS,0.34,0.0,Phase3-EA-S4v1-EURCHF-M15-221,EURCHFMT4,776,5h 14m,Buy
28029.76,122.67,16.12.2008 13:59:59,tp 122.670,0.0,-24.110000000000582,0.0,0.0,123.96,16.12.2008 05:30:00,2673,-0.0204228798259647,128.73,IS,0.09,0.0,Phase3-EA-TR1v1-EURJPY-M30-91,EURJPYMT4,18,8h 29m,Sell
28069.27,1.5745,16.12.2008 22:09:58,tp 1.57450,0.0,-0.0,0.0,0.0,1.5756,16.12.2008 22:05:00,2674,-0.0,39.51,IS,0.41,0.0,Phase3-EA-SA2v2-EURCHF-M5-43,EURCHFMT4,1570,4m 58s,Sell
28189.71,89.67,16.12.2008 22:29:58,tp 89.670,0.0,-0.0,0.0,0.0,90.07,16.12.2008 19:00:00,2675,-0.0,120.44,IS,0.27,0.0,Phase3-EA-S1v2-USDJPY-M15-0,USDJPYMT4,1026,3h 29m,Sell
28229.61,1.5769,16.12.2008 22:49:58,tp 1.57690,0.0,-0.0,0.0,0.0,1578,16.12.2008 22:45:00,2676,-0.0,39.9,IS,0.41,0.0,Phase3-EA-SA2v2-EURCHF-M5-43,EURCHFMT4,1572,4m 58s,Sell
28281.26,1.12292,16.12.2008 23:44:57,tp 1.12292,0.0,-0.0,0.0,0.0,1.12192,16.12.2008 23:30:00,2677,-0.0,51.65,IS,0.58,0.0,Phase3-EA-SA2v2-USDCHF-M15-107,USDCHFMT4,632,14m 57s,Buy
28382.08,138702,17.12.2008 03:59:58,tp 138.702,0.0,-0.0,0.0,0.0,138312,17.12.2008 03:05:00,2678,-0.0,100.82,IS,0.23,0.0,Phase3-EA-S4v1-GBPJPY-M5-194,GBPJPYMT4,768,54m 58s,Buy
28503.48,1.57762,17.12.2008 09:44:58,tp 1.57762,0.0,-0.0,0.0,0.0,1.57362,17.12.2008 01:45:00,2679,-0.0,121.4,IS,0.34,0.0,Phase3-EA-S4v1-EURCHF-M15-221,EURCHFMT4,778,7h 59m,Buy
28430.06,124622,17.12.2008 10:29:58,sl 124.622,-0.5,-73.41999999999825,0.0,0.0,125342,16.12.2008 23:30:00,2680,-0.061955986440228004,-73.42,IS,0.09,0.0,Phase3-EA-TR1v1-EURJPY-M30-91,EURJPYMT4,20,10h 59m,Buy
28490.62,88282,17.12.2008 17:15:00,,0.0,-12.860000000000582,0.0,0.0,88.48,17.12.2008 17:00:00,2681,-0.010852001983402167,60.56,IS,0.27,0.0,Phase3-EA-S1v2-USDJPY-M15-0,USDJPYMT4,1028,15m 0s,Sell
28563.61,88042,17.12.2008 17:30:00,,0.0,-0.0,0.0,0.0,88.28,17.12.2008 17:15:00,2682,-0.0,72.99,IS,0.27,0.0,Phase3-EA-S1v2-USDJPY-M15-0,USDJPYMT4,1030,15m 0s,Sell
28605.42,1.54832,17.12.2008 22:19:57,tp 1.54832,0.0,-0.0,0.0,0.0,1.54722,17.12.2008 21:50:00,2683,-0.0,41.81,IS,0.41,0.0,Phase3-EA-SA2v2-EURCHF-M5-43,EURCHFMT4,1574,29m 57s,Buy
28728.72,87.59,17.12.2008 23:29:58,tp 87.590,0.0,-0.0,0.0,0.0,87.99,17.12.2008 21:45:00,2684,-0.0,123.3,IS,0.27,0.0,Phase3-EA-S1v2-USDJPY-M15-0,USDJPYMT4,1032,1h 44m,Sell
28900.42,126.23,18.12.2008 04:00:00,,-2.86,-0.0,0.0,0.0,125332,17.12.2008 18:00:00,2685,-0.0,171.7,IS,0.17,0.0,Phase3-EA-T1v2-EURJPY-M15-322,EURJPYMT4,16,10h 0m,Buy
28870.12,1.5461,18.12.2008 07:05:00,,-2.75,-30.30000000000291,0.0,0.0,1.54682,17.12.2008 22:45:00,2686,-0.025483509646141645,-30.3,IS,0.41,0.0,Phase3-EA-SA2v2-EURCHF-M5-43,EURCHFMT4,1576,8h 20m,Buy
28790.45,127.83,18.12.2008 12:59:57,sl 127.830,0.0,-109.97000000000116,0.0,0.0,127.05,18.12.2008 12:00:00,2687,-0.09248916025696229,-79.67,IS,0.09,0.0,Phase3-EA-TR1v1-EURJPY-M30-91,EURJPYMT4,22,59m 57s,Sell
28717.25,128512,18.12.2008 17:29:57,sl 128.512,0.0,-183.16999999999825,0.0,0.0,129232,18.12.2008 14:30:00,2688,-0.15405328257040504,-73.2,IS,0.09,0.0,Phase3-EA-TR1v1-EURJPY-M30-91,EURJPYMT4,24,2h 59m,Buy
28813.9,88.84,18.12.2008 17:45:00,,0.0,-86.52000000000407,0.0,0.0,88522,18.12.2008 17:00:00,2689,-0.0727667740786821,96.65,IS,0.27,0.0,Phase3-EA-S1v2-USDJPY-M15-0,USDJPYMT4,1034,45m 0s,Buy
28734.8,128.75,18.12.2008 18:29:58,sl 128.750,0.0,-165.6200000000099,0.0,0.0,127.97,18.12.2008 18:00:00,2690,-0.13929303193378964,-79.1,IS,0.09,0.0,Phase3-EA-TR1v1-EURJPY-M30-91,EURJPYMT4,26,29m 58s,Sell
28776.54,1.5423,18.12.2008 21:14:57,tp 1.54230,0.0,-123.88000000000466,0.0,0.0,1.5434,18.12.2008 21:10:00,2691,-0.10418802557636445,41.74,IS,0.41,0.0,Phase3-EA-SA2v2-EURCHF-M5-43,EURCHFMT4,1578,4m 57s,Sell
28830.25,1.07982,18.12.2008 23:29:59,tp 1.07982,0.0,-70.16999999999825,0.0,0.0,1.07882,18.12.2008 23:15:00,2692,-0.05901577134882981,53.71,IS,0.58,0.0,Phase3-EA-SA2v2-USDCHF-M15-107,USDCHFMT4,634,14m 59s,Buy
28929.63,134302,19.12.2008 00:14:57,tp 134.302,-0.93,-0.0,0.0,0.0,133912,18.12.2008 23:35:00,2693,-0.0,99.38,IS,0.23,0.0,Phase3-EA-S4v1-GBPJPY-M5-194,GBPJPYMT4,770,39m 57s,Buy
28980.44,1.0811,19.12.2008 00:44:57,tp 1.08110,-2.84,-0.0,0.0,0.0,1.0821,18.12.2008 23:45:00,2694,-0.0,50.81,IS,0.58,0.0,Phase3-EA-SA2v2-USDCHF-M15-107,USDCHFMT4,636,59m 57s,Sell
29034.12,1.08052,19.12.2008 02:59:58,tp 1.08052,0.0,-0.0,0.0,0.0,1.07952,19.12.2008 02:30:00,2695,-0.0,53.68,IS,0.58,0.0,Phase3-EA-SA2v2-USDCHF-M15-107,USDCHFMT4,638,29m 58s,Buy
29153.63,89712,19.12.2008 03:59:58,tp 89.712,-0.88,-0.0,0.0,0.0,89312,18.12.2008 23:15:00,2696,-0.0,119.51,IS,0.27,0.0,Phase3-EA-S1v2-USDJPY-M15-0,USDJPYMT4,1036,4h 44m,Buy
29030.42,1.53612,19.12.2008 07:59:58,sl 1.53612,0.0,-123.2100000000064,0.0,0.0,1.54002,19.12.2008 04:30:00,2697,-0.10340431928092035,-123.21,IS,0.34,0.0,Phase3-EA-S4v1-EURCHF-M15-221,EURCHFMT4,780,3h 29m,Buy
28988.42,1.4978,19.12.2008 15:29:58,sl 1.49780,0.0,-165.2100000000064,0.0,0.0,1.4948,19.12.2008 15:00:00,2698,-0.13865293067446333,-42.0,IS,0.14,0.0,Phase3-EA-B1v1-GBPUSD-M30-14,GBPUSDMT4,188,29m 58s,Sell
29021.04,89.38,19.12.2008 19:15:00,,0.0,-132.59000000001106,0.0,0.0,89272,19.12.2008 18:15:00,2699,-0.11127650915881553,32.62,IS,0.27,0.0,Phase3-EA-S1v2-USDJPY-M15-0,USDJPYMT4,1038,1h 0m,Buy
29059.52,89.81,19.12.2008 21:15:00,,0.0,-94.11000000001513,0.0,0.0,89682,19.12.2008 21:00:00,2700,-0.07898206710111577,38.48,IS,0.27,0.0,Phase3-EA-S1v2-USDJPY-M15-0,USDJPYMT4,1040,15m 0s,Buy
29100.22,1.53862,19.12.2008 21:59:57,tp 1.53862,0.0,-53.410000000018044,0.0,0.0,1.53752,19.12.2008 21:50:00,2701,-0.04482448415547062,40.7,IS,0.41,0.0,Phase3-EA-SA2v2-EURCHF-M5-43,EURCHFMT4,1580,9m 57s,Buy
29132.74,89.68,19.12.2008 22:15:00,,0.0,-20.89000000001397,0.0,0.0,89572,19.12.2008 22:00:00,2702,-0.017531987905038213,32.52,IS,0.27,0.0,Phase3-EA-S1v2-USDJPY-M15-0,USDJPYMT4,1042,15m 0s,Buy
29185.09,1.10802,19.12.2008 23:29:58,tp 1.10802,0.0,-0.0,0.0,0.0,1.10702,19.12.2008 23:15:00,2703,-0.0,52.35,IS,0.58,0.0,Phase3-EA-SA2v2-USDCHF-M15-107,USDCHFMT4,640,14m 58s,Buy
29284.58,132902,22.12.2008 02:00:00,tp 132.902,-0.93,-0.0,0.0,0.0,132512,19.12.2008 23:25:00,2704,-0.0,99.49,IS,0.23,0.0,Phase3-EA-S4v1-GBPJPY-M5-194,GBPJPYMT4,772,2d 2h 35m,Buy
29324.56,1.53732,22.12.2008 02:00:00,tp 1.53732,-0.89,-0.0,0.0,0.0,1.53622,19.12.2008 23:40:00,2705,-0.0,39.98,IS,0.41,0.0,Phase3-EA-SA2v2-EURCHF-M5-43,EURCHFMT4,1582,2d 2h 20m,Buy
29448.37,1.5375,22.12.2008 09:44:58,tp 1.53750,0.0,-0.0,0.0,0.0,1.5415,22.12.2008 03:15:00,2706,-0.0,123.81,IS,0.34,0.0,Phase3-EA-S4v1-EURCHF-M15-221,EURCHFMT4,782,6h 29m,Sell
29577.84,126372,22.12.2008 10:59:58,tp 126.372,0.0,-0.0,0.0,0.0,125082,22.12.2008 03:00:00,2707,-0.0,129.47,IS,0.09,0.0,Phase3-EA-TR1v1-EURJPY-M30-91,EURJPYMT4,28,7h 59m,Buy
29393.89,1.52192,22.12.2008 20:49:57,sl 1.52192,0.0,-183.9499999999971,0.0,0.0,1.52682,22.12.2008 20:20:00,2708,-0.153832850635199,-183.95,IS,0.41,0.0,Phase3-EA-SA2v2-EURCHF-M5-43,EURCHFMT4,1584,29m 57s,Buy
29435.24,1.52192,22.12.2008 21:04:58,tp 1.52192,0.0,-142.59999999999127,0.0,0.0,1.52082,22.12.2008 20:55:00,2709,-0.11925286491208688,41.35,IS,0.41,0.0,Phase3-EA-SA2v2-EURCHF-M5-43,EURCHFMT4,1586,9m 58s,Buy
29476.48,1.5237,23.12.2008 01:29:57,tp 1.52370,0.0,-101.35999999998603,0.0,0.0,1.5248,23.12.2008 00:20:00,2710,-0.08476486947747686,41.24,IS,0.41,0.0,Phase3-EA-SA2v2-EURCHF-M5-43,EURCHFMT4,1588,1h 9m,Sell
29529.6,1.0919,23.12.2008 01:29:58,tp 1.09190,0.0,-48.23999999999069,0.0,0.0,1.0929,23.12.2008 00:30:00,2711,-0.04034192288470065,53.12,IS,0.58,0.0,Phase3-EA-SA2v2-USDCHF-M15-107,USDCHFMT4,642,59m 58s,Sell
29654.3,1.5244,23.12.2008 12:29:59,tp 1.52440,0.0,-0.0,0.0,0.0,1.5284,23.12.2008 04:15:00,2712,-0.0,124.7,IS,0.34,0.0,Phase3-EA-S4v1-EURCHF-M15-221,EURCHFMT4,784,8h 14m,Sell
29611.05,126062,23.12.2008 17:44:58,sl 126.062,0.0,-43.25,0.0,0.0,126292,23.12.2008 17:30:00,2713,-0.036145796682609845,-43.25,IS,0.17,0.0,Phase3-EA-T1v2-EURJPY-M15-322,EURJPYMT4,18,14m 58s,Buy
29664.41,1.0869,24.12.2008 00:29:57,tp 1.08690,0.0,-0.0,0.0,0.0,1.0879,24.12.2008 00:15:00,2714,-0.0,53.36,IS,0.58,0.0,Phase3-EA-SA2v2-USDCHF-M15-107,USDCHFMT4,644,14m 57s,Sell
29704.04,1.5157,24.12.2008 03:54:59,tp 1.51570,-1.88,-0.0,0.0,0.0,1.5168,23.12.2008 21:20:00,2715,-0.0,39.63,IS,0.41,0.0,Phase3-EA-SA2v2-EURCHF-M5-43,EURCHFMT4,1590,6h 34m,Sell
29581.81,1.51142,24.12.2008 11:29:58,sl 1.51142,0.0,-122.22999999999593,0.0,0.0,1.51532,24.12.2008 05:15:00,2716,-0.1021101710518676,-122.23,IS,0.34,0.0,Phase3-EA-S4v1-EURCHF-M15-221,EURCHFMT4,786,6h 14m,Buy
29623.64,1505,24.12.2008 20:19:58,tp 1.50500,0.0,-80.39999999999418,0.0,0.0,1.5061,24.12.2008 20:15:00,2717,-0.06716565288856936,41.83,IS,0.41,0.0,Phase3-EA-SA2v2-EURCHF-M5-43,EURCHFMT4,1592,4m 58s,Sell
29665.85,1.50452,26.12.2008 21:29:57,tp 1.50452,0.0,-38.189999999987776,0.0,0.0,1.50342,26.12.2008 21:05:00,2718,-0.03190368512206255,42.21,IS,0.41,0.0,Phase3-EA-SA2v2-EURCHF-M5-43,EURCHFMT4,1594,24m 57s,Buy
29788.98,127682,26.12.2008 21:29:58,tp 127.682,-1.95,-0.0,0.0,0.0,126422,23.12.2008 07:00:00,2719,-0.0,123.13,IS,0.09,0.0,Phase3-EA-TR1v1-EURJPY-M30-91,EURJPYMT4,30,3d 14h 29m,Buy
29843.29,1.06792,26.12.2008 23:14:57,tp 1.06792,0.0,-0.0,0.0,0.0,1.06692,26.12.2008 22:45:00,2720,-0.0,54.31,IS,0.58,0.0,Phase3-EA-SA2v2-USDCHF-M15-107,USDCHFMT4,646,29m 57s,Buy
29852.88,90.65,29.12.2008 02:00:00,,-1.73,-0.0,0.0,0.0,90612,26.12.2008 22:30:00,2721,-0.0,9.59,IS,0.27,0.0,Phase3-EA-S1v2-USDJPY-M15-0,USDJPYMT4,1044,2d 3h 30m,Buy
29893.31,1.50312,29.12.2008 02:09:59,tp 1.50312,-1.84,-0.0,0.0,0.0,1.50202,26.12.2008 23:05:00,2722,-0.0,40.43,IS,0.41,0.0,Phase3-EA-SA2v2-EURCHF-M5-43,EURCHFMT4,1596,2d 3h 4m,Buy
29680.26,1.06172,29.12.2008 04:14:58,sl 1.06172,0.0,-213.0500000000029,0.0,0.0,1.06562,29.12.2008 02:30:00,2723,-0.17769965646957536,-213.05,IS,0.58,0.0,Phase3-EA-SA2v2-USDCHF-M15-107,USDCHFMT4,648,1h 44m,Buy
29779.32,132.75,29.12.2008 07:44:58,tp 132.750,0.0,-113.99000000000524,0.0,0.0,133.14,29.12.2008 03:35:00,2724,-0.09507619732911311,99.06,IS,0.23,0.0,Phase3-EA-S4v1-GBPJPY-M5-194,GBPJPYMT4,774,4h 9m,Sell
29907.74,1.50112,29.12.2008 09:14:58,tp 1.50112,0.0,-0.0,0.0,0.0,1.49712,29.12.2008 06:00:00,2725,-0.0,128.42,IS,0.34,0.0,Phase3-EA-S4v1-EURCHF-M15-221,EURCHFMT4,788,3h 14m,Buy
29830.14,128.93,29.12.2008 12:59:58,sl 128.930,0.0,-77.60000000000582,0.0,0.0,128.15,29.12.2008 07:30:00,2726,-0.06471642280974178,-77.6,IS,0.09,0.0,Phase3-EA-TR1v1-EURJPY-M30-91,EURJPYMT4,32,5h 29m,Sell
30149.93,129262,29.12.2008 13:44:59,tp 129.262,0.0,-0.0,0.0,0.0,127562,29.12.2008 02:00:00,2727,-0.0,319.79,IS,0.17,0.0,Phase3-EA-T1v2-EURJPY-M15-322,EURJPYMT4,20,11h 44m,Buy
30078.17,128332,29.12.2008 18:29:58,sl 128.332,0.0,-71.75999999999476,0.0,0.0,129052,29.12.2008 13:00:00,2728,-0.059725378117153144,-71.76,IS,0.09,0.0,Phase3-EA-TR1v1-EURJPY-M30-91,EURJPYMT4,34,5h 29m,Buy
30095.54,90142,29.12.2008 21:15:00,,0.0,-54.38999999999942,0.0,0.0,90.2,29.12.2008 20:00:00,2729,-0.04526844085552065,17.37,IS,0.27,0.0,Phase3-EA-S1v2-USDJPY-M15-0,USDJPYMT4,1046,1h 15m,Sell
30138.27,1.4824,29.12.2008 23:34:57,tp 1.48240,0.0,-11.660000000003492,0.0,0.0,1.4835,29.12.2008 23:25:00,2730,-0.009704541650588977,42.73,IS,0.41,0.0,Phase3-EA-SA2v2-EURCHF-M5-43,EURCHFMT4,1598,9m 57s,Sell
30237.17,130902,30.12.2008 02:14:58,tp 130.902,0.0,-0.0,0.0,0.0,130512,30.12.2008 01:05:00,2731,-0.0,98.9,IS,0.23,0.0,Phase3-EA-S4v1-GBPJPY-M5-194,GBPJPYMT4,776,1h 9m,Buy
30170.69,131.1,30.12.2008 02:59:58,sl 131.100,0.0,-66.47999999999593,0.0,0.0,130.43,30.12.2008 01:00:00,2732,-0.05529072249454639,-66.48,IS,0.09,0.0,Phase3-EA-B1v1-GBPJPY-M30-1,GBPJPYMT4,366,1h 59m,Sell
29967.89,131.82,30.12.2008 04:19:57,sl 131.820,0.0,-269.27999999999884,0.0,0.0,131.02,30.12.2008 02:40:00,2733,-0.22395736692738116,-202.8,IS,0.23,0.0,Phase3-EA-S4v1-GBPJPY-M5-194,GBPJPYMT4,778,1h 39m,Sell
29896.19,128.0,30.12.2008 04:29:58,sl 128.000,-0.35,-340.9799999999959,0.0,0.0,127.28,29.12.2008 23:00:00,2734,-0.2835895089679807,-71.7,IS,0.09,0.0,Phase3-EA-TR1v1-EURJPY-M30-91,EURJPYMT4,36,5h 29m,Sell
29938.93,1.4807,30.12.2008 09:29:58,tp 1.48070,0.0,-298.2399999999907,0.0,0.0,1.4818,30.12.2008 02:35:00,2735,-0.24804309682271375,42.74,IS,0.41,0.0,Phase3-EA-SA2v2-EURCHF-M5-43,EURCHFMT4,1600,6h 54m,Sell
30067.71,1.4802,30.12.2008 09:44:57,tp 1.48020,0.0,-169.45999999999185,0.0,0.0,1.4842,30.12.2008 04:30:00,2736,-0.14093811422872976,128.78,IS,0.34,0.0,Phase3-EA-S4v1-EURCHF-M15-221,EURCHFMT4,790,5h 14m,Sell
30024.44,127.23,30.12.2008 10:59:58,sl 127.230,0.0,-212.72999999999593,0.0,0.0,127.0,30.12.2008 09:15:00,2737,-0.17692532184514664,-43.27,IS,0.17,0.0,Phase3-EA-T1v2-EURJPY-M15-322,EURJPYMT4,22,1h 44m,Sell
30067.14,1.4908,30.12.2008 21:54:57,tp 1.49080,0.0,-170.02999999999884,0.0,0.0,1.4919,30.12.2008 21:45:00,2738,-0.14141217728261482,42.7,IS,0.41,0.0,Phase3-EA-SA2v2-EURCHF-M5-43,EURCHFMT4,1602,9m 57s,Sell
30053.71,90.3,31.12.2008 01:15:00,,-0.87,-183.45999999999185,0.0,0.0,90342,30.12.2008 21:00:00,2739,-0.152581768183659,-13.43,IS,0.27,0.0,Phase3-EA-S1v2-USDJPY-M15-0,USDJPYMT4,1048,4h 15m,Buy
30108.59,1.05682,31.12.2008 04:14:58,tp 1.05682,0.0,-128.5799999999872,0.0,0.0,1.05582,31.12.2008 02:00:00,2740,-0.10693864468033246,54.88,IS,0.58,0.0,Phase3-EA-SA2v2-USDCHF-M15-107,USDCHFMT4,650,2h 14m,Buy
30151.29,1.4899,31.12.2008 05:04:59,tp 1.48990,0.0,-85.8799999999901,0.0,0.0,1491,31.12.2008 02:10:00,2741,-0.07142550011780066,42.7,IS,0.41,0.0,Phase3-EA-SA2v2-EURCHF-M5-43,EURCHFMT4,1604,2h 54m,Sell
30108.02,127.28,31.12.2008 06:59:57,sl 127.280,0.0,-129.14999999999418,0.0,0.0,127.05,31.12.2008 06:00:00,2742,-0.10741270773421753,-43.27,IS,0.17,0.0,Phase3-EA-T1v2-EURJPY-M15-322,EURJPYMT4,24,59m 57s,Sell
30236.91,1.4886,31.12.2008 11:14:58,tp 1.48860,0.0,-0.2599999999947613,0.0,0.0,1.4926,31.12.2008 03:15:00,2743,-2.1623928773004347E-4,128.89,IS,0.34,0.0,Phase3-EA-S4v1-EURCHF-M15-221,EURCHFMT4,792,7h 59m,Sell
30362.23,125.76,31.12.2008 16:29:57,tp 125.760,0.0,-0.0,0.0,0.0,127.02,31.12.2008 00:30:00,2744,-0.0,125.32,IS,0.09,0.0,Phase3-EA-TR1v1-EURJPY-M30-91,EURJPYMT4,38,15h 59m,Sell
30290.64,126.13,31.12.2008 16:59:58,sl 126.130,0.0,-71.58999999999651,0.0,0.0,125.41,31.12.2008 16:30:00,2745,-0.05947879164418652,-71.59,IS,0.09,0.0,Phase3-EA-TR1v1-EURJPY-M30-91,EURJPYMT4,40,29m 58s,Sell
30219.25,126.61,31.12.2008 17:29:57,sl 126.610,0.0,-142.97999999999593,0.0,0.0,125.89,31.12.2008 17:00:00,2746,-0.11879141820486047,-71.39,IS,0.09,0.0,Phase3-EA-TR1v1-EURJPY-M30-91,EURJPYMT4,42,29m 57s,Sell
30483.85,1.46762,31.12.2008 18:29:58,tp 1.46762,0.0,-0.0,0.0,0.0,1.44872,31.12.2008 13:00:00,2747,-0.0,264.6,IS,0.14,0.0,Phase3-EA-B1v1-GBPUSD-M30-14,GBPUSDMT4,190,5h 29m,Buy
30496.5,1.49032,02.01.2009 08:00:00,,-5.75,-0.0,0.0,0.0,1.4908,31.12.2008 21:05:00,2748,-0.0,12.65,IS,0.41,0.0,Phase3-EA-SA2v2-EURCHF-M5-43,EURCHFMT4,1606,1d 10h 55m,Sell
30453.45,126.47,02.01.2009 08:29:57,sl 126.470,0.0,-43.05000000000291,0.0,0.0,126.24,02.01.2009 08:00:00,2749,-0.035727178797726855,-43.05,IS,0.17,0.0,Phase3-EA-T1v2-EURJPY-M15-322,EURJPYMT4,26,29m 57s,Sell
30387.06,132752,02.01.2009 10:59:57,sl 132.752,0.0,-109.44000000000233,0.0,0.0,133422,02.01.2009 08:30:00,2750,-0.09082421481122058,-66.39,IS,0.09,0.0,Phase3-EA-B1v1-GBPJPY-M30-1,GBPJPYMT4,368,2h 29m,Buy
30344.07,126692,02.01.2009 19:14:57,sl 126.692,0.0,-152.43000000000757,0.0,0.0,126922,02.01.2009 18:15:00,2751,-0.12650159963153093,-42.99,IS,0.17,0.0,Phase3-EA-T1v2-EURJPY-M15-322,EURJPYMT4,28,59m 57s,Buy
30408.5,91.36,02.01.2009 20:30:00,,0.0,-88.00000000001455,0.0,0.0,91142,02.01.2009 17:30:00,2752,-0.07303116688037795,64.43,IS,0.27,0.0,Phase3-EA-S1v2-USDJPY-M15-0,USDJPYMT4,1050,3h 0m,Buy
30462.34,1.0772,02.01.2009 22:14:58,tp 1.07720,0.0,-34.160000000018044,0.0,0.0,1.0782,02.01.2009 22:00:00,2753,-0.028349371143575178,53.84,IS,0.58,0.0,Phase3-EA-SA2v2-USDCHF-M15-107,USDCHFMT4,652,14m 58s,Sell
30276.82,1.4985,02.01.2009 23:29:58,sl 1.49850,0.0,-219.68000000002212,0.0,0.0,1.4936,02.01.2009 21:50:00,2754,-0.18231234932136806,-185.52,IS,0.41,0.0,Phase3-EA-SA2v2-EURCHF-M5-43,EURCHFMT4,1608,1h 39m,Sell
30067.96,1083,02.01.2009 23:44:58,sl 1.08300,0.0,-428.5400000000227,0.0,0.0,1.0791,02.01.2009 23:00:00,2755,-0.3556451847149278,-208.86,IS,0.58,0.0,Phase3-EA-SA2v2-USDCHF-M15-107,USDCHFMT4,654,44m 58s,Sell
30109.57,1.5004,02.01.2009 23:54:58,tp 1.50040,0.0,-386.9300000000221,0.0,0.0,1.5015,02.01.2009 23:45:00,2756,-0.3211130613752452,41.61,IS,0.41,0.0,Phase3-EA-SA2v2-EURCHF-M5-43,EURCHFMT4,1610,9m 58s,Sell
30157.46,1.0827,05.01.2009 02:00:00,tp 1.08270,-5.68,-339.0400000000227,0.0,0.0,1.0837,02.01.2009 23:45:00,2757,-0.28136916839910114,47.89,IS,0.58,0.0,Phase3-EA-SA2v2-USDCHF-M15-107,USDCHFMT4,656,2d 2h 15m,Sell
30283.63,1.4975,05.01.2009 02:59:58,tp 1.49750,0.0,-212.87000000002445,0.0,0.0,1.5015,05.01.2009 02:15:00,2758,-0.17666073288437803,126.17,IS,0.34,0.0,Phase3-EA-S4v1-EURCHF-M15-221,EURCHFMT4,794,44m 58s,Sell
30399.33,93342,05.01.2009 20:14:59,tp 93.342,0.0,-97.17000000002736,0.0,0.0,92942,05.01.2009 17:15:00,2759,-0.08064134642917214,115.7,IS,0.27,0.0,Phase3-EA-S1v2-USDJPY-M15-0,USDJPYMT4,1052,2h 59m,Buy
30439.96,1.5064,05.01.2009 23:34:58,tp 1.50640,0.0,-56.5400000000227,0.0,0.0,1.5075,05.01.2009 22:40:00,2760,-0.04692252472065391,40.63,IS,0.41,0.0,Phase3-EA-SA2v2-EURCHF-M5-43,EURCHFMT4,1612,54m 58s,Sell
30259.21,1.5141,06.01.2009 01:44:57,sl 1.51410,0.0,-237.2900000000227,0.0,0.0,1.5092,06.01.2009 00:20:00,2761,-0.1969268816936781,-180.75,IS,0.41,0.0,Phase3-EA-SA2v2-EURCHF-M5-43,EURCHFMT4,1614,1h 24m,Sell
30299.84,1.5128,06.01.2009 02:35:00,tp 1.51280,0.0,-196.66000000001804,0.0,0.0,1.5139,06.01.2009 01:55:00,2762,-0.1632080599851599,40.63,IS,0.41,0.0,Phase3-EA-SA2v2-EURCHF-M5-43,EURCHFMT4,1616,40m 0s,Sell
30422.41,1509,06.01.2009 03:14:58,tp 1.50900,0.0,-74.09000000001106,0.0,0.0,1513,06.01.2009 02:30:00,2763,-0.061487263115535394,122.57,IS,0.34,0.0,Phase3-EA-S4v1-EURCHF-M15-221,EURCHFMT4,796,44m 58s,Sell
30380.45,126.67,06.01.2009 05:44:57,sl 126.670,0.0,-116.05000000001746,0.0,0.0,126.44,06.01.2009 04:15:00,2764,-0.09630985132349698,-41.96,IS,0.17,0.0,Phase3-EA-T1v2-EURJPY-M15-322,EURJPYMT4,30,1h 29m,Sell
30505.07,126.16,06.01.2009 07:59:58,tp 126.160,-0.34,-0.0,0.0,0.0,127.45,05.01.2009 06:00:00,2765,-0.0,124.62,IS,0.09,0.0,Phase3-EA-TR1v1-EURJPY-M30-91,EURJPYMT4,44,1d 1h 59m,Sell
30533.4,93.39,06.01.2009 10:45:00,,0.0,-0.0,0.0,0.0,93292,06.01.2009 01:15:00,2766,-0.0,28.33,IS,0.27,0.0,Phase3-EA-S1v2-USDJPY-M15-0,USDJPYMT4,1054,9h 30m,Buy
30710.97,137682,06.01.2009 12:29:58,tp 137.682,-0.35,-0.0,0.0,0.0,135832,05.01.2009 19:30:00,2767,-0.0,177.57,IS,0.09,0.0,Phase3-EA-B1v1-GBPJPY-M30-1,GBPJPYMT4,370,16h 59m,Buy
30751.28,1.5065,06.01.2009 21:29:57,tp 1.50650,0.0,-0.0,0.0,0.0,1.5076,06.01.2009 20:20:00,2768,-0.0,40.31,IS,0.41,0.0,Phase3-EA-SA2v2-EURCHF-M5-43,EURCHFMT4,1618,1h 9m,Sell
30803.14,1.11842,06.01.2009 22:59:57,tp 1.11842,0.0,-0.0,0.0,0.0,1.11742,06.01.2009 22:00:00,2769,-0.0,51.86,IS,0.58,0.0,Phase3-EA-SA2v2-USDCHF-M15-107,USDCHFMT4,658,59m 57s,Buy
30843.49,1.5103,06.01.2009 23:19:58,tp 1.51030,0.0,-0.0,0.0,0.0,1.5114,06.01.2009 23:15:00,2770,-0.0,40.35,IS,0.41,0.0,Phase3-EA-SA2v2-EURCHF-M5-43,EURCHFMT4,1620,4m 58s,Sell
30895.4,1.11742,07.01.2009 01:29:58,tp 1.11742,0.0,-0.0,0.0,0.0,1.11642,07.01.2009 01:15:00,2771,-0.0,51.91,IS,0.58,0.0,Phase3-EA-SA2v2-USDCHF-M15-107,USDCHFMT4,660,14m 58s,Buy
30654.59,93382,07.01.2009 01:59:57,sl 93.382,-0.83,-240.80999999999767,0.0,0.0,94212,06.01.2009 20:00:00,2772,-0.19918872016635691,-240.81,IS,0.27,0.0,Phase3-EA-S1v2-USDJPY-M15-0,USDJPYMT4,1056,5h 59m,Buy
30750.39,139572,07.01.2009 03:29:58,tp 139.572,0.0,-145.00999999999476,0.0,0.0,139182,07.01.2009 01:55:00,2773,-0.11994666463735996,95.8,IS,0.23,0.0,Phase3-EA-S4v1-GBPJPY-M5-194,GBPJPYMT4,780,1h 34m,Buy
30708.7,126532,07.01.2009 05:44:58,sl 126.532,0.0,-186.6999999999971,0.0,0.0,126762,07.01.2009 05:15:00,2774,-0.15443102053510493,-41.69,IS,0.17,0.0,Phase3-EA-T1v2-EURJPY-M15-322,EURJPYMT4,32,29m 58s,Buy
30588.31,1.50152,07.01.2009 11:59:58,sl 1.50152,0.0,-307.0899999999965,0.0,0.0,1.50542,07.01.2009 05:00:00,2775,-0.25401297319831584,-120.39,IS,0.34,0.0,Phase3-EA-S4v1-EURCHF-M15-221,EURCHFMT4,798,6h 59m,Buy
30546.39,126692,07.01.2009 15:59:58,sl 126.692,0.0,-349.00999999999476,0.0,0.0,126922,07.01.2009 13:45:00,2776,-0.2886875762022335,-41.92,IS,0.17,0.0,Phase3-EA-T1v2-EURJPY-M15-322,EURJPYMT4,34,2h 14m,Buy
30671.53,127492,07.01.2009 16:59:58,tp 127.492,-0.47,-223.86999999999534,0.0,0.0,126202,06.01.2009 17:00:00,2777,-0.18517660721582088,125.14,IS,0.09,0.0,Phase3-EA-TR1v1-EURJPY-M30-91,EURJPYMT4,46,23h 59m,Buy
30712.44,1.5026,07.01.2009 22:24:59,tp 1.50260,0.0,-182.95999999999185,0.0,0.0,1.5037,07.01.2009 21:45:00,2778,-0.15133743715641124,40.91,IS,0.41,0.0,Phase3-EA-SA2v2-EURCHF-M5-43,EURCHFMT4,1622,39m 59s,Sell
30767.3,92522,07.01.2009 23:15:00,,0.0,-128.09999999999127,0.0,0.0,92.71,07.01.2009 21:45:00,2779,-0.10595936652675897,54.86,IS,0.27,0.0,Phase3-EA-S1v2-USDJPY-M15-0,USDJPYMT4,1058,1h 30m,Sell
30861.45,140202,08.01.2009 00:49:59,tp 140.202,-2.68,-33.94999999999709,0.0,0.0,139812,07.01.2009 23:25:00,2780,-0.028082127194249837,94.15,IS,0.23,0.0,Phase3-EA-S4v1-GBPJPY-M5-194,GBPJPYMT4,782,1h 24m,Buy
30892.96,92532,08.01.2009 01:45:00,,0.0,-2.4400000000023283,0.0,0.0,92.64,08.01.2009 01:00:00,2781,-0.0020182736481308057,31.51,IS,0.27,0.0,Phase3-EA-S1v2-USDJPY-M15-0,USDJPYMT4,1060,45m 0s,Sell
30815.84,124672,08.01.2009 21:29:58,sl 124.672,0.0,-79.55999999999767,0.0,0.0,125452,08.01.2009 17:30:00,2782,-0.06580895551029876,-77.12,IS,0.09,0.0,Phase3-EA-TR1v1-EURJPY-M30-91,EURJPYMT4,48,3h 59m,Buy
30868.91,1.0929,08.01.2009 22:29:58,tp 1.09290,0.0,-26.489999999990687,0.0,0.0,1.0939,08.01.2009 22:00:00,2783,-0.02191150366348985,53.07,IS,0.58,0.0,Phase3-EA-SA2v2-USDCHF-M15-107,USDCHFMT4,662,29m 58s,Sell
30910.15,1.4994,08.01.2009 23:19:57,tp 1.49940,0.0,-0.0,0.0,0.0,1.5005,08.01.2009 22:45:00,2784,-0.0,41.24,IS,0.41,0.0,Phase3-EA-SA2v2-EURCHF-M5-43,EURCHFMT4,1624,34m 57s,Sell
31008.48,138.72,08.01.2009 23:24:58,tp 138.720,0.0,-0.0,0.0,0.0,139.11,08.01.2009 23:10:00,2785,-0.0,98.33,IS,0.23,0.0,Phase3-EA-S4v1-GBPJPY-M5-194,GBPJPYMT4,784,14m 58s,Sell
31061.53,1.09322,09.01.2009 00:29:57,tp 1.09322,0.0,-0.0,0.0,0.0,1.09222,09.01.2009 00:15:00,2786,-0.0,53.05,IS,0.58,0.0,Phase3-EA-SA2v2-USDCHF-M15-107,USDCHFMT4,664,14m 57s,Buy
31018.62,125.03,09.01.2009 01:59:58,sl 125.030,0.0,-42.91000000000349,0.0,0.0,124.8,09.01.2009 01:15:00,2787,-0.035444785804378584,-42.91,IS,0.17,0.0,Phase3-EA-T1v2-EURJPY-M15-322,EURJPYMT4,36,44m 58s,Sell
31116.94,138.65,09.01.2009 03:59:58,tp 138.650,0.0,-0.0,0.0,0.0,139.04,09.01.2009 02:25:00,2788,-0.0,98.32,IS,0.23,0.0,Phase3-EA-S4v1-GBPJPY-M5-194,GBPJPYMT4,786,1h 34m,Sell
31159.45,91152,09.01.2009 08:30:00,,-1.33,-0.0,0.0,0.0,91.3,08.01.2009 21:45:00,2789,-0.0,42.51,IS,0.27,0.0,Phase3-EA-S1v2-USDJPY-M15-0,USDJPYMT4,1062,10h 45m,Sell
31116.53,124.93,09.01.2009 10:29:58,sl 124.930,0.0,-42.919999999998254,0.0,0.0,124.7,09.01.2009 04:00:00,2790,-0.035424393227270576,-42.92,IS,0.17,0.0,Phase3-EA-T1v2-EURJPY-M15-322,EURJPYMT4,38,6h 29m,Sell
31074.53,1.52182,09.01.2009 11:59:58,sl 1.52182,0.0,-84.91999999999825,0.0,0.0,1.52482,09.01.2009 11:30:00,2791,-0.07008945649720126,-42.0,IS,0.14,0.0,Phase3-EA-B1v1-GBPUSD-M30-14,GBPUSDMT4,192,29m 58s,Buy
30953.41,1.49352,09.01.2009 11:59:58,sl 1.49352,0.0,-206.0399999999936,0.0,0.0,1.49742,09.01.2009 05:00:00,2792,-0.1700568960984832,-121.12,IS,0.34,0.0,Phase3-EA-S4v1-EURCHF-M15-221,EURCHFMT4,800,6h 59m,Buy
30876.65,123592,09.01.2009 17:29:58,sl 123.592,0.0,-282.79999999998836,0.0,0.0,124372,09.01.2009 17:00:00,2793,-0.23341142601752363,-76.76,IS,0.09,0.0,Phase3-EA-TR1v1-EURJPY-M30-91,EURJPYMT4,50,29m 58s,Buy
30917.06,1.4984,09.01.2009 22:59:58,tp 1.49840,0.0,-242.38999999998487,0.0,0.0,1.4995,09.01.2009 22:15:00,2794,-0.20005868299995172,40.41,IS,0.41,0.0,Phase3-EA-SA2v2-EURCHF-M5-43,EURCHFMT4,1626,44m 58s,Sell
31035.62,90.07,12.01.2009 02:00:00,tp 90.070,-1.35,-123.8299999999872,0.0,0.0,90.47,09.01.2009 22:45:00,2795,-0.10220416154083505,118.56,IS,0.27,0.0,Phase3-EA-S1v2-USDJPY-M15-0,USDJPYMT4,1064,2d 3h 15m,Sell
31076.02,1.49662,12.01.2009 04:14:59,tp 1.49662,0.0,-83.42999999999302,0.0,0.0,1.49552,12.01.2009 02:15:00,2796,-0.06885967210976368,40.4,IS,0.41,0.0,Phase3-EA-SA2v2-EURCHF-M5-43,EURCHFMT4,1628,1h 59m,Buy
31088.27,135.94,12.01.2009 07:40:00,,0.0,-71.17999999999302,0.0,0.0,135892,12.01.2009 02:15:00,2797,-0.058749028656033896,12.25,IS,0.23,0.0,Phase3-EA-S4v1-GBPJPY-M5-194,GBPJPYMT4,788,5h 25m,Buy
31010.06,119942,12.01.2009 18:29:58,sl 119.942,0.0,-149.38999999999942,0.0,0.0,120722,12.01.2009 11:00:00,2798,-0.12330032861654582,-78.21,IS,0.09,0.0,Phase3-EA-TR1v1-EURJPY-M30-91,EURJPYMT4,52,7h 29m,Buy
31050.56,1.48782,12.01.2009 20:39:58,tp 1.48782,0.0,-108.88999999999942,0.0,0.0,1.48672,12.01.2009 20:35:00,2799,-0.08987330332054122,40.5,IS,0.41,0.0,Phase3-EA-SA2v2-EURCHF-M5-43,EURCHFMT4,1630,4m 58s,Buy
31091.08,1.49,12.01.2009 23:14:58,tp 1.49000,0.0,-68.36999999999534,0.0,0.0,1.4911,12.01.2009 22:00:00,2800,-0.0564297708515476,40.52,IS,0.41,0.0,Phase3-EA-SA2v2-EURCHF-M5-43,EURCHFMT4,1632,1h 14m,Sell
31135.83,89.29,13.01.2009 01:15:00,,0.0,-23.619999999995343,0.0,0.0,89142,13.01.2009 00:15:00,2801,-0.019494971296085743,44.75,IS,0.27,0.0,Phase3-EA-S1v2-USDJPY-M15-0,USDJPYMT4,1066,1h 0m,Buy
31101.95,89252,13.01.2009 07:45:00,,0.0,-57.5,0.0,0.0,89.14,13.01.2009 00:15:00,2802,-0.04745812233383367,-33.88,IS,0.27,0.0,Phase3-EA-S1v2-USDJPY-M15-0,USDJPYMT4,1067,7h 30m,Sell
31053.72,1.4884,13.01.2009 08:55:00,,0.0,-105.72999999999593,0.0,0.0,1.48972,13.01.2009 00:35:00,2803,-0.0872651699888007,-48.23,IS,0.41,0.0,Phase3-EA-SA2v2-EURCHF-M5-43,EURCHFMT4,1634,8h 20m,Buy
30974.72,118672,13.01.2009 08:59:58,sl 118.672,-0.5,-184.72999999999593,0.0,0.0,119452,12.01.2009 21:30:00,2804,-0.15246850328224174,-79.0,IS,0.09,0.0,Phase3-EA-TR1v1-EURJPY-M30-91,EURJPYMT4,54,11h 29m,Buy
30895.84,117722,13.01.2009 21:59:59,sl 117.722,0.0,-263.6100000000006,0.0,0.0,118502,13.01.2009 14:00:00,2805,-0.21757279353777254,-78.88,IS,0.09,0.0,Phase3-EA-TR1v1-EURJPY-M30-91,EURJPYMT4,56,7h 59m,Buy
30716.45,1.47422,13.01.2009 22:04:58,sl 1.47422,0.0,-443.0,0.0,0.0,1.47912,13.01.2009 20:05:00,2806,-0.3656338816328403,-179.39,IS,0.41,0.0,Phase3-EA-SA2v2-EURCHF-M5-43,EURCHFMT4,1636,1h 59m,Buy
30756.67,1.47592,13.01.2009 22:19:57,tp 1.47592,0.0,-402.77999999999884,0.0,0.0,1.47482,13.01.2009 22:10:00,2807,-0.33243795675863425,40.22,IS,0.41,0.0,Phase3-EA-SA2v2-EURCHF-M5-43,EURCHFMT4,1638,9m 57s,Buy
30731.04,89.44,14.01.2009 04:15:00,,-0.88,-428.4100000000035,0.0,0.0,89522,13.01.2009 20:45:00,2808,-0.35359189893978865,-25.63,IS,0.27,0.0,Phase3-EA-S1v2-USDJPY-M15-0,USDJPYMT4,1070,7h 30m,Buy
30860.3,119092,14.01.2009 08:59:58,tp 119.092,0.0,-299.15000000000873,0.0,0.0,117802,14.01.2009 02:00:00,2809,-0.24690603993333488,129.26,IS,0.09,0.0,Phase3-EA-TR1v1-EURJPY-M30-91,EURJPYMT4,58,6h 59m,Buy
30741.22,1.4822,14.01.2009 10:14:58,sl 1.48220,0.0,-418.2300000000105,0.0,0.0,1.4783,14.01.2009 05:00:00,2810,-0.34518974789008267,-119.08,IS,0.34,0.0,Phase3-EA-S4v1-EURCHF-M15-221,EURCHFMT4,802,5h 14m,Sell
30781.6,1.4715,14.01.2009 20:24:57,tp 1.47150,0.0,-377.8500000000058,0.0,0.0,1.4726,14.01.2009 20:10:00,2811,-0.3118617656319883,40.38,IS,0.41,0.0,Phase3-EA-SA2v2-EURCHF-M5-43,EURCHFMT4,1640,14m 57s,Sell
30822.03,1.47092,14.01.2009 22:34:58,tp 1.47092,0.0,-337.4200000000128,0.0,0.0,1.46982,14.01.2009 22:15:00,2812,-0.2784925154414394,40.43,IS,0.41,0.0,Phase3-EA-SA2v2-EURCHF-M5-43,EURCHFMT4,1642,19m 58s,Buy
30862.39,1.47072,14.01.2009 23:29:57,tp 1.47072,0.0,-297.0600000000122,0.0,0.0,1.46962,14.01.2009 23:15:00,2813,-0.2451810403563341,40.36,IS,0.41,0.0,Phase3-EA-SA2v2-EURCHF-M5-43,EURCHFMT4,1644,14m 57s,Buy
30970.11,88862,15.01.2009 01:15:00,,-4.09,-189.34000000001106,0.0,0.0,89.23,14.01.2009 21:00:00,2814,-0.15627340665545378,107.72,IS,0.27,0.0,Phase3-EA-S1v2-USDJPY-M15-0,USDJPYMT4,1072,4h 15m,Sell
30926.12,117.25,15.01.2009 02:44:58,sl 117.250,0.0,-233.3300000000163,0.0,0.0,117.02,15.01.2009 02:00:00,2815,-0.19258093363746406,-43.99,IS,0.17,0.0,Phase3-EA-T1v2-EURJPY-M15-322,EURJPYMT4,40,44m 58s,Sell
31026.83,129.73,15.01.2009 05:04:58,tp 129.730,0.0,-132.6200000000099,0.0,0.0,130.12,15.01.2009 03:15:00,2816,-0.1094590640680607,100.71,IS,0.23,0.0,Phase3-EA-S4v1-GBPJPY-M5-194,GBPJPYMT4,790,1h 49m,Sell
30982.85,117.36,15.01.2009 09:29:57,sl 117.360,0.0,-176.60000000000582,0.0,0.0,117.13,15.01.2009 06:15:00,2817,-0.14575833746357048,-43.98,IS,0.17,0.0,Phase3-EA-T1v2-EURJPY-M15-322,EURJPYMT4,42,3h 14m,Sell
31104.8,1.47412,15.01.2009 12:44:57,tp 1.47412,0.0,-54.65000000000873,0.0,0.0,1.47012,15.01.2009 05:30:00,2818,-0.04510585018338129,121.95,IS,0.34,0.0,Phase3-EA-S4v1-EURCHF-M15-221,EURCHFMT4,804,7h 14m,Buy
31060.93,116.64,15.01.2009 18:44:58,sl 116.640,0.0,-98.52000000000407,0.0,0.0,116.41,15.01.2009 18:30:00,2819,-0.08131433412746933,-43.87,IS,0.17,0.0,Phase3-EA-T1v2-EURJPY-M15-322,EURJPYMT4,44,14m 58s,Sell
31017.2,117.05,15.01.2009 21:44:57,sl 117.050,0.0,-142.25,0.0,0.0,116.82,15.01.2009 20:45:00,2820,-0.11740726786065807,-43.73,IS,0.17,0.0,Phase3-EA-T1v2-EURJPY-M15-322,EURJPYMT4,46,59m 57s,Sell
31137.59,89712,15.01.2009 21:59:58,tp 89.712,0.0,-21.860000000000582,0.0,0.0,89312,15.01.2009 20:45:00,2821,-0.018042340073350115,120.39,IS,0.27,0.0,Phase3-EA-S1v2-USDJPY-M15-0,USDJPYMT4,1074,1h 14m,Buy
31177.81,1.4741,15.01.2009 23:49:58,tp 1.47410,0.0,-0.0,0.0,0.0,1.4752,15.01.2009 22:00:00,2822,-0.0,40.22,IS,0.41,0.0,Phase3-EA-SA2v2-EURCHF-M5-43,EURCHFMT4,1646,1h 49m,Sell
31229.46,1123,16.01.2009 01:59:58,tp 1.12300,0.0,-0.0,0.0,0.0,1124,16.01.2009 00:45:00,2823,-0.0,51.65,IS,0.58,0.0,Phase3-EA-SA2v2-USDCHF-M15-107,USDCHFMT4,666,1h 14m,Sell
31329.32,131.76,16.01.2009 03:39:58,tp 131.760,0.0,-0.0,0.0,0.0,132.15,16.01.2009 03:20:00,2824,-0.0,99.86,IS,0.23,0.0,Phase3-EA-S4v1-GBPJPY-M5-194,GBPJPYMT4,792,19m 58s,Sell
31450.91,1.47992,16.01.2009 07:59:58,tp 1.47992,0.0,-0.0,0.0,0.0,1.47592,16.01.2009 05:30:00,2825,-0.0,121.59,IS,0.34,0.0,Phase3-EA-S4v1-EURCHF-M15-221,EURCHFMT4,806,2h 29m,Buy
31769.66,119602,16.01.2009 08:29:57,tp 119.602,-0.93,-0.0,0.0,0.0,117902,15.01.2009 22:00:00,2826,-0.0,318.75,IS,0.17,0.0,Phase3-EA-T1v2-EURJPY-M15-322,EURJPYMT4,48,10h 29m,Buy
31810.73,90.72,16.01.2009 18:30:00,,0.0,-0.0,0.0,0.0,90582,16.01.2009 18:15:00,2827,-0.0,41.07,IS,0.27,0.0,Phase3-EA-S1v2-USDJPY-M15-0,USDJPYMT4,1076,15m 0s,Buy
31744.09,133462,16.01.2009 19:59:58,sl 133.462,0.0,-66.63999999999942,0.0,0.0,134132,16.01.2009 10:30:00,2828,-0.05470782417936372,-66.64,IS,0.09,0.0,Phase3-EA-B1v1-GBPJPY-M30-1,GBPJPYMT4,372,9h 29m,Buy
31784.53,1.48012,16.01.2009 21:44:57,tp 1.48012,0.0,-26.19999999999709,0.0,0.0,1.47902,16.01.2009 20:15:00,2829,-0.021508778413853284,40.44,IS,0.41,0.0,Phase3-EA-SA2v2-EURCHF-M5-43,EURCHFMT4,1648,1h 29m,Buy
31909.05,120792,19.01.2009 02:00:00,tp 120.792,-0.49,-0.0,0.0,0.0,119532,16.01.2009 10:00:00,2830,-0.0,124.52,IS,0.09,0.0,Phase3-EA-TR1v1-EURJPY-M30-91,EURJPYMT4,60,2d 16h 0m,Buy
31726.56,1.4883,19.01.2009 02:19:59,sl 1.48830,-1.84,-182.49000000000524,0.0,0.0,1.4834,16.01.2009 22:20:00,2831,-0.14969356253699403,-182.49,IS,0.41,0.0,Phase3-EA-SA2v2-EURCHF-M5-43,EURCHFMT4,1650,2d 3h 59m,Sell
31778.6,1.11452,19.01.2009 02:44:58,tp 1.11452,0.0,-130.45000000001164,0.0,0.0,1.11352,19.01.2009 02:30:00,2832,-0.1070060016053047,52.04,IS,0.58,0.0,Phase3-EA-SA2v2-USDCHF-M15-107,USDCHFMT4,668,14m 58s,Buy
31877.13,135.29,19.01.2009 03:34:57,tp 135.290,0.0,-31.920000000012806,0.0,0.0,135.68,19.01.2009 02:35:00,2833,-0.02618345397656107,98.53,IS,0.23,0.0,Phase3-EA-S4v1-GBPJPY-M5-194,GBPJPYMT4,794,59m 57s,Sell
31917.53,1.4892,19.01.2009 04:19:58,tp 1.48920,0.0,-0.0,0.0,0.0,1.4903,19.01.2009 02:40:00,2834,-0.0,40.4,IS,0.41,0.0,Phase3-EA-SA2v2-EURCHF-M5-43,EURCHFMT4,1652,1h 39m,Sell
32045.48,120.16,19.01.2009 10:29:58,tp 120.160,0.0,-0.0,0.0,0.0,121.45,19.01.2009 06:00:00,2835,-0.0,127.95,IS,0.09,0.0,Phase3-EA-TR1v1-EURJPY-M30-91,EURJPYMT4,62,4h 29m,Sell
32167.18,1.4865,19.01.2009 11:59:59,tp 1.48650,0.0,-0.0,0.0,0.0,1.4905,19.01.2009 03:30:00,2836,-0.0,121.7,IS,0.34,0.0,Phase3-EA-S4v1-EURCHF-M15-221,EURCHFMT4,808,8h 29m,Sell
32218.35,1.1335,20.01.2009 02:14:59,tp 1.13350,0.0,-0.0,0.0,0.0,1.1345,20.01.2009 01:15:00,2837,-0.0,51.17,IS,0.58,0.0,Phase3-EA-SA2v2-USDCHF-M15-107,USDCHFMT4,670,59m 59s,Sell
32317.34,130712,20.01.2009 02:49:59,tp 130.712,0.0,-0.0,0.0,0.0,130322,20.01.2009 01:25:00,2838,-0.0,98.99,IS,0.23,0.0,Phase3-EA-S4v1-GBPJPY-M5-194,GBPJPYMT4,796,1h 24m,Buy
32368.49,1.13382,20.01.2009 03:14:58,tp 1.13382,0.0,-0.0,0.0,0.0,1.13282,20.01.2009 02:30:00,2839,-0.0,51.15,IS,0.58,0.0,Phase3-EA-SA2v2-USDCHF-M15-107,USDCHFMT4,672,44m 58s,Buy
32351.63,90472,20.01.2009 03:15:00,,-1.34,-16.860000000000582,0.0,0.0,90.42,19.01.2009 20:45:00,2840,-0.013778056753009369,-16.86,IS,0.27,0.0,Phase3-EA-S1v2-USDJPY-M15-0,USDJPYMT4,1078,6h 30m,Sell
32174.24,1.48022,20.01.2009 03:49:58,sl 1.48022,-0.87,-194.25,0.0,0.0,1.48512,19.01.2009 23:10:00,2841,-0.1587418460422288,-177.39,IS,0.41,0.0,Phase3-EA-SA2v2-EURCHF-M5-43,EURCHFMT4,1654,4h 39m,Buy
32299.21,117.53,20.01.2009 03:59:58,tp 117.530,-0.35,-69.27999999999884,0.0,0.0,118.79,19.01.2009 18:30:00,2842,-0.056615882078792416,124.97,IS,0.09,0.0,Phase3-EA-TR1v1-EURJPY-M30-91,EURJPYMT4,64,9h 29m,Sell
32483.21,128.91,20.01.2009 03:59:58,tp 128.910,0.0,-0.0,0.0,0.0,130.76,20.01.2009 01:00:00,2843,-0.0,184.0,IS,0.09,0.0,Phase3-EA-B1v1-GBPJPY-M30-1,GBPJPYMT4,374,2h 59m,Sell
32366.5,1.47902,20.01.2009 03:59:58,sl 1.47902,0.0,-116.7100000000064,0.0,0.0,1.48292,20.01.2009 01:30:00,2844,-0.0952865294761678,-116.71,IS,0.34,0.0,Phase3-EA-S4v1-EURCHF-M15-221,EURCHFMT4,810,2h 29m,Buy
32162.42,128442,20.01.2009 07:29:58,sl 128.442,0.0,-320.79000000000815,0.0,0.0,129242,20.01.2009 03:40:00,2845,-0.2619052848141459,-204.08,IS,0.23,0.0,Phase3-EA-S4v1-GBPJPY-M5-194,GBPJPYMT4,798,3h 49m,Buy
32095.52,128.7,20.01.2009 08:59:58,sl 128.700,0.0,-387.6900000000023,0.0,0.0,128.03,20.01.2009 07:30:00,2846,-0.3165250159593324,-66.9,IS,0.09,0.0,Phase3-EA-B1v1-GBPJPY-M30-1,GBPJPYMT4,376,1h 29m,Sell
32214.67,1.48282,20.01.2009 11:14:58,tp 1.48282,0.0,-268.54000000000815,0.0,0.0,1.47882,20.01.2009 05:00:00,2847,-0.21924637670747557,119.15,IS,0.34,0.0,Phase3-EA-S4v1-EURCHF-M15-221,EURCHFMT4,812,6h 14m,Buy
32399.28,125.76,20.01.2009 14:59:58,tp 125.760,0.0,-83.93000000000757,0.0,0.0,127.61,20.01.2009 11:00:00,2848,-0.06852367765345768,184.61,IS,0.09,0.0,Phase3-EA-B1v1-GBPJPY-M30-1,GBPJPYMT4,378,3h 59m,Sell
32321.41,116512,20.01.2009 17:59:58,sl 116.512,0.0,-161.8000000000029,0.0,0.0,117292,20.01.2009 10:30:00,2849,-0.13209973840496428,-77.87,IS,0.09,0.0,Phase3-EA-TR1v1-EURJPY-M30-91,EURJPYMT4,66,7h 29m,Buy
32360.87,1.4802,20.01.2009 20:34:57,tp 1.48020,0.0,-122.33999999999651,0.0,0.0,1.4813,20.01.2009 20:25:00,2850,-0.09988307785205548,39.46,IS,0.41,0.0,Phase3-EA-SA2v2-EURCHF-M5-43,EURCHFMT4,1656,9m 57s,Sell
32400.11,1.4799,20.01.2009 22:19:57,tp 1.47990,0.0,-83.09999999999127,0.0,0.0,1481,20.01.2009 20:55:00,2851,-0.06784603375433362,39.24,IS,0.41,0.0,Phase3-EA-SA2v2-EURCHF-M5-43,EURCHFMT4,1658,1h 24m,Sell
32439.37,1.48022,20.01.2009 23:14:57,tp 1.48022,0.0,-43.83999999999651,0.0,0.0,1.47912,20.01.2009 23:10:00,2852,-0.03579266088796705,39.26,IS,0.41,0.0,Phase3-EA-SA2v2-EURCHF-M5-43,EURCHFMT4,1660,4m 57s,Buy
32760.68,115.46,21.01.2009 01:14:57,tp 115.460,-0.66,-0.0,0.0,0.0,117.16,20.01.2009 14:00:00,2853,-0.0,321.31,IS,0.17,0.0,Phase3-EA-T1v2-EURJPY-M15-322,EURJPYMT4,50,11h 14m,Sell
32688.61,116.09,21.01.2009 04:59:58,sl 116.090,0.0,-72.07000000000698,0.0,0.0,115.37,21.01.2009 02:00:00,2854,-0.05870772302662957,-72.07,IS,0.09,0.0,Phase3-EA-TR1v1-EURJPY-M30-91,EURJPYMT4,68,2h 59m,Sell
32727.14,1.48072,21.01.2009 05:09:57,tp 1.48072,-0.86,-33.54000000000815,0.0,0.0,1.47962,20.01.2009 23:30:00,2855,-0.02732145178733791,38.53,IS,0.41,0.0,Phase3-EA-SA2v2-EURCHF-M5-43,EURCHFMT4,1662,5h 39m,Buy
32659.54,125.92,21.01.2009 05:59:57,sl 125.920,-0.58,-101.14000000001397,0.0,0.0,125.25,20.01.2009 22:00:00,2856,-0.08238794376180879,-67.6,IS,0.09,0.0,Phase3-EA-B1v1-GBPJPY-M30-1,GBPJPYMT4,380,7h 59m,Sell
32543.47,1484,21.01.2009 08:59:58,sl 1.48400,0.0,-217.21000000002095,0.0,0.0,1.4801,21.01.2009 05:30:00,2857,-0.17693776215643406,-116.07,IS,0.34,0.0,Phase3-EA-S4v1-EURCHF-M15-221,EURCHFMT4,814,3h 29m,Sell
32500.1,116292,21.01.2009 18:14:59,sl 116.292,0.0,-260.5800000000163,0.0,0.0,116522,21.01.2009 17:30:00,2858,-0.21226666388620238,-43.37,IS,0.17,0.0,Phase3-EA-T1v2-EURJPY-M15-322,EURJPYMT4,52,44m 59s,Buy
32824.24,113.68,21.01.2009 18:44:58,tp 113.680,0.0,-0.0,0.0,0.0,115.38,21.01.2009 18:15:00,2859,-0.0,324.14,IS,0.17,0.0,Phase3-EA-T1v2-EURJPY-M15-322,EURJPYMT4,54,29m 58s,Sell
33010.98,121.11,21.01.2009 18:59:58,tp 121.110,0.0,-0.0,0.0,0.0,122.96,21.01.2009 18:30:00,2860,-0.0,186.74,IS,0.09,0.0,Phase3-EA-B1v1-GBPJPY-M30-1,GBPJPYMT4,382,29m 58s,Sell
33050.28,1.47762,21.01.2009 20:14:58,tp 1.47762,0.0,-0.0,0.0,0.0,1.47652,21.01.2009 20:10:00,2861,-0.0,39.3,IS,0.41,0.0,Phase3-EA-SA2v2-EURCHF-M5-43,EURCHFMT4,1664,4m 58s,Buy
32877.28,1.4948,21.01.2009 22:29:58,sl 1.49480,0.0,-173.0,0.0,0.0,1.4899,21.01.2009 21:30:00,2862,-0.14059293485557298,-173.0,IS,0.41,0.0,Phase3-EA-SA2v2-EURCHF-M5-43,EURCHFMT4,1666,59m 58s,Sell
32703.72,1.5,21.01.2009 23:04:57,sl 1.50000,0.0,-346.5599999999977,0.0,0.0,1.4951,21.01.2009 22:45:00,2863,-0.28164096822859563,-173.56,IS,0.41,0.0,Phase3-EA-SA2v2-EURCHF-M5-43,EURCHFMT4,1668,19m 57s,Sell
32453.41,89.53,21.01.2009 23:14:58,sl 89.530,0.0,-596.8699999999953,0.0,0.0,88.7,21.01.2009 22:30:00,2864,-0.48506187877020335,-250.31,IS,0.27,0.0,Phase3-EA-S1v2-USDJPY-M15-0,USDJPYMT4,1080,44m 58s,Sell
32247.66,124.97,21.01.2009 23:49:58,sl 124.970,0.0,-802.6199999999953,0.0,0.0,124.17,21.01.2009 23:15:00,2865,-0.6522699501374527,-205.75,IS,0.23,0.0,Phase3-EA-S4v1-GBPJPY-M5-194,GBPJPYMT4,800,34m 58s,Sell
32073.93,1.5032,21.01.2009 23:49:58,sl 1.50320,0.0,-976.3499999999913,0.0,0.0,1.4983,21.01.2009 23:05:00,2866,-0.7934561384175575,-173.73,IS,0.41,0.0,Phase3-EA-SA2v2-EURCHF-M5-43,EURCHFMT4,1670,44m 58s,Sell
32112.98,1.5023,21.01.2009 23:59:58,tp 1.50230,0.0,-937.2999999999884,0.0,0.0,1.5034,21.01.2009 23:50:00,2867,-0.7617211435845486,39.05,IS,0.41,0.0,Phase3-EA-SA2v2-EURCHF-M5-43,EURCHFMT4,1672,9m 58s,Sell
32152.14,1.50162,22.01.2009 02:39:57,tp 1.50162,0.0,-898.1399999999849,0.0,0.0,1.50052,22.01.2009 02:35:00,2868,-0.729896754399897,39.16,IS,0.41,0.0,Phase3-EA-SA2v2-EURCHF-M5-43,EURCHFMT4,1674,4m 57s,Buy
32269.53,88.91,22.01.2009 03:14:58,tp 88.910,-4.08,-780.7499999999854,0.0,0.0,89.31,21.01.2009 23:15:00,2869,-0.634496727679113,117.39,IS,0.27,0.0,Phase3-EA-S1v2-USDJPY-M15-0,USDJPYMT4,1082,3h 59m,Sell
32370.61,123452,22.01.2009 03:29:57,tp 123.452,0.0,-679.6699999999837,0.0,0.0,123062,22.01.2009 03:20:00,2870,-0.552351445279104,101.08,IS,0.23,0.0,Phase3-EA-S4v1-GBPJPY-M5-194,GBPJPYMT4,802,9m 57s,Buy
32391.32,88652,22.01.2009 19:15:00,,0.0,-658.9599999999773,0.0,0.0,88.72,22.01.2009 18:15:00,2871,-0.5355209268926311,20.71,IS,0.27,0.0,Phase3-EA-S1v2-USDJPY-M15-0,USDJPYMT4,1084,1h 0m,Sell
32430.38,1.4967,22.01.2009 21:19:57,tp 1.49670,0.0,-619.8999999999796,0.0,0.0,1.4978,22.01.2009 21:10:00,2872,-0.5037778053003862,39.06,IS,0.41,0.0,Phase3-EA-SA2v2-EURCHF-M5-43,EURCHFMT4,1676,9m 57s,Sell
32469.45,1.5002,22.01.2009 23:09:58,tp 1.50020,0.0,-580.8299999999726,0.0,0.0,1.5013,22.01.2009 22:10:00,2873,-0.4720265569488936,39.07,IS,0.41,0.0,Phase3-EA-SA2v2-EURCHF-M5-43,EURCHFMT4,1678,59m 58s,Sell
32508.59,1.49972,23.01.2009 01:24:59,tp 1.49972,0.0,-541.6899999999732,0.0,0.0,1.49862,23.01.2009 01:05:00,2874,-0.44021842128272576,39.14,IS,0.41,0.0,Phase3-EA-SA2v2-EURCHF-M5-43,EURCHFMT4,1680,19m 59s,Buy
32558.65,89.04,23.01.2009 03:15:00,,-0.88,-491.62999999997555,0.0,0.0,88872,22.01.2009 23:30:00,2875,-0.3995358645262538,50.06,IS,0.27,0.0,Phase3-EA-S1v2-USDJPY-M15-0,USDJPYMT4,1086,3h 45m,Buy
32485.61,113.7,23.01.2009 16:29:57,sl 113.700,0.0,-564.6699999999691,0.0,0.0,112.98,23.01.2009 13:30:00,2876,-0.458893714016717,-73.04,IS,0.09,0.0,Phase3-EA-TR1v1-EURJPY-M30-91,EURJPYMT4,70,2h 59m,Sell
32524.43,1.49582,23.01.2009 20:09:58,tp 1.49582,0.0,-525.8499999999622,0.0,0.0,1.49472,23.01.2009 20:05:00,2877,-0.4273456346462296,38.82,IS,0.41,0.0,Phase3-EA-SA2v2-EURCHF-M5-43,EURCHFMT4,1682,4m 58s,Buy
32574.55,1.15712,23.01.2009 22:29:58,tp 1.15712,0.0,-475.7299999999668,0.0,0.0,1.15612,23.01.2009 22:15:00,2878,-0.3866143173343183,50.12,IS,0.58,0.0,Phase3-EA-SA2v2-USDCHF-M15-107,USDCHFMT4,674,14m 58s,Buy
32611.59,1.4978,26.01.2009 04:05:00,tp 1.49780,-1.77,-438.6899999999732,0.0,0.0,1.4989,23.01.2009 21:25:00,2879,-0.3565128011085985,37.04,IS,0.41,0.0,Phase3-EA-SA2v2-EURCHF-M5-43,EURCHFMT4,1684,2d 6h 40m,Sell
32704.11,89.04,26.01.2009 04:45:00,,-0.88,-346.16999999996915,0.0,0.0,88732,23.01.2009 20:00:00,2880,-0.2813240246182044,92.52,IS,0.27,0.0,Phase3-EA-S1v2-USDJPY-M15-0,USDJPYMT4,1088,2d 8h 45m,Buy
32824.89,89422,26.01.2009 18:14:57,tp 89.422,0.0,-225.3899999999703,0.0,0.0,89022,26.01.2009 17:00:00,2881,-0.18316902651499084,120.78,IS,0.27,0.0,Phase3-EA-S1v2-USDJPY-M15-0,USDJPYMT4,1090,1h 14m,Buy
32752.28,116952,26.01.2009 21:29:58,sl 116.952,0.0,-297.9999999999709,0.0,0.0,117672,26.01.2009 20:30:00,2882,-0.24217742535813094,-72.61,IS,0.09,0.0,Phase3-EA-TR1v1-EURJPY-M30-91,EURJPYMT4,72,59m 58s,Buy
32576.32,1.49722,26.01.2009 22:09:59,sl 1.49722,0.0,-473.9599999999773,0.0,0.0,1.50212,26.01.2009 21:05:00,2883,-0.3851758809488102,-175.96,IS,0.41,0.0,Phase3-EA-SA2v2-EURCHF-M5-43,EURCHFMT4,1686,1h 4m,Buy
32615.85,1.49742,26.01.2009 22:49:57,tp 1.49742,0.0,-434.42999999997846,0.0,0.0,1.49632,26.01.2009 22:15:00,2884,-0.35305080167227476,39.53,IS,0.41,0.0,Phase3-EA-SA2v2-EURCHF-M5-43,EURCHFMT4,1688,34m 57s,Buy
32536.94,117.39,26.01.2009 23:29:57,sl 117.390,0.0,-513.339999999982,0.0,0.0,116.61,26.01.2009 22:30:00,2885,-0.41717905883674733,-78.91,IS,0.09,0.0,Phase3-EA-TR1v1-EURJPY-M30-91,EURJPYMT4,74,59m 57s,Sell
32587.96,1.13672,26.01.2009 23:59:58,tp 1.13672,0.0,-462.3199999999779,0.0,0.0,1.13572,26.01.2009 23:45:00,2886,-0.3757163331932103,51.02,IS,0.58,0.0,Phase3-EA-SA2v2-USDCHF-M15-107,USDCHFMT4,676,14m 58s,Buy
32669.43,88822,27.01.2009 01:15:00,,0.0,-380.8499999999767,0.0,0.0,89.09,27.01.2009 01:00:00,2887,-0.30950762566324674,81.47,IS,0.27,0.0,Phase3-EA-S1v2-USDJPY-M15-0,USDJPYMT4,1092,15m 0s,Sell
32608.16,89022,27.01.2009 01:30:00,,0.0,-442.1199999999808,0.0,0.0,88.82,27.01.2009 01:15:00,2888,-0.3593002795279955,-61.27,IS,0.27,0.0,Phase3-EA-S1v2-USDJPY-M15-0,USDJPYMT4,1094,15m 0s,Sell
32577.78,124502,27.01.2009 05:00:00,,-1.5,-472.49999999998545,0.0,0.0,124.39,26.01.2009 23:35:00,2889,-0.3839893740997467,-30.38,IS,0.23,0.0,Phase3-EA-S4v1-GBPJPY-M5-194,GBPJPYMT4,804,5h 25m,Sell
32447.43,1.50272,27.01.2009 09:20:00,,0.0,-602.8499999999913,0.0,0.0,1.4991,27.01.2009 01:00:00,2890,-0.4899216807958436,-130.35,IS,0.41,0.0,Phase3-EA-SA2v2-EURCHF-M5-43,EURCHFMT4,1690,8h 20m,Sell
32368.95,118.83,27.01.2009 10:29:58,sl 118.830,0.0,-681.3299999999872,0.0,0.0,118.05,27.01.2009 08:00:00,2891,-0.553700487312981,-78.48,IS,0.09,0.0,Phase3-EA-TR1v1-EURJPY-M30-91,EURJPYMT4,76,2h 29m,Sell
32119.53,89.85,27.01.2009 10:29:58,sl 89.850,0.0,-930.7499999999854,0.0,0.0,89.02,27.01.2009 01:30:00,2892,-0.756398116282211,-249.42,IS,0.27,0.0,Phase3-EA-S1v2-USDJPY-M15-0,USDJPYMT4,1096,8h 59m,Sell
32002.75,1.5058,27.01.2009 11:44:58,sl 1.50580,0.0,-1047.5299999999843,0.0,0.0,1.5019,27.01.2009 06:00:00,2893,-0.8513024106893419,-116.78,IS,0.34,0.0,Phase3-EA-S4v1-EURCHF-M15-221,EURCHFMT4,816,5h 44m,Sell
32124.28,88.87,27.01.2009 18:14:57,tp 88.870,0.0,-925.9999999999854,0.0,0.0,89.27,27.01.2009 17:15:00,2894,-0.7525379056431128,121.53,IS,0.27,0.0,Phase3-EA-S1v2-USDJPY-M15-0,USDJPYMT4,1098,59m 57s,Sell
32255.59,116.91,27.01.2009 18:29:58,tp 116.910,0.0,-794.6899999999878,0.0,0.0,118.2,27.01.2009 13:30:00,2895,-0.6458254300599627,131.31,IS,0.09,0.0,Phase3-EA-TR1v1-EURJPY-M30-91,EURJPYMT4,78,4h 59m,Sell
32285.39,88792,27.01.2009 21:15:00,,0.0,-764.8899999999849,0.0,0.0,88.89,27.01.2009 19:30:00,2896,-0.621607687524145,29.8,IS,0.27,0.0,Phase3-EA-S1v2-USDJPY-M15-0,USDJPYMT4,1100,1h 45m,Sell
32384.76,125.71,28.01.2009 00:24:58,tp 125.710,-1.5,-665.5199999999895,0.0,0.0,126.1,27.01.2009 23:35:00,2897,-0.5408520809542164,99.37,IS,0.23,0.0,Phase3-EA-S4v1-GBPJPY-M5-194,GBPJPYMT4,806,49m 58s,Sell
32435.59,1141,28.01.2009 00:44:58,tp 1.14100,0.0,-614.6899999999878,0.0,0.0,1142,28.01.2009 00:30:00,2898,-0.49954376373624526,50.83,IS,0.58,0.0,Phase3-EA-SA2v2-USDCHF-M15-107,USDCHFMT4,678,14m 58s,Sell
32536.19,125972,28.01.2009 01:29:59,tp 125.972,0.0,-514.089999999982,0.0,0.0,125582,28.01.2009 00:40:00,2899,-0.4177885657797628,100.6,IS,0.23,0.0,Phase3-EA-S4v1-GBPJPY-M5-194,GBPJPYMT4,808,49m 59s,Buy
32358.24,1.5071,28.01.2009 02:44:58,sl 1.50710,-1.8,-692.039999999979,0.0,0.0,1.5022,27.01.2009 23:40:00,2900,-0.5624042464592357,-177.95,IS,0.41,0.0,Phase3-EA-SA2v2-EURCHF-M5-43,EURCHFMT4,1692,3h 4m,Sell
32397.83,1.5056,28.01.2009 03:39:57,tp 1.50560,0.0,-652.4499999999825,0.0,0.0,1.5067,28.01.2009 02:50:00,2901,-0.5302304066272608,39.59,IS,0.41,0.0,Phase3-EA-SA2v2-EURCHF-M5-43,EURCHFMT4,1694,49m 57s,Sell
32498.53,125.87,28.01.2009 04:04:57,tp 125.870,0.0,-551.7499999999854,0.0,0.0,126.26,28.01.2009 01:45:00,2902,-0.4483939410783835,100.7,IS,0.23,0.0,Phase3-EA-S4v1-GBPJPY-M5-194,GBPJPYMT4,810,2h 19m,Sell
32432.9,89082,28.01.2009 10:30:00,,-1.37,-617.3799999999901,0.0,0.0,88.87,27.01.2009 23:15:00,2903,-0.5017298619718626,-65.63,IS,0.27,0.0,Phase3-EA-S1v2-USDJPY-M15-0,USDJPYMT4,1102,11h 15m,Sell
32417.33,1.50702,28.01.2009 12:15:00,,0.0,-632.9499999999971,0.0,0.0,1.5065,28.01.2009 03:30:00,2904,-0.51438322610887,-15.57,IS,0.34,0.0,Phase3-EA-S4v1-EURCHF-M15-221,EURCHFMT4,818,8h 45m,Sell
32349.76,127372,28.01.2009 17:59:58,sl 127.372,0.0,-700.5200000000041,0.0,0.0,128042,28.01.2009 16:00:00,2905,-0.5692957382949512,-67.57,IS,0.09,0.0,Phase3-EA-B1v1-GBPJPY-M30-1,GBPJPYMT4,384,1h 59m,Buy
32460.57,89.67,28.01.2009 18:30:00,,0.0,-589.7100000000064,0.0,0.0,89302,28.01.2009 17:30:00,2906,-0.47924311915422446,110.81,IS,0.27,0.0,Phase3-EA-S1v2-USDJPY-M15-0,USDJPYMT4,1104,1h 0m,Buy
32499.88,1.5165,28.01.2009 22:24:57,tp 1.51650,0.0,-550.4000000000087,0.0,0.0,1.5176,28.01.2009 22:10:00,2907,-0.4472968285809745,39.31,IS,0.41,0.0,Phase3-EA-SA2v2-EURCHF-M5-43,EURCHFMT4,1696,14m 57s,Sell
32550.63,1.1429,28.01.2009 22:29:57,tp 1.14290,0.0,-499.65000000000873,0.0,0.0,1.1439,28.01.2009 22:15:00,2908,-0.40605352543692635,50.75,IS,0.58,0.0,Phase3-EA-SA2v2-USDCHF-M15-107,USDCHFMT4,680,14m 57s,Sell
32589.66,1.5161,28.01.2009 22:29:58,tp 1.51610,0.0,-460.6200000000099,0.0,0.0,1.5172,28.01.2009 22:25:00,2909,-0.37433478412240123,39.03,IS,0.41,0.0,Phase3-EA-SA2v2-EURCHF-M5-43,EURCHFMT4,1698,4m 58s,Sell
32628.82,1.51342,28.01.2009 23:44:57,tp 1.51342,0.0,-421.4600000000064,0.0,0.0,1.51232,28.01.2009 23:40:00,2910,-0.3425103949377496,39.16,IS,0.41,0.0,Phase3-EA-SA2v2-EURCHF-M5-43,EURCHFMT4,1700,4m 57s,Buy
32679.14,1.15272,29.01.2009 01:59:58,tp 1.15272,0.0,-371.1399999999994,0.0,0.0,1.15172,29.01.2009 01:30:00,2911,-0.30161654244102465,50.32,IS,0.58,0.0,Phase3-EA-SA2v2-USDCHF-M15-107,USDCHFMT4,682,29m 58s,Buy
32600.37,119.09,29.01.2009 02:29:58,sl 119.090,-1.05,-449.9100000000035,0.0,0.0,118.31,28.01.2009 23:30:00,2912,-0.3656310249761348,-78.77,IS,0.09,0.0,Phase3-EA-TR1v1-EURJPY-M30-91,EURJPYMT4,80,2h 59m,Sell
32615.03,118.96,29.01.2009 02:30:00,,0.0,-435.25,0.0,0.0,118882,29.01.2009 01:15:00,2913,-0.35371719592998924,14.66,IS,0.17,0.0,Phase3-EA-T1v2-EURJPY-M15-322,EURJPYMT4,56,1h 15m,Buy
32654.16,1515,29.01.2009 02:39:57,tp 1.51500,0.0,-396.11999999999534,0.0,0.0,1.5161,29.01.2009 01:35:00,2914,-0.32191718702305727,39.13,IS,0.41,0.0,Phase3-EA-SA2v2-EURCHF-M5-43,EURCHFMT4,1702,1h 4m,Sell
32586.34,127802,29.01.2009 05:29:57,sl 127.802,-1.08,-463.9400000000023,0.0,0.0,128472,28.01.2009 19:30:00,2915,-0.37703286819014364,-67.82,IS,0.09,0.0,Phase3-EA-B1v1-GBPJPY-M30-1,GBPJPYMT4,386,9h 59m,Buy
32471.82,1.50992,29.01.2009 11:44:58,sl 1.50992,0.0,-578.4600000000064,0.0,0.0,1.51382,29.01.2009 04:30:00,2916,-0.47010051500899214,-114.52,IS,0.34,0.0,Phase3-EA-S4v1-EURCHF-M15-221,EURCHFMT4,820,7h 14m,Buy
32601.4,117.28,29.01.2009 18:29:58,tp 117.280,0.0,-448.88000000000466,0.0,0.0,118.57,29.01.2009 04:00:00,2917,-0.3647939687743945,129.58,IS,0.09,0.0,Phase3-EA-TR1v1-EURJPY-M30-91,EURJPYMT4,82,14h 29m,Sell
32709.36,89532,29.01.2009 19:30:00,,0.0,-340.91999999999825,0.0,0.0,89.89,29.01.2009 18:30:00,2918,-0.2770574760171196,107.96,IS,0.27,0.0,Phase3-EA-S1v2-USDJPY-M15-0,USDJPYMT4,1106,1h 0m,Sell
32748.49,1.49372,29.01.2009 20:29:59,tp 1.49372,0.0,-301.7899999999936,0.0,0.0,1.49262,29.01.2009 20:15:00,2919,-0.24525746711018767,39.13,IS,0.41,0.0,Phase3-EA-SA2v2-EURCHF-M5-43,EURCHFMT4,1704,14m 59s,Buy
33069.41,115.78,30.01.2009 03:29:58,tp 115.780,-0.66,-0.0,0.0,0.0,117.48,29.01.2009 18:45:00,2920,-0.0,320.92,IS,0.17,0.0,Phase3-EA-T1v2-EURJPY-M15-322,EURJPYMT4,58,8h 44m,Sell
33186.93,1.49282,30.01.2009 11:14:57,tp 1.49282,0.0,-0.0,0.0,0.0,1.48882,30.01.2009 05:00:00,2921,-0.0,117.52,IS,0.34,0.0,Phase3-EA-S4v1-EURCHF-M15-221,EURCHFMT4,822,6h 14m,Buy
33143.29,115.02,30.01.2009 19:44:58,sl 115.020,0.0,-43.63999999999942,0.0,0.0,114.79,30.01.2009 19:30:00,2922,-0.035425836166222704,-43.64,IS,0.17,0.0,Phase3-EA-T1v2-EURJPY-M15-322,EURJPYMT4,60,14m 58s,Sell
33205.81,89.83,30.01.2009 19:45:00,,0.0,-0.0,0.0,0.0,89622,30.01.2009 19:30:00,2923,-0.0,62.52,IS,0.27,0.0,Phase3-EA-S1v2-USDJPY-M15-0,USDJPYMT4,1108,15m 0s,Buy
33211.22,89.85,30.01.2009 20:30:00,,0.0,-0.0,0.0,0.0,89832,30.01.2009 19:45:00,2924,-0.0,5.41,IS,0.27,0.0,Phase3-EA-S1v2-USDJPY-M15-0,USDJPYMT4,1110,45m 0s,Buy
33250.05,1.48782,30.01.2009 20:49:57,tp 1.48782,0.0,-0.0,0.0,0.0,1.48672,30.01.2009 20:15:00,2925,-0.0,38.83,IS,0.41,0.0,Phase3-EA-SA2v2-EURCHF-M5-43,EURCHFMT4,1706,34m 57s,Buy
33206.55,115.33,30.01.2009 21:14:58,sl 115.330,0.0,-43.5,0.0,0.0,115.1,30.01.2009 19:45:00,2926,-0.03529410332896419,-43.5,IS,0.17,0.0,Phase3-EA-T1v2-EURJPY-M15-322,EURJPYMT4,62,1h 29m,Sell
33174.97,89.68,02.02.2009 02:00:00,,-0.87,-75.08000000000175,0.0,0.0,89782,30.01.2009 23:45:00,2927,-0.06091681098709639,-31.58,IS,0.27,0.0,Phase3-EA-S1v2-USDJPY-M15-0,USDJPYMT4,1112,2d 2h 15m,Buy
33301.08,114.33,02.02.2009 02:59:58,tp 114.330,-0.35,-0.0,0.0,0.0,115.59,30.01.2009 05:00:00,2928,-0.0,126.11,IS,0.09,0.0,Phase3-EA-TR1v1-EURJPY-M30-91,EURJPYMT4,84,2d 21h 59m,Sell
33401.1,129382,02.02.2009 03:54:58,tp 129.382,0.0,-0.0,0.0,0.0,128992,02.02.2009 03:00:00,2929,-0.0,100.02,IS,0.23,0.0,Phase3-EA-S4v1-GBPJPY-M5-194,GBPJPYMT4,812,54m 58s,Buy
33439.78,1.48492,02.02.2009 05:14:58,tp 1.48492,0.0,-0.0,0.0,0.0,1.48382,02.02.2009 02:10:00,2930,-0.0,38.68,IS,0.41,0.0,Phase3-EA-SA2v2-EURCHF-M5-43,EURCHFMT4,1708,3h 4m,Buy
33465.48,1485,02.02.2009 12:15:00,,0.0,-0.0,0.0,0.0,1.48412,02.02.2009 03:30:00,2931,-0.0,25.7,IS,0.34,0.0,Phase3-EA-S4v1-EURCHF-M15-221,EURCHFMT4,824,8h 45m,Buy
33595.18,114982,02.02.2009 18:29:57,tp 114.982,0.0,-0.0,0.0,0.0,113692,02.02.2009 15:30:00,2932,-0.0,129.7,IS,0.09,0.0,Phase3-EA-TR1v1-EURJPY-M30-91,EURJPYMT4,86,2h 59m,Buy
33634.1,1.4919,02.02.2009 20:59:59,tp 1.49190,0.0,-0.0,0.0,0.0,1493,02.02.2009 20:55:00,2933,-0.0,38.92,IS,0.41,0.0,Phase3-EA-SA2v2-EURCHF-M5-43,EURCHFMT4,1710,4m 59s,Sell
33607.99,89472,03.02.2009 00:15:00,,-1.36,-26.110000000000582,0.0,0.0,89.39,02.02.2009 17:00:00,2934,-0.021118769012756677,-26.11,IS,0.27,0.0,Phase3-EA-S1v2-USDJPY-M15-0,USDJPYMT4,1114,7h 15m,Sell
33535.04,114672,03.02.2009 01:29:57,sl 114.672,-0.49,-99.05999999999767,0.0,0.0,115392,02.02.2009 20:30:00,2935,-0.08012352579102186,-72.95,IS,0.09,0.0,Phase3-EA-TR1v1-EURJPY-M30-91,EURJPYMT4,88,4h 59m,Buy
33573.92,1.49042,03.02.2009 04:14:57,tp 1.49042,0.0,-60.179999999993015,0.0,0.0,1.48932,03.02.2009 02:10:00,2936,-0.048675891198296475,38.88,IS,0.41,0.0,Phase3-EA-SA2v2-EURCHF-M5-43,EURCHFMT4,1712,2h 4m,Buy
33674.06,127732,03.02.2009 05:19:59,tp 127.732,0.0,-0.0,0.0,0.0,127342,03.02.2009 01:15:00,2937,-0.0,100.14,IS,0.23,0.0,Phase3-EA-S4v1-GBPJPY-M5-194,GBPJPYMT4,814,4h 4m,Buy
33791.26,1.49302,03.02.2009 05:30:00,tp 1.49302,0.0,-0.0,0.0,0.0,1.48902,03.02.2009 02:45:00,2938,-0.0,117.2,IS,0.34,0.0,Phase3-EA-S4v1-EURCHF-M15-221,EURCHFMT4,826,2h 45m,Buy
33747.32,114882,03.02.2009 17:59:57,sl 114.882,0.0,-43.94000000000233,0.0,0.0,115112,03.02.2009 16:00:00,2939,-0.03549523609340624,-43.94,IS,0.17,0.0,Phase3-EA-T1v2-EURJPY-M15-322,EURJPYMT4,64,1h 59m,Buy
33786.64,1.4856,03.02.2009 22:04:58,tp 1.48560,0.0,-4.619999999995343,0.0,0.0,1.4867,03.02.2009 21:15:00,2940,-0.003732089002079264,39.32,IS,0.41,0.0,Phase3-EA-SA2v2-EURCHF-M5-43,EURCHFMT4,1714,49m 58s,Sell
33885.5,128.7,04.02.2009 03:09:58,tp 128.700,-1.5,-0.0,0.0,0.0,129.09,03.02.2009 23:45:00,2941,-0.0,98.86,IS,0.23,0.0,Phase3-EA-S4v1-GBPJPY-M5-194,GBPJPYMT4,816,3h 24m,Sell
33923.04,1.4877,04.02.2009 03:54:58,tp 1.48770,-1.79,-0.0,0.0,0.0,1.4888,03.02.2009 22:50:00,2942,-0.0,37.54,IS,0.41,0.0,Phase3-EA-SA2v2-EURCHF-M5-43,EURCHFMT4,1716,5h 4m,Sell
33875.79,89422,04.02.2009 10:00:00,,-1.36,-47.25,0.0,0.0,89.27,03.02.2009 20:45:00,2943,-0.03812850298055958,-47.25,IS,0.27,0.0,Phase3-EA-S1v2-USDJPY-M15-0,USDJPYMT4,1116,13h 15m,Sell
33803.1,114.98,04.02.2009 16:59:58,sl 114.980,0.0,-119.94000000000233,0.0,0.0,115.37,04.02.2009 11:00:00,2944,-0.09678587613732073,-72.69,IS,0.09,0.0,Phase3-EA-TR1v1-EURJPY-M30-91,EURJPYMT4,90,5h 59m,Sell
33842.01,1.48992,05.02.2009 01:09:59,tp 1.48992,0.0,-81.02999999999884,0.0,0.0,1.48882,05.02.2009 01:05:00,2945,-0.06538735653999361,38.91,IS,0.41,0.0,Phase3-EA-SA2v2-EURCHF-M5-43,EURCHFMT4,1718,4m 59s,Buy
33793.49,89.44,05.02.2009 07:30:00,,-2.63,-129.5500000000029,0.0,0.0,89592,04.02.2009 22:45:00,2946,-0.10454068912447839,-48.52,IS,0.27,0.0,Phase3-EA-S1v2-USDJPY-M15-0,USDJPYMT4,1118,8h 45m,Buy
33792.89,89.8,05.02.2009 17:15:00,,0.0,-130.15000000000873,0.0,0.0,89802,05.02.2009 17:00:00,2947,-0.1050248605909029,-0.6,IS,0.27,0.0,Phase3-EA-S1v2-USDJPY-M15-0,USDJPYMT4,1120,15m 0s,Buy
33804.31,89.84,05.02.2009 17:45:00,,0.0,-118.73000000001048,0.0,0.0,89802,05.02.2009 17:30:00,2948,-0.09580946368004736,11.42,IS,0.27,0.0,Phase3-EA-S1v2-USDJPY-M15-0,USDJPYMT4,1122,15m 0s,Buy
33794.69,89.81,05.02.2009 18:00:00,,0.0,-128.35000000000582,0.0,0.0,89842,05.02.2009 17:45:00,2949,-0.10357234619164114,-9.62,IS,0.27,0.0,Phase3-EA-S1v2-USDJPY-M15-0,USDJPYMT4,1124,15m 0s,Buy
33715.79,116.15,05.02.2009 19:29:58,sl 116.150,-1.06,-207.25,0.0,0.0,114.26,04.02.2009 16:00:00,2950,-0.1672408940258407,-78.9,IS,0.09,0.0,Phase3-EA-TR1v1-EURJPY-M30-91,EURJPYMT4,91,1d 3h 29m,Sell
34033.33,117542,05.02.2009 20:14:57,tp 117.542,0.0,-0.0,0.0,0.0,115842,05.02.2009 19:00:00,2951,-0.0,317.54,IS,0.17,0.0,Phase3-EA-T1v2-EURJPY-M15-322,EURJPYMT4,66,1h 14m,Buy
34072.11,1.4961,05.02.2009 20:24:59,tp 1.49610,0.0,-0.0,0.0,0.0,1.4972,05.02.2009 20:15:00,2952,-0.0,38.78,IS,0.41,0.0,Phase3-EA-SA2v2-EURCHF-M5-43,EURCHFMT4,1720,9m 59s,Sell
34121.72,1.1692,05.02.2009 23:44:58,tp 1.16920,0.0,-0.0,0.0,0.0,1.1702,05.02.2009 23:15:00,2953,-0.0,49.61,IS,0.58,0.0,Phase3-EA-SA2v2-USDCHF-M15-107,USDCHFMT4,684,29m 58s,Sell
34160.25,1.49762,06.02.2009 00:34:57,tp 1.49762,0.0,-0.0,0.0,0.0,1.49652,06.02.2009 00:15:00,2954,-0.0,38.53,IS,0.41,0.0,Phase3-EA-SA2v2-EURCHF-M5-43,EURCHFMT4,1722,19m 57s,Buy
34198.74,1.49892,06.02.2009 01:14:59,tp 1.49892,0.0,-0.0,0.0,0.0,1.49782,06.02.2009 00:35:00,2955,-0.0,38.49,IS,0.41,0.0,Phase3-EA-SA2v2-EURCHF-M5-43,EURCHFMT4,1724,39m 59s,Buy
34297.15,133512,06.02.2009 02:14:58,tp 133.512,0.0,-0.0,0.0,0.0,133122,06.02.2009 00:35:00,2956,-0.0,98.41,IS,0.23,0.0,Phase3-EA-S4v1-GBPJPY-M5-194,GBPJPYMT4,818,1h 39m,Buy
34395.69,133.07,06.02.2009 03:19:59,tp 133.070,0.0,-0.0,0.0,0.0,133.46,06.02.2009 02:20:00,2957,-0.0,98.54,IS,0.23,0.0,Phase3-EA-S4v1-GBPJPY-M5-194,GBPJPYMT4,820,59m 59s,Sell
34430.61,133.1,06.02.2009 08:50:00,,0.0,-0.0,0.0,0.0,132962,06.02.2009 03:25:00,2958,-0.0,34.92,IS,0.23,0.0,Phase3-EA-S4v1-GBPJPY-M5-194,GBPJPYMT4,822,5h 25m,Buy
34388.48,91.0,06.02.2009 11:15:00,,0.0,-42.13000000000466,0.0,0.0,91142,06.02.2009 00:15:00,2959,-0.03385822829286515,-42.13,IS,0.27,0.0,Phase3-EA-S1v2-USDJPY-M15-0,USDJPYMT4,1126,11h 0m,Buy
34427.38,1.5047,06.02.2009 22:04:58,tp 1.50470,0.0,-3.2300000000104774,0.0,0.0,1.5058,06.02.2009 20:30:00,2960,-0.0025958242911535033,38.9,IS,0.41,0.0,Phase3-EA-SA2v2-EURCHF-M5-43,EURCHFMT4,1726,1h 34m,Sell
34477.26,1.16282,06.02.2009 22:59:58,tp 1.16282,0.0,-0.0,0.0,0.0,1.16182,06.02.2009 22:15:00,2961,-0.0,49.88,IS,0.58,0.0,Phase3-EA-SA2v2-USDCHF-M15-107,USDCHFMT4,686,44m 58s,Buy
34574.56,136.71,09.02.2009 02:34:58,tp 136.710,0.0,-0.0,0.0,0.0,137.1,09.02.2009 02:20:00,2962,-0.0,97.3,IS,0.23,0.0,Phase3-EA-S4v1-GBPJPY-M5-194,GBPJPYMT4,824,14m 58s,Sell
34624.53,1.16075,09.02.2009 02:44:58,tp 1.16075,0.0,-0.0,0.0,0.0,1.15975,09.02.2009 02:30:00,2963,-0.0,49.97,IS,0.58,0.0,Phase3-EA-SA2v2-USDCHF-M15-107,USDCHFMT4,688,14m 58s,Buy
34558.81,136142,09.02.2009 03:59:58,sl 136.142,0.0,-65.72000000000116,0.0,0.0,136812,09.02.2009 02:30:00,2964,-0.05273440148580799,-65.72,IS,0.09,0.0,Phase3-EA-B1v1-GBPJPY-M30-1,GBPJPYMT4,388,1h 29m,Buy
34487.5,118232,09.02.2009 05:59:58,sl 118.232,-0.48,-137.02999999999884,0.0,0.0,118952,06.02.2009 22:30:00,2965,-0.10995427625684843,-71.31,IS,0.09,0.0,Phase3-EA-TR1v1-EURJPY-M30-91,EURJPYMT4,94,2d 7h 29m,Buy
34604.34,1.50612,09.02.2009 13:29:58,tp 1.50612,0.0,-20.19000000000233,0.0,0.0,1.50212,09.02.2009 05:00:00,2966,-0.016200662903204006,116.84,IS,0.34,0.0,Phase3-EA-S4v1-EURCHF-M15-221,EURCHFMT4,828,8h 29m,Buy
34533.63,119232,09.02.2009 18:29:58,sl 119.232,0.0,-90.90000000000873,0.0,0.0,119952,09.02.2009 17:30:00,2967,-0.07293909152556789,-70.71,IS,0.09,0.0,Phase3-EA-TR1v1-EURJPY-M30-91,EURJPYMT4,96,59m 58s,Buy
34501.5,91595,09.02.2009 21:30:00,,0.0,-123.03000000001339,0.0,0.0,91704,09.02.2009 17:15:00,2968,-0.09872053278757681,-32.13,IS,0.27,0.0,Phase3-EA-S1v2-USDJPY-M15-0,USDJPYMT4,1128,4h 15m,Buy
34540.37,1.5111,09.02.2009 21:39:58,tp 1.51110,0.0,-84.16000000001804,0.0,0.0,1.5122,09.02.2009 20:45:00,2969,-0.06753084645536325,38.87,IS,0.41,0.0,Phase3-EA-SA2v2-EURCHF-M5-43,EURCHFMT4,1728,54m 58s,Sell
34579.09,1.5135,10.02.2009 00:59:58,tp 1.51350,0.0,-45.44000000001688,0.0,0.0,1.5146,10.02.2009 00:40:00,2970,-0.036461521660315924,38.72,IS,0.41,0.0,Phase3-EA-SA2v2-EURCHF-M5-43,EURCHFMT4,1730,19m 58s,Sell
34617.82,1.5123,10.02.2009 01:54:57,tp 1.51230,0.0,-6.710000000020955,0.0,0.0,1.5134,10.02.2009 01:00:00,2971,-0.005384172762794741,38.73,IS,0.41,0.0,Phase3-EA-SA2v2-EURCHF-M5-43,EURCHFMT4,1732,54m 57s,Sell
34424.2,1.16825,10.02.2009 03:29:58,sl 1.16825,0.0,-200.3300000000163,0.0,0.0,1.16435,10.02.2009 01:45:00,2972,-0.1607468449429791,-193.62,IS,0.58,0.0,Phase3-EA-SA2v2-USDCHF-M15-107,USDCHFMT4,690,1h 44m,Sell
34222.3,134662,10.02.2009 04:04:57,sl 134.662,0.0,-402.2300000000105,0.0,0.0,135462,10.02.2009 03:25:00,2973,-0.3227534739749958,-201.9,IS,0.23,0.0,Phase3-EA-S4v1-GBPJPY-M5-194,GBPJPYMT4,826,39m 57s,Buy
34338.06,1.51152,10.02.2009 05:45:00,tp 1.51152,0.0,-286.4700000000157,0.0,0.0,1.50752,10.02.2009 05:00:00,2974,-0.2298664636889832,115.76,IS,0.34,0.0,Phase3-EA-S4v1-EURCHF-M15-221,EURCHFMT4,830,45m 0s,Buy
34267.09,118.31,10.02.2009 11:29:58,sl 118.310,0.0,-357.4400000000169,0.0,0.0,117.59,10.02.2009 05:00:00,2975,-0.2868135189757724,-70.97,IS,0.09,0.0,Phase3-EA-TR1v1-EURJPY-M30-91,EURJPYMT4,98,6h 29m,Sell
34266.5,91177,10.02.2009 18:30:00,,0.0,-358.0300000000134,0.0,0.0,91175,10.02.2009 17:45:00,2976,-0.2872869410219751,-0.59,IS,0.27,0.0,Phase3-EA-S1v2-USDJPY-M15-0,USDJPYMT4,1130,45m 0s,Sell
34305.55,1.49762,10.02.2009 20:14:58,tp 1.49762,0.0,-318.9800000000105,0.0,0.0,1.49652,10.02.2009 20:05:00,2977,-0.2559528208451504,39.05,IS,0.41,0.0,Phase3-EA-SA2v2-EURCHF-M5-43,EURCHFMT4,1734,9m 58s,Buy
34132.01,1.49092,10.02.2009 21:24:58,sl 1.49092,0.0,-492.5200000000041,0.0,0.0,1.49582,10.02.2009 21:15:00,2978,-0.3952030952493899,-173.54,IS,0.41,0.0,Phase3-EA-SA2v2-EURCHF-M5-43,EURCHFMT4,1736,9m 58s,Buy
34170.98,1.49392,10.02.2009 21:29:58,tp 1.49392,0.0,-453.5500000000029,0.0,0.0,1.49282,10.02.2009 21:25:00,2979,-0.3639331678923911,38.97,IS,0.41,0.0,Phase3-EA-SA2v2-EURCHF-M5-43,EURCHFMT4,1738,4m 58s,Buy
34209.99,1.49222,10.02.2009 22:14:58,tp 1.49222,0.0,-414.54000000000815,0.0,0.0,1.49112,10.02.2009 22:10:00,2980,-0.33263114412548517,39.01,IS,0.41,0.0,Phase3-EA-SA2v2-EURCHF-M5-43,EURCHFMT4,1740,4m 58s,Buy
34529.96,116.0,10.02.2009 22:29:58,tp 116.000,0.0,-94.57000000000698,0.0,0.0,117.7,10.02.2009 20:15:00,2981,-0.07588393713501433,319.97,IS,0.17,0.0,Phase3-EA-T1v2-EURJPY-M15-322,EURJPYMT4,68,2h 14m,Sell
34568.95,1.49192,10.02.2009 23:04:58,tp 1.49192,0.0,-55.580000000001746,0.0,0.0,1.49082,10.02.2009 23:00:00,2982,-0.04459796157305612,38.99,IS,0.41,0.0,Phase3-EA-SA2v2-EURCHF-M5-43,EURCHFMT4,1742,4m 58s,Buy
34668.23,131.12,11.02.2009 03:44:58,tp 131.120,0.0,-0.0,0.0,0.0,131.51,11.02.2009 00:55:00,2983,-0.0,99.28,IS,0.23,0.0,Phase3-EA-S4v1-GBPJPY-M5-194,GBPJPYMT4,828,2h 49m,Sell
34705.0,90327,11.02.2009 06:00:00,,0.0,-0.0,0.0,0.0,90.45,11.02.2009 01:00:00,2984,-0.0,36.77,IS,0.27,0.0,Phase3-EA-S1v2-USDJPY-M15-0,USDJPYMT4,1132,5h 0m,Sell
34590.28,1.4979,11.02.2009 10:59:58,sl 1.49790,0.0,-114.72000000000116,0.0,0.0,1494,11.02.2009 05:30:00,2985,-0.09199310372479151,-114.72,IS,0.34,0.0,Phase3-EA-S4v1-EURCHF-M15-221,EURCHFMT4,832,5h 29m,Sell
34546.8,116.63,11.02.2009 15:29:58,sl 116.630,0.0,-158.1999999999971,0.0,0.0,116.4,11.02.2009 15:00:00,2986,-0.12685938815604603,-43.48,IS,0.17,0.0,Phase3-EA-T1v2-EURJPY-M15-322,EURJPYMT4,70,29m 58s,Sell
34503.34,116.57,11.02.2009 16:14:58,sl 116.570,0.0,-201.6600000000035,0.0,0.0,116.34,11.02.2009 16:00:00,2987,-0.16170963473798455,-43.46,IS,0.17,0.0,Phase3-EA-T1v2-EURJPY-M15-322,EURJPYMT4,72,14m 58s,Sell
34460.13,116.56,11.02.2009 21:14:57,sl 116.560,0.0,-244.8700000000099,0.0,0.0,116.33,11.02.2009 21:00:00,2988,-0.196359408203368,-43.21,IS,0.17,0.0,Phase3-EA-T1v2-EURJPY-M15-322,EURJPYMT4,74,14m 57s,Sell
34416.83,116.66,11.02.2009 22:59:58,sl 116.660,0.0,-288.1700000000128,0.0,0.0,116.43,11.02.2009 21:15:00,2989,-0.2310813519907085,-43.3,IS,0.17,0.0,Phase3-EA-T1v2-EURJPY-M15-322,EURJPYMT4,76,1h 44m,Sell
34363.99,1493,12.02.2009 04:35:00,,-2.55,-341.0100000000093,0.0,0.0,1.49442,11.02.2009 20:15:00,2990,-0.2734533499057853,-52.84,IS,0.41,0.0,Phase3-EA-SA2v2-EURCHF-M5-43,EURCHFMT4,1744,8h 20m,Buy
34228.14,129.33,12.02.2009 07:10:00,,0.0,-476.86000000001513,0.0,0.0,129862,12.02.2009 01:45:00,2991,-0.3823904414418151,-135.85,IS,0.23,0.0,Phase3-EA-S4v1-GBPJPY-M5-194,GBPJPYMT4,830,5h 25m,Buy
34144.07,90145,12.02.2009 11:00:00,,-2.6,-560.9300000000221,0.0,0.0,90417,11.02.2009 22:00:00,2992,-0.44980554107695964,-84.07,IS,0.27,0.0,Phase3-EA-S1v2-USDJPY-M15-0,USDJPYMT4,1134,13h 0m,Buy
34064.76,115742,12.02.2009 11:59:58,sl 115.742,-1.46,-640.2400000000198,0.0,0.0,116522,11.02.2009 12:30:00,2993,-0.5134036325728882,-79.31,IS,0.09,0.0,Phase3-EA-TR1v1-EURJPY-M30-91,EURJPYMT4,100,23h 29m,Buy
34119.67,1.49322,12.02.2009 14:45:00,,0.0,-585.3300000000163,0.0,0.0,1.4951,12.02.2009 06:00:00,2994,-0.46937171725272986,54.91,IS,0.34,0.0,Phase3-EA-S4v1-EURCHF-M15-221,EURCHFMT4,834,8h 45m,Sell
34041.91,115072,12.02.2009 17:59:57,sl 115.072,0.0,-663.0900000000111,0.0,0.0,115852,12.02.2009 17:00:00,2995,-0.5317268754260146,-77.76,IS,0.09,0.0,Phase3-EA-TR1v1-EURJPY-M30-91,EURJPYMT4,102,59m 57s,Buy
34080.65,1.49062,12.02.2009 23:14:58,tp 1.49062,0.0,-624.3500000000058,0.0,0.0,1.48952,12.02.2009 23:10:00,2996,-0.5006615612846368,38.74,IS,0.41,0.0,Phase3-EA-SA2v2-EURCHF-M5-43,EURCHFMT4,1746,4m 58s,Buy
34179.75,128682,12.02.2009 23:24:58,tp 128.682,0.0,-525.25,0.0,0.0,128292,12.02.2009 23:10:00,2997,-0.42119401788220234,99.1,IS,0.23,0.0,Phase3-EA-S4v1-GBPJPY-M5-194,GBPJPYMT4,832,14m 58s,Buy
34229.57,1.1641,12.02.2009 23:29:58,tp 1.16410,0.0,-475.429999999993,0.0,0.0,1.1651,12.02.2009 23:15:00,2998,-0.38124373521510235,49.82,IS,0.58,0.0,Phase3-EA-SA2v2-USDCHF-M15-107,USDCHFMT4,692,14m 58s,Sell
34312.33,90695,12.02.2009 23:30:00,,0.0,-392.66999999999825,0.0,0.0,90417,12.02.2009 21:45:00,2999,-0.3148791147107161,82.76,IS,0.27,0.0,Phase3-EA-S1v2-USDJPY-M15-0,USDJPYMT4,1136,1h 45m,Buy
34269.24,116.69,12.02.2009 23:44:58,sl 116.690,0.0,-435.75999999999476,0.0,0.0,116.46,12.02.2009 01:45:00,3000,-0.3494326610801452,-43.09,IS,0.17,0.0,Phase3-EA-T1v2-EURJPY-M15-322,EURJPYMT4,78,21h 59m,Sell
34277.57,90725,12.02.2009 23:45:00,,0.0,-427.429999999993,0.0,0.0,90697,12.02.2009 23:30:00,3001,-0.3427528968365289,8.33,IS,0.27,0.0,Phase3-EA-S1v2-USDJPY-M15-0,USDJPYMT4,1138,15m 0s,Buy
34404.93,117082,13.02.2009 00:29:58,tp 117.082,-0.49,-300.06999999999243,0.0,0.0,115792,12.02.2009 19:00:00,3002,-0.2406238723387135,127.36,IS,0.09,0.0,Phase3-EA-TR1v1-EURJPY-M30-91,EURJPYMT4,104,5h 29m,Buy
34454.86,1.16167,13.02.2009 02:14:58,tp 1.16167,0.0,-250.13999999999942,0.0,0.0,1.16067,13.02.2009 01:30:00,3003,-0.2005853815003405,49.93,IS,0.58,0.0,Phase3-EA-SA2v2-USDCHF-M15-107,USDCHFMT4,694,44m 58s,Buy
34493.74,1495,13.02.2009 03:19:58,tp 1.49500,0.0,-211.25999999999476,0.0,0.0,1.4961,13.02.2009 01:45:00,3004,-0.16940780241369224,38.88,IS,0.41,0.0,Phase3-EA-SA2v2-EURCHF-M5-43,EURCHFMT4,1748,1h 34m,Sell
34592.64,129812,13.02.2009 04:19:58,tp 129.812,0.0,-112.36000000000058,0.0,0.0,129422,13.02.2009 02:50:00,3005,-0.09010063750451118,98.9,IS,0.23,0.0,Phase3-EA-S4v1-GBPJPY-M5-194,GBPJPYMT4,834,1h 29m,Buy
34710.39,91717,13.02.2009 17:59:58,tp 91.717,0.0,-0.0,0.0,0.0,91317,13.02.2009 17:00:00,3006,-0.0,117.75,IS,0.27,0.0,Phase3-EA-S1v2-USDJPY-M15-0,USDJPYMT4,1140,59m 58s,Buy
34748.0,91895,13.02.2009 18:15:00,,0.0,-0.0,0.0,0.0,91767,13.02.2009 18:00:00,3007,-0.0,37.61,IS,0.27,0.0,Phase3-EA-S1v2-USDJPY-M15-0,USDJPYMT4,1142,15m 0s,Buy
34671.63,118.51,13.02.2009 18:59:57,sl 118.510,0.0,-76.36999999999534,0.0,0.0,117.73,13.02.2009 16:00:00,3008,-0.06121941834738466,-76.37,IS,0.09,0.0,Phase3-EA-TR1v1-EURJPY-M30-91,EURJPYMT4,106,2h 59m,Sell
34629.07,118152,13.02.2009 19:29:58,sl 118.152,0.0,-118.92999999999302,0.0,0.0,118382,13.02.2009 18:30:00,3009,-0.09533619777470831,-42.56,IS,0.17,0.0,Phase3-EA-T1v2-EURJPY-M15-322,EURJPYMT4,80,59m 58s,Buy
34667.97,1.4942,13.02.2009 23:14:58,tp 1.49420,0.0,-80.02999999999884,0.0,0.0,1.4953,13.02.2009 23:00:00,3010,-0.06415333311956818,38.9,IS,0.41,0.0,Phase3-EA-SA2v2-EURCHF-M5-43,EURCHFMT4,1750,14m 58s,Sell
34706.75,1.48832,16.02.2009 02:49:58,tp 1.48832,0.0,-41.25,0.0,0.0,1.48722,16.02.2009 02:20:00,3011,-0.033066662391381056,38.78,IS,0.41,0.0,Phase3-EA-SA2v2-EURCHF-M5-43,EURCHFMT4,1752,29m 58s,Buy
34676.14,130.3,16.02.2009 08:00:00,,0.0,-71.86000000000058,0.0,0.0,130422,16.02.2009 02:35:00,3012,-0.0576041299259312,-30.61,IS,0.23,0.0,Phase3-EA-S4v1-GBPJPY-M5-194,GBPJPYMT4,836,5h 25m,Buy
34792.52,1.49222,16.02.2009 11:59:58,tp 1.49222,0.0,-0.0,0.0,0.0,1.48822,16.02.2009 04:00:00,3013,-0.0,116.38,IS,0.34,0.0,Phase3-EA-S4v1-EURCHF-M15-221,EURCHFMT4,836,7h 59m,Buy
34830.58,1.48502,17.02.2009 00:59:58,tp 1.48502,-0.85,-0.0,0.0,0.0,1.48392,16.02.2009 20:45:00,3014,-0.0,38.06,IS,0.41,0.0,Phase3-EA-SA2v2-EURCHF-M5-43,EURCHFMT4,1754,4h 14m,Buy
34787.92,117182,17.02.2009 01:44:57,sl 117.182,0.0,-42.66000000000349,0.0,0.0,117412,17.02.2009 01:00:00,3015,-0.03417431850433085,-42.66,IS,0.17,0.0,Phase3-EA-T1v2-EURJPY-M15-322,EURJPYMT4,82,44m 57s,Buy
34710.97,116592,17.02.2009 04:29:58,sl 116.592,-0.48,-119.61000000000058,0.0,0.0,117372,16.02.2009 17:00:00,3016,-0.09581786770517343,-76.95,IS,0.09,0.0,Phase3-EA-TR1v1-EURJPY-M30-91,EURJPYMT4,108,11h 29m,Buy
34668.97,1.42527,17.02.2009 13:59:58,sl 1.42527,0.0,-161.61000000000058,0.0,0.0,1.42827,17.02.2009 13:30:00,3017,-0.1294634696081687,-42.0,IS,0.14,0.0,Phase3-EA-B1v1-GBPUSD-M30-14,GBPUSDMT4,194,29m 58s,Buy
34707.32,1.47752,17.02.2009 20:29:58,tp 1.47752,0.0,-123.25999999999476,0.0,0.0,1.47642,17.02.2009 20:00:00,3018,-0.09874183072769098,38.35,IS,0.41,0.0,Phase3-EA-SA2v2-EURCHF-M5-43,EURCHFMT4,1756,29m 58s,Buy
34745.81,1.47672,17.02.2009 21:44:58,tp 1.47672,0.0,-84.76999999998952,0.0,0.0,1.47562,17.02.2009 21:25:00,3019,-0.06790803984087039,38.49,IS,0.41,0.0,Phase3-EA-SA2v2-EURCHF-M5-43,EURCHFMT4,1758,19m 58s,Buy
34795.38,1.17012,17.02.2009 23:29:58,tp 1.17012,0.0,-35.19999999998254,0.0,0.0,1.16912,17.02.2009 23:15:00,3020,-0.02819821873773443,49.57,IS,0.58,0.0,Phase3-EA-SA2v2-USDCHF-M15-107,USDCHFMT4,696,14m 58s,Buy
34833.95,1.47622,17.02.2009 23:44:57,tp 1.47622,0.0,-0.0,0.0,0.0,1.47512,17.02.2009 23:25:00,3021,-0.0,38.57,IS,0.41,0.0,Phase3-EA-SA2v2-EURCHF-M5-43,EURCHFMT4,1760,19m 57s,Buy
34872.59,1.47372,17.02.2009 23:59:58,tp 1.47372,0.0,-0.0,0.0,0.0,1.47262,17.02.2009 23:55:00,3022,-0.0,38.64,IS,0.41,0.0,Phase3-EA-SA2v2-EURCHF-M5-43,EURCHFMT4,1762,4m 58s,Buy
34911.21,1.47242,18.02.2009 00:34:57,tp 1.47242,0.0,-0.0,0.0,0.0,1.47132,18.02.2009 00:25:00,3023,-0.0,38.62,IS,0.41,0.0,Phase3-EA-SA2v2-EURCHF-M5-43,EURCHFMT4,1764,9m 57s,Buy
34868.85,116.2,18.02.2009 02:14:59,sl 116.200,0.0,-42.36000000000058,0.0,0.0,115.97,18.02.2009 01:45:00,3024,-0.03391208843465739,-42.36,IS,0.17,0.0,Phase3-EA-T1v2-EURJPY-M15-322,EURJPYMT4,84,29m 59s,Sell
34776.54,92286,18.02.2009 03:00:00,,-1.32,-134.66999999999825,0.0,0.0,91975,17.02.2009 17:00:00,3025,-0.10781258143284206,-92.31,IS,0.27,0.0,Phase3-EA-S1v2-USDJPY-M15-0,USDJPYMT4,1144,10h 0m,Sell
34815.1,1.47242,18.02.2009 08:54:58,tp 1.47242,0.0,-96.11000000000058,0.0,0.0,1.47132,18.02.2009 01:00:00,3026,-0.07694265390592298,38.56,IS,0.41,0.0,Phase3-EA-SA2v2-EURCHF-M5-43,EURCHFMT4,1766,7h 54m,Buy
34834.93,1.4723,18.02.2009 10:15:00,,0.0,-76.27999999999884,0.0,0.0,1.47162,18.02.2009 01:30:00,3027,-0.06106737737949931,19.83,IS,0.34,0.0,Phase3-EA-S4v1-EURCHF-M15-221,EURCHFMT4,838,8h 45m,Buy
34958.55,117612,18.02.2009 18:59:57,tp 117.612,-0.48,-0.0,0.0,0.0,116322,17.02.2009 21:00:00,3028,-0.0,123.62,IS,0.09,0.0,Phase3-EA-TR1v1-EURJPY-M30-91,EURJPYMT4,110,21h 59m,Buy
34996.72,1.4824,18.02.2009 20:29:58,tp 1.48240,0.0,-0.0,0.0,0.0,1.4835,18.02.2009 20:15:00,3029,-0.0,38.17,IS,0.41,0.0,Phase3-EA-SA2v2-EURCHF-M5-43,EURCHFMT4,1768,14m 58s,Sell
35111.92,93747,18.02.2009 22:29:58,tp 93.747,0.0,-0.0,0.0,0.0,93347,18.02.2009 21:45:00,3030,-0.0,115.2,IS,0.27,0.0,Phase3-EA-S1v2-USDJPY-M15-0,USDJPYMT4,1146,44m 58s,Buy
35111.92,93692,19.02.2009 04:00:00,,0.0,-0.0,0.0,0.0,93692,19.02.2009 00:45:00,3031,-0.0,0.0,IS,0.27,0.0,Phase3-EA-S1v2-USDJPY-M15-0,USDJPYMT4,1148,3h 15m,Buy
35115.7,1.4766,19.02.2009 06:55:00,,-2.51,-0.0,0.0,0.0,1.47642,18.02.2009 22:35:00,3032,-0.0,3.78,IS,0.41,0.0,Phase3-EA-SA2v2-EURCHF-M5-43,EURCHFMT4,1770,8h 20m,Buy
35051.19,132982,19.02.2009 08:29:58,sl 132.982,0.0,-64.50999999999476,0.0,0.0,133652,19.02.2009 04:00:00,3033,-0.05156027580870731,-64.51,IS,0.09,0.0,Phase3-EA-B1v1-GBPJPY-M30-1,GBPJPYMT4,390,4h 29m,Buy
34976.07,118.24,19.02.2009 11:59:58,sl 118.240,0.0,-139.6299999999901,0.0,0.0,117.46,19.02.2009 08:30:00,3034,-0.11160070238986011,-75.12,IS,0.09,0.0,Phase3-EA-TR1v1-EURJPY-M30-91,EURJPYMT4,112,3h 29m,Sell
35282.74,119462,19.02.2009 16:59:58,tp 119.462,0.0,-0.0,0.0,0.0,117762,19.02.2009 10:45:00,3035,-0.0,306.67,IS,0.17,0.0,Phase3-EA-T1v2-EURJPY-M15-322,EURJPYMT4,86,6h 14m,Buy
35459.55,136242,19.02.2009 17:29:58,tp 136.242,0.0,-0.0,0.0,0.0,134392,19.02.2009 13:30:00,3036,-0.0,176.81,IS,0.09,0.0,Phase3-EA-B1v1-GBPJPY-M30-1,GBPJPYMT4,392,3h 59m,Buy
35536.19,94415,19.02.2009 22:30:00,,0.0,-0.0,0.0,0.0,94147,19.02.2009 22:00:00,3037,-0.0,76.64,IS,0.27,0.0,Phase3-EA-S1v2-USDJPY-M15-0,USDJPYMT4,1150,30m 0s,Buy
35466.91,119112,20.02.2009 02:59:58,sl 119.112,-0.47,-69.27999999999884,0.0,0.0,119832,19.02.2009 17:00:00,3038,-0.055187273088341204,-69.28,IS,0.09,0.0,Phase3-EA-TR1v1-EURJPY-M30-91,EURJPYMT4,114,9h 59m,Buy
35434.09,1.4861,20.02.2009 07:50:00,,-0.84,-102.10000000000582,0.0,0.0,1.48702,19.02.2009 23:30:00,3039,-0.0813311284976913,-32.82,IS,0.41,0.0,Phase3-EA-SA2v2-EURCHF-M5-43,EURCHFMT4,1772,8h 20m,Buy
35343.09,133.67,20.02.2009 08:25:00,,0.0,-193.10000000000582,0.0,0.0,134042,20.02.2009 03:00:00,3040,-0.15382018523901828,-91.0,IS,0.23,0.0,Phase3-EA-S4v1-GBPJPY-M5-194,GBPJPYMT4,838,5h 25m,Buy
35305.12,1486,20.02.2009 10:15:00,,0.0,-231.07000000000698,0.0,0.0,1.48732,20.02.2009 01:30:00,3041,-0.18406644331009817,-37.97,IS,0.34,0.0,Phase3-EA-S4v1-EURCHF-M15-221,EURCHFMT4,840,8h 45m,Buy
35133.13,1.47742,20.02.2009 20:04:58,sl 1.47742,0.0,-403.0600000000122,0.0,0.0,1.48232,20.02.2009 20:00:00,3042,-0.32107076055121037,-171.99,IS,0.41,0.0,Phase3-EA-SA2v2-EURCHF-M5-43,EURCHFMT4,1774,4m 58s,Buy
34892.96,93307,20.02.2009 20:14:58,sl 93.307,0.0,-643.2300000000105,0.0,0.0,94137,20.02.2009 19:15:00,3043,-0.5123861095354343,-240.17,IS,0.27,0.0,Phase3-EA-S1v2-USDJPY-M15-0,USDJPYMT4,1152,59m 58s,Buy
34932.19,1.47802,20.02.2009 21:39:58,tp 1.47802,0.0,-604.0000000000146,0.0,0.0,1.47692,20.02.2009 21:30:00,3044,-0.48113615683255556,39.23,IS,0.41,0.0,Phase3-EA-SA2v2-EURCHF-M5-43,EURCHFMT4,1776,9m 58s,Buy
34971.46,1.47832,20.02.2009 21:59:58,tp 1.47832,0.0,-564.7300000000105,0.0,0.0,1.47722,20.02.2009 21:55:00,3045,-0.44985434080802583,39.27,IS,0.41,0.0,Phase3-EA-SA2v2-EURCHF-M5-43,EURCHFMT4,1778,4m 58s,Buy
34856.32,1.4887,23.02.2009 09:44:57,sl 1.48870,0.0,-679.8700000000099,0.0,0.0,1.4848,23.02.2009 05:00:00,3046,-0.5415729121618319,-115.14,IS,0.34,0.0,Phase3-EA-S4v1-EURCHF-M15-221,EURCHFMT4,842,4h 44m,Sell
34971.01,94.17,23.02.2009 18:29:57,tp 94.170,0.0,-565.1800000000076,0.0,0.0,94.57,23.02.2009 17:45:00,3047,-0.45021280317652457,114.69,IS,0.27,0.0,Phase3-EA-S1v2-USDJPY-M15-0,USDJPYMT4,1154,44m 57s,Sell
35085.03,94722,23.02.2009 20:14:58,tp 94.722,0.0,-451.1600000000035,0.0,0.0,94322,23.02.2009 18:30:00,3048,-0.35938640482876194,114.02,IS,0.27,0.0,Phase3-EA-S1v2-USDJPY-M15-0,USDJPYMT4,1156,1h 44m,Buy
35123.73,1.48512,23.02.2009 20:14:58,tp 1.48512,0.0,-412.4600000000064,0.0,0.0,1.48402,23.02.2009 20:10:00,3049,-0.32855864113767247,38.7,IS,0.41,0.0,Phase3-EA-SA2v2-EURCHF-M5-43,EURCHFMT4,1780,4m 58s,Buy
35162.4,1.4846,23.02.2009 22:44:58,tp 1.48460,0.0,-373.79000000000815,0.0,0.0,1.4857,23.02.2009 21:35:00,3050,-0.29775477493781544,38.67,IS,0.41,0.0,Phase3-EA-SA2v2-EURCHF-M5-43,EURCHFMT4,1782,1h 9m,Sell
35285.04,119.88,23.02.2009 23:59:58,tp 119.880,0.0,-251.15000000000873,0.0,0.0,121.17,23.02.2009 16:30:00,3051,-0.2000618307756583,122.64,IS,0.09,0.0,Phase3-EA-TR1v1-EURJPY-M30-91,EURJPYMT4,116,7h 29m,Sell
35346.0,94776,24.02.2009 04:30:00,,0.0,-190.19000000000233,0.0,0.0,94562,24.02.2009 01:15:00,3052,-0.15150212858937526,60.96,IS,0.27,0.0,Phase3-EA-S1v2-USDJPY-M15-0,USDJPYMT4,1158,3h 15m,Buy
35384.9,1.4904,24.02.2009 23:59:57,tp 1.49040,0.0,-151.29000000000815,0.0,0.0,1.4915,24.02.2009 22:00:00,3053,-0.1205150482900654,38.9,IS,0.41,0.0,Phase3-EA-SA2v2-EURCHF-M5-43,EURCHFMT4,1784,1h 59m,Sell
35477.67,140292,25.02.2009 01:34:57,tp 140.292,0.0,-58.520000000004075,0.0,0.0,139902,25.02.2009 00:55:00,3054,-0.046616039565964294,92.77,IS,0.23,0.0,Phase3-EA-S4v1-GBPJPY-M5-194,GBPJPYMT4,840,39m 57s,Buy
35527.67,1.15992,25.02.2009 03:14:59,tp 1.15992,0.0,-8.520000000004075,0.0,0.0,1.15892,25.02.2009 02:45:00,3055,-0.0067868875102901245,50.0,IS,0.58,0.0,Phase3-EA-SA2v2-USDCHF-M15-107,USDCHFMT4,698,29m 59s,Buy
35337.95,141.14,25.02.2009 05:59:57,sl 141.140,0.0,-198.24000000000524,0.0,0.0,140.34,25.02.2009 02:10:00,3056,-0.15791462207034113,-189.72,IS,0.23,0.0,Phase3-EA-S4v1-GBPJPY-M5-194,GBPJPYMT4,842,3h 49m,Sell
35449.15,97119,25.02.2009 05:59:58,tp 97.119,0.0,-87.04000000000815,0.0,0.0,96719,25.02.2009 00:30:00,3057,-0.06933458789852409,111.2,IS,0.27,0.0,Phase3-EA-S1v2-USDJPY-M15-0,USDJPYMT4,1160,5h 29m,Buy
35407.15,1.45037,25.02.2009 07:29:57,sl 1.45037,0.0,-129.04000000000815,0.0,0.0,1.45337,25.02.2009 05:30:00,3058,-0.10279107562529038,-42.0,IS,0.14,0.0,Phase3-EA-B1v1-GBPUSD-M30-14,GBPUSDMT4,196,1h 59m,Buy
35524.22,1.4875,25.02.2009 10:14:58,tp 1.48750,0.0,-11.970000000001164,0.0,0.0,1.4915,25.02.2009 06:15:00,3059,-0.009535099002129324,117.07,IS,0.34,0.0,Phase3-EA-S4v1-EURCHF-M15-221,EURCHFMT4,844,3h 59m,Sell
35482.22,1.45063,25.02.2009 12:59:58,sl 1.45063,0.0,-53.970000000001164,0.0,0.0,1.45363,25.02.2009 08:00:00,3060,-0.04299158672889563,-42.0,IS,0.14,0.0,Phase3-EA-B1v1-GBPUSD-M30-14,GBPUSDMT4,198,4h 59m,Buy
35602.51,123.2,25.02.2009 18:29:58,tp 123.200,0.0,-0.0,0.0,0.0,124.49,25.02.2009 02:00:00,3061,-0.0,120.29,IS,0.09,0.0,Phase3-EA-TR1v1-EURJPY-M30-91,EURJPYMT4,118,16h 29m,Sell
35641.16,1.4853,25.02.2009 21:34:57,tp 1.48530,0.0,-0.0,0.0,0.0,1.4864,25.02.2009 21:15:00,3062,-0.0,38.65,IS,0.41,0.0,Phase3-EA-SA2v2-EURCHF-M5-43,EURCHFMT4,1786,19m 57s,Sell
35679.81,1.4862,25.02.2009 22:14:58,tp 1.48620,0.0,-0.0,0.0,0.0,1.4873,25.02.2009 22:05:00,3063,-0.0,38.65,IS,0.41,0.0,Phase3-EA-SA2v2-EURCHF-M5-43,EURCHFMT4,1788,9m 58s,Sell
35771.76,138.57,25.02.2009 23:59:58,tp 138.570,0.0,-0.0,0.0,0.0,138.96,25.02.2009 23:25:00,3064,-0.0,91.95,IS,0.23,0.0,Phase3-EA-S4v1-GBPJPY-M5-194,GBPJPYMT4,844,34m 58s,Sell
35875.34,97754,26.02.2009 04:15:00,,0.0,-0.0,0.0,0.0,97379,26.02.2009 01:00:00,3065,-0.0,103.58,IS,0.27,0.0,Phase3-EA-S1v2-USDJPY-M15-0,USDJPYMT4,1162,3h 15m,Buy
35785.22,1.49012,26.02.2009 07:00:00,,-5.26,-90.11999999999534,0.0,0.0,1.4877,25.02.2009 22:40:00,3066,-0.07159464276322544,-90.12,IS,0.41,0.0,Phase3-EA-SA2v2-EURCHF-M5-43,EURCHFMT4,1790,8h 20m,Sell
35713.78,125.68,26.02.2009 19:29:58,sl 125.680,0.0,-161.55999999999767,0.0,0.0,124.9,26.02.2009 18:00:00,3067,-0.12834920644504144,-71.44,IS,0.09,0.0,Phase3-EA-TR1v1-EURJPY-M30-91,EURJPYMT4,120,1h 29m,Sell
35674.09,125292,27.02.2009 02:14:58,sl 125.292,0.0,-201.25,0.0,0.0,125522,27.02.2009 01:45:00,3068,-0.15988040230914186,-39.69,IS,0.17,0.0,Phase3-EA-T1v2-EURJPY-M15-322,EURJPYMT4,88,29m 58s,Buy
35485.97,139702,27.02.2009 03:29:59,sl 139.702,0.0,-389.36999999999534,0.0,0.0,140502,27.02.2009 02:55:00,3069,-0.30932984967507987,-188.12,IS,0.23,0.0,Phase3-EA-S4v1-GBPJPY-M5-194,GBPJPYMT4,846,34m 59s,Buy
35312.84,1.48142,27.02.2009 03:59:58,sl 1.48142,-0.85,-562.5,0.0,0.0,1.48632,26.02.2009 21:30:00,3070,-0.4468706896839369,-173.13,IS,0.41,0.0,Phase3-EA-SA2v2-EURCHF-M5-43,EURCHFMT4,1792,6h 29m,Buy
35431.14,124.01,27.02.2009 04:29:58,tp 124.010,-0.32,-444.1999999999971,0.0,0.0,125.3,26.02.2009 23:30:00,3071,-0.35288881841351727,118.3,IS,0.09,0.0,Phase3-EA-TR1v1-EURJPY-M30-91,EURJPYMT4,122,4h 59m,Sell
35200.35,97439,27.02.2009 04:44:57,sl 97.439,-0.8,-674.9899999999907,0.0,0.0,98269,26.02.2009 22:15:00,3072,-0.5362368832529003,-230.79,IS,0.27,0.0,Phase3-EA-S1v2-USDJPY-M15-0,USDJPYMT4,1164,6h 29m,Buy
35011.61,139002,27.02.2009 06:09:57,sl 139.002,0.0,-863.7299999999959,0.0,0.0,139802,27.02.2009 03:35:00,3073,-0.6861788814234755,-188.74,IS,0.23,0.0,Phase3-EA-S4v1-GBPJPY-M5-194,GBPJPYMT4,848,2h 34m,Buy
34945.2,124.54,27.02.2009 08:29:58,sl 124.540,0.0,-930.1399999999994,0.0,0.0,123.82,27.02.2009 06:30:00,3074,-0.738937428093541,-66.41,IS,0.09,0.0,Phase3-EA-TR1v1-EURJPY-M30-91,EURJPYMT4,124,1h 59m,Sell
34903.2,1.42559,27.02.2009 18:59:58,sl 1.42559,0.0,-972.1399999999994,0.0,0.0,1.42859,27.02.2009 18:30:00,3075,-0.7723037729232749,-42.0,IS,0.14,0.0,Phase3-EA-B1v1-GBPUSD-M30-14,GBPUSDMT4,200,29m 58s,Buy
34941.87,1.4818,27.02.2009 21:39:57,tp 1.48180,0.0,-933.4700000000012,0.0,0.0,1.4829,27.02.2009 21:35:00,3076,-0.7415829025764713,38.67,IS,0.41,0.0,Phase3-EA-SA2v2-EURCHF-M5-43,EURCHFMT4,1794,4m 57s,Sell
34980.47,1.4821,27.02.2009 23:14:57,tp 1.48210,0.0,-894.8699999999953,0.0,0.0,1.4832,27.02.2009 23:05:00,3077,-0.7109176428043779,38.6,IS,0.41,0.0,Phase3-EA-SA2v2-EURCHF-M5-43,EURCHFMT4,1796,9m 57s,Sell
34908.07,123472,02.03.2009 02:00:00,sl 123.472,-0.45,-967.2699999999895,0.0,0.0,124252,27.02.2009 19:00:00,3078,-0.7684348657965813,-72.4,IS,0.09,0.0,Phase3-EA-TR1v1-EURJPY-M30-91,EURJPYMT4,126,2d 7h 0m,Buy
34860.03,97512,02.03.2009 02:15:00,,-1.25,-1015.3099999999831,0.0,0.0,97343,27.02.2009 17:15:00,3079,-0.8065996087875386,-48.04,IS,0.27,0.0,Phase3-EA-S1v2-USDJPY-M15-0,USDJPYMT4,1166,2d 9h 0m,Sell
34898.46,1.47832,02.03.2009 02:49:58,tp 1.47832,0.0,-976.8799999999901,0.0,0.0,1.47722,02.03.2009 02:25:00,3080,-0.7760694032683375,38.43,IS,0.41,0.0,Phase3-EA-SA2v2-EURCHF-M5-43,EURCHFMT4,1798,24m 58s,Buy
34990.69,138632,02.03.2009 04:19:58,tp 138.632,0.0,-884.6499999999942,0.0,0.0,138242,02.03.2009 02:50:00,3081,-0.7027984988958083,92.23,IS,0.23,0.0,Phase3-EA-S4v1-GBPJPY-M5-194,GBPJPYMT4,850,1h 29m,Buy
35106.3,1.48022,02.03.2009 11:59:57,tp 1.48022,0.0,-769.0399999999936,0.0,0.0,1.47622,02.03.2009 04:15:00,3082,-0.6109536625680568,115.61,IS,0.34,0.0,Phase3-EA-S4v1-EURCHF-M15-221,EURCHFMT4,846,7h 44m,Buy
35034.21,122172,02.03.2009 19:59:58,sl 122.172,0.0,-841.1299999999901,0.0,0.0,122952,02.03.2009 17:30:00,3083,-0.6682246101579474,-72.09,IS,0.09,0.0,Phase3-EA-TR1v1-EURJPY-M30-91,EURJPYMT4,128,2h 29m,Buy
35068.22,97239,03.03.2009 00:15:00,,-1.25,-807.1199999999953,0.0,0.0,97366,02.03.2009 17:00:00,3084,-0.6412058152136837,34.01,IS,0.27,0.0,Phase3-EA-S1v2-USDJPY-M15-0,USDJPYMT4,1168,7h 15m,Sell
35106.65,1.47952,03.03.2009 06:34:57,tp 1.47952,0.0,-768.6900000000023,0.0,0.0,1.47842,03.03.2009 01:20:00,3085,-0.6106756096944826,38.43,IS,0.41,0.0,Phase3-EA-SA2v2-EURCHF-M5-43,EURCHFMT4,1800,5h 14m,Buy
35065.95,123.41,03.03.2009 09:14:57,sl 123.410,-0.61,-809.3899999999994,0.0,0.0,123.18,02.03.2009 02:00:00,3086,-0.6430091867080558,-40.7,IS,0.17,0.0,Phase3-EA-T1v2-EURJPY-M15-322,EURJPYMT4,90,1d 7h 14m,Sell
34952.89,1.4828,03.03.2009 11:14:58,sl 1.48280,0.0,-922.4499999999971,0.0,0.0,1.4789,03.03.2009 06:15:00,3087,-0.7328282092425712,-113.06,IS,0.34,0.0,Phase3-EA-S4v1-EURCHF-M15-221,EURCHFMT4,848,4h 59m,Sell
34991.3,1.4778,03.03.2009 23:24:58,tp 1.47780,0.0,-884.0399999999936,0.0,0.0,1.4789,03.03.2009 23:05:00,3088,-0.702313892458995,38.41,IS,0.41,0.0,Phase3-EA-SA2v2-EURCHF-M5-43,EURCHFMT4,1802,19m 58s,Sell
35026.16,98427,04.03.2009 02:15:00,,-0.8,-849.179999999993,0.0,0.0,98297,03.03.2009 22:00:00,3089,-0.6746198262503154,34.86,IS,0.27,0.0,Phase3-EA-S1v2-USDJPY-M15-0,USDJPYMT4,1170,4h 15m,Buy
35117.32,138152,04.03.2009 02:39:58,tp 138.152,0.0,-758.0199999999895,0.0,0.0,137762,04.03.2009 00:45:00,3090,-0.6021989692341567,91.16,IS,0.23,0.0,Phase3-EA-S4v1-GBPJPY-M5-194,GBPJPYMT4,852,1h 54m,Buy
35155.6,1.47792,04.03.2009 03:14:57,tp 1.47792,0.0,-719.7399999999907,0.0,0.0,1.47682,04.03.2009 01:50:00,3091,-0.5717879292322001,38.28,IS,0.41,0.0,Phase3-EA-SA2v2-EURCHF-M5-43,EURCHFMT4,1804,1h 24m,Buy
35246.73,138092,04.03.2009 05:19:58,tp 138.092,0.0,-628.609999999986,0.0,0.0,137702,04.03.2009 03:55:00,3092,-0.4993909053194904,91.13,IS,0.23,0.0,Phase3-EA-S4v1-GBPJPY-M5-194,GBPJPYMT4,854,1h 24m,Buy
35204.73,1.40236,04.03.2009 05:29:58,sl 1.40236,0.0,-670.609999999986,0.0,0.0,1.39936,04.03.2009 04:00:00,3093,-0.5327572501492243,-42.0,IS,0.14,0.0,Phase3-EA-B1v1-GBPUSD-M30-14,GBPUSDMT4,202,1h 29m,Sell
35319.88,1.47822,04.03.2009 10:29:58,tp 1.47822,0.0,-555.4599999999919,0.0,0.0,1.47422,04.03.2009 05:15:00,3094,-0.4412778547410417,115.15,IS,0.34,0.0,Phase3-EA-S4v1-EURCHF-M15-221,EURCHFMT4,850,5h 14m,Buy
35248.51,124.4,04.03.2009 11:29:58,sl 124.400,-0.32,-626.8299999999872,0.0,0.0,123.62,03.03.2009 21:00:00,3095,-0.49797680784813586,-71.37,IS,0.09,0.0,Phase3-EA-TR1v1-EURJPY-M30-91,EURJPYMT4,130,14h 29m,Sell
35310.01,99224,04.03.2009 18:15:00,,0.0,-565.3299999999872,0.0,0.0,99.45,04.03.2009 17:15:00,3096,-0.44911894577602546,61.5,IS,0.27,0.0,Phase3-EA-S1v2-USDJPY-M15-0,USDJPYMT4,1172,1h 0m,Sell
35348.55,1.48112,04.03.2009 22:49:58,tp 1.48112,0.0,-526.7899999999936,0.0,0.0,1.48002,04.03.2009 22:35:00,3097,-0.41850135221084134,38.54,IS,0.41,0.0,Phase3-EA-SA2v2-EURCHF-M5-43,EURCHFMT4,1806,14m 58s,Buy
35309.14,125032,05.03.2009 05:14:59,sl 125.032,0.0,-566.1999999999971,0.0,0.0,125262,05.03.2009 04:45:00,3098,-0.44981010577607783,-39.41,IS,0.17,0.0,Phase3-EA-T1v2-EURJPY-M15-322,EURJPYMT4,92,29m 59s,Buy
35347.63,1.47942,05.03.2009 07:54:57,tp 1.47942,0.0,-527.7099999999919,0.0,0.0,1.47832,05.03.2009 01:00:00,3099,-0.41923223404996746,38.49,IS,0.41,0.0,Phase3-EA-SA2v2-EURCHF-M5-43,EURCHFMT4,1808,6h 54m,Buy
35368.04,140.41,05.03.2009 08:15:00,,0.0,-507.29999999998836,0.0,0.0,140322,05.03.2009 02:50:00,3100,-0.4030177793362773,20.41,IS,0.23,0.0,Phase3-EA-S4v1-GBPJPY-M5-194,GBPJPYMT4,856,5h 25m,Buy
35434.11,1.4793,05.03.2009 10:30:00,,0.0,-441.2299999999814,0.0,0.0,1.47702,05.03.2009 01:45:00,3101,-0.3505293411719736,66.07,IS,0.34,0.0,Phase3-EA-S4v1-EURCHF-M15-221,EURCHFMT4,852,8h 45m,Buy
35394.84,125392,05.03.2009 11:29:57,sl 125.392,0.0,-480.49999999998545,0.0,0.0,125622,05.03.2009 10:15:00,3102,-0.38172687358777807,-39.27,IS,0.17,0.0,Phase3-EA-T1v2-EURJPY-M15-322,EURJPYMT4,94,1h 14m,Buy
35328.23,123772,05.03.2009 17:29:58,sl 123.772,-1.34,-547.109999999986,0.0,0.0,124492,04.03.2009 15:30:00,3103,-0.4346443076141733,-66.61,IS,0.09,0.0,Phase3-EA-TR1v1-EURJPY-M30-91,EURJPYMT4,132,1d 1h 59m,Buy
35366.79,1.46932,05.03.2009 22:14:58,tp 1.46932,0.0,-508.54999999998836,0.0,0.0,1.46822,05.03.2009 21:50:00,3104,-0.4040108253133527,38.56,IS,0.41,0.0,Phase3-EA-SA2v2-EURCHF-M5-43,EURCHFMT4,1810,24m 58s,Buy
35405.37,1.46942,06.03.2009 03:29:58,tp 1.46942,0.0,-469.9699999999866,0.0,0.0,1.46832,06.03.2009 02:00:00,3105,-0.3733614542768957,38.58,IS,0.41,0.0,Phase3-EA-SA2v2-EURCHF-M5-43,EURCHFMT4,1812,1h 29m,Buy
35496.85,138.79,06.03.2009 05:49:57,tp 138.790,0.0,-378.4899999999907,0.0,0.0,139.18,06.03.2009 03:25:00,3106,-0.3006863774906118,91.48,IS,0.23,0.0,Phase3-EA-S4v1-GBPJPY-M5-194,GBPJPYMT4,858,2h 24m,Sell
35613.96,122.51,06.03.2009 13:29:59,tp 122.510,-0.32,-261.3799999999901,0.0,0.0,123.77,05.03.2009 18:00:00,3107,-0.2076498859903698,117.11,IS,0.09,0.0,Phase3-EA-TR1v1-EURJPY-M30-91,EURJPYMT4,134,19h 29m,Sell
35724.01,98138,06.03.2009 23:29:58,tp 98.138,0.0,-151.3299999999872,0.0,0.0,97738,06.03.2009 21:45:00,3108,-0.1202221181686479,110.05,IS,0.27,0.0,Phase3-EA-S1v2-USDJPY-M15-0,USDJPYMT4,1174,1h 44m,Buy
35548.64,1.4683,09.03.2009 02:09:58,sl 1.46830,-1.77,-326.69999999998254,0.0,0.0,1.4634,06.03.2009 22:05:00,3109,-0.25954249656841666,-175.37,IS,0.41,0.0,Phase3-EA-SA2v2-EURCHF-M5-43,EURCHFMT4,1814,2d 4h 4m,Sell
35596.1,1.15742,09.03.2009 02:14:59,tp 1.15742,-2.65,-279.23999999997613,0.0,0.0,1.15842,06.03.2009 23:45:00,3110,-0.2218385269108122,47.46,IS,0.58,0.0,Phase3-EA-SA2v2-USDCHF-M15-107,USDCHFMT4,700,2d 2h 29m,Sell
35635.12,1.4681,09.03.2009 02:39:58,tp 1.46810,0.0,-240.21999999997206,0.0,0.0,1.4692,09.03.2009 02:20:00,3111,-0.19083960369042283,39.02,IS,0.41,0.0,Phase3-EA-SA2v2-EURCHF-M5-43,EURCHFMT4,1816,19m 58s,Sell
35726.44,138.67,09.03.2009 06:14:58,tp 138.670,0.0,-148.89999999996508,0.0,0.0,139.06,09.03.2009 03:25:00,3112,-0.11829163678919573,91.32,IS,0.23,0.0,Phase3-EA-S4v1-GBPJPY-M5-194,GBPJPYMT4,860,2h 49m,Sell
35670.2,1.46902,09.03.2009 10:45:00,,0.0,-205.1399999999703,0.0,0.0,1.4671,09.03.2009 02:00:00,3113,-0.16297076138977698,-56.24,IS,0.34,0.0,Phase3-EA-S4v1-EURCHF-M15-221,EURCHFMT4,854,8h 45m,Sell
35630.63,124612,09.03.2009 13:44:57,sl 124.612,0.0,-244.7099999999773,0.0,0.0,124842,09.03.2009 13:15:00,3114,-0.19440662484008187,-39.57,IS,0.17,0.0,Phase3-EA-T1v2-EURJPY-M15-322,EURJPYMT4,96,29m 57s,Buy
35559.66,125.22,09.03.2009 17:29:58,sl 125.220,0.0,-315.67999999997846,0.0,0.0,124.44,09.03.2009 08:30:00,3115,-0.25078780323451655,-70.97,IS,0.09,0.0,Phase3-EA-TR1v1-EURJPY-M30-91,EURJPYMT4,136,8h 59m,Sell
35598.59,1.46532,09.03.2009 21:04:58,tp 1.46532,0.0,-276.74999999998545,0.0,0.0,1.46422,09.03.2009 20:35:00,3116,-0.21986037932448538,38.93,IS,0.41,0.0,Phase3-EA-SA2v2-EURCHF-M5-43,EURCHFMT4,1818,29m 58s,Buy
35558.97,124522,09.03.2009 22:29:58,sl 124.522,0.0,-316.3699999999808,0.0,0.0,124752,09.03.2009 16:45:00,3117,-0.25133596461386404,-39.62,IS,0.17,0.0,Phase3-EA-T1v2-EURJPY-M15-322,EURJPYMT4,98,5h 44m,Buy
35582.46,98958,10.03.2009 02:00:00,,-0.79,-292.87999999997555,0.0,0.0,98869,09.03.2009 18:00:00,3118,-0.2326746446126587,23.49,IS,0.27,0.0,Phase3-EA-S1v2-USDJPY-M15-0,USDJPYMT4,1176,8h 0m,Buy
35521.01,136.93,10.03.2009 03:59:58,sl 136.930,-0.53,-354.32999999997264,0.0,0.0,136.26,09.03.2009 18:00:00,3119,-0.2814927848456838,-61.45,IS,0.09,0.0,Phase3-EA-B1v1-GBPJPY-M30-1,GBPJPYMT4,394,9h 59m,Sell
35481.48,124942,10.03.2009 04:59:57,sl 124.942,0.0,-393.8599999999715,0.0,0.0,125172,10.03.2009 03:30:00,3120,-0.3128968708247158,-39.53,IS,0.17,0.0,Phase3-EA-T1v2-EURJPY-M15-322,EURJPYMT4,100,1h 29m,Buy
35483.46,1.4637,10.03.2009 05:55:00,,-0.85,-391.87999999997555,0.0,0.0,1.46362,09.03.2009 21:35:00,3121,-0.3113238859970316,1.98,IS,0.41,0.0,Phase3-EA-SA2v2-EURCHF-M5-43,EURCHFMT4,1820,8h 20m,Buy
35601.04,1.46462,10.03.2009 06:14:58,tp 1.46462,0.0,-274.2999999999738,0.0,0.0,1.46062,10.03.2009 01:45:00,3122,-0.21791400920940832,117.58,IS,0.34,0.0,Phase3-EA-S4v1-EURCHF-M15-221,EURCHFMT4,856,4h 29m,Buy
35574.99,136512,10.03.2009 07:35:00,,0.0,-300.3499999999767,0.0,0.0,136.4,10.03.2009 02:10:00,3123,-0.23860908737166228,-26.05,IS,0.23,0.0,Phase3-EA-S4v1-GBPJPY-M5-194,GBPJPYMT4,862,5h 25m,Sell
35532.99,1.38148,10.03.2009 09:29:59,sl 1.38148,0.0,-342.3499999999767,0.0,0.0,1.38448,10.03.2009 09:00:00,3124,-0.27197543220139625,-42.0,IS,0.14,0.0,Phase3-EA-B1v1-GBPUSD-M30-14,GBPUSDMT4,204,29m 59s,Buy
35651.13,1.4602,10.03.2009 09:44:58,tp 1.46020,0.0,-224.2099999999773,0.0,0.0,1.4642,10.03.2009 06:45:00,3125,-0.17812067081604505,118.14,IS,0.34,0.0,Phase3-EA-S4v1-EURCHF-M15-221,EURCHFMT4,858,2h 59m,Sell
35611.34,125272,10.03.2009 19:59:57,sl 125.272,0.0,-263.9999999999709,0.0,0.0,125502,10.03.2009 16:00:00,3126,-0.20973131035830458,-39.79,IS,0.17,0.0,Phase3-EA-T1v2-EURJPY-M15-322,EURJPYMT4,102,3h 59m,Buy
35650.11,1.46942,10.03.2009 21:44:57,tp 1.46942,0.0,-225.22999999996682,0.0,0.0,1.46832,10.03.2009 20:05:00,3127,-0.17893099633333026,38.77,IS,0.41,0.0,Phase3-EA-SA2v2-EURCHF-M5-43,EURCHFMT4,1822,1h 39m,Buy
35689.0,1.4706,10.03.2009 23:34:58,tp 1.47060,0.0,-186.3399999999674,0.0,0.0,1.4717,10.03.2009 22:20:00,3128,-0.1480353498945604,38.89,IS,0.41,0.0,Phase3-EA-SA2v2-EURCHF-M5-43,EURCHFMT4,1824,1h 14m,Sell
35606.14,98568,11.03.2009 04:15:00,,-1.23,-269.199999999968,0.0,0.0,98.27,10.03.2009 17:15:00,3129,-0.213862381622936,-82.86,IS,0.27,0.0,Phase3-EA-S1v2-USDJPY-M15-0,USDJPYMT4,1178,11h 0m,Sell
35626.55,1.47282,11.03.2009 10:25:00,,0.0,-248.7899999999645,0.0,0.0,1.4734,11.03.2009 02:05:00,3130,-0.19764792690924585,20.41,IS,0.41,0.0,Phase3-EA-SA2v2-EURCHF-M5-43,EURCHFMT4,1826,8h 20m,Sell
35586.84,125.24,11.03.2009 13:29:57,sl 125.240,0.0,-288.4999999999709,0.0,0.0,125.01,11.03.2009 05:45:00,3131,-0.22919501150898272,-39.71,IS,0.17,0.0,Phase3-EA-T1v2-EURJPY-M15-322,EURJPYMT4,104,7h 44m,Sell
35546.73,124.55,11.03.2009 19:44:58,sl 124.550,0.0,-328.6099999999715,0.0,0.0,124.32,11.03.2009 19:30:00,3132,-0.2610598708213791,-40.11,IS,0.17,0.0,Phase3-EA-T1v2-EURJPY-M15-322,EURJPYMT4,106,14m 58s,Sell
35585.7,1.47732,11.03.2009 20:19:57,tp 1.47732,0.0,-289.6399999999703,0.0,0.0,1.47622,11.03.2009 20:05:00,3133,-0.23010066944007504,38.97,IS,0.41,0.0,Phase3-EA-SA2v2-EURCHF-M5-43,EURCHFMT4,1828,14m 57s,Buy
35624.81,1.4803,11.03.2009 22:59:58,tp 1.48030,0.0,-250.52999999996973,0.0,0.0,1.4814,11.03.2009 22:35:00,3134,-0.199030246909339,39.11,IS,0.41,0.0,Phase3-EA-SA2v2-EURCHF-M5-43,EURCHFMT4,1830,24m 58s,Sell
35673.28,1.15352,12.03.2009 00:29:58,tp 1.15352,-1.81,-202.05999999996857,0.0,0.0,1.15252,11.03.2009 23:30:00,3135,-0.16052389610226175,48.47,IS,0.58,0.0,Phase3-EA-SA2v2-USDCHF-M15-107,USDCHFMT4,702,59m 58s,Buy
35753.38,97073,12.03.2009 03:15:00,,0.0,-121.95999999996275,0.0,0.0,97361,12.03.2009 01:15:00,3136,-0.09688950989126452,80.1,IS,0.27,0.0,Phase3-EA-S1v2-USDJPY-M15-0,USDJPYMT4,1180,2h 0m,Sell
35845.68,134742,12.03.2009 03:39:58,tp 134.742,0.0,-29.659999999959837,0.0,0.0,134352,12.03.2009 03:10:00,3137,-0.023562994944013548,92.3,IS,0.23,0.0,Phase3-EA-S4v1-GBPJPY-M5-194,GBPJPYMT4,864,29m 58s,Buy
36018.71,131.45,12.03.2009 11:59:58,tp 131.450,0.0,-0.0,0.0,0.0,133.3,12.03.2009 09:30:00,3138,-0.0,173.03,IS,0.09,0.0,Phase3-EA-B1v1-GBPJPY-M30-1,GBPJPYMT4,396,2h 29m,Sell
35951.41,123.31,12.03.2009 14:59:58,sl 123.310,0.0,-67.30000000000291,0.0,0.0,122.59,12.03.2009 11:30:00,3139,-0.05340476822846619,-67.3,IS,0.09,0.0,Phase3-EA-TR1v1-EURJPY-M30-91,EURJPYMT4,138,3h 29m,Sell
36070.67,124872,12.03.2009 17:29:58,tp 124.872,0.0,-0.0,0.0,0.0,123582,12.03.2009 15:00:00,3140,-0.0,119.26,IS,0.09,0.0,Phase3-EA-TR1v1-EURJPY-M30-91,EURJPYMT4,140,2h 29m,Buy
35901.27,1.5291,12.03.2009 22:14:59,sl 1.52910,0.0,-169.39999999999418,0.0,0.0,1.5242,12.03.2009 20:50:00,3141,-0.13436908045304613,-169.4,IS,0.41,0.0,Phase3-EA-SA2v2-EURCHF-M5-43,EURCHFMT4,1832,1h 24m,Sell
35939.35,1.5283,12.03.2009 22:34:58,tp 1.52830,0.0,-131.31999999999243,0.0,0.0,1.5294,12.03.2009 22:20:00,3142,-0.10416379955781349,38.08,IS,0.41,0.0,Phase3-EA-SA2v2-EURCHF-M5-43,EURCHFMT4,1834,14m 58s,Sell
36024.28,97598,12.03.2009 23:00:00,,0.0,-46.38999999999942,0.0,0.0,97907,12.03.2009 22:15:00,3143,-0.03679682197294537,84.93,IS,0.27,0.0,Phase3-EA-S1v2-USDJPY-M15-0,USDJPYMT4,1182,45m 0s,Buy
36062.36,1.5295,12.03.2009 23:09:57,tp 1.52950,0.0,-8.309999999997672,0.0,0.0,1.5306,12.03.2009 22:55:00,3144,-0.006591541077712744,38.08,IS,0.41,0.0,Phase3-EA-SA2v2-EURCHF-M5-43,EURCHFMT4,1836,14m 57s,Sell
36100.42,1.5317,12.03.2009 23:29:58,tp 1.53170,0.0,-0.0,0.0,0.0,1.5328,12.03.2009 23:20:00,3145,-0.0,38.06,IS,0.41,0.0,Phase3-EA-SA2v2-EURCHF-M5-43,EURCHFMT4,1838,9m 58s,Sell
36149.3,1.18648,13.03.2009 02:14:58,tp 1.18648,0.0,-0.0,0.0,0.0,1.18748,13.03.2009 01:45:00,3146,-0.0,48.88,IS,0.58,0.0,Phase3-EA-SA2v2-USDCHF-M15-107,USDCHFMT4,704,29m 58s,Sell
36151.53,97918,13.03.2009 04:30:00,,-0.8,-0.0,0.0,0.0,97905,12.03.2009 22:15:00,3147,-0.0,2.23,IS,0.27,0.0,Phase3-EA-S1v2-USDJPY-M15-0,USDJPYMT4,1183,6h 15m,Sell
36266.84,126882,13.03.2009 11:29:58,tp 126.882,-0.45,-0.0,0.0,0.0,125622,12.03.2009 20:00:00,3148,-0.0,115.31,IS,0.09,0.0,Phase3-EA-TR1v1-EURJPY-M30-91,EURJPYMT4,142,15h 29m,Buy
36257.23,98363,13.03.2009 17:15:00,,0.0,-9.610000000000582,0.0,0.0,98398,13.03.2009 17:00:00,3149,-0.007610866004091484,-9.61,IS,0.27,0.0,Phase3-EA-S1v2-USDJPY-M15-0,USDJPYMT4,1186,15m 0s,Buy
36295.21,1.5333,13.03.2009 23:04:57,tp 1.53330,0.0,-0.0,0.0,0.0,1.5344,13.03.2009 22:50:00,3150,-0.0,37.98,IS,0.41,0.0,Phase3-EA-SA2v2-EURCHF-M5-43,EURCHFMT4,1840,14m 57s,Sell
36254.46,126432,16.03.2009 02:00:00,sl 126.432,-0.85,-40.75,0.0,0.0,126662,13.03.2009 23:45:00,3151,-0.032265673417067854,-40.75,IS,0.17,0.0,Phase3-EA-T1v2-EURJPY-M15-322,EURJPYMT4,108,2d 2h 15m,Buy
36204.95,98121,16.03.2009 02:15:00,,-0.8,-90.25999999999476,0.0,0.0,98298,13.03.2009 17:30:00,3152,-0.07146747687421781,-49.51,IS,0.27,0.0,Phase3-EA-S1v2-USDJPY-M15-0,USDJPYMT4,1188,2d 8h 45m,Buy
36014.38,1.18699,16.03.2009 04:29:58,sl 1.18699,0.0,-280.83000000000175,0.0,0.0,1.19089,16.03.2009 02:15:00,3153,-0.2223599770727662,-190.57,IS,0.58,0.0,Phase3-EA-SA2v2-USDCHF-M15-107,USDCHFMT4,706,2h 14m,Buy
35974.6,126622,16.03.2009 06:29:57,sl 126.622,0.0,-320.6100000000006,0.0,0.0,126852,16.03.2009 04:30:00,3154,-0.2538576086931569,-39.78,IS,0.17,0.0,Phase3-EA-T1v2-EURJPY-M15-322,EURJPYMT4,110,1h 59m,Buy
35902.64,127.35,16.03.2009 10:59:58,sl 127.350,-0.32,-392.570000000007,0.0,0.0,126.57,13.03.2009 13:30:00,3155,-0.3108352248672038,-71.96,IS,0.09,0.0,Phase3-EA-TR1v1-EURJPY-M30-91,EURJPYMT4,144,2d 21h 29m,Sell
36167.24,1.42157,16.03.2009 13:29:57,tp 1.42157,0.0,-127.97000000000116,0.0,0.0,1.40267,16.03.2009 08:00:00,3156,-0.10132609146459413,264.6,IS,0.14,0.0,Phase3-EA-B1v1-GBPUSD-M30-14,GBPUSDMT4,206,5h 29m,Buy
36101.43,127772,16.03.2009 17:59:58,sl 127.772,0.0,-193.77999999999884,0.0,0.0,128492,16.03.2009 15:30:00,3157,-0.15343416428857354,-65.81,IS,0.09,0.0,Phase3-EA-TR1v1-EURJPY-M30-91,EURJPYMT4,146,2h 29m,Buy
36061.67,127782,16.03.2009 20:14:58,sl 127.782,0.0,-233.5399999999936,0.0,0.0,128012,16.03.2009 20:00:00,3158,-0.1849159599956275,-39.76,IS,0.17,0.0,Phase3-EA-T1v2-EURJPY-M15-322,EURJPYMT4,112,14m 58s,Buy
36099.73,1.5383,16.03.2009 22:19:57,tp 1.53830,0.0,-195.47999999999593,0.0,0.0,1.5394,16.03.2009 20:10:00,3159,-0.1547802169219213,38.06,IS,0.41,0.0,Phase3-EA-SA2v2-EURCHF-M5-43,EURCHFMT4,1842,2h 9m,Sell
36148.67,1.18516,17.03.2009 01:44:58,tp 1.18516,0.0,-146.5399999999936,0.0,0.0,1.18416,17.03.2009 01:00:00,3160,-0.11602973699477097,48.94,IS,0.58,0.0,Phase3-EA-SA2v2-USDCHF-M15-107,USDCHFMT4,708,44m 58s,Buy
36185.91,1.53802,17.03.2009 03:59:58,tp 1.53802,-0.83,-109.29999999998836,0.0,0.0,1.53692,16.03.2009 22:45:00,3161,-0.08654326636773352,37.24,IS,0.41,0.0,Phase3-EA-SA2v2-EURCHF-M5-43,EURCHFMT4,1844,5h 14m,Buy
36114.57,128.37,17.03.2009 09:29:58,sl 128.370,-0.32,-180.63999999998487,0.0,0.0,127.59,16.03.2009 19:00:00,3162,-0.1430299692284331,-71.34,IS,0.09,0.0,Phase3-EA-TR1v1-EURJPY-M30-91,EURJPYMT4,148,14h 29m,Sell
36002.87,1.5428,17.03.2009 09:29:58,sl 1.54280,0.0,-292.33999999998196,0.0,0.0,1.5389,17.03.2009 05:30:00,3163,-0.23147354519619717,-111.7,IS,0.34,0.0,Phase3-EA-S4v1-EURCHF-M15-221,EURCHFMT4,860,3h 59m,Sell
35964.04,98661,18.03.2009 01:45:00,,-0.79,-331.1699999999837,0.0,0.0,98.8,17.03.2009 19:15:00,3164,-0.2622189709332475,-38.83,IS,0.27,0.0,Phase3-EA-S1v2-USDJPY-M15-0,USDJPYMT4,1190,6h 30m,Buy
36055.09,138.45,18.03.2009 04:04:59,tp 138.450,0.0,-240.1199999999808,0.0,0.0,138.84,18.03.2009 02:25:00,3165,-0.1901259754823488,91.05,IS,0.23,0.0,Phase3-EA-S4v1-GBPJPY-M5-194,GBPJPYMT4,866,1h 39m,Sell
36097.3,98507,18.03.2009 04:15:00,,0.0,-197.9099999999744,0.0,0.0,98661,18.03.2009 01:45:00,3166,-0.15670428039192816,42.21,IS,0.27,0.0,Phase3-EA-S1v2-USDJPY-M15-0,USDJPYMT4,1192,2h 30m,Sell
36070.58,1.53812,18.03.2009 04:25:00,,-1.73,-224.62999999997555,0.0,0.0,1.5374,17.03.2009 20:05:00,3167,-0.17786106060552548,-26.72,IS,0.41,0.0,Phase3-EA-SA2v2-EURCHF-M5-43,EURCHFMT4,1846,8h 20m,Sell
36030.89,128342,18.03.2009 09:59:58,sl 128.342,0.0,-264.3199999999779,0.0,0.0,128572,18.03.2009 09:30:00,3168,-0.2092874306159181,-39.69,IS,0.17,0.0,Phase3-EA-T1v2-EURJPY-M15-322,EURJPYMT4,114,29m 58s,Buy
36146.07,1.5351,18.03.2009 10:44:57,tp 1.53510,0.0,-149.13999999998487,0.0,0.0,1.5391,18.03.2009 02:45:00,3169,-0.11808840572812299,115.18,IS,0.34,0.0,Phase3-EA-S4v1-EURCHF-M15-221,EURCHFMT4,862,7h 59m,Sell
36184.8,1.52962,18.03.2009 20:59:58,tp 1.52962,0.0,-110.40999999998894,0.0,0.0,1.52852,18.03.2009 20:45:00,3170,-0.0874221595577449,38.73,IS,0.41,0.0,Phase3-EA-SA2v2-EURCHF-M5-43,EURCHFMT4,1848,14m 58s,Buy
36144.99,128542,18.03.2009 21:29:57,sl 128.542,0.0,-150.2199999999866,0.0,0.0,128772,18.03.2009 21:15:00,3171,-0.118943545048135,-39.81,IS,0.17,0.0,Phase3-EA-T1v2-EURJPY-M15-322,EURJPYMT4,116,14m 57s,Buy
36255.4,97816,18.03.2009 21:29:58,tp 97.816,0.0,-39.80999999998312,0.0,0.0,98216,18.03.2009 21:15:00,3172,-0.03152138549037857,110.41,IS,0.27,0.0,Phase3-EA-S1v2-USDJPY-M15-0,USDJPYMT4,1194,14m 58s,Sell
36079.18,1.5392,18.03.2009 23:14:57,sl 1.53920,0.0,-216.02999999998428,0.0,0.0,1.5343,18.03.2009 22:05:00,3173,-0.1710516178721144,-176.22,IS,0.41,0.0,Phase3-EA-SA2v2-EURCHF-M5-43,EURCHFMT4,1850,1h 9m,Sell
36118.72,1.5387,18.03.2009 23:49:59,tp 1.53870,0.0,-176.4899999999907,0.0,0.0,1.5398,18.03.2009 23:30:00,3174,-0.1397440172117302,39.54,IS,0.41,0.0,Phase3-EA-SA2v2-EURCHF-M5-43,EURCHFMT4,1852,19m 59s,Sell
36235.16,129932,19.03.2009 02:59:58,tp 129.932,-1.38,-60.04999999998836,0.0,0.0,128672,18.03.2009 02:00:00,3175,-0.047547329783915314,116.44,IS,0.09,0.0,Phase3-EA-TR1v1-EURJPY-M30-91,EURJPYMT4,150,1d 0h 59m,Buy
36285.34,1.5382,19.03.2009 14:30:00,,0.0,-9.869999999995343,0.0,0.0,1.53652,19.03.2009 05:45:00,3176,-0.007815023230093483,50.18,IS,0.34,0.0,Phase3-EA-S4v1-EURCHF-M15-221,EURCHFMT4,864,8h 45m,Buy
36211.57,129.65,19.03.2009 15:59:58,sl 129.650,0.0,-83.63999999999942,0.0,0.0,128.87,19.03.2009 05:30:00,3177,-0.06622578956082298,-73.77,IS,0.09,0.0,Phase3-EA-TR1v1-EURJPY-M30-91,EURJPYMT4,152,10h 29m,Sell
36169.79,128.71,19.03.2009 18:59:58,sl 128.710,0.0,-125.41999999999825,0.0,0.0,128.48,19.03.2009 18:30:00,3178,-0.09930701251456672,-41.78,IS,0.17,0.0,Phase3-EA-T1v2-EURJPY-M15-322,EURJPYMT4,118,29m 58s,Sell
36209.88,1.5395,19.03.2009 20:24:57,tp 1.53950,0.0,-85.33000000000175,0.0,0.0,1.5406,19.03.2009 20:20:00,3179,-0.06756392423750814,40.09,IS,0.41,0.0,Phase3-EA-SA2v2-EURCHF-M5-43,EURCHFMT4,1854,4m 57s,Sell
36265.55,94323,20.03.2009 10:45:00,,-1.29,-29.660000000003492,0.0,0.0,94522,19.03.2009 21:00:00,3180,-0.023484659473628103,55.67,IS,0.27,0.0,Phase3-EA-S1v2-USDJPY-M15-0,USDJPYMT4,1196,13h 45m,Sell
36223.55,1.45484,20.03.2009 11:29:58,sl 1.45484,0.0,-71.66000000000349,0.0,0.0,1.45784,20.03.2009 11:00:00,3181,-0.0567400774740416,-42.0,IS,0.14,0.0,Phase3-EA-B1v1-GBPUSD-M30-14,GBPUSDMT4,208,29m 58s,Buy
36104.93,1.52932,20.03.2009 13:14:58,sl 1.52932,0.0,-190.27999999999884,0.0,0.0,1.53322,20.03.2009 05:15:00,3182,-0.15066287945520573,-118.62,IS,0.34,0.0,Phase3-EA-S4v1-EURCHF-M15-221,EURCHFMT4,866,7h 59m,Buy
36156.45,1.12567,23.03.2009 02:44:57,tp 1.12567,0.0,-138.75999999999476,0.0,0.0,1.12467,23.03.2009 02:15:00,3183,-0.10986956670802862,51.52,IS,0.58,0.0,Phase3-EA-SA2v2-USDCHF-M15-107,USDCHFMT4,710,29m 57s,Buy
36233.53,96008,23.03.2009 03:15:00,,-0.82,-61.679999999993015,0.0,0.0,95731,20.03.2009 21:15:00,3184,-0.04883795672060171,77.08,IS,0.27,0.0,Phase3-EA-S1v2-USDJPY-M15-0,USDJPYMT4,1198,2d 6h 0m,Buy
36533.07,131002,23.03.2009 03:44:59,tp 131.002,-0.87,-0.0,0.0,0.0,129302,20.03.2009 10:15:00,3185,-0.0,299.54,IS,0.17,0.0,Phase3-EA-T1v2-EURJPY-M15-322,EURJPYMT4,120,2d 17h 29m,Buy
36650.77,131152,23.03.2009 03:59:58,tp 131.152,-0.46,-0.0,0.0,0.0,129892,20.03.2009 16:00:00,3186,-0.0,117.7,IS,0.09,0.0,Phase3-EA-TR1v1-EURJPY-M30-91,EURJPYMT4,154,2d 11h 59m,Buy
36459.59,139685,23.03.2009 05:14:57,sl 139.685,0.0,-191.17999999999302,0.0,0.0,138885,23.03.2009 03:15:00,3187,-0.15095052323802938,-191.18,IS,0.23,0.0,Phase3-EA-S4v1-GBPJPY-M5-194,GBPJPYMT4,868,1h 59m,Sell
36279.03,1.53564,23.03.2009 05:34:58,sl 1.53564,-1.82,-371.7399999999907,0.0,0.0,1.53074,20.03.2009 21:15:00,3188,-0.29351578359925556,-180.56,IS,0.41,0.0,Phase3-EA-SA2v2-EURCHF-M5-43,EURCHFMT4,1856,2d 8h 19m,Sell
36312.34,1.5324,23.03.2009 12:00:00,,0.0,-338.429999999993,0.0,0.0,1.5335,23.03.2009 03:15:00,3189,-0.2672151144442258,33.31,IS,0.34,0.0,Phase3-EA-S4v1-EURCHF-M15-221,EURCHFMT4,868,8h 45m,Sell
36270.34,1.44864,23.03.2009 17:59:58,sl 1.44864,0.0,-380.429999999993,0.0,0.0,1.45164,23.03.2009 08:30:00,3190,-0.3003771710191681,-42.0,IS,0.14,0.0,Phase3-EA-B1v1-GBPUSD-M30-14,GBPUSDMT4,210,9h 29m,Buy
36361.44,141039,24.03.2009 01:54:58,tp 141.039,-1.38,-289.3299999999872,0.0,0.0,141429,23.03.2009 23:05:00,3191,-0.2284470911625625,91.1,IS,0.23,0.0,Phase3-EA-S4v1-GBPJPY-M5-194,GBPJPYMT4,870,2h 49m,Sell
36405.94,97141,24.03.2009 02:30:00,,-0.81,-244.8299999999872,0.0,0.0,96978,23.03.2009 20:00:00,3192,-0.19331110264863557,44.5,IS,0.27,0.0,Phase3-EA-S1v2-USDJPY-M15-0,USDJPYMT4,1200,6h 30m,Buy
36444.23,1.53186,24.03.2009 02:44:58,tp 1.53186,-1.82,-206.5399999999936,0.0,0.0,1.53296,23.03.2009 22:10:00,3193,-0.1630783610711516,38.29,IS,0.41,0.0,Phase3-EA-SA2v2-EURCHF-M5-43,EURCHFMT4,1858,4h 34m,Sell
36484.31,1.53311,24.03.2009 03:09:58,tp 1.53311,0.0,-166.45999999999185,0.0,0.0,1.53201,24.03.2009 02:45:00,3194,-0.13143228422534814,40.08,IS,0.41,0.0,Phase3-EA-SA2v2-EURCHF-M5-43,EURCHFMT4,1860,24m 58s,Buy
36600.74,132.59,24.03.2009 03:29:58,tp 132.590,-0.45,-50.029999999998836,0.0,0.0,131.33,23.03.2009 04:30:00,3195,-0.03950232596296009,116.43,IS,0.09,0.0,Phase3-EA-TR1v1-EURJPY-M30-91,EURJPYMT4,156,22h 59m,Buy
36772.01,142253,24.03.2009 03:29:58,tp 142.253,-0.33,-0.0,0.0,0.0,140403,23.03.2009 12:00:00,3196,-0.0,171.27,IS,0.09,0.0,Phase3-EA-B1v1-GBPJPY-M30-1,GBPJPYMT4,398,15h 29m,Buy
37068.0,133457,24.03.2009 03:59:57,tp 133.457,-0.86,-0.0,0.0,0.0,131757,23.03.2009 18:45:00,3197,-0.0,295.99,IS,0.17,0.0,Phase3-EA-T1v2-EURJPY-M15-322,EURJPYMT4,122,9h 14m,Buy
37238.23,144038,24.03.2009 08:29:58,tp 144.038,0.0,-0.0,0.0,0.0,142188,24.03.2009 03:30:00,3198,-0.0,170.23,IS,0.09,0.0,Phase3-EA-B1v1-GBPJPY-M30-1,GBPJPYMT4,400,4h 59m,Buy
37359.58,1.53065,24.03.2009 09:44:58,tp 1.53065,0.0,-0.0,0.0,0.0,1.53465,24.03.2009 05:30:00,3199,-0.0,121.35,IS,0.34,0.0,Phase3-EA-S4v1-EURCHF-M15-221,EURCHFMT4,870,4h 14m,Sell
37293.47,133062,24.03.2009 13:29:57,sl 133.062,0.0,-66.11000000000058,0.0,0.0,133782,24.03.2009 05:30:00,3200,-0.05190814856644519,-66.11,IS,0.09,0.0,Phase3-EA-TR1v1-EURJPY-M30-91,EURJPYMT4,158,7h 59m,Buy
37231.93,143443,24.03.2009 18:29:57,sl 143.443,0.0,-127.64999999999418,0.0,0.0,144113,24.03.2009 08:30:00,3201,-0.10022803153087835,-61.54,IS,0.09,0.0,Phase3-EA-B1v1-GBPJPY-M30-1,GBPJPYMT4,402,9h 59m,Buy
37271.88,1.52707,24.03.2009 20:34:58,tp 1.52707,0.0,-87.69999999999709,0.0,0.0,1.52817,24.03.2009 20:25:00,3202,-0.06886015170590004,39.95,IS,0.41,0.0,Phase3-EA-SA2v2-EURCHF-M5-43,EURCHFMT4,1862,9m 58s,Sell
37094.16,1.52041,24.03.2009 22:54:58,sl 1.52041,0.0,-265.41999999999825,0.0,0.0,1.52531,24.03.2009 21:20:00,3203,-0.20840206916511375,-177.72,IS,0.41,0.0,Phase3-EA-SA2v2-EURCHF-M5-43,EURCHFMT4,1864,1h 34m,Buy
37134.02,1.52299,24.03.2009 23:04:57,tp 1.52299,0.0,-225.55999999999767,0.0,0.0,1.52189,24.03.2009 23:00:00,3204,-0.17710485540231663,39.86,IS,0.41,0.0,Phase3-EA-SA2v2-EURCHF-M5-43,EURCHFMT4,1866,4m 57s,Buy
37225.69,143711,24.03.2009 23:49:58,tp 143.711,0.0,-133.88999999999942,0.0,0.0,143321,24.03.2009 23:15:00,3205,-0.10512754517563538,91.67,IS,0.23,0.0,Phase3-EA-S4v1-GBPJPY-M5-194,GBPJPYMT4,872,34m 58s,Buy
37317.27,143.87,25.03.2009 03:44:57,tp 143.870,0.0,-42.30999999999767,0.0,0.0,144.26,25.03.2009 02:10:00,3206,-0.03322090101113532,91.58,IS,0.23,0.0,Phase3-EA-S4v1-GBPJPY-M5-194,GBPJPYMT4,874,1h 34m,Sell
37376.78,97546,25.03.2009 04:15:00,,0.0,-0.0,0.0,0.0,97761,25.03.2009 00:15:00,3207,-0.0,59.51,IS,0.27,0.0,Phase3-EA-S1v2-USDJPY-M15-0,USDJPYMT4,1202,4h 0m,Sell
37417.09,1.52197,25.03.2009 21:29:57,tp 1.52197,0.0,-0.0,0.0,0.0,1.52087,25.03.2009 20:50:00,3208,-0.0,40.31,IS,0.41,0.0,Phase3-EA-SA2v2-EURCHF-M5-43,EURCHFMT4,1868,39m 57s,Buy
37457.38,1.52123,25.03.2009 22:49:57,tp 1.52123,0.0,-0.0,0.0,0.0,1.52013,25.03.2009 22:15:00,3209,-0.0,40.29,IS,0.41,0.0,Phase3-EA-SA2v2-EURCHF-M5-43,EURCHFMT4,1870,34m 57s,Buy
37356.94,142617,26.03.2009 08:10:00,,0.0,-100.44000000000233,0.0,0.0,142.19,26.03.2009 02:45:00,3210,-0.07880281235970989,-100.44,IS,0.23,0.0,Phase3-EA-S4v1-GBPJPY-M5-194,GBPJPYMT4,876,5h 25m,Sell
37311.27,1.52377,26.03.2009 08:15:00,,-5.49,-146.11000000000058,0.0,0.0,1.52267,25.03.2009 23:55:00,3211,-0.1146343977885005,-45.67,IS,0.41,0.0,Phase3-EA-SA2v2-EURCHF-M5-43,EURCHFMT4,1872,8h 20m,Sell
37263.04,97704,26.03.2009 09:15:00,,-3.74,-194.3399999999965,0.0,0.0,97543,25.03.2009 23:30:00,3212,-0.15247449774975497,-48.23,IS,0.27,0.0,Phase3-EA-S1v2-USDJPY-M15-0,USDJPYMT4,1204,9h 45m,Sell
37380.25,133212,26.03.2009 10:29:58,tp 133.212,-1.36,-77.1299999999901,0.0,0.0,131922,25.03.2009 14:00:00,3213,-0.060514346050413205,117.21,IS,0.09,0.0,Phase3-EA-TR1v1-EURJPY-M30-91,EURJPYMT4,160,20h 29m,Buy
37262.51,1.52732,26.03.2009 12:59:58,sl 1.52732,0.0,-194.86999999999534,0.0,0.0,1.52342,26.03.2009 06:00:00,3214,-0.1528903230240536,-117.74,IS,0.34,0.0,Phase3-EA-S4v1-EURCHF-M15-221,EURCHFMT4,872,6h 59m,Sell
37320.85,98572,26.03.2009 22:30:00,,0.0,-136.52999999999884,0.0,0.0,98359,26.03.2009 19:30:00,3215,-0.10711815981153773,58.34,IS,0.27,0.0,Phase3-EA-S1v2-USDJPY-M15-0,USDJPYMT4,1206,3h 0m,Buy
37320.85,98574,26.03.2009 22:45:00,,0.0,-136.52999999999884,0.0,0.0,98574,26.03.2009 22:30:00,3216,-0.10711815981153773,0.0,IS,0.27,0.0,Phase3-EA-S1v2-USDJPY-M15-0,USDJPYMT4,1208,15m 0s,Buy
37281.13,133263,27.03.2009 03:29:57,sl 133.263,0.0,-176.25,0.0,0.0,133493,27.03.2009 00:30:00,3217,-0.1382815181043264,-39.72,IS,0.17,0.0,Phase3-EA-T1v2-EURJPY-M15-322,EURJPYMT4,124,2h 59m,Buy
37320.33,1.52662,27.03.2009 04:39:57,tp 1.52662,-0.87,-137.0500000000029,0.0,0.0,1.52552,26.03.2009 21:35:00,3218,-0.10752613932594801,39.2,IS,0.41,0.0,Phase3-EA-SA2v2-EURCHF-M5-43,EURCHFMT4,1874,7h 4m,Buy
37438.15,132192,27.03.2009 13:29:58,tp 132.192,-0.32,-19.229999999995925,0.0,0.0,133482,26.03.2009 19:30:00,3219,-0.015087396273166714,117.82,IS,0.09,0.0,Phase3-EA-TR1v1-EURJPY-M30-91,EURJPYMT4,162,17h 59m,Sell
37450.11,1.5261,27.03.2009 13:45:00,,0.0,-7.269999999989523,0.0,0.0,1.5265,27.03.2009 05:00:00,3220,-0.005703867441798605,11.96,IS,0.34,0.0,Phase3-EA-S4v1-EURCHF-M15-221,EURCHFMT4,874,8h 45m,Sell
37565.77,129941,27.03.2009 14:59:58,tp 129.941,0.0,-0.0,0.0,0.0,131201,27.03.2009 14:30:00,3221,-0.0,115.66,IS,0.09,0.0,Phase3-EA-TR1v1-EURJPY-M30-91,EURJPYMT4,164,29m 58s,Sell
37499.27,130352,27.03.2009 15:59:58,sl 130.352,0.0,-66.5,0.0,0.0,129632,27.03.2009 15:00:00,3222,-0.05212997185687041,-66.5,IS,0.09,0.0,Phase3-EA-TR1v1-EURJPY-M30-91,EURJPYMT4,166,59m 58s,Sell
37538.72,1.52155,27.03.2009 21:04:57,tp 1.52155,0.0,-27.05000000000291,0.0,0.0,1.52045,27.03.2009 21:00:00,3223,-0.021204747950804455,39.45,IS,0.41,0.0,Phase3-EA-SA2v2-EURCHF-M5-43,EURCHFMT4,1876,4m 57s,Buy
37573.48,97861,27.03.2009 23:30:00,,0.0,-0.0,0.0,0.0,97987,27.03.2009 19:00:00,3224,-0.0,34.76,IS,0.27,0.0,Phase3-EA-S1v2-USDJPY-M15-0,USDJPYMT4,1210,4h 30m,Sell
37664.92,140127,30.03.2009 02:34:57,tp 140.127,0.0,-0.0,0.0,0.0,139737,30.03.2009 02:15:00,3225,-0.0,91.44,IS,0.23,0.0,Phase3-EA-S4v1-GBPJPY-M5-194,GBPJPYMT4,878,19m 57s,Buy
37757.6,98201,30.03.2009 02:45:00,,-0.8,-0.0,0.0,0.0,97861,27.03.2009 23:30:00,3226,-0.0,92.68,IS,0.27,0.0,Phase3-EA-S1v2-USDJPY-M15-0,USDJPYMT4,1212,2d 3h 15m,Buy
37747.79,1.52005,30.03.2009 06:15:00,,-0.86,-9.809999999997672,0.0,0.0,1.5203,27.03.2009 21:55:00,3227,-0.007678603856050582,-9.81,IS,0.41,0.0,Phase3-EA-SA2v2-EURCHF-M5-43,EURCHFMT4,1878,2d 8h 20m,Buy
37631.99,1.51537,30.03.2009 09:14:59,sl 1.51537,0.0,-125.61000000000058,0.0,0.0,1.51927,30.03.2009 03:45:00,3228,-0.09831900411404149,-115.8,IS,0.34,0.0,Phase3-EA-S4v1-EURCHF-M15-221,EURCHFMT4,876,5h 29m,Buy
37750.03,126.79,30.03.2009 11:29:58,tp 126.790,0.0,-7.570000000006985,0.0,0.0,128.05,30.03.2009 10:00:00,3229,-0.005925283505644275,118.04,IS,0.09,0.0,Phase3-EA-TR1v1-EURJPY-M30-91,EURJPYMT4,168,1h 29m,Sell
37683.05,127556,30.03.2009 15:29:58,sl 127.556,0.0,-74.55000000000291,0.0,0.0,126836,30.03.2009 11:30:00,3230,-0.0583526929122048,-66.98,IS,0.09,0.0,Phase3-EA-TR1v1-EURJPY-M30-91,EURJPYMT4,170,3h 59m,Sell
37722.17,1.51565,30.03.2009 20:59:58,tp 1.51565,0.0,-35.43000000000757,0.0,0.0,1.51675,30.03.2009 20:30:00,3231,-0.027732205363913843,39.12,IS,0.41,0.0,Phase3-EA-SA2v2-EURCHF-M5-43,EURCHFMT4,1880,29m 58s,Sell
37761.31,1.51484,30.03.2009 22:14:58,tp 1.51484,0.0,-0.0,0.0,0.0,1.51374,30.03.2009 21:55:00,3232,-0.0,39.14,IS,0.41,0.0,Phase3-EA-SA2v2-EURCHF-M5-43,EURCHFMT4,1882,19m 58s,Buy
37811.78,1.14921,30.03.2009 23:59:58,tp 1.14921,0.0,-0.0,0.0,0.0,1.14821,30.03.2009 23:30:00,3233,-0.0,50.47,IS,0.58,0.0,Phase3-EA-SA2v2-USDCHF-M15-107,USDCHFMT4,712,29m 58s,Buy
37850.2,1.51608,31.03.2009 01:04:58,tp 1.51608,-0.86,-0.0,0.0,0.0,1.51498,30.03.2009 23:15:00,3234,-0.0,38.42,IS,0.41,0.0,Phase3-EA-SA2v2-EURCHF-M5-43,EURCHFMT4,1884,1h 49m,Buy
37960.16,97501,31.03.2009 01:14:57,tp 97.501,-0.81,-0.0,0.0,0.0,97101,30.03.2009 22:00:00,3235,-0.0,109.96,IS,0.27,0.0,Phase3-EA-S1v2-USDJPY-M15-0,USDJPYMT4,1214,3h 14m,Buy
37894.94,97291,31.03.2009 01:30:00,,0.0,-65.22000000000116,0.0,0.0,97526,31.03.2009 01:15:00,3236,-0.05096898909785766,-65.22,IS,0.27,0.0,Phase3-EA-S1v2-USDJPY-M15-0,USDJPYMT4,1216,15m 0s,Buy
37906.87,97336,31.03.2009 02:15:00,,0.0,-53.29000000000815,0.0,0.0,97293,31.03.2009 01:30:00,3237,-0.04164577474739652,11.93,IS,0.27,0.0,Phase3-EA-S1v2-USDJPY-M15-0,USDJPYMT4,1218,45m 0s,Buy
37999.08,138561,31.03.2009 02:29:58,tp 138.561,0.0,-0.0,0.0,0.0,138951,31.03.2009 01:10:00,3238,-0.0,92.21,IS,0.23,0.0,Phase3-EA-S4v1-GBPJPY-M5-194,GBPJPYMT4,880,1h 19m,Sell
38038.31,1.51645,31.03.2009 03:34:58,tp 1.51645,0.0,-0.0,0.0,0.0,1.51755,31.03.2009 02:10:00,3239,-0.0,39.23,IS,0.41,0.0,Phase3-EA-SA2v2-EURCHF-M5-43,EURCHFMT4,1886,1h 24m,Sell
38069.0,1.51624,31.03.2009 11:15:00,,0.0,-0.0,0.0,0.0,1.51727,31.03.2009 02:30:00,3240,-0.0,30.69,IS,0.34,0.0,Phase3-EA-S4v1-EURCHF-M15-221,EURCHFMT4,878,8h 45m,Sell
38184.38,130661,31.03.2009 11:29:57,tp 130.661,0.0,-0.0,0.0,0.0,129401,31.03.2009 04:00:00,3241,-0.0,115.38,IS,0.09,0.0,Phase3-EA-TR1v1-EURJPY-M30-91,EURJPYMT4,172,7h 29m,Buy
38353.72,141145,31.03.2009 13:59:58,tp 141.145,0.0,-0.0,0.0,0.0,139295,31.03.2009 03:30:00,3242,-0.0,169.34,IS,0.09,0.0,Phase3-EA-B1v1-GBPJPY-M30-1,GBPJPYMT4,404,10h 29m,Buy
38292.51,140405,31.03.2009 16:59:58,sl 140.405,0.0,-61.2100000000064,0.0,0.0,141075,31.03.2009 14:00:00,3243,-0.0476885282327668,-61.21,IS,0.09,0.0,Phase3-EA-B1v1-GBPJPY-M30-1,GBPJPYMT4,406,2h 59m,Buy
38332.14,1.5117,31.03.2009 22:44:58,tp 1.51170,0.0,-21.580000000001746,0.0,0.0,1.5128,31.03.2009 21:40:00,3244,-0.01681291356417388,39.63,IS,0.41,0.0,Phase3-EA-SA2v2-EURCHF-M5-43,EURCHFMT4,1888,1h 4m,Sell
38371.77,1.51211,31.03.2009 22:54:58,tp 1.51211,0.0,-0.0,0.0,0.0,1.51101,31.03.2009 22:50:00,3245,-0.0,39.63,IS,0.41,0.0,Phase3-EA-SA2v2-EURCHF-M5-43,EURCHFMT4,1890,4m 58s,Buy
38310.88,141741,31.03.2009 23:29:58,sl 141.741,0.0,-60.88999999999942,0.0,0.0,142411,31.03.2009 22:30:00,3246,-0.04743254689095543,-60.89,IS,0.09,0.0,Phase3-EA-B1v1-GBPJPY-M30-1,GBPJPYMT4,408,59m 58s,Buy
38361.8,1.13908,31.03.2009 23:29:58,tp 1.13908,0.0,-9.970000000001164,0.0,0.0,1.13808,31.03.2009 23:00:00,3247,-0.007766505050137713,50.92,IS,0.58,0.0,Phase3-EA-SA2v2-USDCHF-M15-107,USDCHFMT4,714,29m 58s,Buy
38452.44,141936,01.04.2009 01:24:58,tp 141.936,0.0,-0.0,0.0,0.0,141546,01.04.2009 00:20:00,3248,-0.0,90.64,IS,0.23,0.0,Phase3-EA-S4v1-GBPJPY-M5-194,GBPJPYMT4,882,1h 4m,Buy
38492.07,1.50888,01.04.2009 02:29:58,tp 1.50888,0.0,-0.0,0.0,0.0,1.50778,01.04.2009 01:05:00,3249,-0.0,39.63,IS,0.41,0.0,Phase3-EA-SA2v2-EURCHF-M5-43,EURCHFMT4,1892,1h 24m,Buy
38599.96,99376,01.04.2009 02:59:57,tp 99.376,-0.79,-0.0,0.0,0.0,98976,31.03.2009 23:00:00,3250,-0.0,107.89,IS,0.27,0.0,Phase3-EA-S1v2-USDJPY-M15-0,USDJPYMT4,1220,3h 59m,Buy
38639.56,1.50893,01.04.2009 03:04:57,tp 1.50893,0.0,-0.0,0.0,0.0,1.51003,01.04.2009 02:50:00,3251,-0.0,39.6,IS,0.41,0.0,Phase3-EA-SA2v2-EURCHF-M5-43,EURCHFMT4,1894,14m 57s,Sell
38730.88,141625,01.04.2009 03:04:58,tp 141.625,0.0,-0.0,0.0,0.0,142015,01.04.2009 01:35:00,3252,-0.0,91.32,IS,0.23,0.0,Phase3-EA-S4v1-GBPJPY-M5-194,GBPJPYMT4,884,1h 29m,Sell
38691.07,131435,01.04.2009 03:14:58,sl 131.435,0.0,-39.80999999999767,0.0,0.0,131665,01.04.2009 03:00:00,3253,-0.030924980859291643,-39.81,IS,0.17,0.0,Phase3-EA-T1v2-EURJPY-M15-322,EURJPYMT4,126,14m 58s,Buy
38770.12,1.51108,01.04.2009 10:15:00,,0.0,-0.0,0.0,0.0,1.50842,01.04.2009 01:30:00,3254,-0.0,79.05,IS,0.34,0.0,Phase3-EA-S4v1-EURCHF-M15-221,EURCHFMT4,880,8h 45m,Buy
38728.12,1.43322,01.04.2009 16:59:58,sl 1.43322,0.0,-42.0,0.0,0.0,1.43622,01.04.2009 11:00:00,3255,-0.032616262219837974,-42.0,IS,0.14,0.0,Phase3-EA-B1v1-GBPUSD-M30-14,GBPUSDMT4,212,5h 59m,Buy
38767.43,1.51666,01.04.2009 21:54:58,tp 1.51666,0.0,-2.6900000000023283,0.0,0.0,1.51556,01.04.2009 21:45:00,3256,-0.0020889939374152404,39.31,IS,0.41,0.0,Phase3-EA-SA2v2-EURCHF-M5-43,EURCHFMT4,1896,9m 58s,Buy
38806.79,1.51697,01.04.2009 23:04:57,tp 1.51697,0.0,-0.0,0.0,0.0,1.51587,01.04.2009 22:40:00,3257,-0.0,39.36,IS,0.41,0.0,Phase3-EA-SA2v2-EURCHF-M5-43,EURCHFMT4,1898,24m 57s,Buy
38857.38,1.14643,01.04.2009 23:14:57,tp 1.14643,0.0,-0.0,0.0,0.0,1.14543,01.04.2009 22:45:00,3258,-0.0,50.59,IS,0.58,0.0,Phase3-EA-SA2v2-USDCHF-M15-107,USDCHFMT4,716,29m 57s,Buy
38905.62,98498,02.04.2009 02:45:00,,0.0,-0.0,0.0,0.0,98674,02.04.2009 00:45:00,3259,-0.0,48.24,IS,0.27,0.0,Phase3-EA-S1v2-USDJPY-M15-0,USDJPYMT4,1222,2h 0m,Sell
38865.91,130697,02.04.2009 03:59:58,sl 130.697,0.0,-39.7100000000064,0.0,0.0,130467,02.04.2009 03:00:00,3260,-0.030805483888139574,-39.71,IS,0.17,0.0,Phase3-EA-T1v2-EURJPY-M15-322,EURJPYMT4,128,59m 58s,Sell
38750.2,1.52134,02.04.2009 11:44:57,sl 1.52134,0.0,-155.4200000000128,0.0,0.0,1.51744,02.04.2009 05:00:00,3261,-0.12056883167701524,-115.71,IS,0.34,0.0,Phase3-EA-S4v1-EURCHF-M15-221,EURCHFMT4,882,6h 44m,Sell
38678.14,131936,02.04.2009 12:29:58,sl 131.936,-1.28,-227.48000000001048,0.0,0.0,131156,31.03.2009 23:30:00,3262,-0.17647019579131662,-72.06,IS,0.09,0.0,Phase3-EA-TR1v1-EURJPY-M30-91,EURJPYMT4,174,1d 12h 59m,Sell
38786.56,99611,02.04.2009 18:29:59,tp 99.611,0.0,-119.06000000001222,0.0,0.0,99211,02.04.2009 17:00:00,3263,-0.09236214836871526,108.42,IS,0.27,0.0,Phase3-EA-S1v2-USDJPY-M15-0,USDJPYMT4,1224,1h 29m,Buy
38826.32,1.52635,02.04.2009 21:09:58,tp 1.52635,0.0,-79.30000000001746,0.0,0.0,1.52745,02.04.2009 20:15:00,3264,-0.061517876412228965,39.76,IS,0.41,0.0,Phase3-EA-SA2v2-EURCHF-M5-43,EURCHFMT4,1900,54m 58s,Sell
38876.81,1.1351,03.04.2009 02:59:57,tp 1.13510,-0.61,-28.810000000012224,0.0,0.0,1.1341,02.04.2009 23:45:00,3265,-0.02234968498659115,50.49,IS,0.58,0.0,Phase3-EA-SA2v2-USDCHF-M15-107,USDCHFMT4,718,3h 14m,Buy
38989.95,134377,03.04.2009 02:59:58,tp 134.377,-0.44,-0.0,0.0,0.0,133117,02.04.2009 13:30:00,3266,-0.0,113.14,IS,0.09,0.0,Phase3-EA-TR1v1-EURJPY-M30-91,EURJPYMT4,176,13h 29m,Buy
39079.76,147296,03.04.2009 03:49:58,tp 147.296,0.0,-0.0,0.0,0.0,147686,03.04.2009 03:35:00,3267,-0.0,89.81,IS,0.23,0.0,Phase3-EA-S4v1-GBPJPY-M5-194,GBPJPYMT4,886,14m 58s,Sell
39019.3,146074,03.04.2009 05:29:58,sl 146.074,0.0,-60.4600000000064,0.0,0.0,146744,03.04.2009 00:30:00,3268,-0.04683925659608171,-60.46,IS,0.09,0.0,Phase3-EA-B1v1-GBPJPY-M30-1,GBPJPYMT4,410,4h 59m,Buy
38944.89,99606,03.04.2009 08:45:00,,-1.22,-134.8700000000099,0.0,0.0,99336,02.04.2009 21:00:00,3269,-0.1044857846032639,-74.41,IS,0.27,0.0,Phase3-EA-S1v2-USDJPY-M15-0,USDJPYMT4,1226,11h 45m,Sell
38884.23,146464,03.04.2009 10:29:58,sl 146.464,0.0,-195.5300000000134,0.0,0.0,145794,03.04.2009 09:30:00,3270,-0.1514799841586423,-60.66,IS,0.09,0.0,Phase3-EA-B1v1-GBPJPY-M30-1,GBPJPYMT4,412,59m 58s,Sell
38814.0,134.68,03.04.2009 11:59:57,sl 134.680,0.0,-265.7600000000093,0.0,0.0,133.9,03.04.2009 05:00:00,3271,-0.20588820431647029,-70.23,IS,0.09,0.0,Phase3-EA-TR1v1-EURJPY-M30-91,EURJPYMT4,178,6h 59m,Sell
38780.14,1.52425,03.04.2009 14:30:00,,0.0,-299.6200000000099,0.0,0.0,1.52538,03.04.2009 05:45:00,3272,-0.2321200473257853,-33.86,IS,0.34,0.0,Phase3-EA-S4v1-EURCHF-M15-221,EURCHFMT4,884,8h 45m,Buy
38798.24,99.93,03.04.2009 19:00:00,,0.0,-281.5200000000041,0.0,0.0,99863,03.04.2009 17:00:00,3273,-0.21809770950922458,18.1,IS,0.27,0.0,Phase3-EA-S1v2-USDJPY-M15-0,USDJPYMT4,1228,2h 0m,Buy
38825.27,134.4,03.04.2009 19:45:00,,0.0,-254.49000000000524,0.0,0.0,134241,03.04.2009 18:45:00,3274,-0.1971571685599705,27.03,IS,0.17,0.0,Phase3-EA-T1v2-EURJPY-M15-322,EURJPYMT4,130,1h 0m,Buy
38865.17,1.52395,03.04.2009 22:54:57,tp 1.52395,0.0,-214.59000000001106,0.0,0.0,1.52505,03.04.2009 20:50:00,3275,-0.16624604817983174,39.9,IS,0.41,0.0,Phase3-EA-SA2v2-EURCHF-M5-43,EURCHFMT4,1902,2h 4m,Sell
38663.84,1127,06.04.2009 01:14:59,sl 1.12700,-0.62,-415.9200000000128,0.0,0.0,1.1309,03.04.2009 23:00:00,3276,-0.322219378158135,-201.33,IS,0.58,0.0,Phase3-EA-SA2v2-USDCHF-M15-107,USDCHFMT4,720,2d 2h 14m,Buy
38715.27,1.12785,06.04.2009 01:59:58,tp 1.12785,0.0,-364.4900000000198,0.0,0.0,1.12685,06.04.2009 01:30:00,3277,-0.2823757961744119,51.43,IS,0.58,0.0,Phase3-EA-SA2v2-USDCHF-M15-107,USDCHFMT4,722,29m 58s,Buy
38827.62,136.49,06.04.2009 03:59:58,tp 136.490,-0.44,-252.14000000001397,0.0,0.0,135.23,03.04.2009 23:00:00,3278,-0.19533658878821444,112.35,IS,0.09,0.0,Phase3-EA-TR1v1-EURJPY-M30-91,EURJPYMT4,180,2d 4h 59m,Buy
38867.71,1.52557,06.04.2009 05:59:57,tp 1.52557,0.0,-212.05000000001746,0.0,0.0,1.52667,06.04.2009 01:10:00,3279,-0.16427827259673988,40.09,IS,0.41,0.0,Phase3-EA-SA2v2-EURCHF-M5-43,EURCHFMT4,1904,4h 49m,Sell
38852.36,1.52693,06.04.2009 12:30:00,,0.0,-227.40000000002328,0.0,0.0,1.52642,06.04.2009 03:45:00,3280,-0.17617014472293985,-15.35,IS,0.34,0.0,Phase3-EA-S4v1-EURCHF-M15-221,EURCHFMT4,886,8h 45m,Sell
38788.19,135806,06.04.2009 15:29:58,sl 135.806,0.0,-291.57000000002154,0.0,0.0,136526,06.04.2009 04:00:00,3281,-0.22588359321401102,-64.17,IS,0.09,0.0,Phase3-EA-TR1v1-EURJPY-M30-91,EURJPYMT4,182,11h 29m,Buy
38728.25,150042,06.04.2009 15:29:59,sl 150.042,0.0,-351.51000000002387,0.0,0.0,150712,06.04.2009 07:30:00,3282,-0.2723199981159123,-59.94,IS,0.09,0.0,Phase3-EA-B1v1-GBPJPY-M30-1,GBPJPYMT4,414,7h 59m,Buy
38663.93,135345,06.04.2009 21:29:58,sl 135.345,0.0,-415.83000000003085,0.0,0.0,134625,06.04.2009 19:30:00,3283,-0.32214965382646443,-64.32,IS,0.09,0.0,Phase3-EA-TR1v1-EURJPY-M30-91,EURJPYMT4,184,1h 59m,Sell
38703.65,1.52329,06.04.2009 21:29:58,tp 1.52329,0.0,-376.1100000000297,0.0,0.0,1.52439,06.04.2009 21:10:00,3284,-0.29137798210968935,39.72,IS,0.41,0.0,Phase3-EA-SA2v2-EURCHF-M5-43,EURCHFMT4,1906,19m 58s,Sell
38742.98,100581,07.04.2009 02:30:00,,-1.2,-336.78000000002794,0.0,0.0,100732,06.04.2009 20:15:00,3285,-0.2609084491635468,39.33,IS,0.27,0.0,Phase3-EA-S1v2-USDJPY-M15-0,USDJPYMT4,1230,6h 15m,Sell
38560.06,147659,07.04.2009 02:34:58,sl 147.659,0.0,-519.7000000000262,0.0,0.0,148459,07.04.2009 01:35:00,3286,-0.4026192797383777,-182.92,IS,0.23,0.0,Phase3-EA-S4v1-GBPJPY-M5-194,GBPJPYMT4,888,59m 58s,Buy
38383.75,1.51712,07.04.2009 02:59:58,sl 1.51712,0.0,-696.0100000000239,0.0,0.0,1.52202,07.04.2009 02:35:00,3287,-0.5392092455083773,-176.31,IS,0.41,0.0,Phase3-EA-SA2v2-EURCHF-M5-43,EURCHFMT4,1908,24m 58s,Buy
38472.86,147923,07.04.2009 04:24:58,tp 147.923,0.0,-606.9000000000233,0.0,0.0,147533,07.04.2009 02:40:00,3288,-0.47017440999272364,89.11,IS,0.23,0.0,Phase3-EA-S4v1-GBPJPY-M5-194,GBPJPYMT4,890,1h 44m,Buy
38402.94,133.54,07.04.2009 11:59:58,sl 133.540,0.0,-676.8200000000215,0.0,0.0,134.32,07.04.2009 09:30:00,3289,-0.52434246856364,-69.92,IS,0.09,0.0,Phase3-EA-TR1v1-EURJPY-M30-91,EURJPYMT4,186,2h 29m,Buy
38691.16,133.35,07.04.2009 12:14:57,tp 133.350,0.0,-388.6000000000204,0.0,0.0,135.05,07.04.2009 02:15:00,3290,-0.3010541699179024,288.22,IS,0.17,0.0,Phase3-EA-T1v2-EURJPY-M15-322,EURJPYMT4,132,9h 59m,Sell
38765.0,1.52013,07.04.2009 13:15:00,,0.0,-314.76000000002387,0.0,0.0,1.51764,07.04.2009 04:30:00,3291,-0.2438492293447277,73.84,IS,0.34,0.0,Phase3-EA-S4v1-EURCHF-M15-221,EURCHFMT4,888,8h 45m,Buy
38856.73,100693,08.04.2009 01:30:00,,-0.78,-223.03000000002794,0.0,0.0,100348,07.04.2009 20:30:00,3292,-0.1727846410622611,91.73,IS,0.27,0.0,Phase3-EA-S1v2-USDJPY-M15-0,USDJPYMT4,1232,5h 0m,Buy
38946.0,148012,08.04.2009 03:09:58,tp 148.012,0.0,-133.76000000002387,0.0,0.0,148402,08.04.2009 01:40:00,3293,-0.10362585117916547,89.27,IS,0.23,0.0,Phase3-EA-S4v1-GBPJPY-M5-194,GBPJPYMT4,892,1h 29m,Sell
39035.31,148.01,08.04.2009 03:49:57,tp 148.010,0.0,-44.45000000002619,0.0,0.0,147.62,08.04.2009 03:45:00,3294,-0.03443607270421499,89.31,IS,0.23,0.0,Phase3-EA-S4v1-GBPJPY-M5-194,GBPJPYMT4,894,4m 57s,Buy
38996.38,132901,08.04.2009 03:59:57,sl 132.901,0.0,-83.38000000001921,0.0,0.0,132671,08.04.2009 03:30:00,3295,-0.06459571973175288,-38.93,IS,0.17,0.0,Phase3-EA-T1v2-EURJPY-M15-322,EURJPYMT4,134,29m 57s,Sell
38926.02,132556,08.04.2009 03:59:57,sl 132.556,-0.44,-153.7400000000198,0.0,0.0,133336,07.04.2009 17:30:00,3296,-0.11910465281312879,-70.36,IS,0.09,0.0,Phase3-EA-TR1v1-EURJPY-M30-91,EURJPYMT4,188,10h 29m,Buy
38842.86,1.51421,08.04.2009 04:25:00,,-0.86,-236.90000000002328,0.0,0.0,1.51651,07.04.2009 20:05:00,3297,-0.18352993528964062,-83.16,IS,0.41,0.0,Phase3-EA-SA2v2-EURCHF-M5-43,EURCHFMT4,1910,8h 20m,Buy
38909.21,1.51668,08.04.2009 13:15:00,,0.0,-170.55000000001746,0.0,0.0,1.51444,08.04.2009 04:30:00,3298,-0.1321276085422049,66.35,IS,0.34,0.0,Phase3-EA-S4v1-EURCHF-M15-221,EURCHFMT4,890,8h 45m,Buy
38948.47,1.52158,08.04.2009 22:49:57,tp 1.52158,0.0,-131.2900000000227,0.0,0.0,1.52048,08.04.2009 21:30:00,3299,-0.10171230563182236,39.26,IS,0.41,0.0,Phase3-EA-SA2v2-EURCHF-M5-43,EURCHFMT4,1912,1h 19m,Buy
38909.24,132238,08.04.2009 23:29:58,sl 132.238,0.0,-170.52000000001863,0.0,0.0,132008,08.04.2009 21:30:00,3300,-0.13210436709831094,-39.23,IS,0.17,0.0,Phase3-EA-T1v2-EURJPY-M15-322,EURJPYMT4,136,1h 59m,Sell
38809.64,99671,09.04.2009 01:45:00,,-2.35,-270.12000000002445,0.0,0.0,100.03,08.04.2009 17:30:00,3301,-0.2092659608291994,-99.6,IS,0.27,0.0,Phase3-EA-S1v2-USDJPY-M15-0,USDJPYMT4,1234,8h 15m,Buy
38800.05,1.14883,09.04.2009 06:45:00,,0.0,-279.71000000002095,0.0,0.0,1.14864,09.04.2009 02:30:00,3302,-0.21669547572758202,-9.59,IS,0.58,0.0,Phase3-EA-SA2v2-USDCHF-M15-107,USDCHFMT4,724,4h 15m,Sell
38914.74,133323,09.04.2009 09:59:58,tp 133.323,-1.33,-165.02000000001863,0.0,0.0,132033,08.04.2009 13:30:00,3303,-0.12784343571758944,114.69,IS,0.09,0.0,Phase3-EA-TR1v1-EURJPY-M30-91,EURJPYMT4,190,20h 29m,Buy
38833.72,99971,09.04.2009 12:15:00,,0.0,-246.0400000000227,0.0,0.0,99671,09.04.2009 01:45:00,3304,-0.19061082852960282,-81.02,IS,0.27,0.0,Phase3-EA-S1v2-USDJPY-M15-0,USDJPYMT4,1236,10h 30m,Sell
38639.01,1.16173,10.04.2009 02:29:58,sl 1.16173,0.0,-440.7500000000291,0.0,0.0,1.15783,10.04.2009 02:15:00,3305,-0.34145554655511395,-194.71,IS,0.58,0.0,Phase3-EA-SA2v2-USDCHF-M15-107,USDCHFMT4,726,14m 58s,Sell
38677.97,1.52212,10.04.2009 08:24:58,tp 1.52212,0.0,-401.7900000000227,0.0,0.0,1.52102,10.04.2009 02:25:00,3306,-0.3112726580836709,38.96,IS,0.41,0.0,Phase3-EA-SA2v2-EURCHF-M5-43,EURCHFMT4,1914,5h 59m,Buy
38717.02,1.52241,10.04.2009 23:04:57,tp 1.52241,0.0,-362.7400000000198,0.0,0.0,1.52131,10.04.2009 22:25:00,3307,-0.2810200452805459,39.05,IS,0.41,0.0,Phase3-EA-SA2v2-EURCHF-M5-43,EURCHFMT4,1916,39m 57s,Buy
38766.61,1.15555,13.04.2009 01:14:58,tp 1.15555,-0.6,-313.1500000000233,0.0,0.0,1.15455,10.04.2009 23:30:00,3308,-0.24260193852237058,49.59,IS,0.58,0.0,Phase3-EA-SA2v2-USDCHF-M15-107,USDCHFMT4,728,2d 1h 44m,Buy
38805.59,1.52218,13.04.2009 02:59:57,tp 1.52218,0.0,-274.17000000002736,0.0,0.0,1.52328,13.04.2009 01:00:00,3309,-0.2124035557550057,38.98,IS,0.41,0.0,Phase3-EA-SA2v2-EURCHF-M5-43,EURCHFMT4,1918,1h 59m,Sell
38893.66,146847,13.04.2009 02:59:58,tp 146.847,-1.33,-186.10000000002037,0.0,0.0,147237,10.04.2009 23:50:00,3310,-0.14417442362770158,88.07,IS,0.23,0.0,Phase3-EA-S4v1-GBPJPY-M5-194,GBPJPYMT4,896,2d 3h 9m,Sell
38983.04,146918,13.04.2009 04:04:57,tp 146.918,0.0,-96.72000000001572,0.0,0.0,146528,13.04.2009 03:25:00,3311,-0.07493041511699106,89.38,IS,0.23,0.0,Phase3-EA-S4v1-GBPJPY-M5-194,GBPJPYMT4,898,39m 57s,Buy
38996.91,1.52218,13.04.2009 10:15:00,,0.0,-82.85000000002037,0.0,0.0,1.52265,13.04.2009 01:30:00,3312,-0.06418512088961152,13.87,IS,0.34,0.0,Phase3-EA-S4v1-EURCHF-M15-221,EURCHFMT4,892,8h 45m,Sell
39111.94,133127,13.04.2009 15:29:58,tp 133.127,-0.44,-0.0,0.0,0.0,131837,10.04.2009 10:30:00,3313,-0.0,115.03,IS,0.09,0.0,Phase3-EA-TR1v1-EURJPY-M30-91,EURJPYMT4,192,3d 4h 59m,Buy
39224.81,133483,13.04.2009 15:59:58,tp 133.483,0.0,-0.0,0.0,0.0,132223,13.04.2009 02:30:00,3314,-0.0,112.87,IS,0.09,0.0,Phase3-EA-TR1v1-EURJPY-M30-91,EURJPYMT4,193,13h 29m,Buy
39264.59,1.51533,13.04.2009 21:24:57,tp 1.51533,0.0,-0.0,0.0,0.0,1.51423,13.04.2009 20:10:00,3315,-0.0,39.78,IS,0.41,0.0,Phase3-EA-SA2v2-EURCHF-M5-43,EURCHFMT4,1920,1h 14m,Buy
39315.14,1.13375,14.04.2009 00:44:58,tp 1.13375,-0.61,-0.0,0.0,0.0,1.13275,13.04.2009 22:30:00,3316,-0.0,50.55,IS,0.58,0.0,Phase3-EA-SA2v2-USDCHF-M15-107,USDCHFMT4,730,2h 14m,Buy
39311.63,100049,14.04.2009 01:45:00,,0.0,-3.5099999999947613,0.0,0.0,100036,14.04.2009 00:15:00,3317,-0.0027142993465380494,-3.51,IS,0.27,0.0,Phase3-EA-S1v2-USDJPY-M15-0,USDJPYMT4,1238,1h 30m,Sell
39401.05,148725,14.04.2009 03:49:58,tp 148.725,0.0,-0.0,0.0,0.0,149115,14.04.2009 02:55:00,3318,-0.0,89.42,IS,0.23,0.0,Phase3-EA-S4v1-GBPJPY-M5-194,GBPJPYMT4,900,54m 58s,Sell
39335.96,133096,14.04.2009 04:29:57,sl 133.096,-0.44,-65.08999999999651,0.0,0.0,133816,13.04.2009 21:00:00,3319,-0.050300982874556706,-65.09,IS,0.09,0.0,Phase3-EA-TR1v1-EURJPY-M30-91,EURJPYMT4,196,7h 29m,Buy
39275.31,147992,14.04.2009 05:29:58,sl 147.992,-0.32,-125.73999999999069,0.0,0.0,148662,13.04.2009 20:30:00,3320,-0.0971707725710037,-60.65,IS,0.09,0.0,Phase3-EA-B1v1-GBPJPY-M30-1,GBPJPYMT4,416,8h 59m,Buy
39269.04,1.51383,14.04.2009 10:45:00,,0.0,-132.00999999999476,0.0,0.0,1.51404,14.04.2009 02:00:00,3321,-0.10201617374819978,-6.27,IS,0.34,0.0,Phase3-EA-S4v1-EURCHF-M15-221,EURCHFMT4,894,8h 45m,Buy
39292.11,98898,15.04.2009 00:15:00,,-1.23,-108.93999999998778,0.0,0.0,98987,14.04.2009 23:30:00,3322,-0.0841878794646472,23.07,IS,0.27,0.0,Phase3-EA-S1v2-USDJPY-M15-0,USDJPYMT4,1240,45m 0s,Sell
39324.09,98779,15.04.2009 00:45:00,,0.0,-76.95999999999185,0.0,0.0,98896,15.04.2009 00:15:00,3323,-0.05947401508719745,31.98,IS,0.27,0.0,Phase3-EA-S1v2-USDJPY-M15-0,USDJPYMT4,1242,30m 0s,Sell
39414.81,147093,15.04.2009 03:44:59,tp 147.093,0.0,-0.0,0.0,0.0,147483,15.04.2009 02:10:00,3324,-0.0,90.72,IS,0.23,0.0,Phase3-EA-S4v1-GBPJPY-M5-194,GBPJPYMT4,902,1h 34m,Sell
39460.75,98738,15.04.2009 04:00:00,,0.0,-0.0,0.0,0.0,98906,15.04.2009 01:30:00,3325,-0.0,45.94,IS,0.27,0.0,Phase3-EA-S1v2-USDJPY-M15-0,USDJPYMT4,1244,2h 30m,Sell
39412.75,1.50882,15.04.2009 04:50:00,,-0.86,-48.0,0.0,0.0,1.51013,14.04.2009 20:30:00,3326,-0.0370768746511974,-48.0,IS,0.41,0.0,Phase3-EA-SA2v2-EURCHF-M5-43,EURCHFMT4,1922,8h 20m,Buy
39527.63,130022,15.04.2009 07:29:58,tp 130.022,-0.32,-0.0,0.0,0.0,131282,14.04.2009 20:30:00,3327,-0.0,114.88,IS,0.09,0.0,Phase3-EA-TR1v1-EURJPY-M30-91,EURJPYMT4,198,10h 59m,Sell
39645.01,131746,15.04.2009 13:59:58,tp 131.746,0.0,-0.0,0.0,0.0,130456,15.04.2009 09:00:00,3328,-0.0,117.38,IS,0.09,0.0,Phase3-EA-TR1v1-EURJPY-M30-91,EURJPYMT4,200,4h 59m,Buy
39605.54,130997,15.04.2009 21:14:58,sl 130.997,0.0,-39.470000000001164,0.0,0.0,130767,15.04.2009 21:00:00,3329,-0.030444673497268572,-39.47,IS,0.17,0.0,Phase3-EA-T1v2-EURJPY-M15-322,EURJPYMT4,138,14m 58s,Sell
39644.98,1.51125,15.04.2009 22:49:59,tp 1.51125,0.0,-0.029999999998835847,0.0,0.0,1.51015,15.04.2009 22:05:00,3330,-2.314011160077497E-5,39.44,IS,0.41,0.0,Phase3-EA-SA2v2-EURCHF-M5-43,EURCHFMT4,1924,44m 59s,Buy
39683.82,99419,15.04.2009 23:30:00,,0.0,-0.0,0.0,0.0,99276,15.04.2009 18:15:00,3331,-0.0,38.84,IS,0.27,0.0,Phase3-EA-S1v2-USDJPY-M15-0,USDJPYMT4,1246,5h 15m,Buy
39723.29,1.51041,15.04.2009 23:34:58,tp 1.51041,0.0,-0.0,0.0,0.0,1.51151,15.04.2009 23:10:00,3332,-0.0,39.47,IS,0.41,0.0,Phase3-EA-SA2v2-EURCHF-M5-43,EURCHFMT4,1926,24m 58s,Sell
39681.41,131259,16.04.2009 00:59:58,sl 131.259,-2.52,-41.88000000000466,0.0,0.0,131489,15.04.2009 23:15:00,3333,-0.03228410256940344,-41.88,IS,0.17,0.0,Phase3-EA-T1v2-EURJPY-M15-322,EURJPYMT4,140,1h 44m,Buy
39767.74,148697,16.04.2009 02:04:59,tp 148.697,-4.03,-0.0,0.0,0.0,149087,15.04.2009 23:25:00,3334,-0.0,86.33,IS,0.23,0.0,Phase3-EA-S4v1-GBPJPY-M5-194,GBPJPYMT4,904,2h 39m,Sell
39857.98,149.05,16.04.2009 05:04:57,tp 149.050,0.0,-0.0,0.0,0.0,149.44,16.04.2009 03:30:00,3335,-0.0,90.24,IS,0.23,0.0,Phase3-EA-S4v1-GBPJPY-M5-194,GBPJPYMT4,906,1h 34m,Sell
39881.1,99358,17.04.2009 00:45:00,,-0.79,-0.0,0.0,0.0,99.27,16.04.2009 23:45:00,3336,-0.0,23.12,IS,0.27,0.0,Phase3-EA-S1v2-USDJPY-M15-0,USDJPYMT4,1248,1h 0m,Buy
39971.14,148215,17.04.2009 04:14:57,tp 148.215,0.0,-0.0,0.0,0.0,148605,17.04.2009 02:55:00,3337,-0.0,90.04,IS,0.23,0.0,Phase3-EA-S4v1-GBPJPY-M5-194,GBPJPYMT4,908,1h 19m,Sell
39856.43,1.51656,17.04.2009 10:29:57,sl 1.51656,0.0,-114.7100000000064,0.0,0.0,1.51266,17.04.2009 03:15:00,3338,-0.08825805482663802,-114.71,IS,0.34,0.0,Phase3-EA-S4v1-EURCHF-M15-221,EURCHFMT4,896,7h 14m,Sell
39895.05,1.52016,17.04.2009 21:59:58,tp 1.52016,0.0,-76.09000000001106,0.0,0.0,1.52126,17.04.2009 20:20:00,3339,-0.05854376594681797,38.62,IS,0.41,0.0,Phase3-EA-SA2v2-EURCHF-M5-43,EURCHFMT4,1928,1h 39m,Sell
39932.87,1.52155,20.04.2009 01:04:57,tp 1.52155,-0.84,-38.270000000004075,0.0,0.0,1.52045,17.04.2009 22:10:00,3340,-0.029444998328093528,37.82,IS,0.41,0.0,Phase3-EA-SA2v2-EURCHF-M5-43,EURCHFMT4,1930,2d 2h 54m,Buy
39954.36,99267,20.04.2009 02:15:00,,0.0,-16.779999999998836,0.0,0.0,99188,20.04.2009 01:00:00,3341,-0.01291055845166769,21.49,IS,0.27,0.0,Phase3-EA-S1v2-USDJPY-M15-0,USDJPYMT4,1250,1h 15m,Buy
40068.78,127749,20.04.2009 12:59:58,tp 127.749,-0.32,-0.0,0.0,0.0,129009,17.04.2009 18:30:00,3342,-0.0,114.42,IS,0.09,0.0,Phase3-EA-TR1v1-EURJPY-M30-91,EURJPYMT4,202,2d 18h 29m,Sell
40001.66,1.51723,20.04.2009 13:45:00,,0.0,-67.11999999999534,0.0,0.0,1.51954,20.04.2009 05:00:00,3343,-0.05160346702721083,-67.12,IS,0.34,0.0,Phase3-EA-S4v1-EURCHF-M15-221,EURCHFMT4,898,8h 45m,Buy
39940.36,143.79,20.04.2009 16:29:58,sl 143.790,0.0,-128.41999999999825,0.0,0.0,143.12,20.04.2009 15:30:00,3344,-0.09873237836166246,-61.3,IS,0.09,0.0,Phase3-EA-B1v1-GBPJPY-M30-1,GBPJPYMT4,418,59m 58s,Sell
40234.1,127312,20.04.2009 16:59:58,tp 127.312,0.0,-0.0,0.0,0.0,129012,20.04.2009 03:30:00,3345,-0.0,293.74,IS,0.17,0.0,Phase3-EA-T1v2-EURJPY-M15-322,EURJPYMT4,142,13h 29m,Sell
40283.1,1.16927,21.04.2009 00:29:57,tp 1.16927,-0.6,-0.0,0.0,0.0,1.16827,20.04.2009 22:30:00,3346,-0.0,49.0,IS,0.58,0.0,Phase3-EA-SA2v2-USDCHF-M15-107,USDCHFMT4,732,1h 59m,Buy
40326.74,97756,21.04.2009 03:00:00,,0.0,-0.0,0.0,0.0,97914,21.04.2009 00:15:00,3347,-0.0,43.64,IS,0.27,0.0,Phase3-EA-S1v2-USDJPY-M15-0,USDJPYMT4,1252,2h 45m,Sell
40418.42,142024,21.04.2009 03:39:57,tp 142.024,0.0,-0.0,0.0,0.0,141634,21.04.2009 03:05:00,3348,-0.0,91.68,IS,0.23,0.0,Phase3-EA-S4v1-GBPJPY-M5-194,GBPJPYMT4,910,34m 57s,Buy
40456.13,1.51143,21.04.2009 04:09:58,tp 1.51143,-0.84,-0.0,0.0,0.0,1.51033,20.04.2009 20:35:00,3349,-0.0,37.71,IS,0.41,0.0,Phase3-EA-SA2v2-EURCHF-M5-43,EURCHFMT4,1932,7h 34m,Buy
40431.82,1.16919,21.04.2009 05:00:00,,0.0,-24.30999999999767,0.0,0.0,1.1687,21.04.2009 00:45:00,3350,-0.01863461686315368,-24.31,IS,0.58,0.0,Phase3-EA-SA2v2-USDCHF-M15-107,USDCHFMT4,734,4h 15m,Sell
40369.88,143204,21.04.2009 07:59:57,sl 143.204,-0.53,-86.25,0.0,0.0,142534,20.04.2009 19:30:00,3351,-0.06611417953299707,-61.94,IS,0.09,0.0,Phase3-EA-B1v1-GBPJPY-M30-1,GBPJPYMT4,420,12h 29m,Sell
40303.56,127386,21.04.2009 07:59:58,sl 127.386,-0.32,-152.57000000000698,0.0,0.0,126666,20.04.2009 19:30:00,3352,-0.11695119271130232,-66.32,IS,0.09,0.0,Phase3-EA-TR1v1-EURJPY-M30-91,EURJPYMT4,204,12h 29m,Sell
40261.56,1.45363,21.04.2009 09:29:58,sl 1.45363,0.0,-194.57000000000698,0.0,0.0,1.45663,21.04.2009 08:00:00,3353,-0.149145923614327,-42.0,IS,0.14,0.0,Phase3-EA-B1v1-GBPUSD-M30-14,GBPUSDMT4,214,1h 29m,Buy
40200.18,142674,21.04.2009 09:59:57,sl 142.674,0.0,-255.95000000001164,0.0,0.0,143344,21.04.2009 09:00:00,3354,-0.19619622320546518,-61.38,IS,0.09,0.0,Phase3-EA-B1v1-GBPJPY-M30-1,GBPJPYMT4,422,59m 57s,Buy
40086.73,1.51554,21.04.2009 12:14:58,sl 1.51554,0.0,-369.40000000000873,0.0,0.0,1.51164,21.04.2009 04:30:00,3355,-0.2831603237042284,-113.45,IS,0.34,0.0,Phase3-EA-S4v1-EURCHF-M15-221,EURCHFMT4,900,7h 44m,Sell
40046.93,126992,21.04.2009 13:59:58,sl 126.992,0.0,-409.20000000001164,0.0,0.0,127222,21.04.2009 11:45:00,3356,-0.31366866394090637,-39.8,IS,0.17,0.0,Phase3-EA-T1v2-EURJPY-M15-322,EURJPYMT4,144,2h 14m,Buy
40004.93,1.45408,21.04.2009 13:59:58,sl 1.45408,0.0,-451.20000000001164,0.0,0.0,1.45708,21.04.2009 12:00:00,3357,-0.345863394843931,-42.0,IS,0.14,0.0,Phase3-EA-B1v1-GBPUSD-M30-14,GBPUSDMT4,216,1h 59m,Buy
40043.52,1.5119,21.04.2009 22:09:58,tp 1.51190,0.0,-412.61000000001513,0.0,0.0,1.5108,21.04.2009 21:10:00,3358,-0.31628256947374983,38.59,IS,0.41,0.0,Phase3-EA-SA2v2-EURCHF-M5-43,EURCHFMT4,1934,59m 58s,Buy
40058.78,1.16727,22.04.2009 02:30:00,,-2.63,-397.3500000000204,0.0,0.0,1.16763,21.04.2009 22:15:00,3359,-0.3045851505789882,15.26,IS,0.58,0.0,Phase3-EA-SA2v2-USDCHF-M15-107,USDCHFMT4,736,4h 15m,Sell
40066.57,127306,22.04.2009 03:15:00,,-0.84,-389.5600000000268,0.0,0.0,127256,21.04.2009 17:45:00,3360,-0.29861379453769404,7.79,IS,0.17,0.0,Phase3-EA-T1v2-EURJPY-M15-322,EURJPYMT4,146,9h 30m,Buy
40087.52,1.51156,22.04.2009 12:15:00,,0.0,-368.6100000000297,0.0,0.0,1.51084,22.04.2009 03:30:00,3361,-0.28255475614678277,20.95,IS,0.34,0.0,Phase3-EA-S4v1-EURCHF-M15-221,EURCHFMT4,902,8h 45m,Buy
39858.42,97816,22.04.2009 12:59:58,sl 97.816,0.0,-597.7100000000355,0.0,0.0,98646,22.04.2009 01:00:00,3362,-0.458169347810667,-229.1,IS,0.27,0.0,Phase3-EA-S1v2-USDJPY-M15-0,USDJPYMT4,1254,11h 59m,Buy
39897.18,1.51341,22.04.2009 21:24:57,tp 1.51341,0.0,-558.9500000000407,0.0,0.0,1.51451,22.04.2009 20:45:00,3363,-0.4284582104344511,38.76,IS,0.41,0.0,Phase3-EA-SA2v2-EURCHF-M5-43,EURCHFMT4,1936,39m 57s,Sell
39935.93,1.51447,22.04.2009 22:29:57,tp 1.51447,0.0,-520.2000000000407,0.0,0.0,1.51557,22.04.2009 21:45:00,3364,-0.398754738470351,38.75,IS,0.41,0.0,Phase3-EA-SA2v2-EURCHF-M5-43,EURCHFMT4,1938,44m 57s,Sell
40014.01,97858,22.04.2009 23:15:00,,0.0,-442.120000000039,0.0,0.0,98141,22.04.2009 18:30:00,3365,-0.3389032006392028,78.08,IS,0.27,0.0,Phase3-EA-S1v2-USDJPY-M15-0,USDJPYMT4,1256,4h 45m,Sell
40103.02,142008,23.04.2009 00:04:58,tp 142.008,-2.53,-353.11000000004424,0.0,0.0,141618,22.04.2009 23:15:00,3366,-0.2706733673611539,89.01,IS,0.23,0.0,Phase3-EA-S4v1-GBPJPY-M5-194,GBPJPYMT4,912,49m 58s,Buy
40139.22,1.51379,23.04.2009 00:19:58,tp 1.51379,-2.54,-316.91000000004715,0.0,0.0,1.51269,22.04.2009 23:15:00,3367,-0.24292457548759674,36.2,IS,0.41,0.0,Phase3-EA-SA2v2-EURCHF-M5-43,EURCHFMT4,1940,1h 4m,Buy
40066.73,128133,23.04.2009 11:29:57,sl 128.133,-0.96,-389.4000000000524,0.0,0.0,127353,22.04.2009 03:30:00,3368,-0.2984911479437974,-72.49,IS,0.09,0.0,Phase3-EA-TR1v1-EURJPY-M30-91,EURJPYMT4,206,1d 7h 59m,Sell
40119.02,127847,23.04.2009 18:45:00,,0.0,-337.1100000000588,0.0,0.0,127546,23.04.2009 08:45:00,3369,-0.2584087079695366,52.29,IS,0.17,0.0,Phase3-EA-T1v2-EURJPY-M15-322,EURJPYMT4,148,10h 0m,Buy
40158.06,1.51131,23.04.2009 20:54:58,tp 1.51131,0.0,-298.0700000000652,0.0,0.0,1.51241,23.04.2009 20:20:00,3370,-0.2284829390539681,39.04,IS,0.41,0.0,Phase3-EA-SA2v2-EURCHF-M5-43,EURCHFMT4,1942,34m 58s,Sell
40118.1,128143,23.04.2009 22:14:58,sl 128.143,0.0,-338.0300000000716,0.0,0.0,128373,23.04.2009 21:00:00,3371,-0.25911392588456506,-39.96,IS,0.17,0.0,Phase3-EA-T1v2-EURJPY-M15-322,EURJPYMT4,150,1h 14m,Buy
40046.31,128704,23.04.2009 22:59:58,sl 128.704,0.0,-409.8200000000652,0.0,0.0,127924,23.04.2009 17:30:00,3372,-0.31414391949237297,-71.79,IS,0.09,0.0,Phase3-EA-TR1v1-EURJPY-M30-91,EURJPYMT4,208,5h 29m,Sell
39975.22,97991,23.04.2009 23:45:00,,0.0,-480.9100000000617,0.0,0.0,98249,23.04.2009 17:00:00,3373,-0.36863733425179945,-71.09,IS,0.27,0.0,Phase3-EA-S1v2-USDJPY-M15-0,USDJPYMT4,1258,6h 45m,Buy
40036.67,97764,24.04.2009 03:15:00,,-1.24,-419.4600000000646,0.0,0.0,97991,23.04.2009 23:45:00,3374,-0.32153337677582866,61.45,IS,0.27,0.0,Phase3-EA-S1v2-USDJPY-M15-0,USDJPYMT4,1260,3h 30m,Sell
39847.44,142724,24.04.2009 05:19:58,sl 142.724,0.0,-608.6900000000605,0.0,0.0,143524,24.04.2009 03:10:00,3375,-0.4665859703181912,-189.23,IS,0.23,0.0,Phase3-EA-S4v1-GBPJPY-M5-194,GBPJPYMT4,914,2h 9m,Buy
39775.1,129156,24.04.2009 16:59:58,sl 129.156,0.0,-681.030000000057,0.0,0.0,128376,24.04.2009 03:30:00,3376,-0.5220375615925886,-72.34,IS,0.09,0.0,Phase3-EA-TR1v1-EURJPY-M30-91,EURJPYMT4,210,13h 29m,Sell
39584.86,141051,27.04.2009 06:44:57,sl 141.051,0.0,-871.2700000000623,0.0,0.0,141851,27.04.2009 01:20:00,3377,-0.6678643617590548,-190.24,IS,0.23,0.0,Phase3-EA-S4v1-GBPJPY-M5-194,GBPJPYMT4,916,5h 24m,Buy
39695.8,1.50869,27.04.2009 11:45:00,,0.0,-760.33000000006,0.0,0.0,1.50495,27.04.2009 03:00:00,3378,-0.5828242797023493,110.94,IS,0.34,0.0,Phase3-EA-S4v1-EURCHF-M15-221,EURCHFMT4,904,8h 45m,Buy
39633.35,140934,27.04.2009 15:29:58,sl 140.934,0.0,-822.780000000057,0.0,0.0,140264,27.04.2009 12:30:00,3379,-0.6306947783902969,-62.45,IS,0.09,0.0,Phase3-EA-B1v1-GBPJPY-M30-1,GBPJPYMT4,424,2h 59m,Sell
39672.29,1.50649,27.04.2009 21:09:58,tp 1.50649,0.0,-783.8400000000547,0.0,0.0,1.50759,27.04.2009 20:35:00,3380,-0.6008456635959194,38.94,IS,0.41,0.0,Phase3-EA-SA2v2-EURCHF-M5-43,EURCHFMT4,1944,34m 58s,Sell
39598.94,125.4,28.04.2009 02:59:57,sl 125.400,-0.46,-857.1900000000605,0.0,0.0,126.18,27.04.2009 23:30:00,3381,-0.6570714614944204,-73.35,IS,0.09,0.0,Phase3-EA-TR1v1-EURJPY-M30-91,EURJPYMT4,212,3h 29m,Buy
39407.71,140263,28.04.2009 06:24:57,sl 140.263,0.0,-1048.4200000000565,0.0,0.0,141063,28.04.2009 01:55:00,3382,-0.8036571374607365,-191.23,IS,0.23,0.0,Phase3-EA-S4v1-GBPJPY-M5-194,GBPJPYMT4,918,4h 29m,Buy
39416.21,1.50592,28.04.2009 08:55:00,,0.0,-1039.9200000000565,0.0,0.0,1.50568,28.04.2009 00:35:00,3383,-0.7971415371589339,8.5,IS,0.41,0.0,Phase3-EA-SA2v2-EURCHF-M5-43,EURCHFMT4,1946,8h 20m,Buy
39343.04,124627,28.04.2009 09:29:57,sl 124.627,0.0,-1113.0900000000547,0.0,0.0,125407,28.04.2009 07:00:00,3384,-0.8532293576392734,-73.17,IS,0.09,0.0,Phase3-EA-TR1v1-EURJPY-M30-91,EURJPYMT4,214,2h 29m,Buy
39301.33,1.50369,28.04.2009 15:15:00,,0.0,-1154.8000000000611,0.0,0.0,1.50511,28.04.2009 06:30:00,3385,-0.8852017915908297,-41.71,IS,0.34,0.0,Phase3-EA-S4v1-EURCHF-M15-221,EURCHFMT4,906,8h 45m,Buy
39421.66,126339,28.04.2009 17:29:57,tp 126.339,0.0,-1034.4700000000594,0.0,0.0,125049,28.04.2009 11:30:00,3386,-0.7929638875536626,120.33,IS,0.09,0.0,Phase3-EA-TR1v1-EURJPY-M30-91,EURJPYMT4,216,5h 59m,Buy
39455.81,96542,29.04.2009 02:00:00,,-0.81,-1000.3200000000652,0.0,0.0,96417,28.04.2009 22:00:00,3387,-0.7667865051646602,34.15,IS,0.27,0.0,Phase3-EA-S1v2-USDJPY-M15-0,USDJPYMT4,1262,4h 0m,Buy
39506.57,1.14258,29.04.2009 03:29:58,tp 1.14258,0.0,-949.5600000000704,0.0,0.0,1.14358,29.04.2009 02:45:00,3388,-0.7278768732447229,50.76,IS,0.58,0.0,Phase3-EA-SA2v2-USDCHF-M15-107,USDCHFMT4,738,44m 58s,Sell
39497.46,1.50362,29.04.2009 04:25:00,,-0.86,-958.670000000071,0.0,0.0,1.50385,28.04.2009 20:05:00,3389,-0.7348600636858319,-9.11,IS,0.41,0.0,Phase3-EA-SA2v2-EURCHF-M5-43,EURCHFMT4,1948,8h 20m,Buy
39307.82,142602,29.04.2009 06:19:57,sl 142.602,0.0,-1148.3100000000704,0.0,0.0,141802,29.04.2009 03:30:00,3390,-0.8802269391251075,-189.64,IS,0.23,0.0,Phase3-EA-S4v1-GBPJPY-M5-194,GBPJPYMT4,920,2h 49m,Sell
39426.94,1.50606,29.04.2009 08:29:58,tp 1.50606,0.0,-1029.190000000075,0.0,0.0,1.50206,29.04.2009 02:30:00,3391,-0.7889165499544374,119.12,IS,0.34,0.0,Phase3-EA-S4v1-EURCHF-M15-221,EURCHFMT4,908,5h 59m,Buy
39543.63,127931,29.04.2009 09:29:58,tp 127.931,-0.46,-912.5000000000728,0.0,0.0,126671,28.04.2009 20:30:00,3392,-0.6994688559288654,116.69,IS,0.09,0.0,Phase3-EA-TR1v1-EURJPY-M30-91,EURJPYMT4,218,12h 59m,Buy
39471.05,128185,29.04.2009 12:29:58,sl 128.185,0.0,-985.0800000000745,0.0,0.0,127405,29.04.2009 10:30:00,3393,-0.7551044170941412,-72.58,IS,0.09,0.0,Phase3-EA-TR1v1-EURJPY-M30-91,EURJPYMT4,220,1h 59m,Sell
39492.49,96953,29.04.2009 19:30:00,,0.0,-963.6400000000722,0.0,0.0,96876,29.04.2009 17:15:00,3394,-0.7386697735093574,21.44,IS,0.27,0.0,Phase3-EA-S1v2-USDJPY-M15-0,USDJPYMT4,1264,2h 15m,Buy
39532.33,1.50867,29.04.2009 21:19:58,tp 1.50867,0.0,-923.8000000000757,0.0,0.0,1.50977,29.04.2009 20:25:00,3395,-0.7081307716242052,39.84,IS,0.41,0.0,Phase3-EA-SA2v2-EURCHF-M5-43,EURCHFMT4,1950,54m 58s,Sell
39572.04,1.50856,29.04.2009 23:49:57,tp 1.50856,0.0,-884.0900000000693,0.0,0.0,1.50746,29.04.2009 22:30:00,3396,-0.6776914200966024,39.71,IS,0.41,0.0,Phase3-EA-SA2v2-EURCHF-M5-43,EURCHFMT4,1952,1h 19m,Buy
39499.06,129917,30.04.2009 03:29:58,sl 129.917,-0.97,-957.0700000000652,0.0,0.0,129137,29.04.2009 23:00:00,3397,-0.7336335977466646,-72.98,IS,0.09,0.0,Phase3-EA-TR1v1-EURJPY-M30-91,EURJPYMT4,222,4h 29m,Sell
39591.28,144014,30.04.2009 07:04:59,tp 144.014,0.0,-864.850000000064,0.0,0.0,144404,30.04.2009 03:30:00,3398,-0.6629431671781653,92.22,IS,0.23,0.0,Phase3-EA-S4v1-GBPJPY-M5-194,GBPJPYMT4,922,3h 34m,Sell
39854.28,1.48601,30.04.2009 09:59:58,tp 1.48601,-1.6,-601.850000000064,0.0,0.0,1.46711,29.04.2009 06:00:00,3399,-0.46134282842827273,263.0,IS,0.14,0.0,Phase3-EA-B1v1-GBPUSD-M30-14,GBPUSDMT4,218,1d 3h 59m,Buy
39782.13,129907,30.04.2009 09:59:58,sl 129.907,0.0,-674.0000000000582,0.0,0.0,129127,30.04.2009 07:30:00,3400,-0.5166487768723927,-72.15,IS,0.09,0.0,Phase3-EA-TR1v1-EURJPY-M30-91,EURJPYMT4,224,2h 29m,Sell
39742.38,129858,30.04.2009 16:29:57,sl 129.858,0.0,-713.7500000000582,0.0,0.0,130088,30.04.2009 09:45:00,3401,-0.5471187900484696,-39.75,IS,0.17,0.0,Phase3-EA-T1v2-EURJPY-M15-322,EURJPYMT4,152,6h 44m,Buy
39671.24,131112,30.04.2009 19:29:58,sl 131.112,0.0,-784.8900000000576,0.0,0.0,130332,30.04.2009 14:00:00,3402,-0.6016505318684972,-71.14,IS,0.09,0.0,Phase3-EA-TR1v1-EURJPY-M30-91,EURJPYMT4,226,5h 29m,Sell
39710.78,1.50904,30.04.2009 22:29:57,tp 1.50904,0.0,-745.350000000064,0.0,0.0,1.51014,30.04.2009 20:20:00,3403,-0.5713414923469403,39.54,IS,0.41,0.0,Phase3-EA-SA2v2-EURCHF-M5-43,EURCHFMT4,1954,2h 9m,Sell
39722.57,98.75,01.05.2009 02:15:00,,-0.79,-733.5600000000704,0.0,0.0,98704,30.04.2009 22:00:00,3404,-0.562303971457739,11.79,IS,0.27,0.0,Phase3-EA-S1v2-USDJPY-M15-0,USDJPYMT4,1266,4h 15m,Buy
39651.23,131249,01.05.2009 03:29:58,sl 131.249,-0.32,-804.9000000000669,0.0,0.0,130469,30.04.2009 23:00:00,3405,-0.6169890215201597,-71.34,IS,0.09,0.0,Phase3-EA-TR1v1-EURJPY-M30-91,EURJPYMT4,228,4h 29m,Sell
39689.95,1.51012,01.05.2009 03:39:57,tp 1.51012,-0.86,-766.1800000000658,0.0,0.0,1.50902,30.04.2009 23:30:00,3406,-0.587308545792418,38.72,IS,0.41,0.0,Phase3-EA-SA2v2-EURCHF-M5-43,EURCHFMT4,1956,4h 9m,Buy
39504.35,146.87,01.05.2009 03:44:57,sl 146.870,0.0,-951.7800000000716,0.0,0.0,146.07,01.05.2009 02:20:00,3407,-0.7295785947353123,-185.6,IS,0.23,0.0,Phase3-EA-S4v1-GBPJPY-M5-194,GBPJPYMT4,924,1h 24m,Sell
39537.85,1.50994,01.05.2009 10:45:00,,0.0,-918.2800000000716,0.0,0.0,1.50882,01.05.2009 02:00:00,3408,-0.7038994641340903,33.5,IS,0.34,0.0,Phase3-EA-S4v1-EURCHF-M15-221,EURCHFMT4,910,8h 45m,Buy
39497.34,99317,01.05.2009 17:15:00,,0.0,-958.7900000000664,0.0,0.0,99466,01.05.2009 17:00:00,3409,-0.7349520486312655,-40.51,IS,0.27,0.0,Phase3-EA-S1v2-USDJPY-M15-0,USDJPYMT4,1268,15m 0s,Buy
39667.0,131778,01.05.2009 19:15:00,,0.0,-789.1300000000629,0.0,0.0,130787,01.05.2009 02:15:00,3410,-0.6049006666072827,169.66,IS,0.17,0.0,Phase3-EA-T1v2-EURJPY-M15-322,EURJPYMT4,154,17h 0m,Buy
39710.97,99481,01.05.2009 20:30:00,,0.0,-745.1600000000617,0.0,0.0,99319,01.05.2009 17:15:00,3411,-0.5711958495166629,43.97,IS,0.27,0.0,Phase3-EA-S1v2-USDJPY-M15-0,USDJPYMT4,1270,3h 15m,Buy
39671.58,131691,01.05.2009 22:14:58,sl 131.691,0.0,-784.5500000000611,0.0,0.0,131921,01.05.2009 20:45:00,3412,-0.6013899078564278,-39.39,IS,0.17,0.0,Phase3-EA-T1v2-EURJPY-M15-322,EURJPYMT4,156,1h 29m,Buy
39710.47,1.5078,04.05.2009 01:04:58,tp 1.50780,-0.87,-745.6600000000617,0.0,0.0,1.5067,01.05.2009 22:05:00,3413,-0.5715791201226513,38.89,IS,0.41,0.0,Phase3-EA-SA2v2-EURCHF-M5-43,EURCHFMT4,1958,2d 2h 59m,Buy
39738.94,1.13688,04.05.2009 02:30:00,,-0.61,-717.1900000000605,0.0,0.0,1.13631,01.05.2009 22:15:00,3414,-0.5497556918176716,28.47,IS,0.58,0.0,Phase3-EA-SA2v2-USDCHF-M15-107,USDCHFMT4,740,2d 4h 15m,Buy
39790.01,1.13569,04.05.2009 03:29:58,tp 1.13569,0.0,-666.1200000000536,0.0,0.0,1.13669,04.05.2009 02:45:00,3415,-0.5106084321220122,51.07,IS,0.58,0.0,Phase3-EA-SA2v2-USDCHF-M15-107,USDCHFMT4,742,44m 58s,Sell
39719.09,132.73,04.05.2009 06:29:57,sl 132.730,-0.32,-737.0400000000518,0.0,0.0,131.95,01.05.2009 15:30:00,3416,-0.564971534875404,-70.92,IS,0.09,0.0,Phase3-EA-TR1v1-EURJPY-M30-91,EURJPYMT4,230,2d 14h 59m,Sell
39616.48,1.51052,04.05.2009 09:35:00,,0.0,-839.6500000000524,0.0,0.0,1.50768,04.05.2009 01:15:00,3417,-0.6436263286363415,-102.61,IS,0.41,0.0,Phase3-EA-SA2v2-EURCHF-M5-43,EURCHFMT4,1960,8h 20m,Sell
39574.48,1.4926,04.05.2009 11:29:58,sl 1.49260,0.0,-881.6500000000524,0.0,0.0,1.4956,04.05.2009 10:00:00,3418,-0.6758210595393662,-42.0,IS,0.14,0.0,Phase3-EA-B1v1-GBPUSD-M30-14,GBPUSDMT4,220,1h 29m,Buy
39589.36,132.12,04.05.2009 12:00:00,,0.0,-866.7700000000477,0.0,0.0,132033,04.05.2009 02:00:00,3419,-0.6644149263051482,14.88,IS,0.17,0.0,Phase3-EA-T1v2-EURJPY-M15-322,EURJPYMT4,158,10h 0m,Buy
39573.23,1.50979,04.05.2009 12:45:00,,0.0,-882.9000000000524,0.0,0.0,1.50925,04.05.2009 04:00:00,3420,-0.6767792360543372,-16.13,IS,0.34,0.0,Phase3-EA-S4v1-EURCHF-M15-221,EURCHFMT4,912,8h 45m,Sell
39533.87,132435,04.05.2009 18:44:58,sl 132.435,0.0,-922.260000000053,0.0,0.0,132665,04.05.2009 17:30:00,3421,-0.7069502981577436,-39.36,IS,0.17,0.0,Phase3-EA-T1v2-EURJPY-M15-322,EURJPYMT4,160,1h 14m,Buy
39557.36,98835,05.05.2009 01:30:00,,0.0,-898.7700000000477,0.0,0.0,98921,05.05.2009 00:45:00,3422,-0.688944245088405,23.49,IS,0.27,0.0,Phase3-EA-S1v2-USDJPY-M15-0,USDJPYMT4,1272,45m 0s,Sell
39560.91,98.82,05.05.2009 02:00:00,,0.0,-895.2200000000448,0.0,0.0,98833,05.05.2009 01:30:00,3423,-0.6862230237858853,3.55,IS,0.27,0.0,Phase3-EA-S1v2-USDJPY-M15-0,USDJPYMT4,1274,30m 0s,Sell
39612.39,1.12669,05.05.2009 02:44:57,tp 1.12669,0.0,-843.7400000000489,0.0,0.0,1.12569,05.05.2009 01:15:00,3424,-0.6467614821933239,51.48,IS,0.58,0.0,Phase3-EA-SA2v2-USDCHF-M15-107,USDCHFMT4,744,1h 29m,Buy
39703.11,148.27,05.05.2009 03:49:58,tp 148.270,0.0,-753.0200000000477,0.0,0.0,148.66,05.05.2009 00:45:00,3425,-0.5772208634427897,90.72,IS,0.23,0.0,Phase3-EA-S4v1-GBPJPY-M5-194,GBPJPYMT4,926,3h 4m,Sell
39535.68,1.12934,05.05.2009 07:00:00,,0.0,-920.4500000000407,0.0,0.0,1.12608,05.05.2009 02:45:00,3426,-0.7055628585640562,-167.43,IS,0.58,0.0,Phase3-EA-SA2v2-USDCHF-M15-107,USDCHFMT4,746,4h 15m,Sell
39573.79,1.50901,05.05.2009 07:19:58,tp 1.50901,-1.82,-882.3400000000402,0.0,0.0,1.51011,04.05.2009 23:55:00,3427,-0.6763499729756208,38.11,IS,0.41,0.0,Phase3-EA-SA2v2-EURCHF-M5-43,EURCHFMT4,1962,7h 24m,Sell
39520.72,1.51255,05.05.2009 10:30:00,,0.0,-935.4100000000471,0.0,0.0,1.51078,05.05.2009 01:45:00,3428,-0.7170303150952337,-53.07,IS,0.34,0.0,Phase3-EA-S4v1-EURCHF-M15-221,EURCHFMT4,914,8h 45m,Sell
39481.23,132416,05.05.2009 14:44:58,sl 132.416,0.0,-974.9000000000524,0.0,0.0,132646,05.05.2009 12:15:00,3429,-0.7473010275562006,-39.49,IS,0.17,0.0,Phase3-EA-T1v2-EURJPY-M15-322,EURJPYMT4,162,2h 29m,Buy
39745.3,1.51539,05.05.2009 15:59:57,tp 1.51539,-0.53,-710.8300000000454,0.0,0.0,1.49649,04.05.2009 17:30:00,3430,-0.5448804897094877,264.07,IS,0.14,0.0,Phase3-EA-B1v1-GBPUSD-M30-14,GBPUSDMT4,222,22h 29m,Buy
39705.75,132094,05.05.2009 18:29:57,sl 132.094,0.0,-750.3800000000483,0.0,0.0,131864,05.05.2009 17:45:00,3431,-0.5751971946431714,-39.55,IS,0.17,0.0,Phase3-EA-T1v2-EURJPY-M15-322,EURJPYMT4,164,44m 57s,Sell
39745.53,1.51043,05.05.2009 22:44:57,tp 1.51043,0.0,-710.6000000000495,0.0,0.0,1.50933,05.05.2009 20:30:00,3432,-0.5447041852307362,39.78,IS,0.41,0.0,Phase3-EA-SA2v2-EURCHF-M5-43,EURCHFMT4,1964,2h 14m,Buy
39756.6,98782,06.05.2009 02:30:00,,-1.23,-699.5300000000425,0.0,0.0,98827,05.05.2009 20:15:00,3433,-0.5362185740141479,11.07,IS,0.27,0.0,Phase3-EA-S1v2-USDJPY-M15-0,USDJPYMT4,1276,6h 15m,Sell
39873.47,131198,06.05.2009 03:29:58,tp 131.198,-0.64,-582.6600000000471,0.0,0.0,132488,04.05.2009 10:00:00,3434,-0.4466329025704254,116.87,IS,0.09,0.0,Phase3-EA-TR1v1-EURJPY-M30-91,EURJPYMT4,232,1d 17h 29m,Sell
39686.76,147.89,06.05.2009 04:19:57,sl 147.890,0.0,-769.3700000000536,0.0,0.0,148.69,06.05.2009 02:25:00,3435,-0.5897538122586145,-186.71,IS,0.23,0.0,Phase3-EA-S4v1-GBPJPY-M5-194,GBPJPYMT4,928,1h 54m,Buy
39726.51,1.5098,06.05.2009 10:14:58,tp 1.50980,0.0,-729.6200000000536,0.0,0.0,1.5087,06.05.2009 02:30:00,3436,-0.5592837990825376,39.75,IS,0.41,0.0,Phase3-EA-SA2v2-EURCHF-M5-43,EURCHFMT4,1966,7h 44m,Buy
39660.76,131183,06.05.2009 11:29:58,sl 131.183,0.0,-795.3700000000536,0.0,0.0,130463,06.05.2009 05:30:00,3437,-0.6096838837700107,-65.75,IS,0.09,0.0,Phase3-EA-TR1v1-EURJPY-M30-91,EURJPYMT4,234,5h 59m,Sell
39618.76,1.50735,06.05.2009 12:29:58,sl 1.50735,0.0,-837.3700000000536,0.0,0.0,1.51035,06.05.2009 11:30:00,3438,-0.6418786146730353,-42.0,IS,0.14,0.0,Phase3-EA-B1v1-GBPUSD-M30-14,GBPUSDMT4,224,59m 58s,Buy
39598.0,98.5,07.05.2009 02:15:00,,-2.39,-858.1300000000483,0.0,0.0,98567,06.05.2009 19:15:00,3439,-0.6577920102336693,-20.76,IS,0.27,0.0,Phase3-EA-S1v2-USDJPY-M15-0,USDJPYMT4,1278,7h 0m,Buy
39558.42,131235,07.05.2009 03:44:57,sl 131.235,0.0,-897.7100000000501,0.0,0.0,131465,07.05.2009 03:15:00,3440,-0.6881317114037114,-39.58,IS,0.17,0.0,Phase3-EA-T1v2-EURJPY-M15-322,EURJPYMT4,166,29m 57s,Buy
39502.16,1.13404,07.05.2009 05:15:00,,0.0,-953.9700000000448,0.0,0.0,1.13294,07.05.2009 01:00:00,3441,-0.7312573199895209,-56.26,IS,0.58,0.0,Phase3-EA-SA2v2-USDCHF-M15-107,USDCHFMT4,748,4h 15m,Sell
39462.45,130992,07.05.2009 07:44:58,sl 130.992,0.0,-993.6800000000512,0.0,0.0,130762,07.05.2009 07:00:00,3442,-0.7616966715171237,-39.71,IS,0.17,0.0,Phase3-EA-T1v2-EURJPY-M15-322,EURJPYMT4,168,44m 58s,Sell
39346.26,1.51293,07.05.2009 11:14:58,sl 1.51293,0.0,-1109.8700000000536,0.0,0.0,1.50903,07.05.2009 03:30:00,3443,-0.8507610949367073,-116.19,IS,0.34,0.0,Phase3-EA-S4v1-EURCHF-M15-221,EURCHFMT4,916,7h 44m,Sell
39386.11,1.51229,07.05.2009 21:29:58,tp 1.51229,0.0,-1070.0200000000477,0.0,0.0,1.51119,07.05.2009 21:00:00,3444,-0.8202144276394282,39.85,IS,0.41,0.0,Phase3-EA-SA2v2-EURCHF-M5-43,EURCHFMT4,1968,29m 58s,Buy
39397.55,99085,07.05.2009 23:45:00,,0.0,-1058.5800000000454,0.0,0.0,99043,07.05.2009 17:00:00,3445,-0.8114451961744121,11.44,IS,0.27,0.0,Phase3-EA-S1v2-USDJPY-M15-0,USDJPYMT4,1280,6h 45m,Buy
39435.6,1.51194,08.05.2009 03:54:58,tp 1.51194,-1.81,-1020.5300000000425,0.0,0.0,1.51304,07.05.2009 23:25:00,3446,-0.7822783030586935,38.05,IS,0.41,0.0,Phase3-EA-SA2v2-EURCHF-M5-43,EURCHFMT4,1970,4h 29m,Sell
39525.96,148758,08.05.2009 04:14:58,tp 148.758,0.0,-930.1700000000419,0.0,0.0,149148,08.05.2009 00:20:00,3447,-0.7130136391444714,90.36,IS,0.23,0.0,Phase3-EA-S4v1-GBPJPY-M5-194,GBPJPYMT4,930,3h 54m,Sell
39454.84,133167,08.05.2009 08:59:58,sl 133.167,-0.32,-1001.2900000000373,0.0,0.0,132387,07.05.2009 22:00:00,3448,-0.7675300501402562,-71.12,IS,0.09,0.0,Phase3-EA-TR1v1-EURJPY-M30-91,EURJPYMT4,236,10h 59m,Sell
39495.56,1.50812,08.05.2009 22:44:57,tp 1.50812,0.0,-960.5700000000361,0.0,0.0,1.50702,08.05.2009 20:50:00,3449,-0.736316491988561,40.72,IS,0.41,0.0,Phase3-EA-SA2v2-EURCHF-M5-43,EURCHFMT4,1972,1h 54m,Buy
39788.25,134472,11.05.2009 01:00:00,tp 134.472,-0.85,-667.8800000000338,0.0,0.0,132772,08.05.2009 08:15:00,3450,-0.5119575446550761,292.69,IS,0.17,0.0,Phase3-EA-T1v2-EURJPY-M15-322,EURJPYMT4,170,2d 16h 45m,Buy
39827.28,1.50671,11.05.2009 01:04:58,tp 1.50671,-1.85,-628.8500000000349,0.0,0.0,1.50781,08.05.2009 23:45:00,3451,-0.4820394411516234,39.03,IS,0.41,0.0,Phase3-EA-SA2v2-EURCHF-M5-43,EURCHFMT4,1974,2d 1h 19m,Sell
39879.77,1105,11.05.2009 01:14:58,tp 1.10500,0.0,-576.3600000000297,0.0,0.0,1104,11.05.2009 01:00:00,3452,-0.4418036929349583,52.49,IS,0.58,0.0,Phase3-EA-SA2v2-USDCHF-M15-107,USDCHFMT4,750,14m 58s,Buy
39818.55,149548,11.05.2009 04:29:57,sl 149.548,0.0,-637.5800000000309,0.0,0.0,150218,11.05.2009 02:30:00,3453,-0.48873134593217754,-61.22,IS,0.09,0.0,Phase3-EA-B1v1-GBPJPY-M30-1,GBPJPYMT4,426,1h 59m,Buy
39854.21,98423,11.05.2009 04:30:00,,0.0,-601.9200000000274,0.0,0.0,98553,11.05.2009 01:15:00,3454,-0.461396486313083,35.66,IS,0.27,0.0,Phase3-EA-S1v2-USDJPY-M15-0,USDJPYMT4,1282,3h 15m,Sell
39859.58,149778,11.05.2009 09:20:00,,0.0,-596.550000000032,0.0,0.0,149755,11.05.2009 03:55:00,3455,-0.45728016000477123,5.37,IS,0.23,0.0,Phase3-EA-S4v1-GBPJPY-M5-194,GBPJPYMT4,932,5h 25m,Buy
39819.95,134163,11.05.2009 10:14:58,sl 134.163,0.0,-636.1800000000367,0.0,0.0,134393,11.05.2009 09:30:00,3456,-0.4876581882354145,-39.63,IS,0.17,0.0,Phase3-EA-T1v2-EURJPY-M15-322,EURJPYMT4,172,44m 58s,Buy
39879.21,1.5082,11.05.2009 10:15:00,,0.0,-576.9200000000419,0.0,0.0,1.50627,11.05.2009 01:30:00,3457,-0.4422329560136747,59.26,IS,0.34,0.0,Phase3-EA-S4v1-EURCHF-M15-221,EURCHFMT4,918,8h 45m,Buy
39813.29,133.57,11.05.2009 11:29:58,sl 133.570,0.0,-642.8400000000402,0.0,0.0,134.29,11.05.2009 01:30:00,3458,-0.4927633527071825,-65.92,IS,0.09,0.0,Phase3-EA-TR1v1-EURJPY-M30-91,EURJPYMT4,238,9h 59m,Buy
39746.75,132953,11.05.2009 17:59:58,sl 132.953,0.0,-709.3800000000338,0.0,0.0,132233,11.05.2009 17:00:00,3459,-0.5437690049521124,-66.54,IS,0.09,0.0,Phase3-EA-TR1v1-EURJPY-M30-91,EURJPYMT4,240,59m 58s,Sell
39794.75,97318,11.05.2009 22:30:00,,0.0,-661.3800000000338,0.0,0.0,97491,11.05.2009 21:00:00,3460,-0.5069750267772271,48.0,IS,0.27,0.0,Phase3-EA-S1v2-USDJPY-M15-0,USDJPYMT4,1284,1h 30m,Sell
39835.39,1.50682,11.05.2009 23:09:57,tp 1.50682,0.0,-620.7400000000343,0.0,0.0,1.50792,11.05.2009 20:40:00,3461,-0.4758227919224913,40.64,IS,0.41,0.0,Phase3-EA-SA2v2-EURCHF-M5-43,EURCHFMT4,1976,2h 29m,Sell
39860.39,1.50737,12.05.2009 07:40:00,,-0.89,-595.7400000000343,0.0,0.0,1.50667,11.05.2009 23:20:00,3462,-0.45665926162307185,25.0,IS,0.41,0.0,Phase3-EA-SA2v2-EURCHF-M5-43,EURCHFMT4,1978,8h 20m,Buy
39820.22,132479,12.05.2009 08:44:58,sl 132.479,0.0,-635.9100000000326,0.0,0.0,132249,12.05.2009 08:00:00,3463,-0.48745122210817765,-40.17,IS,0.17,0.0,Phase3-EA-T1v2-EURJPY-M15-322,EURJPYMT4,174,44m 58s,Sell
39753.37,133226,12.05.2009 10:59:58,sl 133.226,-0.32,-702.7600000000384,0.0,0.0,132506,11.05.2009 20:30:00,3464,-0.5386945021288297,-66.85,IS,0.09,0.0,Phase3-EA-TR1v1-EURJPY-M30-91,EURJPYMT4,242,14h 29m,Sell
39845.64,96125,13.05.2009 02:30:00,,-1.26,-610.4900000000343,0.0,0.0,96458,12.05.2009 22:30:00,3465,-0.46796574449972933,92.27,IS,0.27,0.0,Phase3-EA-S1v2-USDJPY-M15-0,USDJPYMT4,1286,4h 0m,Sell
39884.73,1.50742,13.05.2009 03:14:58,tp 1.50742,-1.85,-571.4000000000378,0.0,0.0,1.50852,12.05.2009 22:10:00,3466,-0.4380016485235598,39.09,IS,0.41,0.0,Phase3-EA-SA2v2-EURCHF-M5-43,EURCHFMT4,1980,5h 4m,Sell
39846.82,1.50613,13.05.2009 13:00:00,,0.0,-609.3100000000413,0.0,0.0,1.50736,13.05.2009 04:15:00,3467,-0.4670612258696021,-37.91,IS,0.34,0.0,Phase3-EA-S4v1-EURCHF-M15-221,EURCHFMT4,920,8h 45m,Buy
39906.5,95919,13.05.2009 18:30:00,,0.0,-549.6300000000483,0.0,0.0,96131,13.05.2009 17:00:00,3468,-0.42131404633883335,59.68,IS,0.27,0.0,Phase3-EA-S1v2-USDJPY-M15-0,USDJPYMT4,1288,1h 30m,Sell
39944.58,1.5055,14.05.2009 00:04:57,tp 1.50550,-2.67,-511.55000000004657,0.0,0.0,1.5044,13.05.2009 23:05:00,3469,-0.3921241569867563,38.08,IS,0.41,0.0,Phase3-EA-SA2v2-EURCHF-M5-43,EURCHFMT4,1982,59m 57s,Buy
39741.04,1.11131,14.05.2009 02:59:58,sl 1.11131,0.0,-715.0900000000402,0.0,0.0,1.10741,14.05.2009 02:30:00,3470,-0.5481459552725048,-203.54,IS,0.58,0.0,Phase3-EA-SA2v2-USDCHF-M15-107,USDCHFMT4,752,29m 58s,Sell
39699.95,129378,14.05.2009 13:59:58,sl 129.378,0.0,-756.1800000000367,0.0,0.0,129148,14.05.2009 13:30:00,3471,-0.5796431336726279,-41.09,IS,0.17,0.0,Phase3-EA-T1v2-EURJPY-M15-322,EURJPYMT4,176,29m 58s,Sell
39767.03,95792,14.05.2009 21:45:00,,0.0,-689.1000000000349,0.0,0.0,95554,14.05.2009 20:00:00,3472,-0.5282235491732242,67.08,IS,0.27,0.0,Phase3-EA-S1v2-USDJPY-M15-0,USDJPYMT4,1290,1h 45m,Buy
39888.41,130914,14.05.2009 21:59:57,tp 130.914,0.0,-567.7200000000303,0.0,0.0,129624,14.05.2009 05:00:00,3473,-0.4351807768634794,121.38,IS,0.09,0.0,Phase3-EA-TR1v1-EURJPY-M30-91,EURJPYMT4,244,16h 59m,Buy
39940.93,1.10425,14.05.2009 22:59:58,tp 1.10425,0.0,-515.2000000000262,0.0,0.0,1.10325,14.05.2009 22:00:00,3474,-0.3949220324104559,52.52,IS,0.58,0.0,Phase3-EA-SA2v2-USDCHF-M15-107,USDCHFMT4,754,59m 58s,Buy
40034.42,145971,15.05.2009 04:09:57,tp 145.971,0.0,-421.71000000002095,0.0,0.0,146361,15.05.2009 01:45:00,3475,-0.32325809450274295,93.49,IS,0.23,0.0,Phase3-EA-S4v1-GBPJPY-M5-194,GBPJPYMT4,934,2h 24m,Sell
40028.11,1.50644,15.05.2009 06:10:00,,-1.86,-428.0200000000186,0.0,0.0,1.50632,14.05.2009 21:50:00,3476,-0.32809496955031464,-6.31,IS,0.41,0.0,Phase3-EA-SA2v2-EURCHF-M5-43,EURCHFMT4,1984,8h 20m,Sell
39960.53,130206,15.05.2009 09:29:57,sl 130.206,0.0,-495.6000000000204,0.0,0.0,130926,15.05.2009 02:00:00,3477,-0.37989782465570665,-67.58,IS,0.09,0.0,Phase3-EA-TR1v1-EURJPY-M30-91,EURJPYMT4,246,7h 29m,Buy
39918.53,1.51971,15.05.2009 09:59:58,sl 1.51971,0.0,-537.6000000000204,0.0,0.0,1.52271,15.05.2009 08:00:00,3478,-0.4120925555587313,-42.0,IS,0.14,0.0,Phase3-EA-B1v1-GBPUSD-M30-14,GBPUSDMT4,226,1h 59m,Buy
40040.54,128937,15.05.2009 12:29:58,tp 128.937,0.0,-415.5900000000256,0.0,0.0,130227,15.05.2009 09:30:00,3479,-0.31856686228544867,122.01,IS,0.09,0.0,Phase3-EA-TR1v1-EURJPY-M30-91,EURJPYMT4,248,2h 59m,Sell
39972.38,129306,15.05.2009 15:59:58,sl 129.306,0.0,-483.7500000000291,0.0,0.0,128586,15.05.2009 13:30:00,3480,-0.3708143112937885,-68.16,IS,0.09,0.0,Phase3-EA-TR1v1-EURJPY-M30-91,EURJPYMT4,250,2h 29m,Sell
40010.69,1.51235,18.05.2009 01:39:57,tp 1.51235,-1.83,-445.44000000003143,0.0,0.0,1.51345,15.05.2009 21:00:00,3481,-0.34144811746295994,38.31,IS,0.41,0.0,Phase3-EA-SA2v2-EURCHF-M5-43,EURCHFMT4,1986,2d 4h 39m,Sell
40050.85,1.51353,18.05.2009 01:54:58,tp 1.51353,0.0,-405.28000000002794,0.0,0.0,1.51243,18.05.2009 01:40:00,3482,-0.31066382238996987,40.16,IS,0.41,0.0,Phase3-EA-SA2v2-EURCHF-M5-43,EURCHFMT4,1988,14m 58s,Buy
40106.75,94918,18.05.2009 03:15:00,,-1.28,-349.38000000003376,0.0,0.0,95119,15.05.2009 23:00:00,3483,-0.26781416864047247,55.9,IS,0.27,0.0,Phase3-EA-S1v2-USDJPY-M15-0,USDJPYMT4,1292,2d 4h 15m,Sell
40411.77,127.04,18.05.2009 04:59:58,tp 127.040,-0.62,-44.360000000029686,0.0,0.0,128.74,15.05.2009 18:45:00,3484,-0.03400376816331261,305.02,IS,0.17,0.0,Phase3-EA-T1v2-EURJPY-M15-322,EURJPYMT4,178,2d 10h 14m,Sell
40506.3,143893,18.05.2009 08:19:58,tp 143.893,0.0,-0.0,0.0,0.0,143503,18.05.2009 03:35:00,3485,-0.0,94.53,IS,0.23,0.0,Phase3-EA-S4v1-GBPJPY-M5-194,GBPJPYMT4,936,4h 44m,Buy
40538.67,1.51306,18.05.2009 12:30:00,,0.0,-0.0,0.0,0.0,1.51199,18.05.2009 03:45:00,3486,-0.0,32.37,IS,0.34,0.0,Phase3-EA-S4v1-EURCHF-M15-221,EURCHFMT4,922,8h 45m,Buy
40659.86,129.22,18.05.2009 14:59:58,tp 129.220,0.0,-0.0,0.0,0.0,127.93,18.05.2009 08:30:00,3487,-0.0,121.19,IS,0.09,0.0,Phase3-EA-TR1v1-EURJPY-M30-91,EURJPYMT4,252,6h 29m,Buy
40777.6,130353,18.05.2009 19:59:59,tp 130.353,0.0,-0.0,0.0,0.0,129093,18.05.2009 14:30:00,3488,-0.0,117.74,IS,0.09,0.0,Phase3-EA-TR1v1-EURJPY-M30-91,EURJPYMT4,253,5h 29m,Buy
40818.09,1.51109,18.05.2009 23:59:58,tp 1.51109,0.0,-0.0,0.0,0.0,1.50999,18.05.2009 22:55:00,3489,-0.0,40.49,IS,0.41,0.0,Phase3-EA-SA2v2-EURCHF-M5-43,EURCHFMT4,1990,1h 4m,Buy
40911.17,147915,19.05.2009 02:19:57,tp 147.915,0.0,-0.0,0.0,0.0,147525,19.05.2009 00:55:00,3490,-0.0,93.08,IS,0.23,0.0,Phase3-EA-S4v1-GBPJPY-M5-194,GBPJPYMT4,938,1h 24m,Buy
40962.57,1.11502,19.05.2009 02:59:57,tp 1.11502,-0.62,-0.0,0.0,0.0,1.11402,18.05.2009 23:00:00,3491,-0.0,51.4,IS,0.58,0.0,Phase3-EA-SA2v2-USDCHF-M15-107,USDCHFMT4,756,3h 59m,Buy
40729.31,96596,19.05.2009 03:29:57,sl 96.596,-1.26,-233.25999999999476,0.0,0.0,95766,18.05.2009 17:00:00,3492,-0.17811195977598404,-233.26,IS,0.27,0.0,Phase3-EA-S1v2-USDJPY-M15-0,USDJPYMT4,1294,10h 29m,Sell
40688.77,130527,19.05.2009 09:14:58,sl 130.527,0.0,-273.79999999998836,0.0,0.0,130757,19.05.2009 05:45:00,3493,-0.20906736940179824,-40.54,IS,0.17,0.0,Phase3-EA-T1v2-EURJPY-M15-322,EURJPYMT4,180,3h 29m,Buy
40860.68,148861,19.05.2009 09:59:58,tp 148.861,-0.34,-101.88999999998487,0.0,0.0,147011,18.05.2009 19:00:00,3494,-0.07780085561850607,171.91,IS,0.09,0.0,Phase3-EA-B1v1-GBPJPY-M30-1,GBPJPYMT4,428,14h 59m,Buy
40977.73,131681,19.05.2009 12:29:57,tp 131.681,-0.46,-0.0,0.0,0.0,130421,18.05.2009 20:00:00,3495,-0.0,117.05,IS,0.09,0.0,Phase3-EA-TR1v1-EURJPY-M30-91,EURJPYMT4,256,16h 29m,Buy
40858.41,1.51556,19.05.2009 12:44:58,sl 1.51556,0.0,-119.32000000000698,0.0,0.0,1.51166,19.05.2009 06:45:00,3496,-0.0910994563732377,-119.32,IS,0.34,0.0,Phase3-EA-S4v1-EURCHF-M15-221,EURCHFMT4,924,5h 59m,Sell
40795.62,148107,19.05.2009 16:29:57,sl 148.107,0.0,-182.11000000000058,0.0,0.0,148777,19.05.2009 10:00:00,3497,-0.13903890378921724,-62.79,IS,0.09,0.0,Phase3-EA-B1v1-GBPJPY-M30-1,GBPJPYMT4,430,6h 29m,Buy
40754.93,130967,19.05.2009 22:59:58,sl 130.967,0.0,-222.8000000000029,0.0,0.0,131197,19.05.2009 21:45:00,3498,-0.17010525377100602,-40.69,IS,0.17,0.0,Phase3-EA-T1v2-EURJPY-M15-322,EURJPYMT4,182,1h 14m,Buy
40807.26,1.10832,19.05.2009 22:59:59,tp 1.10832,0.0,-170.47000000000116,0.0,0.0,1.10732,19.05.2009 22:15:00,3499,-0.13015189681482592,52.33,IS,0.58,0.0,Phase3-EA-SA2v2-USDCHF-M15-107,USDCHFMT4,758,44m 59s,Buy
40882.67,95952,19.05.2009 23:30:00,,0.0,-95.05999999999767,0.0,0.0,96.22,19.05.2009 17:15:00,3500,-0.07257722362419759,75.41,IS,0.27,0.0,Phase3-EA-S1v2-USDJPY-M15-0,USDJPYMT4,1296,6h 15m,Sell
40935.01,1.1081,20.05.2009 02:29:57,tp 1.10810,0.0,-42.720000000001164,0.0,0.0,1.1091,20.05.2009 00:30:00,3501,-0.03261623178230467,52.34,IS,0.58,0.0,Phase3-EA-SA2v2-USDCHF-M15-107,USDCHFMT4,760,1h 59m,Sell
41027.46,149018,20.05.2009 02:29:59,tp 149.018,-0.86,-0.0,0.0,0.0,148628,19.05.2009 23:20:00,3502,-0.0,92.45,IS,0.23,0.0,Phase3-EA-S4v1-GBPJPY-M5-194,GBPJPYMT4,940,3h 9m,Buy
41120.79,148612,20.05.2009 03:09:59,tp 148.612,0.0,-0.0,0.0,0.0,149002,20.05.2009 02:35:00,3503,-0.0,93.33,IS,0.23,0.0,Phase3-EA-S4v1-GBPJPY-M5-194,GBPJPYMT4,942,34m 59s,Sell
41060.4,1.51148,20.05.2009 04:25:00,,-0.89,-60.38999999999942,0.0,0.0,1.51309,19.05.2009 20:05:00,3504,-0.04605676948712669,-60.39,IS,0.41,0.0,Phase3-EA-SA2v2-EURCHF-M5-43,EURCHFMT4,1992,8h 20m,Buy
41181.32,129998,20.05.2009 05:29:58,tp 129.998,-0.33,-0.0,0.0,0.0,131288,19.05.2009 13:30:00,3505,-0.0,120.92,IS,0.09,0.0,Phase3-EA-TR1v1-EURJPY-M30-91,EURJPYMT4,258,15h 59m,Sell
41295.63,94.48,21.05.2009 02:29:57,tp 94.480,0.0,-0.0,0.0,0.0,94.88,21.05.2009 00:15:00,3506,-0.0,114.31,IS,0.27,0.0,Phase3-EA-S1v2-USDJPY-M15-0,USDJPYMT4,1298,2h 14m,Sell
41340.01,1.0993,21.05.2009 02:59:57,tp 1.09930,-8.38,-0.0,0.0,0.0,1.1003,20.05.2009 23:15:00,3507,-0.0,44.38,IS,0.58,0.0,Phase3-EA-SA2v2-USDCHF-M15-107,USDCHFMT4,762,3h 44m,Sell
41378.39,1.51674,21.05.2009 05:44:57,tp 1.51674,-2.68,-0.0,0.0,0.0,1.51564,20.05.2009 23:15:00,3508,-0.0,38.38,IS,0.41,0.0,Phase3-EA-SA2v2-EURCHF-M5-43,EURCHFMT4,1994,6h 29m,Buy
41330.19,148882,21.05.2009 07:55:00,,0.0,-48.20000000001164,0.0,0.0,149.08,21.05.2009 02:30:00,3509,-0.0366879210500385,-48.2,IS,0.23,0.0,Phase3-EA-S4v1-GBPJPY-M5-194,GBPJPYMT4,944,5h 25m,Buy
41288.92,130336,21.05.2009 16:44:58,sl 130.336,0.0,-89.47000000000116,0.0,0.0,130106,21.05.2009 16:15:00,3510,-0.0681010019988837,-41.27,IS,0.17,0.0,Phase3-EA-T1v2-EURJPY-M15-322,EURJPYMT4,184,29m 58s,Sell
41330.12,1.5191,21.05.2009 20:54:58,tp 1.51910,0.0,-48.26999999998952,0.0,0.0,1.5202,21.05.2009 20:40:00,3511,-0.036741202263164865,41.2,IS,0.41,0.0,Phase3-EA-SA2v2-EURCHF-M5-43,EURCHFMT4,1996,14m 58s,Sell
41288.71,130858,21.05.2009 21:14:58,sl 130.858,0.0,-89.67999999999302,0.0,0.0,131088,21.05.2009 19:00:00,3512,-0.06826084563830709,-41.41,IS,0.17,0.0,Phase3-EA-T1v2-EURJPY-M15-322,EURJPYMT4,186,2h 14m,Buy
41329.06,1.51975,22.05.2009 00:09:57,tp 1.51975,-0.9,-49.329999999987194,0.0,0.0,1.51865,21.05.2009 23:40:00,3513,-0.03754803206218864,40.35,IS,0.41,0.0,Phase3-EA-SA2v2-EURCHF-M5-43,EURCHFMT4,1998,29m 57s,Buy
41411.67,94132,22.05.2009 02:00:00,,0.0,-0.0,0.0,0.0,94.42,22.05.2009 00:45:00,3514,-0.0,82.61,IS,0.27,0.0,Phase3-EA-S1v2-USDJPY-M15-0,USDJPYMT4,1300,1h 15m,Sell
41370.17,131155,22.05.2009 10:14:58,sl 131.155,0.0,-41.5,0.0,0.0,131385,22.05.2009 09:45:00,3515,-0.03158014809491427,-41.5,IS,0.17,0.0,Phase3-EA-T1v2-EURJPY-M15-322,EURJPYMT4,188,29m 58s,Buy
41367.67,1.52017,22.05.2009 12:45:00,,0.0,-44.0,0.0,0.0,1.52009,22.05.2009 04:00:00,3516,-0.03348256665484887,-2.5,IS,0.34,0.0,Phase3-EA-S4v1-EURCHF-M15-221,EURCHFMT4,926,8h 45m,Sell
41292.98,131725,22.05.2009 16:29:58,sl 131.725,0.0,-118.69000000000233,0.0,0.0,130945,22.05.2009 09:00:00,3517,-0.0903192235514566,-74.69,IS,0.09,0.0,Phase3-EA-TR1v1-EURJPY-M30-91,EURJPYMT4,260,7h 29m,Sell
41346.45,1.08462,25.05.2009 03:14:59,tp 1.08462,0.0,-65.22000000000116,0.0,0.0,1.08362,25.05.2009 02:00:00,3518,-0.0496302953915746,53.47,IS,0.58,0.0,Phase3-EA-SA2v2-USDCHF-M15-107,USDCHFMT4,764,1h 14m,Buy
41277.44,132.11,25.05.2009 05:59:58,sl 132.110,-0.47,-134.23000000001048,0.0,0.0,132.83,22.05.2009 22:30:00,3519,-0.10214465732001625,-69.01,IS,0.09,0.0,Phase3-EA-TR1v1-EURJPY-M30-91,EURJPYMT4,262,2d 7h 29m,Buy
41372.16,150572,25.05.2009 07:54:58,tp 150.572,0.0,-39.51000000000931,0.0,0.0,150182,25.05.2009 03:30:00,3520,-0.030065822921213424,94.72,IS,0.23,0.0,Phase3-EA-S4v1-GBPJPY-M5-194,GBPJPYMT4,946,4h 24m,Buy
41331.03,132804,25.05.2009 10:59:58,sl 132.804,0.0,-80.64000000001397,0.0,0.0,133034,25.05.2009 08:15:00,3521,-0.06136441306926092,-41.13,IS,0.17,0.0,Phase3-EA-T1v2-EURJPY-M15-322,EURJPYMT4,190,2h 44m,Buy
41343.43,94762,26.05.2009 02:30:00,,-1.28,-68.24000000001979,0.0,0.0,94.81,25.05.2009 23:00:00,3522,-0.05192841701198976,12.4,IS,0.27,0.0,Phase3-EA-S1v2-USDJPY-M15-0,USDJPYMT4,1302,3h 30m,Sell
41437.96,151023,26.05.2009 03:14:58,tp 151.023,0.0,-0.0,0.0,0.0,150633,26.05.2009 02:25:00,3523,-0.0,94.53,IS,0.23,0.0,Phase3-EA-S4v1-GBPJPY-M5-194,GBPJPYMT4,948,49m 58s,Buy
41491.54,1.0824,26.05.2009 03:29:57,tp 1.08240,0.0,-0.0,0.0,0.0,1.0834,26.05.2009 02:30:00,3524,-0.0,53.58,IS,0.58,0.0,Phase3-EA-SA2v2-USDCHF-M15-107,USDCHFMT4,766,59m 57s,Sell
41450.34,132879,26.05.2009 03:59:58,sl 132.879,0.0,-41.20000000001164,0.0,0.0,133109,26.05.2009 03:15:00,3525,-0.03133281426319266,-41.2,IS,0.17,0.0,Phase3-EA-T1v2-EURJPY-M15-322,EURJPYMT4,192,44m 58s,Buy
41460.54,1.51711,26.05.2009 09:35:00,,0.0,-31.0,0.0,0.0,1.51738,26.05.2009 01:15:00,3526,-0.023575661217444126,10.2,IS,0.41,0.0,Phase3-EA-SA2v2-EURCHF-M5-43,EURCHFMT4,2000,8h 20m,Sell
41723.55,1.59572,26.05.2009 17:59:57,tp 1.59572,-1.59,-0.0,0.0,0.0,1.57682,21.05.2009 19:30:00,3527,-0.0,263.01,IS,0.14,0.0,Phase3-EA-B1v1-GBPUSD-M30-14,GBPUSDMT4,228,4d 22h 29m,Buy
41740.03,95.02,27.05.2009 01:45:00,,0.0,-0.0,0.0,0.0,94962,27.05.2009 00:15:00,3528,-0.0,16.48,IS,0.27,0.0,Phase3-EA-S1v2-USDJPY-M15-0,USDJPYMT4,1304,1h 30m,Buy
41790.73,1.0833,27.05.2009 01:59:57,tp 1.08330,-2.84,-0.0,0.0,0.0,1.0843,26.05.2009 23:45:00,3529,-0.0,50.7,IS,0.58,0.0,Phase3-EA-SA2v2-USDCHF-M15-107,USDCHFMT4,768,2h 14m,Sell
41885.01,151758,27.05.2009 03:49:58,tp 151.758,0.0,-0.0,0.0,0.0,152148,27.05.2009 02:40:00,3530,-0.0,94.28,IS,0.23,0.0,Phase3-EA-S4v1-GBPJPY-M5-194,GBPJPYMT4,950,1h 9m,Sell
41872.17,1.51647,27.05.2009 05:45:00,,-1.89,-12.839999999996508,0.0,0.0,1.51618,26.05.2009 21:25:00,3531,-0.00973575389651676,-12.84,IS,0.41,0.0,Phase3-EA-SA2v2-EURCHF-M5-43,EURCHFMT4,2002,8h 20m,Sell
41831.15,133074,27.05.2009 12:59:59,sl 133.074,0.0,-53.85999999998603,0.0,0.0,133304,27.05.2009 12:00:00,3532,-0.040838606298006175,-41.02,IS,0.17,0.0,Phase3-EA-T1v2-EURJPY-M15-322,EURJPYMT4,194,59m 59s,Buy
41902.41,1.51417,27.05.2009 14:30:00,,0.0,-0.0,0.0,0.0,1.51645,27.05.2009 05:45:00,3533,-0.0,71.26,IS,0.34,0.0,Phase3-EA-S4v1-EURCHF-M15-221,EURCHFMT4,928,8h 45m,Sell
41943.88,1.51177,27.05.2009 22:54:58,tp 1.51177,0.0,-0.0,0.0,0.0,1.51287,27.05.2009 22:00:00,3534,-0.0,41.47,IS,0.41,0.0,Phase3-EA-SA2v2-EURCHF-M5-43,EURCHFMT4,2004,54m 58s,Sell
41736.95,1.0931,27.05.2009 23:59:58,sl 1.09310,0.0,-206.92999999999302,0.0,0.0,1.0892,27.05.2009 23:45:00,3535,-0.15683182880478666,-206.93,IS,0.58,0.0,Phase3-EA-SA2v2-USDCHF-M15-107,USDCHFMT4,770,14m 58s,Sell
41545.84,153258,28.05.2009 07:09:59,sl 153.258,0.0,-398.03999999997905,0.0,0.0,152458,28.05.2009 03:00:00,3536,-0.30167371158099887,-191.11,IS,0.23,0.0,Phase3-EA-S4v1-GBPJPY-M5-194,GBPJPYMT4,952,4h 9m,Sell
41537.14,1.51126,28.05.2009 07:25:00,,-2.7,-406.7399999999907,0.0,0.0,1.51142,27.05.2009 23:05:00,3537,-0.3082674239987417,-8.7,IS,0.41,0.0,Phase3-EA-SA2v2-EURCHF-M5-43,EURCHFMT4,2006,8h 20m,Buy
41468.81,133185,28.05.2009 07:29:57,sl 133.185,-0.99,-475.0699999999779,0.0,0.0,132439,26.05.2009 17:30:00,3538,-0.36005459290721037,-68.33,IS,0.09,0.0,Phase3-EA-TR1v1-EURJPY-M30-91,EURJPYMT4,264,1d 13h 59m,Buy
41587.34,133729,28.05.2009 09:29:58,tp 133.729,-1.85,-356.53999999997905,0.0,0.0,132465,27.05.2009 21:00:00,3539,-0.2702209454504288,118.53,IS,0.09,0.0,Phase3-EA-TR1v1-EURJPY-M30-91,EURJPYMT4,265,12h 29m,Sell
41525.04,153963,28.05.2009 17:29:57,sl 153.963,0.0,-418.8399999999674,0.0,0.0,154633,28.05.2009 12:30:00,3540,-0.3174379895452276,-62.3,IS,0.09,0.0,Phase3-EA-B1v1-GBPJPY-M30-1,GBPJPYMT4,432,4h 59m,Buy
41564.74,1.51129,29.05.2009 00:19:58,tp 1.51129,-1.89,-379.13999999995576,0.0,0.0,1.51239,28.05.2009 21:20:00,3541,-0.2873494397769385,39.7,IS,0.41,0.0,Phase3-EA-SA2v2-EURCHF-M5-43,EURCHFMT4,2008,2h 59m,Sell
41571.19,1.51166,29.05.2009 08:45:00,,0.0,-372.6899999999441,0.0,0.0,1.51149,29.05.2009 00:25:00,3542,-0.2824609978120579,6.45,IS,0.41,0.0,Phase3-EA-SA2v2-EURCHF-M5-43,EURCHFMT4,2010,8h 20m,Buy
41492.43,96.67,29.05.2009 09:15:00,,0.0,-451.44999999995343,0.0,0.0,96952,29.05.2009 01:00:00,3543,-0.34215304264203367,-78.76,IS,0.27,0.0,Phase3-EA-S1v2-USDJPY-M15-0,USDJPYMT4,1306,8h 15m,Buy
41609.29,135497,29.05.2009 09:59:58,tp 135.497,-0.46,-334.5899999999674,0.0,0.0,134237,28.05.2009 10:00:00,3544,-0.2535850848102751,116.86,IS,0.09,0.0,Phase3-EA-TR1v1-EURJPY-M30-91,EURJPYMT4,268,23h 59m,Buy
41734.97,1.51502,29.05.2009 11:59:58,tp 1.51502,0.0,-208.9099999999744,0.0,0.0,1.51102,29.05.2009 05:30:00,3545,-0.1583324668032913,125.68,IS,0.34,0.0,Phase3-EA-S4v1-EURCHF-M15-221,EURCHFMT4,930,6h 29m,Buy
41694.31,134793,29.05.2009 12:29:58,sl 134.793,0.0,-249.56999999997788,0.0,0.0,135023,29.05.2009 08:30:00,3546,-0.18914859863146213,-40.66,IS,0.17,0.0,Phase3-EA-T1v2-EURJPY-M15-322,EURJPYMT4,196,3h 59m,Buy
41736.56,1.50965,01.06.2009 04:49:58,tp 1.50965,0.0,-207.31999999997788,0.0,0.0,1.50855,01.06.2009 01:45:00,3547,-0.15712740901660463,42.25,IS,0.41,0.0,Phase3-EA-SA2v2-EURCHF-M5-43,EURCHFMT4,2012,3h 4m,Buy
41801.99,96362,02.06.2009 02:15:00,,-1.26,-141.88999999998487,0.0,0.0,96.6,01.06.2009 22:15:00,3548,-0.10753814424737619,65.43,IS,0.27,0.0,Phase3-EA-S1v2-USDJPY-M15-0,USDJPYMT4,1308,4h 0m,Sell
41856.17,1.07042,02.06.2009 03:14:59,tp 1.07042,0.0,-87.70999999999185,0.0,0.0,1.06942,02.06.2009 02:30:00,3549,-0.06647523174245892,54.18,IS,0.58,0.0,Phase3-EA-SA2v2-USDCHF-M15-107,USDCHFMT4,772,44m 59s,Buy
41788.32,136396,02.06.2009 03:29:58,sl 136.396,-0.46,-155.55999999999767,0.0,0.0,137116,01.06.2009 18:30:00,3550,-0.11789860962099778,-67.85,IS,0.09,0.0,Phase3-EA-TR1v1-EURJPY-M30-91,EURJPYMT4,270,8h 59m,Buy
41597.1,157.72,02.06.2009 03:34:57,sl 157.720,0.0,-346.77999999999884,0.0,0.0,158.52,02.06.2009 02:25:00,3551,-0.26282386117491696,-191.22,IS,0.23,0.0,Phase3-EA-S4v1-GBPJPY-M5-194,GBPJPYMT4,954,1h 9m,Buy
41547.17,1.51503,02.06.2009 05:10:00,,-0.92,-396.70999999999185,0.0,0.0,1.51631,01.06.2009 20:50:00,3552,-0.30066570726887226,-49.93,IS,0.41,0.0,Phase3-EA-SA2v2-EURCHF-M5-43,EURCHFMT4,2014,8h 20m,Buy
41528.37,1.51379,02.06.2009 13:15:00,,0.0,-415.5099999999802,0.0,0.0,1.51438,02.06.2009 04:30:00,3553,-0.3149141892750012,-18.8,IS,0.34,0.0,Phase3-EA-S4v1-EURCHF-M15-221,EURCHFMT4,932,8h 45m,Buy
41454.98,136911,02.06.2009 17:29:57,sl 136.911,0.0,-488.8999999999942,0.0,0.0,136131,02.06.2009 03:30:00,3554,-0.3705363219574826,-73.39,IS,0.09,0.0,Phase3-EA-TR1v1-EURJPY-M30-91,EURJPYMT4,272,13h 59m,Sell
41567.94,95.61,02.06.2009 22:29:57,tp 95.610,0.0,-375.9400000000023,0.0,0.0,96.01,02.06.2009 17:15:00,3555,-0.2849241662440142,112.96,IS,0.27,0.0,Phase3-EA-S1v2-USDJPY-M15-0,USDJPYMT4,1310,5h 14m,Sell
41618.26,95502,03.06.2009 02:30:00,,0.0,-325.61999999999534,0.0,0.0,95.68,03.06.2009 00:30:00,3556,-0.24678673993821884,50.32,IS,0.27,0.0,Phase3-EA-S1v2-USDJPY-M15-0,USDJPYMT4,1312,2h 0m,Sell
41712.11,158414,03.06.2009 03:54:58,tp 158.414,0.0,-231.76999999998952,0.0,0.0,158024,03.06.2009 02:50:00,3557,-0.17565801460438307,93.85,IS,0.23,0.0,Phase3-EA-S4v1-GBPJPY-M5-194,GBPJPYMT4,956,1h 4m,Buy
41691.28,1.51848,03.06.2009 05:30:00,,-1.93,-252.59999999997672,0.0,0.0,1.51799,02.06.2009 21:10:00,3558,-0.1914450295079824,-20.83,IS,0.41,0.0,Phase3-EA-SA2v2-EURCHF-M5-43,EURCHFMT4,2016,8h 20m,Sell
41650.71,136638,03.06.2009 12:14:59,sl 136.638,0.0,-293.1699999999837,0.0,0.0,136868,03.06.2009 07:30:00,3559,-0.22219295051804136,-40.57,IS,0.17,0.0,Phase3-EA-T1v2-EURJPY-M15-322,EURJPYMT4,198,4h 44m,Buy
41692.83,1.51358,03.06.2009 21:34:57,tp 1.51358,0.0,-251.04999999998836,0.0,0.0,1.51248,03.06.2009 21:20:00,3560,-0.1902702876404639,42.12,IS,0.41,0.0,Phase3-EA-SA2v2-EURCHF-M5-43,EURCHFMT4,2018,14m 57s,Buy
41652.07,135941,04.06.2009 01:59:59,sl 135.941,0.0,-291.8099999999977,0.0,0.0,135711,04.06.2009 01:15:00,3561,-0.22116220926654412,-40.76,IS,0.17,0.0,Phase3-EA-T1v2-EURJPY-M15-322,EURJPYMT4,200,44m 59s,Sell
41688.05,96.05,04.06.2009 02:00:00,,0.0,-255.8299999999872,0.0,0.0,95922,04.06.2009 01:00:00,3562,-0.19389303998032145,35.98,IS,0.27,0.0,Phase3-EA-S1v2-USDJPY-M15-0,USDJPYMT4,1314,1h 0m,Buy
41724.52,1.51422,04.06.2009 06:24:58,tp 1.51422,-5.75,-219.35999999998603,0.0,0.0,1.51532,03.06.2009 23:55:00,3563,-0.1662525006843714,36.47,IS,0.41,0.0,Phase3-EA-SA2v2-EURCHF-M5-43,EURCHFMT4,2020,6h 29m,Sell
41817.8,156272,04.06.2009 07:04:58,tp 156.272,0.0,-126.0799999999872,0.0,0.0,156662,04.06.2009 02:10:00,3564,-0.09555577719859934,93.28,IS,0.23,0.0,Phase3-EA-S4v1-GBPJPY-M5-194,GBPJPYMT4,958,4h 54m,Sell
41938.26,137265,04.06.2009 12:29:58,tp 137.265,0.0,-5.619999999995343,0.0,0.0,135975,04.06.2009 02:00:00,3565,-0.004259386642256804,120.46,IS,0.09,0.0,Phase3-EA-TR1v1-EURJPY-M30-91,EURJPYMT4,274,10h 29m,Buy
42013.12,96.66,04.06.2009 21:30:00,,0.0,-0.0,0.0,0.0,96392,04.06.2009 17:00:00,3566,-0.0,74.86,IS,0.27,0.0,Phase3-EA-S1v2-USDJPY-M15-0,USDJPYMT4,1316,4h 30m,Buy
42036.17,1.51537,05.06.2009 04:30:00,,-1.92,-0.0,0.0,0.0,1.51602,04.06.2009 20:10:00,3567,-0.0,23.05,IS,0.41,0.0,Phase3-EA-SA2v2-EURCHF-M5-43,EURCHFMT4,2022,8h 20m,Sell
42096.99,96.77,05.06.2009 04:45:00,,0.0,-0.0,0.0,0.0,96552,05.06.2009 00:15:00,3568,-0.0,60.82,IS,0.27,0.0,Phase3-EA-S1v2-USDJPY-M15-0,USDJPYMT4,1318,4h 30m,Buy
42007.13,155969,05.06.2009 05:30:00,,0.0,-89.85999999998603,0.0,0.0,156347,05.06.2009 00:05:00,3569,-0.06802577409219247,-89.86,IS,0.23,0.0,Phase3-EA-S4v1-GBPJPY-M5-194,GBPJPYMT4,960,5h 25m,Buy
42304.42,138418,05.06.2009 15:44:57,tp 138.418,-0.86,-0.0,0.0,0.0,136718,04.06.2009 19:00:00,3570,-0.0,297.29,IS,0.17,0.0,Phase3-EA-T1v2-EURJPY-M15-322,EURJPYMT4,202,20h 44m,Buy
42232.0,137686,05.06.2009 15:59:57,sl 137.686,0.0,-72.4200000000128,0.0,0.0,136906,05.06.2009 03:00:00,3571,-0.054737400307573125,-72.42,IS,0.09,0.0,Phase3-EA-TR1v1-EURJPY-M30-91,EURJPYMT4,276,12h 59m,Sell
42192.12,137374,05.06.2009 20:14:58,sl 137.374,0.0,-112.30000000001746,0.0,0.0,137604,05.06.2009 19:30:00,3572,-0.08488000627644754,-39.88,IS,0.17,0.0,Phase3-EA-T1v2-EURJPY-M15-322,EURJPYMT4,204,44m 58s,Buy
42233.61,1.51848,05.06.2009 20:29:58,tp 1.51848,0.0,-70.81000000002678,0.0,0.0,1.51958,05.06.2009 20:25:00,3573,-0.053520509745650834,41.49,IS,0.41,0.0,Phase3-EA-SA2v2-EURCHF-M5-43,EURCHFMT4,2024,4m 58s,Sell
42275.02,1.51856,05.06.2009 21:09:58,tp 1.51856,0.0,-29.400000000023283,0.0,0.0,1.51966,05.06.2009 21:05:00,3574,-0.022221479826617506,41.41,IS,0.41,0.0,Phase3-EA-SA2v2-EURCHF-M5-43,EURCHFMT4,2026,4m 58s,Sell
42316.55,1.5178,05.06.2009 23:49:57,tp 1.51780,0.0,-0.0,0.0,0.0,1.5167,05.06.2009 21:45:00,3575,-0.0,41.53,IS,0.41,0.0,Phase3-EA-SA2v2-EURCHF-M5-43,EURCHFMT4,2028,2h 4m,Buy
42326.16,1.51727,08.06.2009 14:30:00,,0.0,-0.0,0.0,0.0,1.51758,08.06.2009 05:45:00,3576,-0.0,9.61,IS,0.34,0.0,Phase3-EA-S4v1-EURCHF-M15-221,EURCHFMT4,934,8h 45m,Sell
42367.48,1.51726,08.06.2009 20:24:58,tp 1.51726,0.0,-0.0,0.0,0.0,1.51836,08.06.2009 20:05:00,3577,-0.0,41.32,IS,0.41,0.0,Phase3-EA-SA2v2-EURCHF-M5-43,EURCHFMT4,2030,19m 58s,Sell
42305.55,156788,09.06.2009 07:29:58,sl 156.788,-0.33,-61.929999999993015,0.0,0.0,157458,08.06.2009 17:30:00,3578,-0.04678641611972447,-61.93,IS,0.09,0.0,Phase3-EA-B1v1-GBPJPY-M30-1,GBPJPYMT4,434,13h 59m,Buy
42569.62,1.61632,09.06.2009 10:29:58,tp 1.61632,-0.53,-0.0,0.0,0.0,1.59742,08.06.2009 17:30:00,3579,-0.0,264.07,IS,0.14,0.0,Phase3-EA-B1v1-GBPUSD-M30-14,GBPUSDMT4,230,16h 59m,Buy
42649.54,97302,09.06.2009 21:30:00,,0.0,-0.0,0.0,0.0,97.59,09.06.2009 20:30:00,3580,-0.0,79.92,IS,0.27,0.0,Phase3-EA-S1v2-USDJPY-M15-0,USDJPYMT4,1320,1h 0m,Sell
42643.44,97322,09.06.2009 21:45:00,,0.0,-6.100000000005821,0.0,0.0,97.3,09.06.2009 21:30:00,3581,-0.0045985836060990675,-6.1,IS,0.27,0.0,Phase3-EA-S1v2-USDJPY-M15-0,USDJPYMT4,1322,15m 0s,Sell
42697.19,1.07902,10.06.2009 02:14:57,tp 1.07902,0.0,-0.0,0.0,0.0,1.07802,10.06.2009 01:30:00,3582,-0.0,53.75,IS,0.58,0.0,Phase3-EA-SA2v2-USDCHF-M15-107,USDCHFMT4,774,44m 57s,Buy
42751.02,1.0775,10.06.2009 03:29:57,tp 1.07750,0.0,-0.0,0.0,0.0,1.0785,10.06.2009 02:15:00,3583,-0.0,53.83,IS,0.58,0.0,Phase3-EA-SA2v2-USDCHF-M15-107,USDCHFMT4,776,1h 14m,Sell
42738.62,136816,10.06.2009 04:45:00,,-0.86,-12.39999999999418,0.0,0.0,136882,09.06.2009 18:45:00,3584,-0.009340794518937925,-12.4,IS,0.17,0.0,Phase3-EA-T1v2-EURJPY-M15-322,EURJPYMT4,206,10h 0m,Buy
42666.63,137468,10.06.2009 06:29:58,sl 137.468,0.0,-84.38999999998487,0.0,0.0,136688,10.06.2009 04:00:00,3585,-0.0635701330204355,-71.99,IS,0.09,0.0,Phase3-EA-TR1v1-EURJPY-M30-91,EURJPYMT4,278,2h 29m,Sell
42696.04,1.51632,10.06.2009 15:00:00,,0.0,-54.97999999998137,0.0,0.0,1.51725,10.06.2009 06:15:00,3586,-0.04141587763316727,29.41,IS,0.34,0.0,Phase3-EA-S4v1-EURCHF-M15-221,EURCHFMT4,936,8h 45m,Sell
42698.81,137181,10.06.2009 18:15:00,,0.0,-52.20999999999185,0.0,0.0,137165,10.06.2009 05:45:00,3587,-0.039329264664024345,2.77,IS,0.17,0.0,Phase3-EA-T1v2-EURJPY-M15-322,EURJPYMT4,208,12h 30m,Buy
42740.53,1.51228,10.06.2009 22:49:57,tp 1.51228,0.0,-10.489999999990687,0.0,0.0,1.51118,10.06.2009 20:00:00,3588,-0.007902010847065955,41.72,IS,0.41,0.0,Phase3-EA-SA2v2-EURCHF-M5-43,EURCHFMT4,2032,2h 49m,Buy
42782.27,1.51094,10.06.2009 23:39:58,tp 1.51094,0.0,-0.0,0.0,0.0,1.51204,10.06.2009 22:50:00,3589,-0.0,41.74,IS,0.41,0.0,Phase3-EA-SA2v2-EURCHF-M5-43,EURCHFMT4,2034,49m 58s,Sell
42833.97,1.08142,11.06.2009 00:14:57,tp 1.08142,-1.93,-0.0,0.0,0.0,1.08042,10.06.2009 23:45:00,3590,-0.0,51.7,IS,0.58,0.0,Phase3-EA-SA2v2-USDCHF-M15-107,USDCHFMT4,778,29m 57s,Buy
42836.53,98.22,11.06.2009 03:15:00,,-2.39,-0.0,0.0,0.0,98202,10.06.2009 22:00:00,3591,-0.0,2.56,IS,0.27,0.0,Phase3-EA-S1v2-USDJPY-M15-0,USDJPYMT4,1324,5h 15m,Buy
42865.51,160469,11.06.2009 04:25:00,,-4.08,-0.0,0.0,0.0,160.61,10.06.2009 23:00:00,3592,-0.0,28.98,IS,0.23,0.0,Phase3-EA-S4v1-GBPJPY-M5-194,GBPJPYMT4,962,5h 25m,Sell
42719.14,1.0778,11.06.2009 07:00:00,,0.0,-146.36999999999534,0.0,0.0,1.08052,11.06.2009 02:45:00,3593,-0.110164029777175,-146.37,IS,0.58,0.0,Phase3-EA-SA2v2-USDCHF-M15-107,USDCHFMT4,780,4h 15m,Buy
42679.21,137.09,11.06.2009 11:29:58,sl 137.090,0.0,-186.29999999998836,0.0,0.0,136.86,11.06.2009 10:15:00,3594,-0.1402169757975478,-39.93,IS,0.17,0.0,Phase3-EA-T1v2-EURJPY-M15-322,EURJPYMT4,210,1h 14m,Sell
42644.91,1.51296,11.06.2009 14:00:00,,0.0,-220.59999999997672,0.0,0.0,1.51187,11.06.2009 05:15:00,3595,-0.16603255427234415,-34.3,IS,0.34,0.0,Phase3-EA-S4v1-EURCHF-M15-221,EURCHFMT4,938,8h 45m,Sell
42687.14,1.51123,11.06.2009 21:24:58,tp 1.51123,0.0,-178.36999999996624,0.0,0.0,1.51013,11.06.2009 20:10:00,3596,-0.13424853447667973,42.23,IS,0.41,0.0,Phase3-EA-SA2v2-EURCHF-M5-43,EURCHFMT4,2036,1h 14m,Buy
42729.27,1.51032,11.06.2009 23:04:58,tp 1.51032,0.0,-136.23999999996158,0.0,0.0,1.51142,11.06.2009 21:30:00,3597,-0.10253977875820569,42.13,IS,0.41,0.0,Phase3-EA-SA2v2-EURCHF-M5-43,EURCHFMT4,2038,1h 34m,Sell
42678.17,97.69,12.06.2009 03:30:00,,-0.8,-187.3399999999674,0.0,0.0,97872,11.06.2009 17:30:00,3598,-0.14099972220026666,-51.1,IS,0.27,0.0,Phase3-EA-S1v2-USDJPY-M15-0,USDJPYMT4,1326,10h 0m,Buy
42673.81,1.50965,12.06.2009 08:10:00,,-0.92,-191.69999999995343,0.0,0.0,1.50974,11.06.2009 23:50:00,3599,-0.14428123596556663,-4.36,IS,0.41,0.0,Phase3-EA-SA2v2-EURCHF-M5-43,EURCHFMT4,2040,8h 20m,Buy
42667.76,98.2,12.06.2009 18:45:00,,0.0,-197.7499999999418,0.0,0.0,98222,12.06.2009 17:00:00,3600,-0.14883471263531212,-6.05,IS,0.27,0.0,Phase3-EA-S1v2-USDJPY-M15-0,USDJPYMT4,1328,1h 45m,Buy
42709.68,1.51005,12.06.2009 20:59:58,tp 1.51005,0.0,-155.829999999929,0.0,0.0,1.50895,12.06.2009 20:30:00,3601,-0.11728401147892262,41.92,IS,0.41,0.0,Phase3-EA-SA2v2-EURCHF-M5-43,EURCHFMT4,2042,29m 58s,Buy
42749.5,1.51129,15.06.2009 01:04:58,tp 1.51129,-1.9,-116.009999999922,0.0,0.0,1.51239,12.06.2009 21:45:00,3602,-0.08731385594344392,39.82,IS,0.41,0.0,Phase3-EA-SA2v2-EURCHF-M5-43,EURCHFMT4,2044,2d 3h 19m,Sell
42803.22,1.07972,15.06.2009 02:59:58,tp 1.07972,0.0,-62.28999999992084,0.0,0.0,1.07872,15.06.2009 02:30:00,3603,-0.046881993679112714,53.72,IS,0.58,0.0,Phase3-EA-SA2v2-USDCHF-M15-107,USDCHFMT4,782,29m 58s,Buy
42733.4,160813,15.06.2009 09:10:00,,0.0,-132.10999999992782,0.0,0.0,161112,15.06.2009 03:45:00,3604,-0.09943137237039763,-69.82,IS,0.23,0.0,Phase3-EA-S4v1-GBPJPY-M5-194,GBPJPYMT4,964,5h 25m,Buy
42774.9,1.51137,15.06.2009 09:49:58,tp 1.51137,0.0,-90.60999999992782,0.0,0.0,1.51027,15.06.2009 02:05:00,3605,-0.06819678033819904,41.5,IS,0.41,0.0,Phase3-EA-SA2v2-EURCHF-M5-43,EURCHFMT4,2046,7h 44m,Buy
42891.26,136.44,15.06.2009 10:29:58,tp 136.440,-1.6,-0.0,0.0,0.0,137.73,10.06.2009 16:00:00,3606,-0.0,116.36,IS,0.09,0.0,Phase3-EA-TR1v1-EURJPY-M30-91,EURJPYMT4,280,4d 18h 29m,Sell
42702.68,158041,16.06.2009 03:44:57,sl 158.041,0.0,-188.5799999999872,0.0,0.0,158841,16.06.2009 03:00:00,3607,-0.14190549476315237,-188.58,IS,0.23,0.0,Phase3-EA-S4v1-GBPJPY-M5-194,GBPJPYMT4,966,44m 57s,Buy
42818.41,134.28,16.06.2009 03:59:58,tp 134.280,-0.32,-72.84999999997672,0.0,0.0,135.54,15.06.2009 17:00:00,3608,-0.054819255984160827,115.73,IS,0.09,0.0,Phase3-EA-TR1v1-EURJPY-M30-91,EURJPYMT4,282,10h 59m,Sell
42628.96,157226,16.06.2009 04:09:58,sl 157.226,0.0,-262.29999999998836,0.0,0.0,158026,16.06.2009 03:55:00,3609,-0.1973794213404165,-189.45,IS,0.23,0.0,Phase3-EA-S4v1-GBPJPY-M5-194,GBPJPYMT4,968,14m 58s,Buy
42604.81,1.50571,16.06.2009 04:35:00,,-0.9,-286.44999999998254,0.0,0.0,1.50633,15.06.2009 20:15:00,3610,-0.21555217401052754,-24.15,IS,0.41,0.0,Phase3-EA-SA2v2-EURCHF-M5-43,EURCHFMT4,2048,8h 20m,Buy
42777.28,156989,16.06.2009 06:59:58,tp 156.989,0.0,-113.97999999998137,0.0,0.0,158839,16.06.2009 03:00:00,3611,-0.08576937264345404,172.47,IS,0.09,0.0,Phase3-EA-B1v1-GBPJPY-M30-1,GBPJPYMT4,436,3h 59m,Sell
42710.39,134155,16.06.2009 12:29:58,sl 134.155,0.0,-180.86999999999534,0.0,0.0,133435,16.06.2009 06:30:00,3612,-0.13610375881754402,-66.89,IS,0.09,0.0,Phase3-EA-TR1v1-EURJPY-M30-91,EURJPYMT4,284,5h 59m,Sell
42608.31,96.51,17.06.2009 02:00:00,,-0.81,-282.94999999998254,0.0,0.0,96872,16.06.2009 17:00:00,3613,-0.2129184417394963,-102.08,IS,0.27,0.0,Phase3-EA-S1v2-USDJPY-M15-0,USDJPYMT4,1330,9h 0m,Buy
42701.48,157829,17.06.2009 03:14:58,tp 157.829,0.0,-189.77999999996973,0.0,0.0,157439,17.06.2009 02:40:00,3614,-0.14280848868463566,93.17,IS,0.23,0.0,Phase3-EA-S4v1-GBPJPY-M5-194,GBPJPYMT4,970,34m 58s,Buy
42754.76,1.0886,17.06.2009 03:14:59,tp 1.08860,0.0,-136.4999999999709,0.0,0.0,1.0896,17.06.2009 02:30:00,3615,-0.1027155585701956,53.28,IS,0.58,0.0,Phase3-EA-SA2v2-USDCHF-M15-107,USDCHFMT4,784,44m 59s,Sell
42747.08,1.50607,17.06.2009 05:35:00,,-0.9,-144.1799999999639,0.0,0.0,1.50625,16.06.2009 21:15:00,3616,-0.10849471966776741,-7.68,IS,0.41,0.0,Phase3-EA-SA2v2-EURCHF-M5-43,EURCHFMT4,2050,8h 20m,Buy
42705.93,134.06,17.06.2009 06:59:58,sl 134.060,-0.62,-185.3299999999581,0.0,0.0,133.83,16.06.2009 18:45:00,3617,-0.13945988622574435,-41.15,IS,0.17,0.0,Phase3-EA-T1v2-EURJPY-M15-322,EURJPYMT4,212,12h 14m,Sell
42811.34,1.50904,17.06.2009 11:30:00,,0.0,-79.9199999999546,0.0,0.0,1.50567,17.06.2009 02:45:00,3618,-0.060139395171627245,105.41,IS,0.34,0.0,Phase3-EA-S4v1-EURCHF-M15-221,EURCHFMT4,940,8h 45m,Buy
42863.09,1.08042,18.06.2009 02:14:57,tp 1.08042,-1.93,-28.169999999954598,0.0,0.0,1.07942,17.06.2009 22:45:00,3619,-0.021197782307094237,51.75,IS,0.58,0.0,Phase3-EA-SA2v2-USDCHF-M15-107,USDCHFMT4,786,3h 29m,Buy
42676.71,1.51094,18.06.2009 10:34:57,sl 1.51094,0.0,-214.54999999995925,0.0,0.0,1.50604,18.06.2009 02:55:00,3620,-0.16144778821418299,-186.38,IS,0.41,0.0,Phase3-EA-SA2v2-EURCHF-M5-43,EURCHFMT4,2052,7h 39m,Sell
42553.69,1.51066,18.06.2009 10:44:57,sl 1.51066,0.0,-337.5699999999488,0.0,0.0,1.50676,18.06.2009 04:30:00,3621,-0.2540197150662495,-123.02,IS,0.34,0.0,Phase3-EA-S4v1-EURCHF-M15-221,EURCHFMT4,942,6h 14m,Sell
42512.85,133.59,18.06.2009 10:59:58,sl 133.590,0.0,-378.4099999999453,0.0,0.0,133.82,18.06.2009 09:30:00,3622,-0.2847516081945083,-40.84,IS,0.17,0.0,Phase3-EA-T1v2-EURJPY-M15-322,EURJPYMT4,214,1h 29m,Buy
42472.06,133744,18.06.2009 16:44:58,sl 133.744,0.0,-419.19999999995343,0.0,0.0,133974,18.06.2009 15:45:00,3623,-0.31544587657604684,-40.79,IS,0.17,0.0,Phase3-EA-T1v2-EURJPY-M15-322,EURJPYMT4,216,59m 58s,Buy
42510.59,96.71,19.06.2009 03:00:00,,0.0,-380.6699999999546,0.0,0.0,96572,19.06.2009 00:15:00,3624,-0.28645224674666686,38.53,IS,0.27,0.0,Phase3-EA-S1v2-USDJPY-M15-0,USDJPYMT4,1332,2h 45m,Buy
42603.42,157607,19.06.2009 05:19:58,tp 157.607,0.0,-287.8399999999674,0.0,0.0,157997,19.06.2009 02:05:00,3625,-0.21659814196958282,92.83,IS,0.23,0.0,Phase3-EA-S4v1-GBPJPY-M5-194,GBPJPYMT4,972,3h 14m,Sell
42541.03,157438,19.06.2009 05:29:58,sl 157.438,0.0,-350.2299999999814,0.0,0.0,158108,19.06.2009 03:00:00,3626,-0.26354630093806125,-62.39,IS,0.09,0.0,Phase3-EA-B1v1-GBPJPY-M30-1,GBPJPYMT4,438,2h 29m,Buy
42525.01,1.5102,19.06.2009 06:00:00,,-0.91,-366.2499999999709,0.0,0.0,1.5106,18.06.2009 21:40:00,3627,-0.2756012697900305,-16.02,IS,0.41,0.0,Phase3-EA-SA2v2-EURCHF-M5-43,EURCHFMT4,2054,8h 20m,Buy
42452.21,134969,19.06.2009 09:59:57,sl 134.969,-0.33,-439.04999999995925,0.0,0.0,134189,18.06.2009 23:00:00,3628,-0.3303829010274711,-72.8,IS,0.09,0.0,Phase3-EA-TR1v1-EURJPY-M30-91,EURJPYMT4,286,10h 59m,Sell
42509.42,96042,22.06.2009 02:30:00,,-1.26,-381.8399999999674,0.0,0.0,96.25,19.06.2009 23:30:00,3629,-0.2873326658201355,57.21,IS,0.27,0.0,Phase3-EA-S1v2-USDJPY-M15-0,USDJPYMT4,1334,2d 3h 0m,Sell
42602.66,158512,22.06.2009 03:34:58,tp 158.512,0.0,-288.5999999999767,0.0,0.0,158122,22.06.2009 02:30:00,3630,-0.2171700381198709,93.24,IS,0.23,0.0,Phase3-EA-S4v1-GBPJPY-M5-194,GBPJPYMT4,974,1h 4m,Buy
42543.82,1.50574,22.06.2009 04:35:00,,-0.91,-347.4399999999732,0.0,0.0,1.50727,19.06.2009 20:15:00,3631,-0.26144684007057595,-58.84,IS,0.41,0.0,Phase3-EA-SA2v2-EURCHF-M5-43,EURCHFMT4,2056,2d 8h 20m,Buy
42664.33,133325,22.06.2009 04:59:58,tp 133.325,-0.33,-226.9299999999639,0.0,0.0,134615,19.06.2009 16:00:00,3632,-0.1707636755042912,120.51,IS,0.09,0.0,Phase3-EA-TR1v1-EURJPY-M30-91,EURJPYMT4,288,2d 12h 59m,Sell
42782.42,132746,22.06.2009 15:29:58,tp 132.746,0.0,-108.8399999999674,0.0,0.0,134006,22.06.2009 02:00:00,3633,-0.08190154867970054,118.09,IS,0.09,0.0,Phase3-EA-TR1v1-EURJPY-M30-91,EURJPYMT4,289,13h 29m,Sell
42746.51,1.08712,23.06.2009 03:45:00,,-2.83,-144.7499999999709,0.0,0.0,1.0865,22.06.2009 23:30:00,3634,-0.10892364178048346,-35.91,IS,0.58,0.0,Phase3-EA-SA2v2-USDCHF-M15-107,USDCHFMT4,788,4h 15m,Sell
42553.62,155.45,23.06.2009 04:04:58,sl 155.450,0.0,-337.63999999998487,0.0,0.0,156.25,23.06.2009 02:25:00,3635,-0.25407238971169727,-192.89,IS,0.23,0.0,Phase3-EA-S4v1-GBPJPY-M5-194,GBPJPYMT4,976,1h 39m,Buy
42672.66,131447,23.06.2009 09:29:58,tp 131.447,-0.33,-218.59999999997672,0.0,0.0,132707,22.06.2009 16:00:00,3636,-0.16449539269924654,119.04,IS,0.09,0.0,Phase3-EA-TR1v1-EURJPY-M30-91,EURJPYMT4,292,17h 29m,Sell
42630.66,1.6291,23.06.2009 09:59:57,sl 1.62910,0.0,-260.5999999999767,0.0,0.0,1.6261,23.06.2009 09:00:00,3637,-0.19610017995162116,-42.0,IS,0.14,0.0,Phase3-EA-B1v1-GBPUSD-M30-14,GBPUSDMT4,232,59m 57s,Sell
42567.32,155416,23.06.2009 10:29:57,sl 155.416,0.0,-323.9399999999732,0.0,0.0,154746,23.06.2009 09:00:00,3638,-0.24376320910793775,-63.34,IS,0.09,0.0,Phase3-EA-B1v1-GBPJPY-M30-1,GBPJPYMT4,440,1h 29m,Sell
42503.87,154.73,23.06.2009 11:59:58,sl 154.730,0.0,-387.38999999998487,0.0,0.0,154.06,23.06.2009 11:30:00,3639,-0.2915090127070696,-63.45,IS,0.09,0.0,Phase3-EA-B1v1-GBPJPY-M30-1,GBPJPYMT4,442,29m 58s,Sell
42462.92,133128,23.06.2009 13:29:58,sl 133.128,0.0,-428.3399999999965,0.0,0.0,132898,23.06.2009 00:30:00,3640,-0.3223236802781436,-40.95,IS,0.17,0.0,Phase3-EA-T1v2-EURJPY-M15-322,EURJPYMT4,218,12h 59m,Sell
42584.39,133614,23.06.2009 14:59:58,tp 133.614,0.0,-306.86999999999534,0.0,0.0,132324,23.06.2009 10:30:00,3641,-0.23091812057466787,121.47,IS,0.09,0.0,Phase3-EA-TR1v1-EURJPY-M30-91,EURJPYMT4,294,4h 29m,Buy
42532.27,1.50333,23.06.2009 15:00:00,,0.0,-358.9899999999907,0.0,0.0,1.50498,23.06.2009 06:15:00,3642,-0.27013815656499207,-52.12,IS,0.34,0.0,Phase3-EA-S4v1-EURCHF-M15-221,EURCHFMT4,944,8h 45m,Buy
42508.23,95.35,24.06.2009 03:00:00,,-0.82,-383.02999999999884,0.0,0.0,95432,23.06.2009 17:45:00,3643,-0.2882281347923098,-24.04,IS,0.27,0.0,Phase3-EA-S1v2-USDJPY-M15-0,USDJPYMT4,1336,9h 15m,Buy
42602.33,156.72,24.06.2009 03:09:58,tp 156.720,0.0,-288.929999999993,0.0,0.0,156.33,24.06.2009 02:00:00,3644,-0.21741836144829468,94.1,IS,0.23,0.0,Phase3-EA-S4v1-GBPJPY-M5-194,GBPJPYMT4,978,1h 9m,Buy
42696.35,156624,24.06.2009 04:14:57,tp 156.624,0.0,-194.9100000000035,0.0,0.0,157014,24.06.2009 03:15:00,3645,-0.14666878769905825,94.02,IS,0.23,0.0,Phase3-EA-S4v1-GBPJPY-M5-194,GBPJPYMT4,980,59m 57s,Sell
42711.2,1.50202,24.06.2009 08:15:00,,-0.92,-180.05999999999767,0.0,0.0,1.50161,23.06.2009 23:55:00,3646,-0.1354942379205357,14.85,IS,0.41,0.0,Phase3-EA-SA2v2-EURCHF-M5-43,EURCHFMT4,2058,8h 20m,Buy
42587.29,1.50608,24.06.2009 13:44:59,sl 1.50608,0.0,-303.97000000000116,0.0,0.0,1.50218,24.06.2009 05:15:00,3647,-0.22873588526438923,-123.91,IS,0.34,0.0,Phase3-EA-S4v1-EURCHF-M15-221,EURCHFMT4,946,8h 29m,Sell
42700.0,95822,24.06.2009 21:29:58,tp 95.822,0.0,-191.2600000000093,0.0,0.0,95422,24.06.2009 21:00:00,3648,-0.14392218118784436,112.71,IS,0.27,0.0,Phase3-EA-S1v2-USDJPY-M15-0,USDJPYMT4,1338,29m 58s,Buy
42821.13,133295,24.06.2009 21:59:58,tp 133.295,0.0,-70.13000000000466,0.0,0.0,134585,24.06.2009 11:30:00,3649,-0.052772469762123304,121.13,IS,0.09,0.0,Phase3-EA-TR1v1-EURJPY-M30-91,EURJPYMT4,296,10h 29m,Sell
42862.19,1.53048,24.06.2009 22:49:58,tp 1.53048,0.0,-29.070000000006985,0.0,0.0,1.52938,24.06.2009 22:40:00,3650,-0.02187502774825597,41.06,IS,0.41,0.0,Phase3-EA-SA2v2-EURCHF-M5-43,EURCHFMT4,2060,9m 58s,Buy
42791.29,1.09612,25.06.2009 06:30:00,,0.0,-99.97000000000116,0.0,0.0,1.09746,25.06.2009 02:15:00,3651,-0.07522691860999826,-70.9,IS,0.58,0.0,Phase3-EA-SA2v2-USDCHF-M15-107,USDCHFMT4,790,4h 15m,Buy
42792.72,1.52982,25.06.2009 07:25:00,,-2.69,-98.54000000000815,0.0,0.0,1.52971,24.06.2009 23:05:00,3652,-0.07415085085355362,1.43,IS,0.41,0.0,Phase3-EA-SA2v2-EURCHF-M5-43,EURCHFMT4,2062,8h 20m,Buy
42725.5,133752,25.06.2009 15:59:58,sl 133.752,0.0,-165.7600000000093,0.0,0.0,133694,25.06.2009 03:30:00,3653,-0.12473356035604548,-67.22,IS,0.09,0.0,Phase3-EA-TR1v1-EURJPY-M30-91,EURJPYMT4,298,12h 29m,Buy
42776.81,95769,26.06.2009 03:00:00,,0.0,-114.45000000001164,0.0,0.0,95951,26.06.2009 00:45:00,3654,-0.08612304526272958,51.31,IS,0.27,0.0,Phase3-EA-S1v2-USDJPY-M15-0,USDJPYMT4,1340,2h 15m,Sell
42809.38,1.53125,26.06.2009 04:25:00,,-0.9,-81.88000000000466,0.0,0.0,1.53036,25.06.2009 20:05:00,3655,-0.061614285243442396,32.57,IS,0.41,0.0,Phase3-EA-SA2v2-EURCHF-M5-43,EURCHFMT4,2064,8h 20m,Buy
42850.08,1.52407,29.06.2009 01:54:58,tp 1.52407,-0.91,-41.179999999993015,0.0,0.0,1.52297,26.06.2009 21:30:00,3656,-0.030987741406013472,40.7,IS,0.41,0.0,Phase3-EA-SA2v2-EURCHF-M5-43,EURCHFMT4,2066,2d 4h 24m,Buy
42891.67,1.52297,29.06.2009 03:24:58,tp 1.52297,0.0,-0.0,0.0,0.0,1.52407,29.06.2009 02:05:00,3657,-0.0,41.59,IS,0.41,0.0,Phase3-EA-SA2v2-EURCHF-M5-43,EURCHFMT4,2068,1h 19m,Sell
42683.52,1.08674,29.06.2009 04:14:58,sl 1.08674,0.0,-208.14999999999418,0.0,0.0,1.08284,29.06.2009 01:15:00,3658,-0.15663133738931434,-208.15,IS,0.58,0.0,Phase3-EA-SA2v2-USDCHF-M15-107,USDCHFMT4,792,2h 59m,Sell
42642.57,133953,29.06.2009 10:29:57,sl 133.953,0.0,-249.10000000000582,0.0,0.0,133723,29.06.2009 08:30:00,3659,-0.1874459098903685,-40.95,IS,0.17,0.0,Phase3-EA-T1v2-EURJPY-M15-322,EURJPYMT4,220,1h 59m,Sell
42587.23,95401,29.06.2009 13:00:00,,-1.28,-304.4400000000023,0.0,0.0,95.21,26.06.2009 22:15:00,3660,-0.22908885109202284,-55.34,IS,0.27,0.0,Phase3-EA-S1v2-USDJPY-M15-0,USDJPYMT4,1342,2d 14h 45m,Sell
42707.5,134984,29.06.2009 19:29:58,tp 134.984,-0.92,-184.1700000000128,0.0,0.0,134472,25.06.2009 08:30:00,3661,-0.1385865645303523,120.27,IS,0.09,0.0,Phase3-EA-TR1v1-EURJPY-M30-91,EURJPYMT4,299,4d 10h 59m,Buy
42749.15,1.52512,29.06.2009 20:49:58,tp 1.52512,0.0,-142.52000000001863,0.0,0.0,1.52622,29.06.2009 20:05:00,3662,-0.10724524720023358,41.65,IS,0.41,0.0,Phase3-EA-SA2v2-EURCHF-M5-43,EURCHFMT4,2070,44m 58s,Sell
42790.81,1.52523,29.06.2009 22:09:58,tp 1.52523,0.0,-100.86000000001513,0.0,0.0,1.52413,29.06.2009 21:15:00,3663,-0.07589640494397817,41.66,IS,0.41,0.0,Phase3-EA-SA2v2-EURCHF-M5-43,EURCHFMT4,2072,54m 58s,Buy
43054.35,1.65913,30.06.2009 02:29:58,tp 1.65913,-1.06,-0.0,0.0,0.0,1.64023,26.06.2009 09:00:00,3664,-0.0,263.54,IS,0.14,0.0,Phase3-EA-B1v1-GBPUSD-M30-14,GBPUSDMT4,234,3d 17h 29m,Buy
43081.08,95961,30.06.2009 04:00:00,,0.0,-0.0,0.0,0.0,96056,30.06.2009 00:15:00,3665,-0.0,26.73,IS,0.27,0.0,Phase3-EA-S1v2-USDJPY-M15-0,USDJPYMT4,1344,3h 45m,Sell
43174.75,159045,30.06.2009 07:44:58,tp 159.045,0.0,-0.0,0.0,0.0,159435,30.06.2009 02:25:00,3666,-0.0,93.67,IS,0.23,0.0,Phase3-EA-S4v1-GBPJPY-M5-194,GBPJPYMT4,982,5h 19m,Sell
43216.49,1.52418,30.06.2009 10:09:59,tp 1.52418,0.0,-0.0,0.0,0.0,1.52528,30.06.2009 02:35:00,3667,-0.0,41.74,IS,0.41,0.0,Phase3-EA-SA2v2-EURCHF-M5-43,EURCHFMT4,2074,7h 34m,Sell
43174.49,1.65883,30.06.2009 14:29:58,sl 1.65883,0.0,-42.0,0.0,0.0,1.65583,30.06.2009 14:00:00,3668,-0.03152762844900057,-42.0,IS,0.14,0.0,Phase3-EA-B1v1-GBPUSD-M30-14,GBPUSDMT4,236,29m 58s,Sell
43133.89,135129,30.06.2009 17:14:57,sl 135.129,0.0,-82.60000000000582,0.0,0.0,135359,30.06.2009 13:45:00,3669,-0.06200433594970549,-40.6,IS,0.17,0.0,Phase3-EA-T1v2-EURJPY-M15-322,EURJPYMT4,222,3h 29m,Buy
43110.95,135135,30.06.2009 21:00:00,,0.0,-105.54000000000815,0.0,0.0,135265,30.06.2009 20:15:00,3670,-0.07922442634542326,-22.94,IS,0.17,0.0,Phase3-EA-T1v2-EURJPY-M15-322,EURJPYMT4,224,45m 0s,Buy
43125.81,96293,30.06.2009 22:45:00,,0.0,-90.68000000002212,0.0,0.0,96348,30.06.2009 22:00:00,3671,-0.06806965113704927,14.86,IS,0.27,0.0,Phase3-EA-S1v2-USDJPY-M15-0,USDJPYMT4,1346,45m 0s,Buy
43138.72,96397,01.07.2009 03:15:00,,-0.81,-77.77000000001863,0.0,0.0,96346,30.06.2009 22:00:00,3672,-0.058378658678080037,12.91,IS,0.27,0.0,Phase3-EA-S1v2-USDJPY-M15-0,USDJPYMT4,1347,5h 15m,Sell
43098.09,135107,01.07.2009 03:44:58,sl 135.107,0.0,-118.40000000002328,0.0,0.0,135337,01.07.2009 03:15:00,3673,-0.08887788591339052,-40.63,IS,0.17,0.0,Phase3-EA-T1v2-EURJPY-M15-322,EURJPYMT4,226,29m 58s,Buy
43025.15,136079,01.07.2009 09:59:58,sl 136.079,-0.33,-191.3400000000256,0.0,0.0,135299,30.06.2009 07:00:00,3674,-0.14363086731982325,-72.94,IS,0.09,0.0,Phase3-EA-TR1v1-EURJPY-M30-91,EURJPYMT4,302,1d 2h 59m,Sell
43067.17,1.52105,01.07.2009 21:29:57,tp 1.52105,0.0,-149.3200000000361,0.0,0.0,1.51995,01.07.2009 20:15:00,3675,-0.11208822571442627,42.02,IS,0.41,0.0,Phase3-EA-SA2v2-EURCHF-M5-43,EURCHFMT4,2076,1h 14m,Buy
43026.76,1.07523,02.07.2009 02:15:00,,-8.58,-189.73000000003958,0.0,0.0,1.07464,01.07.2009 22:00:00,3676,-0.14242230822928872,-40.41,IS,0.58,0.0,Phase3-EA-SA2v2-USDCHF-M15-107,USDCHFMT4,794,4h 15m,Sell
43019.07,96.51,02.07.2009 03:00:00,,-3.77,-197.4200000000419,0.0,0.0,96496,01.07.2009 21:15:00,3677,-0.14819486686673844,-7.69,IS,0.27,0.0,Phase3-EA-S1v2-USDJPY-M15-0,USDJPYMT4,1350,5h 45m,Sell
43137.99,135304,02.07.2009 15:59:57,tp 135.304,-0.98,-78.5000000000291,0.0,0.0,136594,01.07.2009 20:00:00,3678,-0.058926638886844344,118.92,IS,0.09,0.0,Phase3-EA-TR1v1-EURJPY-M30-91,EURJPYMT4,304,19h 59m,Sell
42927.22,1.0878,03.07.2009 00:29:58,sl 1.08780,-2.83,-289.2700000000186,0.0,0.0,1.0839,02.07.2009 23:15:00,3679,-0.21714278765340433,-210.77,IS,0.58,0.0,Phase3-EA-SA2v2-USDCHF-M15-107,USDCHFMT4,796,1h 14m,Sell
42967.68,1.51898,03.07.2009 00:29:58,tp 1.51898,-0.91,-248.81000000002678,0.0,0.0,1.51788,02.07.2009 20:35:00,3680,-0.18677117224753992,40.46,IS,0.41,0.0,Phase3-EA-SA2v2-EURCHF-M5-43,EURCHFMT4,2078,3h 54m,Buy
42989.65,95842,03.07.2009 03:00:00,,0.0,-226.8400000000256,0.0,0.0,95.92,03.07.2009 00:30:00,3681,-0.1702792199374309,21.97,IS,0.27,0.0,Phase3-EA-S1v2-USDJPY-M15-0,USDJPYMT4,1352,2h 30m,Sell
43083.12,157165,03.07.2009 05:04:58,tp 157.165,0.0,-133.37000000002445,0.0,0.0,156775,03.07.2009 00:45:00,3682,-0.10011523348199945,93.47,IS,0.23,0.0,Phase3-EA-S4v1-GBPJPY-M5-194,GBPJPYMT4,984,4h 19m,Buy
42961.02,1.52282,03.07.2009 12:59:58,sl 1.52282,0.0,-255.47000000003027,0.0,0.0,1.51892,03.07.2009 06:15:00,3683,-0.19177055333016976,-122.1,IS,0.34,0.0,Phase3-EA-S4v1-EURCHF-M15-221,EURCHFMT4,948,6h 44m,Sell
42950.68,1.51853,06.07.2009 04:25:00,,-0.91,-265.8100000000268,0.0,0.0,1.51878,03.07.2009 20:05:00,3684,-0.199532355191183,-10.34,IS,0.41,0.0,Phase3-EA-SA2v2-EURCHF-M5-43,EURCHFMT4,2080,2d 8h 20m,Buy
43068.8,133232,06.07.2009 05:59:57,tp 133.232,-0.66,-147.69000000003143,0.0,0.0,134492,02.07.2009 18:00:00,3685,-0.11086465346747346,118.12,IS,0.09,0.0,Phase3-EA-TR1v1-EURJPY-M30-91,EURJPYMT4,306,3d 11h 59m,Sell
43005.25,153909,06.07.2009 17:29:57,sl 153.909,0.0,-211.2400000000198,0.0,0.0,153239,06.07.2009 16:30:00,3686,-0.15856895794208345,-63.55,IS,0.09,0.0,Phase3-EA-B1v1-GBPJPY-M30-1,GBPJPYMT4,444,59m 57s,Sell
43046.84,1.51682,06.07.2009 23:14:57,tp 1.51682,0.0,-169.65000000002328,0.0,0.0,1.51572,06.07.2009 20:00:00,3687,-0.12734909919937334,41.59,IS,0.41,0.0,Phase3-EA-SA2v2-EURCHF-M5-43,EURCHFMT4,2082,3h 14m,Buy
43100.31,1.08482,06.07.2009 23:44:58,tp 1.08482,0.0,-116.18000000002212,0.0,0.0,1.08382,06.07.2009 23:15:00,3688,-0.08721142555251389,53.47,IS,0.58,0.0,Phase3-EA-SA2v2-USDCHF-M15-107,USDCHFMT4,798,29m 58s,Buy
43194.49,155166,07.07.2009 02:49:57,tp 155.166,0.0,-22.000000000029104,0.0,0.0,154776,07.07.2009 01:55:00,3689,-0.016514472044736432,94.18,IS,0.23,0.0,Phase3-EA-S4v1-GBPJPY-M5-194,GBPJPYMT4,986,54m 57s,Buy
43199.02,1.51614,07.07.2009 07:35:00,,-1.89,-17.470000000030268,0.0,0.0,1.51631,06.07.2009 23:15:00,3690,-0.01311399211916653,4.53,IS,0.41,0.0,Phase3-EA-SA2v2-EURCHF-M5-43,EURCHFMT4,2084,8h 20m,Sell
43157.02,1.62302,07.07.2009 08:59:58,sl 1.62302,0.0,-59.47000000003027,0.0,0.0,1.62602,07.07.2009 05:30:00,3691,-0.044641620568167104,-42.0,IS,0.14,0.0,Phase3-EA-B1v1-GBPUSD-M30-14,GBPUSDMT4,238,3h 29m,Buy
43109.83,95252,07.07.2009 09:30:00,,-1.27,-106.6600000000326,0.0,0.0,95.09,06.07.2009 19:30:00,3692,-0.08006516310408163,-47.19,IS,0.27,0.0,Phase3-EA-S1v2-USDJPY-M15-0,USDJPYMT4,1354,14h 0m,Sell
43231.33,133531,07.07.2009 14:29:58,tp 133.531,-0.46,-0.0,0.0,0.0,132241,06.07.2009 18:30:00,3693,-0.0,121.5,IS,0.09,0.0,Phase3-EA-TR1v1-EURJPY-M30-91,EURJPYMT4,308,19h 59m,Buy
43272.79,1.51569,07.07.2009 21:54:58,tp 1.51569,0.0,-0.0,0.0,0.0,1.51459,07.07.2009 21:25:00,3694,-0.0,41.46,IS,0.41,0.0,Phase3-EA-SA2v2-EURCHF-M5-43,EURCHFMT4,2086,29m 58s,Buy
43312.28,1.51461,08.07.2009 05:04:57,tp 1.51461,-1.88,-0.0,0.0,0.0,1.51571,07.07.2009 22:50:00,3695,-0.0,39.49,IS,0.41,0.0,Phase3-EA-SA2v2-EURCHF-M5-43,EURCHFMT4,2088,6h 14m,Sell
43488.28,150972,08.07.2009 09:29:58,tp 150.972,-0.55,-0.0,0.0,0.0,152822,07.07.2009 23:00:00,3696,-0.0,176.0,IS,0.09,0.0,Phase3-EA-B1v1-GBPJPY-M30-1,GBPJPYMT4,446,10h 29m,Sell
43446.79,131149,08.07.2009 16:14:57,sl 131.149,0.0,-41.48999999999069,0.0,0.0,130919,08.07.2009 15:30:00,3697,-0.03108138032791396,-41.49,IS,0.17,0.0,Phase3-EA-T1v2-EURJPY-M15-322,EURJPYMT4,228,44m 57s,Sell
43567.27,130145,08.07.2009 18:29:58,tp 130.145,0.0,-0.0,0.0,0.0,131405,08.07.2009 05:30:00,3698,-0.0,120.48,IS,0.09,0.0,Phase3-EA-TR1v1-EURJPY-M30-91,EURJPYMT4,310,12h 59m,Sell
43502.42,149685,08.07.2009 18:59:57,sl 149.685,0.0,-64.85000000000582,0.0,0.0,149015,08.07.2009 18:30:00,3699,-0.048552313751719145,-64.85,IS,0.09,0.0,Phase3-EA-B1v1-GBPJPY-M30-1,GBPJPYMT4,448,29m 57s,Sell
43543.76,1.51365,08.07.2009 22:49:57,tp 1.51365,0.0,-23.510000000009313,0.0,0.0,1.51255,08.07.2009 21:20:00,3700,-0.01760161752202416,41.34,IS,0.41,0.0,Phase3-EA-SA2v2-EURCHF-M5-43,EURCHFMT4,2090,1h 29m,Buy
43636.19,148766,09.07.2009 00:54:57,tp 148.766,-4.31,-0.0,0.0,0.0,149156,08.07.2009 23:50:00,3701,-0.0,92.43,IS,0.23,0.0,Phase3-EA-S4v1-GBPJPY-M5-194,GBPJPYMT4,988,1h 4m,Sell
43749.12,92.43,09.07.2009 02:44:58,tp 92.430,-3.92,-0.0,0.0,0.0,92.83,08.07.2009 23:45:00,3702,-0.0,112.93,IS,0.27,0.0,Phase3-EA-S1v2-USDJPY-M15-0,USDJPYMT4,1356,2h 59m,Sell
43845.94,148755,09.07.2009 02:59:58,tp 148.755,0.0,-0.0,0.0,0.0,148365,09.07.2009 02:45:00,3703,-0.0,96.82,IS,0.23,0.0,Phase3-EA-S4v1-GBPJPY-M5-194,GBPJPYMT4,990,14m 58s,Buy
43899.15,1.09,09.07.2009 03:29:58,tp 1.09000,0.0,-0.0,0.0,0.0,1091,09.07.2009 02:45:00,3704,-0.0,53.21,IS,0.58,0.0,Phase3-EA-SA2v2-USDCHF-M15-107,USDCHFMT4,800,44m 58s,Sell
44022.69,129524,09.07.2009 04:29:58,tp 129.524,-1.42,-0.0,0.0,0.0,128234,08.07.2009 22:30:00,3705,-0.0,123.54,IS,0.09,0.0,Phase3-EA-TR1v1-EURJPY-M30-91,EURJPYMT4,312,5h 59m,Buy
44020.8,92892,10.07.2009 05:00:00,,-1.31,-1.8900000000139698,0.0,0.0,92.89,09.07.2009 19:30:00,3706,-0.0014102089728343541,-1.89,IS,0.27,0.0,Phase3-EA-S1v2-USDJPY-M15-0,USDJPYMT4,1358,9h 30m,Sell
43955.74,151341,10.07.2009 08:50:00,,0.0,-66.95000000001164,0.0,0.0,151604,10.07.2009 03:25:00,3707,-0.04995422789977702,-65.06,IS,0.23,0.0,Phase3-EA-S4v1-GBPJPY-M5-194,GBPJPYMT4,992,5h 25m,Buy
44080.74,129.09,10.07.2009 09:59:58,tp 129.090,0.0,-0.0,0.0,0.0,130.38,10.07.2009 01:00:00,3708,-0.0,125.0,IS,0.09,0.0,Phase3-EA-TR1v1-EURJPY-M30-91,EURJPYMT4,314,8h 59m,Sell
44177.65,149677,13.07.2009 05:09:58,tp 149.677,0.0,-0.0,0.0,0.0,150067,13.07.2009 03:15:00,3709,-0.0,96.91,IS,0.23,0.0,Phase3-EA-S4v1-GBPJPY-M5-194,GBPJPYMT4,994,1h 54m,Sell
44178.68,92362,13.07.2009 08:15:00,,-1.31,-0.0,0.0,0.0,92.37,10.07.2009 19:15:00,3710,-0.0,1.03,IS,0.27,0.0,Phase3-EA-S1v2-USDJPY-M15-0,USDJPYMT4,1360,2d 13h 0m,Sell
44102.1,128.09,13.07.2009 09:29:57,sl 128.090,-0.48,-76.5799999999872,0.0,0.0,128.87,10.07.2009 20:00:00,3711,-0.057073150518388786,-76.58,IS,0.09,0.0,Phase3-EA-TR1v1-EURJPY-M30-91,EURJPYMT4,316,2d 13h 29m,Buy
44140.68,1.51333,13.07.2009 13:15:00,,0.0,-38.0,0.0,0.0,1.51456,13.07.2009 04:30:00,3712,-0.028320445543211496,38.58,IS,0.34,0.0,Phase3-EA-S4v1-EURCHF-M15-221,EURCHFMT4,950,8h 45m,Sell
44058.49,1081,14.07.2009 03:30:00,,-0.64,-120.19000000000233,0.0,0.0,1.08252,13.07.2009 23:15:00,3713,-0.08957458815364884,-82.19,IS,0.58,0.0,Phase3-EA-SA2v2-USDCHF-M15-107,USDCHFMT4,802,4h 15m,Buy
44155.07,150.75,14.07.2009 04:34:58,tp 150.750,0.0,-23.610000000015134,0.0,0.0,151.14,14.07.2009 01:30:00,3714,-0.01759593998093821,96.58,IS,0.23,0.0,Phase3-EA-S4v1-GBPJPY-M5-194,GBPJPYMT4,996,3h 4m,Sell
44179.71,130187,14.07.2009 07:30:00,,0.0,-0.0,0.0,0.0,130052,14.07.2009 07:15:00,3715,-0.0,24.64,IS,0.17,0.0,Phase3-EA-T1v2-EURJPY-M15-322,EURJPYMT4,230,15m 0s,Buy
44110.06,129643,14.07.2009 16:29:57,sl 129.643,0.0,-69.64999999999418,0.0,0.0,130363,14.07.2009 03:00:00,3716,-0.051907997118188894,-69.65,IS,0.09,0.0,Phase3-EA-TR1v1-EURJPY-M30-91,EURJPYMT4,318,13h 29m,Buy
43913.23,152815,14.07.2009 23:39:58,sl 152.815,0.0,-266.4799999999814,0.0,0.0,152015,14.07.2009 23:05:00,3717,-0.19859932623194781,-196.83,IS,0.23,0.0,Phase3-EA-S4v1-GBPJPY-M5-194,GBPJPYMT4,998,34m 58s,Sell
44007.72,152423,15.07.2009 00:04:57,tp 152.423,-1.43,-171.9899999999907,0.0,0.0,152813,14.07.2009 23:50:00,3718,-0.12817884313506922,94.49,IS,0.23,0.0,Phase3-EA-S4v1-GBPJPY-M5-194,GBPJPYMT4,1000,14m 57s,Sell
43965.88,1.52098,15.07.2009 05:05:00,,-1.88,-213.8299999999872,0.0,0.0,1.51992,14.07.2009 20:45:00,3719,-0.1593609048640717,-41.84,IS,0.41,0.0,Phase3-EA-SA2v2-EURCHF-M5-43,EURCHFMT4,2092,8h 20m,Sell
44143.45,153264,15.07.2009 09:29:57,tp 153.264,-0.35,-36.25999999998021,0.0,0.0,151414,14.07.2009 08:00:00,3720,-0.027023459806240623,177.57,IS,0.09,0.0,Phase3-EA-B1v1-GBPJPY-M30-1,GBPJPYMT4,450,1d 1h 29m,Buy
44263.65,133.08,15.07.2009 19:59:58,tp 133.080,0.0,-0.0,0.0,0.0,131.82,15.07.2009 17:00:00,3721,-0.0,120.2,IS,0.09,0.0,Phase3-EA-TR1v1-EURJPY-M30-91,EURJPYMT4,320,2h 59m,Buy
44305.67,1.51681,15.07.2009 20:39:58,tp 1.51681,0.0,-0.0,0.0,0.0,1.51791,15.07.2009 20:00:00,3722,-0.0,42.02,IS,0.41,0.0,Phase3-EA-SA2v2-EURCHF-M5-43,EURCHFMT4,2094,39m 58s,Sell
44347.73,1.51604,15.07.2009 21:09:58,tp 1.51604,0.0,-0.0,0.0,0.0,1.51494,15.07.2009 20:50:00,3723,-0.0,42.06,IS,0.41,0.0,Phase3-EA-SA2v2-EURCHF-M5-43,EURCHFMT4,2096,19m 58s,Buy
44401.67,1.0752,16.07.2009 02:59:58,tp 1.07520,0.0,-0.0,0.0,0.0,1.0762,16.07.2009 02:30:00,3724,-0.0,53.94,IS,0.58,0.0,Phase3-EA-SA2v2-USDCHF-M15-107,USDCHFMT4,804,29m 58s,Sell
44496.78,154999,16.07.2009 03:19:57,tp 154.999,0.0,-0.0,0.0,0.0,154609,16.07.2009 01:15:00,3725,-0.0,95.11,IS,0.23,0.0,Phase3-EA-S4v1-GBPJPY-M5-194,GBPJPYMT4,1002,2h 4m,Buy
44519.1,94.37,16.07.2009 03:45:00,,0.0,-0.0,0.0,0.0,94292,16.07.2009 00:15:00,3726,-0.0,22.32,IS,0.27,0.0,Phase3-EA-S1v2-USDJPY-M15-0,USDJPYMT4,1362,3h 30m,Buy
44453.95,154098,16.07.2009 05:59:57,sl 154.098,-1.03,-65.14999999999418,0.0,0.0,154768,15.07.2009 20:00:00,3727,-0.04843178403661205,-65.15,IS,0.09,0.0,Phase3-EA-B1v1-GBPJPY-M30-1,GBPJPYMT4,452,9h 59m,Buy
44383.65,132.2,16.07.2009 07:29:57,sl 132.200,-1.4,-135.44999999998254,0.0,0.0,132.92,15.07.2009 20:00:00,3728,-0.10069202068701216,-70.3,IS,0.09,0.0,Phase3-EA-TR1v1-EURJPY-M30-91,EURJPYMT4,322,11h 29m,Buy
44341.8,132078,16.07.2009 17:29:58,sl 132.078,0.0,-177.29999999998836,0.0,0.0,131848,16.07.2009 17:15:00,3729,-0.13180284435443623,-41.85,IS,0.17,0.0,Phase3-EA-T1v2-EURJPY-M15-322,EURJPYMT4,232,14m 58s,Sell
44300.04,132.26,16.07.2009 18:14:57,sl 132.260,0.0,-219.05999999999767,0.0,0.0,132.03,16.07.2009 17:30:00,3730,-0.16284676302472864,-41.76,IS,0.17,0.0,Phase3-EA-T1v2-EURJPY-M15-322,EURJPYMT4,234,44m 57s,Sell
44342.02,1.51756,16.07.2009 20:59:59,tp 1.51756,0.0,-177.0799999999872,0.0,0.0,1.51866,16.07.2009 20:50:00,3731,-0.131639298805885,41.98,IS,0.41,0.0,Phase3-EA-SA2v2-EURCHF-M5-43,EURCHFMT4,2098,9m 59s,Sell
44395.38,1.07382,17.07.2009 00:44:57,tp 1.07382,-0.65,-123.72000000000116,0.0,0.0,1.07282,16.07.2009 23:45:00,3732,-0.09197206939386392,53.36,IS,0.58,0.0,Phase3-EA-SA2v2-USDCHF-M15-107,USDCHFMT4,806,59m 57s,Buy
44393.51,93692,17.07.2009 04:15:00,,-1.29,-125.58999999999651,0.0,0.0,93.69,16.07.2009 21:00:00,3733,-0.09336220655653847,-1.87,IS,0.27,0.0,Phase3-EA-S1v2-USDJPY-M15-0,USDJPYMT4,1364,7h 15m,Sell
44196.91,153047,17.07.2009 04:34:57,sl 153.047,0.0,-322.1900000000023,0.0,0.0,153847,17.07.2009 01:20:00,3734,-0.23951245585199607,-196.6,IS,0.23,0.0,Phase3-EA-S4v1-GBPJPY-M5-194,GBPJPYMT4,1004,3h 14m,Buy
44155.18,132313,17.07.2009 07:59:58,sl 132.313,0.0,-363.9200000000128,0.0,0.0,132083,17.07.2009 04:30:00,3735,-0.27053407285657793,-41.73,IS,0.17,0.0,Phase3-EA-T1v2-EURJPY-M15-322,EURJPYMT4,236,3h 29m,Sell
44204.68,1.51914,17.07.2009 14:00:00,,0.0,-314.4200000000128,0.0,0.0,1.51757,17.07.2009 05:15:00,3736,-0.23373632443274814,49.5,IS,0.34,0.0,Phase3-EA-S4v1-EURCHF-M15-221,EURCHFMT4,952,8h 45m,Buy
44162.96,132272,17.07.2009 15:14:57,sl 132.272,0.0,-356.14000000001397,0.0,0.0,132042,17.07.2009 15:00:00,3737,-0.2647505075487526,-41.72,IS,0.17,0.0,Phase3-EA-T1v2-EURJPY-M15-322,EURJPYMT4,238,14m 57s,Sell
44214.05,1.0752,20.07.2009 02:59:59,tp 1.07520,-2.85,-305.05000000001746,0.0,0.0,1.0762,17.07.2009 22:45:00,3738,-0.22677077084222058,51.09,IS,0.58,0.0,Phase3-EA-SA2v2-USDCHF-M15-107,USDCHFMT4,808,2d 4h 14m,Sell
44202.06,1.51968,20.07.2009 04:20:00,,-0.91,-317.04000000000815,0.0,0.0,1.51997,17.07.2009 20:00:00,3739,-0.23568400323820798,-11.99,IS,0.41,0.0,Phase3-EA-SA2v2-EURCHF-M5-43,EURCHFMT4,2100,2d 8h 20m,Buy
44007.52,155185,20.07.2009 05:34:57,sl 155.185,0.0,-511.5800000000163,0.0,0.0,154385,20.07.2009 03:05:00,3740,-0.38030287148815034,-194.54,IS,0.23,0.0,Phase3-EA-S4v1-GBPJPY-M5-194,GBPJPYMT4,1006,2h 29m,Sell
44047.32,1.5199,20.07.2009 15:00:00,,0.0,-471.78000000002794,0.0,0.0,1.52115,20.07.2009 06:15:00,3741,-0.35071599497768574,39.8,IS,0.34,0.0,Phase3-EA-S4v1-EURCHF-M15-221,EURCHFMT4,954,8h 45m,Sell
44072.47,94482,20.07.2009 17:45:00,,0.0,-446.63000000003376,0.0,0.0,94.57,20.07.2009 17:00:00,3742,-0.33201976522295634,25.15,IS,0.27,0.0,Phase3-EA-S1v2-USDJPY-M15-0,USDJPYMT4,1366,45m 0s,Sell
44112.79,1.51884,21.07.2009 01:39:58,tp 1.51884,-1.92,-406.3100000000268,0.0,0.0,1.51994,20.07.2009 21:40:00,3743,-0.30204632650681346,40.32,IS,0.41,0.0,Phase3-EA-SA2v2-EURCHF-M5-43,EURCHFMT4,2102,3h 59m,Sell
44043.41,133281,21.07.2009 04:59:58,sl 133.281,-0.47,-475.69000000003143,0.0,0.0,134001,20.07.2009 06:30:00,3744,-0.3536226454087424,-69.38,IS,0.09,0.0,Phase3-EA-TR1v1-EURJPY-M30-91,EURJPYMT4,324,22h 29m,Buy
43978.94,154886,21.07.2009 04:59:58,sl 154.886,-0.34,-540.1600000000326,0.0,0.0,155556,20.07.2009 09:30:00,3745,-0.4015489250225676,-64.47,IS,0.09,0.0,Phase3-EA-B1v1-GBPJPY-M30-1,GBPJPYMT4,454,19h 29m,Buy
43963.78,155.14,21.07.2009 09:15:00,,0.0,-555.3200000000361,0.0,0.0,155202,21.07.2009 03:50:00,3746,-0.4128187000954037,-15.16,IS,0.23,0.0,Phase3-EA-S4v1-GBPJPY-M5-194,GBPJPYMT4,1008,5h 25m,Buy
43888.53,133046,21.07.2009 18:59:58,sl 133.046,0.0,-630.5700000000361,0.0,0.0,133826,21.07.2009 11:30:00,3747,-0.4687587115881955,-75.25,IS,0.09,0.0,Phase3-EA-TR1v1-EURJPY-M30-91,EURJPYMT4,326,7h 29m,Buy
43930.72,1.51557,21.07.2009 20:49:58,tp 1.51557,0.0,-588.3800000000338,0.0,0.0,1.51447,21.07.2009 20:00:00,3748,-0.43739513570937805,42.19,IS,0.41,0.0,Phase3-EA-SA2v2-EURCHF-M5-43,EURCHFMT4,2104,49m 58s,Buy
44025.19,153765,22.07.2009 02:29:58,tp 153.765,-1.42,-493.9100000000326,0.0,0.0,154155,21.07.2009 23:30:00,3749,-0.3671671903841408,94.47,IS,0.23,0.0,Phase3-EA-S4v1-GBPJPY-M5-194,GBPJPYMT4,1010,2h 59m,Sell
44078.86,1.06772,22.07.2009 02:59:59,tp 1.06772,-0.65,-440.2400000000198,0.0,0.0,1.06672,21.07.2009 23:30:00,3750,-0.3272695104264152,53.67,IS,0.58,0.0,Phase3-EA-SA2v2-USDCHF-M15-107,USDCHFMT4,810,3h 29m,Buy
44094.3,93562,22.07.2009 03:00:00,,-1.3,-424.80000000001746,0.0,0.0,93.62,21.07.2009 22:15:00,3751,-0.3157915864736068,15.44,IS,0.27,0.0,Phase3-EA-S1v2-USDJPY-M15-0,USDJPYMT4,1368,4h 45m,Sell
44090.08,1.5164,22.07.2009 06:15:00,,-1.92,-429.0200000000186,0.0,0.0,1.51634,21.07.2009 21:55:00,3752,-0.3189286874503463,-4.22,IS,0.41,0.0,Phase3-EA-SA2v2-EURCHF-M5-43,EURCHFMT4,2106,8h 20m,Sell
44042.46,153544,22.07.2009 08:00:00,,0.0,-476.64000000001397,0.0,0.0,153738,22.07.2009 02:35:00,3753,-0.35432886482292414,-47.62,IS,0.23,0.0,Phase3-EA-S4v1-GBPJPY-M5-194,GBPJPYMT4,1012,5h 25m,Buy
44000.46,1.6398,22.07.2009 13:59:58,sl 1.63980,0.0,-518.640000000014,0.0,0.0,1.6368,22.07.2009 09:00:00,3754,-0.38555119681890093,-42.0,IS,0.14,0.0,Phase3-EA-B1v1-GBPUSD-M30-14,GBPUSDMT4,240,4h 59m,Sell
43997.91,1.5166,22.07.2009 14:30:00,,0.0,-521.1900000000023,0.0,0.0,1.51652,22.07.2009 05:45:00,3755,-0.3874468384043623,-2.55,IS,0.34,0.0,Phase3-EA-S4v1-EURCHF-M15-221,EURCHFMT4,956,8h 45m,Sell
43922.86,132.15,22.07.2009 15:29:58,sl 132.150,0.0,-596.2399999999907,0.0,0.0,132.93,22.07.2009 09:00:00,3756,-0.44323817212573596,-75.05,IS,0.09,0.0,Phase3-EA-TR1v1-EURJPY-M30-91,EURJPYMT4,328,6h 29m,Buy
43880.47,133453,22.07.2009 18:14:58,sl 133.453,-0.63,-638.6300000000047,0.0,0.0,133223,21.07.2009 18:00:00,3757,-0.4747504257759715,-42.39,IS,0.17,0.0,Phase3-EA-T1v2-EURJPY-M15-322,EURJPYMT4,240,1d 0h 14m,Sell
43917.72,93.71,23.07.2009 03:15:00,,-2.51,-601.3800000000047,0.0,0.0,93572,22.07.2009 22:00:00,3758,-0.44705919085096824,37.25,IS,0.27,0.0,Phase3-EA-S1v2-USDJPY-M15-0,USDJPYMT4,1370,5h 15m,Buy
43957.28,1.5164,23.07.2009 04:59:58,tp 1.51640,-2.77,-561.820000000007,0.0,0.0,1.5153,22.07.2009 23:10:00,3759,-0.41765072766618805,39.56,IS,0.41,0.0,Phase3-EA-SA2v2-EURCHF-M5-43,EURCHFMT4,2108,5h 49m,Buy
43757.41,154879,23.07.2009 05:09:58,sl 154.879,-4.27,-761.6900000000023,0.0,0.0,154079,22.07.2009 23:45:00,3760,-0.5662318585241818,-199.87,IS,0.23,0.0,Phase3-EA-S4v1-GBPJPY-M5-194,GBPJPYMT4,1014,5h 24m,Sell
43633.42,1.52007,23.07.2009 12:44:58,sl 1.52007,0.0,-885.679999999993,0.0,0.0,1.51617,23.07.2009 06:30:00,3761,-0.6584046429094406,-123.99,IS,0.34,0.0,Phase3-EA-S4v1-EURCHF-M15-221,EURCHFMT4,958,6h 14m,Sell
43938.2,135071,23.07.2009 17:14:58,tp 135.071,0.0,-580.8999999999942,0.0,0.0,133371,23.07.2009 04:15:00,3762,-0.43183458705863653,304.78,IS,0.17,0.0,Phase3-EA-T1v2-EURJPY-M15-322,EURJPYMT4,242,12h 59m,Buy
44113.18,157578,23.07.2009 20:59:57,tp 157.578,0.0,-405.9199999999837,0.0,0.0,155728,23.07.2009 09:30:00,3763,-0.3017564048525331,174.98,IS,0.09,0.0,Phase3-EA-B1v1-GBPJPY-M30-1,GBPJPYMT4,456,11h 29m,Buy
44155.23,1.52251,23.07.2009 21:09:58,tp 1.52251,0.0,-363.86999999999534,0.0,0.0,1.52361,23.07.2009 20:55:00,3764,-0.2704969034137126,42.05,IS,0.41,0.0,Phase3-EA-SA2v2-EURCHF-M5-43,EURCHFMT4,2110,14m 58s,Sell
43960.21,156.13,24.07.2009 04:09:58,sl 156.130,-0.87,-558.8899999999849,0.0,0.0,156.93,23.07.2009 23:10:00,3765,-0.4154725983150237,-195.02,IS,0.23,0.0,Phase3-EA-S4v1-GBPJPY-M5-194,GBPJPYMT4,1016,4h 59m,Buy
43968.07,1.52089,24.07.2009 08:10:00,,-0.92,-551.0299999999988,0.0,0.0,1.52066,23.07.2009 23:50:00,3766,-0.40962956189864413,7.86,IS,0.41,0.0,Phase3-EA-SA2v2-EURCHF-M5-43,EURCHFMT4,2112,8h 20m,Buy
43998.83,1.52176,24.07.2009 09:45:00,,0.0,-520.2699999999895,0.0,0.0,1.52079,24.07.2009 01:00:00,3767,-0.3867629206558695,30.76,IS,0.34,0.0,Phase3-EA-S4v1-EURCHF-M15-221,EURCHFMT4,960,8h 45m,Buy
43934.81,94.84,24.07.2009 10:45:00,,-0.82,-584.289999999979,0.0,0.0,95062,23.07.2009 23:15:00,3768,-0.43435467528401484,-64.02,IS,0.27,0.0,Phase3-EA-S1v2-USDJPY-M15-0,USDJPYMT4,1372,11h 30m,Buy
43976.95,1.52195,24.07.2009 22:09:58,tp 1.52195,0.0,-542.1499999999651,0.0,0.0,1.52085,24.07.2009 21:30:00,3769,-0.4030282688480411,42.14,IS,0.41,0.0,Phase3-EA-SA2v2-EURCHF-M5-43,EURCHFMT4,2114,39m 58s,Buy
44028.28,1.0702,27.07.2009 01:00:00,tp 1.07020,-2.87,-490.8199999999779,0.0,0.0,1.0712,24.07.2009 22:30:00,3770,-0.3648701188158247,51.33,IS,0.58,0.0,Phase3-EA-SA2v2-USDCHF-M15-107,USDCHFMT4,812,2d 2h 30m,Sell
44082.4,1.0716,27.07.2009 04:14:59,tp 1.07160,0.0,-436.69999999998254,0.0,0.0,1.0726,27.07.2009 02:45:00,3771,-0.3246379138724409,54.12,IS,0.58,0.0,Phase3-EA-SA2v2-USDCHF-M15-107,USDCHFMT4,814,1h 29m,Sell
44041.14,134846,27.07.2009 06:29:58,sl 134.846,0.0,-477.95999999999185,0.0,0.0,134616,27.07.2009 05:30:00,3772,-0.3553101381142098,-41.26,IS,0.17,0.0,Phase3-EA-T1v2-EURJPY-M15-322,EURJPYMT4,244,59m 58s,Sell
44011.65,1.52298,27.07.2009 07:05:00,,-1.91,-507.44999999998254,0.0,0.0,1.52226,24.07.2009 22:45:00,3773,-0.37723267550852085,-29.49,IS,0.41,0.0,Phase3-EA-SA2v2-EURCHF-M5-43,EURCHFMT4,2116,2d 8h 20m,Sell
44130.01,135736,27.07.2009 12:59:58,tp 135.736,-0.93,-389.0899999999965,0.0,0.0,134476,23.07.2009 09:30:00,3774,-0.2892451703884405,118.36,IS,0.09,0.0,Phase3-EA-TR1v1-EURJPY-M30-91,EURJPYMT4,330,4d 3h 29m,Buy
44088.01,1.64722,27.07.2009 17:59:57,sl 1.64722,0.0,-431.0899999999965,0.0,0.0,1.65022,27.07.2009 14:30:00,3775,-0.3204675023844173,-42.0,IS,0.14,0.0,Phase3-EA-B1v1-GBPUSD-M30-14,GBPUSDMT4,242,3h 29m,Buy
44142.18,1.07062,27.07.2009 22:29:58,tp 1.07062,0.0,-376.9199999999837,0.0,0.0,1.06962,27.07.2009 22:00:00,3776,-0.2801981279981682,54.17,IS,0.58,0.0,Phase3-EA-SA2v2-USDCHF-M15-107,USDCHFMT4,816,29m 58s,Buy
44183.37,1.52433,28.07.2009 02:34:57,tp 1.52433,-0.92,-335.7299999999814,0.0,0.0,1.52323,27.07.2009 21:45:00,3777,-0.24957794097639777,41.19,IS,0.41,0.0,Phase3-EA-SA2v2-EURCHF-M5-43,EURCHFMT4,2118,4h 49m,Buy
44142.29,135364,28.07.2009 03:14:57,sl 135.364,0.0,-376.80999999996857,0.0,0.0,135594,28.07.2009 00:45:00,3778,-0.28011635522388173,-41.08,IS,0.17,0.0,Phase3-EA-T1v2-EURJPY-M15-322,EURJPYMT4,246,2h 29m,Buy
44108.71,1.07072,28.07.2009 04:30:00,,0.0,-410.38999999995576,0.0,0.0,1.0701,28.07.2009 00:15:00,3779,-0.3050793530435127,-33.58,IS,0.58,0.0,Phase3-EA-SA2v2-USDCHF-M15-107,USDCHFMT4,818,4h 15m,Sell
44040.0,135026,28.07.2009 05:59:58,sl 135.026,-0.46,-479.0999999999476,0.0,0.0,135746,27.07.2009 13:00:00,3780,-0.35615760141121056,-68.71,IS,0.09,0.0,Phase3-EA-TR1v1-EURJPY-M30-91,EURJPYMT4,332,16h 59m,Buy
44134.34,156.86,28.07.2009 07:14:57,tp 156.860,0.0,-384.7599999999511,0.0,0.0,156.47,28.07.2009 03:40:00,3781,-0.28602629663739293,94.34,IS,0.23,0.0,Phase3-EA-S4v1-GBPJPY-M5-194,GBPJPYMT4,1018,3h 34m,Buy
44140.49,1.52405,28.07.2009 11:10:00,,0.0,-378.6099999999569,0.0,0.0,1.52421,28.07.2009 02:50:00,3782,-0.2814544551665578,6.15,IS,0.41,0.0,Phase3-EA-SA2v2-EURCHF-M5-43,EURCHFMT4,2120,8h 20m,Sell
44099.19,135297,28.07.2009 13:29:58,sl 135.297,0.0,-419.9099999999453,0.0,0.0,135067,28.07.2009 12:30:00,3783,-0.312156414962593,-41.3,IS,0.17,0.0,Phase3-EA-T1v2-EURJPY-M15-322,EURJPYMT4,248,59m 58s,Sell
44057.19,1.64872,28.07.2009 14:59:58,sl 1.64872,0.0,-461.9099999999453,0.0,0.0,1.65172,28.07.2009 08:30:00,3784,-0.3433787469585698,-42.0,IS,0.14,0.0,Phase3-EA-B1v1-GBPUSD-M30-14,GBPUSDMT4,244,6h 29m,Buy
44015.19,1.6481,28.07.2009 16:59:58,sl 1.64810,0.0,-503.9099999999453,0.0,0.0,1.6451,28.07.2009 16:30:00,3785,-0.3746010789545466,-42.0,IS,0.14,0.0,Phase3-EA-B1v1-GBPUSD-M30-14,GBPUSDMT4,246,29m 58s,Sell
44080.32,94522,28.07.2009 17:30:00,,0.0,-438.7799999999406,0.0,0.0,94.75,28.07.2009 17:00:00,3786,-0.32618416269506767,65.13,IS,0.27,0.0,Phase3-EA-S1v2-USDJPY-M15-0,USDJPYMT4,1374,30m 0s,Sell
44092.75,94462,29.07.2009 02:15:00,,-1.29,-426.3499999999476,0.0,0.0,94.51,28.07.2009 21:00:00,3787,-0.31694383920197783,12.43,IS,0.27,0.0,Phase3-EA-S1v2-USDJPY-M15-0,USDJPYMT4,1376,5h 15m,Sell
44187.63,155227,29.07.2009 03:29:58,tp 155.227,0.0,-331.46999999994296,0.0,0.0,154837,29.07.2009 02:10:00,3788,-0.2464111044453487,94.88,IS,0.23,0.0,Phase3-EA-S4v1-GBPJPY-M5-194,GBPJPYMT4,1020,1h 19m,Buy
44146.26,134083,29.07.2009 03:44:58,sl 134.083,0.0,-372.8399999999383,0.0,0.0,133853,29.07.2009 01:30:00,3789,-0.2771651014613824,-41.37,IS,0.17,0.0,Phase3-EA-T1v2-EURJPY-M15-322,EURJPYMT4,250,2h 14m,Sell
44241.33,155148,29.07.2009 06:29:57,tp 155.148,0.0,-277.7699999999313,0.0,0.0,155538,29.07.2009 03:55:00,3790,-0.20649112282191256,95.07,IS,0.23,0.0,Phase3-EA-S4v1-GBPJPY-M5-194,GBPJPYMT4,1022,2h 34m,Sell
44166.39,133284,29.07.2009 09:29:58,sl 133.284,-0.47,-352.70999999993364,0.0,0.0,134064,28.07.2009 23:30:00,3791,-0.26220068376902145,-74.94,IS,0.09,0.0,Phase3-EA-TR1v1-EURJPY-M30-91,EURJPYMT4,334,9h 59m,Buy
44124.99,133851,29.07.2009 11:29:57,sl 133.851,0.0,-394.1099999999278,0.0,0.0,133621,29.07.2009 06:45:00,3792,-0.2929769824507657,-41.4,IS,0.17,0.0,Phase3-EA-T1v2-EURJPY-M15-322,EURJPYMT4,252,4h 44m,Sell
44095.6,1.52238,29.07.2009 11:45:00,,0.0,-423.4999999999418,0.0,0.0,1.52331,29.07.2009 03:00:00,3793,-0.31482518095938933,-29.39,IS,0.34,0.0,Phase3-EA-S4v1-EURCHF-M15-221,EURCHFMT4,962,8h 45m,Buy
44054.44,133857,29.07.2009 16:59:57,sl 133.857,0.0,-464.6599999999453,0.0,0.0,133627,29.07.2009 16:30:00,3794,-0.3454230663154492,-41.16,IS,0.17,0.0,Phase3-EA-T1v2-EURJPY-M15-322,EURJPYMT4,254,29m 57s,Sell
44095.88,1.52637,29.07.2009 21:44:59,tp 1.52637,0.0,-423.21999999994296,0.0,0.0,1.52747,29.07.2009 20:20:00,3795,-0.31461703207941705,41.44,IS,0.41,0.0,Phase3-EA-SA2v2-EURCHF-M5-43,EURCHFMT4,2122,1h 24m,Sell
44134.59,1.52705,30.07.2009 01:54:58,tp 1.52705,-2.72,-384.5099999999511,0.0,0.0,1.52595,29.07.2009 21:55:00,3796,-0.28584044942313114,38.71,IS,0.41,0.0,Phase3-EA-SA2v2-EURCHF-M5-43,EURCHFMT4,2124,3h 59m,Buy
44168.45,95.13,30.07.2009 02:45:00,,-2.47,-350.6499999999651,0.0,0.0,95002,29.07.2009 22:45:00,3797,-0.2606693027235279,33.86,IS,0.27,0.0,Phase3-EA-S1v2-USDJPY-M15-0,USDJPYMT4,1378,4h 0m,Buy
44221.78,1.0875,30.07.2009 03:14:58,tp 1.08750,0.0,-297.3199999999779,0.0,0.0,1.0885,30.07.2009 02:15:00,3798,-0.22102437497721733,53.33,IS,0.58,0.0,Phase3-EA-SA2v2-USDCHF-M15-107,USDCHFMT4,820,59m 58s,Sell
44178.87,133851,30.07.2009 03:29:58,sl 133.851,-1.88,-340.2299999999814,0.0,0.0,133621,29.07.2009 18:00:00,3799,-0.25292319083310955,-42.91,IS,0.17,0.0,Phase3-EA-T1v2-EURJPY-M15-322,EURJPYMT4,256,9h 29m,Sell
44273.16,155.67,30.07.2009 04:04:58,tp 155.670,0.0,-245.93999999997322,0.0,0.0,156.06,30.07.2009 03:20:00,3800,-0.1828290555021356,94.29,IS,0.23,0.0,Phase3-EA-S4v1-GBPJPY-M5-194,GBPJPYMT4,1024,44m 58s,Sell
44210.09,157294,30.07.2009 22:59:58,sl 157.294,0.0,-309.0099999999802,0.0,0.0,157964,30.07.2009 19:30:00,3801,-0.2297145907160993,-63.07,IS,0.09,0.0,Phase3-EA-B1v1-GBPJPY-M30-1,GBPJPYMT4,458,3h 29m,Buy
44215.61,1.53129,31.07.2009 04:25:00,,-0.9,-303.4899999999907,0.0,0.0,1.53112,30.07.2009 20:05:00,3802,-0.22561108422520726,5.52,IS,0.41,0.0,Phase3-EA-SA2v2-EURCHF-M5-43,EURCHFMT4,2126,8h 20m,Buy
44102.25,1.0847,31.07.2009 07:00:00,,0.0,-416.8499999999767,0.0,0.0,1.08682,31.07.2009 02:45:00,3803,-0.30988164506005234,-113.36,IS,0.58,0.0,Phase3-EA-SA2v2-USDCHF-M15-107,USDCHFMT4,822,4h 15m,Buy
44061.19,134371,31.07.2009 10:14:57,sl 134.371,0.0,-457.9099999999744,0.0,0.0,134601,31.07.2009 04:00:00,3804,-0.34040519153040316,-41.06,IS,0.17,0.0,Phase3-EA-T1v2-EURJPY-M15-322,EURJPYMT4,258,6h 14m,Buy
44048.51,95.6,31.07.2009 10:45:00,,-0.82,-470.5899999999674,0.0,0.0,95642,30.07.2009 21:30:00,3805,-0.34983136223775474,-12.68,IS,0.27,0.0,Phase3-EA-S1v2-USDJPY-M15-0,USDJPYMT4,1380,13h 15m,Buy
43974.8,135092,31.07.2009 13:59:58,sl 135.092,-0.33,-544.2999999999593,0.0,0.0,134312,30.07.2009 23:30:00,3806,-0.40462655489068794,-73.71,IS,0.09,0.0,Phase3-EA-TR1v1-EURJPY-M30-91,EURJPYMT4,336,14h 29m,Sell
43977.31,1.53202,31.07.2009 14:45:00,,0.0,-541.7899999999499,0.0,0.0,1.5321,31.07.2009 06:00:00,3807,-0.4027606488594929,2.51,IS,0.34,0.0,Phase3-EA-S4v1-EURCHF-M15-221,EURCHFMT4,964,8h 45m,Sell
43935.94,134847,31.07.2009 18:29:58,sl 134.847,0.0,-583.1599999999453,0.0,0.0,135077,31.07.2009 17:45:00,3808,-0.43351464587552657,-41.37,IS,0.17,0.0,Phase3-EA-T1v2-EURJPY-M15-322,EURJPYMT4,260,44m 58s,Buy
43894.62,134869,31.07.2009 22:59:57,sl 134.869,0.0,-624.4799999999523,0.0,0.0,135099,31.07.2009 21:15:00,3809,-0.46423147344871657,-41.32,IS,0.17,0.0,Phase3-EA-T1v2-EURJPY-M15-322,EURJPYMT4,262,1h 44m,Buy
43989.37,158.43,03.08.2009 03:54:58,tp 158.430,0.0,-529.7299999999523,0.0,0.0,158.82,03.08.2009 02:30:00,3810,-0.393795379243507,94.75,IS,0.23,0.0,Phase3-EA-S4v1-GBPJPY-M5-194,GBPJPYMT4,1026,1h 24m,Sell
43969.41,1.52462,03.08.2009 10:10:00,,0.0,-549.6899999999441,0.0,0.0,1.5241,03.08.2009 01:50:00,3811,-0.4086334208301604,-19.96,IS,0.41,0.0,Phase3-EA-SA2v2-EURCHF-M5-43,EURCHFMT4,2128,8h 20m,Sell
43894.93,135478,03.08.2009 11:59:58,sl 135.478,-0.33,-624.1699999999546,0.0,0.0,134698,31.07.2009 16:30:00,3812,-0.4640010229030337,-74.48,IS,0.09,0.0,Phase3-EA-TR1v1-EURJPY-M30-91,EURJPYMT4,338,2d 19h 29m,Sell
43952.08,1.5242,03.08.2009 14:45:00,,0.0,-567.0199999999604,0.0,0.0,1.52599,03.08.2009 06:00:00,3813,-0.42151634972279817,57.15,IS,0.34,0.0,Phase3-EA-S4v1-EURCHF-M15-221,EURCHFMT4,966,8h 45m,Sell
44255.1,136965,03.08.2009 17:14:59,tp 136.965,0.0,-263.9999999999709,0.0,0.0,135265,03.08.2009 11:30:00,3814,-0.1962546582604039,303.02,IS,0.17,0.0,Phase3-EA-T1v2-EURJPY-M15-322,EURJPYMT4,264,5h 44m,Buy
44374.23,137367,03.08.2009 19:29:58,tp 137.367,0.0,-144.86999999996624,0.0,0.0,136107,03.08.2009 16:30:00,3815,-0.10769474372038342,119.13,IS,0.09,0.0,Phase3-EA-TR1v1-EURJPY-M30-91,EURJPYMT4,340,2h 59m,Buy
44429.01,1.0587,04.08.2009 02:29:57,tp 1.05870,0.0,-90.0899999999674,0.0,0.0,1.0597,04.08.2009 01:45:00,3816,-0.06697190213134598,54.78,IS,0.58,0.0,Phase3-EA-SA2v2-USDCHF-M15-107,USDCHFMT4,824,44m 57s,Sell
44414.7,1.52711,04.08.2009 04:20:00,,-1.94,-104.39999999996508,0.0,0.0,1.52679,03.08.2009 20:00:00,3817,-0.07760979667568776,-14.31,IS,0.41,0.0,Phase3-EA-SA2v2-EURCHF-M5-43,EURCHFMT4,2130,8h 20m,Sell
44373.7,137125,04.08.2009 07:14:58,sl 137.125,0.0,-145.39999999996508,0.0,0.0,137355,04.08.2009 05:15:00,3818,-0.10808873981461749,-41.0,IS,0.17,0.0,Phase3-EA-T1v2-EURJPY-M15-322,EURJPYMT4,266,1h 59m,Buy
44304.99,136556,04.08.2009 10:59:57,sl 136.556,-0.46,-214.10999999995693,0.0,0.0,137276,03.08.2009 19:30:00,3819,-0.15916698818231537,-68.71,IS,0.09,0.0,Phase3-EA-TR1v1-EURJPY-M30-91,EURJPYMT4,342,15h 29m,Buy
44180.42,1.53168,04.08.2009 12:44:58,sl 1.53168,0.0,-338.6799999999639,0.0,0.0,1.52778,04.08.2009 05:15:00,3820,-0.2517709381046736,-124.57,IS,0.34,0.0,Phase3-EA-S4v1-EURCHF-M15-221,EURCHFMT4,968,7h 29m,Sell
44073.62,95182,05.08.2009 06:30:00,,-1.28,-445.47999999995227,0.0,0.0,94.81,04.08.2009 17:00:00,3821,-0.33116486803729167,-106.8,IS,0.27,0.0,Phase3-EA-S1v2-USDJPY-M15-0,USDJPYMT4,1382,13h 30m,Sell
44167.92,161075,05.08.2009 06:39:58,tp 161.075,0.0,-351.1799999999639,0.0,0.0,161465,05.08.2009 02:15:00,3822,-0.26106329881776197,94.3,IS,0.23,0.0,Phase3-EA-S4v1-GBPJPY-M5-194,GBPJPYMT4,1028,4h 24m,Sell
44126.72,136777,05.08.2009 18:14:58,sl 136.777,0.0,-392.37999999997555,0.0,0.0,136547,05.08.2009 17:30:00,3823,-0.29169091972810973,-41.2,IS,0.17,0.0,Phase3-EA-T1v2-EURJPY-M15-322,EURJPYMT4,268,44m 58s,Sell
44181.36,1.06142,05.08.2009 22:44:58,tp 1.06142,0.0,-337.7399999999616,0.0,0.0,1.06042,05.08.2009 22:00:00,3824,-0.25107215257904764,54.64,IS,0.58,0.0,Phase3-EA-SA2v2-USDCHF-M15-107,USDCHFMT4,826,44m 58s,Buy
44110.1,94.99,06.08.2009 04:00:00,,-2.47,-408.9999999999709,0.0,0.0,95232,05.08.2009 17:00:00,3825,-0.3040460425322285,-71.26,IS,0.27,0.0,Phase3-EA-S1v2-USDJPY-M15-0,USDJPYMT4,1384,11h 0m,Buy
44124.38,1.52925,06.08.2009 06:25:00,,-5.79,-394.71999999997206,0.0,0.0,1.52977,05.08.2009 22:05:00,3826,-0.29343044965359727,14.28,IS,0.41,0.0,Phase3-EA-SA2v2-EURCHF-M5-43,EURCHFMT4,2132,8h 20m,Sell
44083.25,137.02,06.08.2009 07:59:58,sl 137.020,0.0,-435.8499999999767,0.0,0.0,136.79,06.08.2009 06:30:00,3827,-0.32400603334394656,-41.13,IS,0.17,0.0,Phase3-EA-T1v2-EURJPY-M15-322,EURJPYMT4,270,1h 29m,Sell
44139.1,95.72,06.08.2009 20:15:00,,0.0,-379.9999999999709,0.0,0.0,95522,06.08.2009 17:15:00,3828,-0.2824877656778636,55.85,IS,0.27,0.0,Phase3-EA-S1v2-USDJPY-M15-0,USDJPYMT4,1386,3h 0m,Buy
44095.42,1.52846,07.08.2009 04:25:00,,-0.92,-423.6799999999639,0.0,0.0,1.52957,06.08.2009 20:05:00,3829,-0.31495899095367424,-43.68,IS,0.41,0.0,Phase3-EA-SA2v2-EURCHF-M5-43,EURCHFMT4,2134,8h 20m,Buy
44189.46,159846,07.08.2009 04:54:58,tp 159.846,0.0,-329.63999999995576,0.0,0.0,160236,07.08.2009 01:55:00,3830,-0.2450507028369621,94.04,IS,0.23,0.0,Phase3-EA-S4v1-GBPJPY-M5-194,GBPJPYMT4,1030,2h 59m,Sell
44148.47,137047,07.08.2009 08:59:57,sl 137.047,0.0,-370.62999999994645,0.0,0.0,136817,07.08.2009 05:00:00,3831,-0.2755222120873144,-40.99,IS,0.17,0.0,Phase3-EA-T1v2-EURJPY-M15-322,EURJPYMT4,272,3h 59m,Sell
44084.71,161404,07.08.2009 15:59:57,sl 161.404,-0.55,-434.38999999995576,0.0,0.0,160734,06.08.2009 17:00:00,3832,-0.3229206856126423,-63.76,IS,0.09,0.0,Phase3-EA-B1v1-GBPJPY-M30-1,GBPJPYMT4,460,22h 59m,Sell
44011.89,138028,07.08.2009 15:59:58,sl 138.028,-0.33,-507.20999999996275,0.0,0.0,137248,06.08.2009 18:30:00,3833,-0.37705426218281485,-72.82,IS,0.09,0.0,Phase3-EA-TR1v1-EURJPY-M30-91,EURJPYMT4,344,21h 29m,Sell
44053.61,1.53412,07.08.2009 20:24:57,tp 1.53412,0.0,-465.4899999999616,0.0,0.0,1.53522,07.08.2009 20:05:00,3834,-0.3460400790668104,41.72,IS,0.41,0.0,Phase3-EA-SA2v2-EURCHF-M5-43,EURCHFMT4,2136,19m 57s,Sell
44095.26,1.53495,07.08.2009 21:04:58,tp 1.53495,0.0,-423.8399999999674,0.0,0.0,1.53385,07.08.2009 20:55:00,3835,-0.3150779331708044,41.65,IS,0.41,0.0,Phase3-EA-SA2v2-EURCHF-M5-43,EURCHFMT4,2138,9m 58s,Buy
44136.07,1.53435,10.08.2009 01:04:58,tp 1.53435,-0.91,-383.02999999996973,0.0,0.0,1.53325,07.08.2009 23:50:00,3836,-0.28474023391471537,40.81,IS,0.41,0.0,Phase3-EA-SA2v2-EURCHF-M5-43,EURCHFMT4,2140,2d 1h 14m,Buy
44177.8,1.53536,10.08.2009 05:29:58,tp 1.53536,0.0,-341.29999999995925,0.0,0.0,1.53426,10.08.2009 01:05:00,3837,-0.2537186169101335,41.73,IS,0.41,0.0,Phase3-EA-SA2v2-EURCHF-M5-43,EURCHFMT4,2142,4h 24m,Buy
44112.32,1.0807,10.08.2009 05:45:00,,0.0,-406.77999999996973,0.0,0.0,1.08192,10.08.2009 01:30:00,3838,-0.3023957192695832,-65.48,IS,0.58,0.0,Phase3-EA-SA2v2-USDCHF-M15-107,USDCHFMT4,828,4h 15m,Buy
44116.34,162389,10.08.2009 08:15:00,,0.0,-402.7599999999802,0.0,0.0,162372,10.08.2009 02:50:00,3839,-0.29940729606426175,4.02,IS,0.23,0.0,Phase3-EA-S4v1-GBPJPY-M5-194,GBPJPYMT4,1032,5h 25m,Buy
44053.94,97.3,10.08.2009 09:15:00,,-0.8,-465.1599999999744,0.0,0.0,97522,07.08.2009 22:30:00,3840,-0.3457947607439944,-62.4,IS,0.27,0.0,Phase3-EA-S1v2-USDJPY-M15-0,USDJPYMT4,1388,2d 10h 45m,Buy
44013.73,137944,10.08.2009 13:59:58,sl 137.944,0.0,-505.36999999996624,0.0,0.0,138174,10.08.2009 13:15:00,3841,-0.37568642668585084,-40.21,IS,0.17,0.0,Phase3-EA-T1v2-EURJPY-M15-322,EURJPYMT4,274,44m 58s,Buy
44278.33,1.6473,10.08.2009 19:29:58,tp 1.64730,0.0,-240.76999999996042,0.0,0.0,1.6662,10.08.2009 10:00:00,3842,-0.17898573511119276,264.6,IS,0.14,0.0,Phase3-EA-B1v1-GBPUSD-M30-14,GBPUSDMT4,248,9h 29m,Sell
44397.92,136934,10.08.2009 20:29:58,tp 136.934,0.0,-121.17999999996391,0.0,0.0,138224,10.08.2009 05:30:00,3843,-0.09008386169693668,119.59,IS,0.09,0.0,Phase3-EA-TR1v1-EURJPY-M30-91,EURJPYMT4,346,14h 59m,Sell
44419.63,97002,11.08.2009 01:15:00,,0.0,-99.46999999997206,0.0,0.0,97.08,11.08.2009 00:30:00,3844,-0.07394488961045093,21.71,IS,0.27,0.0,Phase3-EA-S1v2-USDJPY-M15-0,USDJPYMT4,1390,45m 0s,Sell
44410.73,97032,11.08.2009 02:00:00,,0.0,-108.36999999996624,0.0,0.0,97.0,11.08.2009 01:15:00,3845,-0.08056105043816549,-8.9,IS,0.27,0.0,Phase3-EA-S1v2-USDJPY-M15-0,USDJPYMT4,1392,45m 0s,Sell
44501.86,159647,11.08.2009 02:14:58,tp 159.647,-1.37,-17.239999999961583,0.0,0.0,160037,10.08.2009 23:20:00,3846,-0.012816023895462866,91.13,IS,0.23,0.0,Phase3-EA-S4v1-GBPJPY-M5-194,GBPJPYMT4,1034,2h 54m,Sell
44594.34,159993,11.08.2009 03:14:58,tp 159.993,0.0,-0.0,0.0,0.0,159603,11.08.2009 02:30:00,3847,-0.0,92.48,IS,0.23,0.0,Phase3-EA-S4v1-GBPJPY-M5-194,GBPJPYMT4,1036,44m 58s,Buy
44587.93,1.0851,11.08.2009 05:30:00,,0.0,-6.4100000000034925,0.0,0.0,1.08522,11.08.2009 01:15:00,3848,-0.004762458807705801,-6.41,IS,0.58,0.0,Phase3-EA-SA2v2-USDCHF-M15-107,USDCHFMT4,830,4h 15m,Buy
44759.82,159088,11.08.2009 05:59:58,tp 159.088,-0.54,-0.0,0.0,0.0,160938,10.08.2009 18:00:00,3849,-0.0,171.89,IS,0.09,0.0,Phase3-EA-B1v1-GBPJPY-M30-1,GBPJPYMT4,462,11h 59m,Sell
44759.82,1.53452,11.08.2009 08:45:00,,0.0,-0.0,0.0,0.0,1.53452,11.08.2009 00:25:00,3850,-0.0,0.0,IS,0.41,0.0,Phase3-EA-SA2v2-EURCHF-M5-43,EURCHFMT4,2144,8h 20m,Buy
44761.7,1.5344,11.08.2009 11:15:00,,0.0,-0.0,0.0,0.0,1.53434,11.08.2009 02:30:00,3851,-0.0,1.88,IS,0.34,0.0,Phase3-EA-S4v1-EURCHF-M15-221,EURCHFMT4,970,8h 45m,Buy
44721.19,136828,11.08.2009 13:59:58,sl 136.828,0.0,-40.51000000000931,0.0,0.0,136598,11.08.2009 13:15:00,3852,-0.03006046970319409,-40.51,IS,0.17,0.0,Phase3-EA-T1v2-EURJPY-M15-322,EURJPYMT4,276,44m 58s,Sell
44838.58,135804,11.08.2009 17:29:58,tp 135.804,-0.32,-0.0,0.0,0.0,137064,10.08.2009 21:30:00,3853,-0.0,117.39,IS,0.09,0.0,Phase3-EA-TR1v1-EURJPY-M30-91,EURJPYMT4,348,19h 59m,Sell
44845.19,95952,12.08.2009 03:00:00,,-1.27,-0.0,0.0,0.0,95.98,11.08.2009 21:45:00,3854,-0.0,6.61,IS,0.27,0.0,Phase3-EA-S1v2-USDJPY-M15-0,USDJPYMT4,1394,5h 15m,Sell
44852.0,1.53047,12.08.2009 07:05:00,,-1.9,-0.0,0.0,0.0,1.5307,11.08.2009 22:45:00,3855,-0.0,6.81,IS,0.41,0.0,Phase3-EA-SA2v2-EURCHF-M5-43,EURCHFMT4,2146,8h 20m,Sell
45025.68,157101,12.08.2009 09:29:58,tp 157.101,-0.54,-0.0,0.0,0.0,158951,11.08.2009 13:00:00,3856,-0.0,173.68,IS,0.09,0.0,Phase3-EA-B1v1-GBPJPY-M30-1,GBPJPYMT4,464,20h 29m,Sell
45144.16,134318,12.08.2009 10:29:58,tp 134.318,-0.33,-0.0,0.0,0.0,135578,11.08.2009 18:00:00,3857,-0.0,118.48,IS,0.09,0.0,Phase3-EA-TR1v1-EURJPY-M30-91,EURJPYMT4,350,16h 29m,Sell
45076.36,135105,12.08.2009 12:29:58,sl 135.105,0.0,-67.79999999998836,0.0,0.0,134385,12.08.2009 10:30:00,3858,-0.05016864953690071,-67.8,IS,0.09,0.0,Phase3-EA-TR1v1-EURJPY-M30-91,EURJPYMT4,352,1h 59m,Sell
45035.56,135.85,12.08.2009 14:14:57,sl 135.850,0.0,-108.59999999997672,0.0,0.0,135.62,12.08.2009 04:45:00,3859,-0.08035863332901452,-40.8,IS,0.17,0.0,Phase3-EA-T1v2-EURJPY-M15-322,EURJPYMT4,278,9h 29m,Sell
45156.8,136506,12.08.2009 16:59:57,tp 136.506,0.0,-0.0,0.0,0.0,135216,12.08.2009 12:30:00,3860,-0.0,121.24,IS,0.09,0.0,Phase3-EA-TR1v1-EURJPY-M30-91,EURJPYMT4,354,4h 29m,Buy
45268.74,96482,12.08.2009 21:29:58,tp 96.482,0.0,-0.0,0.0,0.0,96082,12.08.2009 21:15:00,3861,-0.0,111.94,IS,0.27,0.0,Phase3-EA-S1v2-USDJPY-M15-0,USDJPYMT4,1396,14m 58s,Buy
45362.14,158286,13.08.2009 04:39:58,tp 158.286,0.0,-0.0,0.0,0.0,158676,13.08.2009 01:25:00,3862,-0.0,93.4,IS,0.23,0.0,Phase3-EA-S4v1-GBPJPY-M5-194,GBPJPYMT4,1038,3h 14m,Sell
45398.38,1.52892,13.08.2009 04:54:57,tp 1.52892,-5.7,-0.0,0.0,0.0,1.53002,12.08.2009 21:20:00,3863,-0.0,36.24,IS,0.41,0.0,Phase3-EA-SA2v2-EURCHF-M5-43,EURCHFMT4,2148,7h 34m,Sell
45381.32,96.1,13.08.2009 08:30:00,,-2.45,-17.05999999999767,0.0,0.0,96152,12.08.2009 22:45:00,3864,-0.012599855330615974,-17.06,IS,0.27,0.0,Phase3-EA-S1v2-USDJPY-M15-0,USDJPYMT4,1398,9h 45m,Buy
45308.27,137116,13.08.2009 09:29:57,sl 137.116,0.0,-90.10999999998603,0.0,0.0,136336,13.08.2009 06:30:00,3865,-0.06655175637994046,-73.05,IS,0.09,0.0,Phase3-EA-TR1v1-EURJPY-M30-91,EURJPYMT4,356,2h 59m,Sell
45267.43,136371,13.08.2009 16:44:57,sl 136.371,0.0,-130.94999999998254,0.0,0.0,136601,13.08.2009 08:30:00,3866,-0.09671459880094765,-40.84,IS,0.17,0.0,Phase3-EA-T1v2-EURJPY-M15-322,EURJPYMT4,280,8h 14m,Buy
45389.58,135594,13.08.2009 21:29:58,tp 135.594,0.0,-8.799999999988358,0.0,0.0,136884,13.08.2009 16:00:00,3867,-0.006499339209219755,122.15,IS,0.09,0.0,Phase3-EA-TR1v1-EURJPY-M30-91,EURJPYMT4,358,5h 29m,Sell
45430.83,1.52916,14.08.2009 03:29:58,tp 1.52916,-0.92,-0.0,0.0,0.0,1.52806,13.08.2009 21:00:00,3868,-0.0,41.25,IS,0.41,0.0,Phase3-EA-SA2v2-EURCHF-M5-43,EURCHFMT4,2150,6h 29m,Buy
45457.34,95262,14.08.2009 04:15:00,,-1.27,-0.0,0.0,0.0,95.36,13.08.2009 22:45:00,3869,-0.0,26.51,IS,0.27,0.0,Phase3-EA-S1v2-USDJPY-M15-0,USDJPYMT4,1400,5h 30m,Sell
45415.34,1.6536,14.08.2009 11:29:58,sl 1.65360,0.0,-42.0,0.0,0.0,1.6506,14.08.2009 10:30:00,3870,-0.031006071727083962,-42.0,IS,0.14,0.0,Phase3-EA-B1v1-GBPUSD-M30-14,GBPUSDMT4,250,59m 58s,Sell
45373.34,1.65732,14.08.2009 16:59:58,sl 1.65732,0.0,-84.0,0.0,0.0,1.66032,14.08.2009 16:30:00,3871,-0.062012143454167924,-42.0,IS,0.14,0.0,Phase3-EA-B1v1-GBPUSD-M30-14,GBPUSDMT4,252,29m 58s,Buy
45299.31,135054,14.08.2009 16:59:58,sl 135.054,0.0,-158.02999999999884,0.0,0.0,135834,14.08.2009 11:00:00,3872,-0.11666403607216767,-74.03,IS,0.09,0.0,Phase3-EA-TR1v1-EURJPY-M30-91,EURJPYMT4,360,5h 59m,Buy
45604.74,134319,14.08.2009 18:29:58,tp 134.319,0.0,-0.0,0.0,0.0,136019,14.08.2009 05:45:00,3873,-0.0,305.43,IS,0.17,0.0,Phase3-EA-T1v2-EURJPY-M15-322,EURJPYMT4,282,12h 44m,Sell
45645.78,1.52403,17.08.2009 02:34:58,tp 1.52403,-0.92,-0.0,0.0,0.0,1.52293,14.08.2009 20:35:00,3874,-0.0,41.04,IS,0.41,0.0,Phase3-EA-SA2v2-EURCHF-M5-43,EURCHFMT4,2152,2d 5h 59m,Buy
45669.62,94592,17.08.2009 03:15:00,,-1.28,-0.0,0.0,0.0,94.68,14.08.2009 19:30:00,3875,-0.0,23.84,IS,0.27,0.0,Phase3-EA-S1v2-USDJPY-M15-0,USDJPYMT4,1402,2d 7h 45m,Sell
45711.57,1.52242,17.08.2009 03:49:57,tp 1.52242,0.0,-0.0,0.0,0.0,1.52352,17.08.2009 02:40:00,3876,-0.0,41.95,IS,0.41,0.0,Phase3-EA-SA2v2-EURCHF-M5-43,EURCHFMT4,2154,1h 9m,Sell
45831.04,133.28,17.08.2009 11:29:57,tp 133.280,-0.33,-0.0,0.0,0.0,134.54,14.08.2009 19:00:00,3877,-0.0,119.47,IS,0.09,0.0,Phase3-EA-TR1v1-EURJPY-M30-91,EURJPYMT4,362,2d 16h 29m,Sell
45866.04,1.52242,17.08.2009 11:45:00,,0.0,-0.0,0.0,0.0,1.52353,17.08.2009 03:00:00,3878,-0.0,35.0,IS,0.34,0.0,Phase3-EA-S4v1-EURCHF-M15-221,EURCHFMT4,972,8h 45m,Sell
45802.26,154428,17.08.2009 15:59:57,sl 154.428,0.0,-63.779999999998836,0.0,0.0,153758,17.08.2009 15:00:00,3879,-0.04694329797203099,-63.78,IS,0.09,0.0,Phase3-EA-B1v1-GBPJPY-M30-1,GBPJPYMT4,466,59m 57s,Sell
45727.91,132581,17.08.2009 18:29:57,sl 132.581,0.0,-138.13000000000466,0.0,0.0,133361,17.08.2009 13:00:00,3880,-0.10166631779361834,-74.35,IS,0.09,0.0,Phase3-EA-TR1v1-EURJPY-M30-91,EURJPYMT4,364,5h 29m,Buy
45778.9,1.0773,18.08.2009 02:14:57,tp 1.07730,-2.85,-87.14000000001397,0.0,0.0,1.0783,17.08.2009 23:45:00,3881,-0.06413670406527926,50.99,IS,0.58,0.0,Phase3-EA-SA2v2-USDCHF-M15-107,USDCHFMT4,832,2h 29m,Sell
45737.47,133.14,18.08.2009 02:59:57,sl 133.140,0.0,-128.57000000000698,0.0,0.0,132.91,18.08.2009 02:00:00,3882,-0.09462997523149047,-41.43,IS,0.17,0.0,Phase3-EA-T1v2-EURJPY-M15-322,EURJPYMT4,284,59m 57s,Sell
45832.36,154636,18.08.2009 03:09:58,tp 154.636,0.0,-33.679999999993015,0.0,0.0,154246,18.08.2009 01:15:00,3883,-0.024789123168668936,94.89,IS,0.23,0.0,Phase3-EA-S4v1-GBPJPY-M5-194,GBPJPYMT4,1040,1h 54m,Buy
45763.68,133.69,18.08.2009 03:59:58,sl 133.690,-0.33,-102.35999999998603,0.0,0.0,132.97,17.08.2009 15:30:00,3884,-0.07533891471333529,-68.68,IS,0.09,0.0,Phase3-EA-TR1v1-EURJPY-M30-91,EURJPYMT4,365,12h 29m,Sell
45569.96,155667,18.08.2009 04:39:57,sl 155.667,0.0,-296.0799999999872,0.0,0.0,154867,18.08.2009 03:25:00,3885,-0.2179205340789995,-193.72,IS,0.23,0.0,Phase3-EA-S4v1-GBPJPY-M5-194,GBPJPYMT4,1042,1h 14m,Sell
45557.23,1.51796,18.08.2009 05:45:00,,-0.91,-308.8099999999977,0.0,0.0,1.51827,17.08.2009 21:25:00,3886,-0.2272900571769057,-12.73,IS,0.41,0.0,Phase3-EA-SA2v2-EURCHF-M5-43,EURCHFMT4,2156,8h 20m,Buy
45458.19,1.52158,18.08.2009 14:00:00,,0.0,-407.8500000000058,0.0,0.0,1.51844,18.08.2009 05:15:00,3887,-0.3001853884900198,-99.04,IS,0.34,0.0,Phase3-EA-S4v1-EURCHF-M15-221,EURCHFMT4,974,8h 45m,Sell
45510.6,94542,19.08.2009 04:15:00,,-1.28,-355.4400000000023,0.0,0.0,94.73,18.08.2009 23:00:00,3888,-0.2616106276447022,52.41,IS,0.27,0.0,Phase3-EA-S1v2-USDJPY-M15-0,USDJPYMT4,1404,5h 15m,Sell
45446.63,156326,19.08.2009 04:29:58,sl 156.326,-0.34,-419.4100000000035,0.0,0.0,156996,18.08.2009 21:00:00,3889,-0.3086937692450618,-63.97,IS,0.09,0.0,Phase3-EA-B1v1-GBPJPY-M30-1,GBPJPYMT4,468,7h 29m,Buy
45461.73,1.0754,19.08.2009 07:00:00,,0.0,-404.3099999999977,0.0,0.0,1.07512,19.08.2009 02:45:00,3890,-0.29757988088855575,15.1,IS,0.58,0.0,Phase3-EA-SA2v2-USDCHF-M15-107,USDCHFMT4,834,4h 15m,Buy
45515.11,1.5188,19.08.2009 11:45:00,,0.0,-350.929999999993,0.0,0.0,1.52049,19.08.2009 03:00:00,3891,-0.258291181519674,53.38,IS,0.34,0.0,Phase3-EA-S4v1-EURCHF-M15-221,EURCHFMT4,976,8h 45m,Sell
45471.51,1.65252,20.08.2009 03:59:58,sl 1.65252,-1.6,-394.52999999999884,0.0,0.0,1.65552,19.08.2009 19:00:00,3892,-0.2903816141252065,-43.6,IS,0.14,0.0,Phase3-EA-B1v1-GBPUSD-M30-14,GBPUSDMT4,254,8h 59m,Buy
45566.68,155408,20.08.2009 04:04:59,tp 155.408,0.0,-299.35999999998603,0.0,0.0,155798,20.08.2009 03:15:00,3893,-0.22033467671537785,95.17,IS,0.23,0.0,Phase3-EA-S4v1-GBPJPY-M5-194,GBPJPYMT4,1044,49m 59s,Sell
45688.28,134547,20.08.2009 09:29:58,tp 134.547,-1.41,-177.7599999999802,0.0,0.0,133257,19.08.2009 18:00:00,3894,-0.13083475458619398,121.6,IS,0.09,0.0,Phase3-EA-TR1v1-EURJPY-M30-91,EURJPYMT4,368,15h 29m,Buy
45606.47,94232,20.08.2009 10:45:00,,-3.87,-259.5699999999779,0.0,0.0,93.96,19.08.2009 20:15:00,3895,-0.19104847686734508,-81.81,IS,0.27,0.0,Phase3-EA-S1v2-USDJPY-M15-0,USDJPYMT4,1406,14h 30m,Sell
45564.47,1.65352,20.08.2009 11:59:58,sl 1.65352,0.0,-301.5699999999779,0.0,0.0,1.65652,20.08.2009 10:30:00,3896,-0.22196127891854195,-42.0,IS,0.14,0.0,Phase3-EA-B1v1-GBPUSD-M30-14,GBPUSDMT4,256,1h 29m,Buy
45568.3,1.51652,20.08.2009 12:15:00,,0.0,-297.7399999999907,0.0,0.0,1.51664,20.08.2009 03:30:00,3897,-0.21914232577912082,3.83,IS,0.34,0.0,Phase3-EA-S4v1-EURCHF-M15-221,EURCHFMT4,978,8h 45m,Sell
45526.83,133987,20.08.2009 18:44:58,sl 133.987,0.0,-339.20999999999185,0.0,0.0,134217,20.08.2009 18:15:00,3898,-0.24966503770919632,-41.47,IS,0.17,0.0,Phase3-EA-T1v2-EURJPY-M15-322,EURJPYMT4,286,29m 58s,Buy
45581.44,1.0621,21.08.2009 01:44:57,tp 1.06210,0.0,-284.6000000000058,0.0,0.0,1.0631,21.08.2009 01:15:00,3899,-0.20947103485168606,54.61,IS,0.58,0.0,Phase3-EA-SA2v2-USDCHF-M15-107,USDCHFMT4,836,29m 57s,Sell
45538.96,133906,21.08.2009 03:44:57,sl 133.906,-0.88,-327.0800000000163,0.0,0.0,134136,20.08.2009 21:15:00,3900,-0.24073712606919007,-42.48,IS,0.17,0.0,Phase3-EA-T1v2-EURJPY-M15-322,EURJPYMT4,288,6h 29m,Buy
45514.9,1.5152,21.08.2009 04:50:00,,-0.93,-351.14000000001397,0.0,0.0,1.5158,20.08.2009 20:30:00,3901,-0.2584457455299454,-24.06,IS,0.41,0.0,Phase3-EA-SA2v2-EURCHF-M5-43,EURCHFMT4,2158,8h 20m,Buy
45318.68,154308,21.08.2009 06:29:58,sl 154.308,0.0,-547.3600000000151,0.0,0.0,155108,21.08.2009 03:35:00,3902,-0.4028674126367523,-196.22,IS,0.23,0.0,Phase3-EA-S4v1-GBPJPY-M5-194,GBPJPYMT4,1046,2h 54m,Buy
45442.53,133005,21.08.2009 06:59:58,tp 133.005,-0.33,-423.5100000000093,0.0,0.0,134295,20.08.2009 12:00:00,3903,-0.3117114475405401,123.85,IS,0.09,0.0,Phase3-EA-TR1v1-EURJPY-M30-91,EURJPYMT4,370,18h 59m,Sell
45400.91,134116,21.08.2009 10:29:59,sl 134.116,0.0,-465.13000000000466,0.0,0.0,133886,21.08.2009 04:00:00,3904,-0.3423445623350798,-41.62,IS,0.17,0.0,Phase3-EA-T1v2-EURJPY-M15-322,EURJPYMT4,290,6h 29m,Sell
45434.28,1.51601,21.08.2009 13:00:00,,0.0,-431.7600000000093,0.0,0.0,1.51497,21.08.2009 04:15:00,3905,-0.31778360508631087,33.37,IS,0.34,0.0,Phase3-EA-S4v1-EURCHF-M15-221,EURCHFMT4,980,8h 45m,Buy
45476.91,1.51589,21.08.2009 23:54:58,tp 1.51589,0.0,-389.13000000000466,0.0,0.0,1.51479,21.08.2009 23:45:00,3906,-0.28640711100434263,42.63,IS,0.41,0.0,Phase3-EA-SA2v2-EURCHF-M5-43,EURCHFMT4,2160,9m 58s,Buy
45561.18,94.55,24.08.2009 01:45:00,,-0.83,-304.86000000001513,0.0,0.0,94252,21.08.2009 22:00:00,3907,-0.22438278174591314,84.27,IS,0.27,0.0,Phase3-EA-S1v2-USDJPY-M15-0,USDJPYMT4,1408,2d 3h 45m,Buy
45615.34,1.05802,24.08.2009 02:14:59,tp 1.05802,-0.66,-250.70000000001164,0.0,0.0,1.05702,21.08.2009 23:30:00,3908,-0.1845199874817957,54.16,IS,0.58,0.0,Phase3-EA-SA2v2-USDCHF-M15-107,USDCHFMT4,838,2d 2h 44m,Buy
45473.94,156603,24.08.2009 07:15:00,,0.0,-392.1000000000058,0.0,0.0,156.02,24.08.2009 01:50:00,3909,-0.288593087720821,-141.4,IS,0.23,0.0,Phase3-EA-S4v1-GBPJPY-M5-194,GBPJPYMT4,1048,5h 25m,Sell
45396.73,1.51828,24.08.2009 10:30:00,,0.0,-469.3099999999977,0.0,0.0,1.51628,24.08.2009 02:10:00,3910,-0.34542112215826526,-77.21,IS,0.41,0.0,Phase3-EA-SA2v2-EURCHF-M5-43,EURCHFMT4,2162,8h 20m,Sell
45368.84,1.51852,24.08.2009 14:15:00,,0.0,-497.20000000001164,0.0,0.0,1.51765,24.08.2009 05:30:00,3911,-0.3659486947584632,-27.89,IS,0.34,0.0,Phase3-EA-S4v1-EURCHF-M15-221,EURCHFMT4,982,8h 45m,Sell
45388.27,94502,25.08.2009 01:30:00,,0.0,-477.7700000000186,0.0,0.0,94.57,25.08.2009 01:15:00,3912,-0.35164784371430746,19.43,IS,0.27,0.0,Phase3-EA-S1v2-USDJPY-M15-0,USDJPYMT4,1410,15m 0s,Sell
45401.99,94452,25.08.2009 01:45:00,,0.0,-464.05000000001746,0.0,0.0,94.5,25.08.2009 01:30:00,3913,-0.3415496617109156,13.72,IS,0.27,0.0,Phase3-EA-S1v2-USDJPY-M15-0,USDJPYMT4,1412,15m 0s,Sell
45439.15,1.06122,25.08.2009 06:30:00,,0.0,-426.89000000001397,0.0,0.0,1.0619,25.08.2009 02:15:00,3914,-0.3141991920865684,37.16,IS,0.58,0.0,Phase3-EA-SA2v2-USDCHF-M15-107,USDCHFMT4,840,4h 15m,Sell
45562.38,134.16,25.08.2009 09:29:57,tp 134.160,-0.33,-303.6600000000035,0.0,0.0,135.45,24.08.2009 10:00:00,3915,-0.22349955883015607,123.23,IS,0.09,0.0,Phase3-EA-TR1v1-EURJPY-M30-91,EURJPYMT4,372,23h 29m,Sell
45498.41,154.56,25.08.2009 11:29:58,sl 154.560,0.0,-367.63000000000466,0.0,0.0,153.89,25.08.2009 09:00:00,3916,-0.27058270043051563,-63.97,IS,0.09,0.0,Phase3-EA-B1v1-GBPJPY-M30-1,GBPJPYMT4,470,2h 29m,Sell
45593.67,153616,26.08.2009 02:34:58,tp 153.616,0.0,-272.36999999999534,0.0,0.0,154006,26.08.2009 01:25:00,3917,-0.2004695213020084,95.26,IS,0.23,0.0,Phase3-EA-S4v1-GBPJPY-M5-194,GBPJPYMT4,1050,1h 9m,Sell
45653.42,93992,26.08.2009 02:45:00,,0.0,-212.61999999999534,0.0,0.0,94.2,26.08.2009 00:30:00,3918,-0.15649238028869855,59.75,IS,0.27,0.0,Phase3-EA-S1v2-USDJPY-M15-0,USDJPYMT4,1414,2h 15m,Sell
45675.65,1.51776,26.08.2009 04:30:00,,-0.93,-190.38999999998487,0.0,0.0,1.51716,25.08.2009 20:10:00,3919,-0.14013067577445018,22.23,IS,0.41,0.0,Phase3-EA-SA2v2-EURCHF-M5-43,EURCHFMT4,2164,8h 20m,Buy
45717.41,153678,26.08.2009 08:15:00,,0.0,-148.62999999997555,0.0,0.0,153507,26.08.2009 02:50:00,3920,-0.10939451830639614,41.76,IS,0.23,0.0,Phase3-EA-S4v1-GBPJPY-M5-194,GBPJPYMT4,1052,5h 25m,Buy
45709.74,1.51869,26.08.2009 15:00:00,,0.0,-156.29999999998836,0.0,0.0,1.51845,26.08.2009 06:15:00,3921,-0.11503978477623128,-7.67,IS,0.34,0.0,Phase3-EA-S4v1-EURCHF-M15-221,EURCHFMT4,984,8h 45m,Sell
45668.23,134658,26.08.2009 15:44:57,sl 134.658,0.0,-197.80999999999767,0.0,0.0,134428,26.08.2009 13:30:00,3922,-0.14559193747017107,-41.51,IS,0.17,0.0,Phase3-EA-T1v2-EURJPY-M15-322,EURJPYMT4,292,2h 14m,Sell
45704.69,1.52144,27.08.2009 00:34:58,tp 1.52144,-5.76,-161.35000000000582,0.0,0.0,1.52254,26.08.2009 20:00:00,3923,-0.11875668121335234,36.46,IS,0.41,0.0,Phase3-EA-SA2v2-EURCHF-M5-43,EURCHFMT4,2166,4h 34m,Sell
45652.76,1.0678,27.08.2009 02:15:00,,-1.96,-213.27999999999884,0.0,0.0,1.06872,26.08.2009 22:00:00,3924,-0.15697815289236278,-51.93,IS,0.58,0.0,Phase3-EA-SA2v2-USDCHF-M15-107,USDCHFMT4,842,4h 15m,Buy
45743.81,152.68,27.08.2009 02:34:57,tp 152.680,-4.25,-122.23000000001048,0.0,0.0,153.07,26.08.2009 23:50:00,3925,-0.08996361415995523,91.05,IS,0.23,0.0,Phase3-EA-S4v1-GBPJPY-M5-194,GBPJPYMT4,1054,2h 44m,Sell
45667.38,133887,27.08.2009 03:29:58,sl 133.887,-1.87,-198.6600000000035,0.0,0.0,134667,25.08.2009 11:30:00,3926,-0.14621755370216385,-76.43,IS,0.09,0.0,Phase3-EA-TR1v1-EURJPY-M30-91,EURJPYMT4,374,1d 15h 59m,Buy
45424.96,93402,27.08.2009 09:59:57,sl 93.402,-2.49,-441.0800000000163,0.0,0.0,94232,26.08.2009 20:30:00,3927,-0.32464330306529593,-242.42,IS,0.27,0.0,Phase3-EA-S1v2-USDJPY-M15-0,USDJPYMT4,1416,13h 29m,Buy
45383.16,133373,27.08.2009 18:29:58,sl 133.373,0.0,-482.88000000000466,0.0,0.0,133143,27.08.2009 17:30:00,3928,-0.3554089012971928,-41.8,IS,0.17,0.0,Phase3-EA-T1v2-EURJPY-M15-322,EURJPYMT4,294,59m 58s,Sell
45437.99,1.0578,28.08.2009 02:44:58,tp 1.05780,0.0,-428.05000000001746,0.0,0.0,1.0588,28.08.2009 00:15:00,3929,-0.3150529742384611,54.83,IS,0.58,0.0,Phase3-EA-SA2v2-USDCHF-M15-107,USDCHFMT4,844,2h 29m,Sell
45561.49,134709,28.08.2009 03:29:58,tp 134.709,-0.47,-304.55000000001746,0.0,0.0,133419,27.08.2009 11:00:00,3930,-0.22415461582601315,123.5,IS,0.09,0.0,Phase3-EA-TR1v1-EURJPY-M30-91,EURJPYMT4,376,16h 29m,Buy
45611.34,152342,28.08.2009 08:20:00,,0.0,-254.70000000001164,0.0,0.0,152545,28.08.2009 02:55:00,3931,-0.187464063867624,49.85,IS,0.23,0.0,Phase3-EA-S4v1-GBPJPY-M5-194,GBPJPYMT4,1056,5h 25m,Sell
45679.2,1.5175,28.08.2009 13:15:00,,0.0,-186.8400000000256,0.0,0.0,1.51961,28.08.2009 04:30:00,3932,-0.1375178079820576,67.86,IS,0.34,0.0,Phase3-EA-S4v1-EURCHF-M15-221,EURCHFMT4,986,8h 45m,Sell
45599.59,93782,28.08.2009 14:30:00,,-1.3,-266.45000000001164,0.0,0.0,93.51,27.08.2009 23:00:00,3933,-0.19611228825099455,-79.61,IS,0.27,0.0,Phase3-EA-S1v2-USDJPY-M15-0,USDJPYMT4,1418,15h 30m,Sell
45693.23,93282,31.08.2009 01:15:00,,-1.3,-172.80999999999767,0.0,0.0,93.61,28.08.2009 22:00:00,3934,-0.12719146005874435,93.64,IS,0.27,0.0,Phase3-EA-S1v2-USDJPY-M15-0,USDJPYMT4,1420,2d 3h 15m,Sell
45817.14,133.39,31.08.2009 01:59:58,tp 133.390,-0.34,-48.89999999999418,0.0,0.0,134.68,28.08.2009 15:30:00,3935,-0.03599133381674638,123.91,IS,0.09,0.0,Phase3-EA-TR1v1-EURJPY-M30-91,EURJPYMT4,378,2d 10h 29m,Sell
45871.88,1.0595,31.08.2009 02:44:58,tp 1.05950,0.0,-0.0,0.0,0.0,1.0605,31.08.2009 02:15:00,3936,-0.0,54.74,IS,0.58,0.0,Phase3-EA-SA2v2-USDCHF-M15-107,USDCHFMT4,846,29m 58s,Sell
45673.82,150939,31.08.2009 03:54:58,sl 150.939,0.0,-198.05999999999767,0.0,0.0,151739,31.08.2009 01:20:00,3937,-0.1457696765511728,-198.06,IS,0.23,0.0,Phase3-EA-S4v1-GBPJPY-M5-194,GBPJPYMT4,1058,2h 34m,Buy
45688.49,1.51565,31.08.2009 10:20:00,,0.0,-183.38999999998487,0.0,0.0,1.51527,31.08.2009 02:00:00,3938,-0.13497274049640354,14.67,IS,0.41,0.0,Phase3-EA-SA2v2-EURCHF-M5-43,EURCHFMT4,2168,8h 20m,Buy
45731.11,1.51638,31.08.2009 13:15:00,,0.0,-140.76999999998952,0.0,0.0,1.51505,31.08.2009 04:30:00,3939,-0.10360495490309657,42.62,IS,0.34,0.0,Phase3-EA-S4v1-EURCHF-M15-221,EURCHFMT4,988,8h 45m,Buy
45661.48,133099,31.08.2009 14:29:58,sl 133.099,0.0,-210.39999999999418,0.0,0.0,132379,31.08.2009 07:00:00,3940,-0.15485176182149987,-69.63,IS,0.09,0.0,Phase3-EA-TR1v1-EURJPY-M30-91,EURJPYMT4,380,7h 29m,Sell
45689.91,93.08,31.08.2009 22:45:00,,0.0,-181.97000000000116,0.0,0.0,92982,31.08.2009 17:00:00,3941,-0.1339276383016126,28.43,IS,0.27,0.0,Phase3-EA-S1v2-USDJPY-M15-0,USDJPYMT4,1422,5h 45m,Buy
45785.0,151246,01.09.2009 01:24:59,tp 151.246,-1.43,-86.88000000000466,0.0,0.0,151636,31.08.2009 23:25:00,3942,-0.0639425906228755,95.09,IS,0.23,0.0,Phase3-EA-S4v1-GBPJPY-M5-194,GBPJPYMT4,1060,1h 59m,Sell
45839.76,1.05922,01.09.2009 03:59:57,tp 1.05922,0.0,-32.11999999999534,0.0,0.0,1.05822,01.09.2009 02:30:00,3943,-0.023639917251454336,54.76,IS,0.58,0.0,Phase3-EA-SA2v2-USDCHF-M15-107,USDCHFMT4,848,1h 29m,Buy
45826.2,1.51792,01.09.2009 04:50:00,,-1.94,-45.679999999993015,0.0,0.0,1.51762,31.08.2009 20:30:00,3944,-0.03361990722435945,-13.56,IS,0.41,0.0,Phase3-EA-SA2v2-EURCHF-M5-43,EURCHFMT4,2170,8h 20m,Sell
45950.88,132.1,01.09.2009 20:29:58,tp 132.100,0.0,-0.0,0.0,0.0,133.39,01.09.2009 12:30:00,3945,-0.0,124.68,IS,0.09,0.0,Phase3-EA-TR1v1-EURJPY-M30-91,EURJPYMT4,382,7h 59m,Sell
46047.6,149652,02.09.2009 03:54:58,tp 149.652,0.0,-0.0,0.0,0.0,149262,02.09.2009 02:50:00,3946,-0.0,96.72,IS,0.23,0.0,Phase3-EA-S4v1-GBPJPY-M5-194,GBPJPYMT4,1062,1h 4m,Buy
46045.91,1.5154,02.09.2009 06:25:00,,-0.92,-1.6900000000023283,0.0,0.0,1.51542,01.09.2009 22:05:00,3947,-0.001242212284525657,-1.69,IS,0.41,0.0,Phase3-EA-SA2v2-EURCHF-M5-43,EURCHFMT4,2172,8h 20m,Buy
46003.7,131.93,02.09.2009 11:59:58,sl 131.930,0.0,-43.89999999999418,0.0,0.0,131.7,02.09.2009 11:30:00,3948,-0.032268117923428395,-42.21,IS,0.17,0.0,Phase3-EA-T1v2-EURJPY-M15-322,EURJPYMT4,296,29m 58s,Sell
45964.77,1.51692,02.09.2009 14:15:00,,0.0,-82.8299999999872,0.0,0.0,1.5157,02.09.2009 05:30:00,3949,-0.060883102678758884,-38.93,IS,0.34,0.0,Phase3-EA-S4v1-EURCHF-M15-221,EURCHFMT4,990,8h 45m,Sell
45888.88,131142,02.09.2009 15:59:58,sl 131.142,0.0,-158.72000000000116,0.0,0.0,131922,02.09.2009 06:30:00,3950,-0.11666504958558704,-75.89,IS,0.09,0.0,Phase3-EA-TR1v1-EURJPY-M30-91,EURJPYMT4,384,9h 29m,Buy
45899.98,92472,02.09.2009 17:45:00,,0.0,-147.61999999999534,0.0,0.0,92.51,02.09.2009 17:00:00,3951,-0.10850614049788111,11.1,IS,0.27,0.0,Phase3-EA-S1v2-USDJPY-M15-0,USDJPYMT4,1424,45m 0s,Sell
45942.57,1.51382,02.09.2009 20:09:58,tp 1.51382,0.0,-105.02999999999884,0.0,0.0,1.51272,02.09.2009 20:00:00,3952,-0.07720092085417075,42.59,IS,0.41,0.0,Phase3-EA-SA2v2-EURCHF-M5-43,EURCHFMT4,2174,9m 58s,Buy
45968.36,92112,03.09.2009 02:00:00,,0.0,-79.23999999999069,0.0,0.0,92.2,03.09.2009 00:15:00,3953,-0.058244320370216505,25.79,IS,0.27,0.0,Phase3-EA-S1v2-USDJPY-M15-0,USDJPYMT4,1426,1h 45m,Sell
45950.87,1.06102,03.09.2009 04:30:00,,0.0,-96.72999999998137,0.0,0.0,1.0607,03.09.2009 00:15:00,3954,-0.07110011495975037,-17.49,IS,0.58,0.0,Phase3-EA-SA2v2-USDCHF-M15-107,USDCHFMT4,850,4h 15m,Sell
46048.09,150262,03.09.2009 06:24:58,tp 150.262,0.0,-0.0,0.0,0.0,149872,03.09.2009 02:05:00,3955,-0.0,97.22,IS,0.23,0.0,Phase3-EA-S4v1-GBPJPY-M5-194,GBPJPYMT4,1064,4h 19m,Buy
46003.76,131.83,03.09.2009 06:29:58,sl 131.830,-1.94,-44.329999999987194,0.0,0.0,131.6,02.09.2009 22:30:00,3956,-0.032584066413565364,-44.33,IS,0.17,0.0,Phase3-EA-T1v2-EURJPY-M15-322,EURJPYMT4,298,7h 59m,Sell
45941.11,1.51502,03.09.2009 10:25:00,,0.0,-106.97999999998137,0.0,0.0,1.5134,03.09.2009 02:05:00,3957,-0.07863395950651078,-62.65,IS,0.41,0.0,Phase3-EA-SA2v2-EURCHF-M5-43,EURCHFMT4,2176,8h 20m,Sell
46013.68,151082,04.09.2009 04:25:00,,-1.44,-34.40999999997439,0.0,0.0,151.38,03.09.2009 23:00:00,3958,-0.025292527076252506,72.57,IS,0.23,0.0,Phase3-EA-S4v1-GBPJPY-M5-194,GBPJPYMT4,1066,5h 25m,Sell
45991.69,1.51422,04.09.2009 06:05:00,,-1.93,-56.399999999965075,0.0,0.0,1.5137,03.09.2009 21:45:00,3959,-0.04145592929673989,-21.99,IS,0.41,0.0,Phase3-EA-SA2v2-EURCHF-M5-43,EURCHFMT4,2178,8h 20m,Sell
45949.5,132.1,04.09.2009 07:44:58,sl 132.100,0.0,-98.5899999999674,0.0,0.0,131.87,04.09.2009 04:45:00,3960,-0.07246702250650293,-42.19,IS,0.17,0.0,Phase3-EA-T1v2-EURJPY-M15-322,EURJPYMT4,300,2h 59m,Sell
46073.38,132952,04.09.2009 15:59:58,tp 132.952,-1.92,-0.0,0.0,0.0,131662,02.09.2009 19:00:00,3961,-0.0,123.88,IS,0.09,0.0,Phase3-EA-TR1v1-EURJPY-M30-91,EURJPYMT4,386,1d 20h 59m,Buy
46125.23,1.0594,07.09.2009 01:29:58,tp 1.05940,-2.9,-0.0,0.0,0.0,1.0604,04.09.2009 22:30:00,3962,-0.0,51.85,IS,0.58,0.0,Phase3-EA-SA2v2-USDCHF-M15-107,USDCHFMT4,852,2d 2h 59m,Sell
46246.09,133392,07.09.2009 02:29:57,tp 133.392,-0.95,-0.0,0.0,0.0,132132,03.09.2009 13:30:00,3963,-0.0,120.86,IS,0.09,0.0,Phase3-EA-TR1v1-EURJPY-M30-91,EURJPYMT4,387,3d 12h 59m,Buy
46342.47,152.44,07.09.2009 04:09:57,tp 152.440,0.0,-0.0,0.0,0.0,152.83,07.09.2009 02:10:00,3964,-0.0,96.38,IS,0.23,0.0,Phase3-EA-S4v1-GBPJPY-M5-194,GBPJPYMT4,1068,1h 59m,Sell
46316.53,1.51752,07.09.2009 06:25:00,,-1.93,-25.94000000000233,0.0,0.0,1.5169,04.09.2009 22:05:00,3965,-0.019025619823377346,-25.94,IS,0.41,0.0,Phase3-EA-SA2v2-EURCHF-M5-43,EURCHFMT4,2180,2d 8h 20m,Sell
46274.53,1.63752,07.09.2009 09:59:57,sl 1.63752,0.0,-67.94000000000233,0.0,0.0,1.64052,07.09.2009 09:30:00,3966,-0.04983040134156458,-42.0,IS,0.14,0.0,Phase3-EA-B1v1-GBPUSD-M30-14,GBPUSDMT4,258,29m 57s,Buy
46270.67,1.51752,07.09.2009 13:15:00,,0.0,-71.79999999998836,0.0,0.0,1.5174,07.09.2009 04:30:00,3967,-0.05266150745251154,-3.86,IS,0.34,0.0,Phase3-EA-S4v1-EURCHF-M15-221,EURCHFMT4,992,8h 45m,Sell
46293.32,92982,07.09.2009 19:00:00,,0.0,-49.14999999999418,0.0,0.0,93.06,07.09.2009 18:00:00,3968,-0.036048928848064835,22.65,IS,0.27,0.0,Phase3-EA-S1v2-USDJPY-M15-0,USDJPYMT4,1428,1h 0m,Sell
46228.48,152002,07.09.2009 19:29:58,sl 152.002,0.0,-113.98999999999069,0.0,0.0,152672,07.09.2009 01:30:00,3969,-0.08360564393471133,-64.84,IS,0.09,0.0,Phase3-EA-B1v1-GBPJPY-M30-1,GBPJPYMT4,472,17h 59m,Buy
46248.61,1.0599,08.09.2009 03:00:00,,-0.66,-93.85999999998603,0.0,0.0,1.05952,07.09.2009 22:45:00,3970,-0.06884135222134817,20.13,IS,0.58,0.0,Phase3-EA-SA2v2-USDCHF-M15-107,USDCHFMT4,854,4h 15m,Buy
46269.14,1.51902,08.09.2009 04:20:00,,-1.93,-73.3299999999872,0.0,0.0,1.5196,07.09.2009 20:00:00,3971,-0.053783681636387505,20.53,IS,0.41,0.0,Phase3-EA-SA2v2-EURCHF-M5-43,EURCHFMT4,2182,8h 20m,Sell
46226.69,133.5,08.09.2009 13:59:58,sl 133.500,0.0,-115.77999999999884,0.0,0.0,133.27,08.09.2009 03:30:00,3972,-0.08491851438513529,-42.45,IS,0.17,0.0,Phase3-EA-T1v2-EURJPY-M15-322,EURJPYMT4,302,10h 29m,Sell
46240.75,92162,08.09.2009 17:45:00,,0.0,-101.72000000000116,0.0,0.0,92.21,08.09.2009 17:00:00,3973,-0.07460624704833431,14.06,IS,0.27,0.0,Phase3-EA-S1v2-USDJPY-M15-0,USDJPYMT4,1430,45m 0s,Sell
46296.23,1.0455,08.09.2009 22:44:57,tp 1.04550,0.0,-46.23999999999069,0.0,0.0,1.0465,08.09.2009 22:15:00,3974,-0.0339145975571593,55.48,IS,0.58,0.0,Phase3-EA-SA2v2-USDCHF-M15-107,USDCHFMT4,856,29m 57s,Sell
46351.7,1.0457,09.09.2009 01:59:57,tp 1.04570,0.0,-0.0,0.0,0.0,1.0467,09.09.2009 00:15:00,3975,-0.0,55.47,IS,0.58,0.0,Phase3-EA-SA2v2-USDCHF-M15-107,USDCHFMT4,858,1h 44m,Sell
46364.63,1.51602,09.09.2009 06:25:00,,-1.96,-0.0,0.0,0.0,1.5164,08.09.2009 22:05:00,3976,-0.0,12.93,IS,0.41,0.0,Phase3-EA-SA2v2-EURCHF-M5-43,EURCHFMT4,2184,8h 20m,Sell
46351.67,152472,09.09.2009 07:45:00,,0.0,-12.959999999991851,0.0,0.0,152.42,09.09.2009 02:20:00,3977,-0.009503930748018634,-12.96,IS,0.23,0.0,Phase3-EA-S4v1-GBPJPY-M5-194,GBPJPYMT4,1070,5h 25m,Sell
46275.05,134.24,09.09.2009 14:59:57,sl 134.240,-0.68,-89.5799999999872,0.0,0.0,133.46,07.09.2009 13:00:00,3978,-0.06569152132777181,-76.62,IS,0.09,0.0,Phase3-EA-TR1v1-EURJPY-M30-91,EURJPYMT4,390,2d 1h 59m,Sell
46319.96,1.5176,09.09.2009 15:00:00,,0.0,-44.6699999999837,0.0,0.0,1.51622,09.09.2009 06:15:00,3979,-0.03275776130510065,44.91,IS,0.34,0.0,Phase3-EA-S4v1-EURCHF-M15-221,EURCHFMT4,994,8h 45m,Buy
46277.45,133782,09.09.2009 17:14:58,sl 133.782,0.0,-87.17999999999302,0.0,0.0,134012,09.09.2009 09:15:00,3980,-0.06393153415221597,-42.51,IS,0.17,0.0,Phase3-EA-T1v2-EURJPY-M15-322,EURJPYMT4,304,7h 59m,Buy
46326.51,1.04032,10.09.2009 06:45:00,,0.0,-38.11999999999534,0.0,0.0,1.0412,10.09.2009 02:30:00,3981,-0.02795446297180971,49.06,IS,0.58,0.0,Phase3-EA-SA2v2-USDCHF-M15-107,USDCHFMT4,860,4h 15m,Sell
46321.96,91982,10.09.2009 07:00:00,,-3.96,-42.6699999999837,0.0,0.0,91.98,09.09.2009 20:30:00,3982,-0.03129110532546722,-4.55,IS,0.27,0.0,Phase3-EA-S1v2-USDJPY-M15-0,USDJPYMT4,1432,10h 30m,Sell
46326.22,1.5156,10.09.2009 07:25:00,,-2.84,-38.40999999997439,0.0,0.0,1.51542,09.09.2009 23:05:00,3983,-0.02816712808884119,4.26,IS,0.41,0.0,Phase3-EA-SA2v2-EURCHF-M5-43,EURCHFMT4,2186,8h 20m,Buy
46281.08,133822,10.09.2009 14:14:58,sl 133.822,-2.72,-83.54999999998836,0.0,0.0,134052,09.09.2009 23:45:00,3984,-0.06126955354917789,-45.14,IS,0.17,0.0,Phase3-EA-T1v2-EURJPY-M15-322,EURJPYMT4,306,14h 29m,Buy
46279.34,1514,11.09.2009 04:35:00,,-0.95,-85.28999999997905,0.0,0.0,1.51402,10.09.2009 20:15:00,3985,-0.06254554425145215,-1.74,IS,0.41,0.0,Phase3-EA-SA2v2-EURCHF-M5-43,EURCHFMT4,2188,8h 20m,Buy
46273.8,152.61,11.09.2009 08:05:00,,0.0,-90.8299999999872,0.0,0.0,152632,11.09.2009 02:40:00,3986,-0.06660818131504272,-5.54,IS,0.23,0.0,Phase3-EA-S4v1-GBPJPY-M5-194,GBPJPYMT4,1072,5h 25m,Buy
46400.32,132.41,11.09.2009 17:29:57,tp 132.410,-1.37,-0.0,0.0,0.0,133.7,09.09.2009 17:30:00,3987,-0.0,126.52,IS,0.09,0.0,Phase3-EA-TR1v1-EURJPY-M30-91,EURJPYMT4,392,1d 23h 59m,Sell
46719.48,131.92,11.09.2009 18:29:57,tp 131.920,0.0,-0.0,0.0,0.0,133.62,11.09.2009 02:45:00,3988,-0.0,319.16,IS,0.17,0.0,Phase3-EA-T1v2-EURJPY-M15-322,EURJPYMT4,308,15h 44m,Sell
46810.27,90262,14.09.2009 01:15:00,,-1.34,-0.0,0.0,0.0,90.57,11.09.2009 22:00:00,3989,-0.0,90.79,IS,0.27,0.0,Phase3-EA-S1v2-USDJPY-M15-0,USDJPYMT4,1434,2d 3h 15m,Sell
46866.22,1.0366,14.09.2009 02:14:58,tp 1.03660,0.0,-0.0,0.0,0.0,1.0376,14.09.2009 01:15:00,3990,-0.0,55.95,IS,0.58,0.0,Phase3-EA-SA2v2-USDCHF-M15-107,USDCHFMT4,862,59m 58s,Sell
46991.04,131.5,14.09.2009 04:29:58,tp 131.500,-0.35,-0.0,0.0,0.0,132.76,11.09.2009 10:30:00,3991,-0.0,124.82,IS,0.09,0.0,Phase3-EA-TR1v1-EURJPY-M30-91,EURJPYMT4,393,2d 17h 59m,Sell
46914.2,150.24,14.09.2009 06:55:00,,0.0,-76.83999999999651,0.0,0.0,150542,14.09.2009 01:30:00,3992,-0.05609125969114216,-76.84,IS,0.23,0.0,Phase3-EA-S4v1-GBPJPY-M5-194,GBPJPYMT4,1074,5h 25m,Buy
46861.15,1.5113,14.09.2009 07:10:00,,-0.95,-129.88999999998487,0.0,0.0,1.51262,11.09.2009 22:50:00,3993,-0.0948164201103844,-53.05,IS,0.41,0.0,Phase3-EA-SA2v2-EURCHF-M5-43,EURCHFMT4,2190,2d 8h 20m,Buy
46873.56,1.5127,14.09.2009 12:30:00,,0.0,-117.47999999998137,0.0,0.0,1.51232,14.09.2009 03:45:00,3994,-0.08575743347884741,12.41,IS,0.34,0.0,Phase3-EA-S4v1-EURCHF-M15-221,EURCHFMT4,996,8h 45m,Buy
47001.65,132832,14.09.2009 18:29:58,tp 132.832,0.0,-0.0,0.0,0.0,131542,14.09.2009 09:00:00,3995,-0.0,128.09,IS,0.09,0.0,Phase3-EA-TR1v1-EURJPY-M30-91,EURJPYMT4,396,9h 29m,Buy
47051.51,90.97,14.09.2009 21:00:00,,0.0,-0.0,0.0,0.0,90802,14.09.2009 17:30:00,3996,-0.0,49.86,IS,0.27,0.0,Phase3-EA-S1v2-USDJPY-M15-0,USDJPYMT4,1436,3h 30m,Buy
47077.63,90.97,15.09.2009 03:15:00,,0.0,-0.0,0.0,0.0,90882,15.09.2009 00:45:00,3997,-0.0,26.12,IS,0.27,0.0,Phase3-EA-S1v2-USDJPY-M15-0,USDJPYMT4,1438,2h 30m,Buy
47083.81,1.5127,15.09.2009 04:50:00,,-0.95,-0.0,0.0,0.0,1.51252,14.09.2009 20:30:00,3998,-0.0,6.18,IS,0.41,0.0,Phase3-EA-SA2v2-EURCHF-M5-43,EURCHFMT4,2192,8h 20m,Buy
47010.1,151562,15.09.2009 08:50:00,,0.0,-73.70999999999185,0.0,0.0,151.27,15.09.2009 03:25:00,3999,-0.053770025796621636,-73.71,IS,0.23,0.0,Phase3-EA-S4v1-GBPJPY-M5-194,GBPJPYMT4,1076,5h 25m,Sell
47133.95,133672,15.09.2009 15:59:57,tp 133.672,-0.48,-0.0,0.0,0.0,132412,14.09.2009 15:00:00,4000,-0.0,123.85,IS,0.09,0.0,Phase3-EA-TR1v1-EURJPY-M30-91,EURJPYMT4,397,1d 0h 59m,Buy
47182.51,90912,16.09.2009 02:15:00,,-1.33,-0.0,0.0,0.0,91.08,15.09.2009 22:45:00,4001,-0.0,48.56,IS,0.27,0.0,Phase3-EA-S1v2-USDJPY-M15-0,USDJPYMT4,1440,3h 30m,Sell
47187.67,1.51692,16.09.2009 05:00:00,,-1.98,-0.0,0.0,0.0,1.5171,15.09.2009 20:40:00,4002,-0.0,5.16,IS,0.41,0.0,Phase3-EA-SA2v2-EURCHF-M5-43,EURCHFMT4,2194,8h 20m,Sell
47194.74,149.97,16.09.2009 07:45:00,,0.0,-0.0,0.0,0.0,149942,16.09.2009 02:20:00,4003,-0.0,7.07,IS,0.23,0.0,Phase3-EA-S4v1-GBPJPY-M5-194,GBPJPYMT4,1078,5h 25m,Buy
47150.83,133132,16.09.2009 09:14:58,sl 133.132,-0.92,-43.91000000000349,0.0,0.0,133362,15.09.2009 20:45:00,4004,-0.032005600214704624,-43.91,IS,0.17,0.0,Phase3-EA-T1v2-EURJPY-M15-322,EURJPYMT4,310,12h 29m,Buy
47332.18,149.33,16.09.2009 09:29:58,tp 149.330,-1.72,-0.0,0.0,0.0,151.18,11.09.2009 17:30:00,4005,-0.0,181.35,IS,0.09,0.0,Phase3-EA-B1v1-GBPJPY-M30-1,GBPJPYMT4,474,4d 15h 59m,Sell
47254.7,133.82,16.09.2009 17:59:57,sl 133.820,-0.35,-77.48000000001048,0.0,0.0,133.04,15.09.2009 18:30:00,4006,-0.05641794952938955,-77.48,IS,0.09,0.0,Phase3-EA-TR1v1-EURJPY-M30-91,EURJPYMT4,400,23h 29m,Sell
47298.45,1.51852,16.09.2009 21:29:57,tp 1.51852,0.0,-33.73000000001048,0.0,0.0,1.51742,16.09.2009 20:05:00,4007,-0.024560885875408403,43.75,IS,0.41,0.0,Phase3-EA-SA2v2-EURCHF-M5-43,EURCHFMT4,2196,1h 24m,Buy
47339.79,90.99,17.09.2009 02:15:00,,-2.58,-0.0,0.0,0.0,90842,16.09.2009 22:30:00,4008,-0.0,41.34,IS,0.27,0.0,Phase3-EA-S1v2-USDJPY-M15-0,USDJPYMT4,1442,3h 45m,Buy
47293.26,1.51892,17.09.2009 06:40:00,,-5.96,-46.529999999998836,0.0,0.0,1.5179,16.09.2009 22:20:00,4009,-0.03387947513244253,-46.53,IS,0.41,0.0,Phase3-EA-SA2v2-EURCHF-M5-43,EURCHFMT4,2198,8h 20m,Sell
47211.98,150532,17.09.2009 08:50:00,,0.0,-127.80999999999767,0.0,0.0,150.21,17.09.2009 03:25:00,4010,-0.09306115875085985,-81.28,IS,0.23,0.0,Phase3-EA-S4v1-GBPJPY-M5-194,GBPJPYMT4,1080,5h 25m,Sell
47178.32,1.51932,17.09.2009 12:45:00,,0.0,-161.47000000000116,0.0,0.0,1.5183,17.09.2009 04:00:00,4011,-0.11756971522965122,-33.66,IS,0.34,0.0,Phase3-EA-S4v1-EURCHF-M15-221,EURCHFMT4,998,8h 45m,Sell
47135.54,134152,17.09.2009 14:59:58,sl 134.152,0.0,-204.25,0.0,0.0,134382,17.09.2009 14:30:00,4012,-0.148718736208931,-42.78,IS,0.17,0.0,Phase3-EA-T1v2-EURJPY-M15-322,EURJPYMT4,312,29m 58s,Buy
47179.4,1.51622,17.09.2009 21:49:57,tp 1.51622,0.0,-160.39000000001397,0.0,0.0,1.51512,17.09.2009 20:25:00,4013,-0.11678334443354968,43.86,IS,0.41,0.0,Phase3-EA-SA2v2-EURCHF-M5-43,EURCHFMT4,2200,1h 24m,Buy
47219.39,91.21,18.09.2009 03:00:00,,-0.86,-120.40000000002328,0.0,0.0,91072,17.09.2009 17:45:00,4014,-0.08766578134422892,39.99,IS,0.27,0.0,Phase3-EA-S1v2-USDJPY-M15-0,USDJPYMT4,1444,9h 15m,Buy
47176.57,134132,18.09.2009 04:59:57,sl 134.132,0.0,-163.22000000003027,0.0,0.0,134362,18.09.2009 02:15:00,4015,-0.11884392716781503,-42.82,IS,0.17,0.0,Phase3-EA-T1v2-EURJPY-M15-322,EURJPYMT4,314,2h 44m,Buy
47218.83,1.51492,18.09.2009 14:30:00,,0.0,-120.96000000002095,0.0,0.0,1.5162,18.09.2009 05:45:00,4016,-0.08807352916443285,42.26,IS,0.34,0.0,Phase3-EA-S4v1-EURCHF-M15-221,EURCHFMT4,1000,8h 45m,Sell
47275.16,1.0297,21.09.2009 01:59:57,tp 1.02970,0.0,-64.63000000003376,0.0,0.0,1.0307,21.09.2009 01:30:00,4017,-0.047058467178400155,56.33,IS,0.58,0.0,Phase3-EA-SA2v2-USDCHF-M15-107,USDCHFMT4,864,29m 57s,Sell
47316.98,1.5136,21.09.2009 02:34:57,tp 1.51360,-1.99,-22.810000000026776,0.0,0.0,1.5147,18.09.2009 23:10:00,4018,-0.016608442462324104,41.82,IS,0.41,0.0,Phase3-EA-SA2v2-EURCHF-M5-43,EURCHFMT4,2202,2d 3h 24m,Sell
47437.58,135042,21.09.2009 09:59:58,tp 135.042,-2.42,-0.0,0.0,0.0,133782,16.09.2009 20:30:00,4019,-0.0,120.6,IS,0.09,0.0,Phase3-EA-TR1v1-EURJPY-M30-91,EURJPYMT4,402,4d 13h 29m,Buy
47512.55,1.5163,21.09.2009 12:00:00,,0.0,-0.0,0.0,0.0,1.51402,21.09.2009 03:15:00,4020,-0.0,74.97,IS,0.34,0.0,Phase3-EA-S4v1-EURCHF-M15-221,EURCHFMT4,1002,8h 45m,Buy
47446.68,149.35,21.09.2009 13:59:58,sl 149.350,-0.57,-65.86999999999534,0.0,0.0,148.68,18.09.2009 17:30:00,4021,-0.047901082483013585,-65.87,IS,0.09,0.0,Phase3-EA-B1v1-GBPJPY-M30-1,GBPJPYMT4,476,2d 20h 29m,Sell
47568.25,135.11,21.09.2009 21:00:00,,0.0,-0.0,0.0,0.0,134452,21.09.2009 03:30:00,4022,-0.0,121.57,IS,0.17,0.0,Phase3-EA-T1v2-EURJPY-M15-322,EURJPYMT4,316,17h 30m,Buy
47525.76,134972,21.09.2009 23:59:59,sl 134.972,0.0,-42.48999999999069,0.0,0.0,135202,21.09.2009 22:00:00,4023,-0.030886487252684138,-42.49,IS,0.17,0.0,Phase3-EA-T1v2-EURJPY-M15-322,EURJPYMT4,318,1h 59m,Buy
47524.01,1.5152,22.09.2009 04:55:00,,-0.95,-44.23999999999069,0.0,0.0,1.51522,21.09.2009 20:35:00,4024,-0.0321585831032892,-1.75,IS,0.41,0.0,Phase3-EA-SA2v2-EURCHF-M5-43,EURCHFMT4,2204,8h 20m,Buy
47387.65,1.0293,22.09.2009 07:00:00,,0.0,-180.59999999997672,0.0,0.0,1.03172,22.09.2009 02:45:00,4025,-0.13128029178242548,-136.36,IS,0.58,0.0,Phase3-EA-SA2v2-USDCHF-M15-107,USDCHFMT4,866,4h 15m,Buy
47141.65,91412,22.09.2009 09:44:57,sl 91.412,-0.85,-426.5999999999767,0.0,0.0,92242,21.09.2009 17:30:00,4026,-0.31010062278176564,-246.0,IS,0.27,0.0,Phase3-EA-S1v2-USDJPY-M15-0,USDJPYMT4,1446,16h 14m,Buy
47098.85,134942,22.09.2009 15:44:58,sl 134.942,0.0,-469.3999999999651,0.0,0.0,135172,22.09.2009 12:00:00,4027,-0.34121245272798384,-42.8,IS,0.17,0.0,Phase3-EA-T1v2-EURJPY-M15-322,EURJPYMT4,320,3h 44m,Buy
47129.53,91102,23.09.2009 01:15:00,,-1.33,-438.71999999997206,0.0,0.0,91.21,22.09.2009 20:30:00,4028,-0.3189107951870956,30.68,IS,0.27,0.0,Phase3-EA-S1v2-USDJPY-M15-0,USDJPYMT4,1448,4h 45m,Sell
46906.94,1.01932,23.09.2009 02:29:57,sl 1.01932,-0.68,-661.3099999999686,0.0,0.0,1.02322,22.09.2009 22:45:00,4029,-0.4807141182649107,-222.59,IS,0.58,0.0,Phase3-EA-SA2v2-USDCHF-M15-107,USDCHFMT4,868,3h 44m,Buy
46834.88,134512,23.09.2009 02:29:58,sl 134.512,-0.96,-733.3699999999662,0.0,0.0,135232,21.09.2009 15:00:00,4030,-0.5330953908332523,-72.06,IS,0.09,0.0,Phase3-EA-TR1v1-EURJPY-M30-91,EURJPYMT4,404,1d 11h 29m,Buy
46891.68,1.02112,23.09.2009 02:44:57,tp 1.02112,0.0,-676.5699999999779,0.0,0.0,1.02012,23.09.2009 02:30:00,4031,-0.4918067940821936,56.8,IS,0.58,0.0,Phase3-EA-SA2v2-USDCHF-M15-107,USDCHFMT4,870,14m 57s,Buy
46914.0,148.77,23.09.2009 07:55:00,,0.0,-654.2499999999709,0.0,0.0,148682,23.09.2009 02:30:00,4032,-0.4755821201476142,22.32,IS,0.23,0.0,Phase3-EA-S4v1-GBPJPY-M5-194,GBPJPYMT4,1082,5h 25m,Buy
46870.56,135.07,23.09.2009 16:29:58,sl 135.070,-0.65,-697.6899999999732,0.0,0.0,134.84,22.09.2009 16:30:00,4033,-0.5071591737192067,-43.44,IS,0.17,0.0,Phase3-EA-T1v2-EURJPY-M15-322,EURJPYMT4,322,23h 59m,Sell
46899.49,91.47,23.09.2009 21:15:00,,0.0,-668.7599999999802,0.0,0.0,91372,23.09.2009 20:00:00,4034,-0.4861296120289235,28.93,IS,0.27,0.0,Phase3-EA-S1v2-USDJPY-M15-0,USDJPYMT4,1450,1h 15m,Buy
46947.07,1.0255,24.09.2009 03:59:59,tp 1.02550,-8.98,-621.179999999993,0.0,0.0,1.0265,23.09.2009 23:45:00,4035,-0.45154314313076777,47.58,IS,0.58,0.0,Phase3-EA-SA2v2-USDCHF-M15-107,USDCHFMT4,872,4h 14m,Sell
46868.51,133892,24.09.2009 06:59:58,sl 133.892,-1.45,-699.7399999999907,0.0,0.0,134672,23.09.2009 11:30:00,4036,-0.508649343144214,-78.56,IS,0.09,0.0,Phase3-EA-TR1v1-EURJPY-M30-91,EURJPYMT4,406,19h 29m,Buy
46887.67,1513,24.09.2009 09:30:00,,0.0,-680.5799999999872,0.0,0.0,1.51252,24.09.2009 01:10:00,4037,-0.49472171085987254,19.16,IS,0.41,0.0,Phase3-EA-SA2v2-EURCHF-M5-43,EURCHFMT4,2206,8h 20m,Buy
46931.44,1.5094,24.09.2009 21:44:58,tp 1.50940,0.0,-636.8099999999977,0.0,0.0,1.5105,24.09.2009 21:05:00,4038,-0.46290477635646093,43.77,IS,0.41,0.0,Phase3-EA-SA2v2-EURCHF-M5-43,EURCHFMT4,2208,39m 58s,Sell
47029.71,146.2,25.09.2009 02:34:59,tp 146.200,0.0,-538.5400000000081,0.0,0.0,146.59,25.09.2009 00:10:00,4039,-0.3914711425056346,98.27,IS,0.23,0.0,Phase3-EA-S4v1-GBPJPY-M5-194,GBPJPYMT4,1084,2h 24m,Sell
47086.03,1.0298,25.09.2009 02:59:58,tp 1.02980,0.0,-482.22000000000116,0.0,0.0,1.0308,25.09.2009 02:45:00,4040,-0.35053146347358544,56.32,IS,0.58,0.0,Phase3-EA-SA2v2-USDCHF-M15-107,USDCHFMT4,874,14m 58s,Sell
47269.28,144.36,25.09.2009 04:29:58,tp 144.360,0.0,-298.97000000000116,0.0,0.0,146.21,25.09.2009 02:30:00,4041,-0.21732485511736965,183.25,IS,0.09,0.0,Phase3-EA-B1v1-GBPJPY-M30-1,GBPJPYMT4,478,1h 59m,Sell
47283.99,145.13,25.09.2009 08:30:00,,0.0,-284.2600000000093,0.0,0.0,145072,25.09.2009 03:05:00,4042,-0.20663198085314674,14.71,IS,0.23,0.0,Phase3-EA-S4v1-GBPJPY-M5-194,GBPJPYMT4,1086,5h 25m,Buy
47035.18,90382,25.09.2009 12:59:58,sl 90.382,-0.86,-533.070000000007,0.0,0.0,91212,24.09.2009 22:45:00,4043,-0.3874949343325996,-248.81,IS,0.27,0.0,Phase3-EA-S1v2-USDJPY-M15-0,USDJPYMT4,1452,14h 14m,Buy
47133.86,1.5113,25.09.2009 13:15:00,,0.0,-434.39000000001397,0.0,0.0,1.50832,25.09.2009 04:30:00,4044,-0.31576326659677184,98.68,IS,0.34,0.0,Phase3-EA-S4v1-EURCHF-M15-221,EURCHFMT4,1004,8h 45m,Buy
47259.04,132.4,25.09.2009 13:29:58,tp 132.400,-0.35,-309.21000000002095,0.0,0.0,133.66,24.09.2009 08:00:00,4045,-0.22476843312321024,125.18,IS,0.09,0.0,Phase3-EA-TR1v1-EURJPY-M30-91,EURJPYMT4,408,1d 5h 29m,Sell
47261.43,90232,25.09.2009 17:15:00,,0.0,-306.820000000007,0.0,0.0,90.24,25.09.2009 17:00:00,4046,-0.22303111364723088,2.39,IS,0.27,0.0,Phase3-EA-S1v2-USDJPY-M15-0,USDJPYMT4,1454,15m 0s,Sell
47582.75,132.01,25.09.2009 17:59:58,tp 132.010,-0.65,-0.0,0.0,0.0,133.71,24.09.2009 22:00:00,4047,-0.0,321.32,IS,0.17,0.0,Phase3-EA-T1v2-EURJPY-M15-322,EURJPYMT4,324,19h 59m,Sell
47626.6,1509,25.09.2009 23:19:57,tp 1.50900,0.0,-0.0,0.0,0.0,1.5101,25.09.2009 22:05:00,4048,-0.0,43.85,IS,0.41,0.0,Phase3-EA-SA2v2-EURCHF-M5-43,EURCHFMT4,2210,1h 14m,Sell
47710.35,89622,25.09.2009 23:45:00,,0.0,-0.0,0.0,0.0,89.9,25.09.2009 22:00:00,4049,-0.0,83.75,IS,0.27,0.0,Phase3-EA-S1v2-USDJPY-M15-0,USDJPYMT4,1456,1h 45m,Sell
47503.27,142042,28.09.2009 01:24:58,sl 142.042,-0.92,-207.0799999999872,0.0,0.0,142842,25.09.2009 23:45:00,4050,-0.15037359210835424,-207.08,IS,0.23,0.0,Phase3-EA-S4v1-GBPJPY-M5-194,GBPJPYMT4,1088,2d 1h 39m,Buy
47297.0,141232,28.09.2009 01:54:57,sl 141.232,0.0,-413.3499999999767,0.0,0.0,142032,28.09.2009 01:30:00,4051,-0.30015899313303346,-206.27,IS,0.23,0.0,Phase3-EA-S4v1-GBPJPY-M5-194,GBPJPYMT4,1090,24m 57s,Buy
47423.5,131.04,28.09.2009 01:59:58,tp 131.040,-0.35,-286.8499999999767,0.0,0.0,132.3,25.09.2009 16:00:00,4052,-0.2082995214230277,126.5,IS,0.09,0.0,Phase3-EA-TR1v1-EURJPY-M30-91,EURJPYMT4,410,2d 9h 59m,Sell
47609.16,141.5,28.09.2009 01:59:58,tp 141.500,-0.58,-101.18999999997322,0.0,0.0,143.35,25.09.2009 18:00:00,4053,-0.07348031574966815,185.66,IS,0.09,0.0,Phase3-EA-B1v1-GBPJPY-M30-1,GBPJPYMT4,480,2d 7h 59m,Sell
47402.05,140592,28.09.2009 02:09:58,sl 140.592,0.0,-308.29999999995925,0.0,0.0,141392,28.09.2009 02:00:00,4054,-0.22387569271297253,-207.11,IS,0.23,0.0,Phase3-EA-S4v1-GBPJPY-M5-194,GBPJPYMT4,1092,9m 58s,Buy
47530.11,129.84,28.09.2009 02:59:57,tp 129.840,0.0,-180.23999999996158,0.0,0.0,131.1,28.09.2009 02:00:00,4055,-0.13088340854551703,128.06,IS,0.09,0.0,Phase3-EA-TR1v1-EURJPY-M30-91,EURJPYMT4,412,59m 57s,Sell
47573.72,1.51042,28.09.2009 04:44:58,tp 1.51042,0.0,-136.62999999997555,0.0,0.0,1.50932,28.09.2009 02:30:00,4056,-0.09921549106510544,43.61,IS,0.41,0.0,Phase3-EA-SA2v2-EURCHF-M5-43,EURCHFMT4,2212,2h 14m,Buy
47546.68,1.51192,28.09.2009 14:30:00,,0.0,-163.6699999999837,0.0,0.0,1.5111,28.09.2009 05:45:00,4057,-0.1188509069942699,-27.04,IS,0.34,0.0,Phase3-EA-S4v1-EURCHF-M15-221,EURCHFMT4,1006,8h 45m,Sell
47474.23,131.2,28.09.2009 15:29:59,sl 131.200,0.0,-236.11999999999534,0.0,0.0,130.48,28.09.2009 03:00:00,4058,-0.17146133170091798,-72.45,IS,0.09,0.0,Phase3-EA-TR1v1-EURJPY-M30-91,EURJPYMT4,414,12h 29m,Sell
47430.6,130.9,28.09.2009 21:29:57,sl 130.900,0.0,-279.75,0.0,0.0,130.67,28.09.2009 20:15:00,4059,-0.2031437724179771,-43.63,IS,0.17,0.0,Phase3-EA-T1v2-EURJPY-M15-322,EURJPYMT4,326,1h 14m,Sell
47486.73,1.03332,29.09.2009 03:44:58,tp 1.03332,0.0,-223.61999999999534,0.0,0.0,1.03232,29.09.2009 00:30:00,4060,-0.16238430880467236,56.13,IS,0.58,0.0,Phase3-EA-SA2v2-USDCHF-M15-107,USDCHFMT4,876,3h 14m,Buy
47450.16,1.51052,29.09.2009 08:25:00,,0.0,-260.1900000000023,0.0,0.0,1.5096,29.09.2009 00:05:00,4061,-0.18894004698993364,-36.57,IS,0.41,0.0,Phase3-EA-SA2v2-EURCHF-M5-43,EURCHFMT4,2214,8h 20m,Sell
47408.16,1.58732,29.09.2009 10:29:58,sl 1.58732,0.0,-302.1900000000023,0.0,0.0,1.59032,29.09.2009 05:00:00,4062,-0.21943884392131893,-42.0,IS,0.14,0.0,Phase3-EA-B1v1-GBPUSD-M30-14,GBPUSDMT4,260,5h 29m,Buy
47341.08,142412,29.09.2009 10:29:58,sl 142.412,0.0,-369.2699999999895,0.0,0.0,143082,29.09.2009 05:30:00,4063,-0.26814977959172215,-67.08,IS,0.09,0.0,Phase3-EA-B1v1-GBPJPY-M30-1,GBPJPYMT4,482,4h 59m,Buy
47340.42,1.50972,29.09.2009 10:45:00,,0.0,-369.929999999993,0.0,0.0,1.5097,29.09.2009 02:00:00,4064,-0.2686290464006465,-0.66,IS,0.34,0.0,Phase3-EA-S4v1-EURCHF-M15-221,EURCHFMT4,1008,8h 45m,Sell
47268.12,130742,29.09.2009 10:59:58,sl 130.742,0.0,-442.2299999999814,0.0,0.0,131462,29.09.2009 03:00:00,4065,-0.32113054683252273,-72.3,IS,0.09,0.0,Phase3-EA-TR1v1-EURJPY-M30-91,EURJPYMT4,416,7h 59m,Buy
47275.64,90.15,30.09.2009 02:45:00,,-0.87,-434.70999999999185,0.0,0.0,90122,29.09.2009 20:45:00,4066,-0.31566980985814896,7.52,IS,0.27,0.0,Phase3-EA-S1v2-USDJPY-M15-0,USDJPYMT4,1458,6h 0m,Buy
47318.23,1.51202,30.09.2009 03:59:57,tp 1.51202,-0.95,-392.11999999999534,0.0,0.0,1.51092,29.09.2009 20:55:00,4067,-0.2847425774460634,42.59,IS,0.41,0.0,Phase3-EA-SA2v2-EURCHF-M5-43,EURCHFMT4,2216,7h 4m,Buy
47417.69,143.91,30.09.2009 03:59:58,tp 143.910,0.0,-292.6600000000035,0.0,0.0,144.3,30.09.2009 03:25:00,4068,-0.21251852166522212,99.46,IS,0.23,0.0,Phase3-EA-S4v1-GBPJPY-M5-194,GBPJPYMT4,1094,34m 58s,Sell
47321.23,1.0342,30.09.2009 04:30:00,,0.0,-389.11999999999534,0.0,0.0,1.03592,30.09.2009 00:15:00,4069,-0.28256409195096444,-96.46,IS,0.58,0.0,Phase3-EA-SA2v2-USDCHF-M15-107,USDCHFMT4,878,4h 15m,Buy
47396.58,1.50932,30.09.2009 12:30:00,,0.0,-313.7699999999895,0.0,0.0,1.5116,30.09.2009 03:45:00,4070,-0.2278477979323916,75.35,IS,0.34,0.0,Phase3-EA-S4v1-EURCHF-M15-221,EURCHFMT4,1010,8h 45m,Sell
47352.98,131.31,30.09.2009 19:59:59,sl 131.310,0.0,-357.36999999999534,0.0,0.0,131.08,30.09.2009 15:30:00,4071,-0.25950845379450055,-43.6,IS,0.17,0.0,Phase3-EA-T1v2-EURJPY-M15-322,EURJPYMT4,328,4h 29m,Sell
47345.39,1.5165,01.10.2009 07:40:00,,-2.85,-364.95999999999185,0.0,0.0,1.51662,30.09.2009 23:20:00,4072,-0.26502002209709835,-7.59,IS,0.41,0.0,Phase3-EA-SA2v2-EURCHF-M5-43,EURCHFMT4,2218,8h 20m,Buy
47265.89,130662,01.10.2009 15:59:58,sl 130.662,-1.47,-444.45999999999185,0.0,0.0,131442,30.09.2009 20:30:00,4073,-0.3227498877172206,-79.5,IS,0.09,0.0,Phase3-EA-TR1v1-EURJPY-M30-91,EURJPYMT4,418,19h 29m,Buy
47288.04,89582,02.10.2009 00:15:00,,-1.36,-422.3099999999977,0.0,0.0,89.66,01.10.2009 20:30:00,4074,-0.3066654031450775,22.15,IS,0.27,0.0,Phase3-EA-S1v2-USDJPY-M15-0,USDJPYMT4,1460,3h 45m,Sell
47082.34,141992,02.10.2009 03:14:57,sl 141.992,0.0,-628.0100000000093,0.0,0.0,142792,02.10.2009 00:10:00,4075,-0.456036891925704,-205.7,IS,0.23,0.0,Phase3-EA-S4v1-GBPJPY-M5-194,GBPJPYMT4,1096,3h 4m,Buy
47049.14,1.5137,02.10.2009 04:20:00,,-0.95,-661.210000000021,0.0,0.0,1.51452,01.10.2009 20:00:00,4076,-0.48014546473814085,-33.2,IS,0.41,0.0,Phase3-EA-SA2v2-EURCHF-M5-43,EURCHFMT4,2220,8h 20m,Buy
47104.08,1.51222,02.10.2009 13:45:00,,0.0,-606.2700000000186,0.0,0.0,1.5139,02.10.2009 05:00:00,4077,-0.4402501337045604,54.94,IS,0.34,0.0,Phase3-EA-S4v1-EURCHF-M15-221,EURCHFMT4,1012,8h 45m,Sell
47230.86,129.14,02.10.2009 15:59:57,tp 129.140,-0.35,-479.4900000000198,0.0,0.0,130.4,01.10.2009 17:30:00,4078,-0.34818733668167956,126.78,IS,0.09,0.0,Phase3-EA-TR1v1-EURJPY-M30-91,EURJPYMT4,420,22h 29m,Sell
47186.98,130.21,02.10.2009 17:29:59,sl 130.210,0.0,-523.3700000000244,0.0,0.0,129.98,02.10.2009 13:45:00,4079,-0.38005131785666363,-43.88,IS,0.17,0.0,Phase3-EA-T1v2-EURJPY-M15-322,EURJPYMT4,330,3h 44m,Sell
47119.38,142.65,02.10.2009 18:29:58,sl 142.650,0.0,-590.9700000000303,0.0,0.0,141.98,02.10.2009 10:30:00,4080,-0.4291398576795642,-67.6,IS,0.09,0.0,Phase3-EA-B1v1-GBPJPY-M30-1,GBPJPYMT4,484,7h 59m,Sell
47162.95,1.50972,02.10.2009 23:54:57,tp 1.50972,0.0,-547.4000000000233,0.0,0.0,1.50862,02.10.2009 20:15:00,4081,-0.39750098667240535,43.57,IS,0.41,0.0,Phase3-EA-SA2v2-EURCHF-M5-43,EURCHFMT4,2222,3h 39m,Buy
47261.36,142.66,05.10.2009 01:00:00,tp 142.660,-1.49,-448.9900000000198,0.0,0.0,143.05,02.10.2009 23:40:00,4082,-0.32603940081484023,98.41,IS,0.23,0.0,Phase3-EA-S4v1-GBPJPY-M5-194,GBPJPYMT4,1098,2d 1h 20m,Sell
47314.49,1.0339,05.10.2009 01:59:59,tp 1.03390,-2.97,-395.86000000001513,0.0,0.0,1.0349,02.10.2009 22:45:00,4083,-0.28745842269663446,53.13,IS,0.58,0.0,Phase3-EA-SA2v2-USDCHF-M15-107,USDCHFMT4,880,2d 3h 14m,Sell
47370.58,1.03412,05.10.2009 02:44:58,tp 1.03412,0.0,-339.7700000000186,0.0,0.0,1.03312,05.10.2009 02:15:00,4084,-0.24672800555660362,56.09,IS,0.58,0.0,Phase3-EA-SA2v2-USDCHF-M15-107,USDCHFMT4,882,29m 58s,Buy
47418.12,89.74,05.10.2009 03:15:00,,0.0,-292.2300000000105,0.0,0.0,89582,05.10.2009 01:15:00,4085,-0.21220627207759635,47.54,IS,0.27,0.0,Phase3-EA-S1v2-USDJPY-M15-0,USDJPYMT4,1462,2h 0m,Buy
47375.43,1.5959,05.10.2009 03:29:58,sl 1.59590,-0.69,-334.9200000000128,0.0,0.0,1.5929,02.10.2009 01:30:00,4086,-0.2432061206728561,-42.69,IS,0.14,0.0,Phase3-EA-B1v1-GBPUSD-M30-14,GBPUSDMT4,262,3d 1h 59m,Sell
47504.02,131622,05.10.2009 04:29:58,tp 131.622,-0.49,-206.3300000000163,0.0,0.0,130332,02.10.2009 17:30:00,4087,-0.14982897073460064,128.59,IS,0.09,0.0,Phase3-EA-TR1v1-EURJPY-M30-91,EURJPYMT4,422,2d 10h 59m,Buy
47403.6,143632,05.10.2009 08:40:00,,0.0,-306.7500000000291,0.0,0.0,143.24,05.10.2009 03:15:00,4088,-0.22275014187388878,-100.42,IS,0.23,0.0,Phase3-EA-S4v1-GBPJPY-M5-194,GBPJPYMT4,1100,5h 25m,Sell
47382.94,1.51052,05.10.2009 09:55:00,,0.0,-327.4100000000326,0.0,0.0,1.51,05.10.2009 01:35:00,4089,-0.2377526453168061,-20.66,IS,0.41,0.0,Phase3-EA-SA2v2-EURCHF-M5-43,EURCHFMT4,2224,8h 20m,Sell
47372.41,1.51042,05.10.2009 13:15:00,,0.0,-337.94000000003143,0.0,0.0,1.5101,05.10.2009 04:30:00,4090,-0.24539912940460257,-10.53,IS,0.34,0.0,Phase3-EA-S4v1-EURCHF-M15-221,EURCHFMT4,1014,8h 45m,Sell
47416.13,1.5116,05.10.2009 23:04:57,tp 1.51160,0.0,-294.22000000003027,0.0,0.0,1.5127,05.10.2009 20:20:00,4091,-0.21365133412269302,43.72,IS,0.41,0.0,Phase3-EA-SA2v2-EURCHF-M5-43,EURCHFMT4,2226,2h 44m,Sell
47372.48,131.34,06.10.2009 02:59:57,sl 131.340,0.0,-337.87000000002445,0.0,0.0,131.11,06.10.2009 02:00:00,4092,-0.2453482980763785,-43.65,IS,0.17,0.0,Phase3-EA-T1v2-EURJPY-M15-322,EURJPYMT4,332,59m 57s,Sell
47382.59,89472,06.10.2009 03:30:00,,-1.36,-327.7600000000384,0.0,0.0,89.51,05.10.2009 23:15:00,4093,-0.2380068019579052,10.11,IS,0.27,0.0,Phase3-EA-S1v2-USDJPY-M15-0,USDJPYMT4,1464,4h 15m,Sell
47482.88,142.51,06.10.2009 03:54:59,tp 142.510,0.0,-227.47000000003027,0.0,0.0,142.9,06.10.2009 02:55:00,4094,-0.16518003185674138,100.29,IS,0.23,0.0,Phase3-EA-S4v1-GBPJPY-M5-194,GBPJPYMT4,1102,59m 59s,Sell
47409.77,130762,06.10.2009 04:59:58,sl 130.762,-0.49,-300.5800000000163,0.0,0.0,131482,05.10.2009 06:00:00,4095,-0.21826972337229264,-73.11,IS,0.09,0.0,Phase3-EA-TR1v1-EURJPY-M30-91,EURJPYMT4,424,22h 59m,Buy
47341.47,142022,06.10.2009 04:59:58,sl 142.022,-0.72,-368.88000000000466,0.0,0.0,142692,02.10.2009 18:30:00,4096,-0.2678665764773703,-68.3,IS,0.09,0.0,Phase3-EA-B1v1-GBPJPY-M30-1,GBPJPYMT4,486,3d 10h 29m,Buy
47297.56,131.13,06.10.2009 06:44:57,sl 131.130,0.0,-412.79000000000815,0.0,0.0,130.9,06.10.2009 04:15:00,4097,-0.2997523425073045,-43.91,IS,0.17,0.0,Phase3-EA-T1v2-EURJPY-M15-322,EURJPYMT4,334,2h 29m,Sell
47326.01,88732,07.10.2009 01:30:00,,-1.37,-384.3399999999965,0.0,0.0,88.83,06.10.2009 21:00:00,4098,-0.279093038395441,28.45,IS,0.27,0.0,Phase3-EA-S1v2-USDJPY-M15-0,USDJPYMT4,1466,4h 30m,Sell
47382.5,1.02682,07.10.2009 03:14:57,tp 1.02682,0.0,-327.8500000000058,0.0,0.0,1.02582,07.10.2009 02:30:00,4099,-0.2380721565227345,56.49,IS,0.58,0.0,Phase3-EA-SA2v2-USDCHF-M15-107,USDCHFMT4,884,44m 57s,Buy
47355.78,1.51232,07.10.2009 08:05:00,,-2.0,-354.570000000007,0.0,0.0,1.5117,06.10.2009 23:45:00,4100,-0.25747520066574997,-26.72,IS,0.41,0.0,Phase3-EA-SA2v2-EURCHF-M5-43,EURCHFMT4,2228,8h 20m,Sell
47275.83,1.51392,07.10.2009 10:15:00,,0.0,-434.5200000000186,0.0,0.0,1.5115,07.10.2009 01:30:00,4101,-0.3155318391101455,-79.95,IS,0.34,0.0,Phase3-EA-S4v1-EURCHF-M15-221,EURCHFMT4,1016,8h 45m,Sell
47202.55,130.48,07.10.2009 14:29:58,sl 130.480,0.0,-507.80000000001746,0.0,0.0,129.76,07.10.2009 11:00:00,4102,-0.368744978137095,-73.28,IS,0.09,0.0,Phase3-EA-TR1v1-EURJPY-M30-91,EURJPYMT4,426,3h 29m,Sell
47159.86,1.5947,07.10.2009 20:59:58,sl 1.59470,-0.69,-550.4900000000198,0.0,0.0,1.5917,06.10.2009 14:00:00,4103,-0.39974482673235473,-42.69,IS,0.14,0.0,Phase3-EA-B1v1-GBPUSD-M30-14,GBPUSDMT4,264,1d 6h 59m,Sell
47138.33,88.68,08.10.2009 02:00:00,,-2.65,-572.0200000000186,0.0,0.0,88742,07.10.2009 18:30:00,4104,-0.41537909096884734,-21.53,IS,0.27,0.0,Phase3-EA-S1v2-USDJPY-M15-0,USDJPYMT4,1468,7h 30m,Buy
47239.66,141.02,08.10.2009 03:34:58,tp 141.020,0.0,-470.69000000003143,0.0,0.0,141.41,08.10.2009 00:05:00,4105,-0.3417971125627311,101.33,IS,0.23,0.0,Phase3-EA-S4v1-GBPJPY-M5-194,GBPJPYMT4,1104,3h 29m,Sell
47019.86,1.02912,08.10.2009 04:29:58,sl 1.02912,0.0,-690.4900000000198,0.0,0.0,1.03302,08.10.2009 00:15:00,4106,-0.5014074831703057,-219.8,IS,0.58,0.0,Phase3-EA-SA2v2-USDCHF-M15-107,USDCHFMT4,886,4h 14m,Buy
47017.09,1.51742,08.10.2009 04:45:00,,-5.96,-693.2600000000093,0.0,0.0,1.5175,07.10.2009 20:25:00,4107,-0.5034189514441062,-2.77,IS,0.41,0.0,Phase3-EA-SA2v2-EURCHF-M5-43,EURCHFMT4,2230,8h 20m,Sell
47059.23,1518,09.10.2009 04:20:00,,-0.96,-651.1199999999953,0.0,0.0,1.51692,08.10.2009 20:00:00,4108,-0.4728184918562728,42.14,IS,0.41,0.0,Phase3-EA-SA2v2-EURCHF-M5-43,EURCHFMT4,2232,8h 20m,Buy
47011.83,131.29,09.10.2009 04:29:57,sl 131.290,-3.35,-698.5199999999895,0.0,0.0,131.06,06.10.2009 16:15:00,4109,-0.5072385626788319,-47.4,IS,0.17,0.0,Phase3-EA-T1v2-EURJPY-M15-322,EURJPYMT4,336,2d 12h 14m,Sell
46792.45,1.0311,09.10.2009 05:44:59,sl 1.03110,0.0,-917.8999999999942,0.0,0.0,1.0272,09.10.2009 02:30:00,4110,-0.6665439453171046,-219.38,IS,0.58,0.0,Phase3-EA-SA2v2-USDCHF-M15-107,USDCHFMT4,888,3h 14m,Sell
46768.72,1.51862,09.10.2009 10:00:00,,0.0,-941.6300000000047,0.0,0.0,1.5179,09.10.2009 01:15:00,4111,-0.6837757655833449,-23.73,IS,0.34,0.0,Phase3-EA-S4v1-EURCHF-M15-221,EURCHFMT4,1018,8h 45m,Sell
46690.28,132.12,09.10.2009 18:59:58,sl 132.120,0.0,-1020.070000000007,0.0,0.0,131.34,09.10.2009 11:30:00,4112,-0.7407358996618671,-78.44,IS,0.09,0.0,Phase3-EA-TR1v1-EURJPY-M30-91,EURJPYMT4,428,7h 29m,Sell
46954.88,1.5839,09.10.2009 21:29:58,tp 1.58390,0.0,-755.4700000000012,0.0,0.0,1.6028,09.10.2009 05:00:00,4113,-0.5485934789941355,264.6,IS,0.14,0.0,Phase3-EA-B1v1-GBPUSD-M30-14,GBPUSDMT4,266,16h 29m,Sell
46968.44,89.79,12.10.2009 01:45:00,,-0.87,-741.9100000000035,0.0,0.0,89742,09.10.2009 23:45:00,4114,-0.5387467245562899,13.56,IS,0.27,0.0,Phase3-EA-S1v2-USDJPY-M15-0,USDJPYMT4,1470,2d 2h 0m,Buy
46939.85,142642,12.10.2009 07:00:00,,0.0,-770.5,0.0,0.0,142.53,12.10.2009 01:35:00,4115,-0.5595076913245803,-28.59,IS,0.23,0.0,Phase3-EA-S4v1-GBPJPY-M5-194,GBPJPYMT4,1106,5h 25m,Sell
47258.74,133092,12.10.2009 12:44:58,tp 133.092,-0.93,-451.60999999998603,0.0,0.0,131392,09.10.2009 16:30:00,4116,-0.32794194481386885,318.89,IS,0.17,0.0,Phase3-EA-T1v2-EURJPY-M15-322,EURJPYMT4,338,2d 20h 14m,Buy
47216.74,1.5841,12.10.2009 16:59:58,sl 1.58410,0.0,-493.60999999998603,0.0,0.0,1.5811,12.10.2009 09:30:00,4117,-0.35844074174525414,-42.0,IS,0.14,0.0,Phase3-EA-B1v1-GBPUSD-M30-14,GBPUSDMT4,268,7h 29m,Sell
47238.85,89772,13.10.2009 01:30:00,,-1.35,-471.5,0.0,0.0,89.85,12.10.2009 20:30:00,4118,-0.34238530364638503,22.11,IS,0.27,0.0,Phase3-EA-S1v2-USDJPY-M15-0,USDJPYMT4,1472,5h 0m,Sell
47295.36,1.02632,13.10.2009 03:59:58,tp 1.02632,0.0,-414.9899999999907,0.0,0.0,1.02532,13.10.2009 02:30:00,4119,-0.30134989853703104,56.51,IS,0.58,0.0,Phase3-EA-SA2v2-USDCHF-M15-107,USDCHFMT4,890,1h 29m,Buy
47304.55,1.51702,13.10.2009 06:20:00,,-2.0,-405.79999999998836,0.0,0.0,1.5173,12.10.2009 22:00:00,4120,-0.29467647130370955,9.19,IS,0.41,0.0,Phase3-EA-SA2v2-EURCHF-M5-43,EURCHFMT4,2234,8h 20m,Sell
47261.09,132.97,13.10.2009 08:44:57,sl 132.970,0.0,-449.2599999999802,0.0,0.0,132.74,13.10.2009 06:15:00,4121,-0.3262354645093704,-43.46,IS,0.17,0.0,Phase3-EA-T1v2-EURJPY-M15-322,EURJPYMT4,340,2h 29m,Sell
47290.61,89622,13.10.2009 21:00:00,,0.0,-419.7399999999907,0.0,0.0,89.72,13.10.2009 17:00:00,4122,-0.30479916723760436,29.52,IS,0.27,0.0,Phase3-EA-S1v2-USDJPY-M15-0,USDJPYMT4,1474,4h 0m,Sell
47390.57,142.72,14.10.2009 03:59:57,tp 142.720,0.0,-319.77999999999884,0.0,0.0,143.11,14.10.2009 02:45:00,4123,-0.23221203054091324,99.96,IS,0.23,0.0,Phase3-EA-S4v1-GBPJPY-M5-194,GBPJPYMT4,1108,1h 14m,Sell
47346.01,132852,14.10.2009 04:44:58,sl 132.852,-0.93,-364.3399999999965,0.0,0.0,133082,13.10.2009 19:45:00,4124,-0.26456980176144795,-44.56,IS,0.17,0.0,Phase3-EA-T1v2-EURJPY-M15-322,EURJPYMT4,342,8h 59m,Buy
47375.42,1.51672,14.10.2009 12:45:00,,0.0,-334.929999999993,0.0,0.0,1.5176,14.10.2009 04:00:00,4125,-0.24321338229115871,29.41,IS,0.34,0.0,Phase3-EA-S4v1-EURCHF-M15-221,EURCHFMT4,1020,8h 45m,Sell
47333.42,1.59722,14.10.2009 13:29:57,sl 1.59722,0.0,-376.929999999993,0.0,0.0,1.60022,14.10.2009 12:00:00,4126,-0.27371217922254404,-42.0,IS,0.14,0.0,Phase3-EA-B1v1-GBPUSD-M30-14,GBPUSDMT4,270,1h 29m,Buy
47363.34,89.58,15.10.2009 03:15:00,,-2.63,-347.0099999999802,0.0,0.0,89472,14.10.2009 18:45:00,4127,-0.2519854172180812,29.92,IS,0.27,0.0,Phase3-EA-S1v2-USDJPY-M15-0,USDJPYMT4,1476,8h 30m,Buy
47323.17,1.5141,15.10.2009 04:20:00,,-2.91,-387.179999999993,0.0,0.0,1.51502,14.10.2009 20:00:00,4128,-0.28115533799746545,-40.17,IS,0.41,0.0,Phase3-EA-SA2v2-EURCHF-M5-43,EURCHFMT4,2236,8h 20m,Buy
47253.22,143672,15.10.2009 09:00:00,,0.0,-457.13000000000466,0.0,0.0,143.4,15.10.2009 03:35:00,4129,-0.3319503581248644,-69.95,IS,0.23,0.0,Phase3-EA-S4v1-GBPJPY-M5-194,GBPJPYMT4,1110,5h 25m,Sell
47517.82,1.61912,15.10.2009 11:29:58,tp 1.61912,0.0,-192.52999999999884,0.0,0.0,1.60022,15.10.2009 02:30:00,4130,-0.13980793745713277,264.6,IS,0.14,0.0,Phase3-EA-B1v1-GBPUSD-M30-14,GBPUSDMT4,272,8h 59m,Buy
47641.75,134032,15.10.2009 11:59:58,tp 134.032,-2.46,-68.60000000000582,0.0,0.0,132772,12.10.2009 09:00:00,4131,-0.049814701654600224,123.93,IS,0.09,0.0,Phase3-EA-TR1v1-EURJPY-M30-91,EURJPYMT4,430,3d 2h 59m,Buy
47827.55,145692,15.10.2009 12:29:59,tp 145.692,0.0,-0.0,0.0,0.0,143842,15.10.2009 09:30:00,4132,-0.0,185.8,IS,0.09,0.0,Phase3-EA-B1v1-GBPJPY-M30-1,GBPJPYMT4,488,2h 59m,Buy
47779.95,1.5132,15.10.2009 13:30:00,,0.0,-47.60000000000582,0.0,0.0,1.51462,15.10.2009 04:45:00,4133,-0.034535910998930025,-47.6,IS,0.34,0.0,Phase3-EA-S4v1-EURCHF-M15-221,EURCHFMT4,1022,8h 45m,Buy
47702.48,135.04,15.10.2009 16:59:58,sl 135.040,0.0,-125.07000000000698,0.0,0.0,134.26,15.10.2009 15:30:00,4134,-0.09074383169403133,-77.47,IS,0.09,0.0,Phase3-EA-TR1v1-EURJPY-M30-91,EURJPYMT4,432,1h 29m,Sell
47788.23,90.68,15.10.2009 20:15:00,,0.0,-39.320000000006985,0.0,0.0,90392,15.10.2009 18:15:00,4135,-0.0285284037915547,85.75,IS,0.27,0.0,Phase3-EA-S1v2-USDJPY-M15-0,USDJPYMT4,1478,2h 0m,Buy
47838.23,90.72,16.10.2009 02:30:00,,0.0,-0.0,0.0,0.0,90552,16.10.2009 01:00:00,4136,-0.0,50.0,IS,0.27,0.0,Phase3-EA-S1v2-USDJPY-M15-0,USDJPYMT4,1480,1h 30m,Buy
47819.22,1.51632,16.10.2009 04:45:00,,-2.02,-19.010000000009313,0.0,0.0,1.5159,15.10.2009 20:25:00,4137,-0.013791529389204506,-19.01,IS,0.41,0.0,Phase3-EA-SA2v2-EURCHF-M5-43,EURCHFMT4,2238,8h 20m,Sell
47780.75,148432,16.10.2009 08:10:00,,0.0,-57.48000000001048,0.0,0.0,148.28,16.10.2009 02:45:00,4138,-0.041701057826997956,-38.47,IS,0.23,0.0,Phase3-EA-S4v1-GBPJPY-M5-194,GBPJPYMT4,1112,5h 25m,Sell
47825.04,1.51782,16.10.2009 23:50:00,tp 1.51782,0.0,-13.190000000002328,0.0,0.0,1.51672,16.10.2009 21:30:00,4139,-0.009569188460996865,44.29,IS,0.41,0.0,Phase3-EA-SA2v2-EURCHF-M5-43,EURCHFMT4,2240,2h 20m,Buy
47811.72,91.01,19.10.2009 01:30:00,,-0.86,-26.510000000009313,0.0,0.0,91052,16.10.2009 17:00:00,4140,-0.019232690379156273,-13.32,IS,0.27,0.0,Phase3-EA-S1v2-USDJPY-M15-0,USDJPYMT4,1482,2d 8h 30m,Buy
47910.31,148.61,19.10.2009 02:39:58,tp 148.610,0.0,-0.0,0.0,0.0,149.0,19.10.2009 02:10:00,4141,-0.0,98.59,IS,0.23,0.0,Phase3-EA-S4v1-GBPJPY-M5-194,GBPJPYMT4,1114,29m 58s,Sell
47967.24,1.01882,19.10.2009 03:14:57,tp 1.01882,0.0,-0.0,0.0,0.0,1.01782,19.10.2009 02:15:00,4142,-0.0,56.93,IS,0.58,0.0,Phase3-EA-SA2v2-USDCHF-M15-107,USDCHFMT4,892,59m 57s,Buy
47924.16,135.23,19.10.2009 08:44:59,sl 135.230,0.0,-43.079999999987194,0.0,0.0,135.0,19.10.2009 03:45:00,4143,-0.03122480380124091,-43.08,IS,0.17,0.0,Phase3-EA-T1v2-EURJPY-M15-322,EURJPYMT4,344,4h 59m,Sell
47918.59,148.34,19.10.2009 08:45:00,,0.0,-48.64999999999418,0.0,0.0,148362,19.10.2009 03:20:00,4144,-0.03526199407916992,-5.57,IS,0.23,0.0,Phase3-EA-S4v1-GBPJPY-M5-194,GBPJPYMT4,1116,5h 25m,Buy
48025.25,1.51422,19.10.2009 14:45:00,,0.0,-0.0,0.0,0.0,1.5174,19.10.2009 06:00:00,4145,-0.0,106.66,IS,0.34,0.0,Phase3-EA-S4v1-EURCHF-M15-221,EURCHFMT4,1024,8h 45m,Sell
48059.09,90572,20.10.2009 00:15:00,,-1.34,-0.0,0.0,0.0,90.69,19.10.2009 21:45:00,4146,-0.0,33.84,IS,0.27,0.0,Phase3-EA-S1v2-USDJPY-M15-0,USDJPYMT4,1484,2h 30m,Sell
48158.02,148.5,20.10.2009 03:29:58,tp 148.500,0.0,-0.0,0.0,0.0,148.89,20.10.2009 01:00:00,4147,-0.0,98.93,IS,0.23,0.0,Phase3-EA-S4v1-GBPJPY-M5-194,GBPJPYMT4,1118,2h 29m,Sell
48114.87,135482,20.10.2009 04:14:59,sl 135.482,0.0,-43.14999999999418,0.0,0.0,135712,20.10.2009 00:45:00,4148,-0.031232352635043665,-43.15,IS,0.17,0.0,Phase3-EA-T1v2-EURJPY-M15-322,EURJPYMT4,346,3h 29m,Buy
48128.27,1.51342,20.10.2009 04:45:00,,-2.03,-29.75,0.0,0.0,1.5138,19.10.2009 20:25:00,4149,-0.021533313809795465,13.4,IS,0.41,0.0,Phase3-EA-SA2v2-EURCHF-M5-43,EURCHFMT4,2242,8h 20m,Sell
48310.19,149332,20.10.2009 18:29:58,tp 149.332,-1.08,-0.0,0.0,0.0,147482,15.10.2009 21:30:00,4150,-0.0,181.92,IS,0.09,0.0,Phase3-EA-B1v1-GBPJPY-M30-1,GBPJPYMT4,490,4d 20h 59m,Buy
48367.47,1.01262,21.10.2009 02:14:57,tp 1.01262,0.0,-0.0,0.0,0.0,1.01162,21.10.2009 00:15:00,4151,-0.0,57.28,IS,0.58,0.0,Phase3-EA-SA2v2-USDCHF-M15-107,USDCHFMT4,894,1h 59m,Buy
48398.73,90.79,21.10.2009 02:45:00,,-0.86,-0.0,0.0,0.0,90682,20.10.2009 22:00:00,4152,-0.0,31.26,IS,0.27,0.0,Phase3-EA-S1v2-USDJPY-M15-0,USDJPYMT4,1486,4h 45m,Buy
48417.19,1.5119,21.10.2009 04:35:00,,-0.97,-0.0,0.0,0.0,1.51142,20.10.2009 20:15:00,4153,-0.0,18.46,IS,0.41,0.0,Phase3-EA-SA2v2-EURCHF-M5-43,EURCHFMT4,2244,8h 20m,Buy
48338.99,136.32,21.10.2009 16:29:58,sl 136.320,-1.05,-78.20000000001164,0.0,0.0,135.54,16.10.2009 05:00:00,4154,-0.056495873092071575,-78.2,IS,0.09,0.0,Phase3-EA-TR1v1-EURJPY-M30-91,EURJPYMT4,434,5d 11h 29m,Sell
48376.92,91.12,21.10.2009 17:15:00,,0.0,-40.27000000001863,0.0,0.0,90992,21.10.2009 17:00:00,4155,-0.029093207281565676,37.93,IS,0.27,0.0,Phase3-EA-S1v2-USDJPY-M15-0,USDJPYMT4,1488,15m 0s,Buy
48434.57,1.0061,21.10.2009 23:29:59,tp 1.00610,0.0,-0.0,0.0,0.0,1.0071,21.10.2009 23:00:00,4156,-0.0,57.65,IS,0.58,0.0,Phase3-EA-SA2v2-USDCHF-M15-107,USDCHFMT4,896,29m 59s,Sell
48530.46,151202,22.10.2009 03:34:57,tp 151.202,-2.73,-0.0,0.0,0.0,150812,21.10.2009 23:10:00,4157,-0.0,95.89,IS,0.23,0.0,Phase3-EA-S4v1-GBPJPY-M5-194,GBPJPYMT4,1120,4h 24m,Buy
48464.52,150812,22.10.2009 11:59:57,sl 150.812,0.0,-65.94000000000233,0.0,0.0,151482,22.10.2009 04:00:00,4158,-0.0475996398192876,-65.94,IS,0.09,0.0,Phase3-EA-B1v1-GBPJPY-M30-1,GBPJPYMT4,492,7h 59m,Buy
48522.28,1.0041,23.10.2009 03:15:00,tp 1.00410,0.0,-8.179999999993015,0.0,0.0,1.0051,23.10.2009 00:45:00,4159,-0.005904838545972496,57.76,IS,0.58,0.0,Phase3-EA-SA2v2-USDCHF-M15-107,USDCHFMT4,898,2h 30m,Sell
48566.22,1.51122,23.10.2009 04:19:58,tp 1.51122,-0.98,-0.0,0.0,0.0,1.51012,22.10.2009 20:35:00,4160,-0.0,43.94,IS,0.41,0.0,Phase3-EA-SA2v2-EURCHF-M5-43,EURCHFMT4,2246,7h 44m,Buy
48687.79,137892,23.10.2009 11:29:57,tp 137.892,-1.93,-0.0,0.0,0.0,136632,21.10.2009 17:30:00,4161,-0.0,121.57,IS,0.09,0.0,Phase3-EA-TR1v1-EURJPY-M30-91,EURJPYMT4,436,1d 17h 59m,Buy
48622.16,152102,23.10.2009 12:59:57,sl 152.102,0.0,-65.63000000000466,0.0,0.0,152772,23.10.2009 10:30:00,4162,-0.0473221182629016,-65.63,IS,0.09,0.0,Phase3-EA-B1v1-GBPJPY-M30-1,GBPJPYMT4,494,2h 29m,Buy
48570.79,1.51212,23.10.2009 13:00:00,,0.0,-117.0,0.0,0.0,1.5106,23.10.2009 04:15:00,4163,-0.08436214896783627,-51.37,IS,0.34,0.0,Phase3-EA-S4v1-EURCHF-M15-221,EURCHFMT4,1026,8h 45m,Sell
48528.91,91542,23.10.2009 14:30:00,,0.0,-158.88000000000466,0.0,0.0,91.4,23.10.2009 00:30:00,4164,-0.11455947203427537,-41.88,IS,0.27,0.0,Phase3-EA-S1v2-USDJPY-M15-0,USDJPYMT4,1490,14h 0m,Sell
48571.64,1.5125,26.10.2009 02:09:59,tp 1.51250,-2.03,-116.14999999999418,0.0,0.0,1.5136,23.10.2009 23:40:00,4165,-0.08374926156080077,42.73,IS,0.41,0.0,Phase3-EA-SA2v2-EURCHF-M5-43,EURCHFMT4,2248,2d 2h 29m,Sell
48759.82,137.89,26.10.2009 03:30:00,,-1.81,-0.0,0.0,0.0,136862,22.10.2009 15:00:00,4166,-0.0,188.18,IS,0.17,0.0,Phase3-EA-T1v2-EURJPY-M15-322,EURJPYMT4,348,3d 12h 30m,Buy
48804.63,1.51352,26.10.2009 04:49:57,tp 1.51352,0.0,-0.0,0.0,0.0,1.51242,26.10.2009 02:20:00,4167,-0.0,44.81,IS,0.41,0.0,Phase3-EA-SA2v2-EURCHF-M5-43,EURCHFMT4,2250,2h 29m,Buy
48661.23,149.31,26.10.2009 08:20:00,,0.0,-143.39999999999418,0.0,0.0,149882,26.10.2009 02:55:00,4168,-0.10331067486725341,-143.4,IS,0.23,0.0,Phase3-EA-S4v1-GBPJPY-M5-194,GBPJPYMT4,1122,5h 25m,Buy
48704.45,1.5139,26.10.2009 11:30:00,,0.0,-100.17999999999302,0.0,0.0,1.51262,26.10.2009 02:45:00,4169,-0.07217338499442918,43.22,IS,0.34,0.0,Phase3-EA-S4v1-EURCHF-M15-221,EURCHFMT4,1028,8h 45m,Buy
48689.28,138.0,26.10.2009 15:45:00,,0.0,-115.35000000000582,0.0,0.0,138082,26.10.2009 09:30:00,4170,-0.0831024152436455,-15.17,IS,0.17,0.0,Phase3-EA-T1v2-EURJPY-M15-322,EURJPYMT4,350,6h 15m,Buy
48618.34,137132,26.10.2009 19:29:57,sl 137.132,-0.48,-186.29000000000815,0.0,0.0,137852,23.10.2009 11:30:00,4171,-0.1342102205092208,-70.94,IS,0.09,0.0,Phase3-EA-TR1v1-EURJPY-M30-91,EURJPYMT4,438,3d 7h 59m,Buy
48654.96,92.24,27.10.2009 01:30:00,,-0.85,-149.6700000000128,0.0,0.0,92112,26.10.2009 19:45:00,4172,-0.10782781525372223,36.62,IS,0.27,0.0,Phase3-EA-S1v2-USDJPY-M15-0,USDJPYMT4,1492,5h 45m,Buy
48711.18,1.01932,27.10.2009 03:14:58,tp 1.01932,-0.68,-93.45000000001164,0.0,0.0,1.01832,26.10.2009 23:45:00,4173,-0.06732484355890116,56.22,IS,0.58,0.0,Phase3-EA-SA2v2-USDCHF-M15-107,USDCHFMT4,900,3h 29m,Buy
48720.44,1.51432,27.10.2009 05:10:00,,-2.01,-84.19000000000233,0.0,0.0,1.5146,26.10.2009 20:50:00,4174,-0.06065359635337977,9.26,IS,0.41,0.0,Phase3-EA-SA2v2-EURCHF-M5-43,EURCHFMT4,2252,8h 20m,Sell
48779.89,150.55,27.10.2009 08:20:00,,0.0,-24.739999999990687,0.0,0.0,150312,27.10.2009 02:55:00,4175,-0.017823612944316534,59.45,IS,0.23,0.0,Phase3-EA-S4v1-GBPJPY-M5-194,GBPJPYMT4,1124,5h 25m,Buy
48703.63,136352,27.10.2009 17:29:57,sl 136.352,0.0,-101.0,0.0,0.0,137132,27.10.2009 09:30:00,4176,-0.07276414338628324,-76.26,IS,0.09,0.0,Phase3-EA-TR1v1-EURJPY-M30-91,EURJPYMT4,440,7h 59m,Buy
49017.38,135.7,27.10.2009 20:59:58,tp 135.700,-0.65,-0.0,0.0,0.0,137.4,26.10.2009 19:00:00,4177,-0.0,313.75,IS,0.17,0.0,Phase3-EA-T1v2-EURJPY-M15-322,EURJPYMT4,352,1d 1h 59m,Sell
49074.12,1.02212,28.10.2009 03:44:58,tp 1.02212,0.0,-0.0,0.0,0.0,1.02112,28.10.2009 01:00:00,4178,-0.0,56.74,IS,0.58,0.0,Phase3-EA-SA2v2-USDCHF-M15-107,USDCHFMT4,902,2h 44m,Buy
49060.3,1.5126,28.10.2009 05:05:00,,-0.96,-13.820000000006985,0.0,0.0,1.51292,27.10.2009 20:45:00,4179,-0.009937147184542298,-13.82,IS,0.41,0.0,Phase3-EA-SA2v2-EURCHF-M5-43,EURCHFMT4,2254,8h 20m,Buy
49241.04,148.98,28.10.2009 07:29:58,tp 148.980,-1.71,-0.0,0.0,0.0,150.83,23.10.2009 13:00:00,4180,-0.0,180.74,IS,0.09,0.0,Phase3-EA-B1v1-GBPJPY-M30-1,GBPJPYMT4,496,4d 18h 29m,Sell
49217.07,1.5116,28.10.2009 13:15:00,,0.0,-23.970000000001164,0.0,0.0,1.51232,28.10.2009 04:30:00,4181,-0.01721475220236875,-23.97,IS,0.34,0.0,Phase3-EA-S4v1-EURCHF-M15-221,EURCHFMT4,1030,8h 45m,Buy
49150.81,149.02,28.10.2009 15:59:58,sl 149.020,0.0,-90.23000000001048,0.0,0.0,148.35,28.10.2009 14:30:00,4182,-0.06480129708885429,-66.26,IS,0.09,0.0,Phase3-EA-B1v1-GBPJPY-M30-1,GBPJPYMT4,498,1h 29m,Sell
49275.47,133.87,28.10.2009 19:59:57,tp 133.870,0.0,-0.0,0.0,0.0,135.13,28.10.2009 07:00:00,4183,-0.0,124.66,IS,0.09,0.0,Phase3-EA-TR1v1-EURJPY-M30-91,EURJPYMT4,442,12h 59m,Sell
49289.76,90682,29.10.2009 02:45:00,,0.0,-0.0,0.0,0.0,90.73,29.10.2009 01:30:00,4184,-0.0,14.29,IS,0.27,0.0,Phase3-EA-S1v2-USDJPY-M15-0,USDJPYMT4,1494,1h 15m,Sell
49346.23,1.02712,29.10.2009 03:14:58,tp 1.02712,0.0,-0.0,0.0,0.0,1.02612,29.10.2009 01:00:00,4185,-0.0,56.47,IS,0.58,0.0,Phase3-EA-SA2v2-USDCHF-M15-107,USDCHFMT4,904,2h 14m,Buy
49326.58,1.5099,29.10.2009 06:25:00,,-2.87,-19.64999999999418,0.0,0.0,1.51032,28.10.2009 22:05:00,4186,-0.014101565575182171,-19.65,IS,0.41,0.0,Phase3-EA-SA2v2-EURCHF-M5-43,EURCHFMT4,2256,8h 20m,Buy
49453.7,134372,29.10.2009 15:59:58,tp 134.372,0.0,-0.0,0.0,0.0,133082,29.10.2009 09:30:00,4187,-0.0,127.12,IS,0.09,0.0,Phase3-EA-TR1v1-EURJPY-M30-91,EURJPYMT4,444,6h 29m,Buy
49507.67,1.0177,30.10.2009 02:44:58,tp 1.01770,-3.02,-0.0,0.0,0.0,1.0187,29.10.2009 23:00:00,4188,-0.0,53.97,IS,0.58,0.0,Phase3-EA-SA2v2-USDCHF-M15-107,USDCHFMT4,906,3h 44m,Sell
49522.99,1.51067,30.10.2009 07:30:00,,-2.01,-0.0,0.0,0.0,1.5111,29.10.2009 23:10:00,4189,-0.0,15.32,IS,0.41,0.0,Phase3-EA-SA2v2-EURCHF-M5-43,EURCHFMT4,2258,8h 20m,Sell
49456.88,150873,30.10.2009 07:59:58,sl 150.873,0.0,-66.10999999998603,0.0,0.0,151543,30.10.2009 02:00:00,4190,-0.047382872170375644,-66.11,IS,0.09,0.0,Phase3-EA-B1v1-GBPJPY-M30-1,GBPJPYMT4,500,5h 59m,Buy
49385.29,135052,30.10.2009 08:59:58,sl 135.052,-0.48,-137.69999999998254,0.0,0.0,135772,29.10.2009 21:00:00,4191,-0.09869341246197667,-71.59,IS,0.09,0.0,Phase3-EA-TR1v1-EURJPY-M30-91,EURJPYMT4,446,11h 59m,Buy
49352.54,1.50968,30.10.2009 13:00:00,,0.0,-170.44999999998254,0.0,0.0,1.51066,30.10.2009 04:15:00,4192,-0.12216624658056888,-32.75,IS,0.34,0.0,Phase3-EA-S4v1-EURCHF-M15-221,EURCHFMT4,1032,8h 45m,Buy
49452.38,147775,02.11.2009 03:29:58,tp 147.775,0.0,-70.60999999998603,0.0,0.0,147385,02.11.2009 02:10:00,4193,-0.050608147087434115,99.84,IS,0.23,0.0,Phase3-EA-S4v1-GBPJPY-M5-194,GBPJPYMT4,1126,1h 19m,Buy
49409.4,1.50942,02.11.2009 04:45:00,,-0.96,-113.58999999999651,0.0,0.0,1.51047,30.10.2009 20:25:00,4194,-0.08141310618414675,-42.98,IS,0.41,0.0,Phase3-EA-SA2v2-EURCHF-M5-43,EURCHFMT4,2260,2d 8h 20m,Buy
49365.98,133068,02.11.2009 17:59:59,sl 133.068,0.0,-157.0100000000093,0.0,0.0,132838,02.11.2009 15:30:00,4195,-0.11253342549497343,-43.42,IS,0.17,0.0,Phase3-EA-T1v2-EURJPY-M15-322,EURJPYMT4,354,2h 29m,Sell
49494.67,133662,02.11.2009 18:29:57,tp 133.662,0.0,-28.320000000006985,0.0,0.0,132372,02.11.2009 05:00:00,4196,-0.02029773014469298,128.69,IS,0.09,0.0,Phase3-EA-TR1v1-EURJPY-M30-91,EURJPYMT4,448,13h 29m,Buy
49538.77,1.50998,02.11.2009 21:04:57,tp 1.50998,0.0,-0.0,0.0,0.0,1.50888,02.11.2009 20:30:00,4197,-0.0,44.1,IS,0.41,0.0,Phase3-EA-SA2v2-EURCHF-M5-43,EURCHFMT4,2262,34m 57s,Buy
49495.49,133045,02.11.2009 21:59:58,sl 133.045,0.0,-43.279999999998836,0.0,0.0,133275,02.11.2009 18:00:00,4198,-0.031016469472963545,-43.28,IS,0.17,0.0,Phase3-EA-T1v2-EURJPY-M15-322,EURJPYMT4,356,3h 59m,Buy
49533.15,90391,03.11.2009 02:45:00,,-0.87,-5.619999999995343,0.0,0.0,90262,02.11.2009 21:15:00,4199,-0.004027554492558119,37.66,IS,0.27,0.0,Phase3-EA-S1v2-USDJPY-M15-0,USDJPYMT4,1496,5h 30m,Buy
49632.47,147788,03.11.2009 06:29:57,tp 147.788,0.0,-0.0,0.0,0.0,148178,03.11.2009 02:05:00,4200,-0.0,99.32,IS,0.23,0.0,Phase3-EA-S4v1-GBPJPY-M5-194,GBPJPYMT4,1128,4h 24m,Sell
49604.4,1.51023,03.11.2009 10:40:00,,0.0,-28.070000000006985,0.0,0.0,1.50953,03.11.2009 02:20:00,4201,-0.02010277408972782,-28.07,IS,0.41,0.0,Phase3-EA-SA2v2-EURCHF-M5-43,EURCHFMT4,2264,8h 20m,Sell
49547.1,1.51188,03.11.2009 14:00:00,,0.0,-85.36999999999534,0.0,0.0,1.51014,03.11.2009 05:15:00,4202,-0.06113907460062498,-57.3,IS,0.34,0.0,Phase3-EA-S4v1-EURCHF-M15-221,EURCHFMT4,1034,8h 45m,Sell
49475.44,132734,03.11.2009 18:29:57,sl 132.734,0.0,-157.02999999999884,0.0,0.0,132014,03.11.2009 14:00:00,4203,-0.11245951604236375,-71.66,IS,0.09,0.0,Phase3-EA-TR1v1-EURJPY-M30-91,EURJPYMT4,450,4h 29m,Sell
49491.29,90305,03.11.2009 22:30:00,,0.0,-141.17999999999302,0.0,0.0,90252,03.11.2009 21:30:00,4204,-0.10110828806508466,15.85,IS,0.27,0.0,Phase3-EA-S1v2-USDJPY-M15-0,USDJPYMT4,1498,1h 0m,Buy
49547.79,1.02657,03.11.2009 22:59:59,tp 1.02657,0.0,-84.67999999999302,0.0,0.0,1.02557,03.11.2009 22:15:00,4205,-0.06064492019656529,56.5,IS,0.58,0.0,Phase3-EA-SA2v2-USDCHF-M15-107,USDCHFMT4,908,44m 59s,Buy
49604.28,1.02677,04.11.2009 01:59:58,tp 1.02677,0.0,-28.19000000000233,0.0,0.0,1.02577,04.11.2009 01:00:00,4206,-0.0201887139860824,56.49,IS,0.58,0.0,Phase3-EA-SA2v2-USDCHF-M15-107,USDCHFMT4,910,59m 58s,Buy
49628.49,1.51126,04.11.2009 04:35:00,,-0.96,-3.9800000000104774,0.0,0.0,1.51063,03.11.2009 20:15:00,4207,-0.0028503398958784265,24.21,IS,0.41,0.0,Phase3-EA-SA2v2-EURCHF-M5-43,EURCHFMT4,2266,8h 20m,Buy
49756.42,133606,04.11.2009 10:29:58,tp 133.606,-0.49,-0.0,0.0,0.0,132316,03.11.2009 18:30:00,4208,-0.0,127.93,IS,0.09,0.0,Phase3-EA-TR1v1-EURJPY-M30-91,EURJPYMT4,452,15h 59m,Buy
49757.75,1.5112,04.11.2009 14:00:00,,0.0,-0.0,0.0,0.0,1.51124,04.11.2009 05:15:00,4209,-0.0,1.33,IS,0.34,0.0,Phase3-EA-S4v1-EURCHF-M15-221,EURCHFMT4,1036,8h 45m,Sell
50076.56,134608,04.11.2009 18:59:58,tp 134.608,0.0,-0.0,0.0,0.0,132908,04.11.2009 07:15:00,4210,-0.0,318.81,IS,0.17,0.0,Phase3-EA-T1v2-EURJPY-M15-322,EURJPYMT4,358,11h 44m,Buy
50201.5,134838,04.11.2009 19:29:58,tp 134.838,0.0,-0.0,0.0,0.0,133578,04.11.2009 10:30:00,4211,-0.0,124.94,IS,0.09,0.0,Phase3-EA-TR1v1-EURJPY-M30-91,EURJPYMT4,454,8h 59m,Buy
50319.92,91.2,04.11.2009 22:29:58,tp 91.200,0.0,-0.0,0.0,0.0,90.8,04.11.2009 17:00:00,4212,-0.0,118.42,IS,0.27,0.0,Phase3-EA-S1v2-USDJPY-M15-0,USDJPYMT4,1500,5h 29m,Buy
50252.22,149861,05.11.2009 03:29:59,sl 149.861,-1.07,-67.70000000001164,0.0,0.0,150531,04.11.2009 19:00:00,4213,-0.04824689181693633,-67.7,IS,0.09,0.0,Phase3-EA-B1v1-GBPJPY-M30-1,GBPJPYMT4,502,8h 29m,Buy
50048.82,149325,05.11.2009 04:39:58,sl 149.325,0.0,-271.1000000000058,0.0,0.0,150125,05.11.2009 00:05:00,4214,-0.19320136442495525,-203.4,IS,0.23,0.0,Phase3-EA-S4v1-GBPJPY-M5-194,GBPJPYMT4,1130,4h 34m,Buy
49975.74,134219,05.11.2009 04:59:57,sl 134.219,-1.46,-344.179999999993,0.0,0.0,134939,04.11.2009 19:30:00,4215,-0.24528235192835973,-73.08,IS,0.09,0.0,Phase3-EA-TR1v1-EURJPY-M30-91,EURJPYMT4,456,9h 29m,Buy
49960.34,1.51017,05.11.2009 05:00:00,,-2.91,-359.5799999999872,0.0,0.0,1.51048,04.11.2009 20:40:00,4216,-0.25625727266662285,-15.4,IS,0.41,0.0,Phase3-EA-SA2v2-EURCHF-M5-43,EURCHFMT4,2268,8h 20m,Buy
49927.95,1.51114,05.11.2009 13:45:00,,0.0,-391.97000000000116,0.0,0.0,1.51017,05.11.2009 05:00:00,4217,-0.2793402390765338,-32.39,IS,0.34,0.0,Phase3-EA-S4v1-EURCHF-M15-221,EURCHFMT4,1038,8h 45m,Sell
49973.54,90604,05.11.2009 21:15:00,,0.0,-346.38000000000466,0.0,0.0,90451,05.11.2009 20:00:00,4218,-0.2468501977481205,45.59,IS,0.27,0.0,Phase3-EA-S1v2-USDJPY-M15-0,USDJPYMT4,1502,1h 15m,Buy
49995.31,1.51141,06.11.2009 04:50:00,,-2.02,-324.61000000001513,0.0,0.0,1512,05.11.2009 20:30:00,4219,-0.23133565070448656,21.77,IS,0.41,0.0,Phase3-EA-SA2v2-EURCHF-M5-43,EURCHFMT4,2270,8h 20m,Sell
50002.33,1.51139,06.11.2009 10:15:00,,0.0,-317.5900000000256,0.0,0.0,1.51118,06.11.2009 01:30:00,4220,-0.22633279722510208,7.02,IS,0.34,0.0,Phase3-EA-S4v1-EURCHF-M15-221,EURCHFMT4,1040,8h 45m,Buy
49960.33,1.65831,06.11.2009 15:29:58,sl 1.65831,0.0,-359.5900000000256,0.0,0.0,1.66131,06.11.2009 10:30:00,4221,-0.25626439923855815,-42.0,IS,0.14,0.0,Phase3-EA-B1v1-GBPUSD-M30-14,GBPUSDMT4,274,4h 59m,Buy
49917.24,134633,06.11.2009 16:29:58,sl 134.633,0.0,-402.6800000000221,0.0,0.0,134863,06.11.2009 13:00:00,4222,-0.28697279758998,-43.09,IS,0.17,0.0,Phase3-EA-T1v2-EURJPY-M15-322,EURJPYMT4,360,3h 29m,Buy
50045.61,133526,06.11.2009 16:59:57,tp 133.526,0.0,-274.3100000000268,0.0,0.0,134816,06.11.2009 06:30:00,4223,-0.1954889940074272,128.37,IS,0.09,0.0,Phase3-EA-TR1v1-EURJPY-M30-91,EURJPYMT4,458,10h 29m,Sell
50097.22,89726,09.11.2009 02:15:00,,-1.35,-222.70000000004075,0.0,0.0,89902,06.11.2009 22:45:00,4224,-0.15870875639042598,51.61,IS,0.27,0.0,Phase3-EA-S1v2-USDJPY-M15-0,USDJPYMT4,1504,2d 3h 30m,Sell
50140.62,1.51113,09.11.2009 03:04:58,tp 1.51113,-0.97,-179.30000000004657,0.0,0.0,1.51003,06.11.2009 20:55:00,4225,-0.12777943430985883,43.4,IS,0.41,0.0,Phase3-EA-SA2v2-EURCHF-M5-43,EURCHFMT4,2272,2d 6h 9m,Buy
50068.19,134097,09.11.2009 04:29:58,sl 134.097,-0.35,-251.73000000003958,0.0,0.0,133377,06.11.2009 20:30:00,4226,-0.1793971946392497,-72.43,IS,0.09,0.0,Phase3-EA-TR1v1-EURJPY-M30-91,EURJPYMT4,460,2d 7h 59m,Sell
50102.29,1.51027,09.11.2009 13:30:00,,0.0,-217.63000000003376,0.0,0.0,1.51128,09.11.2009 04:45:00,4227,-0.15509558443308238,34.1,IS,0.34,0.0,Phase3-EA-S4v1-EURCHF-M15-221,EURCHFMT4,1042,8h 45m,Sell
50086.82,89904,10.11.2009 03:15:00,,-1.35,-233.10000000003492,0.0,0.0,89857,09.11.2009 19:30:00,4228,-0.1661203911747062,-15.47,IS,0.27,0.0,Phase3-EA-S1v2-USDJPY-M15-0,USDJPYMT4,1506,7h 45m,Sell
50086.42,1.51151,10.11.2009 04:35:00,,-2.03,-233.5000000000291,0.0,0.0,1.51155,09.11.2009 20:15:00,4229,-0.1664054540510207,-0.4,IS,0.41,0.0,Phase3-EA-SA2v2-EURCHF-M5-43,EURCHFMT4,2274,8h 20m,Sell
50143.91,1.00891,10.11.2009 04:44:58,tp 1.00891,0.0,-176.01000000003842,0.0,0.0,1.00791,10.11.2009 01:15:00,4230,-0.1254347921521323,57.49,IS,0.58,0.0,Phase3-EA-SA2v2-USDCHF-M15-107,USDCHFMT4,912,3h 29m,Buy
50243.62,150509,10.11.2009 08:09:59,tp 150.509,0.0,-76.30000000004657,0.0,0.0,150899,10.11.2009 03:15:00,4231,-0.054375743657811754,99.71,IS,0.23,0.0,Phase3-EA-S4v1-GBPJPY-M5-194,GBPJPYMT4,1132,4h 54m,Sell
50176.23,150101,10.11.2009 08:29:58,sl 150.101,-0.36,-143.69000000006054,0.0,0.0,150771,09.11.2009 09:00:00,4232,-0.10240171174560281,-67.39,IS,0.09,0.0,Phase3-EA-B1v1-GBPJPY-M30-1,GBPJPYMT4,504,23h 29m,Buy
50164.42,1511,10.11.2009 14:45:00,,0.0,-155.5000000000582,0.0,0.0,1.51135,10.11.2009 06:00:00,4233,-0.11081819316890869,-11.81,IS,0.34,0.0,Phase3-EA-S4v1-EURCHF-M15-221,EURCHFMT4,1044,8h 45m,Buy
50187.88,89757,10.11.2009 22:00:00,,0.0,-132.04000000006636,0.0,0.0,89835,10.11.2009 21:30:00,4234,-0.09409925547282687,23.46,IS,0.27,0.0,Phase3-EA-S1v2-USDJPY-M15-0,USDJPYMT4,1508,30m 0s,Sell
49982.04,149391,11.11.2009 07:19:58,sl 149.391,0.0,-337.88000000006286,0.0,0.0,150191,11.11.2009 02:20:00,4235,-0.2407926116263911,-205.84,IS,0.23,0.0,Phase3-EA-S4v1-GBPJPY-M5-194,GBPJPYMT4,1134,4h 59m,Buy
49908.7,133826,11.11.2009 07:29:58,sl 133.826,-0.98,-411.2200000000594,0.0,0.0,134109,09.11.2009 04:30:00,4236,-0.2930588899994093,-73.34,IS,0.09,0.0,Phase3-EA-TR1v1-EURJPY-M30-91,EURJPYMT4,462,2d 2h 59m,Buy
49917.65,1.51037,11.11.2009 09:15:00,,0.0,-402.27000000004773,0.0,0.0,1.51015,11.11.2009 00:55:00,4237,-0.2866806081417717,8.95,IS,0.41,0.0,Phase3-EA-SA2v2-EURCHF-M5-43,EURCHFMT4,2276,8h 20m,Buy
49874.08,134.64,11.11.2009 10:14:58,sl 134.640,0.0,-445.8400000000547,0.0,0.0,134.41,11.11.2009 03:30:00,4238,-0.3177310819447834,-43.57,IS,0.17,0.0,Phase3-EA-T1v2-EURJPY-M15-322,EURJPYMT4,362,6h 44m,Sell
49913.78,148869,12.11.2009 07:50:00,,0.0,-406.1400000000431,0.0,0.0,149024,12.11.2009 02:25:00,4239,-0.2894385914701511,39.7,IS,0.23,0.0,Phase3-EA-S4v1-GBPJPY-M5-194,GBPJPYMT4,1136,5h 25m,Sell
49870.25,134797,12.11.2009 09:59:58,sl 134.797,0.0,-449.6700000000419,0.0,0.0,134567,12.11.2009 08:15:00,4240,-0.3204605589855251,-43.53,IS,0.17,0.0,Phase3-EA-T1v2-EURJPY-M15-322,EURJPYMT4,364,1h 44m,Sell
49875.54,1.51009,12.11.2009 10:15:00,,0.0,-444.38000000003376,0.0,0.0,1.50996,12.11.2009 01:55:00,4241,-0.31669060244620545,5.29,IS,0.41,0.0,Phase3-EA-SA2v2-EURCHF-M5-43,EURCHFMT4,2278,8h 20m,Buy
49833.54,1.65621,12.11.2009 11:59:58,sl 1.65621,0.0,-486.38000000003376,0.0,0.0,1.65321,12.11.2009 11:00:00,4242,-0.3466222044596616,-42.0,IS,0.14,0.0,Phase3-EA-B1v1-GBPUSD-M30-14,GBPUSDMT4,276,59m 58s,Sell
49790.17,134796,12.11.2009 17:14:57,sl 134.796,0.0,-529.7500000000291,0.0,0.0,134566,12.11.2009 10:30:00,4243,-0.37753014682450564,-43.37,IS,0.17,0.0,Phase3-EA-T1v2-EURJPY-M15-322,EURJPYMT4,366,6h 44m,Sell
49803.73,1.51071,13.11.2009 06:20:00,,-0.97,-516.1900000000314,0.0,0.0,1.51035,12.11.2009 22:00:00,4244,-0.36786651531730574,13.56,IS,0.41,0.0,Phase3-EA-SA2v2-EURCHF-M5-43,EURCHFMT4,2280,8h 20m,Buy
49764.92,1.01614,13.11.2009 07:00:00,,0.0,-555.0000000000291,0.0,0.0,1.01682,13.11.2009 02:45:00,4245,-0.3955247408921191,-38.81,IS,0.58,0.0,Phase3-EA-SA2v2-USDCHF-M15-107,USDCHFMT4,914,4h 15m,Buy
49744.32,90315,13.11.2009 09:45:00,,-0.87,-575.6000000000349,0.0,0.0,90381,12.11.2009 22:45:00,4246,-0.4102054790225327,-20.6,IS,0.27,0.0,Phase3-EA-S1v2-USDJPY-M15-0,USDJPYMT4,1510,11h 0m,Buy
49757.39,1.51032,13.11.2009 13:00:00,,0.0,-562.5300000000279,0.0,0.0,1.51071,13.11.2009 04:15:00,4247,-0.4008910495388165,13.07,IS,0.34,0.0,Phase3-EA-S4v1-EURCHF-M15-221,EURCHFMT4,1046,8h 45m,Sell
49676.25,133329,13.11.2009 16:59:58,sl 133.329,-2.94,-643.6700000000419,0.0,0.0,134546,09.11.2009 07:00:00,4248,-0.45871605400006044,-81.14,IS,0.09,0.0,Phase3-EA-TR1v1-EURJPY-M30-91,EURJPYMT4,463,4d 9h 59m,Buy
49730.51,1.01214,16.11.2009 02:00:00,tp 1.01214,-3.04,-589.4100000000326,0.0,0.0,1.01314,13.11.2009 23:15:00,4249,-0.4200472748274317,54.26,IS,0.58,0.0,Phase3-EA-SA2v2-USDCHF-M15-107,USDCHFMT4,916,2d 2h 45m,Sell
49756.34,1.5099,16.11.2009 05:20:00,,-0.97,-563.5800000000454,0.0,0.0,1.50924,13.11.2009 21:00:00,4250,-0.4016393395891653,25.83,IS,0.41,0.0,Phase3-EA-SA2v2-EURCHF-M5-43,EURCHFMT4,2282,2d 8h 20m,Buy
49712.67,1.00936,16.11.2009 07:00:00,,0.0,-607.2500000000582,0.0,0.0,1.01012,16.11.2009 02:45:00,4251,-0.4327610791112608,-43.67,IS,0.58,0.0,Phase3-EA-SA2v2-USDCHF-M15-107,USDCHFMT4,918,4h 15m,Buy
49744.04,1.50901,16.11.2009 15:30:00,,0.0,-575.8800000000629,0.0,0.0,1.50994,16.11.2009 06:45:00,4252,-0.41040502303597565,31.37,IS,0.34,0.0,Phase3-EA-S4v1-EURCHF-M15-221,EURCHFMT4,1048,8h 45m,Sell
50008.11,1.68628,16.11.2009 22:29:57,tp 1.68628,-0.53,-311.8100000000559,0.0,0.0,1.66738,13.11.2009 19:00:00,4253,-0.22221363866231944,264.07,IS,0.14,0.0,Phase3-EA-B1v1-GBPUSD-M30-14,GBPUSDMT4,278,3d 3h 29m,Buy
50065.74,1.00649,16.11.2009 22:59:58,tp 1.00649,0.0,-254.18000000005122,0.0,0.0,1.00549,16.11.2009 22:30:00,4254,-0.18114320475670959,57.63,IS,0.58,0.0,Phase3-EA-SA2v2-USDCHF-M15-107,USDCHFMT4,920,29m 58s,Buy
50075.5,1.50877,17.11.2009 04:55:00,,-2.03,-244.4200000000419,0.0,0.0,1.50906,16.11.2009 20:35:00,4255,-0.17418767057452839,9.76,IS,0.41,0.0,Phase3-EA-SA2v2-EURCHF-M5-43,EURCHFMT4,2284,8h 20m,Sell
49995.53,132.78,17.11.2009 11:29:58,sl 132.780,-0.98,-324.3900000000431,0.0,0.0,133.56,13.11.2009 20:30:00,4256,-0.23117886612253122,-79.97,IS,0.09,0.0,Phase3-EA-TR1v1-EURJPY-M30-91,EURJPYMT4,466,3d 14h 59m,Buy
49950.83,1.51024,17.11.2009 12:30:00,,0.0,-369.0900000000547,0.0,0.0,1.50891,17.11.2009 03:45:00,4257,-0.26303464255114634,-44.7,IS,0.34,0.0,Phase3-EA-S4v1-EURCHF-M15-221,EURCHFMT4,1050,8h 45m,Sell
50272.71,132561,17.11.2009 18:44:58,tp 132.561,-1.99,-47.21000000005006,0.0,0.0,134261,12.11.2009 23:00:00,4258,-0.03364454597754191,321.88,IS,0.17,0.0,Phase3-EA-T1v2-EURJPY-M15-322,EURJPYMT4,368,4d 19h 44m,Sell
50298.96,1.01632,18.11.2009 05:00:00,,0.0,-20.96000000005006,0.0,0.0,1.01586,18.11.2009 00:45:00,4259,-0.014937294719131858,26.25,IS,0.58,0.0,Phase3-EA-SA2v2-USDCHF-M15-107,USDCHFMT4,922,4h 15m,Buy
50298.38,89294,18.11.2009 05:15:00,,-0.88,-21.540000000037253,0.0,0.0,89293,17.11.2009 20:30:00,4260,-0.015350635889784746,-0.58,IS,0.27,0.0,Phase3-EA-S1v2-USDJPY-M15-0,USDJPYMT4,1512,8h 45m,Buy
50326.25,1.51165,18.11.2009 09:55:00,,0.0,-0.0,0.0,0.0,1.51096,18.11.2009 01:35:00,4261,-0.0,27.87,IS,0.41,0.0,Phase3-EA-SA2v2-EURCHF-M5-43,EURCHFMT4,2286,8h 20m,Buy
50282.38,132847,18.11.2009 09:59:59,sl 132.847,0.0,-43.86999999999534,0.0,0.0,132617,18.11.2009 07:30:00,4262,-0.031262860655077246,-43.87,IS,0.17,0.0,Phase3-EA-T1v2-EURJPY-M15-322,EURJPYMT4,370,2h 29m,Sell
50298.18,1.51104,18.11.2009 13:30:00,,0.0,-28.070000000006985,0.0,0.0,1.51151,18.11.2009 04:45:00,4263,-0.020003384968961244,15.8,IS,0.34,0.0,Phase3-EA-S4v1-EURCHF-M15-221,EURCHFMT4,1052,8h 45m,Sell
50295.74,1.51085,19.11.2009 04:20:00,,-6.09,-30.510000000009313,0.0,0.0,1.51094,18.11.2009 20:00:00,4264,-0.02174219007492134,-2.44,IS,0.41,0.0,Phase3-EA-SA2v2-EURCHF-M5-43,EURCHFMT4,2288,8h 20m,Sell
50253.74,1.66963,19.11.2009 12:59:58,sl 1.66963,0.0,-72.51000000000931,0.0,0.0,1.66663,19.11.2009 11:00:00,4265,-0.05167244189879606,-42.0,IS,0.14,0.0,Phase3-EA-B1v1-GBPUSD-M30-14,GBPUSDMT4,280,1h 59m,Sell
50379.45,132.04,19.11.2009 15:29:58,tp 132.040,-1.76,-0.0,0.0,0.0,133.3,16.11.2009 23:00:00,4266,-0.0,125.71,IS,0.09,0.0,Phase3-EA-TR1v1-EURJPY-M30-91,EURJPYMT4,467,2d 16h 29m,Sell
50268.38,88972,19.11.2009 19:45:00,,0.0,-111.07000000000698,0.0,0.0,89338,19.11.2009 00:45:00,4267,-0.07912126739348742,-111.07,IS,0.27,0.0,Phase3-EA-S1v2-USDJPY-M15-0,USDJPYMT4,1514,19h 0m,Buy
50195.48,132691,19.11.2009 22:29:58,sl 132.691,0.0,-183.97000000000116,0.0,0.0,131971,19.11.2009 15:30:00,4268,-0.13105194528116554,-72.9,IS,0.09,0.0,Phase3-EA-TR1v1-EURJPY-M30-91,EURJPYMT4,470,6h 59m,Sell
50160.45,1.01326,20.11.2009 02:30:00,,-0.69,-219.0,0.0,0.0,1.01386,19.11.2009 22:15:00,4269,-0.15600574015641175,-35.03,IS,0.58,0.0,Phase3-EA-SA2v2-USDCHF-M15-107,USDCHFMT4,924,4h 15m,Buy
50141.3,1.51178,20.11.2009 04:40:00,,-0.97,-238.14999999999418,0.0,0.0,1.51223,19.11.2009 20:20:00,4270,-0.1696473379828701,-19.15,IS,0.41,0.0,Phase3-EA-SA2v2-EURCHF-M5-43,EURCHFMT4,2290,8h 20m,Buy
50124.48,147993,20.11.2009 07:50:00,,0.0,-254.97000000000116,0.0,0.0,148058,20.11.2009 02:25:00,4271,-0.1816291487108698,-16.82,IS,0.23,0.0,Phase3-EA-S4v1-GBPJPY-M5-194,GBPJPYMT4,1138,5h 25m,Buy
50080.43,132431,20.11.2009 09:44:58,sl 132.431,0.0,-299.0199999999895,0.0,0.0,132661,20.11.2009 09:00:00,4272,-0.21300838548661466,-44.05,IS,0.17,0.0,Phase3-EA-T1v2-EURJPY-M15-322,EURJPYMT4,372,44m 58s,Buy
50056.02,1.5126,20.11.2009 13:15:00,,0.0,-323.429999999993,0.0,0.0,1.51187,20.11.2009 04:30:00,4273,-0.23039697049674504,-24.41,IS,0.34,0.0,Phase3-EA-S4v1-EURCHF-M15-221,EURCHFMT4,1054,8h 45m,Sell
50070.58,89.01,20.11.2009 15:15:00,,0.0,-308.86999999999534,0.0,0.0,88962,20.11.2009 01:30:00,4274,-0.22002508201876791,14.56,IS,0.27,0.0,Phase3-EA-S1v2-USDJPY-M15-0,USDJPYMT4,1516,13h 45m,Buy
50256.86,146312,23.11.2009 02:29:57,tp 146.312,-1.18,-122.58999999999651,0.0,0.0,148162,19.11.2009 11:00:00,4275,-0.08732759673869395,186.28,IS,0.09,0.0,Phase3-EA-B1v1-GBPJPY-M30-1,GBPJPYMT4,506,3d 15h 29m,Sell
50217.46,1.5119,23.11.2009 05:10:00,,-0.97,-161.9899999999907,0.0,0.0,1.51285,20.11.2009 20:50:00,4276,-0.11539438286728625,-39.4,IS,0.41,0.0,Phase3-EA-SA2v2-EURCHF-M5-43,EURCHFMT4,2292,2d 8h 20m,Buy
50194.55,1.5113,23.11.2009 14:15:00,,0.0,-184.89999999999418,0.0,0.0,1.51198,23.11.2009 05:30:00,4277,-0.1317144354105919,-22.91,IS,0.34,0.0,Phase3-EA-S4v1-EURCHF-M15-221,EURCHFMT4,1056,8h 45m,Buy
50241.61,88935,23.11.2009 18:15:00,,0.0,-137.8399999999965,0.0,0.0,88.78,23.11.2009 17:15:00,4278,-0.09819101015141211,47.06,IS,0.27,0.0,Phase3-EA-S1v2-USDJPY-M15-0,USDJPYMT4,1518,1h 0m,Buy
50126.34,147.0,24.11.2009 08:55:00,,0.0,-253.10999999998603,0.0,0.0,147445,24.11.2009 03:30:00,4279,-0.18030416845199634,-115.27,IS,0.23,0.0,Phase3-EA-S4v1-GBPJPY-M5-194,GBPJPYMT4,1140,5h 25m,Buy
50124.72,1.51099,24.11.2009 09:55:00,,0.0,-254.72999999998137,0.0,0.0,1.51103,24.11.2009 01:35:00,4280,-0.18145818351616375,-1.62,IS,0.41,0.0,Phase3-EA-SA2v2-EURCHF-M5-43,EURCHFMT4,2294,8h 20m,Buy
50142.48,1.51156,24.11.2009 10:30:00,,0.0,-236.96999999997206,0.0,0.0,1.51103,24.11.2009 01:45:00,4281,-0.1688067591089522,17.76,IS,0.34,0.0,Phase3-EA-S4v1-EURCHF-M15-221,EURCHFMT4,1058,8h 45m,Buy
50098.33,132594,24.11.2009 18:14:57,sl 132.594,0.0,-281.11999999996624,0.0,0.0,132364,24.11.2009 17:45:00,4282,-0.20025723138248952,-44.15,IS,0.17,0.0,Phase3-EA-T1v2-EURJPY-M15-322,EURJPYMT4,374,29m 57s,Sell
49945.56,88522,24.11.2009 23:00:00,,-0.88,-433.88999999995576,0.0,0.0,89.02,23.11.2009 23:30:00,4283,-0.30908370135369223,-152.77,IS,0.27,0.0,Phase3-EA-S1v2-USDJPY-M15-0,USDJPYMT4,1520,23h 30m,Buy
49876.93,146.98,25.11.2009 03:29:58,sl 146.980,-0.59,-502.5199999999604,0.0,0.0,146.31,24.11.2009 18:30:00,4284,-0.3579726234858167,-68.63,IS,0.09,0.0,Phase3-EA-B1v1-GBPJPY-M30-1,GBPJPYMT4,508,8h 59m,Sell
49830.42,1.50977,25.11.2009 04:45:00,,-0.98,-549.0299999999697,0.0,0.0,1.51089,24.11.2009 20:25:00,4285,-0.3911042535071691,-46.51,IS,0.41,0.0,Phase3-EA-SA2v2-EURCHF-M5-43,EURCHFMT4,2296,8h 20m,Buy
49786.12,132334,25.11.2009 05:59:58,sl 132.334,0.0,-593.3299999999581,0.0,0.0,132104,25.11.2009 04:45:00,4286,-0.4226615790273847,-44.3,IS,0.17,0.0,Phase3-EA-T1v2-EURJPY-M15-322,EURJPYMT4,376,1h 14m,Sell
49789.5,1.50982,25.11.2009 10:15:00,,0.0,-589.9499999999534,0.0,0.0,1.50972,25.11.2009 01:30:00,4287,-0.42025381920213634,3.38,IS,0.34,0.0,Phase3-EA-S4v1-EURCHF-M15-221,EURCHFMT4,1060,8h 45m,Buy
49920.45,131958,25.11.2009 12:29:58,tp 131.958,-0.71,-458.9999999999418,0.0,0.0,133248,23.11.2009 23:00:00,4288,-0.3269709348483284,130.95,IS,0.09,0.0,Phase3-EA-TR1v1-EURJPY-M30-91,EURJPYMT4,472,1d 13h 29m,Sell
49970.13,87497,25.11.2009 21:15:00,,0.0,-409.3199999999488,0.0,0.0,87658,25.11.2009 18:15:00,4289,-0.291581139547098,49.68,IS,0.27,0.0,Phase3-EA-S1v2-USDJPY-M15-0,USDJPYMT4,1522,3h 0m,Sell
50026.23,0.99662,26.11.2009 00:44:58,tp 0.99662,-2.1,-353.21999999994296,0.0,0.0,0.99562,25.11.2009 23:45:00,4290,-0.2516180252878487,56.1,IS,0.58,0.0,Phase3-EA-SA2v2-USDCHF-M15-107,USDCHFMT4,926,59m 58s,Buy
50128.86,146141,26.11.2009 03:59:59,tp 146.141,0.0,-250.5899999999383,0.0,0.0,145751,26.11.2009 02:15:00,4291,-0.1785090339076968,102.63,IS,0.23,0.0,Phase3-EA-S4v1-GBPJPY-M5-194,GBPJPYMT4,1142,1h 44m,Buy
50070.0,1.50764,26.11.2009 04:25:00,,-2.96,-309.44999999992433,0.0,0.0,1509,25.11.2009 20:05:00,4292,-0.22043824790588956,-58.86,IS,0.41,0.0,Phase3-EA-SA2v2-EURCHF-M5-43,EURCHFMT4,2298,8h 20m,Buy
50199.28,130931,26.11.2009 07:29:57,tp 130.931,-1.44,-180.1699999999255,0.0,0.0,132191,24.11.2009 11:30:00,4293,-0.12834499636515564,129.28,IS,0.09,0.0,Phase3-EA-TR1v1-EURJPY-M30-91,EURJPYMT4,473,1d 19h 59m,Sell
50532.97,130422,26.11.2009 07:59:57,tp 130.422,0.0,-0.0,0.0,0.0,132122,26.11.2009 03:15:00,4294,-0.0,333.69,IS,0.17,0.0,Phase3-EA-T1v2-EURJPY-M15-322,EURJPYMT4,378,4h 44m,Sell
50489.37,1.65979,26.11.2009 10:59:58,sl 1.65979,-1.6,-43.60000000000582,0.0,0.0,1.66279,25.11.2009 09:30:00,4295,-0.031024748142735325,-43.6,IS,0.14,0.0,Phase3-EA-B1v1-GBPUSD-M30-14,GBPUSDMT4,282,1d 1h 29m,Buy
50533.33,1.50695,27.11.2009 01:09:57,tp 1.50695,-0.98,-0.0,0.0,0.0,1.50585,26.11.2009 20:05:00,4296,-0.0,43.96,IS,0.41,0.0,Phase3-EA-SA2v2-EURCHF-M5-43,EURCHFMT4,2300,5h 4m,Buy
50578.31,1.50513,27.11.2009 02:19:58,tp 1.50513,0.0,-0.0,0.0,0.0,1.50623,27.11.2009 01:10:00,4297,-0.0,44.98,IS,0.41,0.0,Phase3-EA-SA2v2-EURCHF-M5-43,EURCHFMT4,2302,1h 9m,Sell
50709.16,129268,27.11.2009 02:29:58,tp 129.268,-0.36,-0.0,0.0,0.0,130528,26.11.2009 08:00:00,4298,-0.0,130.85,IS,0.09,0.0,Phase3-EA-TR1v1-EURJPY-M30-91,EURJPYMT4,476,18h 29m,Sell
50901.21,142147,27.11.2009 02:29:58,tp 142.147,-0.6,-0.0,0.0,0.0,143997,26.11.2009 11:00:00,4299,-0.0,192.05,IS,0.09,0.0,Phase3-EA-B1v1-GBPJPY-M30-1,GBPJPYMT4,510,15h 29m,Sell
50945.97,1.50643,27.11.2009 02:44:58,tp 1.50643,0.0,-0.0,0.0,0.0,1.50533,27.11.2009 02:20:00,4300,-0.0,44.76,IS,0.41,0.0,Phase3-EA-SA2v2-EURCHF-M5-43,EURCHFMT4,2304,24m 58s,Buy
50990.85,1.50536,27.11.2009 03:04:57,tp 1.50536,0.0,-0.0,0.0,0.0,1.50426,27.11.2009 02:55:00,4301,-0.0,44.88,IS,0.41,0.0,Phase3-EA-SA2v2-EURCHF-M5-43,EURCHFMT4,2306,9m 57s,Buy
51096.28,140294,27.11.2009 03:04:58,tp 140.294,0.0,-0.0,0.0,0.0,139904,27.11.2009 03:00:00,4302,-0.0,105.43,IS,0.23,0.0,Phase3-EA-S4v1-GBPJPY-M5-194,GBPJPYMT4,1144,4m 58s,Buy
51025.63,141684,27.11.2009 03:59:58,sl 141.684,0.0,-70.64999999999418,0.0,0.0,141014,27.11.2009 02:30:00,4303,-0.05007219183949721,-70.65,IS,0.09,0.0,Phase3-EA-B1v1-GBPJPY-M30-1,GBPJPYMT4,512,1h 29m,Sell
50943.95,128.12,27.11.2009 05:59:57,sl 128.120,0.0,-152.3299999999872,0.0,0.0,128.9,27.11.2009 04:00:00,4304,-0.10796174073475721,-81.68,IS,0.09,0.0,Phase3-EA-TR1v1-EURJPY-M30-91,EURJPYMT4,478,1h 59m,Buy
51078.06,1.50881,27.11.2009 10:44:58,tp 1.50881,0.0,-18.220000000001164,0.0,0.0,1.50481,27.11.2009 03:15:00,4305,-0.012913168228107185,134.11,IS,0.34,0.0,Phase3-EA-S4v1-EURCHF-M15-221,EURCHFMT4,1062,7h 29m,Buy
51122.84,1.50689,27.11.2009 21:14:57,tp 1.50689,0.0,-0.0,0.0,0.0,1.50579,27.11.2009 20:15:00,4306,-0.0,44.78,IS,0.41,0.0,Phase3-EA-SA2v2-EURCHF-M5-43,EURCHFMT4,2308,59m 57s,Buy
51166.7,1.50673,30.11.2009 02:00:00,tp 1.50673,-0.98,-0.0,0.0,0.0,1.50563,27.11.2009 22:20:00,4307,-0.0,43.86,IS,0.41,0.0,Phase3-EA-SA2v2-EURCHF-M5-43,EURCHFMT4,2310,2d 3h 40m,Buy
51184.77,86802,30.11.2009 04:00:00,,-0.9,-0.0,0.0,0.0,86741,27.11.2009 21:30:00,4308,-0.0,18.07,IS,0.27,0.0,Phase3-EA-S1v2-USDJPY-M15-0,USDJPYMT4,1524,2d 6h 30m,Buy
51156.08,1.50701,30.11.2009 10:40:00,,0.0,-28.69000000000233,0.0,0.0,1.50631,30.11.2009 02:20:00,4309,-0.020320888719089398,-28.69,IS,0.41,0.0,Phase3-EA-SA2v2-EURCHF-M5-43,EURCHFMT4,2312,8h 20m,Sell
51080.37,129.27,30.11.2009 11:29:58,sl 129.270,-0.51,-104.39999999999418,0.0,0.0,129.99,27.11.2009 20:00:00,4310,-0.0739456529199248,-75.71,IS,0.09,0.0,Phase3-EA-TR1v1-EURJPY-M30-91,EURJPYMT4,480,2d 15h 29m,Buy
51077.66,1.5078,30.11.2009 13:00:00,,0.0,-107.10999999998603,0.0,0.0,1.50772,30.11.2009 04:15:00,4311,-0.07586512341238079,-2.71,IS,0.34,0.0,Phase3-EA-S4v1-EURCHF-M15-221,EURCHFMT4,1064,8h 45m,Sell
51032.39,129684,30.11.2009 18:59:58,sl 129.684,0.0,-152.37999999997555,0.0,0.0,129914,30.11.2009 17:15:00,4312,-0.10792948842851498,-45.27,IS,0.17,0.0,Phase3-EA-T1v2-EURJPY-M15-322,EURJPYMT4,380,1h 44m,Buy
50987.1,129514,30.11.2009 21:59:58,sl 129.514,0.0,-197.6699999999837,0.0,0.0,129284,30.11.2009 19:15:00,4313,-0.14000801927855505,-45.29,IS,0.17,0.0,Phase3-EA-T1v2-EURJPY-M15-322,EURJPYMT4,382,2h 44m,Sell
51031.93,1.50796,30.11.2009 22:54:57,tp 1.50796,0.0,-152.8399999999965,0.0,0.0,1.50686,30.11.2009 20:10:00,4314,-0.10825530260806207,44.83,IS,0.41,0.0,Phase3-EA-SA2v2-EURCHF-M5-43,EURCHFMT4,2314,2h 44m,Buy
51038.52,86379,01.12.2009 01:00:00,,-0.91,-146.25,0.0,0.0,86355,30.11.2009 18:45:00,4315,-0.10358766034041769,6.59,IS,0.27,0.0,Phase3-EA-S1v2-USDJPY-M15-0,USDJPYMT4,1526,6h 15m,Buy
51140.92,141753,01.12.2009 01:09:57,tp 141.753,-1.54,-43.85000000000582,0.0,0.0,142143,30.11.2009 23:45:00,4316,-0.031058590809763545,102.4,IS,0.23,0.0,Phase3-EA-S4v1-GBPJPY-M5-194,GBPJPYMT4,1146,1h 24m,Sell
51244.79,142044,01.12.2009 03:04:58,tp 142.044,0.0,-0.0,0.0,0.0,141654,01.12.2009 02:30:00,4317,-0.0,103.87,IS,0.23,0.0,Phase3-EA-S4v1-GBPJPY-M5-194,GBPJPYMT4,1148,34m 58s,Buy
51199.47,129773,01.12.2009 03:14:57,sl 129.773,0.0,-45.320000000006985,0.0,0.0,129543,01.12.2009 01:30:00,4318,-0.032086139248043745,-45.32,IS,0.17,0.0,Phase3-EA-T1v2-EURJPY-M15-322,EURJPYMT4,384,1h 44m,Sell
51200.7,1.50805,01.12.2009 07:20:00,,-2.04,-44.08999999999651,0.0,0.0,1.50813,30.11.2009 23:00:00,4319,-0.03121531066738567,1.23,IS,0.41,0.0,Phase3-EA-SA2v2-EURCHF-M5-43,EURCHFMT4,2316,8h 20m,Sell
51205.44,1.50805,01.12.2009 10:00:00,,0.0,-39.35000000000582,0.0,0.0,1.50819,01.12.2009 01:15:00,4320,-0.027859434673665348,4.74,IS,0.34,0.0,Phase3-EA-S4v1-EURCHF-M15-221,EURCHFMT4,1066,8h 45m,Sell
51470.04,1.66448,01.12.2009 22:59:58,tp 1.66448,0.0,-0.0,0.0,0.0,1.64558,01.12.2009 10:30:00,4321,-0.0,264.6,IS,0.14,0.0,Phase3-EA-B1v1-GBPUSD-M30-14,GBPUSDMT4,284,12h 29m,Buy
51472.69,86636,02.12.2009 03:30:00,,-1.4,-0.0,0.0,0.0,86649,01.12.2009 23:15:00,4322,-0.0,2.65,IS,0.27,0.0,Phase3-EA-S1v2-USDJPY-M15-0,USDJPYMT4,1528,4h 15m,Sell
51466.38,1.50724,02.12.2009 06:05:00,,-0.98,-6.309999999997672,0.0,0.0,1.50737,01.12.2009 21:45:00,4323,-0.004460224796741808,-6.31,IS,0.41,0.0,Phase3-EA-SA2v2-EURCHF-M5-43,EURCHFMT4,2318,8h 20m,Buy
51385.57,131635,02.12.2009 10:29:57,sl 131.635,-0.36,-87.11999999999534,0.0,0.0,130855,01.12.2009 20:30:00,4324,-0.061580789903687636,-80.81,IS,0.09,0.0,Phase3-EA-TR1v1-EURJPY-M30-91,EURJPYMT4,482,13h 59m,Sell
51421.33,1.50806,02.12.2009 13:45:00,,0.0,-51.35999999998603,0.0,0.0,1.50701,02.12.2009 05:00:00,4325,-0.03630382655478313,35.76,IS,0.34,0.0,Phase3-EA-S4v1-EURCHF-M15-221,EURCHFMT4,1068,8h 45m,Buy
51522.32,131442,02.12.2009 18:00:00,,0.0,-0.0,0.0,0.0,130924,02.12.2009 04:00:00,4326,-0.0,100.99,IS,0.17,0.0,Phase3-EA-T1v2-EURJPY-M15-322,EURJPYMT4,386,14h 0m,Buy
51312.82,146572,03.12.2009 05:54:58,sl 146.572,0.0,-209.5,0.0,0.0,145772,03.12.2009 02:10:00,4327,-0.1480331865673202,-209.5,IS,0.23,0.0,Phase3-EA-S4v1-GBPJPY-M5-194,GBPJPYMT4,1150,3h 44m,Sell
51440.49,132939,03.12.2009 13:59:58,tp 132.939,-1.51,-81.8299999999872,0.0,0.0,131679,02.12.2009 12:30:00,4328,-0.05782126805156046,127.67,IS,0.09,0.0,Phase3-EA-TR1v1-EURJPY-M30-91,EURJPYMT4,484,1d 1h 29m,Buy
51498.51,0.99958,03.12.2009 23:59:58,tp 0.99958,0.0,-23.80999999999767,0.0,0.0,0.99858,03.12.2009 23:00:00,4329,-0.016824201299129114,58.02,IS,0.58,0.0,Phase3-EA-SA2v2-USDCHF-M15-107,USDCHFMT4,928,59m 58s,Buy
51512.0,88253,04.12.2009 01:00:00,,-0.89,-10.320000000006985,0.0,0.0,88206,03.12.2009 22:15:00,4330,-0.007292135968380804,13.49,IS,0.27,0.0,Phase3-EA-S1v2-USDJPY-M15-0,USDJPYMT4,1530,2h 45m,Buy
51569.99,1.00019,04.12.2009 02:29:59,tp 1.00019,0.0,-0.0,0.0,0.0,1.00119,04.12.2009 01:00:00,4331,-0.0,57.99,IS,0.58,0.0,Phase3-EA-SA2v2-USDCHF-M15-107,USDCHFMT4,930,1h 29m,Sell
51552.51,145714,04.12.2009 08:55:00,,0.0,-17.480000000010477,0.0,0.0,145781,04.12.2009 03:30:00,4332,-0.012347249583058155,-17.48,IS,0.23,0.0,Phase3-EA-S4v1-GBPJPY-M5-194,GBPJPYMT4,1152,5h 25m,Buy
51597.66,1.50739,04.12.2009 10:49:58,tp 1.50739,0.0,-0.0,0.0,0.0,1.50629,04.12.2009 02:50:00,4333,-0.0,45.15,IS,0.41,0.0,Phase3-EA-SA2v2-EURCHF-M5-43,EURCHFMT4,2320,7h 59m,Buy
51553.29,132772,04.12.2009 11:14:58,sl 132.772,0.0,-44.36999999999534,0.0,0.0,133002,04.12.2009 10:15:00,4334,-0.031335263591217064,-44.37,IS,0.17,0.0,Phase3-EA-T1v2-EURJPY-M15-322,EURJPYMT4,388,59m 58s,Buy
51577.76,1.5069,04.12.2009 12:45:00,,0.0,-19.89999999999418,0.0,0.0,1.50618,04.12.2009 04:00:00,4335,-0.014053904563108016,24.47,IS,0.34,0.0,Phase3-EA-S4v1-EURCHF-M15-221,EURCHFMT4,1070,8h 45m,Buy
51533.46,133029,04.12.2009 13:44:58,sl 133.029,0.0,-64.19999999998254,0.0,0.0,132799,04.12.2009 12:15:00,4336,-0.04533973230912327,-44.3,IS,0.17,0.0,Phase3-EA-T1v2-EURJPY-M15-322,EURJPYMT4,390,1h 29m,Sell
51454.03,133813,04.12.2009 16:59:57,sl 133.813,-0.36,-143.62999999997555,0.0,0.0,133033,03.12.2009 19:00:00,4337,-0.10143529208037443,-79.43,IS,0.09,0.0,Phase3-EA-TR1v1-EURJPY-M30-91,EURJPYMT4,486,21h 59m,Sell
51511.09,1.01652,07.12.2009 02:59:57,tp 1.01652,0.0,-86.56999999997788,0.0,0.0,1.01552,07.12.2009 02:00:00,4338,-0.0611380159813219,57.06,IS,0.58,0.0,Phase3-EA-SA2v2-USDCHF-M15-107,USDCHFMT4,932,59m 57s,Buy
51441.23,1.51103,07.12.2009 04:40:00,,-2.02,-156.4299999999639,0.0,0.0,1.50935,04.12.2009 20:20:00,4339,-0.11047498948779512,-69.86,IS,0.41,0.0,Phase3-EA-SA2v2-EURCHF-M5-43,EURCHFMT4,2322,2d 8h 20m,Sell
51374.17,147877,07.12.2009 10:29:58,sl 147.877,0.0,-223.48999999996158,0.0,0.0,148547,07.12.2009 02:00:00,4340,-0.15783452918640148,-67.06,IS,0.09,0.0,Phase3-EA-B1v1-GBPJPY-M30-1,GBPJPYMT4,514,8h 29m,Buy
51301.58,133302,07.12.2009 11:29:58,sl 133.302,-0.49,-296.0799999999581,0.0,0.0,134022,04.12.2009 18:00:00,4341,-0.20909950065556027,-72.59,IS,0.09,0.0,Phase3-EA-TR1v1-EURJPY-M30-91,EURJPYMT4,488,2d 17h 29m,Buy
51565.49,1.63415,07.12.2009 11:59:57,tp 1.63415,-0.69,-32.1699999999546,0.0,0.0,1.65305,04.12.2009 19:00:00,4342,-0.022719301999732613,263.91,IS,0.14,0.0,Phase3-EA-B1v1-GBPUSD-M30-14,GBPUSDMT4,286,2d 16h 59m,Sell
51537.85,1.51172,07.12.2009 13:00:00,,0.0,-59.80999999996857,0.0,0.0,1.51089,07.12.2009 04:15:00,4343,-0.04223939858890927,-27.64,IS,0.34,0.0,Phase3-EA-S4v1-EURCHF-M15-221,EURCHFMT4,1072,8h 45m,Sell
51619.97,89262,08.12.2009 02:45:00,,-1.36,-0.0,0.0,0.0,89538,07.12.2009 23:30:00,4344,-0.0,82.12,IS,0.27,0.0,Phase3-EA-S1v2-USDJPY-M15-0,USDJPYMT4,1532,3h 15m,Sell
51638.33,1.51131,08.12.2009 05:55:00,,-0.96,-0.0,0.0,0.0,1.51083,07.12.2009 21:35:00,4345,-0.0,18.36,IS,0.41,0.0,Phase3-EA-SA2v2-EURCHF-M5-43,EURCHFMT4,2324,8h 20m,Buy
51825.13,145922,08.12.2009 09:29:58,tp 145.922,-0.58,-0.0,0.0,0.0,147772,07.12.2009 10:30:00,4346,-0.0,186.8,IS,0.09,0.0,Phase3-EA-B1v1-GBPJPY-M30-1,GBPJPYMT4,516,22h 59m,Sell
51953.43,130862,08.12.2009 15:59:58,tp 130.862,0.0,-0.0,0.0,0.0,132122,08.12.2009 05:30:00,4347,-0.0,128.3,IS,0.09,0.0,Phase3-EA-TR1v1-EURJPY-M30-91,EURJPYMT4,490,10h 29m,Sell
52142.26,144007,08.12.2009 16:59:58,tp 144.007,0.0,-0.0,0.0,0.0,145857,08.12.2009 09:30:00,4348,-0.0,188.83,IS,0.09,0.0,Phase3-EA-B1v1-GBPJPY-M30-1,GBPJPYMT4,518,7h 29m,Sell
52203.39,88331,08.12.2009 20:15:00,,0.0,-0.0,0.0,0.0,88531,08.12.2009 18:30:00,4349,-0.0,61.13,IS,0.27,0.0,Phase3-EA-S1v2-USDJPY-M15-0,USDJPYMT4,1534,1h 45m,Sell
52331.72,129712,08.12.2009 22:59:58,tp 129.712,0.0,-0.0,0.0,0.0,130972,08.12.2009 16:00:00,4350,-0.0,128.33,IS,0.09,0.0,Phase3-EA-TR1v1-EURJPY-M30-91,EURJPYMT4,492,6h 59m,Sell
52432.88,144091,09.12.2009 03:24:59,tp 144.091,0.0,-0.0,0.0,0.0,143701,09.12.2009 02:00:00,4351,-0.0,101.16,IS,0.23,0.0,Phase3-EA-S4v1-GBPJPY-M5-194,GBPJPYMT4,1154,1h 24m,Buy
52359.18,130419,09.12.2009 03:29:58,sl 130.419,-0.36,-73.70000000001164,0.0,0.0,129699,08.12.2009 23:00:00,4352,-0.05174367042217474,-73.7,IS,0.09,0.0,Phase3-EA-TR1v1-EURJPY-M30-91,EURJPYMT4,494,4h 29m,Sell
52290.34,144302,09.12.2009 03:29:58,sl 144.302,-0.59,-142.54000000000815,0.0,0.0,143632,08.12.2009 23:00:00,4353,-0.10007520735381335,-68.84,IS,0.09,0.0,Phase3-EA-B1v1-GBPJPY-M30-1,GBPJPYMT4,520,4h 29m,Sell
52318.92,88315,09.12.2009 05:45:00,,-1.38,-113.96000000002095,0.0,0.0,88413,08.12.2009 21:45:00,4354,-0.08000961575727525,28.58,IS,0.27,0.0,Phase3-EA-S1v2-USDJPY-M15-0,USDJPYMT4,1536,8h 0m,Sell
52331.55,1.51036,09.12.2009 07:30:00,,-0.96,-101.3300000000163,0.0,0.0,1.51002,08.12.2009 23:10:00,4355,-0.07114228119238782,12.63,IS,0.41,0.0,Phase3-EA-SA2v2-EURCHF-M5-43,EURCHFMT4,2326,8h 20m,Buy
52359.72,1.51053,09.12.2009 11:45:00,,0.0,-73.16000000000349,0.0,0.0,1.50968,09.12.2009 03:00:00,4356,-0.051364544478777294,28.17,IS,0.34,0.0,Phase3-EA-S4v1-EURCHF-M15-221,EURCHFMT4,1074,8h 45m,Buy
52317.72,1.62976,09.12.2009 12:29:58,sl 1.62976,0.0,-115.16000000000349,0.0,0.0,1.62676,09.12.2009 02:00:00,4357,-0.08085211785368905,-42.0,IS,0.14,0.0,Phase3-EA-B1v1-GBPUSD-M30-14,GBPUSDMT4,288,10h 29m,Sell
52273.21,130037,09.12.2009 13:44:57,sl 130.037,0.0,-159.6700000000128,0.0,0.0,129807,09.12.2009 09:30:00,4358,-0.11210192478029848,-44.51,IS,0.17,0.0,Phase3-EA-T1v2-EURJPY-M15-322,EURJPYMT4,392,4h 14m,Sell
52204.75,143849,09.12.2009 13:59:58,sl 143.849,0.0,-228.13000000000466,0.0,0.0,143179,09.12.2009 09:30:00,4359,-0.16016666938139892,-68.46,IS,0.09,0.0,Phase3-EA-B1v1-GBPJPY-M30-1,GBPJPYMT4,522,4h 29m,Sell
52124.89,129099,09.12.2009 17:59:58,sl 129.099,0.0,-307.9899999999907,0.0,0.0,129879,09.12.2009 14:00:00,4360,-0.21623518389854274,-79.86,IS,0.09,0.0,Phase3-EA-TR1v1-EURJPY-M30-91,EURJPYMT4,496,3h 59m,Buy
52140.33,87974,10.12.2009 01:15:00,,-2.67,-292.54999999998836,0.0,0.0,87915,09.12.2009 18:45:00,4361,-0.20539499025785926,15.44,IS,0.27,0.0,Phase3-EA-S1v2-USDJPY-M15-0,USDJPYMT4,1538,6h 30m,Buy
52091.97,1.51226,10.12.2009 04:40:00,,-5.99,-340.9099999999744,0.0,0.0,1.5112,09.12.2009 20:20:00,4362,-0.23934782474381924,-48.36,IS,0.41,0.0,Phase3-EA-SA2v2-EURCHF-M5-43,EURCHFMT4,2328,8h 20m,Sell
52124.1,143343,10.12.2009 07:10:00,,0.0,-308.77999999996973,0.0,0.0,143466,10.12.2009 01:45:00,4363,-0.2167898311120085,32.13,IS,0.23,0.0,Phase3-EA-S4v1-GBPJPY-M5-194,GBPJPYMT4,1156,5h 25m,Sell
52079.6,129322,10.12.2009 08:29:57,sl 129.322,0.0,-353.27999999996973,0.0,0.0,129092,10.12.2009 07:45:00,4364,-0.24803261718780786,-44.5,IS,0.17,0.0,Phase3-EA-T1v2-EURJPY-M15-322,EURJPYMT4,394,44m 57s,Sell
52060.05,1.51243,10.12.2009 10:15:00,,0.0,-372.8299999999581,0.0,0.0,1.51184,10.12.2009 01:30:00,4365,-0.26175838050874073,-19.55,IS,0.34,0.0,Phase3-EA-S4v1-EURCHF-M15-221,EURCHFMT4,1076,8h 45m,Sell
52015.73,129718,10.12.2009 12:59:58,sl 129.718,0.0,-417.1499999999651,0.0,0.0,129948,10.12.2009 12:30:00,4366,-0.2928747912700811,-44.32,IS,0.17,0.0,Phase3-EA-T1v2-EURJPY-M15-322,EURJPYMT4,396,29m 58s,Buy
52067.7,88318,10.12.2009 18:30:00,,0.0,-365.1799999999639,0.0,0.0,88148,10.12.2009 17:00:00,4367,-0.2563874296440288,51.97,IS,0.27,0.0,Phase3-EA-S1v2-USDJPY-M15-0,USDJPYMT4,1540,1h 30m,Buy
52089.09,1.51127,11.12.2009 05:25:00,,-0.96,-343.78999999994994,0.0,0.0,1.51071,10.12.2009 21:05:00,4368,-0.24136982977522461,21.39,IS,0.41,0.0,Phase3-EA-SA2v2-EURCHF-M5-43,EURCHFMT4,2330,8h 20m,Buy
51881.61,144632,11.12.2009 06:14:57,sl 144.632,0.0,-551.2699999999604,0.0,0.0,143832,11.12.2009 03:30:00,4369,-0.387038442247296,-207.48,IS,0.23,0.0,Phase3-EA-S4v1-GBPJPY-M5-194,GBPJPYMT4,1158,2h 44m,Sell
52011.97,130674,11.12.2009 06:59:57,tp 130.674,-0.5,-420.9099999999744,0.0,0.0,129384,10.12.2009 01:00:00,4370,-0.2955146311722226,130.36,IS,0.09,0.0,Phase3-EA-TR1v1-EURJPY-M30-91,EURJPYMT4,498,1d 5h 59m,Buy
51976.51,1.51228,11.12.2009 12:00:00,,0.0,-456.36999999996624,0.0,0.0,1.51121,11.12.2009 03:15:00,4371,-0.3204105681216066,-35.46,IS,0.34,0.0,Phase3-EA-S4v1-EURCHF-M15-221,EURCHFMT4,1078,8h 45m,Sell
51909.03,144688,11.12.2009 19:59:58,sl 144.688,0.0,-523.8499999999767,0.0,0.0,145358,11.12.2009 18:00:00,4372,-0.3677872693439722,-67.48,IS,0.09,0.0,Phase3-EA-B1v1-GBPJPY-M30-1,GBPJPYMT4,524,1h 59m,Buy
51951.64,1.51289,14.12.2009 02:04:57,tp 1.51289,-0.95,-481.2399999999907,0.0,0.0,1.51179,11.12.2009 20:20:00,4373,-0.3378714240700537,42.61,IS,0.41,0.0,Phase3-EA-SA2v2-EURCHF-M5-43,EURCHFMT4,2332,2d 5h 44m,Buy
52081.99,129864,14.12.2009 04:29:57,tp 129.864,-0.35,-350.88999999998487,0.0,0.0,131154,11.12.2009 18:00:00,4374,-0.24635463384576992,130.35,IS,0.09,0.0,Phase3-EA-TR1v1-EURJPY-M30-91,EURJPYMT4,500,2d 10h 29m,Sell
51827.69,88429,14.12.2009 06:59:57,sl 88.429,-0.88,-605.1899999999732,0.0,0.0,89259,11.12.2009 20:30:00,4375,-0.4248948697800488,-254.3,IS,0.27,0.0,Phase3-EA-S1v2-USDJPY-M15-0,USDJPYMT4,1542,2d 10h 29m,Buy
51783.52,130152,14.12.2009 11:14:58,sl 130.152,0.0,-649.359999999986,0.0,0.0,129922,14.12.2009 10:30:00,4376,-0.45590596777934,-44.17,IS,0.17,0.0,Phase3-EA-T1v2-EURJPY-M15-322,EURJPYMT4,398,44m 58s,Sell
51806.41,1.51203,15.12.2009 04:30:00,,-0.95,-626.4699999999721,0.0,0.0,1.51143,14.12.2009 20:10:00,4377,-0.4398352402900033,22.89,IS,0.41,0.0,Phase3-EA-SA2v2-EURCHF-M5-43,EURCHFMT4,2334,8h 20m,Buy
51788.1,1.5125,15.12.2009 12:30:00,,0.0,-644.7799999999697,0.0,0.0,1.51194,15.12.2009 03:45:00,4378,-0.4526904181113025,-18.31,IS,0.34,0.0,Phase3-EA-S4v1-EURCHF-M15-221,EURCHFMT4,1080,8h 45m,Sell
51833.06,130.31,16.12.2009 01:30:00,,-0.93,-599.8199999999779,0.0,0.0,130068,15.12.2009 15:00:00,4379,-0.42112467289854555,44.96,IS,0.17,0.0,Phase3-EA-T1v2-EURJPY-M15-322,EURJPYMT4,400,10h 30m,Buy
51840.19,1.04047,16.12.2009 03:45:00,,-0.67,-592.6899999999732,0.0,0.0,1.04033,15.12.2009 23:30:00,4380,-0.4161188062756108,7.13,IS,0.58,0.0,Phase3-EA-SA2v2-USDCHF-M15-107,USDCHFMT4,934,4h 15m,Buy
51863.28,1.51314,16.12.2009 04:55:00,,-0.95,-569.5999999999767,0.0,0.0,1.51253,15.12.2009 20:35:00,4381,-0.39990766177021536,23.09,IS,0.41,0.0,Phase3-EA-SA2v2-EURCHF-M5-43,EURCHFMT4,2336,8h 20m,Buy
51823.97,145401,16.12.2009 08:40:00,,0.0,-608.9099999999744,0.0,0.0,145554,16.12.2009 03:15:00,4382,-0.4275066262789704,-39.31,IS,0.23,0.0,Phase3-EA-S4v1-GBPJPY-M5-194,GBPJPYMT4,1160,5h 25m,Buy
51836.08,1.51267,16.12.2009 14:15:00,,0.0,-596.7999999999884,0.0,0.0,1.51304,16.12.2009 05:30:00,4383,-0.41900437595588064,12.11,IS,0.34,0.0,Phase3-EA-S4v1-EURCHF-M15-221,EURCHFMT4,1082,8h 45m,Sell
51879.65,1.50992,16.12.2009 22:19:58,tp 1.50992,0.0,-553.2299999999814,0.0,0.0,1.50882,16.12.2009 20:35:00,4384,-0.3884145290048066,43.57,IS,0.41,0.0,Phase3-EA-SA2v2-EURCHF-M5-43,EURCHFMT4,2338,1h 44m,Buy
51871.14,130556,16.12.2009 23:00:00,,0.0,-561.7399999999907,0.0,0.0,130601,16.12.2009 22:45:00,4385,-0.3943892730386345,-8.51,IS,0.17,0.0,Phase3-EA-T1v2-EURJPY-M15-322,EURJPYMT4,402,15m 0s,Buy
51908.98,89903,17.12.2009 03:45:00,,0.0,-523.8999999999942,0.0,0.0,89777,17.12.2009 01:45:00,4386,-0.36782237359800224,37.84,IS,0.27,0.0,Phase3-EA-S1v2-USDJPY-M15-0,USDJPYMT4,1544,2h 0m,Buy
51865.46,130347,17.12.2009 04:59:58,sl 130.347,0.0,-567.4199999999837,0.0,0.0,130577,17.12.2009 03:15:00,4387,-0.3983771162950463,-43.52,IS,0.17,0.0,Phase3-EA-T1v2-EURJPY-M15-322,EURJPYMT4,404,1h 44m,Buy
51791.55,129492,17.12.2009 10:29:57,sl 129.492,-1.96,-641.3299999999872,0.0,0.0,129814,14.12.2009 20:00:00,4388,-0.4502682245840898,-73.91,IS,0.09,0.0,Phase3-EA-TR1v1-EURJPY-M30-91,EURJPYMT4,502,2d 14h 29m,Buy
51710.88,129034,17.12.2009 10:59:58,sl 129.034,-2.46,-722.0,0.0,0.0,130212,15.12.2009 08:30:00,4389,-0.5069054280163401,-80.67,IS,0.09,0.0,Phase3-EA-TR1v1-EURJPY-M30-91,EURJPYMT4,503,2d 2h 29m,Buy
51642.39,144754,17.12.2009 13:29:58,sl 144.754,-1.44,-790.4899999999907,0.0,0.0,145424,15.12.2009 16:30:00,4390,-0.5549912351698503,-68.49,IS,0.09,0.0,Phase3-EA-B1v1-GBPJPY-M30-1,GBPJPYMT4,526,1d 20h 59m,Buy
51575.55,1.50543,17.12.2009 15:30:00,,0.0,-857.3299999999872,0.0,0.0,1.50749,17.12.2009 06:45:00,4391,-0.6019186019407788,-66.84,IS,0.34,0.0,Phase3-EA-S4v1-EURCHF-M15-221,EURCHFMT4,1084,8h 45m,Buy
51598.63,90065,17.12.2009 18:15:00,,0.0,-834.25,0.0,0.0,89988,17.12.2009 17:45:00,4392,-0.5857144782861935,23.08,IS,0.27,0.0,Phase3-EA-S1v2-USDJPY-M15-0,USDJPYMT4,1546,30m 0s,Buy
51641.63,1.50305,17.12.2009 20:04:58,tp 1.50305,0.0,-791.25,0.0,0.0,1.50195,17.12.2009 20:00:00,4393,-0.5555248198309267,43.0,IS,0.41,0.0,Phase3-EA-SA2v2-EURCHF-M5-43,EURCHFMT4,2340,4m 58s,Buy
51683.76,1.50239,18.12.2009 01:54:57,tp 1.50239,-0.94,-749.1199999999953,0.0,0.0,1.50129,17.12.2009 21:50:00,4394,-0.5259459753955655,42.13,IS,0.41,0.0,Phase3-EA-SA2v2-EURCHF-M5-43,EURCHFMT4,2342,4h 4m,Buy
51605.15,128.51,18.12.2009 02:29:57,sl 128.510,-0.49,-827.7299999999814,0.0,0.0,129.29,17.12.2009 19:30:00,4395,-0.5811368835622656,-78.61,IS,0.09,0.0,Phase3-EA-TR1v1-EURJPY-M30-91,EURJPYMT4,506,6h 59m,Buy
51399.51,143991,18.12.2009 03:39:58,sl 143.991,0.0,-1033.3699999999953,0.0,0.0,144791,18.12.2009 02:35:00,4396,-0.725513659486486,-205.64,IS,0.23,0.0,Phase3-EA-S4v1-GBPJPY-M5-194,GBPJPYMT4,1162,1h 4m,Buy
51500.01,144473,18.12.2009 03:59:58,tp 144.473,0.0,-932.8699999999953,0.0,0.0,144083,18.12.2009 03:45:00,4397,-0.6549541089108044,100.5,IS,0.23,0.0,Phase3-EA-S4v1-GBPJPY-M5-194,GBPJPYMT4,1164,14m 58s,Buy
51455.67,129287,18.12.2009 05:14:58,sl 129.287,-0.66,-977.2099999999919,0.0,0.0,129057,17.12.2009 20:45:00,4398,-0.6860845613737445,-44.34,IS,0.17,0.0,Phase3-EA-T1v2-EURJPY-M15-322,EURJPYMT4,406,8h 29m,Sell
51412.02,128843,18.12.2009 08:44:57,sl 128.843,0.0,-1020.859999999986,0.0,0.0,128613,18.12.2009 08:00:00,4399,-0.716730575131238,-43.65,IS,0.17,0.0,Phase3-EA-T1v2-EURJPY-M15-322,EURJPYMT4,408,44m 57s,Sell
51540.77,129903,18.12.2009 11:59:57,tp 129.903,0.0,-892.109999999986,0.0,0.0,128613,18.12.2009 05:00:00,4400,-0.6263371210355264,128.75,IS,0.09,0.0,Phase3-EA-TR1v1-EURJPY-M30-91,EURJPYMT4,508,6h 59m,Buy
51633.13,1.49925,18.12.2009 14:00:00,,0.0,-799.75,0.0,0.0,1.49642,18.12.2009 05:15:00,4401,-0.5614925430139446,92.36,IS,0.34,0.0,Phase3-EA-S4v1-EURCHF-M15-221,EURCHFMT4,1086,8h 45m,Buy
51700.5,90569,18.12.2009 18:30:00,,0.0,-732.3800000000047,0.0,0.0,90343,18.12.2009 17:30:00,4402,-0.5141930711504287,67.37,IS,0.27,0.0,Phase3-EA-S1v2-USDJPY-M15-0,USDJPYMT4,1548,1h 0m,Buy
51743.73,1.49344,18.12.2009 20:59:58,tp 1.49344,0.0,-689.1499999999942,0.0,0.0,1.49234,18.12.2009 20:10:00,4403,-0.48384193312667284,43.23,IS,0.41,0.0,Phase3-EA-SA2v2-EURCHF-M5-43,EURCHFMT4,2344,49m 58s,Buy
51785.02,1.49262,21.12.2009 02:00:00,tp 1.49262,-1.97,-647.859999999986,0.0,0.0,1.49372,18.12.2009 23:00:00,4404,-0.45485284015880745,41.29,IS,0.41,0.0,Phase3-EA-SA2v2-EURCHF-M5-43,EURCHFMT4,2346,2d 3h 0m,Sell
51802.64,90511,21.12.2009 04:00:00,,-0.87,-630.2399999999907,0.0,0.0,90449,18.12.2009 22:00:00,4405,-0.4424821010429549,17.62,IS,0.27,0.0,Phase3-EA-S1v2-USDJPY-M15-0,USDJPYMT4,1550,2d 6h 0m,Buy
51834.73,145784,21.12.2009 07:25:00,,0.0,-598.1499999999942,0.0,0.0,145.91,21.12.2009 02:00:00,4406,-0.4199521908143641,32.09,IS,0.23,0.0,Phase3-EA-S4v1-GBPJPY-M5-194,GBPJPYMT4,1166,5h 25m,Sell
51877.86,1.49468,21.12.2009 22:09:57,tp 1.49468,0.0,-555.0199999999895,0.0,0.0,1.49358,21.12.2009 20:30:00,4407,-0.3896712612986478,43.13,IS,0.41,0.0,Phase3-EA-SA2v2-EURCHF-M5-43,EURCHFMT4,2348,1h 39m,Buy
51953.67,130098,22.12.2009 03:00:00,,-0.91,-479.20999999999185,0.0,0.0,129687,21.12.2009 14:30:00,4408,-0.33644619135693377,75.81,IS,0.17,0.0,Phase3-EA-T1v2-EURJPY-M15-322,EURJPYMT4,410,12h 30m,Buy
52048.6,1.49636,22.12.2009 10:15:00,,0.0,-384.27999999999884,0.0,0.0,1.49344,22.12.2009 01:30:00,4409,-0.2697972546788346,94.93,IS,0.34,0.0,Phase3-EA-S4v1-EURCHF-M15-221,EURCHFMT4,1088,8h 45m,Buy
51971.83,130886,22.12.2009 17:59:58,sl 130.886,0.0,-461.04999999998836,0.0,0.0,130106,22.12.2009 02:00:00,4410,-0.32369632629768375,-76.77,IS,0.09,0.0,Phase3-EA-TR1v1-EURJPY-M30-91,EURJPYMT4,510,15h 59m,Sell
52014.84,1.49421,22.12.2009 22:59:57,tp 1.49421,0.0,-418.03999999997905,0.0,0.0,1.49531,22.12.2009 22:10:00,4411,-0.2934996469916069,43.01,IS,0.41,0.0,Phase3-EA-SA2v2-EURCHF-M5-43,EURCHFMT4,2350,49m 57s,Sell
51971.3,130671,23.12.2009 04:14:58,sl 130.671,-0.91,-461.5799999999872,0.0,0.0,130901,22.12.2009 21:00:00,4412,-0.32406843139027114,-43.54,IS,0.17,0.0,Phase3-EA-T1v2-EURJPY-M15-322,EURJPYMT4,412,7h 14m,Buy
52051.45,1.49278,23.12.2009 13:45:00,,0.0,-381.429999999993,0.0,0.0,1.49525,23.12.2009 05:00:00,4413,-0.26779631219981864,80.15,IS,0.34,0.0,Phase3-EA-S4v1-EURCHF-M15-221,EURCHFMT4,1090,8h 45m,Sell
51974.34,131349,23.12.2009 20:59:57,sl 131.349,-0.34,-458.53999999997905,0.0,0.0,130569,22.12.2009 19:30:00,4414,-0.32193409274598606,-77.11,IS,0.09,0.0,Phase3-EA-TR1v1-EURJPY-M30-91,EURJPYMT4,512,1d 1h 29m,Sell
52021.32,1.03855,24.12.2009 00:44:59,tp 1.03855,-8.87,-411.55999999996857,0.0,0.0,1.03955,23.12.2009 23:15:00,4415,-0.28895013567089883,46.98,IS,0.58,0.0,Phase3-EA-SA2v2-USDCHF-M15-107,USDCHFMT4,936,1h 29m,Sell
51998.77,91602,24.12.2009 03:30:00,,-3.98,-434.1099999999569,0.0,0.0,91539,23.12.2009 21:45:00,4416,-0.3047821542328969,-22.55,IS,0.27,0.0,Phase3-EA-S1v2-USDJPY-M15-0,USDJPYMT4,1552,5h 45m,Sell
51975.48,1.48971,24.12.2009 07:00:00,,-5.92,-457.3999999999651,0.0,0.0,1.48927,23.12.2009 22:40:00,4417,-0.3211337157543715,-23.29,IS,0.41,0.0,Phase3-EA-SA2v2-EURCHF-M5-43,EURCHFMT4,2352,8h 20m,Sell
52032.4,131164,24.12.2009 07:15:00,,-2.73,-400.47999999995227,0.0,0.0,130843,23.12.2009 11:30:00,4418,-0.28117103298055357,56.92,IS,0.17,0.0,Phase3-EA-T1v2-EURJPY-M15-322,EURJPYMT4,414,19h 45m,Buy
51982.78,1.49122,24.12.2009 13:45:00,,0.0,-450.0999999999476,0.0,0.0,1.48971,24.12.2009 05:00:00,4419,-0.3160084946677674,-49.62,IS,0.34,0.0,Phase3-EA-S4v1-EURCHF-M15-221,EURCHFMT4,1092,8h 45m,Sell
51940.78,1.59729,24.12.2009 16:59:58,sl 1.59729,0.0,-492.0999999999476,0.0,0.0,1.60029,24.12.2009 13:00:00,4420,-0.3454960680426792,-42.0,IS,0.14,0.0,Phase3-EA-B1v1-GBPUSD-M30-14,GBPUSDMT4,290,3h 59m,Buy
51976.98,131607,28.12.2009 04:30:00,,-0.91,-455.89999999993597,0.0,0.0,131407,24.12.2009 13:30:00,4421,-0.3200805881338185,36.2,IS,0.17,0.0,Phase3-EA-T1v2-EURJPY-M15-322,EURJPYMT4,416,3d 15h 0m,Buy
52004.59,1.49011,28.12.2009 14:15:00,,0.0,-428.28999999994994,0.0,0.0,1.48927,28.12.2009 05:30:00,4422,-0.30069601906522564,27.61,IS,0.34,0.0,Phase3-EA-S4v1-EURCHF-M15-221,EURCHFMT4,1094,8h 45m,Buy
52014.8,131727,28.12.2009 22:45:00,,0.0,-418.0799999999581,0.0,0.0,131672,28.12.2009 05:15:00,4423,-0.2935277303948064,10.21,IS,0.17,0.0,Phase3-EA-T1v2-EURJPY-M15-322,EURJPYMT4,418,17h 30m,Buy
52058.42,1.48728,28.12.2009 23:59:57,tp 1.48728,0.0,-374.45999999996275,0.0,0.0,1.48838,28.12.2009 22:00:00,4424,-0.2629027791897227,43.62,IS,0.41,0.0,Phase3-EA-SA2v2-EURCHF-M5-43,EURCHFMT4,2354,1h 59m,Sell
52101.98,1.48815,29.12.2009 01:44:58,tp 1.48815,0.0,-330.8999999999651,0.0,0.0,1.48705,29.12.2009 00:05:00,4425,-0.23231995308945874,43.56,IS,0.41,0.0,Phase3-EA-SA2v2-EURCHF-M5-43,EURCHFMT4,2356,1h 39m,Buy
52081.82,1.03558,29.12.2009 06:00:00,,0.0,-351.05999999996857,0.0,0.0,1.03522,29.12.2009 01:45:00,4426,-0.24647398830941883,-20.16,IS,0.58,0.0,Phase3-EA-SA2v2-USDCHF-M15-107,USDCHFMT4,938,4h 15m,Sell
52033.29,1.48593,29.12.2009 13:00:00,,0.0,-399.5899999999674,0.0,0.0,1.4874,29.12.2009 04:15:00,4427,-0.2805461772590482,-48.53,IS,0.34,0.0,Phase3-EA-S4v1-EURCHF-M15-221,EURCHFMT4,1096,8h 45m,Buy
51991.29,1.59793,29.12.2009 14:29:58,sl 1.59793,0.0,-441.5899999999674,0.0,0.0,1.60093,29.12.2009 08:00:00,4428,-0.31003375063395994,-42.0,IS,0.14,0.0,Phase3-EA-B1v1-GBPUSD-M30-14,GBPUSDMT4,292,6h 29m,Buy
51925.64,146058,29.12.2009 19:29:58,sl 146.058,0.0,-507.2399999999616,0.0,0.0,146728,29.12.2009 05:00:00,4429,-0.35612563615926435,-65.65,IS,0.09,0.0,Phase3-EA-B1v1-GBPJPY-M30-1,GBPJPYMT4,528,14h 29m,Buy
51980.89,1.03726,30.12.2009 02:59:58,tp 1.03726,-0.67,-451.9899999999616,0.0,0.0,1.03626,29.12.2009 23:45:00,4430,-0.31733543546964826,55.25,IS,0.58,0.0,Phase3-EA-SA2v2-USDCHF-M15-107,USDCHFMT4,940,3h 14m,Buy
51999.08,92045,30.12.2009 04:00:00,,0.0,-433.79999999995925,0.0,0.0,91983,30.12.2009 01:00:00,4431,-0.30456450785798844,18.19,IS,0.27,0.0,Phase3-EA-S1v2-USDJPY-M15-0,USDJPYMT4,1554,3h 0m,Buy
51982.34,1.48732,30.12.2009 07:55:00,,-0.95,-450.53999999994994,0.0,0.0,1.48772,29.12.2009 23:35:00,4432,-0.3163174121031253,-16.74,IS,0.41,0.0,Phase3-EA-SA2v2-EURCHF-M5-43,EURCHFMT4,2358,8h 20m,Buy
51939.87,132115,30.12.2009 10:14:57,sl 132.115,0.0,-493.0099999999511,0.0,0.0,131885,30.12.2009 09:15:00,4433,-0.34613496546580474,-42.47,IS,0.17,0.0,Phase3-EA-T1v2-EURJPY-M15-322,EURJPYMT4,420,59m 57s,Sell
51975.28,1.48812,30.12.2009 14:15:00,,0.0,-457.5999999999476,0.0,0.0,1.48704,30.12.2009 05:30:00,4434,-0.32127413277043027,35.41,IS,0.34,0.0,Phase3-EA-S4v1-EURCHF-M15-221,EURCHFMT4,1098,8h 45m,Buy
51909.39,146753,30.12.2009 16:59:58,sl 146.753,-0.57,-523.4899999999616,0.0,0.0,146083,29.12.2009 19:30:00,4435,-0.3675345187150338,-65.89,IS,0.09,0.0,Phase3-EA-B1v1-GBPJPY-M30-1,GBPJPYMT4,530,21h 29m,Sell
52028.48,132674,30.12.2009 19:59:58,tp 132.674,-3.36,-404.3999999999651,0.0,0.0,131414,23.12.2009 22:30:00,4436,-0.2839232064955543,119.09,IS,0.09,0.0,Phase3-EA-TR1v1-EURJPY-M30-91,EURJPYMT4,514,6d 21h 29m,Buy
52293.08,1.60905,30.12.2009 20:29:58,tp 1.60905,0.0,-139.79999999995925,0.0,0.0,1.59015,30.12.2009 17:30:00,4437,-0.09815149423360621,264.6,IS,0.14,0.0,Phase3-EA-B1v1-GBPUSD-M30-14,GBPUSDMT4,294,2h 59m,Buy
52322.35,92525,31.12.2009 03:15:00,,-2.54,-110.52999999996973,0.0,0.0,92416,30.12.2009 20:45:00,4438,-0.0776014639316215,29.27,IS,0.27,0.0,Phase3-EA-S1v2-USDJPY-M15-0,USDJPYMT4,1556,6h 30m,Buy
52333.77,1.48644,31.12.2009 06:05:00,,-2.85,-99.10999999995693,0.0,0.0,1.48608,30.12.2009 21:45:00,4439,-0.06958365231395794,11.42,IS,0.41,0.0,Phase3-EA-SA2v2-EURCHF-M5-43,EURCHFMT4,2360,8h 20m,Buy
52430.83,148342,31.12.2009 06:09:59,tp 148.342,0.0,-2.0499999999592546,0.0,0.0,148732,31.12.2009 03:25:00,4440,-0.0014392744146992287,97.06,IS,0.23,0.0,Phase3-EA-S4v1-GBPJPY-M5-194,GBPJPYMT4,1168,2h 44m,Sell
52355.4,133543,31.12.2009 19:29:57,sl 133.543,0.0,-77.47999999995227,0.0,0.0,132763,31.12.2009 09:00:00,4441,-0.054397552025875116,-75.43,IS,0.09,0.0,Phase3-EA-TR1v1-EURJPY-M30-91,EURJPYMT4,516,10h 29m,Sell
52534.26,150583,31.12.2009 19:59:58,tp 150.583,0.0,-0.0,0.0,0.0,148733,31.12.2009 03:30:00,4442,-0.0,178.86,IS,0.09,0.0,Phase3-EA-B1v1-GBPJPY-M30-1,GBPJPYMT4,532,16h 29m,Buy
52464.03,132674,04.01.2010 03:29:58,sl 132.674,-0.47,-70.23000000001048,0.0,0.0,133394,31.12.2009 17:00:00,4443,-0.0492723644126054,-70.23,IS,0.09,0.0,Phase3-EA-TR1v1-EURJPY-M30-91,EURJPYMT4,517,3d 10h 29m,Buy
52309.52,149199,04.01.2010 07:50:00,,0.0,-224.7400000000198,0.0,0.0,149822,04.01.2010 02:25:00,4444,-0.15767437246316762,-154.51,IS,0.23,0.0,Phase3-EA-S4v1-GBPJPY-M5-194,GBPJPYMT4,1170,5h 25m,Buy
52440.44,1.48628,04.01.2010 10:29:58,tp 1.48628,0.0,-93.82000000000698,0.0,0.0,1.48228,04.01.2010 03:45:00,4445,-0.06582277131126717,130.92,IS,0.34,0.0,Phase3-EA-S4v1-EURCHF-M15-221,EURCHFMT4,1100,6h 44m,Buy
52473.15,92481,05.01.2010 01:30:00,,-2.62,-61.110000000015134,0.0,0.0,92602,04.01.2010 22:00:00,4446,-0.042873902737499824,32.71,IS,0.27,0.0,Phase3-EA-S1v2-USDJPY-M15-0,USDJPYMT4,1558,3h 30m,Sell
52529.53,1.02879,05.01.2010 03:14:58,tp 1.02879,0.0,-4.730000000010477,0.0,0.0,1.02979,05.01.2010 00:15:00,4447,-0.0033185004082600745,56.38,IS,0.58,0.0,Phase3-EA-SA2v2-USDCHF-M15-107,USDCHFMT4,942,2h 59m,Sell
52458.43,132902,05.01.2010 04:29:58,sl 132.902,-0.95,-75.8300000000163,0.0,0.0,133622,04.01.2010 14:00:00,4448,-0.05320124438855352,-71.1,IS,0.09,0.0,Phase3-EA-TR1v1-EURJPY-M30-91,EURJPYMT4,520,14h 29m,Buy
52460.51,1.48373,05.01.2010 07:00:00,,-1.91,-73.7500000000291,0.0,0.0,1.48363,04.01.2010 22:40:00,4449,-0.05174194611178329,2.08,IS,0.41,0.0,Phase3-EA-SA2v2-EURCHF-M5-43,EURCHFMT4,2362,8h 20m,Buy
52518.03,1.48482,05.01.2010 13:30:00,,0.0,-16.23000000003958,0.0,0.0,1.48308,05.01.2010 04:45:00,4450,-0.011386736073165551,57.52,IS,0.34,0.0,Phase3-EA-S4v1-EURCHF-M15-221,EURCHFMT4,1102,8h 45m,Buy
52641.73,131643,05.01.2010 17:59:58,tp 131.643,0.0,-0.0,0.0,0.0,132903,05.01.2010 07:00:00,4451,-0.0,123.7,IS,0.09,0.0,Phase3-EA-TR1v1-EURJPY-M30-91,EURJPYMT4,522,10h 59m,Sell
52823.69,146424,05.01.2010 19:59:57,tp 146.424,0.0,-0.0,0.0,0.0,148274,05.01.2010 06:30:00,4452,-0.0,181.96,IS,0.09,0.0,Phase3-EA-B1v1-GBPJPY-M30-1,GBPJPYMT4,534,13h 29m,Sell
52867.25,1.48681,05.01.2010 21:34:58,tp 1.48681,0.0,-0.0,0.0,0.0,1.48571,05.01.2010 20:40:00,4453,-0.0,43.56,IS,0.41,0.0,Phase3-EA-SA2v2-EURCHF-M5-43,EURCHFMT4,2364,54m 58s,Buy
52923.35,1.0338,05.01.2010 22:59:58,tp 1.03380,0.0,-0.0,0.0,0.0,1.0348,05.01.2010 22:00:00,4454,-0.0,56.1,IS,0.58,0.0,Phase3-EA-SA2v2-USDCHF-M15-107,USDCHFMT4,944,59m 58s,Sell
53019.78,146298,06.01.2010 02:19:57,tp 146.298,-1.46,-0.0,0.0,0.0,146688,05.01.2010 23:05:00,4455,-0.0,96.43,IS,0.23,0.0,Phase3-EA-S4v1-GBPJPY-M5-194,GBPJPYMT4,1172,3h 14m,Sell
53039.97,91568,06.01.2010 03:00:00,,-1.33,-0.0,0.0,0.0,91641,05.01.2010 21:45:00,4456,-0.0,20.19,IS,0.27,0.0,Phase3-EA-S1v2-USDJPY-M15-0,USDJPYMT4,1560,5h 15m,Sell
53137.75,146783,06.01.2010 04:24:58,tp 146.783,0.0,-0.0,0.0,0.0,146393,06.01.2010 02:25:00,4457,-0.0,97.78,IS,0.23,0.0,Phase3-EA-S4v1-GBPJPY-M5-194,GBPJPYMT4,1174,1h 59m,Buy
53071.36,146.84,06.01.2010 04:29:58,sl 146.840,-0.57,-66.39000000001397,0.0,0.0,146.17,05.01.2010 21:30:00,4458,-0.04638189436400528,-66.39,IS,0.09,0.0,Phase3-EA-B1v1-GBPJPY-M30-1,GBPJPYMT4,536,6h 59m,Sell
53066.84,1.48521,06.01.2010 06:35:00,,-0.95,-70.91000000000349,0.0,0.0,1.4853,05.01.2010 22:15:00,4459,-0.049539691660658,-4.52,IS,0.41,0.0,Phase3-EA-SA2v2-EURCHF-M5-43,EURCHFMT4,2366,8h 20m,Buy
53078.03,1.48469,06.01.2010 12:45:00,,0.0,-59.720000000001164,0.0,0.0,1.48435,06.01.2010 04:00:00,4460,-0.04172204746826128,11.19,IS,0.34,0.0,Phase3-EA-S4v1-EURCHF-M15-221,EURCHFMT4,1104,8h 45m,Buy
53034.99,132674,06.01.2010 12:59:58,sl 132.674,-0.65,-102.76000000000931,0.0,0.0,132444,05.01.2010 16:30:00,4461,-0.07179098455858732,-43.04,IS,0.17,0.0,Phase3-EA-T1v2-EURJPY-M15-322,EURJPYMT4,422,20h 29m,Sell
53160.75,133062,06.01.2010 18:29:58,tp 133.062,0.0,-0.0,0.0,0.0,131772,06.01.2010 06:00:00,4462,-0.0,125.76,IS,0.09,0.0,Phase3-EA-TR1v1-EURJPY-M30-91,EURJPYMT4,524,12h 29m,Buy
53217.88,92629,06.01.2010 18:30:00,,0.0,-0.0,0.0,0.0,92433,06.01.2010 18:15:00,4463,-0.0,57.13,IS,0.27,0.0,Phase3-EA-S1v2-USDJPY-M15-0,USDJPYMT4,1562,15m 0s,Buy
53315.1,148168,07.01.2010 03:34:57,tp 148.168,0.0,-0.0,0.0,0.0,147778,07.01.2010 00:55:00,4464,-0.0,97.22,IS,0.23,0.0,Phase3-EA-S4v1-GBPJPY-M5-194,GBPJPYMT4,1176,2h 39m,Buy
53306.13,92414,07.01.2010 04:15:00,,-2.54,-8.970000000001164,0.0,0.0,92436,06.01.2010 23:45:00,4465,-0.006258935729732013,-8.97,IS,0.27,0.0,Phase3-EA-S1v2-USDJPY-M15-0,USDJPYMT4,1564,4h 30m,Buy
53263.98,133074,07.01.2010 11:59:58,sl 133.074,0.0,-51.11999999999534,0.0,0.0,133304,07.01.2010 10:45:00,4466,-0.035669653790839445,-42.15,IS,0.17,0.0,Phase3-EA-T1v2-EURJPY-M15-322,EURJPYMT4,424,1h 14m,Buy
53352.82,93306,07.01.2010 20:00:00,,0.0,-0.0,0.0,0.0,92999,07.01.2010 17:30:00,4467,-0.0,88.84,IS,0.27,0.0,Phase3-EA-S1v2-USDJPY-M15-0,USDJPYMT4,1566,2h 30m,Buy
53380.33,93246,07.01.2010 23:15:00,,0.0,-0.0,0.0,0.0,93151,07.01.2010 21:00:00,4468,-0.0,27.51,IS,0.27,0.0,Phase3-EA-S1v2-USDJPY-M15-0,USDJPYMT4,1568,2h 15m,Buy
53304.75,133752,08.01.2010 01:29:58,sl 133.752,-0.34,-75.5799999999872,0.0,0.0,132972,07.01.2010 02:00:00,4469,-0.05271294884032362,-75.58,IS,0.09,0.0,Phase3-EA-TR1v1-EURJPY-M30-91,EURJPYMT4,526,23h 29m,Sell
53400.91,148657,08.01.2010 04:29:58,tp 148.657,0.0,-0.0,0.0,0.0,149047,08.01.2010 01:15:00,4470,-0.0,96.16,IS,0.23,0.0,Phase3-EA-S4v1-GBPJPY-M5-194,GBPJPYMT4,1178,3h 14m,Sell
53358.1,133388,08.01.2010 05:44:57,sl 133.388,-0.89,-42.80999999999767,0.0,0.0,133618,07.01.2010 23:45:00,4471,-0.02985336703930098,-42.81,IS,0.17,0.0,Phase3-EA-T1v2-EURJPY-M15-322,EURJPYMT4,426,5h 59m,Buy
53347.4,1.48022,08.01.2010 08:10:00,,-1.98,-53.51000000000931,0.0,0.0,1.48,07.01.2010 23:50:00,4472,-0.037314965435023606,-10.7,IS,0.41,0.0,Phase3-EA-SA2v2-EURCHF-M5-43,EURCHFMT4,2368,8h 20m,Sell
53310.57,1.48147,08.01.2010 12:45:00,,0.0,-90.33999999999651,0.0,0.0,1.48035,08.01.2010 04:00:00,4473,-0.06299820552045067,-36.83,IS,0.34,0.0,Phase3-EA-S4v1-EURCHF-M15-221,EURCHFMT4,1106,8h 45m,Sell
53435.47,132592,08.01.2010 16:59:57,tp 132.592,0.0,-0.0,0.0,0.0,133882,08.01.2010 03:30:00,4474,-0.0,124.9,IS,0.09,0.0,Phase3-EA-TR1v1-EURJPY-M30-91,EURJPYMT4,528,13h 29m,Sell
53478.56,1.47604,11.01.2010 02:09:57,tp 1.47604,-0.96,-0.0,0.0,0.0,1.47494,08.01.2010 23:50:00,4475,-0.0,43.09,IS,0.41,0.0,Phase3-EA-SA2v2-EURCHF-M5-43,EURCHFMT4,2370,2d 2h 19m,Buy
53534.66,1.47763,11.01.2010 11:30:00,,0.0,-0.0,0.0,0.0,1.47595,11.01.2010 02:45:00,4476,-0.0,56.1,IS,0.34,0.0,Phase3-EA-S4v1-EURCHF-M15-221,EURCHFMT4,1108,8h 45m,Buy
53630.61,147935,12.01.2010 04:19:58,tp 147.935,-1.45,-0.0,0.0,0.0,148325,11.01.2010 23:40:00,4477,-0.0,95.95,IS,0.23,0.0,Phase3-EA-S4v1-GBPJPY-M5-194,GBPJPYMT4,1180,4h 39m,Sell
53648.36,92012,12.01.2010 04:30:00,,-1.32,-0.0,0.0,0.0,92077,11.01.2010 23:30:00,4478,-0.0,17.75,IS,0.27,0.0,Phase3-EA-S1v2-USDJPY-M15-0,USDJPYMT4,1570,5h 0m,Sell
53691.74,1.47586,12.01.2010 05:09:58,tp 1.47586,-0.97,-0.0,0.0,0.0,1.47476,11.01.2010 22:25:00,4479,-0.0,43.38,IS,0.41,0.0,Phase3-EA-SA2v2-EURCHF-M5-43,EURCHFMT4,2372,6h 44m,Buy
53817.71,132809,12.01.2010 12:29:58,tp 132.809,-0.34,-0.0,0.0,0.0,134099,11.01.2010 18:00:00,4480,-0.0,125.97,IS,0.09,0.0,Phase3-EA-TR1v1-EURJPY-M30-91,EURJPYMT4,530,18h 29m,Sell
53916.06,147194,13.01.2010 03:59:58,tp 147.194,0.0,-0.0,0.0,0.0,147584,13.01.2010 03:45:00,4481,-0.0,98.35,IS,0.23,0.0,Phase3-EA-S4v1-GBPJPY-M5-194,GBPJPYMT4,1182,14m 58s,Sell
53926.91,1.47517,13.01.2010 04:20:00,,-2.01,-0.0,0.0,0.0,1.47549,12.01.2010 20:00:00,4482,-0.0,10.85,IS,0.41,0.0,Phase3-EA-SA2v2-EURCHF-M5-43,EURCHFMT4,2374,8h 20m,Sell
54244.18,131551,13.01.2010 04:44:58,tp 131.551,-0.65,-0.0,0.0,0.0,133251,12.01.2010 10:45:00,4483,-0.0,317.27,IS,0.17,0.0,Phase3-EA-T1v2-EURJPY-M15-322,EURJPYMT4,428,17h 59m,Sell
54229.49,91039,13.01.2010 07:45:00,,-1.34,-14.690000000002328,0.0,0.0,90994,12.01.2010 23:00:00,4484,-0.010184119733636617,-14.69,IS,0.27,0.0,Phase3-EA-S1v2-USDJPY-M15-0,USDJPYMT4,1572,8h 45m,Sell
54158.18,132848,13.01.2010 14:29:58,sl 132.848,-0.35,-86.0,0.0,0.0,132128,12.01.2010 17:30:00,4485,-0.05962112301515386,-71.31,IS,0.09,0.0,Phase3-EA-TR1v1-EURJPY-M30-91,EURJPYMT4,532,20h 59m,Sell
54087.3,132294,13.01.2010 18:29:58,sl 132.294,0.0,-156.88000000000466,0.0,0.0,133014,13.01.2010 18:00:00,4486,-0.10876002068160019,-70.88,IS,0.09,0.0,Phase3-EA-TR1v1-EURJPY-M30-91,EURJPYMT4,534,29m 58s,Buy
54128.72,1.47813,14.01.2010 03:04:58,tp 1.47813,-2.9,-115.45999999999185,0.0,0.0,1.47703,13.01.2010 20:15:00,4487,-0.08004482399219977,41.42,IS,0.41,0.0,Phase3-EA-SA2v2-EURCHF-M5-43,EURCHFMT4,2376,6h 49m,Buy
54085.95,132562,14.01.2010 03:29:59,sl 132.562,0.0,-158.22999999998137,0.0,0.0,132792,14.01.2010 03:15:00,4488,-0.10969593365914751,-42.77,IS,0.17,0.0,Phase3-EA-T1v2-EURJPY-M15-322,EURJPYMT4,430,14m 59s,Buy
54184.22,149084,14.01.2010 03:34:57,tp 149.084,0.0,-59.95999999999185,0.0,0.0,148694,14.01.2010 01:15:00,4489,-0.04156840158125744,98.27,IS,0.23,0.0,Phase3-EA-S4v1-GBPJPY-M5-194,GBPJPYMT4,1184,2h 19m,Buy
54311.58,131719,14.01.2010 19:29:58,tp 131.719,0.0,-0.0,0.0,0.0,133009,14.01.2010 15:00:00,4490,-0.0,127.36,IS,0.09,0.0,Phase3-EA-TR1v1-EURJPY-M30-91,EURJPYMT4,536,4h 29m,Sell
54409.96,148571,15.01.2010 04:09:58,tp 148.571,0.0,-0.0,0.0,0.0,148961,15.01.2010 00:40:00,4491,-0.0,98.38,IS,0.23,0.0,Phase3-EA-S4v1-GBPJPY-M5-194,GBPJPYMT4,1186,3h 29m,Sell
54398.94,1.47655,15.01.2010 04:35:00,,-0.97,-11.019999999989523,0.0,0.0,1.4768,14.01.2010 20:15:00,4492,-0.007631052594979958,-11.02,IS,0.41,0.0,Phase3-EA-SA2v2-EURCHF-M5-43,EURCHFMT4,2378,8h 20m,Buy
54177.72,1.0225,15.01.2010 04:59:58,sl 1.02250,0.0,-232.2399999999907,0.0,0.0,1.0186,15.01.2010 01:30:00,4493,-0.16081993236476944,-221.22,IS,0.58,0.0,Phase3-EA-SA2v2-USDCHF-M15-107,USDCHFMT4,946,3h 29m,Sell
54200.27,91001,15.01.2010 05:00:00,,0.0,-209.69000000000233,0.0,0.0,91077,15.01.2010 00:15:00,4494,-0.14520466593855594,22.55,IS,0.27,0.0,Phase3-EA-S1v2-USDJPY-M15-0,USDJPYMT4,1574,4h 45m,Sell
54234.45,1.4761,15.01.2010 11:45:00,,0.0,-175.5100000000093,0.0,0.0,1.47713,15.01.2010 03:00:00,4495,-0.12153593837987993,34.18,IS,0.34,0.0,Phase3-EA-S4v1-EURCHF-M15-221,EURCHFMT4,1110,8h 45m,Sell
54278.42,1.47465,15.01.2010 21:14:57,tp 1.47465,0.0,-131.54000000000815,0.0,0.0,1.47575,15.01.2010 20:25:00,4496,-0.09108790003127769,43.97,IS,0.41,0.0,Phase3-EA-SA2v2-EURCHF-M5-43,EURCHFMT4,2380,49m 57s,Sell
54200.73,130153,18.01.2010 03:59:58,sl 130.153,-0.49,-209.23000000001048,0.0,0.0,130933,15.01.2010 17:00:00,4497,-0.1448861283529269,-77.69,IS,0.09,0.0,Phase3-EA-TR1v1-EURJPY-M30-91,EURJPYMT4,538,2d 10h 59m,Buy
54518.23,130094,18.01.2010 04:44:58,tp 130.094,-0.66,-0.0,0.0,0.0,131794,15.01.2010 04:45:00,4498,-0.0,317.5,IS,0.17,0.0,Phase3-EA-T1v2-EURJPY-M15-322,EURJPYMT4,432,2d 23h 59m,Sell
54460.77,1.47697,18.01.2010 07:45:00,,-2.0,-57.45999999999185,0.0,0.0,1.47558,15.01.2010 23:25:00,4499,-0.0397596898328964,-57.46,IS,0.41,0.0,Phase3-EA-SA2v2-EURCHF-M5-43,EURCHFMT4,2382,2d 8h 20m,Sell
54418.77,1.62778,18.01.2010 09:29:58,sl 1.62778,0.0,-99.45999999999185,0.0,0.0,1.63078,18.01.2010 07:00:00,4500,-0.06882176732997064,-42.0,IS,0.14,0.0,Phase3-EA-B1v1-GBPUSD-M30-14,GBPUSDMT4,296,2h 29m,Buy
54375.68,130655,18.01.2010 18:29:58,sl 130.655,0.0,-142.54999999998836,0.0,0.0,130425,18.01.2010 14:30:00,4501,-0.09863807493351415,-43.09,IS,0.17,0.0,Phase3-EA-T1v2-EURJPY-M15-322,EURJPYMT4,434,3h 59m,Sell
54406.5,90679,19.01.2010 01:30:00,,-1.34,-111.72999999998137,0.0,0.0,90787,18.01.2010 18:45:00,4502,-0.07731204568446579,30.82,IS,0.27,0.0,Phase3-EA-S1v2-USDJPY-M15-0,USDJPYMT4,1576,6h 45m,Sell
54460.17,1.02354,19.01.2010 02:14:58,tp 1.02354,-3.0,-58.05999999996857,0.0,0.0,1.02454,18.01.2010 22:30:00,4503,-0.04017486236855278,53.67,IS,0.58,0.0,Phase3-EA-SA2v2-USDCHF-M15-107,USDCHFMT4,948,3h 44m,Sell
54417.04,130674,19.01.2010 02:59:58,sl 130.674,0.0,-101.18999999997322,0.0,0.0,130444,19.01.2010 01:30:00,4504,-0.07001884814114676,-43.13,IS,0.17,0.0,Phase3-EA-T1v2-EURJPY-M15-322,EURJPYMT4,436,1h 29m,Sell
54460.13,1.47488,19.01.2010 03:04:57,tp 1.47488,-0.96,-58.09999999997672,0.0,0.0,1.47378,18.01.2010 20:50:00,4505,-0.04020254053760325,43.09,IS,0.41,0.0,Phase3-EA-SA2v2-EURCHF-M5-43,EURCHFMT4,2384,6h 14m,Buy
54420.66,1.47583,19.01.2010 11:45:00,,0.0,-97.56999999997788,0.0,0.0,1.47464,19.01.2010 03:00:00,4506,-0.06751397384259263,-39.47,IS,0.34,0.0,Phase3-EA-S4v1-EURCHF-M15-221,EURCHFMT4,1112,8h 45m,Sell
54342.87,129819,19.01.2010 15:29:58,sl 129.819,-0.49,-175.35999999998603,0.0,0.0,130599,18.01.2010 07:00:00,4507,-0.12134109309253648,-77.79,IS,0.09,0.0,Phase3-EA-TR1v1-EURJPY-M30-91,EURJPYMT4,540,1d 8h 29m,Buy
54333.12,91107,20.01.2010 02:15:00,,-0.86,-185.10999999998603,0.0,0.0,91137,19.01.2010 23:15:00,4508,-0.12808764679721443,-9.75,IS,0.27,0.0,Phase3-EA-S1v2-USDJPY-M15-0,USDJPYMT4,1578,3h 0m,Buy
54275.98,1.47396,20.01.2010 04:30:00,,-0.95,-242.25,0.0,0.0,1.47538,19.01.2010 20:10:00,4509,-0.16762591127776746,-57.14,IS,0.41,0.0,Phase3-EA-SA2v2-EURCHF-M5-43,EURCHFMT4,2386,8h 20m,Buy
54232.92,1.62754,20.01.2010 10:59:58,sl 1.62754,-1.06,-285.3099999999977,0.0,0.0,1.63054,18.01.2010 10:00:00,4510,-0.19742146025452817,-43.06,IS,0.14,0.0,Phase3-EA-B1v1-GBPUSD-M30-14,GBPUSDMT4,298,2d 0h 59m,Buy
54288.76,1.47608,20.01.2010 14:00:00,,0.0,-229.47000000000116,0.0,0.0,1.47437,20.01.2010 05:15:00,4511,-0.15878273626794426,55.84,IS,0.34,0.0,Phase3-EA-S4v1-EURCHF-M15-221,EURCHFMT4,1114,8h 45m,Buy
54413.18,128627,20.01.2010 14:29:58,tp 128.627,-0.35,-105.04999999998836,0.0,0.0,129887,19.01.2010 16:30:00,4512,-0.07268979145398358,124.42,IS,0.09,0.0,Phase3-EA-TR1v1-EURJPY-M30-91,EURJPYMT4,542,21h 59m,Sell
54429.24,91264,21.01.2010 00:15:00,,-2.58,-88.98999999999069,0.0,0.0,91201,20.01.2010 23:00:00,4513,-0.0615770065824849,16.06,IS,0.27,0.0,Phase3-EA-S1v2-USDJPY-M15-0,USDJPYMT4,1580,1h 15m,Buy
54444.04,91214,21.01.2010 02:45:00,,0.0,-74.19000000000233,0.0,0.0,91264,21.01.2010 00:15:00,4514,-0.05133608403590489,14.8,IS,0.27,0.0,Phase3-EA-S1v2-USDJPY-M15-0,USDJPYMT4,1582,2h 30m,Sell
54404.68,1.47241,21.01.2010 05:05:00,,-2.83,-113.54999999998836,0.0,0.0,1.47334,20.01.2010 20:45:00,4515,-0.0785714023760105,-39.36,IS,0.41,0.0,Phase3-EA-SA2v2-EURCHF-M5-43,EURCHFMT4,2388,8h 20m,Buy
54332.79,129289,21.01.2010 10:29:57,sl 129.289,-1.04,-185.44000000000233,0.0,0.0,128569,20.01.2010 17:00:00,4516,-0.12831599169184557,-71.89,IS,0.09,0.0,Phase3-EA-TR1v1-EURJPY-M30-91,EURJPYMT4,544,17h 29m,Sell
54370.45,1.47188,21.01.2010 12:45:00,,0.0,-147.77999999999884,0.0,0.0,1.47304,21.01.2010 04:00:00,4517,-0.10225699553613325,37.66,IS,0.34,0.0,Phase3-EA-S4v1-EURCHF-M15-221,EURCHFMT4,1116,8h 45m,Sell
54377.51,91.75,21.01.2010 17:45:00,,0.0,-140.72000000000116,0.0,0.0,91726,21.01.2010 17:15:00,4518,-0.09737179869972191,7.06,IS,0.27,0.0,Phase3-EA-S1v2-USDJPY-M15-0,USDJPYMT4,1584,30m 0s,Buy
54690.68,128326,21.01.2010 18:29:58,tp 128.326,-1.96,-0.0,0.0,0.0,130026,20.01.2010 04:15:00,4519,-0.0,313.17,IS,0.17,0.0,Phase3-EA-T1v2-EURJPY-M15-322,EURJPYMT4,438,1d 14h 14m,Sell
54755.34,90201,22.01.2010 02:15:00,,0.0,-0.0,0.0,0.0,90419,22.01.2010 01:00:00,4520,-0.0,64.66,IS,0.27,0.0,Phase3-EA-S1v2-USDJPY-M15-0,USDJPYMT4,1586,1h 15m,Buy
54550.57,145.45,22.01.2010 02:19:59,sl 145.450,0.0,-204.76999999998952,0.0,0.0,146.25,22.01.2010 01:50:00,4521,-0.1414593755228577,-204.77,IS,0.23,0.0,Phase3-EA-S4v1-GBPJPY-M5-194,GBPJPYMT4,1188,29m 59s,Buy
54650.01,146168,22.01.2010 02:54:58,tp 146.168,0.0,-105.3299999999872,0.0,0.0,145778,22.01.2010 02:25:00,4522,-0.07276415502183696,99.44,IS,0.23,0.0,Phase3-EA-S4v1-GBPJPY-M5-194,GBPJPYMT4,1190,29m 58s,Buy
54705.69,1.04164,22.01.2010 02:59:58,tp 1.04164,0.0,-49.64999999999418,0.0,0.0,1.04264,22.01.2010 00:45:00,4523,-0.03429925279440065,55.68,IS,0.58,0.0,Phase3-EA-SA2v2-USDCHF-M15-107,USDCHFMT4,950,2h 14m,Sell
54748.12,1.47072,22.01.2010 05:14:58,tp 1.47072,-0.94,-7.220000000001164,0.0,0.0,1.46962,21.01.2010 21:45:00,4524,-0.004987726186820577,42.43,IS,0.41,0.0,Phase3-EA-SA2v2-EURCHF-M5-43,EURCHFMT4,2390,7h 29m,Buy
54690.37,90226,22.01.2010 09:45:00,,0.0,-64.97000000000116,0.0,0.0,90417,22.01.2010 01:00:00,4525,-0.04488262747336377,-57.75,IS,0.27,0.0,Phase3-EA-S1v2-USDJPY-M15-0,USDJPYMT4,1587,8h 45m,Sell
54618.63,127693,22.01.2010 09:59:58,sl 127.693,0.0,-136.70999999999185,0.0,0.0,126973,22.01.2010 04:30:00,4526,-0.09444211177286573,-71.74,IS,0.09,0.0,Phase3-EA-TR1v1-EURJPY-M30-91,EURJPYMT4,546,5h 29m,Sell
54601.63,1.47049,22.01.2010 15:15:00,,0.0,-153.70999999999185,0.0,0.0,1.46997,22.01.2010 06:30:00,4527,-0.10618606539834165,-17.0,IS,0.34,0.0,Phase3-EA-S4v1-EURCHF-M15-221,EURCHFMT4,1118,8h 45m,Sell
54558.2,127361,22.01.2010 16:14:57,sl 127.361,0.0,-197.13999999998487,0.0,0.0,127131,22.01.2010 15:45:00,4528,-0.1361884128074203,-43.43,IS,0.17,0.0,Phase3-EA-T1v2-EURJPY-M15-322,EURJPYMT4,440,29m 57s,Sell
54480.44,126949,22.01.2010 18:29:57,sl 126.949,0.0,-274.8999999999942,0.0,0.0,127729,22.01.2010 10:30:00,4529,-0.1899066383319566,-77.76,IS,0.09,0.0,Phase3-EA-TR1v1-EURJPY-M30-91,EURJPYMT4,548,7h 59m,Buy
54530.84,89998,22.01.2010 21:00:00,,0.0,-224.5,0.0,0.0,90166,22.01.2010 19:30:00,4530,-0.155089269936432,50.4,IS,0.27,0.0,Phase3-EA-S1v2-USDJPY-M15-0,USDJPYMT4,1590,1h 30m,Sell
54574.16,1.47262,22.01.2010 22:44:57,tp 1.47262,0.0,-181.17999999999302,0.0,0.0,1.47372,22.01.2010 22:05:00,4531,-0.12516291281550854,43.32,IS,0.41,0.0,Phase3-EA-SA2v2-EURCHF-M5-43,EURCHFMT4,2392,39m 57s,Sell
54626.98,1.04,25.01.2010 02:29:58,tp 1.04000,-2.95,-128.35999999998603,0.0,0.0,1041,22.01.2010 22:15:00,4532,-0.08867375808034852,52.82,IS,0.58,0.0,Phase3-EA-SA2v2-USDCHF-M15-107,USDCHFMT4,952,2d 4h 14m,Sell
54670.31,1.47248,25.01.2010 03:29:58,tp 1.47248,0.0,-85.02999999999884,0.0,0.0,1.47358,25.01.2010 02:30:00,4533,-0.058740492751423755,43.33,IS,0.41,0.0,Phase3-EA-SA2v2-EURCHF-M5-43,EURCHFMT4,2394,59m 58s,Sell
54667.6,144858,25.01.2010 04:30:00,,-0.92,-87.73999999999069,0.0,0.0,144865,22.01.2010 23:05:00,4534,-0.06061261712347928,-2.71,IS,0.23,0.0,Phase3-EA-S4v1-GBPJPY-M5-194,GBPJPYMT4,1192,2d 5h 25m,Buy
54624.13,127455,25.01.2010 04:44:58,sl 127.455,0.0,-131.20999999999185,0.0,0.0,127225,25.01.2010 04:15:00,4535,-0.09064259736462352,-43.47,IS,0.17,0.0,Phase3-EA-T1v2-EURJPY-M15-322,EURJPYMT4,442,29m 58s,Sell
54580.75,127.45,25.01.2010 18:14:58,sl 127.450,0.0,-174.5899999999965,0.0,0.0,127.68,25.01.2010 13:00:00,4536,-0.12061040373363528,-43.38,IS,0.17,0.0,Phase3-EA-T1v2-EURJPY-M15-322,EURJPYMT4,444,5h 14m,Buy
54601.08,90294,26.01.2010 02:30:00,,0.0,-154.2600000000093,0.0,0.0,90226,26.01.2010 01:30:00,4537,-0.10656601683917793,20.33,IS,0.27,0.0,Phase3-EA-S1v2-USDJPY-M15-0,USDJPYMT4,1592,1h 0m,Buy
54629.35,1.47158,26.01.2010 05:05:00,,-0.95,-125.99000000001979,0.0,0.0,1.47084,25.01.2010 20:45:00,4538,-0.08703651278082021,28.27,IS,0.41,0.0,Phase3-EA-SA2v2-EURCHF-M5-43,EURCHFMT4,2396,8h 20m,Buy
54728.63,146507,26.01.2010 05:54:58,tp 146.507,0.0,-26.710000000020955,0.0,0.0,146897,26.01.2010 02:55:00,4539,-0.01845182360804164,99.28,IS,0.23,0.0,Phase3-EA-S4v1-GBPJPY-M5-194,GBPJPYMT4,1194,2h 59m,Sell
54661.81,146.07,26.01.2010 06:29:58,sl 146.070,0.0,-93.53000000002794,0.0,0.0,146.74,26.01.2010 02:30:00,4540,-0.06461246956418182,-66.82,IS,0.09,0.0,Phase3-EA-B1v1-GBPJPY-M30-1,GBPJPYMT4,538,3h 59m,Buy
54677.1,1.47127,26.01.2010 15:30:00,,0.0,-78.24000000001979,0.0,0.0,1.4708,26.01.2010 06:45:00,4541,-0.054049819509262846,15.29,IS,0.34,0.0,Phase3-EA-S4v1-EURCHF-M15-221,EURCHFMT4,1120,8h 45m,Buy
54712.39,89509,26.01.2010 18:45:00,,0.0,-42.95000000001164,0.0,0.0,89626,26.01.2010 17:15:00,4542,-0.029670753424372205,35.29,IS,0.27,0.0,Phase3-EA-S1v2-USDJPY-M15-0,USDJPYMT4,1594,1h 30m,Sell
54714.8,89499,26.01.2010 19:00:00,,0.0,-40.54000000000815,0.0,0.0,89509,26.01.2010 18:45:00,4543,-0.028005875292758206,2.41,IS,0.27,0.0,Phase3-EA-S1v2-USDJPY-M15-0,USDJPYMT4,1596,15m 0s,Buy
54771.09,89696,26.01.2010 23:00:00,,0.0,-0.0,0.0,0.0,89507,26.01.2010 18:45:00,4544,-0.0,56.29,IS,0.27,0.0,Phase3-EA-S1v2-USDJPY-M15-0,USDJPYMT4,1597,4h 15m,Sell
54812.24,1.47229,27.01.2010 00:59:57,tp 1.47229,-1.96,-0.0,0.0,0.0,1.47339,26.01.2010 22:05:00,4545,-0.0,41.15,IS,0.41,0.0,Phase3-EA-SA2v2-EURCHF-M5-43,EURCHFMT4,2398,2h 54m,Sell
54867.72,1.0455,27.01.2010 04:44:57,tp 1.04550,0.0,-0.0,0.0,0.0,1.0465,27.01.2010 01:45:00,4546,-0.0,55.48,IS,0.58,0.0,Phase3-EA-SA2v2-USDCHF-M15-107,USDCHFMT4,954,2h 59m,Sell
54788.73,125614,27.01.2010 06:59:58,sl 125.614,-0.49,-78.98999999999069,0.0,0.0,126394,26.01.2010 22:00:00,4547,-0.05452560446177427,-78.99,IS,0.09,0.0,Phase3-EA-TR1v1-EURJPY-M30-91,EURJPYMT4,550,8h 59m,Buy
55112.04,125437,27.01.2010 07:29:57,tp 125.437,-0.66,-0.0,0.0,0.0,127137,26.01.2010 06:30:00,4548,-0.0,323.31,IS,0.17,0.0,Phase3-EA-T1v2-EURJPY-M15-322,EURJPYMT4,446,1d 0h 59m,Sell
55080.7,1.4717,27.01.2010 09:45:00,,0.0,-31.339999999996508,0.0,0.0,1.4725,27.01.2010 01:25:00,4549,-0.021597105243642424,-31.34,IS,0.41,0.0,Phase3-EA-SA2v2-EURCHF-M5-43,EURCHFMT4,2400,8h 20m,Buy
55090.96,89495,27.01.2010 21:45:00,,0.0,-21.079999999987194,0.0,0.0,89461,27.01.2010 17:00:00,4550,-0.014526706398715906,10.26,IS,0.27,0.0,Phase3-EA-S1v2-USDJPY-M15-0,USDJPYMT4,1600,4h 45m,Buy
55047.49,125988,27.01.2010 23:14:58,sl 125.988,0.0,-64.54999999998836,0.0,0.0,126218,27.01.2010 22:45:00,4551,-0.04448286992587819,-43.47,IS,0.17,0.0,Phase3-EA-T1v2-EURJPY-M15-322,EURJPYMT4,448,29m 58s,Buy
55012.39,1.47299,28.01.2010 06:20:00,,-5.86,-99.64999999999418,0.0,0.0,1.47224,27.01.2010 22:00:00,4552,-0.06867107650060886,-35.1,IS,0.41,0.0,Phase3-EA-SA2v2-EURCHF-M5-43,EURCHFMT4,2402,8h 20m,Sell
55039.58,1.47245,28.01.2010 13:30:00,,0.0,-72.45999999999185,0.0,0.0,1.47329,28.01.2010 04:45:00,4553,-0.04993383043887455,27.19,IS,0.34,0.0,Phase3-EA-S4v1-EURCHF-M15-221,EURCHFMT4,1122,8h 45m,Sell
54960.08,125237,28.01.2010 19:29:58,sl 125.237,-1.47,-151.95999999999185,0.0,0.0,126017,27.01.2010 13:30:00,4554,-0.10471908464658879,-79.5,IS,0.09,0.0,Phase3-EA-TR1v1-EURJPY-M30-91,EURJPYMT4,552,1d 5h 59m,Buy
55026.47,89679,29.01.2010 02:30:00,,-1.35,-85.56999999997788,0.0,0.0,89904,28.01.2010 23:00:00,4555,-0.0589682289629295,66.39,IS,0.27,0.0,Phase3-EA-S1v2-USDJPY-M15-0,USDJPYMT4,1602,3h 30m,Sell
54834.85,1.46473,29.01.2010 04:09:58,sl 1.46473,-0.94,-277.1899999999732,0.0,0.0,1.46963,28.01.2010 20:40:00,4556,-0.1910179196708785,-191.62,IS,0.41,0.0,Phase3-EA-SA2v2-EURCHF-M5-43,EURCHFMT4,2404,7h 29m,Buy
54934.61,145247,29.01.2010 04:59:58,tp 145.247,0.0,-177.4299999999639,0.0,0.0,144857,29.01.2010 02:10:00,4557,-0.12227103967387119,99.76,IS,0.23,0.0,Phase3-EA-S4v1-GBPJPY-M5-194,GBPJPYMT4,1196,2h 49m,Buy
54862.36,126085,29.01.2010 11:59:58,sl 126.085,-0.35,-249.6799999999639,0.0,0.0,125365,28.01.2010 21:00:00,4558,-0.17206015434691965,-72.25,IS,0.09,0.0,Phase3-EA-TR1v1-EURJPY-M30-91,EURJPYMT4,554,14h 59m,Sell
54879.83,1.46747,29.01.2010 13:15:00,,0.0,-232.20999999996275,0.0,0.0,1.46693,29.01.2010 04:30:00,4559,-0.16002118087511047,17.47,IS,0.34,0.0,Phase3-EA-S4v1-EURCHF-M15-221,EURCHFMT4,1124,8h 45m,Buy
54922.59,1.46571,29.01.2010 20:24:58,tp 1.46571,0.0,-189.44999999995343,0.0,0.0,1.46461,29.01.2010 20:05:00,4560,-0.1305542944609926,42.76,IS,0.41,0.0,Phase3-EA-SA2v2-EURCHF-M5-43,EURCHFMT4,2406,19m 58s,Buy
54965.24,1.46846,29.01.2010 20:29:57,tp 1.46846,0.0,-146.79999999995925,0.0,0.0,1.46736,29.01.2010 20:25:00,4561,-0.10116321154327318,42.65,IS,0.41,0.0,Phase3-EA-SA2v2-EURCHF-M5-43,EURCHFMT4,2408,4m 57s,Buy
55064.63,144184,01.02.2010 03:34:57,tp 144.184,0.0,-47.409999999945285,0.0,0.0,143794,01.02.2010 02:15:00,4562,-0.032671306943204206,99.39,IS,0.23,0.0,Phase3-EA-S4v1-GBPJPY-M5-194,GBPJPYMT4,1198,1h 19m,Buy
55106.24,1.47214,01.02.2010 03:44:57,tp 1.47214,-0.93,-5.799999999959255,0.0,0.0,1.47104,29.01.2010 23:40:00,4563,-0.003996911627704532,41.61,IS,0.41,0.0,Phase3-EA-SA2v2-EURCHF-M5-43,EURCHFMT4,2410,2d 4h 4m,Buy
55075.16,90257,01.02.2010 10:15:00,,-0.87,-36.87999999994645,0.0,0.0,90358,29.01.2010 19:45:00,4564,-0.02541484497078701,-31.08,IS,0.27,0.0,Phase3-EA-S1v2-USDJPY-M15-0,USDJPYMT4,1604,2d 14h 30m,Buy
55339.07,1.58659,01.02.2010 13:29:58,tp 1.58659,-0.69,-0.0,0.0,0.0,1.60549,29.01.2010 17:00:00,4565,-0.0,263.91,IS,0.14,0.0,Phase3-EA-B1v1-GBPUSD-M30-14,GBPUSDMT4,300,2d 20h 29m,Sell
55380.15,90771,02.02.2010 02:30:00,,-0.86,-0.0,0.0,0.0,90.63,01.02.2010 23:00:00,4566,-0.0,41.08,IS,0.27,0.0,Phase3-EA-S1v2-USDJPY-M15-0,USDJPYMT4,1606,3h 30m,Buy
55322.41,1.05672,02.02.2010 03:15:00,,-0.66,-57.73999999999069,0.0,0.0,1.05776,01.02.2010 23:00:00,4567,-0.039716563781225046,-57.74,IS,0.58,0.0,Phase3-EA-SA2v2-USDCHF-M15-107,USDCHFMT4,956,4h 15m,Buy
55295.11,1.4711,02.02.2010 04:30:00,,-0.93,-85.03999999997905,0.0,0.0,1.47178,01.02.2010 20:10:00,4568,-0.05849491832274143,-27.3,IS,0.41,0.0,Phase3-EA-SA2v2-EURCHF-M5-43,EURCHFMT4,2412,8h 20m,Buy
55253.11,1.59257,02.02.2010 06:59:57,sl 1.59257,0.0,-127.03999999997905,0.0,0.0,1.59557,02.02.2010 03:30:00,4569,-0.08738469454047126,-42.0,IS,0.14,0.0,Phase3-EA-B1v1-GBPUSD-M30-14,GBPUSDMT4,302,3h 29m,Buy
55186.77,144485,02.02.2010 06:59:58,sl 144.485,0.0,-193.37999999997555,0.0,0.0,145155,02.02.2010 06:30:00,4570,-0.13301678392818786,-66.34,IS,0.09,0.0,Phase3-EA-B1v1-GBPJPY-M30-1,GBPJPYMT4,540,29m 58s,Buy
55143.68,126245,02.02.2010 10:14:59,sl 126.245,0.0,-236.46999999997206,0.0,0.0,126475,02.02.2010 09:15:00,4571,-0.16265631862394686,-43.09,IS,0.17,0.0,Phase3-EA-T1v2-EURJPY-M15-322,EURJPYMT4,450,59m 59s,Buy
55219.89,1.47331,02.02.2010 10:30:00,,0.0,-160.2599999999802,0.0,0.0,1.47094,02.02.2010 01:45:00,4572,-0.11023513182506696,76.21,IS,0.34,0.0,Phase3-EA-S4v1-EURCHF-M15-221,EURCHFMT4,1126,8h 45m,Buy
55176.79,126343,02.02.2010 14:29:57,sl 126.343,0.0,-203.35999999998603,0.0,0.0,126573,02.02.2010 13:30:00,4573,-0.13988154503897943,-43.1,IS,0.17,0.0,Phase3-EA-T1v2-EURJPY-M15-322,EURJPYMT4,452,59m 57s,Buy
55198.32,90.3,02.02.2010 22:45:00,,0.0,-181.8299999999872,0.0,0.0,90372,02.02.2010 22:15:00,4574,-0.12507209546832015,21.53,IS,0.27,0.0,Phase3-EA-S1v2-USDJPY-M15-0,USDJPYMT4,1608,30m 0s,Sell
55181.88,90353,02.02.2010 23:00:00,,0.0,-198.26999999998952,0.0,0.0,90298,02.02.2010 22:45:00,4575,-0.13638037930211888,-16.44,IS,0.27,0.0,Phase3-EA-S1v2-USDJPY-M15-0,USDJPYMT4,1610,15m 0s,Sell
55185.32,90.36,03.02.2010 05:30:00,,-1.34,-194.8299999999872,0.0,0.0,90376,02.02.2010 23:15:00,4576,-0.13401416905952226,3.44,IS,0.27,0.0,Phase3-EA-S1v2-USDJPY-M15-0,USDJPYMT4,1612,6h 15m,Sell
55142.06,126288,03.02.2010 06:59:59,sl 126.288,0.0,-238.0899999999965,0.0,0.0,126058,03.02.2010 05:30:00,4577,-0.1637706385637904,-43.26,IS,0.17,0.0,Phase3-EA-T1v2-EURJPY-M15-322,EURJPYMT4,454,1h 29m,Sell
55079.54,1.47504,03.02.2010 09:40:00,,0.0,-300.60999999998603,0.0,0.0,1.47343,03.02.2010 01:20:00,4578,-0.20677513401931819,-62.52,IS,0.41,0.0,Phase3-EA-SA2v2-EURCHF-M5-43,EURCHFMT4,2414,8h 20m,Sell
55206.95,126844,03.02.2010 14:59:58,tp 126.844,-0.98,-173.19999999998254,0.0,0.0,125554,01.02.2010 10:30:00,4579,-0.11913593430738818,127.41,IS,0.09,0.0,Phase3-EA-TR1v1-EURJPY-M30-91,EURJPYMT4,556,2d 4h 29m,Buy
55222.13,1.47354,03.02.2010 15:15:00,,0.0,-158.01999999998952,0.0,0.0,1.47401,03.02.2010 06:30:00,4580,-0.10869434376012778,15.18,IS,0.34,0.0,Phase3-EA-S4v1-EURCHF-M15-221,EURCHFMT4,1128,8h 45m,Sell
55176.33,126229,04.02.2010 03:29:58,sl 126.229,-2.75,-203.81999999997788,0.0,0.0,126459,03.02.2010 12:15:00,4581,-0.14019795687373945,-45.8,IS,0.17,0.0,Phase3-EA-T1v2-EURJPY-M15-322,EURJPYMT4,456,15h 14m,Buy
55115.92,144507,04.02.2010 04:30:00,,-2.73,-264.2299999999814,0.0,0.0,144735,03.02.2010 23:05:00,4582,-0.18175108500024326,-60.41,IS,0.23,0.0,Phase3-EA-S4v1-GBPJPY-M5-194,GBPJPYMT4,1200,5h 25m,Buy
55045.76,1.47058,04.02.2010 05:10:00,,-2.79,-334.38999999998487,0.0,0.0,1.47232,03.02.2010 20:50:00,4583,-0.23001076832014866,-70.16,IS,0.41,0.0,Phase3-EA-SA2v2-EURCHF-M5-43,EURCHFMT4,2416,8h 20m,Buy
55047.33,90981,04.02.2010 09:30:00,,-2.58,-332.8199999999779,0.0,0.0,90967,03.02.2010 23:00:00,4584,-0.2289308409710525,1.57,IS,0.27,0.0,Phase3-EA-S1v2-USDJPY-M15-0,USDJPYMT4,1614,10h 30m,Buy
55043.49,1.47069,04.02.2010 11:45:00,,0.0,-336.6599999999744,0.0,0.0,1.47081,04.02.2010 03:00:00,4585,-0.23157219193952827,-3.84,IS,0.34,0.0,Phase3-EA-S4v1-EURCHF-M15-221,EURCHFMT4,1130,8h 45m,Buy
55170.46,125403,04.02.2010 16:59:57,tp 125.403,-1.04,-209.68999999997322,0.0,0.0,126693,03.02.2010 20:00:00,4586,-0.14423564702607133,126.97,IS,0.09,0.0,Phase3-EA-TR1v1-EURJPY-M30-91,EURJPYMT4,558,20h 59m,Sell
55295.56,124948,04.02.2010 17:59:58,tp 124.948,0.0,-84.5899999999674,0.0,0.0,126208,04.02.2010 05:00:00,4587,-0.05818538500611489,125.1,IS,0.09,0.0,Phase3-EA-TR1v1-EURJPY-M30-91,EURJPYMT4,559,12h 59m,Sell
55479.81,141487,04.02.2010 19:29:58,tp 141.487,0.0,-0.0,0.0,0.0,143337,04.02.2010 17:30:00,4588,-0.0,184.25,IS,0.09,0.0,Phase3-EA-B1v1-GBPJPY-M30-1,GBPJPYMT4,542,1h 59m,Sell
55605.3,123215,04.02.2010 19:29:58,tp 123.215,0.0,-0.0,0.0,0.0,124475,04.02.2010 19:00:00,4589,-0.0,125.49,IS,0.09,0.0,Phase3-EA-TR1v1-EURJPY-M30-91,EURJPYMT4,562,29m 58s,Sell
55731.77,122032,04.02.2010 19:59:58,tp 122.032,0.0,-0.0,0.0,0.0,123292,04.02.2010 19:30:00,4590,-0.0,126.47,IS,0.09,0.0,Phase3-EA-TR1v1-EURJPY-M30-91,EURJPYMT4,564,29m 58s,Sell
55821.26,89304,05.02.2010 02:15:00,,0.0,-0.0,0.0,0.0,89008,05.02.2010 01:30:00,4591,-0.0,89.49,IS,0.27,0.0,Phase3-EA-S1v2-USDJPY-M15-0,USDJPYMT4,1616,45m 0s,Buy
55632.29,1.46016,05.02.2010 04:04:58,sl 1.46016,-0.92,-188.97000000000116,0.0,0.0,1.46506,04.02.2010 22:05:00,4592,-0.12959015715541136,-188.97,IS,0.41,0.0,Phase3-EA-SA2v2-EURCHF-M5-43,EURCHFMT4,2418,5h 59m,Buy
55686.75,1.06499,05.02.2010 04:14:58,tp 1.06499,0.0,-134.5100000000093,0.0,0.0,1.06599,05.02.2010 00:30:00,4593,-0.09224306524303054,54.46,IS,0.58,0.0,Phase3-EA-SA2v2-USDCHF-M15-107,USDCHFMT4,958,3h 44m,Sell
55786.96,140766,05.02.2010 04:24:57,tp 140.766,0.0,-34.30000000001746,0.0,0.0,141156,05.02.2010 03:35:00,4594,-0.02352194734843015,100.21,IS,0.23,0.0,Phase3-EA-S4v1-GBPJPY-M5-194,GBPJPYMT4,1202,49m 57s,Sell
55914.0,1.46423,05.02.2010 06:00:00,tp 1.46423,0.0,-0.0,0.0,0.0,1.46023,05.02.2010 04:45:00,4595,-0.0,127.04,IS,0.34,0.0,Phase3-EA-S4v1-EURCHF-M15-221,EURCHFMT4,1132,1h 15m,Buy
55870.28,122458,05.02.2010 11:59:58,sl 122.458,0.0,-43.720000000001164,0.0,0.0,122228,05.02.2010 11:15:00,4596,-0.02996285483229925,-43.72,IS,0.17,0.0,Phase3-EA-T1v2-EURJPY-M15-322,EURJPYMT4,458,44m 58s,Sell
55996.69,121343,05.02.2010 19:59:58,tp 121.343,-0.35,-0.0,0.0,0.0,122603,04.02.2010 20:00:00,4597,-0.0,126.41,IS,0.09,0.0,Phase3-EA-TR1v1-EURJPY-M30-91,EURJPYMT4,566,23h 59m,Sell
55928.95,139.17,05.02.2010 22:29:58,sl 139.170,0.0,-67.73999999999069,0.0,0.0,138.5,05.02.2010 22:00:00,4598,-0.046398312180906724,-67.74,IS,0.09,0.0,Phase3-EA-B1v1-GBPJPY-M30-1,GBPJPYMT4,544,29m 58s,Sell
55982.25,1.07512,08.02.2010 02:00:00,tp 1.07512,-0.65,-14.440000000002328,0.0,0.0,1.07412,05.02.2010 23:30:00,4599,-0.009890635191799427,53.3,IS,0.58,0.0,Phase3-EA-SA2v2-USDCHF-M15-107,USDCHFMT4,960,2d 2h 30m,Buy
56023.27,1.46837,08.02.2010 02:04:58,tp 1.46837,-0.92,-0.0,0.0,0.0,1.46727,05.02.2010 20:10:00,4600,-0.0,41.02,IS,0.41,0.0,Phase3-EA-SA2v2-EURCHF-M5-43,EURCHFMT4,2420,2d 5h 54m,Buy
56077.14,1.07658,08.02.2010 02:29:58,tp 1.07658,0.0,-0.0,0.0,0.0,1.07558,08.02.2010 02:15:00,4601,-0.0,53.87,IS,0.58,0.0,Phase3-EA-SA2v2-USDCHF-M15-107,USDCHFMT4,962,14m 58s,Buy
56119.04,1.46745,08.02.2010 02:44:58,tp 1.46745,0.0,-0.0,0.0,0.0,1.46855,08.02.2010 02:10:00,4602,-0.0,41.9,IS,0.41,0.0,Phase3-EA-SA2v2-EURCHF-M5-43,EURCHFMT4,2422,34m 58s,Sell
56173.0,1.07496,08.02.2010 03:59:57,tp 1.07496,0.0,-0.0,0.0,0.0,1.07596,08.02.2010 02:45:00,4603,-0.0,53.96,IS,0.58,0.0,Phase3-EA-SA2v2-USDCHF-M15-107,USDCHFMT4,964,1h 14m,Sell
56200.08,89237,08.02.2010 10:00:00,,-1.36,-0.0,0.0,0.0,89331,05.02.2010 23:15:00,4604,-0.0,27.08,IS,0.27,0.0,Phase3-EA-S1v2-USDJPY-M15-0,USDJPYMT4,1618,2d 10h 45m,Sell
56156.35,122.04,08.02.2010 10:29:58,sl 122.040,0.0,-43.73000000001048,0.0,0.0,121.81,08.02.2010 09:30:00,4605,-0.029911064344157988,-43.73,IS,0.17,0.0,Phase3-EA-T1v2-EURJPY-M15-322,EURJPYMT4,460,59m 58s,Sell
56088.92,139021,08.02.2010 14:59:58,sl 139.021,0.0,-111.16000000000349,0.0,0.0,139691,08.02.2010 11:30:00,4606,-0.07603279013253852,-67.43,IS,0.09,0.0,Phase3-EA-B1v1-GBPJPY-M30-1,GBPJPYMT4,546,3h 29m,Buy
56045.14,122071,08.02.2010 21:29:57,sl 122.071,0.0,-154.94000000000233,0.0,0.0,122301,08.02.2010 19:30:00,4607,-0.10597805418437682,-43.78,IS,0.17,0.0,Phase3-EA-T1v2-EURJPY-M15-322,EURJPYMT4,462,1h 59m,Buy
56145.57,139364,09.02.2010 03:19:58,tp 139.364,0.0,-54.51000000000931,0.0,0.0,138974,09.02.2010 01:15:00,4608,-0.03728452132174571,100.43,IS,0.23,0.0,Phase3-EA-S4v1-GBPJPY-M5-194,GBPJPYMT4,1204,2h 4m,Buy
56187.6,1.46622,09.02.2010 03:19:58,tp 1.46622,0.0,-12.480000000010477,0.0,0.0,1.46512,09.02.2010 02:45:00,4609,-0.008536247038996471,42.03,IS,0.41,0.0,Phase3-EA-SA2v2-EURCHF-M5-43,EURCHFMT4,2424,34m 58s,Buy
56084.82,1.07399,09.02.2010 03:45:00,,-2.87,-115.26000000000931,0.0,0.0,1.07214,08.02.2010 23:30:00,4610,-0.0788371661629797,-102.78,IS,0.58,0.0,Phase3-EA-SA2v2-USDCHF-M15-107,USDCHFMT4,966,4h 15m,Sell
56074.96,1.46703,09.02.2010 12:45:00,,0.0,-125.11999999999534,0.0,0.0,1.46672,09.02.2010 04:00:00,4611,-0.08558134851909471,-9.86,IS,0.34,0.0,Phase3-EA-S4v1-EURCHF-M15-221,EURCHFMT4,1134,8h 45m,Sell
55996.4,123543,09.02.2010 19:59:58,sl 123.543,0.0,-203.67999999999302,0.0,0.0,122763,09.02.2010 19:00:00,4612,-0.13931592923888475,-78.56,IS,0.09,0.0,Phase3-EA-TR1v1-EURJPY-M30-91,EURJPYMT4,568,59m 58s,Sell
56318.69,123.93,09.02.2010 20:14:59,tp 123.930,0.0,-0.0,0.0,0.0,122.23,09.02.2010 05:45:00,4613,-0.0,322.29,IS,0.17,0.0,Phase3-EA-T1v2-EURJPY-M15-322,EURJPYMT4,464,14h 29m,Buy
56275.08,123791,09.02.2010 20:44:58,sl 123.791,0.0,-43.60999999998603,0.0,0.0,124021,09.02.2010 20:15:00,4614,-0.02980480484071174,-43.61,IS,0.17,0.0,Phase3-EA-T1v2-EURJPY-M15-322,EURJPYMT4,466,29m 58s,Buy
56317.54,1.46667,09.02.2010 20:44:58,tp 1.46667,0.0,-1.1499999999941792,0.0,0.0,1.46777,09.02.2010 20:00:00,4615,-7.859556424365052E-4,42.46,IS,0.41,0.0,Phase3-EA-SA2v2-EURCHF-M5-43,EURCHFMT4,2426,44m 58s,Sell
56359.93,1.46599,09.02.2010 21:19:58,tp 1.46599,0.0,-0.0,0.0,0.0,1.46709,09.02.2010 20:45:00,4616,-0.0,42.39,IS,0.41,0.0,Phase3-EA-SA2v2-EURCHF-M5-43,EURCHFMT4,2428,34m 58s,Sell
56459.83,140661,10.02.2010 05:34:58,tp 140.661,0.0,-0.0,0.0,0.0,141051,10.02.2010 01:25:00,4617,-0.0,99.9,IS,0.23,0.0,Phase3-EA-S4v1-GBPJPY-M5-194,GBPJPYMT4,1206,4h 9m,Sell
56499.71,1.4674,10.02.2010 12:45:00,,0.0,-0.0,0.0,0.0,1.46865,10.02.2010 04:00:00,4618,-0.0,39.88,IS,0.34,0.0,Phase3-EA-S4v1-EURCHF-M15-221,EURCHFMT4,1136,8h 45m,Sell
56456.11,123.48,10.02.2010 15:59:57,sl 123.480,0.0,-43.60000000000582,0.0,0.0,123.71,10.02.2010 13:45:00,4619,-0.029761151063033356,-43.6,IS,0.17,0.0,Phase3-EA-T1v2-EURJPY-M15-322,EURJPYMT4,468,2h 14m,Buy
56412.45,123.23,10.02.2010 16:29:58,sl 123.230,0.0,-87.26000000000931,0.0,0.0,123.0,10.02.2010 16:15:00,4620,-0.059563257838537186,-43.66,IS,0.17,0.0,Phase3-EA-T1v2-EURJPY-M15-322,EURJPYMT4,470,14m 58s,Sell
56448.93,1.46602,11.02.2010 01:19:57,tp 1.46602,-5.76,-50.779999999998836,0.0,0.0,1.46712,10.02.2010 20:30:00,4621,-0.03466218465551829,36.48,IS,0.41,0.0,Phase3-EA-SA2v2-EURCHF-M5-43,EURCHFMT4,2430,4h 49m,Sell
56469.65,89907,11.02.2010 06:00:00,,0.0,-30.05999999999767,0.0,0.0,89976,11.02.2010 00:30:00,4622,-0.020518811948499863,20.72,IS,0.27,0.0,Phase3-EA-S1v2-USDJPY-M15-0,USDJPYMT4,1620,5h 30m,Sell
56313.72,1.06383,11.02.2010 06:45:00,,0.0,-185.9899999999907,0.0,0.0,1.06669,11.02.2010 02:30:00,4623,-0.1269558827112972,-155.93,IS,0.58,0.0,Phase3-EA-SA2v2-USDCHF-M15-107,USDCHFMT4,968,4h 15m,Buy
56329.91,1.46637,11.02.2010 09:45:00,,0.0,-169.79999999998836,0.0,0.0,1.46595,11.02.2010 01:25:00,4624,-0.11590466629591842,16.19,IS,0.41,0.0,Phase3-EA-SA2v2-EURCHF-M5-43,EURCHFMT4,2432,8h 20m,Buy
56257.76,123204,11.02.2010 14:29:58,sl 123.204,0.0,-241.94999999998254,0.0,0.0,123581,10.02.2010 06:00:00,4625,-0.16515391054356512,-72.15,IS,0.09,0.0,Phase3-EA-TR1v1-EURJPY-M30-91,EURJPYMT4,570,1d 8h 29m,Sell
56386.07,122291,11.02.2010 18:59:58,tp 122.291,-1.05,-113.63999999998487,0.0,0.0,123924,11.02.2010 06:00:00,4626,-0.07757011942206901,128.31,IS,0.09,0.0,Phase3-EA-TR1v1-EURJPY-M30-91,EURJPYMT4,571,12h 59m,Buy
56392.69,89679,11.02.2010 22:00:00,,0.0,-107.01999999998952,0.0,0.0,89701,11.02.2010 18:15:00,4627,-0.07305133914598837,6.62,IS,0.27,0.0,Phase3-EA-S1v2-USDJPY-M15-0,USDJPYMT4,1622,3h 45m,Sell
56395.29,1.07044,12.02.2010 03:00:00,,-0.65,-104.4199999999837,0.0,0.0,1.07038,11.02.2010 22:45:00,4628,-0.07127659160552852,2.6,IS,0.58,0.0,Phase3-EA-SA2v2-USDCHF-M15-107,USDCHFMT4,970,4h 15m,Buy
56495.23,140523,12.02.2010 03:54:57,tp 140.523,0.0,-4.4799999999813735,0.0,0.0,140913,12.02.2010 03:10:00,4629,-0.003058026531234342,99.94,IS,0.23,0.0,Phase3-EA-S4v1-GBPJPY-M5-194,GBPJPYMT4,1208,44m 57s,Sell
56466.75,1.46492,12.02.2010 04:55:00,,-0.92,-32.95999999999185,0.0,0.0,1.46564,11.02.2010 20:35:00,4630,-0.022498338051312062,-28.48,IS,0.41,0.0,Phase3-EA-SA2v2-EURCHF-M5-43,EURCHFMT4,2434,8h 20m,Buy
56423.18,122771,12.02.2010 09:44:58,sl 122.771,0.0,-76.52999999999884,0.0,0.0,122541,12.02.2010 04:30:00,4631,-0.05223901125811019,-43.57,IS,0.17,0.0,Phase3-EA-T1v2-EURJPY-M15-322,EURJPYMT4,472,5h 14m,Sell
56549.77,1.46903,12.02.2010 11:44:58,tp 1.46903,0.0,-0.0,0.0,0.0,1.46503,12.02.2010 04:00:00,4632,-0.0,126.59,IS,0.34,0.0,Phase3-EA-S4v1-EURCHF-M15-221,EURCHFMT4,1138,7h 44m,Buy
56506.29,122.26,12.02.2010 13:14:57,sl 122.260,0.0,-43.48000000001048,0.0,0.0,122.03,12.02.2010 13:00:00,4633,-0.029669101493649867,-43.48,IS,0.17,0.0,Phase3-EA-T1v2-EURJPY-M15-322,EURJPYMT4,474,14m 57s,Sell
56631.84,121785,12.02.2010 13:29:58,tp 121.785,-0.35,-0.0,0.0,0.0,123045,11.02.2010 16:30:00,4634,-0.0,125.55,IS,0.09,0.0,Phase3-EA-TR1v1-EURJPY-M30-91,EURJPYMT4,573,20h 59m,Sell
56685.73,1.07622,12.02.2010 22:44:58,tp 1.07622,0.0,-0.0,0.0,0.0,1.07722,12.02.2010 22:15:00,4635,-0.0,53.89,IS,0.58,0.0,Phase3-EA-SA2v2-USDCHF-M15-107,USDCHFMT4,972,29m 58s,Sell
56676.76,90048,15.02.2010 02:45:00,,-0.87,-8.970000000001164,0.0,0.0,90075,12.02.2010 20:15:00,4636,-0.006115114265035295,-8.97,IS,0.27,0.0,Phase3-EA-S1v2-USDJPY-M15-0,USDJPYMT4,1624,2d 6h 30m,Buy
56688.79,1.46639,15.02.2010 07:05:00,,-0.91,-0.0,0.0,0.0,1.46605,12.02.2010 22:45:00,4637,-0.0,12.03,IS,0.41,0.0,Phase3-EA-SA2v2-EURCHF-M5-43,EURCHFMT4,2436,2d 8h 20m,Buy
56703.94,1.46607,15.02.2010 11:30:00,,0.0,-0.0,0.0,0.0,1.46559,15.02.2010 02:45:00,4638,-0.0,15.15,IS,0.34,0.0,Phase3-EA-S4v1-EURCHF-M15-221,EURCHFMT4,1140,8h 45m,Buy
56704.84,89987,15.02.2010 21:15:00,,0.0,-0.0,0.0,0.0,89.99,15.02.2010 17:45:00,4639,-0.0,0.9,IS,0.27,0.0,Phase3-EA-S1v2-USDJPY-M15-0,USDJPYMT4,1626,3h 30m,Sell
56702.4,1.46521,16.02.2010 06:55:00,,-0.91,-2.4400000000023283,0.0,0.0,1.46525,15.02.2010 22:35:00,4640,-0.0016632034771329473,-2.44,IS,0.41,0.0,Phase3-EA-SA2v2-EURCHF-M5-43,EURCHFMT4,2438,8h 20m,Buy
56689.73,1.46608,16.02.2010 12:30:00,,0.0,-15.110000000015134,0.0,0.0,1.46568,16.02.2010 03:45:00,4641,-0.01029959202437706,-12.67,IS,0.34,0.0,Phase3-EA-S4v1-EURCHF-M15-221,EURCHFMT4,1142,8h 45m,Sell
56611.47,123292,16.02.2010 18:59:58,sl 123.292,-0.35,-93.37000000002445,0.0,0.0,122512,15.02.2010 10:00:00,4642,-0.06364479863106384,-78.26,IS,0.09,0.0,Phase3-EA-TR1v1-EURJPY-M30-91,EURJPYMT4,576,1d 8h 59m,Sell
56636.64,90218,17.02.2010 02:15:00,,-0.87,-68.20000000001164,0.0,0.0,90131,16.02.2010 22:00:00,4643,-0.04648790046736809,25.17,IS,0.27,0.0,Phase3-EA-S1v2-USDJPY-M15-0,USDJPYMT4,1628,4h 15m,Buy
56652.38,1.46797,17.02.2010 10:15:00,,0.0,-52.460000000020955,0.0,0.0,1.46756,17.02.2010 01:55:00,4644,-0.03575887475833853,15.74,IS,0.41,0.0,Phase3-EA-SA2v2-EURCHF-M5-43,EURCHFMT4,2440,8h 20m,Buy
56609.19,124292,17.02.2010 13:59:58,sl 124.292,0.0,-95.65000000002328,0.0,0.0,124522,17.02.2010 11:30:00,4645,-0.06519893958510382,-43.19,IS,0.17,0.0,Phase3-EA-T1v2-EURJPY-M15-322,EURJPYMT4,476,2h 29m,Buy
56727.58,91226,17.02.2010 22:14:57,tp 91.226,0.0,-0.0,0.0,0.0,90826,17.02.2010 19:15:00,4646,-0.0,118.39,IS,0.27,0.0,Phase3-EA-S1v2-USDJPY-M15-0,USDJPYMT4,1630,2h 59m,Buy
56689.68,1.46545,18.02.2010 10:45:00,,0.0,-37.89999999999418,0.0,0.0,1.46645,18.02.2010 02:25:00,4647,-0.025830181346952058,-37.9,IS,0.41,0.0,Phase3-EA-SA2v2-EURCHF-M5-43,EURCHFMT4,2442,8h 20m,Buy
56688.11,1.46557,18.02.2010 13:00:00,,0.0,-39.470000000001164,0.0,0.0,1.46562,18.02.2010 04:15:00,4648,-0.026900191497741012,-1.57,IS,0.34,0.0,Phase3-EA-S4v1-EURCHF-M15-221,EURCHFMT4,1144,8h 45m,Buy
56814.93,122999,18.02.2010 16:59:58,tp 122.999,-1.04,-0.0,0.0,0.0,124289,17.02.2010 11:00:00,4649,-0.0,126.82,IS,0.09,0.0,Phase3-EA-TR1v1-EURJPY-M30-91,EURJPYMT4,578,1d 5h 59m,Sell
56856.8,1.46689,18.02.2010 21:59:58,tp 1.46689,0.0,-0.0,0.0,0.0,1.46579,18.02.2010 20:05:00,4650,-0.0,41.87,IS,0.41,0.0,Phase3-EA-SA2v2-EURCHF-M5-43,EURCHFMT4,2444,1h 54m,Buy
56896.63,1.46569,19.02.2010 00:34:58,tp 1.46569,-1.9,-0.0,0.0,0.0,1.46679,18.02.2010 23:05:00,4651,-0.0,39.83,IS,0.41,0.0,Phase3-EA-SA2v2-EURCHF-M5-43,EURCHFMT4,2446,1h 29m,Sell
57014.49,91634,19.02.2010 00:44:58,tp 91.634,0.0,-0.0,0.0,0.0,91234,19.02.2010 00:15:00,4652,-0.0,117.86,IS,0.27,0.0,Phase3-EA-S1v2-USDJPY-M15-0,USDJPYMT4,1632,29m 58s,Buy
57022.73,91796,19.02.2010 01:00:00,,0.0,-0.0,0.0,0.0,91768,19.02.2010 00:45:00,4653,-0.0,8.24,IS,0.27,0.0,Phase3-EA-S1v2-USDJPY-M15-0,USDJPYMT4,1634,15m 0s,Buy
57064.25,1.46603,19.02.2010 04:29:59,tp 1.46603,0.0,-0.0,0.0,0.0,1.46493,19.02.2010 02:10:00,4654,-0.0,41.52,IS,0.41,0.0,Phase3-EA-SA2v2-EURCHF-M5-43,EURCHFMT4,2448,2h 19m,Buy
57038.62,1.08615,19.02.2010 06:45:00,,0.0,-25.630000000004657,0.0,0.0,1.08567,19.02.2010 02:30:00,4655,-0.01742775691577297,-25.63,IS,0.58,0.0,Phase3-EA-SA2v2-USDCHF-M15-107,USDCHFMT4,974,4h 15m,Sell
56924.25,141404,19.02.2010 08:25:00,,0.0,-140.0,0.0,0.0,141.86,19.02.2010 03:00:00,4656,-0.09519648724962046,-114.37,IS,0.23,0.0,Phase3-EA-S4v1-GBPJPY-M5-194,GBPJPYMT4,1210,5h 25m,Buy
56918.31,1.46547,19.02.2010 09:45:00,,0.0,-145.94000000000233,0.0,0.0,1.46566,19.02.2010 01:00:00,4657,-0.09923553820864166,-5.94,IS,0.34,0.0,Phase3-EA-S4v1-EURCHF-M15-221,EURCHFMT4,1146,8h 45m,Buy
56875.75,123785,19.02.2010 11:44:58,sl 123.785,0.0,-188.5,0.0,0.0,124015,19.02.2010 11:15:00,4658,-0.1281752703325247,-42.56,IS,0.17,0.0,Phase3-EA-T1v2-EURJPY-M15-322,EURJPYMT4,478,29m 58s,Buy
56916.77,1.46538,22.02.2010 02:00:00,tp 1.46538,-0.91,-147.48000000001048,0.0,0.0,1.46428,19.02.2010 20:45:00,4659,-0.10028269956839303,41.02,IS,0.41,0.0,Phase3-EA-SA2v2-EURCHF-M5-43,EURCHFMT4,2450,2d 5h 15m,Buy
57042.52,124993,22.02.2010 03:29:58,tp 124.993,-0.96,-21.730000000010477,0.0,0.0,123703,18.02.2010 18:00:00,4660,-0.014775854770966072,125.75,IS,0.09,0.0,Phase3-EA-TR1v1-EURJPY-M30-91,EURJPYMT4,580,3d 9h 29m,Buy
57061.84,141925,22.02.2010 08:45:00,,0.0,-2.4100000000034925,0.0,0.0,142002,22.02.2010 03:20:00,4661,-0.0016387395305136985,19.32,IS,0.23,0.0,Phase3-EA-S4v1-GBPJPY-M5-194,GBPJPYMT4,1212,5h 25m,Sell
57065.32,1.46496,22.02.2010 11:15:00,,0.0,-0.0,0.0,0.0,1.46507,22.02.2010 02:30:00,4662,-0.0,3.48,IS,0.34,0.0,Phase3-EA-S4v1-EURCHF-M15-221,EURCHFMT4,1148,8h 45m,Sell
57030.14,1.07506,23.02.2010 03:15:00,,-0.65,-35.179999999993015,0.0,0.0,1.0757,22.02.2010 23:00:00,4663,-0.023921343250735798,-35.18,IS,0.58,0.0,Phase3-EA-SA2v2-USDCHF-M15-107,USDCHFMT4,976,4h 15m,Buy
56977.39,1.4627,23.02.2010 04:35:00,,-0.91,-87.92999999999302,0.0,0.0,1.46406,22.02.2010 20:15:00,4664,-0.05978975872761368,-52.75,IS,0.41,0.0,Phase3-EA-SA2v2-EURCHF-M5-43,EURCHFMT4,2452,8h 20m,Buy
56934.44,124065,23.02.2010 07:59:58,sl 124.065,0.0,-130.88000000000466,0.0,0.0,123835,23.02.2010 05:15:00,4665,-0.08899446858035913,-42.95,IS,0.17,0.0,Phase3-EA-T1v2-EURJPY-M15-322,EURJPYMT4,480,2h 44m,Sell
57061.15,1.46708,23.02.2010 08:14:58,tp 1.46708,0.0,-4.170000000012806,0.0,0.0,1.46308,23.02.2010 01:00:00,4666,-0.0028354747400765896,126.71,IS,0.34,0.0,Phase3-EA-S4v1-EURCHF-M15-221,EURCHFMT4,1150,7h 14m,Buy
57018.62,1.54402,23.02.2010 12:59:59,sl 1.54402,-0.53,-46.70000000001164,0.0,0.0,1.54702,22.02.2010 03:00:00,4667,-0.031754597208921605,-42.53,IS,0.14,0.0,Phase3-EA-B1v1-GBPUSD-M30-14,GBPUSDMT4,304,1d 9h 59m,Buy
57145.82,123451,23.02.2010 14:59:58,tp 123.451,-0.35,-0.0,0.0,0.0,124741,22.02.2010 10:00:00,4668,-0.0,127.2,IS,0.09,0.0,Phase3-EA-TR1v1-EURJPY-M30-91,EURJPYMT4,582,1d 4h 59m,Sell
57465.73,122029,23.02.2010 18:44:58,tp 122.029,0.0,-0.0,0.0,0.0,123729,23.02.2010 13:30:00,4669,-0.0,319.91,IS,0.17,0.0,Phase3-EA-T1v2-EURJPY-M15-322,EURJPYMT4,482,5h 14m,Sell
57519.26,1.08358,24.02.2010 03:29:57,tp 1.08358,0.0,-0.0,0.0,0.0,1.08258,24.02.2010 02:45:00,4670,-0.0,53.53,IS,0.58,0.0,Phase3-EA-SA2v2-USDCHF-M15-107,USDCHFMT4,978,44m 57s,Buy
57500.55,1.46417,24.02.2010 04:25:00,,-0.91,-18.70999999999185,0.0,0.0,1.46464,23.02.2010 20:05:00,4671,-0.012683089652152436,-18.71,IS,0.41,0.0,Phase3-EA-SA2v2-EURCHF-M5-43,EURCHFMT4,2454,8h 20m,Buy
57511.63,90191,24.02.2010 06:00:00,,0.0,-7.630000000004657,0.0,0.0,90228,24.02.2010 00:15:00,4672,-0.005172205988563564,11.08,IS,0.27,0.0,Phase3-EA-S1v2-USDJPY-M15-0,USDJPYMT4,1636,5h 45m,Sell
57468.27,122101,24.02.2010 13:14:58,sl 122.101,0.0,-50.98999999999069,0.0,0.0,121871,24.02.2010 12:15:00,4673,-0.0345649781594557,-43.36,IS,0.17,0.0,Phase3-EA-T1v2-EURJPY-M15-322,EURJPYMT4,484,59m 58s,Sell
57422.96,122258,25.02.2010 02:59:58,sl 122.258,-1.98,-96.29999999998836,0.0,0.0,122028,24.02.2010 22:30:00,4674,-0.06527961162494195,-45.31,IS,0.17,0.0,Phase3-EA-T1v2-EURJPY-M15-322,EURJPYMT4,486,4h 29m,Sell
57522.41,138651,25.02.2010 03:59:59,tp 138.651,0.0,-0.0,0.0,0.0,139041,25.02.2010 02:35:00,4675,-0.0,99.45,IS,0.23,0.0,Phase3-EA-S4v1-GBPJPY-M5-194,GBPJPYMT4,1214,1h 24m,Sell
57647.2,121122,25.02.2010 04:59:58,tp 121.122,-1.4,-0.0,0.0,0.0,122382,23.02.2010 19:00:00,4676,-0.0,124.79,IS,0.09,0.0,Phase3-EA-TR1v1-EURJPY-M30-91,EURJPYMT4,584,1d 9h 59m,Sell
57662.23,1.46363,25.02.2010 06:40:00,,-2.73,-0.0,0.0,0.0,1.46316,24.02.2010 22:20:00,4677,-0.0,15.03,IS,0.41,0.0,Phase3-EA-SA2v2-EURCHF-M5-43,EURCHFMT4,2456,8h 20m,Buy
57673.51,1.46329,25.02.2010 12:00:00,,0.0,-0.0,0.0,0.0,1.46365,25.02.2010 03:15:00,4678,-0.0,11.28,IS,0.34,0.0,Phase3-EA-S4v1-EURCHF-M15-221,EURCHFMT4,1152,8h 45m,Sell
57997.1,120073,25.02.2010 16:44:58,tp 120.073,0.0,-0.0,0.0,0.0,121773,25.02.2010 04:00:00,4679,-0.0,323.59,IS,0.17,0.0,Phase3-EA-T1v2-EURJPY-M15-322,EURJPYMT4,488,12h 44m,Sell
58038.86,1.46309,25.02.2010 22:14:58,tp 1.46309,0.0,-0.0,0.0,0.0,1.46419,25.02.2010 21:00:00,4680,-0.0,41.76,IS,0.41,0.0,Phase3-EA-SA2v2-EURCHF-M5-43,EURCHFMT4,2458,1h 14m,Sell
58092.53,1.08063,25.02.2010 22:44:58,tp 1.08063,0.0,-0.0,0.0,0.0,1.07963,25.02.2010 22:15:00,4681,-0.0,53.67,IS,0.58,0.0,Phase3-EA-SA2v2-USDCHF-M15-107,USDCHFMT4,980,29m 58s,Buy
58146.26,1.07949,26.02.2010 03:14:58,tp 1.07949,0.0,-0.0,0.0,0.0,1.08049,26.02.2010 02:15:00,4682,-0.0,53.73,IS,0.58,0.0,Phase3-EA-SA2v2-USDCHF-M15-107,USDCHFMT4,982,59m 58s,Sell
58066.9,89308,26.02.2010 10:15:00,,-1.36,-79.35999999998603,0.0,0.0,89.05,25.02.2010 22:15:00,4683,-0.053568682732851966,-79.36,IS,0.27,0.0,Phase3-EA-S1v2-USDJPY-M15-0,USDJPYMT4,1638,12h 0m,Sell
58196.42,121555,26.02.2010 13:59:57,tp 121.555,-0.49,-0.0,0.0,0.0,120265,25.02.2010 21:00:00,4684,-0.0,129.52,IS,0.09,0.0,Phase3-EA-TR1v1-EURJPY-M30-91,EURJPYMT4,586,16h 59m,Buy
58152.64,121125,26.02.2010 15:44:58,sl 121.125,0.0,-43.779999999998836,0.0,0.0,121355,26.02.2010 12:45:00,4685,-0.029541874223411608,-43.78,IS,0.17,0.0,Phase3-EA-T1v2-EURJPY-M15-322,EURJPYMT4,490,2h 59m,Buy
58339.1,134821,26.02.2010 18:29:57,tp 134.821,-0.59,-0.0,0.0,0.0,136671,25.02.2010 12:30:00,4686,-0.0,186.46,IS,0.09,0.0,Phase3-EA-B1v1-GBPJPY-M30-1,GBPJPYMT4,548,1d 5h 59m,Sell
58295.04,121222,26.02.2010 20:14:58,sl 121.222,0.0,-44.05999999999767,0.0,0.0,121452,26.02.2010 19:45:00,4687,-0.029702216071148903,-44.06,IS,0.17,0.0,Phase3-EA-T1v2-EURJPY-M15-322,EURJPYMT4,492,29m 58s,Buy
58251.06,121161,26.02.2010 21:44:58,sl 121.161,0.0,-88.04000000000815,0.0,0.0,120931,26.02.2010 20:45:00,4688,-0.05935050165466023,-43.98,IS,0.17,0.0,Phase3-EA-T1v2-EURJPY-M15-322,EURJPYMT4,494,59m 58s,Sell
58258.8,88933,01.03.2010 02:00:00,,-1.37,-80.30000000001746,0.0,0.0,88963,26.02.2010 21:45:00,4689,-0.054132726974895636,7.74,IS,0.27,0.0,Phase3-EA-S1v2-USDJPY-M15-0,USDJPYMT4,1640,2d 4h 15m,Sell
58359.61,135124,01.03.2010 03:39:58,tp 135.124,0.0,-0.0,0.0,0.0,134734,01.03.2010 02:10:00,4690,-0.0,100.81,IS,0.23,0.0,Phase3-EA-S4v1-GBPJPY-M5-194,GBPJPYMT4,1216,1h 29m,Buy
58460.37,134909,01.03.2010 04:29:58,tp 134.909,0.0,-0.0,0.0,0.0,135299,01.03.2010 03:50:00,4691,-0.0,100.76,IS,0.23,0.0,Phase3-EA-S4v1-GBPJPY-M5-194,GBPJPYMT4,1218,39m 58s,Sell
58449.92,1.46254,01.03.2010 05:30:00,,-0.92,-10.450000000011642,0.0,0.0,1.46279,26.02.2010 21:10:00,4692,-0.007038915503182187,-10.45,IS,0.41,0.0,Phase3-EA-SA2v2-EURCHF-M5-43,EURCHFMT4,2460,2d 8h 20m,Buy
58435.02,1.46393,01.03.2010 12:15:00,,0.0,-25.35000000000582,0.0,0.0,1.46346,01.03.2010 03:30:00,4693,-0.01707526392397231,-14.9,IS,0.34,0.0,Phase3-EA-S4v1-EURCHF-M15-221,EURCHFMT4,1154,8h 45m,Sell
58356.08,121817,01.03.2010 12:29:58,sl 121.817,-0.35,-104.29000000000815,0.0,0.0,121037,26.02.2010 16:00:00,4694,-0.07024770314125453,-78.94,IS,0.09,0.0,Phase3-EA-TR1v1-EURJPY-M30-91,EURJPYMT4,588,2d 20h 29m,Sell
58312.32,121081,01.03.2010 14:44:58,sl 121.081,0.0,-148.05000000001746,0.0,0.0,121311,01.03.2010 02:15:00,4695,-0.0997235827985727,-43.76,IS,0.17,0.0,Phase3-EA-T1v2-EURJPY-M15-322,EURJPYMT4,496,12h 29m,Buy
58311.68,1.07928,02.03.2010 03:00:00,,-0.64,-148.69000000003143,0.0,0.0,1.07928,01.03.2010 22:45:00,4696,-0.1001546742743746,-0.64,IS,0.58,0.0,Phase3-EA-SA2v2-USDCHF-M15-107,USDCHFMT4,984,4h 15m,Buy
58279.31,89.24,02.03.2010 10:15:00,,0.0,-181.06000000002678,0.0,0.0,89133,02.03.2010 01:45:00,4697,-0.12195847282343879,-32.37,IS,0.27,0.0,Phase3-EA-S1v2-USDJPY-M15-0,USDJPYMT4,1642,8h 30m,Sell
58235.4,121013,02.03.2010 16:44:58,sl 121.013,0.0,-224.97000000003027,0.0,0.0,120783,02.03.2010 07:15:00,4698,-0.15153538954539192,-43.91,IS,0.17,0.0,Phase3-EA-T1v2-EURJPY-M15-322,EURJPYMT4,498,9h 29m,Sell
58193.4,1.49426,02.03.2010 18:29:58,sl 1.49426,0.0,-266.97000000003027,0.0,0.0,1.49726,02.03.2010 17:30:00,4699,-0.17982576764427444,-42.0,IS,0.14,0.0,Phase3-EA-B1v1-GBPUSD-M30-14,GBPUSDMT4,306,59m 58s,Buy
58226.44,89068,02.03.2010 18:45:00,,0.0,-233.93000000002212,0.0,0.0,89177,02.03.2010 17:00:00,4700,-0.15757067020648136,33.04,IS,0.27,0.0,Phase3-EA-S1v2-USDJPY-M15-0,USDJPYMT4,1644,1h 45m,Sell
58223.57,120818,03.03.2010 01:30:00,,0.0,-236.80000000001746,0.0,0.0,120833,03.03.2010 00:45:00,4701,-0.1595038460432352,-2.87,IS,0.17,0.0,Phase3-EA-T1v2-EURJPY-M15-322,EURJPYMT4,500,45m 0s,Buy
58270.46,88685,03.03.2010 03:15:00,,0.0,-189.9100000000035,0.0,0.0,88839,03.03.2010 01:00:00,4702,-0.1279196596371162,46.89,IS,0.27,0.0,Phase3-EA-S1v2-USDJPY-M15-0,USDJPYMT4,1646,2h 15m,Sell
58123.7,133464,03.03.2010 06:30:00,,0.0,-336.6700000000128,0.0,0.0,132898,03.03.2010 01:05:00,4703,-0.22677432367978917,-146.76,IS,0.23,0.0,Phase3-EA-S4v1-GBPJPY-M5-194,GBPJPYMT4,1220,5h 25m,Sell
58081.7,1.49888,03.03.2010 10:29:58,sl 1.49888,0.0,-378.6700000000128,0.0,0.0,1.50188,03.03.2010 03:00:00,4704,-0.2550647017786717,-42.0,IS,0.14,0.0,Phase3-EA-B1v1-GBPUSD-M30-14,GBPUSDMT4,308,7h 29m,Buy
58039.7,1.50305,03.03.2010 13:29:58,sl 1.50305,0.0,-420.6700000000128,0.0,0.0,1.50605,03.03.2010 12:30:00,4705,-0.28335507987755426,-42.0,IS,0.14,0.0,Phase3-EA-B1v1-GBPUSD-M30-14,GBPUSDMT4,310,59m 58s,Buy
57995.59,120822,03.03.2010 15:44:58,sl 120.822,0.0,-464.77999999999884,0.0,0.0,121052,03.03.2010 14:00:00,4706,-0.31306671268568076,-44.11,IS,0.17,0.0,Phase3-EA-T1v2-EURJPY-M15-322,EURJPYMT4,502,1h 44m,Buy
57982.38,133381,04.03.2010 04:30:00,,-2.81,-477.9899999999907,0.0,0.0,133421,03.03.2010 23:05:00,4707,-0.32196471017820477,-13.21,IS,0.23,0.0,Phase3-EA-S4v1-GBPJPY-M5-194,GBPJPYMT4,1222,5h 25m,Buy
57983.08,1.46269,04.03.2010 04:35:00,,-2.76,-477.28999999997905,0.0,0.0,1.4626,03.03.2010 20:15:00,4708,-0.32149320387654884,0.7,IS,0.41,0.0,Phase3-EA-SA2v2-EURCHF-M5-43,EURCHFMT4,2462,8h 20m,Buy
57992.54,88441,04.03.2010 07:15:00,,0.0,-467.8299999999872,0.0,0.0,88472,04.03.2010 00:45:00,4709,-0.3151211329999965,9.46,IS,0.27,0.0,Phase3-EA-S1v2-USDJPY-M15-0,USDJPYMT4,1648,6h 30m,Sell
58010.29,89026,05.03.2010 01:15:00,,-1.36,-450.0799999999872,0.0,0.0,89089,04.03.2010 23:00:00,4710,-0.30316508035106404,17.75,IS,0.27,0.0,Phase3-EA-S1v2-USDJPY-M15-0,USDJPYMT4,1650,2h 15m,Sell
57982.81,1.07658,05.03.2010 04:30:00,,0.0,-477.5599999999977,0.0,0.0,1.07709,05.03.2010 00:15:00,4711,-0.3216750705929114,-27.48,IS,0.58,0.0,Phase3-EA-SA2v2-USDCHF-M15-107,USDCHFMT4,986,4h 15m,Buy
57984.57,1.46279,05.03.2010 07:05:00,,-0.91,-475.79999999998836,0.0,0.0,1.46272,04.03.2010 22:45:00,4712,-0.32048956903447573,1.76,IS,0.41,0.0,Phase3-EA-SA2v2-EURCHF-M5-43,EURCHFMT4,2464,8h 20m,Buy
57904.84,121859,05.03.2010 16:59:57,sl 121.859,-1.42,-555.5299999999988,0.0,0.0,121079,03.03.2010 12:30:00,4713,-0.3741941367921948,-79.73,IS,0.09,0.0,Phase3-EA-TR1v1-EURJPY-M30-91,EURJPYMT4,590,2d 4h 29m,Sell
58224.92,122953,05.03.2010 18:29:58,tp 122.953,0.0,-235.45000000001164,0.0,0.0,121253,05.03.2010 03:15:00,4714,-0.15859451246148148,320.08,IS,0.17,0.0,Phase3-EA-T1v2-EURJPY-M15-322,EURJPYMT4,504,15h 14m,Buy
58144.01,90601,08.03.2010 02:45:00,,-1.34,-316.36000000001513,0.0,0.0,90336,05.03.2010 22:45:00,4715,-0.21309390512768825,-80.91,IS,0.27,0.0,Phase3-EA-S1v2-USDJPY-M15-0,USDJPYMT4,1652,2d 4h 0m,Buy
58220.63,90596,08.03.2010 03:00:00,,-0.87,-239.7400000000198,0.0,0.0,90334,05.03.2010 22:45:00,4716,-0.16148417251015854,76.62,IS,0.27,0.0,Phase3-EA-S1v2-USDJPY-M15-0,USDJPYMT4,1653,2d 4h 15m,Sell
58319.84,136.85,08.03.2010 03:59:58,tp 136.850,0.0,-140.53000000002794,0.0,0.0,137.24,08.03.2010 03:10:00,4717,-0.09465825795801792,99.21,IS,0.23,0.0,Phase3-EA-S4v1-GBPJPY-M5-194,GBPJPYMT4,1224,49m 58s,Sell
58320.84,1.46301,08.03.2010 06:25:00,,-0.92,-139.53000000002794,0.0,0.0,1.46296,05.03.2010 22:05:00,4718,-0.09398467752709215,1.0,IS,0.41,0.0,Phase3-EA-SA2v2-EURCHF-M5-43,EURCHFMT4,2466,2d 8h 20m,Buy
58330.68,1463,08.03.2010 13:15:00,,0.0,-129.69000000003143,0.0,0.0,1.46331,08.03.2010 04:30:00,4719,-0.08735664608678488,9.84,IS,0.34,0.0,Phase3-EA-S4v1-EURCHF-M15-221,EURCHFMT4,1156,8h 45m,Sell
58263.79,136558,08.03.2010 13:29:58,sl 136.558,0.0,-196.5800000000454,0.0,0.0,137228,08.03.2010 03:00:00,4720,-0.13241244111141937,-66.89,IS,0.09,0.0,Phase3-EA-B1v1-GBPJPY-M30-1,GBPJPYMT4,550,10h 29m,Buy
58220.5,123457,08.03.2010 18:14:57,sl 123.457,0.0,-239.87000000005355,0.0,0.0,123687,08.03.2010 17:45:00,4721,-0.16157173796620164,-43.29,IS,0.17,0.0,Phase3-EA-T1v2-EURJPY-M15-322,EURJPYMT4,506,29m 57s,Buy
58016.1,135091,09.03.2010 04:34:58,sl 135.091,0.0,-444.27000000004773,0.0,0.0,135891,09.03.2010 02:00:00,4722,-0.299251578047426,-204.4,IS,0.23,0.0,Phase3-EA-S4v1-GBPJPY-M5-194,GBPJPYMT4,1226,2h 34m,Buy
58039.77,1.46237,09.03.2010 05:25:00,,-1.91,-420.6000000000349,0.0,0.0,1.46304,08.03.2010 21:05:00,4723,-0.28330792924740433,23.67,IS,0.41,0.0,Phase3-EA-SA2v2-EURCHF-M5-43,EURCHFMT4,2468,8h 20m,Sell
57966.73,122215,09.03.2010 10:29:57,sl 122.215,-0.98,-493.6400000000431,0.0,0.0,122935,05.03.2010 18:30:00,4724,-0.3325062439222284,-73.04,IS,0.09,0.0,Phase3-EA-TR1v1-EURJPY-M30-91,EURJPYMT4,592,3d 15h 59m,Buy
57968.63,1.46263,09.03.2010 12:30:00,,0.0,-491.7400000000489,0.0,0.0,1.46257,09.03.2010 03:45:00,4725,-0.3312264411034734,1.9,IS,0.34,0.0,Phase3-EA-S4v1-EURCHF-M15-221,EURCHFMT4,1158,8h 45m,Buy
57896.54,122357,09.03.2010 21:29:58,sl 122.357,0.0,-563.8300000000454,0.0,0.0,121637,09.03.2010 17:00:00,4726,-0.3797848543689101,-72.09,IS,0.09,0.0,Phase3-EA-TR1v1-EURJPY-M30-91,EURJPYMT4,594,4h 29m,Sell
57861.25,89901,10.03.2010 01:45:00,,-1.35,-599.1200000000536,0.0,0.0,89788,09.03.2010 17:30:00,4727,-0.4035555077762862,-35.29,IS,0.27,0.0,Phase3-EA-S1v2-USDJPY-M15-0,USDJPYMT4,1656,8h 15m,Sell
57960.94,134.71,10.03.2010 04:04:58,tp 134.710,0.0,-499.4300000000512,0.0,0.0,135.1,10.03.2010 02:40:00,4728,-0.3364062746172941,99.69,IS,0.23,0.0,Phase3-EA-S4v1-GBPJPY-M5-194,GBPJPYMT4,1228,1h 24m,Sell
57947.82,1.46198,10.03.2010 06:15:00,,-0.92,-512.5500000000466,0.0,0.0,1.4623,09.03.2010 21:55:00,4729,-0.3452436498710372,-13.12,IS,0.41,0.0,Phase3-EA-SA2v2-EURCHF-M5-43,EURCHFMT4,2470,8h 20m,Buy
58211.04,1.48882,10.03.2010 11:29:57,tp 1.48882,-1.38,-249.3300000000454,0.0,0.0,1.50772,08.03.2010 18:30:00,4730,-0.16794380884275398,263.22,IS,0.14,0.0,Phase3-EA-B1v1-GBPUSD-M30-14,GBPUSDMT4,312,1d 16h 59m,Sell
58354.64,123479,11.03.2010 03:15:00,,-2.76,-105.73000000003958,0.0,0.0,122.7,10.03.2010 12:45:00,4731,-0.07121765896180882,143.6,IS,0.17,0.0,Phase3-EA-T1v2-EURJPY-M15-322,EURJPYMT4,508,14h 30m,Buy
58281.52,123182,11.03.2010 05:29:58,sl 123.182,-1.46,-178.85000000003492,0.0,0.0,123902,10.03.2010 19:30:00,4732,-0.12046986007109832,-73.12,IS,0.09,0.0,Phase3-EA-TR1v1-EURJPY-M30-91,EURJPYMT4,596,9h 59m,Buy
58268.43,1.46087,11.03.2010 06:25:00,,-2.76,-191.94000000003143,0.0,0.0,1.46114,10.03.2010 22:05:00,4733,-0.12928702791191435,-13.09,IS,0.41,0.0,Phase3-EA-SA2v2-EURCHF-M5-43,EURCHFMT4,2472,8h 20m,Buy
58266.9,135389,11.03.2010 08:20:00,,0.0,-193.47000000003027,0.0,0.0,135395,11.03.2010 02:55:00,4734,-0.13031760597123002,-1.53,IS,0.23,0.0,Phase3-EA-S4v1-GBPJPY-M5-194,GBPJPYMT4,1230,5h 25m,Buy
58268.17,1.46099,11.03.2010 10:15:00,,0.0,-192.20000000004075,0.0,0.0,1.46095,11.03.2010 01:30:00,4735,-0.12946215882396134,1.27,IS,0.34,0.0,Phase3-EA-S4v1-EURCHF-M15-221,EURCHFMT4,1160,8h 45m,Buy
58199.22,136251,11.03.2010 14:29:57,sl 136.251,-2.31,-261.1500000000524,0.0,0.0,135581,09.03.2010 03:30:00,4736,-0.17590552953630134,-68.95,IS,0.09,0.0,Phase3-EA-B1v1-GBPJPY-M30-1,GBPJPYMT4,552,2d 10h 59m,Sell
58156.03,123299,11.03.2010 17:14:58,sl 123.299,0.0,-304.3400000000547,0.0,0.0,123529,11.03.2010 12:00:00,4737,-0.2049974683479871,-43.19,IS,0.17,0.0,Phase3-EA-T1v2-EURJPY-M15-322,EURJPYMT4,510,5h 14m,Buy
58112.84,123525,11.03.2010 19:14:58,sl 123.525,0.0,-347.53000000005704,0.0,0.0,123755,11.03.2010 19:00:00,4738,-0.23408940715967289,-43.19,IS,0.17,0.0,Phase3-EA-T1v2-EURJPY-M15-322,EURJPYMT4,512,14m 58s,Buy
58211.87,136324,12.03.2010 04:19:57,tp 136.324,0.0,-248.5000000000582,0.0,0.0,136714,12.03.2010 02:20:00,4739,-0.16738473708509422,99.03,IS,0.23,0.0,Phase3-EA-S4v1-GBPJPY-M5-194,GBPJPYMT4,1232,1h 59m,Sell
58222.84,1.46203,12.03.2010 04:25:00,,-0.92,-237.53000000005704,0.0,0.0,1.46172,11.03.2010 20:05:00,4740,-0.15999555975783766,10.97,IS,0.41,0.0,Phase3-EA-SA2v2-EURCHF-M5-43,EURCHFMT4,2474,8h 20m,Buy
58180.84,1.5041,12.03.2010 10:29:58,sl 1.50410,0.0,-279.53000000005704,0.0,0.0,1.5071,12.03.2010 07:30:00,4741,-0.1882859378567202,-42.0,IS,0.14,0.0,Phase3-EA-B1v1-GBPUSD-M30-14,GBPUSDMT4,314,2h 59m,Buy
58231.33,1.46031,12.03.2010 12:15:00,,0.0,-229.04000000006636,0.0,0.0,1.46189,12.03.2010 03:30:00,4742,-0.15427686189928413,50.49,IS,0.34,0.0,Phase3-EA-S4v1-EURCHF-M15-221,EURCHFMT4,1162,8h 45m,Sell
58153.76,124708,12.03.2010 16:30:00,sl 124.708,0.0,-306.61000000007334,0.0,0.0,123928,12.03.2010 06:00:00,4743,-0.20652649592620118,-77.57,IS,0.09,0.0,Phase3-EA-TR1v1-EURJPY-M30-91,EURJPYMT4,598,10h 30m,Sell
58212.45,90.67,15.03.2010 02:30:00,,-0.87,-247.920000000071,0.0,0.0,90.47,12.03.2010 20:00:00,4744,-0.16699406043516588,58.69,IS,0.27,0.0,Phase3-EA-S1v2-USDJPY-M15-0,USDJPYMT4,1658,2d 6h 30m,Buy
58169.35,124579,15.03.2010 04:59:58,sl 124.579,0.0,-291.02000000007683,0.0,0.0,124809,15.03.2010 02:45:00,4745,-0.19602537700807068,-43.1,IS,0.17,0.0,Phase3-EA-T1v2-EURJPY-M15-322,EURJPYMT4,514,2h 14m,Buy
58151.4,1.45634,15.03.2010 06:00:00,,-0.93,-308.9700000000885,0.0,0.0,1.45678,12.03.2010 21:40:00,4746,-0.20811614574319617,-17.95,IS,0.41,0.0,Phase3-EA-SA2v2-EURCHF-M5-43,EURCHFMT4,2476,2d 8h 20m,Buy
58191.51,137334,15.03.2010 07:30:00,,0.0,-268.86000000010245,0.0,0.0,137492,15.03.2010 02:05:00,4747,-0.18109883465877277,40.11,IS,0.23,0.0,Phase3-EA-S4v1-GBPJPY-M5-194,GBPJPYMT4,1234,5h 25m,Sell
58119.62,123777,15.03.2010 18:29:58,sl 123.777,-0.49,-340.7500000001164,0.0,0.0,124497,12.03.2010 15:00:00,4748,-0.22952253183803611,-71.89,IS,0.09,0.0,Phase3-EA-TR1v1-EURJPY-M30-91,EURJPYMT4,599,3d 3h 29m,Buy
58160.54,90386,16.03.2010 01:45:00,,0.0,-299.8300000001036,0.0,0.0,90523,16.03.2010 00:15:00,4749,-0.2019596206045448,40.92,IS,0.27,0.0,Phase3-EA-S1v2-USDJPY-M15-0,USDJPYMT4,1660,1h 30m,Sell
58201.09,1.45182,16.03.2010 02:34:57,tp 1.45182,-1.93,-259.28000000011525,0.0,0.0,1.45292,15.03.2010 21:20:00,4750,-0.1746459341305125,40.55,IS,0.41,0.0,Phase3-EA-SA2v2-EURCHF-M5-43,EURCHFMT4,2478,5h 14m,Sell
58072.9,135.59,16.03.2010 07:15:00,,0.0,-387.4700000001176,0.0,0.0,136092,16.03.2010 01:50:00,4751,-0.2609922095708891,-128.19,IS,0.23,0.0,Phase3-EA-S4v1-GBPJPY-M5-194,GBPJPYMT4,1236,5h 25m,Buy
58053.02,1.45104,16.03.2010 12:15:00,,0.0,-407.35000000012224,0.0,0.0,1.45166,16.03.2010 03:30:00,4752,-0.27438298853769666,-19.88,IS,0.34,0.0,Phase3-EA-S4v1-EURCHF-M15-221,EURCHFMT4,1164,8h 45m,Buy
57986.35,136135,16.03.2010 12:29:58,sl 136.135,0.0,-474.02000000013504,0.0,0.0,135465,16.03.2010 08:30:00,4753,-0.31929059586752667,-66.67,IS,0.09,0.0,Phase3-EA-B1v1-GBPJPY-M30-1,GBPJPYMT4,554,3h 59m,Sell
58024.56,90438,16.03.2010 21:15:00,,0.0,-435.8100000001432,0.0,0.0,90.31,16.03.2010 17:00:00,4754,-0.2935530876018583,38.21,IS,0.27,0.0,Phase3-EA-S1v2-USDJPY-M15-0,USDJPYMT4,1662,4h 15m,Buy
58067.28,1.4515,16.03.2010 21:39:57,tp 1.45150,0.0,-393.090000000142,0.0,0.0,1.4526,16.03.2010 21:05:00,4755,-0.2647777315927084,42.72,IS,0.41,0.0,Phase3-EA-SA2v2-EURCHF-M5-43,EURCHFMT4,2480,34m 57s,Sell
58146.87,90243,16.03.2010 21:45:00,,0.0,-313.5000000001455,0.0,0.0,90509,16.03.2010 21:30:00,4756,-0.21116746509532838,79.59,IS,0.27,0.0,Phase3-EA-S1v2-USDJPY-M15-0,USDJPYMT4,1664,15m 0s,Sell
58141.78,90258,16.03.2010 22:00:00,,0.0,-318.590000000142,0.0,0.0,90241,16.03.2010 21:45:00,4757,-0.2145959894887382,-5.09,IS,0.27,0.0,Phase3-EA-S1v2-USDJPY-M15-0,USDJPYMT4,1666,15m 0s,Sell
58184.53,1.45252,16.03.2010 23:34:57,tp 1.45252,0.0,-275.840000000142,0.0,0.0,1.45142,16.03.2010 21:55:00,4758,-0.18580042606666133,42.75,IS,0.41,0.0,Phase3-EA-SA2v2-EURCHF-M5-43,EURCHFMT4,2482,1h 39m,Buy
58191.14,124361,17.03.2010 01:45:00,,-0.92,-269.230000000156,0.0,0.0,124321,16.03.2010 23:30:00,4759,-0.18134805941825138,6.61,IS,0.17,0.0,Phase3-EA-T1v2-EURJPY-M15-322,EURJPYMT4,516,2h 15m,Buy
58318.35,125.05,17.03.2010 10:29:57,tp 125.050,-0.98,-142.02000000016415,0.0,0.0,123.76,15.03.2010 23:30:00,4760,-0.09566189280018908,127.21,IS,0.09,0.0,Phase3-EA-TR1v1-EURJPY-M30-91,EURJPYMT4,602,1d 10h 59m,Buy
58392.92,1.45074,17.03.2010 12:45:00,,0.0,-67.45000000015716,0.0,0.0,1.45305,17.03.2010 04:00:00,4761,-0.04543300006604936,74.57,IS,0.34,0.0,Phase3-EA-S4v1-EURCHF-M15-221,EURCHFMT4,1166,8h 45m,Sell
58576.33,139293,17.03.2010 13:29:57,tp 139.293,-0.36,-0.0,0.0,0.0,137443,16.03.2010 20:30:00,4762,-0.0,183.41,IS,0.09,0.0,Phase3-EA-B1v1-GBPJPY-M30-1,GBPJPYMT4,556,16h 59m,Buy
58675.75,137995,18.03.2010 04:14:58,tp 137.995,0.0,-0.0,0.0,0.0,138385,18.03.2010 02:05:00,4763,-0.0,99.42,IS,0.23,0.0,Phase3-EA-S4v1-GBPJPY-M5-194,GBPJPYMT4,1238,2h 9m,Sell
58678.89,90274,18.03.2010 04:30:00,,-4.04,-0.0,0.0,0.0,90298,17.03.2010 23:45:00,4764,-0.0,3.14,IS,0.27,0.0,Phase3-EA-S1v2-USDJPY-M15-0,USDJPYMT4,1668,4h 45m,Sell
58681.14,1.44796,18.03.2010 04:35:00,,-2.8,-0.0,0.0,0.0,1.44783,17.03.2010 20:15:00,4765,-0.0,2.25,IS,0.41,0.0,Phase3-EA-SA2v2-EURCHF-M5-43,EURCHFMT4,2484,8h 20m,Buy
58808.68,123557,18.03.2010 08:29:58,tp 123.557,-1.05,-0.0,0.0,0.0,124847,17.03.2010 12:00:00,4766,-0.0,127.54,IS,0.09,0.0,Phase3-EA-TR1v1-EURJPY-M30-91,EURJPYMT4,604,20h 29m,Sell
58851.48,1.4374,18.03.2010 21:04:57,tp 1.43740,0.0,-0.0,0.0,0.0,1.4363,18.03.2010 21:00:00,4767,-0.0,42.8,IS,0.41,0.0,Phase3-EA-SA2v2-EURCHF-M5-43,EURCHFMT4,2486,4m 57s,Buy
58894.12,1.44042,19.03.2010 06:04:58,tp 1.44042,0.0,-0.0,0.0,0.0,1.43932,19.03.2010 01:45:00,4768,-0.0,42.64,IS,0.41,0.0,Phase3-EA-SA2v2-EURCHF-M5-43,EURCHFMT4,2488,4h 19m,Buy
58875.3,137942,19.03.2010 07:30:00,,0.0,-18.820000000006985,0.0,0.0,137868,19.03.2010 02:05:00,4769,-0.012639854414671975,-18.82,IS,0.23,0.0,Phase3-EA-S4v1-GBPJPY-M5-194,GBPJPYMT4,1240,5h 25m,Sell
58836.8,90472,19.03.2010 10:15:00,,0.0,-57.320000000006985,0.0,0.0,90343,19.03.2010 01:30:00,4770,-0.038497154891010466,-38.5,IS,0.27,0.0,Phase3-EA-S1v2-USDJPY-M15-0,USDJPYMT4,1670,8h 45m,Sell
58965.6,1.43599,19.03.2010 11:59:58,tp 1.43599,0.0,-0.0,0.0,0.0,1.43999,19.03.2010 05:15:00,4771,-0.0,128.8,IS,0.34,0.0,Phase3-EA-S4v1-EURCHF-M15-221,EURCHFMT4,1168,6h 44m,Sell
58887.62,122337,19.03.2010 17:29:58,sl 122.337,-0.49,-77.98000000001048,0.0,0.0,123117,18.03.2010 12:30:00,4772,-0.05234765610316107,-77.98,IS,0.09,0.0,Phase3-EA-TR1v1-EURJPY-M30-91,EURJPYMT4,606,1d 4h 59m,Buy
59206.33,122272,19.03.2010 19:29:58,tp 122.272,-0.66,-0.0,0.0,0.0,123972,18.03.2010 03:45:00,4773,-0.0,318.71,IS,0.17,0.0,Phase3-EA-T1v2-EURJPY-M15-322,EURJPYMT4,518,1d 15h 44m,Sell
59248.87,1.43562,19.03.2010 23:34:58,tp 1.43562,0.0,-0.0,0.0,0.0,1.43452,19.03.2010 22:05:00,4774,-0.0,42.54,IS,0.41,0.0,Phase3-EA-SA2v2-EURCHF-M5-43,EURCHFMT4,2490,1h 29m,Buy
59302.89,1.06074,22.03.2010 02:14:57,tp 1.06074,-0.66,-0.0,0.0,0.0,1.05974,19.03.2010 22:15:00,4775,-0.0,54.02,IS,0.58,0.0,Phase3-EA-SA2v2-USDCHF-M15-107,USDCHFMT4,988,2d 3h 59m,Buy
59303.34,90459,22.03.2010 05:15:00,,-1.34,-0.0,0.0,0.0,90465,19.03.2010 22:45:00,4776,-0.0,0.45,IS,0.27,0.0,Phase3-EA-S1v2-USDJPY-M15-0,USDJPYMT4,1672,2d 6h 30m,Sell
59345.77,1.43531,22.03.2010 08:59:58,tp 1.43531,0.0,-0.0,0.0,0.0,1.43421,22.03.2010 02:35:00,4777,-0.0,42.43,IS,0.41,0.0,Phase3-EA-SA2v2-EURCHF-M5-43,EURCHFMT4,2492,6h 24m,Buy
59335.51,1.43374,22.03.2010 11:30:00,,0.0,-10.260000000009313,0.0,0.0,1.43406,22.03.2010 02:45:00,4778,-0.006869963575137962,-10.26,IS,0.34,0.0,Phase3-EA-S4v1-EURCHF-M15-221,EURCHFMT4,1170,8h 45m,Buy
59257.9,121552,22.03.2010 16:29:57,sl 121.552,0.0,-87.86999999999534,0.0,0.0,122332,22.03.2010 02:00:00,4779,-0.05883661787005778,-77.61,IS,0.09,0.0,Phase3-EA-TR1v1-EURJPY-M30-91,EURJPYMT4,608,14h 29m,Buy
59204.83,1.43477,23.03.2010 05:05:00,,-1.94,-140.94000000000233,0.0,0.0,1.43345,22.03.2010 20:45:00,4780,-0.09437160490049527,-53.07,IS,0.41,0.0,Phase3-EA-SA2v2-EURCHF-M5-43,EURCHFMT4,2494,8h 20m,Sell
59219.86,136192,23.03.2010 07:40:00,,0.0,-125.91000000000349,0.0,0.0,136251,23.03.2010 02:15:00,4781,-0.08430771089131185,15.03,IS,0.23,0.0,Phase3-EA-S4v1-GBPJPY-M5-194,GBPJPYMT4,1242,5h 25m,Sell
59167.35,90.25,23.03.2010 08:45:00,,-1.35,-178.4200000000128,0.0,0.0,90079,22.03.2010 21:45:00,4782,-0.11946772914961896,-52.51,IS,0.27,0.0,Phase3-EA-S1v2-USDJPY-M15-0,USDJPYMT4,1674,11h 0m,Sell
59001.01,1.42322,24.03.2010 04:20:00,,-0.93,-344.7600000000093,0.0,0.0,1.42749,23.03.2010 20:00:00,4783,-0.23084684621466647,-166.34,IS,0.41,0.0,Phase3-EA-SA2v2-EURCHF-M5-43,EURCHFMT4,2496,8h 20m,Buy
58957.3,122185,24.03.2010 11:44:57,sl 122.185,-0.66,-388.47000000000116,0.0,0.0,121955,23.03.2010 21:00:00,4784,-0.2601144980537456,-43.71,IS,0.17,0.0,Phase3-EA-T1v2-EURJPY-M15-322,EURJPYMT4,520,14h 44m,Sell
59085.36,1.42826,24.03.2010 11:44:58,tp 1.42826,0.0,-260.4100000000035,0.0,0.0,1.42426,24.03.2010 04:45:00,4785,-0.1743671749122882,128.06,IS,0.34,0.0,Phase3-EA-S4v1-EURCHF-M15-221,EURCHFMT4,1172,6h 59m,Buy
59130.84,1.07244,25.03.2010 00:59:57,tp 1.07244,-8.6,-214.92999999999302,0.0,0.0,1.07344,24.03.2010 23:30:00,4786,-0.14391435391842242,45.48,IS,0.58,0.0,Phase3-EA-SA2v2-USDCHF-M15-107,USDCHFMT4,990,1h 29m,Sell
59147.7,1.42797,25.03.2010 05:00:00,,-5.73,-198.07000000000698,0.0,0.0,1.42856,24.03.2010 20:40:00,4787,-0.1326251155288878,16.86,IS,0.41,0.0,Phase3-EA-SA2v2-EURCHF-M5-43,EURCHFMT4,2498,8h 20m,Sell
59109.25,1.0711,25.03.2010 06:45:00,,0.0,-236.52000000001863,0.0,0.0,1.07181,25.03.2010 02:30:00,4788,-0.15837073925831227,-38.45,IS,0.58,0.0,Phase3-EA-SA2v2-USDCHF-M15-107,USDCHFMT4,992,4h 15m,Buy
59070.52,92029,25.03.2010 08:15:00,,0.0,-275.2500000000291,0.0,0.0,92161,25.03.2010 01:15:00,4789,-0.1843038473738019,-38.73,IS,0.27,0.0,Phase3-EA-S1v2-USDJPY-M15-0,USDJPYMT4,1676,7h 0m,Buy
59195.34,123069,25.03.2010 14:29:58,tp 123.069,-1.43,-150.43000000002212,0.0,0.0,121779,24.03.2010 12:00:00,4790,-0.10072598641395883,124.82,IS,0.09,0.0,Phase3-EA-TR1v1-EURJPY-M30-91,EURJPYMT4,610,1d 2h 29m,Buy
59177.85,1.42742,25.03.2010 14:45:00,,0.0,-167.9200000000128,0.0,0.0,1.42797,25.03.2010 06:00:00,4791,-0.11243706467214498,-17.49,IS,0.34,0.0,Phase3-EA-S4v1-EURCHF-M15-221,EURCHFMT4,1174,8h 45m,Buy
59219.83,1.4279,25.03.2010 20:44:58,tp 1.42790,0.0,-125.94000000000233,0.0,0.0,1429,25.03.2010 20:20:00,4792,-0.08432779850410387,41.98,IS,0.41,0.0,Phase3-EA-SA2v2-EURCHF-M5-43,EURCHFMT4,2500,24m 58s,Sell
59149.9,122995,25.03.2010 23:59:58,sl 122.995,0.0,-195.86999999999534,0.0,0.0,123715,25.03.2010 20:00:00,4793,-0.13115202392407596,-69.93,IS,0.09,0.0,Phase3-EA-TR1v1-EURJPY-M30-91,EURJPYMT4,612,3h 59m,Buy
59191.06,1.42734,26.03.2010 04:24:58,tp 1.42734,-0.92,-154.70999999999185,0.0,0.0,1.42624,25.03.2010 21:55:00,4794,-0.10359181917237557,41.16,IS,0.41,0.0,Phase3-EA-SA2v2-EURCHF-M5-43,EURCHFMT4,2502,6h 29m,Buy
59173.61,92645,26.03.2010 07:45:00,,-0.84,-172.1600000000035,0.0,0.0,92702,25.03.2010 23:30:00,4795,-0.11527611394685204,-17.45,IS,0.27,0.0,Phase3-EA-S1v2-USDJPY-M15-0,USDJPYMT4,1678,8h 15m,Buy
59049.61,1.43104,26.03.2010 13:14:57,sl 1.43104,0.0,-296.1600000000035,0.0,0.0,1.42714,26.03.2010 04:45:00,4796,-0.1983049134903544,-124.0,IS,0.34,0.0,Phase3-EA-S4v1-EURCHF-M15-221,EURCHFMT4,1176,8h 29m,Sell
59091.95,1.42842,26.03.2010 23:24:58,tp 1.42842,0.0,-253.82000000000698,0.0,0.0,1.42952,26.03.2010 21:55:00,4797,-0.16995459596880924,42.34,IS,0.41,0.0,Phase3-EA-SA2v2-EURCHF-M5-43,EURCHFMT4,2504,1h 29m,Sell
59117.22,92444,29.03.2010 02:15:00,,-1.31,-228.55000000001746,0.0,0.0,92535,26.03.2010 22:30:00,4798,-0.1530341301263622,25.27,IS,0.27,0.0,Phase3-EA-S1v2-USDJPY-M15-0,USDJPYMT4,1680,2d 3h 45m,Sell
58992.98,1.43391,29.03.2010 06:29:58,sl 1.43391,0.0,-352.79000000000815,0.0,0.0,1.43001,29.03.2010 03:00:00,4799,-0.23622363057220055,-124.24,IS,0.34,0.0,Phase3-EA-S4v1-EURCHF-M15-221,EURCHFMT4,1178,3h 29m,Sell
58804.92,1.43495,29.03.2010 06:44:58,sl 1.43495,0.0,-540.8500000000058,0.0,0.0,1.43005,29.03.2010 02:50:00,4800,-0.3621461792992236,-188.06,IS,0.41,0.0,Phase3-EA-SA2v2-EURCHF-M5-43,EURCHFMT4,2506,3h 54m,Sell
58926.82,124.78,29.03.2010 11:29:58,tp 124.780,-0.48,-418.95000000001164,0.0,0.0,123.52,26.03.2010 09:00:00,4801,-0.28052351265121994,121.9,IS,0.09,0.0,Phase3-EA-TR1v1-EURJPY-M30-91,EURJPYMT4,614,3d 2h 29m,Buy
58884.59,124497,29.03.2010 20:44:58,sl 124.497,0.0,-461.1800000000221,0.0,0.0,124727,29.03.2010 19:30:00,4802,-0.30880017559253425,-42.23,IS,0.17,0.0,Phase3-EA-T1v2-EURJPY-M15-322,EURJPYMT4,522,1h 14m,Buy
58927.02,1.43141,29.03.2010 22:54:59,tp 1.43141,0.0,-418.7500000000291,0.0,0.0,1.43251,29.03.2010 20:35:00,4803,-0.2803895952326131,42.43,IS,0.41,0.0,Phase3-EA-SA2v2-EURCHF-M5-43,EURCHFMT4,2508,2h 19m,Sell
58865.76,1.06237,30.03.2010 02:45:00,,-0.66,-480.0100000000384,0.0,0.0,1.06348,29.03.2010 22:30:00,4804,-0.32140850055548187,-61.26,IS,0.58,0.0,Phase3-EA-SA2v2-USDCHF-M15-107,USDCHFMT4,994,4h 15m,Buy
58823.45,124.41,30.03.2010 04:14:57,sl 124.410,0.0,-522.3200000000361,0.0,0.0,124.64,30.03.2010 00:30:00,4805,-0.34973873046423504,-42.31,IS,0.17,0.0,Phase3-EA-T1v2-EURJPY-M15-322,EURJPYMT4,524,3h 44m,Buy
58842.2,1.43266,30.03.2010 07:20:00,,-0.93,-503.5700000000361,0.0,0.0,1.43215,29.03.2010 23:00:00,4806,-0.33718397246874576,18.75,IS,0.41,0.0,Phase3-EA-SA2v2-EURCHF-M5-43,EURCHFMT4,2510,8h 20m,Buy
58765.95,125434,30.03.2010 10:59:58,sl 125.434,-0.34,-579.8200000000361,0.0,0.0,124654,29.03.2010 13:30:00,4807,-0.38823998831706874,-76.25,IS,0.09,0.0,Phase3-EA-TR1v1-EURJPY-M30-91,EURJPYMT4,616,21h 29m,Sell
58828.71,1.43053,30.03.2010 12:45:00,,0.0,-517.0600000000268,0.0,0.0,1.43249,30.03.2010 04:00:00,4808,-0.34621670235456087,62.76,IS,0.34,0.0,Phase3-EA-S4v1-EURCHF-M15-221,EURCHFMT4,1180,8h 45m,Sell
58809.53,92756,31.03.2010 02:00:00,,-0.84,-536.2400000000198,0.0,0.0,92819,30.03.2010 23:00:00,4809,-0.3590593828000753,-19.18,IS,0.27,0.0,Phase3-EA-S1v2-USDJPY-M15-0,USDJPYMT4,1682,3h 0m,Buy
58767.47,124601,31.03.2010 03:29:58,sl 124.601,0.0,-578.3000000000175,0.0,0.0,124831,31.03.2010 02:45:00,4810,-0.3872222159355553,-42.06,IS,0.17,0.0,Phase3-EA-T1v2-EURJPY-M15-322,EURJPYMT4,526,44m 58s,Buy
58821.85,1.06653,31.03.2010 03:44:57,tp 1.06653,0.0,-523.9200000000128,0.0,0.0,1.06553,31.03.2010 02:45:00,4811,-0.3508100698131678,54.38,IS,0.58,0.0,Phase3-EA-SA2v2-USDCHF-M15-107,USDCHFMT4,996,59m 57s,Buy
59000.45,141726,31.03.2010 17:59:57,tp 141.726,-0.35,-345.320000000007,0.0,0.0,139876,30.03.2010 17:00:00,4812,-0.23122181498679686,178.6,IS,0.09,0.0,Phase3-EA-B1v1-GBPJPY-M30-1,GBPJPYMT4,558,1d 0h 59m,Buy
59026.39,1.05321,01.04.2010 02:15:00,,-8.75,-319.38000000000466,0.0,0.0,1.05384,31.03.2010 22:00:00,4813,-0.21385272579196907,25.94,IS,0.58,0.0,Phase3-EA-SA2v2-USDCHF-M15-107,USDCHFMT4,998,4h 15m,Sell
59063.42,1.42289,01.04.2010 04:14:58,tp 1.42289,-5.84,-282.3500000000058,0.0,0.0,1.42399,31.03.2010 22:50:00,4814,-0.18905791573474492,37.03,IS,0.41,0.0,Phase3-EA-SA2v2-EURCHF-M5-43,EURCHFMT4,2512,5h 24m,Sell
59159.49,141.77,01.04.2010 05:24:59,tp 141.770,0.0,-186.27999999999884,0.0,0.0,142.16,01.04.2010 02:20:00,4815,-0.1247306837013187,96.07,IS,0.23,0.0,Phase3-EA-S4v1-GBPJPY-M5-194,GBPJPYMT4,1244,3h 4m,Sell
59084.67,127076,01.04.2010 17:59:58,sl 127.076,0.0,-261.1000000000058,0.0,0.0,126296,01.04.2010 00:30:00,4816,-0.17482919000652375,-74.82,IS,0.09,0.0,Phase3-EA-TR1v1-EURJPY-M30-91,EURJPYMT4,618,17h 29m,Sell
59121.76,93903,01.04.2010 20:45:00,,0.0,-224.0100000000093,0.0,0.0,93774,01.04.2010 20:00:00,4817,-0.1499942047237156,37.09,IS,0.27,0.0,Phase3-EA-S1v2-USDJPY-M15-0,USDJPYMT4,1684,45m 0s,Buy
59124.67,93844,02.04.2010 01:45:00,,-0.83,-221.10000000000582,0.0,0.0,93831,01.04.2010 21:45:00,4818,-0.14804570628281333,2.91,IS,0.27,0.0,Phase3-EA-S1v2-USDJPY-M15-0,USDJPYMT4,1686,4h 0m,Buy
59126.76,1.05424,02.04.2010 03:00:00,,-0.66,-219.0100000000093,0.0,0.0,1.05419,01.04.2010 22:45:00,4819,-0.14664626925825178,2.09,IS,0.58,0.0,Phase3-EA-SA2v2-USDCHF-M15-107,USDCHFMT4,1000,4h 15m,Buy
59146.37,143282,02.04.2010 08:40:00,,0.0,-199.40000000002328,0.0,0.0,143202,02.04.2010 03:15:00,4820,-0.13351566636271212,19.61,IS,0.23,0.0,Phase3-EA-S4v1-GBPJPY-M5-194,GBPJPYMT4,1246,5h 25m,Buy
59104.72,127267,02.04.2010 10:29:57,sl 127.267,0.0,-241.05000000001746,0.0,0.0,127497,02.04.2010 09:45:00,4821,-0.1614039687900217,-41.65,IS,0.17,0.0,Phase3-EA-T1v2-EURJPY-M15-322,EURJPYMT4,528,44m 57s,Buy
59109.22,1.4324,02.04.2010 11:30:00,,0.0,-236.55000000001746,0.0,0.0,1.43254,02.04.2010 02:45:00,4822,-0.15839082687110428,4.5,IS,0.34,0.0,Phase3-EA-S4v1-EURCHF-M15-221,EURCHFMT4,1182,8h 45m,Sell
59067.5,127077,02.04.2010 15:44:57,sl 127.077,0.0,-278.2700000000186,0.0,0.0,127307,02.04.2010 13:45:00,4823,-0.18632600039493502,-41.72,IS,0.17,0.0,Phase3-EA-T1v2-EURJPY-M15-322,EURJPYMT4,530,1h 59m,Buy
59024.97,1.5216,02.04.2010 16:29:58,sl 1.52160,-0.53,-320.80000000001746,0.0,0.0,1.5246,01.04.2010 16:00:00,4824,-0.21480353946416939,-42.53,IS,0.14,0.0,Phase3-EA-B1v1-GBPUSD-M30-14,GBPUSDMT4,316,1d 0h 29m,Buy
59200.29,144437,05.04.2010 01:00:00,tp 144.437,-0.69,-145.48000000001048,0.0,0.0,142587,01.04.2010 10:30:00,4825,-0.09741153030314187,175.32,IS,0.09,0.0,Phase3-EA-B1v1-GBPJPY-M30-1,GBPJPYMT4,560,3d 14h 30m,Buy
59212.88,94567,05.04.2010 01:15:00,,-0.83,-132.89000000001397,0.0,0.0,94.52,02.04.2010 21:45:00,4826,-0.08898142880110635,12.59,IS,0.27,0.0,Phase3-EA-S1v2-USDJPY-M15-0,USDJPYMT4,1688,2d 3h 30m,Buy
59194.19,1.0614,05.04.2010 03:15:00,,-0.66,-151.5800000000163,0.0,0.0,1.06173,02.04.2010 23:00:00,4827,-0.1014960115710116,-18.69,IS,0.58,0.0,Phase3-EA-SA2v2-USDCHF-M15-107,USDCHFMT4,1002,2d 4h 15m,Buy
59209.91,1.43335,05.04.2010 04:40:00,,-0.93,-135.86000000001513,0.0,0.0,1.43292,02.04.2010 20:20:00,4828,-0.09097010246759263,15.72,IS,0.41,0.0,Phase3-EA-SA2v2-EURCHF-M5-43,EURCHFMT4,2514,2d 8h 20m,Buy
59131.73,144178,05.04.2010 05:00:00,,-1.41,-214.04000000000815,0.0,0.0,143863,02.04.2010 23:35:00,4829,-0.14331842140558,-78.18,IS,0.23,0.0,Phase3-EA-S4v1-GBPJPY-M5-194,GBPJPYMT4,1248,2d 5h 25m,Sell
59089.73,1.52394,05.04.2010 09:29:57,sl 1.52394,0.0,-256.04000000000815,0.0,0.0,1.52694,05.04.2010 01:30:00,4830,-0.17144107931547595,-42.0,IS,0.14,0.0,Phase3-EA-B1v1-GBPUSD-M30-14,GBPUSDMT4,318,7h 59m,Buy
59048.31,127536,05.04.2010 18:14:59,sl 127.536,0.0,-297.46000000002095,0.0,0.0,127766,05.04.2010 17:00:00,4831,-0.19917537671138666,-41.42,IS,0.17,0.0,Phase3-EA-T1v2-EURJPY-M15-322,EURJPYMT4,532,1h 14m,Buy
59142.05,143937,06.04.2010 03:04:57,tp 143.937,-1.41,-203.72000000003027,0.0,0.0,144327,05.04.2010 23:55:00,4832,-0.1364082826048775,93.74,IS,0.23,0.0,Phase3-EA-S4v1-GBPJPY-M5-194,GBPJPYMT4,1250,3h 9m,Sell
59071.91,126676,06.04.2010 03:59:58,sl 126.676,-1.41,-273.86000000004424,0.0,0.0,127396,01.04.2010 20:30:00,4833,-0.1833731213144131,-70.14,IS,0.09,0.0,Phase3-EA-TR1v1-EURJPY-M30-91,EURJPYMT4,620,4d 7h 29m,Buy
59072.52,1.43219,06.04.2010 07:05:00,,-0.93,-273.2500000000582,0.0,0.0,1.43215,05.04.2010 22:45:00,4834,-0.18296467318763587,0.61,IS,0.41,0.0,Phase3-EA-SA2v2-EURCHF-M5-43,EURCHFMT4,2516,8h 20m,Buy
58876.77,143057,06.04.2010 07:14:58,sl 143.057,0.0,-469.0000000000582,0.0,0.0,143857,06.04.2010 03:35:00,4835,-0.3140363466605438,-195.75,IS,0.23,0.0,Phase3-EA-S4v1-GBPJPY-M5-194,GBPJPYMT4,1252,3h 39m,Buy
58889.83,1.43199,06.04.2010 11:00:00,,0.0,-455.94000000006054,0.0,0.0,1.4324,06.04.2010 02:15:00,4836,-0.30529153922475394,13.06,IS,0.34,0.0,Phase3-EA-S4v1-EURCHF-M15-221,EURCHFMT4,1184,8h 45m,Sell
59196.61,125448,06.04.2010 15:59:58,tp 125.448,-0.63,-149.1600000000617,0.0,0.0,127148,05.04.2010 19:00:00,4837,-0.09987561080575752,306.78,IS,0.17,0.0,Phase3-EA-T1v2-EURJPY-M15-322,EURJPYMT4,534,20h 59m,Sell
59154.89,125635,07.04.2010 04:29:58,sl 125.635,0.0,-190.88000000006286,0.0,0.0,125405,07.04.2010 02:45:00,4838,-0.12781078432958828,-41.72,IS,0.17,0.0,Phase3-EA-T1v2-EURJPY-M15-322,EURJPYMT4,536,1h 44m,Sell
59250.43,143136,07.04.2010 04:34:58,tp 143.136,0.0,-95.34000000005472,0.0,0.0,142746,07.04.2010 03:05:00,4839,-0.06383843345550046,95.54,IS,0.23,0.0,Phase3-EA-S4v1-GBPJPY-M5-194,GBPJPYMT4,1254,1h 29m,Buy
59251.96,1.43207,07.04.2010 07:00:00,,-1.92,-93.81000000005588,0.0,0.0,1.43216,06.04.2010 22:40:00,4840,-0.06281396520306931,1.53,IS,0.41,0.0,Phase3-EA-SA2v2-EURCHF-M5-43,EURCHFMT4,2518,8h 20m,Sell
59210.36,125598,07.04.2010 13:29:58,sl 125.598,0.0,-135.4100000000617,0.0,0.0,125828,07.04.2010 12:30:00,4841,-0.09066878827573206,-41.6,IS,0.17,0.0,Phase3-EA-T1v2-EURJPY-M15-322,EURJPYMT4,538,59m 58s,Buy
59135.0,124769,07.04.2010 15:29:58,sl 124.769,-0.47,-210.77000000004773,0.0,0.0,125549,06.04.2010 20:00:00,4842,-0.14112887161119317,-75.36,IS,0.09,0.0,Phase3-EA-TR1v1-EURJPY-M30-91,EURJPYMT4,622,19h 29m,Buy
59091.4,1.52302,08.04.2010 00:29:58,sl 1.52302,-1.6,-254.37000000005355,0.0,0.0,1.52602,07.04.2010 20:30:00,4843,-0.17032286887004144,-43.6,IS,0.14,0.0,Phase3-EA-B1v1-GBPUSD-M30-14,GBPUSDMT4,320,3h 59m,Buy
59136.88,93199,08.04.2010 03:00:00,,0.0,-208.89000000004307,0.0,0.0,93356,08.04.2010 01:45:00,4844,-0.13987004787617566,45.48,IS,0.27,0.0,Phase3-EA-S1v2-USDJPY-M15-0,USDJPYMT4,1690,1h 15m,Sell
59176.05,1.4339,08.04.2010 04:24:58,tp 1.43390,-2.75,-169.72000000003027,0.0,0.0,1.4328,07.04.2010 23:25:00,4845,-0.11364232143972364,39.17,IS,0.41,0.0,Phase3-EA-SA2v2-EURCHF-M5-43,EURCHFMT4,2520,4h 59m,Buy
59484.07,123.93,08.04.2010 10:29:58,tp 123.930,-1.91,-0.0,0.0,0.0,125.63,07.04.2010 13:30:00,4846,-0.0,308.02,IS,0.17,0.0,Phase3-EA-T1v2-EURJPY-M15-322,EURJPYMT4,540,20h 59m,Sell
59514.1,1.43236,08.04.2010 13:45:00,,0.0,-0.0,0.0,0.0,1.43331,08.04.2010 05:00:00,4847,-0.0,30.03,IS,0.34,0.0,Phase3-EA-S4v1-EURCHF-M15-221,EURCHFMT4,1186,8h 45m,Sell
59449.46,142187,08.04.2010 17:59:58,sl 142.187,0.0,-64.64000000001397,0.0,0.0,141517,08.04.2010 09:30:00,4848,-0.04323338066444169,-64.64,IS,0.09,0.0,Phase3-EA-B1v1-GBPJPY-M30-1,GBPJPYMT4,562,8h 29m,Sell
59473.16,93428,09.04.2010 01:45:00,,0.0,-40.94000000000233,0.0,0.0,93346,09.04.2010 01:15:00,4849,-0.027382032865129347,23.7,IS,0.27,0.0,Phase3-EA-S1v2-USDJPY-M15-0,USDJPYMT4,1692,30m 0s,Buy
59596.94,124997,09.04.2010 02:59:57,tp 124.997,-0.47,-0.0,0.0,0.0,123707,08.04.2010 14:00:00,4850,-0.0,123.78,IS,0.09,0.0,Phase3-EA-TR1v1-EURJPY-M30-91,EURJPYMT4,624,12h 59m,Buy
59611.53,1.07318,09.04.2010 04:30:00,,0.0,-0.0,0.0,0.0,1.07291,09.04.2010 00:15:00,4851,-0.0,14.59,IS,0.58,0.0,Phase3-EA-SA2v2-USDCHF-M15-107,USDCHFMT4,1004,4h 15m,Buy
59602.36,1.43353,09.04.2010 05:10:00,,-1.91,-9.170000000012806,0.0,0.0,1.43334,08.04.2010 20:50:00,4852,-0.006129206752990771,-9.17,IS,0.41,0.0,Phase3-EA-SA2v2-EURCHF-M5-43,EURCHFMT4,2522,8h 20m,Sell
59615.63,142904,09.04.2010 08:05:00,,0.0,-0.0,0.0,0.0,142958,09.04.2010 02:40:00,4853,-0.0,13.27,IS,0.23,0.0,Phase3-EA-S4v1-GBPJPY-M5-194,GBPJPYMT4,1256,5h 25m,Sell
59736.88,126189,12.04.2010 01:00:00,tp 126.189,-0.47,-0.0,0.0,0.0,124929,09.04.2010 03:30:00,4854,-0.0,121.25,IS,0.09,0.0,Phase3-EA-TR1v1-EURJPY-M30-91,EURJPYMT4,626,2d 21h 30m,Buy
59523.24,1.06203,12.04.2010 01:15:00,sl 1.06203,-0.65,-213.64000000001397,0.0,0.0,1.06593,09.04.2010 23:15:00,4855,-0.14267694104486095,-213.64,IS,0.58,0.0,Phase3-EA-SA2v2-USDCHF-M15-107,USDCHFMT4,1006,2d 2h 0m,Buy
59537.16,93129,12.04.2010 01:30:00,,0.0,-199.72000000000116,0.0,0.0,93177,12.04.2010 01:15:00,4856,-0.13338063408293357,13.92,IS,0.27,0.0,Phase3-EA-S1v2-USDJPY-M15-0,USDJPYMT4,1694,15m 0s,Sell
59591.91,1.05935,12.04.2010 01:44:58,tp 1.05935,0.0,-144.97000000000116,0.0,0.0,1.05835,12.04.2010 01:30:00,4857,-0.09681649570900723,54.75,IS,0.58,0.0,Phase3-EA-SA2v2-USDCHF-M15-107,USDCHFMT4,1008,14m 58s,Buy
59400.43,1.44293,12.04.2010 01:54:58,sl 1.44293,-1.92,-336.45000000001164,0.0,0.0,1.43803,09.04.2010 23:15:00,4858,-0.22469414348690314,-191.48,IS,0.41,0.0,Phase3-EA-SA2v2-EURCHF-M5-43,EURCHFMT4,2524,2d 2h 39m,Sell
59455.27,1.05758,12.04.2010 02:59:58,tp 1.05758,0.0,-281.61000000001513,0.0,0.0,1.05658,12.04.2010 02:30:00,4859,-0.18806989968003568,54.84,IS,0.58,0.0,Phase3-EA-SA2v2-USDCHF-M15-107,USDCHFMT4,1010,29m 58s,Buy
59719.34,1.5467,12.04.2010 07:29:58,tp 1.54670,-0.53,-17.54000000000815,0.0,0.0,1.5278,09.04.2010 07:00:00,4860,-0.011713881042538194,264.07,IS,0.14,0.0,Phase3-EA-B1v1-GBPUSD-M30-14,GBPUSDMT4,322,3d 0h 29m,Buy
59761.88,1.43942,12.04.2010 21:14:58,tp 1.43942,0.0,-0.0,0.0,0.0,1.44052,12.04.2010 20:00:00,4861,-0.0,42.54,IS,0.41,0.0,Phase3-EA-SA2v2-EURCHF-M5-43,EURCHFMT4,2526,1h 14m,Sell
59816.6,1.05991,12.04.2010 22:29:58,tp 1.05991,0.0,-0.0,0.0,0.0,1.05891,12.04.2010 22:00:00,4862,-0.0,54.72,IS,0.58,0.0,Phase3-EA-SA2v2-USDCHF-M15-107,USDCHFMT4,1012,29m 58s,Buy
59817.76,93233,12.04.2010 23:45:00,,0.0,-0.0,0.0,0.0,93237,12.04.2010 22:15:00,4863,-0.0,1.16,IS,0.27,0.0,Phase3-EA-S1v2-USDJPY-M15-0,USDJPYMT4,1696,1h 30m,Sell
59859.39,1.44025,13.04.2010 01:59:57,tp 1.44025,-0.93,-0.0,0.0,0.0,1.43915,12.04.2010 21:30:00,4864,-0.0,41.63,IS,0.41,0.0,Phase3-EA-SA2v2-EURCHF-M5-43,EURCHFMT4,2528,4h 29m,Buy
59901.95,1.43946,13.04.2010 03:04:57,tp 1.43946,0.0,-0.0,0.0,0.0,1.44056,13.04.2010 02:30:00,4865,-0.0,42.56,IS,0.41,0.0,Phase3-EA-SA2v2-EURCHF-M5-43,EURCHFMT4,2530,34m 57s,Sell
59836.27,142265,13.04.2010 06:29:58,sl 142.265,-0.7,-65.67999999999302,0.0,0.0,142935,09.04.2010 02:30:00,4866,-0.04381530727251585,-65.68,IS,0.09,0.0,Phase3-EA-B1v1-GBPJPY-M30-1,GBPJPYMT4,564,4d 3h 59m,Buy
59961.21,125838,13.04.2010 06:59:58,tp 125.838,-0.34,-0.0,0.0,0.0,127128,12.04.2010 11:00:00,4867,-0.0,124.94,IS,0.09,0.0,Phase3-EA-TR1v1-EURJPY-M30-91,EURJPYMT4,628,19h 59m,Sell
59984.5,142705,13.04.2010 09:00:00,,0.0,-0.0,0.0,0.0,142611,13.04.2010 03:35:00,4868,-0.0,23.29,IS,0.23,0.0,Phase3-EA-S4v1-GBPJPY-M5-194,GBPJPYMT4,1258,5h 25m,Buy
59923.48,1.43678,13.04.2010 13:00:00,,0.0,-61.01999999998952,0.0,0.0,1.43868,13.04.2010 04:15:00,4869,-0.040684204034409935,-61.02,IS,0.34,0.0,Phase3-EA-S4v1-EURCHF-M15-221,EURCHFMT4,1188,8h 45m,Buy
59881.4,126346,13.04.2010 17:59:58,sl 126.346,0.0,-103.09999999997672,0.0,0.0,126116,13.04.2010 16:45:00,4870,-0.06874043651175742,-42.08,IS,0.17,0.0,Phase3-EA-T1v2-EURJPY-M15-322,EURJPYMT4,542,1h 14m,Sell
59924.18,1.43442,13.04.2010 23:34:58,tp 1.43442,0.0,-60.31999999997788,0.0,0.0,1.43332,13.04.2010 22:00:00,4871,-0.040217489140529805,42.78,IS,0.41,0.0,Phase3-EA-SA2v2-EURCHF-M5-43,EURCHFMT4,2532,1h 34m,Buy
59942.45,93233,14.04.2010 00:15:00,,-0.84,-42.04999999998836,0.0,0.0,93167,13.04.2010 23:00:00,4872,-0.02803623041046801,18.27,IS,0.27,0.0,Phase3-EA-S1v2-USDJPY-M15-0,USDJPYMT4,1698,1h 15m,Buy
59994.6,1.05328,14.04.2010 03:14:58,tp 1.05328,-2.92,-0.0,0.0,0.0,1.05428,13.04.2010 23:15:00,4873,-0.0,52.15,IS,0.58,0.0,Phase3-EA-SA2v2-USDCHF-M15-107,USDCHFMT4,1014,3h 59m,Sell
59949.77,1.43544,14.04.2010 08:35:00,,0.0,-44.829999999987194,0.0,0.0,1.43429,14.04.2010 00:15:00,4874,-0.029887742625392663,-44.83,IS,0.41,0.0,Phase3-EA-SA2v2-EURCHF-M5-43,EURCHFMT4,2534,8h 20m,Sell
60073.76,127546,14.04.2010 09:29:58,tp 127.546,-0.47,-0.0,0.0,0.0,126256,13.04.2010 10:00:00,4875,-0.0,123.99,IS,0.09,0.0,Phase3-EA-TR1v1-EURJPY-M30-91,EURJPYMT4,630,23h 29m,Buy
60046.97,1.43571,14.04.2010 10:00:00,,0.0,-26.79000000000815,0.0,0.0,1.43488,14.04.2010 01:15:00,4876,-0.01785122195912741,-26.79,IS,0.34,0.0,Phase3-EA-S4v1-EURCHF-M15-221,EURCHFMT4,1190,8h 45m,Sell
60201.26,127343,14.04.2010 16:30:00,,-0.89,-0.0,0.0,0.0,126.49,13.04.2010 19:15:00,4877,-0.0,154.29,IS,0.17,0.0,Phase3-EA-T1v2-EURJPY-M15-322,EURJPYMT4,544,21h 15m,Buy
60148.14,1.43476,15.04.2010 06:10:00,,-2.81,-53.11999999999534,0.0,0.0,1.43605,14.04.2010 21:50:00,4878,-0.03536588175092232,-53.12,IS,0.41,0.0,Phase3-EA-SA2v2-EURCHF-M5-43,EURCHFMT4,2536,8h 20m,Buy
60035.61,144823,15.04.2010 07:20:00,,0.0,-165.64999999999418,0.0,0.0,144366,15.04.2010 01:55:00,4879,-0.11028535978992074,-112.53,IS,0.23,0.0,Phase3-EA-S4v1-GBPJPY-M5-194,GBPJPYMT4,1260,5h 25m,Sell
59977.9,93346,15.04.2010 08:30:00,,-3.91,-223.35999999998603,0.0,0.0,93.16,14.04.2010 22:30:00,4880,-0.14870714133821927,-57.71,IS,0.27,0.0,Phase3-EA-S1v2-USDJPY-M15-0,USDJPYMT4,1700,10h 0m,Sell
59952.07,127204,15.04.2010 09:30:00,,-2.68,-249.18999999997322,0.0,0.0,127331,14.04.2010 23:45:00,4881,-0.16590406764894874,-25.83,IS,0.17,0.0,Phase3-EA-T1v2-EURJPY-M15-322,EURJPYMT4,546,9h 45m,Buy
59881.09,126562,15.04.2010 10:59:58,sl 126.562,-1.42,-320.1699999999837,0.0,0.0,127282,14.04.2010 06:30:00,4882,-0.21316066190122768,-70.98,IS,0.09,0.0,Phase3-EA-TR1v1-EURJPY-M30-91,EURJPYMT4,631,1d 4h 29m,Buy
59889.76,1.05643,16.04.2010 02:30:00,,-0.66,-311.4999999999709,0.0,0.0,1.05626,15.04.2010 22:15:00,4883,-0.20738840672839304,8.67,IS,0.58,0.0,Phase3-EA-SA2v2-USDCHF-M15-107,USDCHFMT4,1016,4h 15m,Buy
59691.71,143161,16.04.2010 03:59:58,sl 143.161,0.0,-509.54999999995925,0.0,0.0,143961,16.04.2010 00:55:00,4884,-0.3392448239115701,-198.05,IS,0.23,0.0,Phase3-EA-S4v1-GBPJPY-M5-194,GBPJPYMT4,1262,3h 4m,Buy
59684.58,1.43355,16.04.2010 05:25:00,,-0.93,-516.6799999999639,0.0,0.0,1.43371,15.04.2010 21:05:00,4885,-0.34399178808484315,-7.13,IS,0.41,0.0,Phase3-EA-SA2v2-EURCHF-M5-43,EURCHFMT4,2538,8h 20m,Buy
59806.69,124772,16.04.2010 17:59:58,tp 124.772,-0.34,-394.5699999999779,0.0,0.0,126032,15.04.2010 13:00:00,4886,-0.26269420110056213,122.11,IS,0.09,0.0,Phase3-EA-TR1v1-EURJPY-M30-91,EURJPYMT4,634,1d 4h 59m,Sell
59853.82,91944,19.04.2010 01:45:00,,-1.32,-347.4399999999732,0.0,0.0,92109,16.04.2010 23:30:00,4887,-0.2313163018738814,47.13,IS,0.27,0.0,Phase3-EA-S1v2-USDJPY-M15-0,USDJPYMT4,1702,2d 2h 15m,Sell
59895.31,1.43368,19.04.2010 03:29:58,tp 1.43368,-0.93,-305.94999999998254,0.0,0.0,1.43258,16.04.2010 20:35:00,4888,-0.20369336448974049,41.49,IS,0.41,0.0,Phase3-EA-SA2v2-EURCHF-M5-43,EURCHFMT4,2540,2d 6h 54m,Buy
59718.2,140204,19.04.2010 06:40:00,,0.0,-483.05999999996857,0.0,0.0,140912,19.04.2010 01:15:00,4889,-0.3216084871724571,-177.11,IS,0.23,0.0,Phase3-EA-S4v1-GBPJPY-M5-194,GBPJPYMT4,1264,5h 25m,Buy
60032.42,123642,19.04.2010 09:44:59,tp 123.642,-0.65,-168.8399999999674,0.0,0.0,125342,16.04.2010 15:00:00,4890,-0.11240917686041217,314.22,IS,0.17,0.0,Phase3-EA-T1v2-EURJPY-M15-322,EURJPYMT4,548,2d 18h 44m,Sell
59967.05,141391,19.04.2010 21:29:58,sl 141.391,0.0,-234.20999999996275,0.0,0.0,140721,19.04.2010 04:00:00,4891,-0.1559307824714406,-65.37,IS,0.09,0.0,Phase3-EA-B1v1-GBPJPY-M30-1,GBPJPYMT4,566,17h 29m,Sell
59896.29,124935,20.04.2010 03:29:58,sl 124.935,-0.68,-304.96999999997206,0.0,0.0,124215,16.04.2010 21:00:00,4892,-0.20304090658092502,-70.76,IS,0.09,0.0,Phase3-EA-TR1v1-EURJPY-M30-91,EURJPYMT4,636,3d 6h 29m,Sell
59899.37,1.4335,20.04.2010 06:25:00,,-1.93,-301.88999999998487,0.0,0.0,1.43363,19.04.2010 22:05:00,4893,-0.20099032458182114,3.08,IS,0.41,0.0,Phase3-EA-SA2v2-EURCHF-M5-43,EURCHFMT4,2542,8h 20m,Sell
59892.33,1.4332,20.04.2010 15:30:00,,0.0,-308.929999999993,0.0,0.0,1.43342,20.04.2010 06:45:00,4894,-0.20567736915122634,-7.04,IS,0.34,0.0,Phase3-EA-S4v1-EURCHF-M15-221,EURCHFMT4,1192,8h 45m,Buy
59937.22,125221,20.04.2010 22:15:00,,0.0,-264.03999999997905,0.0,0.0,124975,20.04.2010 10:45:00,4895,-0.17579080228753025,44.89,IS,0.17,0.0,Phase3-EA-T1v2-EURJPY-M15-322,EURJPYMT4,550,11h 30m,Buy
59977.49,1.4347,21.04.2010 03:04:57,tp 1.43470,-1.92,-223.76999999998952,0.0,0.0,1.4358,20.04.2010 22:05:00,4896,-0.14898010842251902,40.27,IS,0.41,0.0,Phase3-EA-SA2v2-EURCHF-M5-43,EURCHFMT4,2544,4h 59m,Sell
59991.06,1.06883,21.04.2010 06:45:00,,0.0,-210.19999999998254,0.0,0.0,1.06908,21.04.2010 02:30:00,4897,-0.13994556370564581,13.57,IS,0.58,0.0,Phase3-EA-SA2v2-USDCHF-M15-107,USDCHFMT4,1018,4h 15m,Sell
60047.59,143.24,21.04.2010 07:40:00,,0.0,-153.6699999999837,0.0,0.0,143011,21.04.2010 02:15:00,4898,-0.10230939474141816,56.53,IS,0.23,0.0,Phase3-EA-S4v1-GBPJPY-M5-194,GBPJPYMT4,1266,5h 25m,Buy
60056.89,93218,21.04.2010 09:00:00,,-0.84,-144.36999999999534,0.0,0.0,93183,20.04.2010 22:00:00,4899,-0.09611770234150863,9.3,IS,0.27,0.0,Phase3-EA-S1v2-USDJPY-M15-0,USDJPYMT4,1704,11h 0m,Buy
60235.18,143784,21.04.2010 09:29:58,tp 143.784,-0.35,-0.0,0.0,0.0,141934,20.04.2010 03:30:00,4900,-0.0,178.29,IS,0.09,0.0,Phase3-EA-B1v1-GBPJPY-M30-1,GBPJPYMT4,568,1d 5h 59m,Buy
60184.48,1.4332,21.04.2010 12:45:00,,0.0,-50.70000000001164,0.0,0.0,1.43479,21.04.2010 04:00:00,4901,-0.03374708906396736,-50.7,IS,0.34,0.0,Phase3-EA-S4v1-EURCHF-M15-221,EURCHFMT4,1194,8h 45m,Buy
60142.49,124733,21.04.2010 15:14:58,sl 124.733,0.0,-92.69000000000233,0.0,0.0,124503,21.04.2010 14:15:00,4902,-0.061696601288727705,-41.99,IS,0.17,0.0,Phase3-EA-T1v2-EURJPY-M15-322,EURJPYMT4,552,59m 58s,Sell
60070.8,124186,22.04.2010 04:29:58,sl 124.186,-1.89,-164.38000000000466,0.0,0.0,124906,20.04.2010 03:30:00,4903,-0.10941511834977984,-71.69,IS,0.09,0.0,Phase3-EA-TR1v1-EURJPY-M30-91,EURJPYMT4,638,2d 0h 59m,Buy
60100.28,1.43256,22.04.2010 04:30:00,,-5.75,-134.89999999999418,0.0,0.0,1.43348,21.04.2010 20:10:00,4904,-0.08979255058635019,29.48,IS,0.41,0.0,Phase3-EA-SA2v2-EURCHF-M5-43,EURCHFMT4,2546,8h 20m,Sell
60173.34,143404,22.04.2010 08:45:00,,0.0,-61.83999999999651,0.0,0.0,143109,22.04.2010 03:20:00,4905,-0.04116212993520995,73.06,IS,0.23,0.0,Phase3-EA-S4v1-GBPJPY-M5-194,GBPJPYMT4,1268,5h 25m,Buy
60172.39,1.4325,22.04.2010 13:45:00,,0.0,-62.79000000000815,0.0,0.0,1.43253,22.04.2010 05:00:00,4906,-0.0417944718407554,-0.95,IS,0.34,0.0,Phase3-EA-S4v1-EURCHF-M15-221,EURCHFMT4,1196,8h 45m,Buy
60096.98,123895,22.04.2010 14:29:58,sl 123.895,0.0,-138.20000000001164,0.0,0.0,124675,22.04.2010 09:30:00,4907,-0.09198910667928227,-75.41,IS,0.09,0.0,Phase3-EA-TR1v1-EURJPY-M30-91,EURJPYMT4,640,4h 59m,Buy
60136.89,1.43258,23.04.2010 01:29:58,tp 1.43258,-1.9,-98.29000000000815,0.0,0.0,1.43368,22.04.2010 20:20:00,4908,-0.06542409041611173,39.91,IS,0.41,0.0,Phase3-EA-SA2v2-EURCHF-M5-43,EURCHFMT4,2548,5h 9m,Sell
59924.93,1.08171,23.04.2010 02:14:58,sl 1.08171,-2.85,-310.25,0.0,0.0,1.07781,22.04.2010 23:30:00,4909,-0.20650955388744513,-211.96,IS,0.58,0.0,Phase3-EA-SA2v2-USDCHF-M15-107,USDCHFMT4,1020,2h 44m,Sell
59991.85,93602,23.04.2010 02:15:00,,0.0,-243.3299999999872,0.0,0.0,93.37,23.04.2010 01:45:00,4910,-0.16196605881524379,66.92,IS,0.27,0.0,Phase3-EA-S1v2-USDJPY-M15-0,USDJPYMT4,1706,30m 0s,Buy
60045.44,1.08234,23.04.2010 03:29:58,tp 1.08234,0.0,-189.7399999999907,0.0,0.0,1.08334,23.04.2010 02:15:00,4911,-0.12629531911233494,53.59,IS,0.58,0.0,Phase3-EA-SA2v2-USDCHF-M15-107,USDCHFMT4,1022,1h 14m,Sell
59969.77,123414,23.04.2010 04:59:58,sl 123.414,-0.47,-265.4100000000035,0.0,0.0,124194,22.04.2010 20:30:00,4912,-0.17666301594606781,-75.67,IS,0.09,0.0,Phase3-EA-TR1v1-EURJPY-M30-91,EURJPYMT4,642,8h 29m,Buy
59965.98,1.43253,23.04.2010 10:05:00,,0.0,-269.20000000001164,0.0,0.0,1.43263,23.04.2010 01:45:00,4913,-0.17918572733763943,-3.79,IS,0.41,0.0,Phase3-EA-SA2v2-EURCHF-M5-43,EURCHFMT4,2550,8h 20m,Buy
60089.59,125236,23.04.2010 16:59:58,tp 125.236,0.0,-145.5900000000256,0.0,0.0,123946,23.04.2010 11:30:00,4914,-0.09690806108131644,123.61,IS,0.09,0.0,Phase3-EA-TR1v1-EURJPY-M30-91,EURJPYMT4,644,5h 29m,Buy
60119.74,94028,23.04.2010 21:15:00,,0.0,-115.44000000003143,0.0,0.0,94133,23.04.2010 20:45:00,4915,-0.07683952586872896,30.15,IS,0.27,0.0,Phase3-EA-S1v2-USDJPY-M15-0,USDJPYMT4,1708,30m 0s,Sell
60214.33,144753,26.04.2010 01:00:00,tp 144.753,-0.88,-20.850000000034925,0.0,0.0,144363,23.04.2010 23:45:00,4916,-0.013878240768929713,94.59,IS,0.23,0.0,Phase3-EA-S4v1-GBPJPY-M5-194,GBPJPYMT4,1270,2d 1h 15m,Buy
60254.46,1.43451,26.04.2010 01:00:00,tp 1.43451,-1.91,-0.0,0.0,0.0,1.43561,23.04.2010 20:05:00,4917,-0.0,40.13,IS,0.41,0.0,Phase3-EA-SA2v2-EURCHF-M5-43,EURCHFMT4,2552,2d 4h 55m,Sell
60308.48,1.07377,26.04.2010 02:59:58,tp 1.07377,0.0,-0.0,0.0,0.0,1.07277,26.04.2010 02:30:00,4918,-0.0,54.02,IS,0.58,0.0,Phase3-EA-SA2v2-USDCHF-M15-107,USDCHFMT4,1024,29m 58s,Buy
60341.49,94146,26.04.2010 03:00:00,,-0.83,-0.0,0.0,0.0,94028,23.04.2010 21:15:00,4919,-0.0,33.01,IS,0.27,0.0,Phase3-EA-S1v2-USDJPY-M15-0,USDJPYMT4,1710,2d 5h 45m,Buy
60383.52,1.4351,26.04.2010 03:24:58,tp 1.43510,0.0,-0.0,0.0,0.0,1434,26.04.2010 02:05:00,4920,-0.0,42.03,IS,0.41,0.0,Phase3-EA-SA2v2-EURCHF-M5-43,EURCHFMT4,2554,1h 19m,Buy
60188.4,145635,26.04.2010 04:54:58,sl 145.635,0.0,-195.11999999999534,0.0,0.0,144835,26.04.2010 01:15:00,4921,-0.1297482596497246,-195.12,IS,0.23,0.0,Phase3-EA-S4v1-GBPJPY-M5-194,GBPJPYMT4,1272,3h 39m,Sell
60308.31,126261,26.04.2010 04:59:58,tp 126.261,-0.47,-75.20999999999185,0.0,0.0,125001,23.04.2010 16:30:00,4922,-0.05001212898859657,119.91,IS,0.09,0.0,Phase3-EA-TR1v1-EURJPY-M30-91,EURJPYMT4,645,2d 12h 29m,Buy
60320.96,1.4346,26.04.2010 11:15:00,,0.0,-62.55999999999767,0.0,0.0,1.4342,26.04.2010 02:30:00,4923,-0.041600303011924265,12.65,IS,0.34,0.0,Phase3-EA-S4v1-EURCHF-M15-221,EURCHFMT4,1198,8h 45m,Buy
60303.0,1.07244,27.04.2010 04:00:00,,-0.65,-80.51999999998952,0.0,0.0,1.07276,26.04.2010 23:45:00,4924,-0.053543100999357905,-17.96,IS,0.58,0.0,Phase3-EA-SA2v2-USDCHF-M15-107,USDCHFMT4,1026,4h 15m,Buy
60294.59,1.43537,27.04.2010 04:50:00,,-1.91,-88.92999999999302,0.0,0.0,1.4352,26.04.2010 20:30:00,4925,-0.059135469099269054,-8.41,IS,0.41,0.0,Phase3-EA-SA2v2-EURCHF-M5-43,EURCHFMT4,2556,8h 20m,Sell
60418.16,124592,27.04.2010 13:59:57,tp 124.592,-0.34,-0.0,0.0,0.0,125882,26.04.2010 08:00:00,4926,-0.0,123.57,IS,0.09,0.0,Phase3-EA-TR1v1-EURJPY-M30-91,EURJPYMT4,648,1d 5h 59m,Sell
60471.46,1.08814,28.04.2010 01:14:58,tp 1.08814,0.0,-0.0,0.0,0.0,1.08914,28.04.2010 00:45:00,4927,-0.0,53.3,IS,0.58,0.0,Phase3-EA-SA2v2-USDCHF-M15-107,USDCHFMT4,1028,29m 58s,Sell
60567.72,142171,28.04.2010 02:44:58,tp 142.171,0.0,-0.0,0.0,0.0,141781,28.04.2010 00:40:00,4928,-0.0,96.26,IS,0.23,0.0,Phase3-EA-S4v1-GBPJPY-M5-194,GBPJPYMT4,1274,2h 4m,Buy
60589.34,93082,28.04.2010 03:15:00,,-1.3,-0.0,0.0,0.0,93161,27.04.2010 23:15:00,4929,-0.0,21.62,IS,0.27,0.0,Phase3-EA-S1v2-USDJPY-M15-0,USDJPYMT4,1712,4h 0m,Sell
60577.48,1.43307,28.04.2010 07:05:00,,-0.9,-11.85999999998603,0.0,0.0,1.43336,27.04.2010 22:45:00,4930,-0.007875723474175556,-11.86,IS,0.41,0.0,Phase3-EA-SA2v2-EURCHF-M5-43,EURCHFMT4,2558,8h 20m,Buy
60569.65,1.43246,28.04.2010 10:15:00,,0.0,-19.689999999973224,0.0,0.0,1.43271,28.04.2010 01:30:00,4931,-0.013075294705437477,-7.83,IS,0.34,0.0,Phase3-EA-S4v1-EURCHF-M15-221,EURCHFMT4,1200,8h 45m,Buy
60693.43,124154,28.04.2010 15:29:58,tp 124.154,0.0,-0.0,0.0,0.0,122864,28.04.2010 05:00:00,4932,-0.0,123.78,IS,0.09,0.0,Phase3-EA-TR1v1-EURJPY-M30-91,EURJPYMT4,650,10h 29m,Buy
60741.03,94168,28.04.2010 21:00:00,,0.0,-0.0,0.0,0.0,94002,28.04.2010 18:45:00,4933,-0.0,47.6,IS,0.27,0.0,Phase3-EA-S1v2-USDJPY-M15-0,USDJPYMT4,1714,2h 15m,Buy
60699.51,123686,28.04.2010 21:14:58,sl 123.686,0.0,-41.51999999998952,0.0,0.0,123916,28.04.2010 21:00:00,4934,-0.02754392748940985,-41.52,IS,0.17,0.0,Phase3-EA-T1v2-EURJPY-M15-322,EURJPYMT4,554,14m 58s,Buy
60778.59,94228,28.04.2010 21:30:00,,0.0,-0.0,0.0,0.0,93952,28.04.2010 21:15:00,4935,-0.0,79.08,IS,0.27,0.0,Phase3-EA-S1v2-USDJPY-M15-0,USDJPYMT4,1716,15m 0s,Buy
60817.44,1.43362,29.04.2010 00:24:57,tp 1.43362,-2.72,-0.0,0.0,0.0,1.43252,28.04.2010 20:30:00,4936,-0.0,38.85,IS,0.41,0.0,Phase3-EA-SA2v2-EURCHF-M5-43,EURCHFMT4,2560,3h 54m,Buy
60740.5,142374,29.04.2010 07:15:00,,0.0,-76.94000000000233,0.0,0.0,142688,29.04.2010 01:50:00,4937,-0.05101532024413249,-76.94,IS,0.23,0.0,Phase3-EA-S4v1-GBPJPY-M5-194,GBPJPYMT4,1276,5h 25m,Buy
60705.71,1.43442,29.04.2010 08:45:00,,0.0,-111.73000000001048,0.0,0.0,1.4335,29.04.2010 00:25:00,4938,-0.0740829442536689,-34.79,IS,0.41,0.0,Phase3-EA-SA2v2-EURCHF-M5-43,EURCHFMT4,2562,8h 20m,Sell
60744.22,124514,29.04.2010 22:15:00,,0.0,-73.22000000000116,0.0,0.0,124301,29.04.2010 08:30:00,4939,-0.048548761999939266,38.51,IS,0.17,0.0,Phase3-EA-T1v2-EURJPY-M15-322,EURJPYMT4,556,13h 45m,Buy
60785.84,1.43349,29.04.2010 23:39:58,tp 1.43349,0.0,-31.60000000000582,0.0,0.0,1.43459,29.04.2010 21:00:00,4940,-0.020952484009810694,41.62,IS,0.41,0.0,Phase3-EA-SA2v2-EURCHF-M5-43,EURCHFMT4,2564,2h 39m,Sell
60836.59,1.08221,30.04.2010 01:44:57,tp 1.08221,-2.84,-0.0,0.0,0.0,1.08321,29.04.2010 22:45:00,4941,-0.0,50.75,IS,0.58,0.0,Phase3-EA-SA2v2-USDCHF-M15-107,USDCHFMT4,1030,2h 59m,Sell
60795.0,124465,30.04.2010 03:29:58,sl 124.465,0.0,-41.58999999999651,0.0,0.0,124695,30.04.2010 02:00:00,4942,-0.02757288533239616,-41.59,IS,0.17,0.0,Phase3-EA-T1v2-EURJPY-M15-322,EURJPYMT4,558,1h 29m,Buy
60802.09,144259,30.04.2010 06:10:00,,0.0,-34.5,0.0,0.0,144288,30.04.2010 00:45:00,4943,-0.022872434334401236,7.09,IS,0.23,0.0,Phase3-EA-S4v1-GBPJPY-M5-194,GBPJPYMT4,1278,5h 25m,Sell
60790.7,124567,30.04.2010 09:00:00,,0.0,-45.89000000001397,0.0,0.0,124.63,30.04.2010 07:45:00,4944,-0.030423652510318616,-11.39,IS,0.17,0.0,Phase3-EA-T1v2-EURJPY-M15-322,EURJPYMT4,560,1h 15m,Buy
60774.78,1.43471,30.04.2010 09:30:00,,0.0,-61.810000000026776,0.0,0.0,1.43429,30.04.2010 01:10:00,4945,-0.040978120759708775,-15.92,IS,0.41,0.0,Phase3-EA-SA2v2-EURCHF-M5-43,EURCHFMT4,2566,8h 20m,Sell
60699.79,125.18,30.04.2010 10:29:58,sl 125.180,-0.34,-136.80000000001746,0.0,0.0,124.4,29.04.2010 22:30:00,4946,-0.09069417440424604,-74.99,IS,0.09,0.0,Phase3-EA-TR1v1-EURJPY-M30-91,EURJPYMT4,652,11h 59m,Sell
60635.41,143392,30.04.2010 17:29:57,sl 143.392,-0.34,-201.18000000002212,0.0,0.0,144062,29.04.2010 19:00:00,4947,-0.13337612577957525,-64.38,IS,0.09,0.0,Phase3-EA-B1v1-GBPJPY-M30-1,GBPJPYMT4,570,22h 29m,Buy
60566.6,125135,30.04.2010 17:29:58,sl 125.135,0.0,-269.9900000000198,0.0,0.0,125855,30.04.2010 14:30:00,4948,-0.1789950303172592,-68.81,IS,0.09,0.0,Phase3-EA-TR1v1-EURJPY-M30-91,EURJPYMT4,654,2h 59m,Buy
60607.55,1.43376,03.05.2010 01:00:00,tp 1.43376,-0.91,-229.04000000000815,0.0,0.0,1.43266,30.04.2010 20:15:00,4949,-0.15184644521598392,40.95,IS,0.41,0.0,Phase3-EA-SA2v2-EURCHF-M5-43,EURCHFMT4,2568,2d 4h 45m,Buy
60566.01,125119,03.05.2010 03:14:58,sl 125.119,0.0,-270.5800000000163,0.0,0.0,125349,03.05.2010 02:30:00,4950,-0.1793861820928307,-41.54,IS,0.17,0.0,Phase3-EA-T1v2-EURJPY-M15-322,EURJPYMT4,562,44m 58s,Buy
60607.75,1.43262,03.05.2010 04:24:57,tp 1.43262,0.0,-228.8400000000256,0.0,0.0,1.43372,03.05.2010 01:35:00,4951,-0.15171385139376709,41.74,IS,0.41,0.0,Phase3-EA-SA2v2-EURCHF-M5-43,EURCHFMT4,2570,2h 49m,Sell
60537.8,143496,03.05.2010 08:50:00,,0.0,-298.79000000003725,0.0,0.0,143782,03.05.2010 03:25:00,4952,-0.19808854071816223,-69.95,IS,0.23,0.0,Phase3-EA-S4v1-GBPJPY-M5-194,GBPJPYMT4,1280,5h 25m,Buy
60571.06,1.43256,03.05.2010 10:30:00,,0.0,-265.53000000002794,0.0,0.0,1.43362,03.05.2010 01:45:00,4953,-0.17603818808157098,33.26,IS,0.34,0.0,Phase3-EA-S4v1-EURCHF-M15-221,EURCHFMT4,1202,8h 45m,Sell
60529.56,125.0,03.05.2010 15:14:58,sl 125.000,0.0,-307.03000000002794,0.0,0.0,124.77,03.05.2010 04:00:00,4954,-0.20355140619396667,-41.5,IS,0.17,0.0,Phase3-EA-T1v2-EURJPY-M15-322,EURJPYMT4,564,11h 14m,Sell
60562.38,94687,04.05.2010 01:45:00,,-0.83,-274.21000000002095,0.0,0.0,94569,03.05.2010 21:45:00,4955,-0.18179275996627947,32.82,IS,0.27,0.0,Phase3-EA-S1v2-USDJPY-M15-0,USDJPYMT4,1718,4h 0m,Buy
60571.83,1.43243,04.05.2010 04:40:00,,-1.89,-264.7600000000093,0.0,0.0,1.43273,03.05.2010 20:20:00,4956,-0.17552770186597924,9.45,IS,0.41,0.0,Phase3-EA-SA2v2-EURCHF-M5-43,EURCHFMT4,2572,8h 20m,Sell
60448.42,144771,04.05.2010 07:05:00,,0.0,-388.1700000000128,0.0,0.0,144262,04.05.2010 01:40:00,4957,-0.2573447198720238,-123.41,IS,0.23,0.0,Phase3-EA-S4v1-GBPJPY-M5-194,GBPJPYMT4,1282,5h 25m,Sell
60570.52,123707,04.05.2010 14:59:58,tp 123.707,-0.67,-266.070000000007,0.0,0.0,124997,30.04.2010 18:00:00,4958,-0.1763961914015738,122.1,IS,0.09,0.0,Phase3-EA-TR1v1-EURJPY-M30-91,EURJPYMT4,656,3d 20h 59m,Sell
60597.96,94467,04.05.2010 19:30:00,,0.0,-238.63000000000466,0.0,0.0,94563,04.05.2010 17:15:00,4959,-0.15820431899183401,27.44,IS,0.27,0.0,Phase3-EA-S1v2-USDJPY-M15-0,USDJPYMT4,1720,2h 15m,Sell
60472.84,1.10473,05.05.2010 03:45:00,,-2.79,-363.75,0.0,0.0,1.1024,04.05.2010 23:30:00,4960,-0.24115501417792606,-125.12,IS,0.58,0.0,Phase3-EA-SA2v2-USDCHF-M15-107,USDCHFMT4,1032,4h 15m,Sell
60567.55,143127,05.05.2010 04:09:57,tp 143.127,0.0,-269.04000000000815,0.0,0.0,143517,05.05.2010 02:50:00,4961,-0.17836520966166652,94.71,IS,0.23,0.0,Phase3-EA-S4v1-GBPJPY-M5-194,GBPJPYMT4,1284,1h 19m,Sell
60564.44,1.43247,05.05.2010 04:20:00,,-0.89,-272.1499999999942,0.0,0.0,1.43253,04.05.2010 20:00:00,4962,-0.18042704359730907,-3.11,IS,0.41,0.0,Phase3-EA-SA2v2-EURCHF-M5-43,EURCHFMT4,2574,8h 20m,Buy
60523.16,122926,05.05.2010 05:14:58,sl 122.926,0.0,-313.429999999993,0.0,0.0,122696,05.05.2010 04:30:00,4963,-0.20779440850525274,-41.28,IS,0.17,0.0,Phase3-EA-T1v2-EURJPY-M15-322,EURJPYMT4,566,44m 58s,Sell
60481.79,122589,05.05.2010 11:29:57,sl 122.589,0.0,-354.79999999998836,0.0,0.0,122359,05.05.2010 11:15:00,4964,-0.23522144063319686,-41.37,IS,0.17,0.0,Phase3-EA-T1v2-EURJPY-M15-322,EURJPYMT4,568,14m 57s,Sell
60600.98,122172,05.05.2010 15:59:58,tp 122.172,-0.33,-235.60999999998603,0.0,0.0,123432,04.05.2010 17:00:00,4965,-0.15620215227617262,119.19,IS,0.09,0.0,Phase3-EA-TR1v1-EURJPY-M30-91,EURJPYMT4,658,22h 59m,Sell
60542.92,1.11779,06.05.2010 02:15:00,,-8.25,-293.6699999999837,0.0,0.0,1.11683,05.05.2010 22:00:00,4966,-0.19469413886907935,-58.06,IS,0.58,0.0,Phase3-EA-SA2v2-USDCHF-M15-107,USDCHFMT4,1034,4h 15m,Sell
60611.53,93653,06.05.2010 03:45:00,,0.0,-225.05999999999767,0.0,0.0,93891,06.05.2010 00:30:00,4967,-0.14920782815363157,68.61,IS,0.27,0.0,Phase3-EA-S1v2-USDJPY-M15-0,USDJPYMT4,1722,3h 15m,Sell
60636.8,1.4333,06.05.2010 04:25:00,,-2.64,-199.79000000000815,0.0,0.0,1.43254,05.05.2010 20:05:00,4968,-0.13245459871507853,25.27,IS,0.41,0.0,Phase3-EA-SA2v2-EURCHF-M5-43,EURCHFMT4,2576,8h 20m,Buy
60757.35,118928,06.05.2010 09:59:58,tp 118.928,-1.01,-79.24000000001979,0.0,0.0,120188,05.05.2010 23:00:00,4969,-0.05253367236691033,120.55,IS,0.09,0.0,Phase3-EA-TR1v1-EURJPY-M30-91,EURJPYMT4,660,10h 59m,Sell
60715.61,120.4,06.05.2010 11:59:58,sl 120.400,0.0,-120.98000000001048,0.0,0.0,120.17,06.05.2010 09:15:00,4970,-0.08020600306597395,-41.74,IS,0.17,0.0,Phase3-EA-T1v2-EURJPY-M15-322,EURJPYMT4,570,2h 44m,Sell
60836.92,1.42918,06.05.2010 12:44:58,tp 1.42918,0.0,-0.0,0.0,0.0,1.43318,06.05.2010 04:45:00,4971,-0.0,121.31,IS,0.34,0.0,Phase3-EA-S4v1-EURCHF-M15-221,EURCHFMT4,1204,7h 59m,Sell
60960.42,115497,06.05.2010 21:29:58,tp 115.497,0.0,-0.0,0.0,0.0,116757,06.05.2010 20:30:00,4972,-0.0,123.5,IS,0.09,0.0,Phase3-EA-TR1v1-EURJPY-M30-91,EURJPYMT4,662,59m 58s,Sell
61085.91,112684,06.05.2010 21:59:58,tp 112.684,0.0,-0.0,0.0,0.0,113944,06.05.2010 21:30:00,4973,-0.0,125.49,IS,0.09,0.0,Phase3-EA-TR1v1-EURJPY-M30-91,EURJPYMT4,664,29m 58s,Sell
61012.98,112814,06.05.2010 22:29:58,sl 112.814,0.0,-72.92999999999302,0.0,0.0,112094,06.05.2010 22:00:00,4974,-0.04827055017902932,-72.93,IS,0.09,0.0,Phase3-EA-TR1v1-EURJPY-M30-91,EURJPYMT4,666,29m 58s,Sell
61053.48,1.40563,06.05.2010 22:44:59,tp 1.40563,0.0,-32.429999999993015,0.0,0.0,1.40453,06.05.2010 21:15:00,4975,-0.02146460910881302,40.5,IS,0.41,0.0,Phase3-EA-SA2v2-EURCHF-M5-43,EURCHFMT4,2578,1h 29m,Buy
60981.33,113866,06.05.2010 22:59:58,sl 113.866,0.0,-104.5799999999872,0.0,0.0,113146,06.05.2010 22:30:00,4976,-0.06921889671908339,-72.15,IS,0.09,0.0,Phase3-EA-TR1v1-EURJPY-M30-91,EURJPYMT4,668,29m 58s,Sell
60909.25,114515,07.05.2010 00:29:58,sl 114.515,-0.35,-176.6599999999744,0.0,0.0,113795,06.05.2010 23:30:00,4977,-0.11692685307317839,-72.08,IS,0.09,0.0,Phase3-EA-TR1v1-EURJPY-M30-91,EURJPYMT4,670,59m 58s,Sell
61007.6,135691,07.05.2010 03:09:57,tp 135.691,0.0,-78.30999999996857,0.0,0.0,136081,07.05.2010 02:55:00,4978,-0.051831438153278904,98.35,IS,0.23,0.0,Phase3-EA-S4v1-GBPJPY-M5-194,GBPJPYMT4,1286,14m 57s,Sell
61048.17,1.40642,07.05.2010 03:09:58,tp 1.40642,0.0,-37.73999999996158,0.0,0.0,1.40752,07.05.2010 02:35:00,4979,-0.02497916582688724,40.57,IS,0.41,0.0,Phase3-EA-SA2v2-EURCHF-M5-43,EURCHFMT4,2580,34m 58s,Sell
60929.09,1.41595,07.05.2010 07:14:58,sl 1.41595,0.0,-156.81999999994878,0.0,0.0,1.41205,07.05.2010 06:15:00,4980,-0.10379525132419622,-119.08,IS,0.34,0.0,Phase3-EA-S4v1-EURCHF-M15-221,EURCHFMT4,1206,59m 58s,Sell
60969.74,1.41222,07.05.2010 21:09:58,tp 1.41222,0.0,-116.1699999999546,0.0,0.0,1.41332,07.05.2010 20:50:00,4981,-0.07689002899076075,40.65,IS,0.41,0.0,Phase3-EA-SA2v2-EURCHF-M5-43,EURCHFMT4,2582,19m 58s,Sell
61087.81,91472,07.05.2010 21:44:57,tp 91.472,0.0,-0.0,0.0,0.0,91872,07.05.2010 20:45:00,4982,-0.0,118.07,IS,0.27,0.0,Phase3-EA-S1v2-USDJPY-M15-0,USDJPYMT4,1724,59m 57s,Sell
61128.5,1.41127,07.05.2010 23:04:57,tp 1.41127,0.0,-0.0,0.0,0.0,1.41017,07.05.2010 22:45:00,4983,-0.0,40.69,IS,0.41,0.0,Phase3-EA-SA2v2-EURCHF-M5-43,EURCHFMT4,2584,19m 57s,Buy
60884.54,92361,10.05.2010 01:00:00,sl 92.361,-1.33,-243.95999999999185,0.0,0.0,91531,07.05.2010 23:45:00,4984,-0.16142554184021674,-243.96,IS,0.27,0.0,Phase3-EA-S1v2-USDJPY-M15-0,USDJPYMT4,1726,2d 1h 15m,Sell
61001.58,92276,10.05.2010 01:14:58,tp 92.276,0.0,-126.9199999999837,0.0,0.0,92676,10.05.2010 01:00:00,4985,-0.0839815124215378,117.04,IS,0.27,0.0,Phase3-EA-S1v2-USDJPY-M15-0,USDJPYMT4,1728,14m 58s,Sell
61098.98,136008,10.05.2010 01:19:58,tp 136.008,0.0,-29.519999999989523,0.0,0.0,136398,10.05.2010 01:15:00,4986,-0.019533046381052903,97.4,IS,0.23,0.0,Phase3-EA-S4v1-GBPJPY-M5-194,GBPJPYMT4,1288,4m 58s,Sell
61056.52,118328,10.05.2010 01:29:57,sl 118.328,0.0,-71.97999999998137,0.0,0.0,118558,10.05.2010 01:15:00,4987,-0.047628342767897125,-42.46,IS,0.17,0.0,Phase3-EA-T1v2-EURJPY-M15-322,EURJPYMT4,572,14m 57s,Buy
61013.99,1.47892,10.05.2010 01:29:58,sl 1.47892,-0.53,-114.50999999998021,0.0,0.0,1.48192,07.05.2010 23:00:00,4988,-0.07576995735415905,-42.53,IS,0.14,0.0,Phase3-EA-B1v1-GBPUSD-M30-14,GBPUSDMT4,324,2d 2h 29m,Buy
61054.91,1.42004,10.05.2010 01:49:58,tp 1.42004,0.0,-73.5899999999674,0.0,0.0,1.42114,10.05.2010 01:25:00,4989,-0.04869366135438877,40.92,IS,0.41,0.0,Phase3-EA-SA2v2-EURCHF-M5-43,EURCHFMT4,2586,24m 58s,Sell
60934.86,1.42382,10.05.2010 04:44:58,sl 1.42382,0.0,-193.63999999995576,0.0,0.0,1.41992,10.05.2010 02:45:00,4990,-0.12812937334781715,-120.05,IS,0.34,0.0,Phase3-EA-S4v1-EURCHF-M15-221,EURCHFMT4,1208,1h 59m,Sell
61199.46,1.49926,10.05.2010 12:29:58,tp 1.49926,0.0,-0.0,0.0,0.0,1.48036,10.05.2010 02:30:00,4991,-0.0,264.6,IS,0.14,0.0,Phase3-EA-B1v1-GBPUSD-M30-14,GBPUSDMT4,326,9h 59m,Buy
61134.72,139287,10.05.2010 15:59:57,sl 139.287,0.0,-64.73999999999069,0.0,0.0,139957,10.05.2010 14:00:00,4992,-0.04281761323750143,-64.74,IS,0.09,0.0,Phase3-EA-B1v1-GBPJPY-M30-1,GBPJPYMT4,572,1h 59m,Buy
61259.17,119101,10.05.2010 20:29:58,tp 119.101,0.0,-0.0,0.0,0.0,120391,10.05.2010 15:30:00,4993,-0.0,124.45,IS,0.09,0.0,Phase3-EA-TR1v1-EURJPY-M30-91,EURJPYMT4,672,4h 59m,Sell
61299.83,1.41928,10.05.2010 20:29:58,tp 1.41928,0.0,-0.0,0.0,0.0,1.41818,10.05.2010 20:20:00,4994,-0.0,40.66,IS,0.41,0.0,Phase3-EA-SA2v2-EURCHF-M5-43,EURCHFMT4,2588,9m 58s,Buy
61340.42,1.41942,10.05.2010 23:29:59,tp 1.41942,0.0,-0.0,0.0,0.0,1.42052,10.05.2010 23:05:00,4995,-0.0,40.59,IS,0.41,0.0,Phase3-EA-SA2v2-EURCHF-M5-43,EURCHFMT4,2590,24m 59s,Sell
61436.71,138473,11.05.2010 04:29:58,tp 138.473,0.0,-0.0,0.0,0.0,138083,11.05.2010 02:30:00,4996,-0.0,96.29,IS,0.23,0.0,Phase3-EA-S4v1-GBPJPY-M5-194,GBPJPYMT4,1290,1h 59m,Buy
61255.73,1.41328,11.05.2010 08:04:58,sl 1.41328,0.0,-180.98000000001048,0.0,0.0,1.41818,11.05.2010 02:00:00,4997,-0.11950867131226667,-180.98,IS,0.41,0.0,Phase3-EA-SA2v2-EURCHF-M5-43,EURCHFMT4,2592,6h 4m,Buy
61136.45,1.41224,11.05.2010 09:29:58,sl 1.41224,0.0,-300.2600000000093,0.0,0.0,1.41614,11.05.2010 03:15:00,4998,-0.19827424935473656,-119.28,IS,0.34,0.0,Phase3-EA-S4v1-EURCHF-M15-221,EURCHFMT4,1210,6h 14m,Buy
61071.32,136935,11.05.2010 15:59:58,sl 136.935,0.0,-365.39000000001397,0.0,0.0,136265,11.05.2010 14:00:00,4999,-0.2412823152325575,-65.13,IS,0.09,0.0,Phase3-EA-B1v1-GBPJPY-M30-1,GBPJPYMT4,574,1h 59m,Sell
61196.33,118501,11.05.2010 19:59:58,tp 118.501,0.0,-240.38000000000466,0.0,0.0,117211,11.05.2010 13:00:00,5000,-0.15873297828512295,125.01,IS,0.09,0.0,Phase3-EA-TR1v1-EURJPY-M30-91,EURJPYMT4,674,6h 59m,Buy
61236.98,1.40895,11.05.2010 21:39:59,tp 1.40895,0.0,-199.73000000001048,0.0,0.0,1.41005,11.05.2010 20:40:00,5001,-0.13189008134157856,40.65,IS,0.41,0.0,Phase3-EA-SA2v2-EURCHF-M5-43,EURCHFMT4,2594,59m 59s,Sell
61277.59,1.40835,11.05.2010 23:54:57,tp 1.40835,0.0,-159.12000000002445,0.0,0.0,1.40725,11.05.2010 23:45:00,5002,-0.10507359807276877,40.61,IS,0.41,0.0,Phase3-EA-SA2v2-EURCHF-M5-43,EURCHFMT4,2596,9m 57s,Buy
61194.43,1.11104,12.05.2010 02:30:00,,-2.77,-242.28000000002794,0.0,0.0,1.1095,11.05.2010 22:15:00,5003,-0.15998762783477527,-83.16,IS,0.58,0.0,Phase3-EA-SA2v2-USDCHF-M15-107,USDCHFMT4,1036,4h 15m,Sell
61291.14,138652,12.05.2010 02:54:59,tp 138.652,0.0,-145.5700000000361,0.0,0.0,138262,12.05.2010 01:10:00,5004,-0.09612596575826038,96.71,IS,0.23,0.0,Phase3-EA-S4v1-GBPJPY-M5-194,GBPJPYMT4,1292,1h 44m,Buy
61331.75,1.40638,12.05.2010 03:24:58,tp 1.40638,0.0,-104.96000000005006,0.0,0.0,1.40528,12.05.2010 00:30:00,5005,-0.06930948248945057,40.61,IS,0.41,0.0,Phase3-EA-SA2v2-EURCHF-M5-43,EURCHFMT4,2598,2h 54m,Buy
61343.69,92857,12.05.2010 03:30:00,,-0.85,-93.02000000004773,0.0,0.0,92813,11.05.2010 21:45:00,5006,-0.06142500058278321,11.94,IS,0.27,0.0,Phase3-EA-S1v2-USDJPY-M15-0,USDJPYMT4,1730,5h 45m,Buy
61440.4,138235,12.05.2010 03:44:58,tp 138.235,0.0,-0.0,0.0,0.0,138625,12.05.2010 03:10:00,5007,-0.0,96.71,IS,0.23,0.0,Phase3-EA-S4v1-GBPJPY-M5-194,GBPJPYMT4,1294,34m 58s,Sell
61539.22,1.40767,12.05.2010 11:00:00,,0.0,-0.0,0.0,0.0,1.40444,12.05.2010 02:15:00,5008,-0.0,98.82,IS,0.34,0.0,Phase3-EA-S4v1-EURCHF-M15-221,EURCHFMT4,1212,8h 45m,Buy
61577.14,1.40305,13.05.2010 00:04:57,tp 1.40305,-2.66,-0.0,0.0,0.0,1.40195,12.05.2010 21:45:00,5009,-0.0,37.92,IS,0.41,0.0,Phase3-EA-SA2v2-EURCHF-M5-43,EURCHFMT4,2600,2h 19m,Buy
61604.36,93.24,13.05.2010 03:15:00,,0.0,-0.0,0.0,0.0,93146,13.05.2010 01:30:00,5010,-0.0,27.22,IS,0.27,0.0,Phase3-EA-S1v2-USDJPY-M15-0,USDJPYMT4,1732,1h 45m,Buy
61562.51,117611,13.05.2010 11:44:57,sl 117.611,0.0,-41.85000000000582,0.0,0.0,117841,13.05.2010 03:00:00,5011,-0.027604746987491536,-41.85,IS,0.17,0.0,Phase3-EA-T1v2-EURJPY-M15-322,EURJPYMT4,574,8h 44m,Buy
61610.47,1.4017,13.05.2010 14:15:00,,0.0,-0.0,0.0,0.0,1.40327,13.05.2010 05:30:00,5012,-0.0,47.96,IS,0.34,0.0,Phase3-EA-S4v1-EURCHF-M15-221,EURCHFMT4,1214,8h 45m,Sell
61642.51,92699,13.05.2010 19:15:00,,0.0,-0.0,0.0,0.0,92809,13.05.2010 18:30:00,5013,-0.0,32.04,IS,0.27,0.0,Phase3-EA-S1v2-USDJPY-M15-0,USDJPYMT4,1734,45m 0s,Sell
61683.01,1.40067,13.05.2010 20:44:58,tp 1.40067,0.0,-0.0,0.0,0.0,1.40177,13.05.2010 20:25:00,5014,-0.0,40.5,IS,0.41,0.0,Phase3-EA-SA2v2-EURCHF-M5-43,EURCHFMT4,2602,19m 58s,Sell
61716.22,92675,13.05.2010 23:15:00,,0.0,-0.0,0.0,0.0,92789,13.05.2010 20:00:00,5015,-0.0,33.21,IS,0.27,0.0,Phase3-EA-S1v2-USDJPY-M15-0,USDJPYMT4,1736,3h 15m,Sell
61812.93,135528,14.05.2010 01:59:58,tp 135.528,0.0,-0.0,0.0,0.0,135138,14.05.2010 00:40:00,5016,-0.0,96.71,IS,0.23,0.0,Phase3-EA-S4v1-GBPJPY-M5-194,GBPJPYMT4,1296,1h 19m,Buy
61740.18,1.11864,14.05.2010 03:30:00,,-2.75,-72.75,0.0,0.0,1.11729,13.05.2010 23:15:00,5017,-0.04792081939265649,-72.75,IS,0.58,0.0,Phase3-EA-SA2v2-USDCHF-M15-107,USDCHFMT4,1038,4h 15m,Sell
61742.24,1.40065,14.05.2010 06:20:00,,-0.88,-70.69000000000233,0.0,0.0,1.40057,13.05.2010 22:00:00,5018,-0.046563886224975926,2.06,IS,0.41,0.0,Phase3-EA-SA2v2-EURCHF-M5-43,EURCHFMT4,2604,8h 20m,Buy
61700.16,116505,14.05.2010 07:44:58,sl 116.505,0.0,-112.76999999998952,0.0,0.0,116275,14.05.2010 07:00:00,5019,-0.0742822103492697,-42.08,IS,0.17,0.0,Phase3-EA-T1v2-EURJPY-M15-322,EURJPYMT4,576,44m 58s,Sell
61624.47,115616,14.05.2010 11:29:58,sl 115.616,0.0,-188.45999999999185,0.0,0.0,116396,14.05.2010 05:30:00,5020,-0.12413962368027012,-75.69,IS,0.09,0.0,Phase3-EA-TR1v1-EURJPY-M30-91,EURJPYMT4,676,5h 59m,Buy
61582.23,116019,14.05.2010 11:44:58,sl 116.019,0.0,-230.69999999998254,0.0,0.0,115789,14.05.2010 11:30:00,5021,-0.15196334067195896,-42.24,IS,0.17,0.0,Phase3-EA-T1v2-EURJPY-M15-322,EURJPYMT4,578,14m 58s,Sell
61506.42,115115,14.05.2010 16:59:58,sl 115.115,0.0,-306.5099999999802,0.0,0.0,115895,14.05.2010 16:00:00,5022,-0.2018997986535009,-75.81,IS,0.09,0.0,Phase3-EA-TR1v1-EURJPY-M30-91,EURJPYMT4,678,59m 58s,Buy
61530.7,92314,14.05.2010 17:15:00,,0.0,-282.2299999999814,0.0,0.0,92397,14.05.2010 17:00:00,5023,-0.1859064310266467,24.28,IS,0.27,0.0,Phase3-EA-S1v2-USDJPY-M15-0,USDJPYMT4,1738,15m 0s,Sell
61571.62,92061,17.05.2010 03:30:00,,-1.31,-241.30999999996857,0.0,0.0,92205,14.05.2010 22:00:00,5024,-0.15895220519093375,40.92,IS,0.27,0.0,Phase3-EA-S1v2-USDJPY-M15-0,USDJPYMT4,1740,2d 5h 30m,Sell
61372.16,132736,17.05.2010 04:34:58,sl 132.736,0.0,-440.7699999999604,0.0,0.0,133536,17.05.2010 03:00:00,5025,-0.2903375885044578,-199.46,IS,0.23,0.0,Phase3-EA-S4v1-GBPJPY-M5-194,GBPJPYMT4,1298,1h 34m,Buy
61173.14,1.13656,17.05.2010 05:14:58,sl 1.13656,0.0,-639.7899999999499,0.0,0.0,1.13266,17.05.2010 01:30:00,5026,-0.4214331414326501,-199.02,IS,0.58,0.0,Phase3-EA-SA2v2-USDCHF-M15-107,USDCHFMT4,1040,3h 44m,Sell
61437.74,1.42879,17.05.2010 05:29:57,tp 1.42879,0.0,-375.1899999999441,0.0,0.0,1.44769,17.05.2010 03:00:00,5027,-0.2471396869818297,264.6,IS,0.14,0.0,Phase3-EA-B1v1-GBPUSD-M30-14,GBPUSDMT4,328,2h 29m,Sell
61428.25,1.40034,17.05.2010 06:00:00,,-0.87,-384.6799999999348,0.0,0.0,1.40058,14.05.2010 21:40:00,5028,-0.25339080142905807,-9.49,IS,0.41,0.0,Phase3-EA-SA2v2-EURCHF-M5-43,EURCHFMT4,2606,2d 8h 20m,Buy
61553.94,114723,17.05.2010 15:59:57,tp 114.723,0.0,-258.9899999999325,0.0,0.0,113433,17.05.2010 10:30:00,5029,-0.1705981170378126,125.69,IS,0.09,0.0,Phase3-EA-TR1v1-EURJPY-M30-91,EURJPYMT4,680,5h 29m,Buy
61591.6,92489,17.05.2010 18:00:00,,0.0,-221.329999999929,0.0,0.0,92.36,17.05.2010 17:00:00,5030,-0.14579127087523377,37.66,IS,0.27,0.0,Phase3-EA-S1v2-USDJPY-M15-0,USDJPYMT4,1742,1h 0m,Buy
61631.46,1.4017,17.05.2010 22:14:57,tp 1.40170,0.0,-181.46999999994296,0.0,0.0,1.4006,17.05.2010 20:20:00,5031,-0.11953527278601565,39.86,IS,0.41,0.0,Phase3-EA-SA2v2-EURCHF-M5-43,EURCHFMT4,2608,1h 54m,Buy
61691.87,92.52,17.05.2010 22:45:00,,0.0,-121.05999999993946,0.0,0.0,92313,17.05.2010 18:15:00,5032,-0.07974287829102535,60.41,IS,0.27,0.0,Phase3-EA-S1v2-USDJPY-M15-0,USDJPYMT4,1744,4h 30m,Buy
61616.52,133486,18.05.2010 07:40:00,,0.0,-196.40999999994528,0.0,0.0,133789,18.05.2010 02:15:00,5033,-0.1293763317788184,-75.35,IS,0.23,0.0,Phase3-EA-S4v1-GBPJPY-M5-194,GBPJPYMT4,1300,5h 25m,Buy
61610.02,1.40185,18.05.2010 07:40:00,,-1.81,-202.90999999994528,0.0,0.0,1.40172,17.05.2010 23:20:00,5034,-0.13365791701665025,-6.5,IS,0.41,0.0,Phase3-EA-SA2v2-EURCHF-M5-43,EURCHFMT4,2610,8h 20m,Sell
61567.78,114519,18.05.2010 17:59:58,sl 114.519,0.0,-245.14999999993597,0.0,0.0,114749,18.05.2010 09:45:00,5035,-0.1614816340083391,-42.24,IS,0.17,0.0,Phase3-EA-T1v2-EURJPY-M15-322,EURJPYMT4,580,8h 14m,Buy
61693.27,113217,18.05.2010 20:59:58,tp 113.217,0.0,-119.65999999994528,0.0,0.0,114507,18.05.2010 18:00:00,5036,-0.07882069070134232,125.49,IS,0.09,0.0,Phase3-EA-TR1v1-EURJPY-M30-91,EURJPYMT4,682,2h 59m,Sell
61493.76,1.14923,19.05.2010 00:14:58,sl 1.14923,-2.68,-319.1699999999546,0.0,0.0,1.14533,18.05.2010 22:15:00,5037,-0.21023900928593808,-199.51,IS,0.58,0.0,Phase3-EA-SA2v2-USDCHF-M15-107,USDCHFMT4,1042,1h 59m,Sell
61293.47,130539,19.05.2010 03:44:58,sl 130.539,0.0,-519.4599999999627,0.0,0.0,131339,19.05.2010 00:40:00,5038,-0.3421711180990729,-200.29,IS,0.23,0.0,Phase3-EA-S4v1-GBPJPY-M5-194,GBPJPYMT4,1302,3h 4m,Buy
61416.52,111363,19.05.2010 03:59:58,tp 111.363,-0.34,-396.4099999999744,0.0,0.0,112623,18.05.2010 22:00:00,5039,-0.2611174160198176,123.05,IS,0.09,0.0,Phase3-EA-TR1v1-EURJPY-M30-91,EURJPYMT4,684,5h 59m,Sell
61408.53,1.4004,19.05.2010 04:45:00,,-0.86,-404.3999999999651,0.0,0.0,1.4006,18.05.2010 20:25:00,5040,-0.26638047233523865,-7.99,IS,0.41,0.0,Phase3-EA-SA2v2-EURCHF-M5-43,EURCHFMT4,2612,8h 20m,Buy
61342.99,131601,19.05.2010 06:59:57,sl 131.601,0.0,-469.9399999999732,0.0,0.0,130931,19.05.2010 03:00:00,5041,-0.30955202564101314,-65.54,IS,0.09,0.0,Phase3-EA-B1v1-GBPJPY-M30-1,GBPJPYMT4,576,3h 59m,Sell
61266.15,111322,19.05.2010 11:29:58,sl 111.322,0.0,-546.7799999999697,0.0,0.0,112102,19.05.2010 09:00:00,5042,-0.3601669502063954,-76.84,IS,0.09,0.0,Phase3-EA-TR1v1-EURJPY-M30-91,EURJPYMT4,686,2h 29m,Buy
61223.37,111484,19.05.2010 11:44:57,sl 111.484,0.0,-589.5599999999686,0.0,0.0,111254,19.05.2010 11:30:00,5043,-0.38834636812554024,-42.78,IS,0.17,0.0,Phase3-EA-T1v2-EURJPY-M15-322,EURJPYMT4,582,14m 57s,Sell
61341.83,91.17,19.05.2010 17:29:58,tp 91.170,0.0,-471.0999999999767,0.0,0.0,91.57,19.05.2010 17:00:00,5044,-0.31031612392961316,118.46,IS,0.27,0.0,Phase3-EA-S1v2-USDJPY-M15-0,USDJPYMT4,1746,29m 58s,Sell
61406.37,91202,19.05.2010 18:15:00,,0.0,-406.55999999996857,0.0,0.0,91.42,19.05.2010 17:30:00,5045,-0.2678032760450435,64.54,IS,0.27,0.0,Phase3-EA-S1v2-USDJPY-M15-0,USDJPYMT4,1748,45m 0s,Sell
61533.27,113388,19.05.2010 20:59:58,tp 113.388,0.0,-279.6599999999744,0.0,0.0,112098,19.05.2010 15:30:00,5046,-0.18421355809414552,126.9,IS,0.09,0.0,Phase3-EA-TR1v1-EURJPY-M30-91,EURJPYMT4,688,5h 29m,Buy
61572.41,1.42855,19.05.2010 21:04:58,tp 1.42855,0.0,-240.51999999996042,0.0,0.0,1.42965,19.05.2010 21:00:00,5047,-0.15843182790817653,39.14,IS,0.41,0.0,Phase3-EA-SA2v2-EURCHF-M5-43,EURCHFMT4,2614,4m 58s,Sell
61611.57,1.42894,20.05.2010 01:09:58,tp 1.42894,0.0,-201.35999999995693,0.0,0.0,1.43004,20.05.2010 00:50:00,5048,-0.13263692361379031,39.16,IS,0.41,0.0,Phase3-EA-SA2v2-EURCHF-M5-43,EURCHFMT4,2616,19m 58s,Sell
61705.1,132093,20.05.2010 01:44:59,tp 132.093,-4.36,-107.82999999995809,0.0,0.0,132483,19.05.2010 23:50:00,5049,-0.07102820556849677,93.53,IS,0.23,0.0,Phase3-EA-S4v1-GBPJPY-M5-194,GBPJPYMT4,1304,1h 54m,Sell
61823.07,1.42569,20.05.2010 03:29:58,tp 1.42569,0.0,-0.0,0.0,0.0,1.42969,20.05.2010 01:00:00,5050,-0.0,117.97,IS,0.34,0.0,Phase3-EA-S4v1-EURCHF-M15-221,EURCHFMT4,1216,2h 29m,Sell
61920.81,132424,20.05.2010 03:39:58,tp 132.424,0.0,-0.0,0.0,0.0,132034,20.05.2010 02:05:00,5051,-0.0,97.74,IS,0.23,0.0,Phase3-EA-S4v1-GBPJPY-M5-194,GBPJPYMT4,1306,1h 34m,Buy
61929.87,1.15232,20.05.2010 06:30:00,,0.0,-0.0,0.0,0.0,1.1525,20.05.2010 02:15:00,5052,-0.0,9.06,IS,0.58,0.0,Phase3-EA-SA2v2-USDCHF-M15-107,USDCHFMT4,1044,4h 15m,Sell
61922.35,91622,20.05.2010 08:15:00,,-3.98,-7.519999999989523,0.0,0.0,91.61,19.05.2010 22:45:00,5053,-0.004949652099346575,-7.52,IS,0.27,0.0,Phase3-EA-S1v2-USDJPY-M15-0,USDJPYMT4,1750,9h 30m,Sell
62040.22,1.42847,20.05.2010 09:59:58,tp 1.42847,0.0,-0.0,0.0,0.0,1.42447,20.05.2010 05:15:00,5054,-0.0,117.87,IS,0.34,0.0,Phase3-EA-S4v1-EURCHF-M15-221,EURCHFMT4,1218,4h 44m,Buy
62167.57,112047,20.05.2010 14:29:58,tp 112.047,0.0,-0.0,0.0,0.0,113337,20.05.2010 05:30:00,5055,-0.0,127.35,IS,0.09,0.0,Phase3-EA-TR1v1-EURJPY-M30-91,EURJPYMT4,690,8h 59m,Sell
62095.59,110665,20.05.2010 18:29:59,sl 110.665,0.0,-71.98000000001048,0.0,0.0,109945,20.05.2010 17:30:00,5056,-0.047303114586117447,-71.98,IS,0.09,0.0,Phase3-EA-TR1v1-EURJPY-M30-91,EURJPYMT4,692,59m 59s,Sell
61920.61,1.43683,20.05.2010 20:34:58,sl 1.43683,0.0,-246.96000000002095,0.0,0.0,1.43193,20.05.2010 20:30:00,5057,-0.16229476490951453,-174.98,IS,0.41,0.0,Phase3-EA-SA2v2-EURCHF-M5-43,EURCHFMT4,2618,4m 58s,Sell
62040.92,89767,20.05.2010 21:14:58,tp 89.767,0.0,-126.65000000002328,0.0,0.0,90167,20.05.2010 20:45:00,5058,-0.08323061214687419,120.31,IS,0.27,0.0,Phase3-EA-S1v2-USDJPY-M15-0,USDJPYMT4,1752,29m 58s,Sell
62080.28,1.44249,20.05.2010 21:54:57,tp 1.44249,0.0,-87.29000000003725,0.0,0.0,1.44359,20.05.2010 21:45:00,5059,-0.05736439111174428,39.36,IS,0.41,0.0,Phase3-EA-SA2v2-EURCHF-M5-43,EURCHFMT4,2620,9m 57s,Sell
62200.88,89551,20.05.2010 23:14:58,tp 89.551,0.0,-0.0,0.0,0.0,89951,20.05.2010 21:30:00,5060,-0.0,120.6,IS,0.27,0.0,Phase3-EA-S1v2-USDJPY-M15-0,USDJPYMT4,1754,1h 44m,Sell
61993.59,127802,21.05.2010 00:39:57,sl 127.802,-0.92,-207.29000000000815,0.0,0.0,128602,20.05.2010 23:25:00,5061,-0.13619500754529681,-207.29,IS,0.23,0.0,Phase3-EA-S4v1-GBPJPY-M5-194,GBPJPYMT4,1308,1h 14m,Buy
62032.75,1.43715,21.05.2010 00:44:57,tp 1.43715,0.0,-168.13000000000466,0.0,0.0,1.43605,21.05.2010 00:25:00,5062,-0.11046585275985571,39.16,IS,0.41,0.0,Phase3-EA-SA2v2-EURCHF-M5-43,EURCHFMT4,2622,19m 57s,Buy
61988.83,111283,21.05.2010 00:59:58,sl 111.283,0.0,-212.05000000001746,0.0,0.0,111053,21.05.2010 00:45:00,5063,-0.13932245332616833,-43.92,IS,0.17,0.0,Phase3-EA-T1v2-EURJPY-M15-322,EURJPYMT4,584,14m 58s,Sell
62089.23,128415,21.05.2010 01:24:58,tp 128.415,0.0,-111.65000000002328,0.0,0.0,128025,21.05.2010 00:40:00,5064,-0.07335700030119621,100.4,IS,0.23,0.0,Phase3-EA-S4v1-GBPJPY-M5-194,GBPJPYMT4,1310,44m 58s,Buy
62128.44,1.43662,21.05.2010 01:29:58,tp 1.43662,0.0,-72.44000000003143,0.0,0.0,1.43552,21.05.2010 00:50:00,5065,-0.04759499419453517,39.21,IS,0.41,0.0,Phase3-EA-SA2v2-EURCHF-M5-43,EURCHFMT4,2624,39m 58s,Buy
62167.64,1.43887,21.05.2010 03:09:58,tp 1.43887,0.0,-33.24000000001979,0.0,0.0,1.43997,21.05.2010 02:50:00,5066,-0.021839558352106634,39.2,IS,0.41,0.0,Phase3-EA-SA2v2-EURCHF-M5-43,EURCHFMT4,2626,19m 58s,Sell
62267.4,128839,21.05.2010 03:49:58,tp 128.839,0.0,-0.0,0.0,0.0,129229,21.05.2010 03:05:00,5067,-0.0,99.76,IS,0.23,0.0,Phase3-EA-S4v1-GBPJPY-M5-194,GBPJPYMT4,1312,44m 58s,Sell
62189.52,113.0,21.05.2010 12:29:58,sl 113.000,0.0,-77.88000000000466,0.0,0.0,112.22,21.05.2010 11:30:00,5068,-0.05114686400372284,-77.88,IS,0.09,0.0,Phase3-EA-TR1v1-EURJPY-M30-91,EURJPYMT4,694,59m 58s,Sell
62228.8,1.44426,21.05.2010 21:09:58,tp 1.44426,0.0,-38.60000000000582,0.0,0.0,1.44536,21.05.2010 21:05:00,5069,-0.025350140607908078,39.28,IS,0.41,0.0,Phase3-EA-SA2v2-EURCHF-M5-43,EURCHFMT4,2628,4m 58s,Sell
62347.74,90146,24.05.2010 01:00:00,tp 90.146,-0.87,-0.0,0.0,0.0,89746,21.05.2010 21:45:00,5070,-0.0,118.94,IS,0.27,0.0,Phase3-EA-S1v2-USDJPY-M15-0,USDJPYMT4,1756,2d 3h 15m,Buy
62386.86,1.44411,24.05.2010 05:29:58,tp 1.44411,0.0,-0.0,0.0,0.0,1.44301,24.05.2010 01:15:00,5071,-0.0,39.12,IS,0.41,0.0,Phase3-EA-SA2v2-EURCHF-M5-43,EURCHFMT4,2630,4h 14m,Buy
62343.58,112.77,24.05.2010 09:59:58,sl 112.770,0.0,-43.279999999998836,0.0,0.0,113.0,24.05.2010 09:30:00,5072,-0.028401398913265125,-43.28,IS,0.17,0.0,Phase3-EA-T1v2-EURJPY-M15-322,EURJPYMT4,586,29m 58s,Buy
62321.16,1.44139,24.05.2010 10:30:00,,0.0,-65.70000000001164,0.0,0.0,1.44215,24.05.2010 01:45:00,5073,-0.04311395352592189,-22.42,IS,0.34,0.0,Phase3-EA-S4v1-EURCHF-M15-221,EURCHFMT4,1220,8h 45m,Buy
62360.07,1.43497,24.05.2010 22:59:58,tp 1.43497,0.0,-26.79000000000815,0.0,0.0,1.43607,24.05.2010 22:25:00,5074,-0.017580255935458054,38.91,IS,0.41,0.0,Phase3-EA-SA2v2-EURCHF-M5-43,EURCHFMT4,2632,34m 58s,Sell
62186.15,1.42846,25.05.2010 03:54:57,sl 1.42846,-0.85,-200.71000000002095,0.0,0.0,1.43336,24.05.2010 23:40:00,5075,-0.13171083123572533,-173.92,IS,0.41,0.0,Phase3-EA-SA2v2-EURCHF-M5-43,EURCHFMT4,2634,4h 14m,Buy
62071.79,1.4278,25.05.2010 03:59:58,sl 1.42780,0.0,-315.070000000007,0.0,0.0,1.4317,25.05.2010 02:00:00,5076,-0.2067566718022847,-114.36,IS,0.34,0.0,Phase3-EA-S4v1-EURCHF-M15-221,EURCHFMT4,1222,1h 59m,Buy
61867.52,129038,25.05.2010 04:04:58,sl 129.038,0.0,-519.3399999999965,0.0,0.0,129838,25.05.2010 00:40:00,5077,-0.3408036624680085,-204.27,IS,0.23,0.0,Phase3-EA-S4v1-GBPJPY-M5-194,GBPJPYMT4,1314,3h 24m,Buy
61753.32,1.42547,25.05.2010 08:44:57,sl 1.42547,0.0,-633.5400000000081,0.0,0.0,1.42937,25.05.2010 05:00:00,5078,-0.41574450710514566,-114.2,IS,0.34,0.0,Phase3-EA-S4v1-EURCHF-M15-221,EURCHFMT4,1224,3h 44m,Buy
61502.3,89586,25.05.2010 09:29:57,sl 89.586,-0.87,-884.5599999999977,0.0,0.0,90416,24.05.2010 20:30:00,5079,-0.580469995903845,-251.02,IS,0.27,0.0,Phase3-EA-S1v2-USDJPY-M15-0,USDJPYMT4,1758,12h 59m,Buy
61824.27,109953,25.05.2010 09:29:58,tp 109.953,-0.66,-562.5899999999965,0.0,0.0,111653,24.05.2010 23:30:00,5080,-0.36918537464450457,321.97,IS,0.17,0.0,Phase3-EA-T1v2-EURJPY-M15-322,EURJPYMT4,588,9h 59m,Sell
61950.42,110143,25.05.2010 09:29:58,tp 110.143,0.0,-436.4400000000023,0.0,0.0,111403,25.05.2010 02:30:00,5081,-0.28640264652739905,126.15,IS,0.09,0.0,Phase3-EA-TR1v1-EURJPY-M30-91,EURJPYMT4,696,6h 59m,Sell
62077.4,108913,25.05.2010 13:29:58,tp 108.913,0.0,-309.45999999999185,0.0,0.0,110173,25.05.2010 09:30:00,5082,-0.2030752520263177,126.98,IS,0.09,0.0,Phase3-EA-TR1v1-EURJPY-M30-91,EURJPYMT4,698,3h 59m,Sell
62005.01,109881,25.05.2010 17:29:58,sl 109.881,0.0,-381.8500000000058,0.0,0.0,109161,25.05.2010 13:30:00,5083,-0.2505793478519119,-72.39,IS,0.09,0.0,Phase3-EA-TR1v1-EURJPY-M30-91,EURJPYMT4,700,3h 59m,Sell
61937.82,129347,25.05.2010 21:29:58,sl 129.347,0.0,-449.04000000000815,0.0,0.0,128677,25.05.2010 09:00:00,5084,-0.2946710759707289,-67.19,IS,0.09,0.0,Phase3-EA-B1v1-GBPJPY-M30-1,GBPJPYMT4,578,12h 29m,Sell
61976.74,1.4263,25.05.2010 22:04:57,tp 1.42630,0.0,-410.11999999999534,0.0,0.0,1.4274,25.05.2010 21:30:00,5085,-0.269130816134669,38.92,IS,0.41,0.0,Phase3-EA-SA2v2-EURCHF-M5-43,EURCHFMT4,2636,34m 57s,Sell
62076.16,130076,26.05.2010 01:09:59,tp 130.076,0.0,-310.69999999998254,0.0,0.0,130466,26.05.2010 00:45:00,5086,-0.20388897047946433,99.42,IS,0.23,0.0,Phase3-EA-S4v1-GBPJPY-M5-194,GBPJPYMT4,1316,24m 59s,Sell
62115.14,1.42774,26.05.2010 02:39:57,tp 1.42774,0.0,-271.71999999997206,0.0,0.0,1.42884,26.05.2010 01:00:00,5087,-0.1783093371698663,38.98,IS,0.41,0.0,Phase3-EA-SA2v2-EURCHF-M5-43,EURCHFMT4,2638,1h 39m,Sell
62043.41,110992,26.05.2010 03:29:58,sl 110.992,0.0,-343.44999999998254,0.0,0.0,111712,26.05.2010 01:00:00,5088,-0.22538032478652203,-71.73,IS,0.09,0.0,Phase3-EA-TR1v1-EURJPY-M30-91,EURJPYMT4,702,2h 29m,Buy
61848.57,1.16093,26.05.2010 04:59:58,sl 1.16093,0.0,-538.289999999979,0.0,0.0,1.15703,26.05.2010 02:15:00,5089,-0.35323911786093576,-194.84,IS,0.58,0.0,Phase3-EA-SA2v2-USDCHF-M15-107,USDCHFMT4,1046,2h 44m,Sell
61965.79,1.42877,26.05.2010 07:44:58,tp 1.42877,0.0,-421.0699999999779,0.0,0.0,1.42477,26.05.2010 04:45:00,5090,-0.2763164750556433,117.22,IS,0.34,0.0,Phase3-EA-S4v1-EURCHF-M15-221,EURCHFMT4,1226,2h 59m,Buy
61923.26,1.43521,26.05.2010 08:59:58,sl 1.43521,-0.53,-463.5999999999767,0.0,0.0,1.43821,25.05.2010 22:30:00,5091,-0.3042257055496628,-42.53,IS,0.14,0.0,Phase3-EA-B1v1-GBPUSD-M30-14,GBPUSDMT4,330,10h 29m,Buy
61879.93,111095,26.05.2010 12:59:58,sl 111.095,0.0,-506.9299999999639,0.0,0.0,111325,26.05.2010 12:00:00,5092,-0.33265991569086995,-43.33,IS,0.17,0.0,Phase3-EA-T1v2-EURJPY-M15-322,EURJPYMT4,590,59m 58s,Buy
61836.58,110.91,26.05.2010 16:44:58,sl 110.910,0.0,-550.2799999999697,0.0,0.0,110.68,26.05.2010 16:30:00,5093,-0.3611072503232693,-43.35,IS,0.17,0.0,Phase3-EA-T1v2-EURJPY-M15-322,EURJPYMT4,592,14m 58s,Sell
61875.48,1.41527,26.05.2010 22:44:58,tp 1.41527,0.0,-511.37999999997555,0.0,0.0,1.41417,26.05.2010 21:50:00,5094,-0.3355801149784015,38.9,IS,0.41,0.0,Phase3-EA-SA2v2-EURCHF-M5-43,EURCHFMT4,2640,54m 58s,Buy
61925.47,1.16013,27.05.2010 01:29:58,tp 1.16013,0.0,-461.38999999998487,0.0,0.0,1.16113,27.05.2010 00:45:00,5095,-0.3027754492742911,49.99,IS,0.58,0.0,Phase3-EA-SA2v2-USDCHF-M15-107,USDCHFMT4,1048,44m 58s,Sell
61961.93,1.41429,27.05.2010 07:09:58,tp 1.41429,-2.54,-424.929999999993,0.0,0.0,1.41319,26.05.2010 23:15:00,5096,-0.27884950185337054,36.46,IS,0.41,0.0,Phase3-EA-SA2v2-EURCHF-M5-43,EURCHFMT4,2642,7h 54m,Buy
62079.58,1.4156,27.05.2010 07:29:57,tp 1.41560,0.0,-307.27999999999884,0.0,0.0,1.4116,27.05.2010 01:45:00,5097,-0.2016446824877151,117.65,IS,0.34,0.0,Phase3-EA-S4v1-EURCHF-M15-221,EURCHFMT4,1228,5h 44m,Buy
62262.44,131113,27.05.2010 09:59:57,tp 131.113,-1.44,-124.4200000000128,0.0,0.0,129263,25.05.2010 21:30:00,5098,-0.0816474596300579,182.86,IS,0.09,0.0,Phase3-EA-B1v1-GBPJPY-M30-1,GBPJPYMT4,580,1d 12h 29m,Buy
62390.95,111392,27.05.2010 10:29:57,tp 111.392,0.0,-0.0,0.0,0.0,110102,27.05.2010 04:30:00,5099,-0.0,128.51,IS,0.09,0.0,Phase3-EA-TR1v1-EURJPY-M30-91,EURJPYMT4,704,5h 59m,Buy
62515.83,112221,27.05.2010 18:59:58,tp 112.221,0.0,-0.0,0.0,0.0,110961,27.05.2010 09:30:00,5100,-0.0,124.88,IS,0.09,0.0,Phase3-EA-TR1v1-EURJPY-M30-91,EURJPYMT4,705,9h 29m,Buy
62554.98,1.42542,27.05.2010 20:44:58,tp 1.42542,0.0,-0.0,0.0,0.0,1.42652,27.05.2010 20:35:00,5101,-0.0,39.15,IS,0.41,0.0,Phase3-EA-SA2v2-EURCHF-M5-43,EURCHFMT4,2644,9m 58s,Sell
62488.31,132211,28.05.2010 01:59:58,sl 132.211,-0.36,-66.6700000000128,0.0,0.0,132881,27.05.2010 23:30:00,5102,-0.04370227704137408,-66.67,IS,0.09,0.0,Phase3-EA-B1v1-GBPJPY-M30-1,GBPJPYMT4,582,2h 29m,Buy
62538.65,1.15207,28.05.2010 02:14:58,tp 1.15207,0.0,-16.330000000016298,0.0,0.0,1.15307,28.05.2010 02:00:00,5103,-0.01070433754441599,50.34,IS,0.58,0.0,Phase3-EA-SA2v2-USDCHF-M15-107,USDCHFMT4,1050,14m 58s,Sell
62637.16,132713,28.05.2010 02:49:58,tp 132.713,0.0,-0.0,0.0,0.0,132323,28.05.2010 01:35:00,5104,-0.0,98.51,IS,0.23,0.0,Phase3-EA-S4v1-GBPJPY-M5-194,GBPJPYMT4,1318,1h 14m,Buy
62676.23,1.42394,28.05.2010 03:24:57,tp 1.42394,0.0,-0.0,0.0,0.0,1.42504,28.05.2010 02:55:00,5105,-0.0,39.07,IS,0.41,0.0,Phase3-EA-SA2v2-EURCHF-M5-43,EURCHFMT4,2646,29m 57s,Sell
62877.29,112378,28.05.2010 05:00:00,,-0.92,-0.0,0.0,0.0,111294,27.05.2010 17:30:00,5106,-0.0,201.06,IS,0.17,0.0,Phase3-EA-T1v2-EURJPY-M15-322,EURJPYMT4,594,11h 30m,Buy
62800.27,112912,28.05.2010 09:59:58,sl 112.912,0.0,-77.01999999998952,0.0,0.0,112132,28.05.2010 03:30:00,5107,-0.05038027557918481,-77.02,IS,0.09,0.0,Phase3-EA-TR1v1-EURJPY-M30-91,EURJPYMT4,708,6h 29m,Sell
62918.1,1.4262,28.05.2010 10:29:58,tp 1.42620,0.0,-0.0,0.0,0.0,1.4222,28.05.2010 04:45:00,5108,-0.0,117.83,IS,0.34,0.0,Phase3-EA-S4v1-EURCHF-M15-221,EURCHFMT4,1230,5h 44m,Buy
62851.93,132204,28.05.2010 16:59:57,sl 132.204,0.0,-66.1700000000128,0.0,0.0,132874,28.05.2010 04:30:00,5109,-0.043271529008019866,-66.17,IS,0.09,0.0,Phase3-EA-B1v1-GBPJPY-M30-1,GBPJPYMT4,584,12h 29m,Buy
62979.78,111409,28.05.2010 21:29:58,tp 111.409,0.0,-0.0,0.0,0.0,112699,28.05.2010 15:30:00,5110,-0.0,127.85,IS,0.09,0.0,Phase3-EA-TR1v1-EURJPY-M30-91,EURJPYMT4,710,5h 59m,Sell
63018.75,1.4239,28.05.2010 22:19:58,tp 1.42390,0.0,-0.0,0.0,0.0,1.4228,28.05.2010 21:10:00,5111,-0.0,38.97,IS,0.41,0.0,Phase3-EA-SA2v2-EURCHF-M5-43,EURCHFMT4,2648,1h 9m,Buy
63066.18,1.15826,31.05.2010 01:00:00,tp 1.15826,-2.65,-0.0,0.0,0.0,1.15926,28.05.2010 23:30:00,5112,-0.0,47.43,IS,0.58,0.0,Phase3-EA-SA2v2-USDCHF-M15-107,USDCHFMT4,1052,2d 1h 30m,Sell
63104.25,1.42339,31.05.2010 01:14:57,tp 1.42339,-0.85,-0.0,0.0,0.0,1.42229,28.05.2010 23:15:00,5113,-0.0,38.07,IS,0.41,0.0,Phase3-EA-SA2v2-EURCHF-M5-43,EURCHFMT4,2650,2d 1h 59m,Buy
63143.21,1.42292,31.05.2010 03:04:59,tp 1.42292,0.0,-0.0,0.0,0.0,1.42182,31.05.2010 01:35:00,5114,-0.0,38.96,IS,0.41,0.0,Phase3-EA-SA2v2-EURCHF-M5-43,EURCHFMT4,2652,1h 29m,Buy
63086.92,132254,31.05.2010 08:55:00,,0.0,-56.29000000000815,0.0,0.0,132.03,31.05.2010 03:30:00,5115,-0.03675644516006173,-56.29,IS,0.23,0.0,Phase3-EA-S4v1-GBPJPY-M5-194,GBPJPYMT4,1320,5h 25m,Sell
62941.96,91.36,31.05.2010 10:00:00,,-1.33,-201.25,0.0,0.0,90874,28.05.2010 22:00:00,5116,-0.1314129434795053,-144.96,IS,0.27,0.0,Phase3-EA-S1v2-USDJPY-M15-0,USDJPYMT4,1760,2d 12h 0m,Sell
62995.13,1.42362,31.05.2010 10:30:00,,0.0,-148.0799999999872,0.0,0.0,1.42181,31.05.2010 01:45:00,5117,-0.09669380705810415,53.17,IS,0.34,0.0,Phase3-EA-S4v1-EURCHF-M15-221,EURCHFMT4,1232,8h 45m,Buy
63040.66,91044,01.06.2010 03:15:00,,-1.33,-102.54999999998836,0.0,0.0,91202,31.05.2010 23:15:00,5118,-0.0669634651121577,45.53,IS,0.27,0.0,Phase3-EA-S1v2-USDJPY-M15-0,USDJPYMT4,1762,4h 0m,Sell
63113.02,132289,01.06.2010 08:35:00,,0.0,-30.19000000000233,0.0,0.0,132002,01.06.2010 03:10:00,5119,-0.019713573980852526,72.36,IS,0.23,0.0,Phase3-EA-S4v1-GBPJPY-M5-194,GBPJPYMT4,1322,5h 25m,Buy
62989.12,1.41647,01.06.2010 10:40:00,,0.0,-154.0899999999965,0.0,0.0,1.41998,01.06.2010 02:20:00,5120,-0.10061823831431807,-123.9,IS,0.41,0.0,Phase3-EA-SA2v2-EURCHF-M5-43,EURCHFMT4,2654,8h 20m,Buy
63307.61,110.36,01.06.2010 11:44:58,tp 110.360,0.0,-0.0,0.0,0.0,112.06,01.06.2010 01:45:00,5121,-0.0,318.49,IS,0.17,0.0,Phase3-EA-T1v2-EURJPY-M15-322,EURJPYMT4,596,9h 59m,Sell
63423.88,1.42156,01.06.2010 13:14:58,tp 1.42156,0.0,-0.0,0.0,0.0,1.41756,01.06.2010 05:15:00,5122,-0.0,116.27,IS,0.34,0.0,Phase3-EA-S4v1-EURCHF-M15-221,EURCHFMT4,1234,7h 59m,Buy
63686.89,1.46171,01.06.2010 16:29:58,tp 1.46171,-1.59,-0.0,0.0,0.0,1.44281,27.05.2010 07:30:00,5123,-0.0,263.01,IS,0.14,0.0,Phase3-EA-B1v1-GBPUSD-M30-14,GBPUSDMT4,332,5d 8h 59m,Buy
63814.25,111.98,01.06.2010 17:29:57,tp 111.980,0.0,-0.0,0.0,0.0,110.69,01.06.2010 16:00:00,5124,-0.0,127.36,IS,0.09,0.0,Phase3-EA-TR1v1-EURJPY-M30-91,EURJPYMT4,712,1h 29m,Buy
63861.78,1.15555,02.06.2010 01:14:58,tp 1.15555,-2.66,-0.0,0.0,0.0,1.15655,01.06.2010 23:15:00,5125,-0.0,47.53,IS,0.58,0.0,Phase3-EA-SA2v2-USDCHF-M15-107,USDCHFMT4,1054,1h 59m,Sell
63835.15,91149,02.06.2010 03:45:00,,-0.86,-26.630000000004657,0.0,0.0,91236,01.06.2010 22:00:00,5126,-0.01730774205264275,-26.63,IS,0.27,0.0,Phase3-EA-S1v2-USDJPY-M15-0,USDJPYMT4,1764,5h 45m,Buy
63753.24,1.41296,02.06.2010 07:45:00,,-0.85,-108.54000000000815,0.0,0.0,1.41525,01.06.2010 23:25:00,5127,-0.07054383486269833,-81.91,IS,0.41,0.0,Phase3-EA-SA2v2-EURCHF-M5-43,EURCHFMT4,2656,8h 20m,Buy
63710.48,111604,02.06.2010 09:29:58,sl 111.604,0.0,-151.30000000001746,0.0,0.0,111834,02.06.2010 09:15:00,5128,-0.0983350121128311,-42.76,IS,0.17,0.0,Phase3-EA-T1v2-EURJPY-M15-322,EURJPYMT4,598,14m 58s,Buy
63676.64,1.41252,02.06.2010 10:00:00,,0.0,-185.14000000001397,0.0,0.0,1.41367,02.06.2010 01:15:00,5129,-0.12032877820600676,-33.84,IS,0.34,0.0,Phase3-EA-S4v1-EURCHF-M15-221,EURCHFMT4,1236,8h 45m,Buy
63715.73,1.41434,02.06.2010 23:59:58,tp 1.41434,0.0,-146.05000000001746,0.0,0.0,1.41324,02.06.2010 23:25:00,5130,-0.09492285868525474,39.09,IS,0.41,0.0,Phase3-EA-SA2v2-EURCHF-M5-43,EURCHFMT4,2658,34m 58s,Buy
63721.67,92213,03.06.2010 00:45:00,,-2.55,-140.11000000001513,0.0,0.0,92184,02.06.2010 22:00:00,5131,-0.0910622508071954,5.94,IS,0.27,0.0,Phase3-EA-S1v2-USDJPY-M15-0,USDJPYMT4,1766,2h 45m,Buy
64032.56,113343,03.06.2010 04:14:58,tp 113.343,-2.71,-0.0,0.0,0.0,111643,02.06.2010 09:30:00,5132,-0.0,310.89,IS,0.17,0.0,Phase3-EA-T1v2-EURJPY-M15-322,EURJPYMT4,600,18h 44m,Buy
63990.38,113443,03.06.2010 15:44:58,sl 113.443,0.0,-42.179999999993015,0.0,0.0,113673,03.06.2010 15:00:00,5133,-0.027383820667521878,-42.18,IS,0.17,0.0,Phase3-EA-T1v2-EURJPY-M15-322,EURJPYMT4,602,44m 58s,Buy
63925.2,135362,03.06.2010 16:59:57,sl 135.362,0.0,-107.35999999998603,0.0,0.0,136032,03.06.2010 11:30:00,5134,-0.06969954923815204,-65.18,IS,0.09,0.0,Phase3-EA-B1v1-GBPJPY-M30-1,GBPJPYMT4,586,5h 29m,Buy
64050.93,112229,03.06.2010 19:29:58,tp 112.229,0.0,-0.0,0.0,0.0,113519,03.06.2010 13:30:00,5135,-0.0,125.73,IS,0.09,0.0,Phase3-EA-TR1v1-EURJPY-M30-91,EURJPYMT4,714,5h 59m,Sell
64040.72,92581,03.06.2010 21:30:00,,0.0,-10.209999999991851,0.0,0.0,92616,03.06.2010 17:00:00,5136,-0.006627678261982486,-10.21,IS,0.27,0.0,Phase3-EA-S1v2-USDJPY-M15-0,USDJPYMT4,1768,4h 30m,Buy
64078.86,1.40761,04.06.2010 01:19:58,tp 1.40761,-0.85,-0.0,0.0,0.0,1.40651,03.06.2010 22:25:00,5137,-0.0,38.14,IS,0.41,0.0,Phase3-EA-SA2v2-EURCHF-M5-43,EURCHFMT4,2660,2h 54m,Buy
64117.87,1.40639,04.06.2010 02:14:58,tp 1.40639,0.0,-0.0,0.0,0.0,1.40749,04.06.2010 01:25:00,5138,-0.0,39.01,IS,0.41,0.0,Phase3-EA-SA2v2-EURCHF-M5-43,EURCHFMT4,2662,49m 58s,Sell
64113.64,92591,04.06.2010 03:00:00,,-1.31,-4.230000000010477,0.0,0.0,92581,03.06.2010 21:30:00,5139,-0.0027446525182384615,-4.23,IS,0.27,0.0,Phase3-EA-S1v2-USDJPY-M15-0,USDJPYMT4,1770,5h 30m,Sell
64105.97,1.4055,04.06.2010 13:00:00,,0.0,-11.900000000023283,0.0,0.0,1.40576,04.06.2010 04:15:00,5140,-0.00772136287636423,-7.67,IS,0.34,0.0,Phase3-EA-S4v1-EURCHF-M15-221,EURCHFMT4,1238,8h 45m,Buy
64155.89,1.16186,04.06.2010 22:59:58,tp 1.16186,0.0,-0.0,0.0,0.0,1.16286,04.06.2010 22:45:00,5141,-0.0,49.92,IS,0.58,0.0,Phase3-EA-SA2v2-USDCHF-M15-107,USDCHFMT4,1056,14m 58s,Sell
64194.71,1.39245,04.06.2010 23:39:58,tp 1.39245,0.0,-0.0,0.0,0.0,1.39135,04.06.2010 21:15:00,5142,-0.0,38.82,IS,0.41,0.0,Phase3-EA-SA2v2-EURCHF-M5-43,EURCHFMT4,2664,2h 24m,Buy
64311.39,91526,07.06.2010 01:59:58,tp 91.526,-1.32,-0.0,0.0,0.0,91926,04.06.2010 23:15:00,5143,-0.0,116.68,IS,0.27,0.0,Phase3-EA-S1v2-USDJPY-M15-0,USDJPYMT4,1772,2d 2h 44m,Sell
64409.28,132309,07.06.2010 02:14:57,tp 132.309,0.0,-0.0,0.0,0.0,131919,07.06.2010 02:00:00,5144,-0.0,97.89,IS,0.23,0.0,Phase3-EA-S4v1-GBPJPY-M5-194,GBPJPYMT4,1324,14m 57s,Buy
64532.58,108845,07.06.2010 03:29:58,tp 108.845,-0.34,-0.0,0.0,0.0,110105,04.06.2010 20:30:00,5145,-0.0,123.3,IS,0.09,0.0,Phase3-EA-TR1v1-EURJPY-M30-91,EURJPYMT4,716,2d 6h 59m,Sell
64418.57,1.38599,07.06.2010 03:29:58,sl 1.38599,0.0,-114.01000000000931,0.0,0.0,1.38989,07.06.2010 02:15:00,5146,-0.0737773225555474,-114.01,IS,0.34,0.0,Phase3-EA-S4v1-EURCHF-M15-221,EURCHFMT4,1240,1h 14m,Buy
64426.32,1.38987,07.06.2010 10:25:00,,0.0,-106.26000000000931,0.0,0.0,1.38965,07.06.2010 02:05:00,5147,-0.06876219888389189,7.75,IS,0.41,0.0,Phase3-EA-SA2v2-EURCHF-M5-43,EURCHFMT4,2666,8h 20m,Buy
64543.17,1.39111,07.06.2010 11:44:58,tp 1.39111,0.0,-0.0,0.0,0.0,1.38711,07.06.2010 04:00:00,5148,-0.0,116.85,IS,0.34,0.0,Phase3-EA-S4v1-EURCHF-M15-221,EURCHFMT4,1242,7h 44m,Buy
64477.34,132587,07.06.2010 12:59:58,sl 132.587,0.0,-65.8299999999872,0.0,0.0,131917,07.06.2010 02:00:00,5149,-0.042596512029607785,-65.83,IS,0.09,0.0,Phase3-EA-B1v1-GBPJPY-M30-1,GBPJPYMT4,588,10h 59m,Sell
64603.91,110116,07.06.2010 13:29:58,tp 110.116,0.0,-0.0,0.0,0.0,108826,07.06.2010 08:30:00,5150,-0.0,126.57,IS,0.09,0.0,Phase3-EA-TR1v1-EURJPY-M30-91,EURJPYMT4,718,4h 59m,Buy
64684.61,92006,07.06.2010 18:45:00,,0.0,-0.0,0.0,0.0,91731,07.06.2010 17:00:00,5151,-0.0,80.7,IS,0.27,0.0,Phase3-EA-S1v2-USDJPY-M15-0,USDJPYMT4,1774,1h 45m,Buy
64681.09,91996,07.06.2010 19:00:00,,0.0,-3.5199999999895226,0.0,0.0,92008,07.06.2010 18:45:00,5152,-0.002275598070156768,-3.52,IS,0.27,0.0,Phase3-EA-S1v2-USDJPY-M15-0,USDJPYMT4,1776,15m 0s,Buy
64778.2,132491,08.06.2010 01:29:57,tp 132.491,-0.91,-0.0,0.0,0.0,132101,07.06.2010 23:45:00,5153,-0.0,97.11,IS,0.23,0.0,Phase3-EA-S4v1-GBPJPY-M5-194,GBPJPYMT4,1326,1h 44m,Buy
64825.47,1.16219,08.06.2010 01:29:58,tp 1.16219,-2.64,-0.0,0.0,0.0,1.16319,07.06.2010 23:30:00,5154,-0.0,47.27,IS,0.58,0.0,Phase3-EA-SA2v2-USDCHF-M15-107,USDCHFMT4,1058,1h 59m,Sell
64864.27,1.38715,08.06.2010 03:29:58,tp 1.38715,0.0,-0.0,0.0,0.0,1.38605,08.06.2010 01:10:00,5155,-0.0,38.8,IS,0.41,0.0,Phase3-EA-SA2v2-EURCHF-M5-43,EURCHFMT4,2668,2h 19m,Buy
64762.39,132891,08.06.2010 07:00:00,,0.0,-101.88000000000466,0.0,0.0,132485,08.06.2010 01:35:00,5156,-0.06578664013332751,-101.88,IS,0.23,0.0,Phase3-EA-S4v1-GBPJPY-M5-194,GBPJPYMT4,1328,5h 25m,Sell
64719.61,109383,08.06.2010 11:59:57,sl 109.383,0.0,-144.6600000000035,0.0,0.0,109153,08.06.2010 11:45:00,5157,-0.09341083001263205,-42.78,IS,0.17,0.0,Phase3-EA-T1v2-EURJPY-M15-322,EURJPYMT4,604,14m 57s,Sell
64836.78,1.38483,08.06.2010 11:59:58,tp 1.38483,0.0,-27.489999999990687,0.0,0.0,1.38883,08.06.2010 05:00:00,5158,-0.017751028045391422,117.17,IS,0.34,0.0,Phase3-EA-S4v1-EURCHF-M15-221,EURCHFMT4,1244,6h 59m,Sell
64793.95,109.1,08.06.2010 22:44:58,sl 109.100,0.0,-70.31999999997788,0.0,0.0,108.87,08.06.2010 20:45:00,5159,-0.04540750426162077,-42.83,IS,0.17,0.0,Phase3-EA-T1v2-EURJPY-M15-322,EURJPYMT4,606,1h 59m,Sell
64833.06,1.37753,08.06.2010 22:54:58,tp 1.37753,0.0,-31.20999999999185,0.0,0.0,1.37863,08.06.2010 22:45:00,5160,-0.02015313151315785,39.11,IS,0.41,0.0,Phase3-EA-SA2v2-EURCHF-M5-43,EURCHFMT4,2670,9m 58s,Sell
64931.17,132009,09.06.2010 01:54:57,tp 132.009,0.0,-0.0,0.0,0.0,132399,09.06.2010 00:20:00,5161,-0.0,98.11,IS,0.23,0.0,Phase3-EA-S4v1-GBPJPY-M5-194,GBPJPYMT4,1330,1h 34m,Sell
64970.25,1.37794,09.06.2010 03:19:58,tp 1.37794,0.0,-0.0,0.0,0.0,1.37904,09.06.2010 00:05:00,5162,-0.0,39.08,IS,0.41,0.0,Phase3-EA-SA2v2-EURCHF-M5-43,EURCHFMT4,2672,3h 14m,Sell
64963.3,91297,09.06.2010 03:30:00,,-1.33,-6.9500000000116415,0.0,0.0,91278,08.06.2010 21:30:00,5163,-0.004484731746907322,-6.95,IS,0.27,0.0,Phase3-EA-S1v2-USDJPY-M15-0,USDJPYMT4,1778,6h 0m,Sell
64920.5,109281,09.06.2010 04:29:58,sl 109.281,0.0,-49.75,0.0,0.0,109051,09.06.2010 04:00:00,5164,-0.032102935886081374,-42.8,IS,0.17,0.0,Phase3-EA-T1v2-EURJPY-M15-322,EURJPYMT4,608,29m 58s,Sell
64877.59,109175,09.06.2010 22:14:57,sl 109.175,0.0,-92.66000000000349,0.0,0.0,109405,09.06.2010 13:15:00,5165,-0.05979212139104346,-42.91,IS,0.17,0.0,Phase3-EA-T1v2-EURJPY-M15-322,EURJPYMT4,610,8h 59m,Buy
64909.87,91179,10.06.2010 04:15:00,,0.0,-60.38000000000466,0.0,0.0,91288,10.06.2010 01:15:00,5166,-0.03896231696083905,32.28,IS,0.27,0.0,Phase3-EA-S1v2-USDJPY-M15-0,USDJPYMT4,1780,3h 0m,Sell
64898.36,1.37644,10.06.2010 06:25:00,,-2.57,-71.89000000001397,0.0,0.0,1.37669,09.06.2010 22:05:00,5167,-0.0463895489618259,-11.51,IS,0.41,0.0,Phase3-EA-SA2v2-EURCHF-M5-43,EURCHFMT4,2674,8h 20m,Buy
65017.3,1.3792,10.06.2010 08:59:58,tp 1.37920,0.0,-0.0,0.0,0.0,1.3752,10.06.2010 03:45:00,5168,-0.0,118.94,IS,0.34,0.0,Phase3-EA-S4v1-EURCHF-M15-221,EURCHFMT4,1246,5h 14m,Buy
64974.3,109528,10.06.2010 11:44:58,sl 109.528,0.0,-43.0,0.0,0.0,109298,10.06.2010 11:15:00,5169,-0.027738839471465455,-43.0,IS,0.17,0.0,Phase3-EA-T1v2-EURJPY-M15-322,EURJPYMT4,612,29m 58s,Sell
65013.7,1.38349,10.06.2010 20:49:58,tp 1.38349,0.0,-3.6000000000058208,0.0,0.0,1.38459,10.06.2010 20:20:00,5170,-0.002322321444126444,39.4,IS,0.41,0.0,Phase3-EA-SA2v2-EURCHF-M5-43,EURCHFMT4,2676,29m 58s,Sell
65053.15,1.38392,10.06.2010 23:24:58,tp 1.38392,0.0,-0.0,0.0,0.0,1.38502,10.06.2010 21:55:00,5171,-0.0,39.45,IS,0.41,0.0,Phase3-EA-SA2v2-EURCHF-M5-43,EURCHFMT4,2678,1h 29m,Sell
65078.89,91.36,11.06.2010 00:15:00,,-0.86,-0.0,0.0,0.0,91.27,10.06.2010 18:00:00,5172,-0.0,25.74,IS,0.27,0.0,Phase3-EA-S1v2-USDJPY-M15-0,USDJPYMT4,1782,6h 15m,Buy
65118.33,1.3842,11.06.2010 04:39:57,tp 1.38420,0.0,-0.0,0.0,0.0,1.3853,11.06.2010 02:35:00,5173,-0.0,39.44,IS,0.41,0.0,Phase3-EA-SA2v2-EURCHF-M5-43,EURCHFMT4,2680,2h 4m,Sell
65052.49,134176,11.06.2010 12:29:57,sl 134.176,0.0,-65.83999999999651,0.0,0.0,134846,11.06.2010 04:00:00,5174,-0.042445016008099454,-65.84,IS,0.09,0.0,Phase3-EA-B1v1-GBPJPY-M30-1,GBPJPYMT4,590,8h 29m,Buy
64986.54,133604,11.06.2010 16:59:58,sl 133.604,0.0,-131.79000000000815,0.0,0.0,132934,11.06.2010 16:00:00,5175,-0.08496094562132549,-65.95,IS,0.09,0.0,Phase3-EA-B1v1-GBPJPY-M30-1,GBPJPYMT4,592,59m 58s,Sell
65036.92,1.1512,11.06.2010 22:29:58,tp 1.15120,0.0,-81.41000000000349,0.0,0.0,1.1502,11.06.2010 22:00:00,5176,-0.0524825144778206,50.38,IS,0.58,0.0,Phase3-EA-SA2v2-USDCHF-M15-107,USDCHFMT4,1060,29m 58s,Buy
64838.93,1.14602,14.06.2010 01:44:58,sl 1.14602,-0.61,-279.3999999999942,0.0,0.0,1.14992,11.06.2010 23:30:00,5177,-0.18012055699670976,-197.99,IS,0.58,0.0,Phase3-EA-SA2v2-USDCHF-M15-107,USDCHFMT4,1062,2d 2h 14m,Buy
64762.05,111497,14.06.2010 02:29:58,sl 111.497,-0.34,-356.27999999999884,0.0,0.0,110717,11.06.2010 07:00:00,5178,-0.2296827202819931,-76.88,IS,0.09,0.0,Phase3-EA-TR1v1-EURJPY-M30-91,EURJPYMT4,720,2d 19h 29m,Sell
64720.13,1.39313,14.06.2010 10:00:00,,0.0,-398.20000000001164,0.0,0.0,1.39196,14.06.2010 01:40:00,5179,-0.2567072505228827,-41.92,IS,0.41,0.0,Phase3-EA-SA2v2-EURCHF-M5-43,EURCHFMT4,2682,8h 20m,Sell
64839.19,1.39044,14.06.2010 10:44:58,tp 1.39044,0.0,-279.14000000001397,0.0,0.0,1.39444,14.06.2010 03:30:00,5180,-0.17995294302099185,119.06,IS,0.34,0.0,Phase3-EA-S4v1-EURCHF-M15-221,EURCHFMT4,1248,7h 14m,Sell
65152.58,112649,14.06.2010 12:44:58,tp 112.649,-0.91,-0.0,0.0,0.0,110949,11.06.2010 23:30:00,5181,-0.0,313.39,IS,0.17,0.0,Phase3-EA-T1v2-EURJPY-M15-322,EURJPYMT4,614,2d 13h 14m,Buy
65192.08,1.39581,14.06.2010 20:14:58,tp 1.39581,0.0,-0.0,0.0,0.0,1.39691,14.06.2010 20:00:00,5182,-0.0,39.5,IS,0.41,0.0,Phase3-EA-SA2v2-EURCHF-M5-43,EURCHFMT4,2684,14m 58s,Sell
65231.63,1.39614,14.06.2010 21:59:57,tp 1.39614,0.0,-0.0,0.0,0.0,1.39504,14.06.2010 21:45:00,5183,-0.0,39.55,IS,0.41,0.0,Phase3-EA-SA2v2-EURCHF-M5-43,EURCHFMT4,2686,14m 57s,Buy
65271.11,1.39669,15.06.2010 01:39:58,tp 1.39669,0.0,-0.0,0.0,0.0,1.39559,15.06.2010 01:10:00,5184,-0.0,39.48,IS,0.41,0.0,Phase3-EA-SA2v2-EURCHF-M5-43,EURCHFMT4,2688,29m 58s,Buy
65369.03,134855,15.06.2010 04:09:57,tp 134.855,0.0,-0.0,0.0,0.0,135245,15.06.2010 03:35:00,5185,-0.0,97.92,IS,0.23,0.0,Phase3-EA-S4v1-GBPJPY-M5-194,GBPJPYMT4,1332,34m 57s,Sell
65297.71,111126,15.06.2010 09:29:58,sl 111.126,-0.48,-71.32000000000698,0.0,0.0,111846,14.06.2010 03:00:00,5186,-0.045903614124389536,-71.32,IS,0.09,0.0,Phase3-EA-TR1v1-EURJPY-M30-91,EURJPYMT4,722,1d 6h 29m,Buy
65337.06,1.39652,15.06.2010 10:39:58,tp 1.39652,0.0,-31.970000000001164,0.0,0.0,1.39542,15.06.2010 02:30:00,5187,-0.020576816370676432,39.35,IS,0.41,0.0,Phase3-EA-SA2v2-EURCHF-M5-43,EURCHFMT4,2690,8h 9m,Buy
65436.79,1.39852,15.06.2010 11:45:00,,0.0,-0.0,0.0,0.0,1.39516,15.06.2010 03:00:00,5188,-0.0,99.73,IS,0.34,0.0,Phase3-EA-S4v1-EURCHF-M15-221,EURCHFMT4,1250,8h 45m,Buy
65413.28,1.39598,16.06.2010 04:50:00,,-1.81,-23.510000000009313,0.0,0.0,1.39538,15.06.2010 20:30:00,5189,-0.01512511934916394,-23.51,IS,0.41,0.0,Phase3-EA-SA2v2-EURCHF-M5-43,EURCHFMT4,2692,8h 20m,Sell
65295.92,1.39151,16.06.2010 06:59:57,sl 1.39151,0.0,-140.86999999999534,0.0,0.0,1.39541,16.06.2010 03:30:00,5190,-0.09062847991134879,-117.36,IS,0.34,0.0,Phase3-EA-S4v1-EURCHF-M15-221,EURCHFMT4,1252,3h 29m,Buy
65422.3,113166,16.06.2010 09:59:58,tp 113.166,-0.48,-14.489999999990687,0.0,0.0,111876,15.06.2010 13:00:00,5191,-0.009322117370019473,126.38,IS,0.09,0.0,Phase3-EA-TR1v1-EURJPY-M30-91,EURJPYMT4,724,20h 59m,Buy
65379.52,112685,16.06.2010 21:14:57,sl 112.685,0.0,-57.26999999998952,0.0,0.0,112455,16.06.2010 20:30:00,5192,-0.03684455912914152,-42.78,IS,0.17,0.0,Phase3-EA-T1v2-EURJPY-M15-322,EURJPYMT4,616,44m 57s,Sell
65419.48,1.38818,16.06.2010 21:44:57,tp 1.38818,0.0,-17.30999999999767,0.0,0.0,1.38928,16.06.2010 21:25:00,5193,-0.011136359673921263,39.96,IS,0.41,0.0,Phase3-EA-SA2v2-EURCHF-M5-43,EURCHFMT4,2694,19m 57s,Sell
65458.81,91.31,16.06.2010 22:30:00,,0.0,-0.0,0.0,0.0,91443,16.06.2010 18:15:00,5194,-0.0,39.33,IS,0.27,0.0,Phase3-EA-S1v2-USDJPY-M15-0,USDJPYMT4,1784,4h 15m,Sell
65380.92,1.13101,17.06.2010 03:00:00,,-8.15,-77.89000000001397,0.0,0.0,1.12965,16.06.2010 22:45:00,5195,-0.05010330389124553,-77.89,IS,0.58,0.0,Phase3-EA-SA2v2-USDCHF-M15-107,USDCHFMT4,1064,4h 15m,Sell
65415.35,1.38904,17.06.2010 03:39:58,tp 1.38904,-5.44,-43.460000000020955,0.0,0.0,1.39014,16.06.2010 21:55:00,5196,-0.027955958237439852,34.43,IS,0.41,0.0,Phase3-EA-SA2v2-EURCHF-M5-43,EURCHFMT4,2696,5h 44m,Sell
65535.65,1.3879,17.06.2010 04:14:59,tp 1.38790,0.0,-0.0,0.0,0.0,1.3919,17.06.2010 01:15:00,5197,-0.0,120.3,IS,0.34,0.0,Phase3-EA-S4v1-EURCHF-M15-221,EURCHFMT4,1254,2h 59m,Sell
65537.41,134.3,17.06.2010 08:25:00,,0.0,-0.0,0.0,0.0,134293,17.06.2010 03:00:00,5198,-0.0,1.76,IS,0.23,0.0,Phase3-EA-S4v1-GBPJPY-M5-194,GBPJPYMT4,1334,5h 25m,Buy
65420.24,1.38454,17.06.2010 10:44:58,sl 1.38454,0.0,-117.1700000000128,0.0,0.0,1.38844,17.06.2010 05:15:00,5199,-0.07533235894825102,-117.17,IS,0.34,0.0,Phase3-EA-S4v1-EURCHF-M15-221,EURCHFMT4,1256,5h 29m,Buy
65460.78,1.37652,17.06.2010 22:04:58,tp 1.37652,0.0,-76.63000000000466,0.0,0.0,1.37762,17.06.2010 21:35:00,5200,-0.049267889956509305,40.54,IS,0.41,0.0,Phase3-EA-SA2v2-EURCHF-M5-43,EURCHFMT4,2698,29m 58s,Sell
65436.86,90874,18.06.2010 04:00:00,,-1.34,-100.55000000001746,0.0,0.0,90798,17.06.2010 21:15:00,5201,-0.06464682676663931,-23.92,IS,0.27,0.0,Phase3-EA-S1v2-USDJPY-M15-0,USDJPYMT4,1786,6h 45m,Sell
65382.59,1.11139,18.06.2010 05:00:00,,0.0,-154.82000000000698,0.0,0.0,1.11243,18.06.2010 00:45:00,5202,-0.09953875405280767,-54.27,IS,0.58,0.0,Phase3-EA-SA2v2-USDCHF-M15-107,USDCHFMT4,1066,4h 15m,Buy
65338.62,112368,18.06.2010 09:44:58,sl 112.368,-0.92,-198.79000000000815,0.0,0.0,112598,17.06.2010 23:45:00,5203,-0.1278084802878023,-43.97,IS,0.17,0.0,Phase3-EA-T1v2-EURJPY-M15-322,EURJPYMT4,618,9h 59m,Buy
65338.62,1.3763,18.06.2010 10:45:00,,0.0,-198.79000000000815,0.0,0.0,1.3763,18.06.2010 02:00:00,5204,-0.1278084802878023,0.0,IS,0.34,0.0,Phase3-EA-S4v1-EURCHF-M15-221,EURCHFMT4,1258,8h 45m,Buy
65296.62,1.48096,18.06.2010 13:29:58,sl 1.48096,0.0,-240.79000000000815,0.0,0.0,1.48396,18.06.2010 09:00:00,5205,-0.1548116302052402,-42.0,IS,0.14,0.0,Phase3-EA-B1v1-GBPUSD-M30-14,GBPUSDMT4,334,4h 29m,Buy
65337.32,1.37297,18.06.2010 23:39:58,tp 1.37297,0.0,-200.0899999999965,0.0,0.0,1.37187,18.06.2010 22:15:00,5206,-0.12864429207095363,40.7,IS,0.41,0.0,Phase3-EA-SA2v2-EURCHF-M5-43,EURCHFMT4,2700,1h 24m,Buy
65131.88,1.10443,21.06.2010 01:00:00,sl 1.10443,-0.63,-405.52999999999884,0.0,0.0,1.10833,18.06.2010 23:15:00,5207,-0.26072827109567986,-205.44,IS,0.58,0.0,Phase3-EA-SA2v2-USDCHF-M15-107,USDCHFMT4,1068,2d 1h 45m,Buy
65230.96,134564,21.06.2010 04:19:58,tp 134.564,0.0,-306.45000000001164,0.0,0.0,134174,21.06.2010 01:35:00,5208,-0.19702655457617033,99.08,IS,0.23,0.0,Phase3-EA-S4v1-GBPJPY-M5-194,GBPJPYMT4,1336,2h 44m,Buy
65277.12,1.37264,21.06.2010 11:15:00,,0.0,-260.29000000000815,0.0,0.0,1.37114,21.06.2010 02:30:00,5209,-0.16734880695262208,46.16,IS,0.34,0.0,Phase3-EA-S4v1-EURCHF-M15-221,EURCHFMT4,1260,8h 45m,Buy
65457.2,135958,21.06.2010 12:29:58,tp 135.958,-2.48,-80.21000000002095,0.0,0.0,134108,14.06.2010 06:00:00,5210,-0.05156958702091092,180.08,IS,0.09,0.0,Phase3-EA-B1v1-GBPJPY-M30-1,GBPJPYMT4,594,7d 6h 29m,Buy
65378.5,113402,21.06.2010 12:29:58,sl 113.402,-1.73,-158.9100000000326,0.0,0.0,112622,16.06.2010 11:00:00,5211,-0.10216834650906986,-78.7,IS,0.09,0.0,Phase3-EA-TR1v1-EURJPY-M30-91,EURJPYMT4,726,5d 1h 29m,Sell
65335.67,112948,21.06.2010 17:44:57,sl 112.948,0.0,-201.7400000000198,0.0,0.0,113178,21.06.2010 17:15:00,5212,-0.12970513010343937,-42.83,IS,0.17,0.0,Phase3-EA-T1v2-EURJPY-M15-322,EURJPYMT4,620,29m 57s,Buy
65264.53,112295,21.06.2010 19:59:58,sl 112.295,0.0,-272.88000000003376,0.0,0.0,113015,21.06.2010 08:30:00,5213,-0.175443322606461,-71.14,IS,0.09,0.0,Phase3-EA-TR1v1-EURJPY-M30-91,EURJPYMT4,727,11h 29m,Buy
65305.03,1.37108,21.06.2010 22:54:57,tp 1.37108,0.0,-232.38000000003376,0.0,0.0,1.36998,21.06.2010 20:35:00,5214,-0.14940457090036016,40.5,IS,0.41,0.0,Phase3-EA-SA2v2-EURCHF-M5-43,EURCHFMT4,2702,2h 19m,Buy
65357.31,1.10934,22.06.2010 02:59:58,tp 1.10934,0.0,-180.10000000003492,0.0,0.0,1.10834,22.06.2010 02:45:00,5215,-0.11579207857455967,52.28,IS,0.58,0.0,Phase3-EA-SA2v2-USDCHF-M15-107,USDCHFMT4,1070,14m 58s,Buy
65455.84,134594,22.06.2010 04:29:58,tp 134.594,0.0,-81.57000000003609,0.0,0.0,134204,22.06.2010 03:15:00,5216,-0.05244397473253292,98.53,IS,0.23,0.0,Phase3-EA-S4v1-GBPJPY-M5-194,GBPJPYMT4,1338,1h 14m,Buy
65387.68,91069,22.06.2010 04:30:00,,-0.86,-149.73000000003958,0.0,0.0,91296,21.06.2010 17:30:00,5217,-0.09626622945569151,-68.16,IS,0.27,0.0,Phase3-EA-S1v2-USDJPY-M15-0,USDJPYMT4,1788,11h 0m,Buy
65352.62,1.36734,22.06.2010 10:00:00,,0.0,-184.79000000003725,0.0,0.0,1.36829,22.06.2010 01:40:00,5218,-0.11880743031534173,-35.06,IS,0.41,0.0,Phase3-EA-SA2v2-EURCHF-M5-43,EURCHFMT4,2704,8h 20m,Buy
65233.12,1.36345,22.06.2010 11:44:57,sl 1.36345,0.0,-304.29000000003725,0.0,0.0,1.36735,22.06.2010 03:00:00,5219,-0.19563782115186143,-119.5,IS,0.34,0.0,Phase3-EA-S4v1-EURCHF-M15-221,EURCHFMT4,1262,8h 44m,Buy
65285.54,1.10638,22.06.2010 22:29:58,tp 1.10638,0.0,-251.87000000002445,0.0,0.0,1.10738,22.06.2010 22:00:00,5220,-0.16193531832632715,52.42,IS,0.58,0.0,Phase3-EA-SA2v2-USDCHF-M15-107,USDCHFMT4,1072,29m 58s,Sell
65325.33,1.36011,23.06.2010 05:04:58,tp 1.36011,-0.89,-212.0800000000163,0.0,0.0,1.35901,22.06.2010 21:15:00,5221,-0.13635304844025398,39.79,IS,0.41,0.0,Phase3-EA-SA2v2-EURCHF-M5-43,EURCHFMT4,2706,7h 49m,Buy
65424.43,134.24,23.06.2010 05:54:58,tp 134.240,0.0,-112.98000000001048,0.0,0.0,133.85,23.06.2010 03:05:00,5222,-0.07263847327791464,99.1,IS,0.23,0.0,Phase3-EA-S4v1-GBPJPY-M5-194,GBPJPYMT4,1340,2h 49m,Buy
65346.16,110668,23.06.2010 14:59:58,sl 110.668,-0.49,-191.25,0.0,0.0,111448,22.06.2010 16:30:00,5223,-0.12296077194547608,-78.27,IS,0.09,0.0,Phase3-EA-TR1v1-EURJPY-M30-91,EURJPYMT4,730,22h 29m,Buy
65333.28,1.36084,23.06.2010 15:00:00,,0.0,-204.13000000000466,0.0,0.0,1.36042,23.06.2010 06:15:00,5224,-0.13124173792016003,-12.88,IS,0.34,0.0,Phase3-EA-S4v1-EURCHF-M15-221,EURCHFMT4,1264,8h 45m,Sell
65385.8,89972,23.06.2010 21:30:00,,0.0,-151.61000000001513,0.0,0.0,90147,23.06.2010 20:15:00,5225,-0.09747494188055159,52.52,IS,0.27,0.0,Phase3-EA-S1v2-USDJPY-M15-0,USDJPYMT4,1790,1h 15m,Sell
65426.7,1.35898,23.06.2010 21:44:59,tp 1.35898,0.0,-110.71000000002095,0.0,0.0,1.36008,23.06.2010 21:40:00,5226,-0.07117901731809795,40.9,IS,0.41,0.0,Phase3-EA-SA2v2-EURCHF-M5-43,EURCHFMT4,2708,4m 59s,Sell
65461.94,1.35909,24.06.2010 00:14:57,tp 1.35909,-5.57,-75.47000000003027,0.0,0.0,1.36019,23.06.2010 22:45:00,5227,-0.048522088673091775,35.24,IS,0.41,0.0,Phase3-EA-SA2v2-EURCHF-M5-43,EURCHFMT4,2710,1h 29m,Sell
65584.84,1.35711,24.06.2010 11:44:58,tp 1.35711,0.0,-0.0,0.0,0.0,1.36111,24.06.2010 04:00:00,5228,-0.0,122.9,IS,0.34,0.0,Phase3-EA-S4v1-EURCHF-M15-221,EURCHFMT4,1266,7h 44m,Sell
65504.99,109758,24.06.2010 13:59:58,sl 109.758,-1.47,-79.85000000000582,0.0,0.0,110538,23.06.2010 21:00:00,5229,-0.05132248103350293,-79.85,IS,0.09,0.0,Phase3-EA-TR1v1-EURJPY-M30-91,EURJPYMT4,732,16h 59m,Buy
65432.41,110388,24.06.2010 18:59:58,sl 110.388,0.0,-152.42999999999302,0.0,0.0,109668,24.06.2010 14:00:00,5230,-0.09797227030602283,-72.58,IS,0.09,0.0,Phase3-EA-TR1v1-EURJPY-M30-91,EURJPYMT4,734,4h 59m,Sell
65475.36,89.26,24.06.2010 20:00:00,,0.0,-109.47999999998137,0.0,0.0,89402,24.06.2010 19:00:00,5231,-0.07036675295612443,42.95,IS,0.27,0.0,Phase3-EA-S1v2-USDJPY-M15-0,USDJPYMT4,1792,1h 0m,Sell
65516.28,1.36017,24.06.2010 23:59:58,tp 1.36017,0.0,-68.55999999996857,0.0,0.0,1.35907,24.06.2010 22:25:00,5232,-0.04406598997689532,40.92,IS,0.41,0.0,Phase3-EA-SA2v2-EURCHF-M5-43,EURCHFMT4,2712,1h 34m,Buy
65566.14,1.1017,25.06.2010 00:14:57,tp 1.10170,-2.79,-18.699999999982538,0.0,0.0,1.1027,24.06.2010 22:00:00,5233,-0.012019165877589714,49.86,IS,0.58,0.0,Phase3-EA-SA2v2-USDCHF-M15-107,USDCHFMT4,1074,2h 14m,Sell
65607.08,1.35969,25.06.2010 03:04:58,tp 1.35969,0.0,-0.0,0.0,0.0,1.35859,25.06.2010 01:05:00,5234,-0.0,40.94,IS,0.41,0.0,Phase3-EA-SA2v2-EURCHF-M5-43,EURCHFMT4,2714,1h 59m,Buy
65486.91,1.35417,25.06.2010 12:14:58,sl 1.35417,0.0,-120.1700000000128,0.0,0.0,1.35807,25.06.2010 06:15:00,5235,-0.07722656321294177,-120.17,IS,0.34,0.0,Phase3-EA-S4v1-EURCHF-M15-221,EURCHFMT4,1268,5h 59m,Buy
65749.38,1.50226,25.06.2010 20:59:58,tp 1.50226,-2.13,-0.0,0.0,0.0,1.48336,23.06.2010 06:00:00,5236,-0.0,262.47,IS,0.14,0.0,Phase3-EA-B1v1-GBPUSD-M30-14,GBPUSDMT4,336,2d 14h 59m,Buy
65785.38,89254,25.06.2010 22:30:00,,0.0,-0.0,0.0,0.0,89373,25.06.2010 20:45:00,5237,-0.0,36.0,IS,0.27,0.0,Phase3-EA-S1v2-USDJPY-M15-0,USDJPYMT4,1794,1h 45m,Sell
65817.71,1.35063,28.06.2010 04:20:00,,-1.88,-0.0,0.0,0.0,1.35154,25.06.2010 20:00:00,5238,-0.0,32.33,IS,0.41,0.0,Phase3-EA-SA2v2-EURCHF-M5-43,EURCHFMT4,2716,2d 8h 20m,Sell
65870.81,1.09222,28.06.2010 06:29:58,tp 1.09222,0.0,-0.0,0.0,0.0,1.09122,28.06.2010 02:45:00,5239,-0.0,53.1,IS,0.58,0.0,Phase3-EA-SA2v2-USDCHF-M15-107,USDCHFMT4,1076,3h 44m,Buy
65749.3,1.34711,28.06.2010 10:44:58,sl 1.34711,0.0,-121.51000000000931,0.0,0.0,1.35101,28.06.2010 03:45:00,5240,-0.07795558385820245,-121.51,IS,0.34,0.0,Phase3-EA-S4v1-EURCHF-M15-221,EURCHFMT4,1270,6h 59m,Buy
65756.85,89379,29.06.2010 04:00:00,,0.0,-113.96000000002095,0.0,0.0,89354,29.06.2010 00:15:00,5241,-0.0731118289563139,7.55,IS,0.27,0.0,Phase3-EA-S1v2-USDJPY-M15-0,USDJPYMT4,1796,3h 45m,Buy
65747.27,1.33548,29.06.2010 05:15:00,,-0.91,-123.54000000000815,0.0,0.0,1.33571,28.06.2010 20:55:00,5242,-0.07925794444771811,-9.58,IS,0.41,0.0,Phase3-EA-SA2v2-EURCHF-M5-43,EURCHFMT4,2718,8h 20m,Buy
66067.71,109211,29.06.2010 06:29:57,tp 109.211,-3.99,-0.0,0.0,0.0,110911,23.06.2010 13:45:00,5243,-0.0,320.44,IS,0.17,0.0,Phase3-EA-T1v2-EURJPY-M15-322,EURJPYMT4,622,5d 16h 44m,Sell
65988.69,108.97,29.06.2010 07:29:58,sl 108.970,0.0,-79.01999999998952,0.0,0.0,109.75,29.06.2010 05:00:00,5244,-0.05063186997489076,-79.02,IS,0.09,0.0,Phase3-EA-TR1v1-EURJPY-M30-91,EURJPYMT4,736,2h 29m,Buy
66116.56,107405,29.06.2010 17:29:58,tp 107.405,0.0,-0.0,0.0,0.0,108665,29.06.2010 08:30:00,5245,-0.0,127.87,IS,0.09,0.0,Phase3-EA-TR1v1-EURJPY-M30-91,EURJPYMT4,738,8h 59m,Sell
66158.27,1.31977,29.06.2010 21:49:57,tp 1.31977,0.0,-0.0,0.0,0.0,1.32087,29.06.2010 21:30:00,5246,-0.0,41.71,IS,0.41,0.0,Phase3-EA-SA2v2-EURCHF-M5-43,EURCHFMT4,2720,19m 57s,Sell
66211.9,1.08157,29.06.2010 23:14:58,tp 1.08157,0.0,-0.0,0.0,0.0,1.08057,29.06.2010 22:15:00,5247,-0.0,53.63,IS,0.58,0.0,Phase3-EA-SA2v2-USDCHF-M15-107,USDCHFMT4,1078,59m 58s,Buy
66253.61,1.31893,29.06.2010 23:19:59,tp 1.31893,0.0,-0.0,0.0,0.0,1.31783,29.06.2010 22:25:00,5248,-0.0,41.71,IS,0.41,0.0,Phase3-EA-SA2v2-EURCHF-M5-43,EURCHFMT4,2722,54m 59s,Buy
66354.83,133111,30.06.2010 03:29:58,tp 133.111,0.0,-0.0,0.0,0.0,133501,30.06.2010 02:15:00,5249,-0.0,101.22,IS,0.23,0.0,Phase3-EA-S4v1-GBPJPY-M5-194,GBPJPYMT4,1342,1h 14m,Sell
66365.35,88541,30.06.2010 04:00:00,,-1.37,-0.0,0.0,0.0,88.58,29.06.2010 21:15:00,5250,-0.0,10.52,IS,0.27,0.0,Phase3-EA-S1v2-USDJPY-M15-0,USDJPYMT4,1798,6h 45m,Sell
66321.17,108079,30.06.2010 05:14:58,sl 108.079,0.0,-44.179999999993015,0.0,0.0,107849,30.06.2010 04:00:00,5251,-0.028254341514915585,-44.18,IS,0.17,0.0,Phase3-EA-T1v2-EURJPY-M15-322,EURJPYMT4,624,1h 14m,Sell
66198.61,1.32507,30.06.2010 09:44:58,sl 1.32507,0.0,-166.7399999999907,0.0,0.0,1.32117,30.06.2010 06:15:00,5252,-0.10663487786775705,-122.56,IS,0.34,0.0,Phase3-EA-S4v1-EURCHF-M15-221,EURCHFMT4,1272,3h 29m,Sell
66009.5,1.31437,01.07.2010 03:54:57,sl 1.31437,-2.74,-355.8499999999767,0.0,0.0,1.31927,30.06.2010 21:50:00,5253,-0.2275759942979548,-189.11,IS,0.41,0.0,Phase3-EA-SA2v2-EURCHF-M5-43,EURCHFMT4,2724,6h 4m,Buy
66110.97,131934,01.07.2010 04:24:58,tp 131.934,0.0,-254.37999999997555,0.0,0.0,132324,01.07.2010 03:15:00,5254,-0.16268310082762952,101.47,IS,0.23,0.0,Phase3-EA-S4v1-GBPJPY-M5-194,GBPJPYMT4,1344,1h 9m,Sell
66297.03,131508,01.07.2010 04:59:58,tp 131.508,-2.36,-68.31999999997788,0.0,0.0,133358,29.06.2010 11:00:00,5255,-0.04369254441599622,186.06,IS,0.09,0.0,Phase3-EA-B1v1-GBPJPY-M30-1,GBPJPYMT4,596,1d 17h 59m,Sell
66423.61,1.31412,01.07.2010 08:29:57,tp 1.31412,0.0,-0.0,0.0,0.0,1.31012,01.07.2010 05:45:00,5256,-0.0,126.58,IS,0.34,0.0,Phase3-EA-S4v1-EURCHF-M15-221,EURCHFMT4,1274,2h 44m,Buy
66350.2,108844,01.07.2010 13:29:58,sl 108.844,0.0,-73.41000000000349,0.0,0.0,108.77,30.06.2010 17:30:00,5257,-0.04693025560527823,-73.41,IS,0.09,0.0,Phase3-EA-TR1v1-EURJPY-M30-91,EURJPYMT4,740,19h 59m,Sell
66392.68,1.32807,01.07.2010 22:44:57,tp 1.32807,0.0,-30.929999999993015,0.0,0.0,1.32697,01.07.2010 22:05:00,5258,-0.019773229885177206,42.48,IS,0.41,0.0,Phase3-EA-SA2v2-EURCHF-M5-43,EURCHFMT4,2726,39m 57s,Buy
66311.33,109.55,01.07.2010 22:59:58,sl 109.550,-1.07,-112.27999999999884,0.0,0.0,108124,01.07.2010 00:30:00,5259,-0.0717794455709077,-81.35,IS,0.09,0.0,Phase3-EA-TR1v1-EURJPY-M30-91,EURJPYMT4,741,22h 29m,Sell
66097.55,1.05809,01.07.2010 22:59:58,sl 1.05809,0.0,-326.0599999999977,0.0,0.0,1.06199,01.07.2010 22:15:00,5260,-0.208446793933472,-213.78,IS,0.58,0.0,Phase3-EA-SA2v2-USDCHF-M15-107,USDCHFMT4,1080,44m 58s,Buy
66140.13,1.32686,01.07.2010 23:14:57,tp 1.32686,0.0,-283.4800000000105,0.0,0.0,1.32576,01.07.2010 22:55:00,5261,-0.18122583924511826,42.58,IS,0.41,0.0,Phase3-EA-SA2v2-EURCHF-M5-43,EURCHFMT4,2728,19m 57s,Buy
66182.68,1.32714,02.07.2010 01:14:57,tp 1.32714,0.0,-240.93000000002212,0.0,0.0,1.32604,02.07.2010 00:25:00,5262,-0.15402406324724402,42.55,IS,0.41,0.0,Phase3-EA-SA2v2-EURCHF-M5-43,EURCHFMT4,2730,49m 57s,Buy
66164.91,133388,02.07.2010 09:05:00,,0.0,-258.70000000001164,0.0,0.0,133.32,02.07.2010 03:40:00,5263,-0.1653842409083973,-17.77,IS,0.23,0.0,Phase3-EA-S4v1-GBPJPY-M5-194,GBPJPYMT4,1346,5h 25m,Sell
66090.41,87898,02.07.2010 10:45:00,,-1.39,-333.20000000001164,0.0,0.0,87.66,01.07.2010 19:45:00,5264,-0.2130113222677906,-74.5,IS,0.27,0.0,Phase3-EA-S1v2-USDJPY-M15-0,USDJPYMT4,1800,15h 0m,Sell
66010.35,110707,02.07.2010 16:59:58,sl 110.707,0.0,-413.2600000000093,0.0,0.0,109927,02.07.2010 09:00:00,5265,-0.2641928542628633,-80.06,IS,0.09,0.0,Phase3-EA-TR1v1-EURJPY-M30-91,EURJPYMT4,744,7h 59m,Sell
66052.56,1.33741,02.07.2010 23:19:58,tp 1.33741,0.0,-371.05000000001746,0.0,0.0,1.33631,02.07.2010 20:00:00,5266,-0.23720843675709682,42.21,IS,0.41,0.0,Phase3-EA-SA2v2-EURCHF-M5-43,EURCHFMT4,2732,3h 19m,Buy
66106.98,1.06586,02.07.2010 23:29:57,tp 1.06586,0.0,-316.63000000000466,0.0,0.0,1.06486,02.07.2010 22:15:00,5267,-0.20241829222583785,54.42,IS,0.58,0.0,Phase3-EA-SA2v2-USDCHF-M15-107,USDCHFMT4,1082,1h 14m,Buy
66061.48,110082,05.07.2010 02:14:58,sl 110.082,-0.95,-362.13000000000466,0.0,0.0,110312,02.07.2010 22:45:00,5268,-0.23150597278761495,-45.5,IS,0.17,0.0,Phase3-EA-T1v2-EURJPY-M15-322,EURJPYMT4,626,2d 3h 29m,Buy
66115.3,1.06456,05.07.2010 02:59:58,tp 1.06456,-0.66,-308.3099999999977,0.0,0.0,1.06356,02.07.2010 23:45:00,5269,-0.19709940206596557,53.82,IS,0.58,0.0,Phase3-EA-SA2v2-USDCHF-M15-107,USDCHFMT4,1084,2d 3h 14m,Buy
66068.91,1.33481,05.07.2010 07:55:00,,-0.93,-354.70000000001164,0.0,0.0,1.33599,02.07.2010 23:35:00,5270,-0.22675605044533362,-46.39,IS,0.41,0.0,Phase3-EA-SA2v2-EURCHF-M5-43,EURCHFMT4,2734,2d 8h 20m,Buy
66044.78,87.84,05.07.2010 10:45:00,,-1.38,-378.8300000000163,0.0,0.0,87766,02.07.2010 17:00:00,5271,-0.2421821104883186,-24.13,IS,0.27,0.0,Phase3-EA-S1v2-USDJPY-M15-0,USDJPYMT4,1802,2d 17h 45m,Sell
66000.27,110026,05.07.2010 10:59:57,sl 110.026,0.0,-423.3400000000256,0.0,0.0,110256,05.07.2010 05:30:00,5272,-0.270636894264252,-44.51,IS,0.17,0.0,Phase3-EA-T1v2-EURJPY-M15-322,EURJPYMT4,628,5h 29m,Buy
66040.7,1.33413,06.07.2010 01:19:58,tp 1.33413,-1.93,-382.9100000000326,0.0,0.0,1.33523,05.07.2010 20:45:00,5273,-0.24479041239364882,40.43,IS,0.41,0.0,Phase3-EA-SA2v2-EURCHF-M5-43,EURCHFMT4,2736,4h 34m,Sell
66094.49,1.0653,06.07.2010 02:29:58,tp 1.06530,-0.65,-329.12000000002445,0.0,0.0,1.0643,05.07.2010 22:45:00,5274,-0.210403020362479,53.79,IS,0.58,0.0,Phase3-EA-SA2v2-USDCHF-M15-107,USDCHFMT4,1086,3h 44m,Buy
65884.15,131842,06.07.2010 03:49:57,sl 131.842,0.0,-539.460000000021,0.0,0.0,132642,06.07.2010 02:05:00,5275,-0.34487121221663497,-210.34,IS,0.23,0.0,Phase3-EA-S4v1-GBPJPY-M5-194,GBPJPYMT4,1348,1h 44m,Buy
65938.64,1.06439,06.07.2010 04:44:57,tp 1.06439,0.0,-484.97000000003027,0.0,0.0,1.06539,06.07.2010 02:45:00,5276,-0.3100363174076028,54.49,IS,0.58,0.0,Phase3-EA-SA2v2-USDCHF-M15-107,USDCHFMT4,1088,1h 59m,Sell
65894.0,109962,06.07.2010 07:59:58,sl 109.962,0.0,-529.6100000000442,0.0,0.0,109732,06.07.2010 02:15:00,5277,-0.3385742088422871,-44.64,IS,0.17,0.0,Phase3-EA-T1v2-EURJPY-M15-322,EURJPYMT4,630,5h 44m,Sell
65704.13,1.32864,06.07.2010 09:34:58,sl 1.32864,0.0,-719.4800000000396,0.0,0.0,1.33354,06.07.2010 02:35:00,5278,-0.459956140892056,-189.87,IS,0.41,0.0,Phase3-EA-SA2v2-EURCHF-M5-43,EURCHFMT4,2738,6h 59m,Buy
65832.86,1.33389,06.07.2010 10:29:58,tp 1.33389,0.0,-590.7500000000291,0.0,0.0,1.32989,06.07.2010 06:00:00,5279,-0.37766038004111374,128.73,IS,0.34,0.0,Phase3-EA-S4v1-EURCHF-M15-221,EURCHFMT4,1276,4h 29m,Buy
65874.53,1.33818,07.07.2010 00:44:57,tp 1.33818,-0.93,-549.0800000000163,0.0,0.0,1.33708,06.07.2010 21:30:00,5280,-0.3510211789639791,41.67,IS,0.41,0.0,Phase3-EA-SA2v2-EURCHF-M5-43,EURCHFMT4,2740,3h 14m,Buy
65860.48,87.47,07.07.2010 04:15:00,,-1.39,-563.1300000000047,0.0,0.0,87429,06.07.2010 22:00:00,5281,-0.36000319900557537,-14.05,IS,0.27,0.0,Phase3-EA-S1v2-USDJPY-M15-0,USDJPYMT4,1804,6h 15m,Sell
65799.86,1.06201,07.07.2010 06:45:00,,0.0,-623.75,0.0,0.0,1.0609,07.07.2010 02:30:00,5282,-0.398756939569417,-60.62,IS,0.58,0.0,Phase3-EA-SA2v2-USDCHF-M15-107,USDCHFMT4,1090,4h 15m,Sell
65842.28,1.33748,07.07.2010 07:24:58,tp 1.33748,0.0,-581.3299999999872,0.0,0.0,1.33858,07.07.2010 02:25:00,5283,-0.37163827123027504,42.42,IS,0.41,0.0,Phase3-EA-SA2v2-EURCHF-M5-43,EURCHFMT4,2742,4h 59m,Sell
65767.56,109866,07.07.2010 09:59:57,sl 109.866,-0.5,-656.0499999999884,0.0,0.0,110586,06.07.2010 11:30:00,5284,-0.4194059963198579,-74.72,IS,0.09,0.0,Phase3-EA-TR1v1-EURJPY-M30-91,EURJPYMT4,746,22h 29m,Buy
65698.41,132692,07.07.2010 17:59:58,sl 132.692,0.0,-725.1999999999825,0.0,0.0,132022,07.07.2010 09:30:00,5285,-0.4636128778769286,-69.15,IS,0.09,0.0,Phase3-EA-B1v1-GBPJPY-M30-1,GBPJPYMT4,598,8h 29m,Sell
65624.1,110281,07.07.2010 17:59:58,sl 110.281,0.0,-799.5099999999802,0.0,0.0,109561,07.07.2010 11:30:00,5286,-0.5111184941966119,-74.31,IS,0.09,0.0,Phase3-EA-TR1v1-EURJPY-M30-91,EURJPYMT4,748,6h 29m,Sell
65666.99,1.32949,07.07.2010 21:34:58,tp 1.32949,0.0,-756.6199999999662,0.0,0.0,1.33059,07.07.2010 21:20:00,5287,-0.4836993597066113,42.89,IS,0.41,0.0,Phase3-EA-SA2v2-EURCHF-M5-43,EURCHFMT4,2744,14m 58s,Sell
65559.14,133654,08.07.2010 04:25:00,,-4.56,-864.4699999999721,0.0,0.0,133259,07.07.2010 23:00:00,5288,-0.552646751983267,-107.85,IS,0.23,0.0,Phase3-EA-S4v1-GBPJPY-M5-194,GBPJPYMT4,1350,5h 25m,Sell
65602.09,1.3294,08.07.2010 04:29:59,tp 1.32940,0.0,-821.5199999999604,0.0,0.0,1.3283,08.07.2010 01:20:00,5289,-0.5251892601123073,42.95,IS,0.41,0.0,Phase3-EA-SA2v2-EURCHF-M5-43,EURCHFMT4,2746,3h 9m,Buy
65731.41,1.33097,08.07.2010 06:14:58,tp 1.33097,0.0,-692.1999999999534,0.0,0.0,1.32697,08.07.2010 03:15:00,5290,-0.4425163183485882,129.32,IS,0.34,0.0,Phase3-EA-S4v1-EURCHF-M15-221,EURCHFMT4,1278,2h 59m,Buy
65774.39,1.33168,08.07.2010 22:44:58,tp 1.33168,0.0,-649.219999999943,0.0,0.0,1.33058,08.07.2010 21:50:00,5291,-0.41503964778714897,42.98,IS,0.41,0.0,Phase3-EA-SA2v2-EURCHF-M5-43,EURCHFMT4,2748,54m 58s,Buy
65775.03,88414,09.07.2010 01:15:00,,-0.89,-648.579999999929,0.0,0.0,88409,08.07.2010 21:00:00,5292,-0.4146305023902271,0.64,IS,0.27,0.0,Phase3-EA-S1v2-USDJPY-M15-0,USDJPYMT4,1806,4h 15m,Buy
65766.08,1.04923,09.07.2010 02:30:00,,-0.66,-657.5299999999406,0.0,0.0,1.04938,08.07.2010 22:15:00,5293,-0.42035214505018853,-8.95,IS,0.58,0.0,Phase3-EA-SA2v2-USDCHF-M15-107,USDCHFMT4,1092,4h 15m,Buy
65746.6,134201,09.07.2010 08:10:00,,0.0,-677.0099999999511,0.0,0.0,134126,09.07.2010 02:45:00,5294,-0.43280550806873186,-19.48,IS,0.23,0.0,Phase3-EA-S4v1-GBPJPY-M5-194,GBPJPYMT4,1352,5h 25m,Sell
65620.52,1.33742,09.07.2010 11:14:58,sl 1.33742,0.0,-803.0899999999383,0.0,0.0,1.33352,09.07.2010 05:30:00,5295,-0.5134071512605667,-126.08,IS,0.34,0.0,Phase3-EA-S4v1-EURCHF-M15-221,EURCHFMT4,1280,5h 44m,Sell
65663.15,1.33718,09.07.2010 20:29:58,tp 1.33718,0.0,-760.4599999999336,0.0,0.0,1.33828,09.07.2010 20:05:00,5296,-0.48615423208806796,42.63,IS,0.41,0.0,Phase3-EA-SA2v2-EURCHF-M5-43,EURCHFMT4,2750,24m 58s,Sell
65718.07,1.05613,09.07.2010 22:29:58,tp 1.05613,0.0,-705.5399999999208,0.0,0.0,1.05513,09.07.2010 22:15:00,5297,-0.4510444427154708,54.92,IS,0.58,0.0,Phase3-EA-SA2v2-USDCHF-M15-107,USDCHFMT4,1094,14m 58s,Buy
65527.06,1.33095,12.07.2010 04:54:57,sl 1.33095,-0.93,-896.5499999999302,0.0,0.0,1.33585,09.07.2010 22:05:00,5298,-0.5731551650034997,-191.01,IS,0.41,0.0,Phase3-EA-SA2v2-EURCHF-M5-43,EURCHFMT4,2752,2d 6h 49m,Buy
65458.4,132.84,12.07.2010 09:59:57,sl 132.840,-0.74,-965.2099999999336,0.0,0.0,133.51,08.07.2010 03:30:00,5299,-0.617048794616065,-68.66,IS,0.09,0.0,Phase3-EA-B1v1-GBPJPY-M30-1,GBPJPYMT4,600,4d 6h 29m,Buy
65384.33,111131,12.07.2010 13:29:58,sl 111.131,-1.0,-1039.2799999999406,0.0,0.0,111851,08.07.2010 05:30:00,5300,-0.6644009814119118,-74.07,IS,0.09,0.0,Phase3-EA-TR1v1-EURJPY-M30-91,EURJPYMT4,750,4d 7h 59m,Buy
65439.01,1.06073,12.07.2010 22:59:58,tp 1.06073,0.0,-984.5999999999476,0.0,0.0,1.05973,12.07.2010 22:15:00,5301,-0.6294446215631697,54.68,IS,0.58,0.0,Phase3-EA-SA2v2-USDCHF-M15-107,USDCHFMT4,1096,44m 58s,Buy
65481.55,1.33557,12.07.2010 22:59:58,tp 1.33557,0.0,-942.0599999999395,0.0,0.0,1.33447,12.07.2010 22:10:00,5302,-0.6022492384621095,42.54,IS,0.41,0.0,Phase3-EA-SA2v2-EURCHF-M5-43,EURCHFMT4,2754,49m 58s,Buy
65582.76,133104,13.07.2010 06:19:57,tp 133.104,0.0,-840.8499999999476,0.0,0.0,133494,13.07.2010 03:35:00,5303,-0.5375467296784343,101.21,IS,0.23,0.0,Phase3-EA-S4v1-GBPJPY-M5-194,GBPJPYMT4,1354,2h 44m,Sell
65625.18,1.3345,13.07.2010 09:24:58,tp 1.33450,0.0,-798.4299999999348,0.0,0.0,1.3356,13.07.2010 01:50:00,5304,-0.5104280613392924,42.42,IS,0.41,0.0,Phase3-EA-SA2v2-EURCHF-M5-43,EURCHFMT4,2756,7h 34m,Sell
65753.24,1.33329,13.07.2010 10:29:58,tp 1.33329,0.0,-670.3699999999371,0.0,0.0,1.33729,13.07.2010 04:45:00,5305,-0.4285606245757515,128.06,IS,0.34,0.0,Phase3-EA-S4v1-EURCHF-M15-221,EURCHFMT4,1282,5h 44m,Sell
65673.34,110713,13.07.2010 11:29:57,sl 110.713,-0.5,-750.2699999999313,0.0,0.0,111493,12.07.2010 22:00:00,5306,-0.47963987022159377,-79.9,IS,0.09,0.0,Phase3-EA-TR1v1-EURJPY-M30-91,EURJPYMT4,752,13h 29m,Buy
65629.96,1.51663,13.07.2010 17:29:58,sl 1.51663,-1.38,-793.649999999936,0.0,0.0,1.51363,09.07.2010 15:00:00,5307,-0.5073722566560999,-43.38,IS,0.14,0.0,Phase3-EA-B1v1-GBPUSD-M30-14,GBPUSDMT4,338,4d 2h 29m,Sell
65690.57,88202,13.07.2010 17:45:00,,0.0,-733.0399999999499,0.0,0.0,88.4,13.07.2010 17:00:00,5308,-0.4686249089890909,60.61,IS,0.27,0.0,Phase3-EA-S1v2-USDJPY-M15-0,USDJPYMT4,1808,45m 0s,Sell
65483.72,135656,14.07.2010 03:19:58,sl 135.656,0.0,-939.8899999999558,0.0,0.0,134856,14.07.2010 02:10:00,5309,-0.6008619798507121,-206.85,IS,0.23,0.0,Phase3-EA-S4v1-GBPJPY-M5-194,GBPJPYMT4,1356,1h 9m,Sell
65584.61,135102,14.07.2010 04:19:58,tp 135.102,0.0,-838.9999999999418,0.0,0.0,135492,14.07.2010 03:35:00,5310,-0.5363640437654792,100.89,IS,0.23,0.0,Phase3-EA-S4v1-GBPJPY-M5-194,GBPJPYMT4,1358,44m 58s,Sell
65458.45,1.34414,14.07.2010 06:10:00,,-1.95,-965.1599999999453,0.0,0.0,1.34094,13.07.2010 21:50:00,5311,-0.6170168301319385,-126.16,IS,0.41,0.0,Phase3-EA-SA2v2-EURCHF-M5-43,EURCHFMT4,2758,8h 20m,Sell
65332.92,1.34589,14.07.2010 09:14:57,sl 1.34589,0.0,-1090.6899999999441,0.0,0.0,1.34199,14.07.2010 01:00:00,5312,-0.6972668639983088,-125.53,IS,0.34,0.0,Phase3-EA-S4v1-EURCHF-M15-221,EURCHFMT4,1284,8h 14m,Sell
65264.85,134754,14.07.2010 15:29:58,sl 134.754,0.0,-1158.759999999951,0.0,0.0,135424,14.07.2010 06:30:00,5313,-0.7407833126980972,-68.07,IS,0.09,0.0,Phase3-EA-B1v1-GBPJPY-M30-1,GBPJPYMT4,602,8h 59m,Buy
65191.59,112095,14.07.2010 16:29:57,sl 112.095,0.0,-1232.0199999999604,0.0,0.0,112815,14.07.2010 00:30:00,5314,-0.7876176748509777,-73.26,IS,0.09,0.0,Phase3-EA-TR1v1-EURJPY-M30-91,EURJPYMT4,754,15h 59m,Buy
65147.41,112751,14.07.2010 19:59:58,sl 112.751,0.0,-1276.1999999999534,0.0,0.0,112981,14.07.2010 19:00:00,5315,-0.8158614930316175,-44.18,IS,0.17,0.0,Phase3-EA-T1v2-EURJPY-M15-322,EURJPYMT4,632,59m 58s,Buy
65208.24,88325,14.07.2010 20:45:00,,0.0,-1215.3699999999662,0.0,0.0,88524,14.07.2010 18:30:00,5316,-0.776973501634419,60.83,IS,0.27,0.0,Phase3-EA-S1v2-USDJPY-M15-0,USDJPYMT4,1810,2h 15m,Sell
65163.95,112627,14.07.2010 23:29:58,sl 112.627,0.0,-1259.6599999999744,0.0,0.0,112397,14.07.2010 21:15:00,5317,-0.8052876416801629,-44.29,IS,0.17,0.0,Phase3-EA-T1v2-EURJPY-M15-322,EURJPYMT4,634,2h 14m,Sell
65219.0,1.05358,15.07.2010 03:59:58,tp 1.05358,0.0,-1204.609999999986,0.0,0.0,1.05258,15.07.2010 00:15:00,5318,-0.7700947446488334,55.05,IS,0.58,0.0,Phase3-EA-SA2v2-USDCHF-M15-107,USDCHFMT4,1098,3h 44m,Buy
65174.75,112692,15.07.2010 05:14:59,sl 112.692,0.0,-1248.859999999986,0.0,0.0,112462,15.07.2010 02:00:00,5319,-0.798383313107265,-44.25,IS,0.17,0.0,Phase3-EA-T1v2-EURJPY-M15-322,EURJPYMT4,636,3h 14m,Sell
65047.14,1.34021,15.07.2010 05:35:00,,-2.8,-1376.469999999972,0.0,0.0,1.34341,14.07.2010 21:15:00,5320,-0.879963069513594,-127.61,IS,0.41,0.0,Phase3-EA-SA2v2-EURCHF-M5-43,EURCHFMT4,2760,8h 20m,Buy
65061.21,134777,15.07.2010 06:40:00,,0.0,-1362.399999999965,0.0,0.0,134723,15.07.2010 01:15:00,5321,-0.8709682636783324,14.07,IS,0.23,0.0,Phase3-EA-S4v1-GBPJPY-M5-194,GBPJPYMT4,1360,5h 25m,Buy
65130.25,1.34195,15.07.2010 10:00:00,,0.0,-1293.359999999957,0.0,0.0,1.33981,15.07.2010 01:15:00,5322,-0.8268317039863471,69.04,IS,0.34,0.0,Phase3-EA-S4v1-EURCHF-M15-221,EURCHFMT4,1286,8h 45m,Buy
65173.51,1.34525,15.07.2010 21:49:57,tp 1.34525,0.0,-1250.0999999999476,0.0,0.0,1.34635,15.07.2010 20:30:00,5323,-0.7991760323137592,43.26,IS,0.41,0.0,Phase3-EA-SA2v2-EURCHF-M5-43,EURCHFMT4,2762,1h 19m,Sell
65204.11,87.35,15.07.2010 23:30:00,,0.0,-1219.4999999999418,0.0,0.0,87449,15.07.2010 22:00:00,5324,-0.779613768023857,30.6,IS,0.27,0.0,Phase3-EA-S1v2-USDJPY-M15-0,USDJPYMT4,1812,1h 30m,Sell
65247.43,1.34672,15.07.2010 23:49:58,tp 1.34672,0.0,-1176.1799999999348,0.0,0.0,1.34782,15.07.2010 23:15:00,5325,-0.7519197389703101,43.32,IS,0.41,0.0,Phase3-EA-SA2v2-EURCHF-M5-43,EURCHFMT4,2764,34m 58s,Sell
65096.62,134235,16.07.2010 06:45:00,,0.0,-1326.9899999999325,0.0,0.0,134806,16.07.2010 01:20:00,5326,-0.8483310160147395,-150.81,IS,0.23,0.0,Phase3-EA-S4v1-GBPJPY-M5-194,GBPJPYMT4,1362,5h 25m,Buy
65139.87,1.34767,16.07.2010 07:14:58,tp 1.34767,0.0,-1283.7399999999325,0.0,0.0,1.34657,16.07.2010 02:10:00,5327,-0.8206817372389843,43.25,IS,0.41,0.0,Phase3-EA-SA2v2-EURCHF-M5-43,EURCHFMT4,2766,5h 4m,Buy
65182.78,1.35824,16.07.2010 23:29:58,tp 1.35824,0.0,-1240.829999999929,0.0,0.0,1.35934,16.07.2010 22:00:00,5328,-0.7932498169553368,42.91,IS,0.41,0.0,Phase3-EA-SA2v2-EURCHF-M5-43,EURCHFMT4,2768,1h 29m,Sell
65225.79,1354,19.07.2010 01:34:58,tp 1.35400,0.0,-1197.8199999999197,0.0,0.0,1.3529,19.07.2010 01:10:00,5329,-0.7657539677034181,43.01,IS,0.41,0.0,Phase3-EA-SA2v2-EURCHF-M5-43,EURCHFMT4,2770,24m 58s,Buy
65257.77,86.54,19.07.2010 02:15:00,,-1.4,-1165.8399999999092,0.0,0.0,86647,16.07.2010 19:45:00,5330,-0.7453094836514195,31.98,IS,0.27,0.0,Phase3-EA-S1v2-USDJPY-M15-0,USDJPYMT4,1814,2d 6h 30m,Sell
65387.45,1.35837,19.07.2010 10:44:58,tp 1.35837,0.0,-1036.1599999999162,0.0,0.0,1.35437,19.07.2010 02:15:00,5331,-0.6624063976019458,129.68,IS,0.34,0.0,Phase3-EA-S4v1-EURCHF-M15-221,EURCHFMT4,1288,8h 29m,Buy
65341.71,112703,19.07.2010 11:14:57,sl 112.703,-0.69,-1081.8999999999069,0.0,0.0,112473,16.07.2010 16:00:00,5332,-0.6916475076875593,-45.74,IS,0.17,0.0,Phase3-EA-T1v2-EURJPY-M15-322,EURJPYMT4,638,2d 19h 14m,Sell
65384.55,1.36351,19.07.2010 21:09:58,tp 1.36351,0.0,-1039.0599999999104,0.0,0.0,1.36241,19.07.2010 20:20:00,5333,-0.6642603376817037,42.84,IS,0.41,0.0,Phase3-EA-SA2v2-EURCHF-M5-43,EURCHFMT4,2772,49m 58s,Buy
65332.92,86805,19.07.2010 23:15:00,,0.0,-1090.689999999915,0.0,0.0,86971,19.07.2010 17:00:00,5334,-0.6972668639982902,-51.63,IS,0.27,0.0,Phase3-EA-S1v2-USDJPY-M15-0,USDJPYMT4,1816,6h 15m,Buy
65355.8,86727,20.07.2010 00:15:00,,-1.4,-1067.8099999999104,0.0,0.0,86805,19.07.2010 23:15:00,5335,-0.6826399160586507,22.88,IS,0.27,0.0,Phase3-EA-S1v2-USDJPY-M15-0,USDJPYMT4,1818,1h 0m,Sell
65396.64,1.36376,20.07.2010 02:14:59,tp 1.36376,-1.94,-1026.9699999999139,0.0,0.0,1.36486,19.07.2010 21:45:00,5336,-0.656531325418148,40.84,IS,0.41,0.0,Phase3-EA-SA2v2-EURCHF-M5-43,EURCHFMT4,2774,4h 29m,Sell
65439.42,1.36514,20.07.2010 04:04:59,tp 1.36514,0.0,-984.189999999915,0.0,0.0,1.36404,20.07.2010 02:20:00,5337,-0.6291825127932515,42.78,IS,0.41,0.0,Phase3-EA-SA2v2-EURCHF-M5-43,EURCHFMT4,2776,1h 44m,Buy
65572.28,113128,20.07.2010 09:29:58,tp 113.128,-0.51,-851.329999999929,0.0,0.0,111838,19.07.2010 07:30:00,5338,-0.5442464855528713,132.86,IS,0.09,0.0,Phase3-EA-TR1v1-EURJPY-M30-91,EURJPYMT4,756,1d 1h 59m,Buy
65470.59,1.35696,21.07.2010 05:50:00,,-1.95,-953.0199999999313,0.0,0.0,1.3544,20.07.2010 21:30:00,5339,-0.6092558533842379,-101.69,IS,0.41,0.0,Phase3-EA-SA2v2-EURCHF-M5-43,EURCHFMT4,2778,8h 20m,Sell
65414.34,133146,21.07.2010 09:00:00,,0.0,-1009.2699999999313,0.0,0.0,133359,21.07.2010 03:35:00,5340,-0.6452158980347865,-56.25,IS,0.23,0.0,Phase3-EA-S4v1-GBPJPY-M5-194,GBPJPYMT4,1364,5h 25m,Buy
65314.63,1.33944,22.07.2010 05:40:00,,-2.81,-1108.9799999999232,0.0,0.0,1.34192,21.07.2010 21:20:00,5341,-0.7089594722944471,-99.71,IS,0.41,0.0,Phase3-EA-SA2v2-EURCHF-M5-43,EURCHFMT4,2780,8h 20m,Buy
65239.75,111131,22.07.2010 11:59:57,sl 111.131,0.0,-1183.8599999999278,0.0,0.0,110411,22.07.2010 06:30:00,5342,-0.7568294837332604,-74.88,IS,0.09,0.0,Phase3-EA-TR1v1-EURJPY-M30-91,EURJPYMT4,758,5h 29m,Sell
65112.46,1.33449,22.07.2010 12:29:58,sl 1.33449,0.0,-1311.149999999936,0.0,0.0,1.33839,22.07.2010 04:15:00,5343,-0.8382046674411472,-127.29,IS,0.34,0.0,Phase3-EA-S4v1-EURCHF-M15-221,EURCHFMT4,1290,8h 14m,Buy
65155.74,1.34351,22.07.2010 21:39:57,tp 1.34351,0.0,-1267.8699999999371,0.0,0.0,1.34461,22.07.2010 21:10:00,5344,-0.8105362099749125,43.28,IS,0.41,0.0,Phase3-EA-SA2v2-EURCHF-M5-43,EURCHFMT4,2782,29m 57s,Sell
65198.97,1.34395,22.07.2010 22:44:58,tp 1.34395,0.0,-1224.6399999999267,0.0,0.0,1.34505,22.07.2010 22:20:00,5345,-0.7828997169928041,43.23,IS,0.41,0.0,Phase3-EA-SA2v2-EURCHF-M5-43,EURCHFMT4,2784,24m 58s,Sell
65248.57,87151,23.07.2010 01:45:00,,-0.9,-1175.0399999999208,0.0,0.0,86988,22.07.2010 22:30:00,5346,-0.75119094873205,49.6,IS,0.27,0.0,Phase3-EA-S1v2-USDJPY-M15-0,USDJPYMT4,1820,3h 15m,Buy
65351.79,132526,23.07.2010 04:54:58,tp 132.526,0.0,-1071.8199999999197,0.0,0.0,132916,23.07.2010 01:50:00,5347,-0.6852034676861891,103.22,IS,0.23,0.0,Phase3-EA-S4v1-GBPJPY-M5-194,GBPJPYMT4,1366,3h 4m,Sell
65279.96,1.34637,23.07.2010 09:55:00,,0.0,-1143.6499999999069,0.0,0.0,1.34454,23.07.2010 01:35:00,5348,-0.7311236455928283,-71.83,IS,0.41,0.0,Phase3-EA-SA2v2-EURCHF-M5-43,EURCHFMT4,2786,8h 20m,Sell
65307.65,1.34411,23.07.2010 10:45:00,,0.0,-1115.9599999999045,0.0,0.0,1.34496,23.07.2010 02:00:00,5349,-0.7134217142795166,27.69,IS,0.34,0.0,Phase3-EA-S4v1-EURCHF-M15-221,EURCHFMT4,1292,8h 45m,Sell
65226.9,112668,23.07.2010 11:59:58,sl 112.668,0.0,-1196.7099999999045,0.0,0.0,111888,23.07.2010 05:30:00,5350,-0.7650443561556376,-80.75,IS,0.09,0.0,Phase3-EA-TR1v1-EURJPY-M30-91,EURJPYMT4,760,6h 29m,Sell
65182.19,112297,23.07.2010 16:14:58,sl 112.297,0.0,-1241.4199999998964,0.0,0.0,112527,23.07.2010 11:15:00,5351,-0.7936269978680951,-44.71,IS,0.17,0.0,Phase3-EA-T1v2-EURJPY-M15-322,EURJPYMT4,640,4h 59m,Buy
65188.99,87326,23.07.2010 19:15:00,,0.0,-1234.619999999908,0.0,0.0,87304,23.07.2010 18:30:00,5352,-0.7892798280259029,6.8,IS,0.27,0.0,Phase3-EA-S1v2-USDJPY-M15-0,USDJPYMT4,1822,45m 0s,Buy
64998.33,1.36116,23.07.2010 23:24:58,sl 1.36116,0.0,-1425.2799999999115,0.0,0.0,1.35626,23.07.2010 20:30:00,5353,-0.9111667989249914,-190.66,IS,0.41,0.0,Phase3-EA-SA2v2-EURCHF-M5-43,EURCHFMT4,2788,2h 54m,Sell
65041.12,1.35854,26.07.2010 01:14:57,tp 1.35854,0.0,-1382.4899999999034,0.0,0.0,1.35964,26.07.2010 01:00:00,5354,-0.8838115934032621,42.79,IS,0.41,0.0,Phase3-EA-SA2v2-EURCHF-M5-43,EURCHFMT4,2790,14m 57s,Sell
64995.45,112577,26.07.2010 01:29:57,sl 112.577,-0.95,-1428.1599999999162,0.0,0.0,112807,23.07.2010 21:30:00,5355,-0.9130079532111024,-45.67,IS,0.17,0.0,Phase3-EA-T1v2-EURJPY-M15-322,EURJPYMT4,642,2d 3h 59m,Buy
65028.56,135.14,26.07.2010 08:30:00,,0.0,-1395.0499999999302,0.0,0.0,135266,26.07.2010 03:05:00,5356,-0.8918410718176951,33.11,IS,0.23,0.0,Phase3-EA-S4v1-GBPJPY-M5-194,GBPJPYMT4,1368,5h 25m,Sell
65292.63,1.54793,26.07.2010 09:29:58,tp 1.54793,-0.53,-1130.9799999999232,0.0,0.0,1.52903,23.07.2010 09:30:00,5357,-0.7230238453133284,264.07,IS,0.14,0.0,Phase3-EA-B1v1-GBPUSD-M30-14,GBPUSDMT4,340,2d 23h 59m,Buy
65373.64,1.35866,26.07.2010 12:30:00,,0.0,-1049.9699999999139,0.0,0.0,1.36117,26.07.2010 03:45:00,5358,-0.6712349881197056,81.01,IS,0.34,0.0,Phase3-EA-S4v1-EURCHF-M15-221,EURCHFMT4,1294,8h 45m,Sell
65424.58,86918,26.07.2010 20:00:00,,0.0,-999.0299999999115,0.0,0.0,87082,26.07.2010 17:00:00,5359,-0.6386695716841674,50.94,IS,0.27,0.0,Phase3-EA-S1v2-USDJPY-M15-0,USDJPYMT4,1824,3h 0m,Sell
65455.04,86867,27.07.2010 03:15:00,,0.0,-968.5699999999197,0.0,0.0,86965,27.07.2010 00:45:00,5360,-0.6191968079498488,30.46,IS,0.27,0.0,Phase3-EA-S1v2-USDJPY-M15-0,USDJPYMT4,1826,2h 30m,Sell
65383.12,1.36394,27.07.2010 04:45:00,,-1.96,-1040.4899999999325,0.0,0.0,1.36215,26.07.2010 20:25:00,5361,-0.6651745219279451,-71.92,IS,0.41,0.0,Phase3-EA-SA2v2-EURCHF-M5-43,EURCHFMT4,2792,8h 20m,Sell
65256.68,1.36674,27.07.2010 10:14:58,sl 1.36674,0.0,-1166.9299999999348,0.0,0.0,1.36284,27.07.2010 02:30:00,5362,-0.7460063094055531,-126.44,IS,0.34,0.0,Phase3-EA-S4v1-EURCHF-M15-221,EURCHFMT4,1296,7h 44m,Sell
65176.06,113885,27.07.2010 14:29:58,sl 113.885,-0.36,-1247.5499999999302,0.0,0.0,113105,26.07.2010 10:00:00,5363,-0.7975458436229231,-80.62,IS,0.09,0.0,Phase3-EA-TR1v1-EURJPY-M30-91,EURJPYMT4,762,1d 4h 29m,Sell
65365.31,136854,27.07.2010 20:59:58,tp 136.854,-0.37,-1058.2999999999302,0.0,0.0,135004,26.07.2010 02:00:00,5364,-0.6765602711764107,189.25,IS,0.09,0.0,Phase3-EA-B1v1-GBPJPY-M30-1,GBPJPYMT4,604,1d 18h 59m,Buy
65407.86,1.37795,27.07.2010 22:24:58,tp 1.37795,0.0,-1015.7499999999418,0.0,0.0,1.37685,27.07.2010 22:05:00,5365,-0.6493584951785364,42.55,IS,0.41,0.0,Phase3-EA-SA2v2-EURCHF-M5-43,EURCHFMT4,2794,19m 58s,Buy
65424.15,1.06067,28.07.2010 02:30:00,,-0.66,-999.4599999999336,0.0,0.0,1.06036,27.07.2010 22:15:00,5366,-0.6389444662477324,16.29,IS,0.58,0.0,Phase3-EA-SA2v2-USDCHF-M15-107,USDCHFMT4,1100,4h 15m,Buy
65416.81,87852,28.07.2010 06:45:00,,-0.89,-1006.7999999999302,0.0,0.0,87873,27.07.2010 23:45:00,5367,-0.643636852518575,-7.34,IS,0.27,0.0,Phase3-EA-S1v2-USDJPY-M15-0,USDJPYMT4,1828,7h 0m,Buy
65347.68,136323,28.07.2010 15:59:57,sl 136.323,-0.37,-1075.9299999999348,0.0,0.0,136993,27.07.2010 22:30:00,5368,-0.6878309482819989,-69.13,IS,0.09,0.0,Phase3-EA-B1v1-GBPJPY-M30-1,GBPJPYMT4,606,17h 29m,Buy
65383.46,87.54,28.07.2010 20:45:00,,0.0,-1040.149999999936,0.0,0.0,87656,28.07.2010 19:30:00,5369,-0.6649571634358373,35.78,IS,0.27,0.0,Phase3-EA-S1v2-USDJPY-M15-0,USDJPYMT4,1830,1h 15m,Sell
65409.07,87517,28.07.2010 21:30:00,,0.0,-1014.5399999999499,0.0,0.0,87.6,28.07.2010 21:15:00,5370,-0.6485849546625032,25.61,IS,0.27,0.0,Phase3-EA-S1v2-USDJPY-M15-0,USDJPYMT4,1832,15m 0s,Sell
65426.36,87459,28.07.2010 21:45:00,,0.0,-997.2499999999418,0.0,0.0,87515,28.07.2010 21:30:00,5371,-0.6375316360490226,17.29,IS,0.27,0.0,Phase3-EA-S1v2-USDJPY-M15-0,USDJPYMT4,1834,15m 0s,Sell
65426.03,1.05662,29.07.2010 03:30:00,,-1.98,-997.579999999929,0.0,0.0,1.05659,28.07.2010 23:15:00,5372,-0.6377426016442976,-0.33,IS,0.58,0.0,Phase3-EA-SA2v2-USDCHF-M15-107,USDCHFMT4,1102,4h 15m,Buy
65465.89,1.37406,29.07.2010 04:54:57,tp 1.37406,-2.79,-957.719999999943,0.0,0.0,1.37296,28.07.2010 21:45:00,5373,-0.6122605148928245,39.86,IS,0.41,0.0,Phase3-EA-SA2v2-EURCHF-M5-43,EURCHFMT4,2796,7h 9m,Buy
65595.4,1.36985,29.07.2010 12:44:58,tp 1.36985,0.0,-828.2099999999336,0.0,0.0,1.37385,29.07.2010 05:15:00,5374,-0.5294661080893954,129.51,IS,0.34,0.0,Phase3-EA-S4v1-EURCHF-M15-221,EURCHFMT4,1298,7h 29m,Sell
65553.4,1.56074,29.07.2010 14:59:58,sl 1.56074,0.0,-870.2099999999336,0.0,0.0,1.56374,29.07.2010 11:30:00,5375,-0.556316274761805,-42.0,IS,0.14,0.0,Phase3-EA-B1v1-GBPUSD-M30-14,GBPUSDMT4,342,3h 29m,Buy
65508.53,113721,29.07.2010 15:44:59,sl 113.721,0.0,-915.079999999929,0.0,0.0,113491,29.07.2010 15:30:00,5376,-0.585001202823493,-44.87,IS,0.17,0.0,Phase3-EA-T1v2-EURJPY-M15-322,EURJPYMT4,644,14m 59s,Sell
65463.65,113659,29.07.2010 18:14:58,sl 113.659,0.0,-959.9599999999336,0.0,0.0,113889,29.07.2010 15:45:00,5377,-0.6136925237820138,-44.88,IS,0.17,0.0,Phase3-EA-T1v2-EURJPY-M15-322,EURJPYMT4,646,2h 29m,Buy
65544.8,86843,29.07.2010 18:30:00,,0.0,-878.8099999999395,0.0,0.0,87104,29.07.2010 17:00:00,5378,-0.561814166032826,81.15,IS,0.27,0.0,Phase3-EA-S1v2-USDJPY-M15-0,USDJPYMT4,1836,1h 30m,Sell
65600.54,1.04053,29.07.2010 22:44:57,tp 1.04053,0.0,-823.0699999999488,0.0,0.0,1.04153,29.07.2010 22:15:00,5379,-0.5261801591204482,55.74,IS,0.58,0.0,Phase3-EA-SA2v2-USDCHF-M15-107,USDCHFMT4,1104,29m 57s,Sell
65641.91,1.3605,30.07.2010 00:29:57,tp 1.36050,-1.97,-781.6999999999534,0.0,0.0,1.3616,29.07.2010 20:55:00,5380,-0.49973274494812775,41.37,IS,0.41,0.0,Phase3-EA-SA2v2-EURCHF-M5-43,EURCHFMT4,2798,3h 34m,Sell
65699.01,86768,30.07.2010 01:45:00,,-1.4,-724.5999999999476,0.0,0.0,86956,29.07.2010 23:30:00,5381,-0.46322930406730045,57.1,IS,0.27,0.0,Phase3-EA-S1v2-USDJPY-M15-0,USDJPYMT4,1838,2h 15m,Sell
65754.75,1.04057,30.07.2010 03:29:58,tp 1.04057,0.0,-668.8599999999569,0.0,0.0,1.03957,30.07.2010 02:30:00,5382,-0.4275952971549228,55.74,IS,0.58,0.0,Phase3-EA-SA2v2-USDCHF-M15-107,USDCHFMT4,1106,59m 58s,Buy
65541.71,134593,30.07.2010 05:59:57,sl 134.593,0.0,-881.8999999999651,0.0,0.0,135393,30.07.2010 01:40:00,5383,-0.5637895711523125,-213.04,IS,0.23,0.0,Phase3-EA-S4v1-GBPJPY-M5-194,GBPJPYMT4,1370,4h 19m,Buy
65674.46,112751,30.07.2010 05:59:58,tp 112.751,-1.44,-749.1499999999651,0.0,0.0,114041,28.07.2010 02:00:00,5384,-0.47892386577701773,132.75,IS,0.09,0.0,Phase3-EA-TR1v1-EURJPY-M30-91,EURJPYMT4,764,2d 3h 59m,Sell
65717.8,1.36043,30.07.2010 09:04:57,tp 1.36043,0.0,-705.8099999999686,0.0,0.0,1.35933,30.07.2010 02:30:00,5385,-0.45121705092982395,43.34,IS,0.41,0.0,Phase3-EA-SA2v2-EURCHF-M5-43,EURCHFMT4,2800,6h 34m,Buy
65848.47,1.36167,30.07.2010 09:29:58,tp 1.36167,0.0,-575.1399999999558,0.0,0.0,1.35767,30.07.2010 04:15:00,5386,-0.3676810680944879,130.67,IS,0.34,0.0,Phase3-EA-S4v1-EURCHF-M15-221,EURCHFMT4,1300,5h 14m,Buy
65767.0,112434,30.07.2010 10:59:58,sl 112.434,0.0,-656.6099999999569,0.0,0.0,113214,30.07.2010 10:00:00,5387,-0.41976399854213664,-81.47,IS,0.09,0.0,Phase3-EA-TR1v1-EURJPY-M30-91,EURJPYMT4,766,59m 58s,Buy
65810.36,1.35871,30.07.2010 21:09:58,tp 1.35871,0.0,-613.2499999999709,0.0,0.0,1.35761,30.07.2010 21:00:00,5388,-0.39204439790129597,43.36,IS,0.41,0.0,Phase3-EA-SA2v2-EURCHF-M5-43,EURCHFMT4,2802,9m 58s,Buy
65853.67,1.35867,30.07.2010 23:44:57,tp 1.35867,0.0,-569.9399999999732,0.0,0.0,1.35757,30.07.2010 23:05:00,5389,-0.3643567617445817,43.31,IS,0.41,0.0,Phase3-EA-SA2v2-EURCHF-M5-43,EURCHFMT4,2804,39m 57s,Buy
65726.61,1.36543,02.08.2010 10:44:58,sl 1.36543,0.0,-696.9999999999709,0.0,0.0,1.36153,02.08.2010 04:30:00,5390,-0.44558490882544616,-127.06,IS,0.34,0.0,Phase3-EA-S4v1-EURCHF-M15-221,EURCHFMT4,1302,6h 14m,Sell
65860.29,113612,02.08.2010 16:29:58,tp 113.612,-0.51,-563.3199999999779,0.0,0.0,112322,30.07.2010 16:00:00,5391,-0.3601246640452668,133.68,IS,0.09,0.0,Phase3-EA-TR1v1-EURJPY-M30-91,EURJPYMT4,768,3d 0h 29m,Buy
65901.74,1.36818,03.08.2010 00:19:58,tp 1.36818,-1.97,-521.8699999999662,0.0,0.0,1.36928,02.08.2010 20:40:00,5392,-0.3336261066983217,41.45,IS,0.41,0.0,Phase3-EA-SA2v2-EURCHF-M5-43,EURCHFMT4,2806,3h 39m,Sell
65910.67,1.03901,03.08.2010 04:45:00,,0.0,-512.9399999999732,0.0,0.0,1.03885,03.08.2010 00:30:00,5393,-0.32791724983202575,8.93,IS,0.58,0.0,Phase3-EA-SA2v2-USDCHF-M15-107,USDCHFMT4,1108,4h 15m,Buy
66014.44,137184,03.08.2010 04:54:57,tp 137.184,0.0,-409.1699999999837,0.0,0.0,137574,03.08.2010 01:55:00,5394,-0.26157815946070034,103.77,IS,0.23,0.0,Phase3-EA-S4v1-GBPJPY-M5-194,GBPJPYMT4,1372,2h 59m,Sell
66034.91,86435,03.08.2010 05:00:00,,-1.4,-388.69999999998254,0.0,0.0,86505,02.08.2010 21:15:00,5395,-0.2484918996563133,20.47,IS,0.27,0.0,Phase3-EA-S1v2-USDJPY-M15-0,USDJPYMT4,1840,7h 45m,Sell
66166.09,1.37207,03.08.2010 11:59:57,tp 1.37207,0.0,-257.5199999999895,0.0,0.0,1.36807,03.08.2010 04:15:00,5396,-0.16462987908282498,131.18,IS,0.34,0.0,Phase3-EA-S4v1-EURCHF-M15-221,EURCHFMT4,1304,7h 44m,Buy
66095.53,136838,03.08.2010 11:59:58,sl 136.838,-0.37,-328.0799999999872,0.0,0.0,137508,02.08.2010 17:30:00,5397,-0.2097381590924717,-70.56,IS,0.09,0.0,Phase3-EA-B1v1-GBPJPY-M30-1,GBPJPYMT4,608,18h 29m,Buy
66050.05,113662,03.08.2010 13:44:58,sl 113.662,0.0,-373.5599999999977,0.0,0.0,113892,03.08.2010 12:45:00,5398,-0.23881305386060198,-45.48,IS,0.17,0.0,Phase3-EA-T1v2-EURJPY-M15-322,EURJPYMT4,648,59m 58s,Buy
66085.29,85803,03.08.2010 17:15:00,,0.0,-338.320000000007,0.0,0.0,85915,03.08.2010 17:00:00,5399,-0.2162844854430909,35.24,IS,0.27,0.0,Phase3-EA-S1v2-USDJPY-M15-0,USDJPYMT4,1842,15m 0s,Sell
66065.18,1.37509,04.08.2010 06:20:00,,-1.97,-358.429999999993,0.0,0.0,1.37463,03.08.2010 22:00:00,5400,-0.22914060096170477,-20.11,IS,0.41,0.0,Phase3-EA-SA2v2-EURCHF-M5-43,EURCHFMT4,2808,8h 20m,Sell
65960.49,136093,04.08.2010 09:15:00,,0.0,-463.11999999999534,0.0,0.0,136482,04.08.2010 03:50:00,5401,-0.2960678378411007,-104.69,IS,0.23,0.0,Phase3-EA-S4v1-GBPJPY-M5-194,GBPJPYMT4,1374,5h 25m,Buy
66003.35,1.38461,04.08.2010 21:49:57,tp 1.38461,0.0,-420.2600000000093,0.0,0.0,1.38571,04.08.2010 20:20:00,5402,-0.26866788204159825,42.86,IS,0.41,0.0,Phase3-EA-SA2v2-EURCHF-M5-43,EURCHFMT4,2810,1h 29m,Sell
66016.27,86304,05.08.2010 00:45:00,,-2.72,-407.3399999999965,0.0,0.0,86254,04.08.2010 23:15:00,5403,-0.2604082593414107,12.92,IS,0.27,0.0,Phase3-EA-S1v2-USDJPY-M15-0,USDJPYMT4,1844,1h 30m,Buy
66120.26,136961,05.08.2010 04:34:58,tp 136.961,0.0,-303.3500000000058,0.0,0.0,137351,05.08.2010 03:25:00,5404,-0.19392852523989573,103.99,IS,0.23,0.0,Phase3-EA-S4v1-GBPJPY-M5-194,GBPJPYMT4,1376,1h 9m,Sell
66157.73,86119,05.08.2010 04:45:00,,-4.23,-265.88000000000466,0.0,0.0,86252,04.08.2010 23:15:00,5405,-0.16997434083000953,37.47,IS,0.27,0.0,Phase3-EA-S1v2-USDJPY-M15-0,USDJPYMT4,1845,5h 30m,Sell
66286.95,1.38283,05.08.2010 09:59:58,tp 1.38283,0.0,-136.6600000000035,0.0,0.0,1.38683,05.08.2010 04:00:00,5406,-0.08736532803456179,129.22,IS,0.34,0.0,Phase3-EA-S4v1-EURCHF-M15-221,EURCHFMT4,1306,5h 59m,Sell
66241.47,113326,05.08.2010 16:29:58,sl 113.326,0.0,-182.14000000001397,0.0,0.0,113556,05.08.2010 12:00:00,5407,-0.11644022280269208,-45.48,IS,0.17,0.0,Phase3-EA-T1v2-EURJPY-M15-322,EURJPYMT4,650,4h 29m,Buy
66285.25,85716,05.08.2010 22:15:00,,0.0,-138.36000000001513,0.0,0.0,85855,05.08.2010 21:30:00,5408,-0.08845212049511915,43.78,IS,0.27,0.0,Phase3-EA-S1v2-USDJPY-M15-0,USDJPYMT4,1848,45m 0s,Sell
66328.36,1.37875,05.08.2010 22:34:58,tp 1.37875,0.0,-95.2500000000291,0.0,0.0,1.37985,05.08.2010 21:10:00,5409,-0.060892342274947615,43.11,IS,0.41,0.0,Phase3-EA-SA2v2-EURCHF-M5-43,EURCHFMT4,2812,1h 24m,Sell
66329.91,1.04616,06.08.2010 03:30:00,,-0.67,-93.70000000004075,0.0,0.0,1.04612,05.08.2010 23:15:00,5410,-0.0599014432668066,1.55,IS,0.58,0.0,Phase3-EA-SA2v2-USDCHF-M15-107,USDCHFMT4,1110,4h 15m,Buy
66283.73,113375,06.08.2010 05:29:58,sl 113.375,-0.69,-139.88000000003376,0.0,0.0,113145,05.08.2010 16:45:00,5411,-0.08942384081279922,-46.18,IS,0.17,0.0,Phase3-EA-T1v2-EURJPY-M15-322,EURJPYMT4,652,12h 44m,Sell
66388.11,136516,06.08.2010 06:09:58,tp 136.516,0.0,-35.500000000029104,0.0,0.0,136126,06.08.2010 03:10:00,5412,-0.022694783735031518,104.38,IS,0.23,0.0,Phase3-EA-S4v1-GBPJPY-M5-194,GBPJPYMT4,1378,2h 59m,Buy
66521.01,112631,06.08.2010 15:59:58,tp 112.631,-2.2,-0.0,0.0,0.0,113921,02.08.2010 21:00:00,5413,-0.0,132.9,IS,0.09,0.0,Phase3-EA-TR1v1-EURJPY-M30-91,EURJPYMT4,770,3d 18h 59m,Sell
66564.52,1.37641,06.08.2010 21:09:59,tp 1.37641,0.0,-0.0,0.0,0.0,1.37531,06.08.2010 20:30:00,5414,-0.0,43.51,IS,0.41,0.0,Phase3-EA-SA2v2-EURCHF-M5-43,EURCHFMT4,2814,39m 59s,Buy
66499.8,1.37995,09.08.2010 06:40:00,,-1.97,-64.72000000000116,0.0,0.0,1.37836,06.08.2010 22:20:00,5415,-0.04133759040681837,-64.72,IS,0.41,0.0,Phase3-EA-SA2v2-EURCHF-M5-43,EURCHFMT4,2816,2d 8h 20m,Sell
66419.66,1.38179,09.08.2010 10:00:00,,0.0,-144.86000000001513,0.0,0.0,1.37934,09.08.2010 01:15:00,5416,-0.0925241555366537,-80.14,IS,0.34,0.0,Phase3-EA-S4v1-EURCHF-M15-221,EURCHFMT4,1308,8h 45m,Sell
66460.66,1.38598,10.08.2010 03:54:58,tp 1.38598,-1.95,-103.86000000001513,0.0,0.0,1.38708,09.08.2010 23:00:00,5417,-0.06633686865965242,41.0,IS,0.41,0.0,Phase3-EA-SA2v2-EURCHF-M5-43,EURCHFMT4,2818,4h 54m,Sell
66390.2,136243,10.08.2010 03:59:59,sl 136.243,-0.38,-174.32000000000698,0.0,0.0,136913,09.08.2010 19:00:00,5418,-0.11134067922924502,-70.46,IS,0.09,0.0,Phase3-EA-B1v1-GBPJPY-M30-1,GBPJPYMT4,610,8h 59m,Buy
66249.48,85766,10.08.2010 04:00:00,,-2.83,-315.04000000000815,0.0,0.0,85328,06.08.2010 21:15:00,5419,-0.20122055750562673,-140.72,IS,0.27,0.0,Phase3-EA-S1v2-USDJPY-M15-0,USDJPYMT4,1850,3d 6h 45m,Sell
66035.08,135.72,10.08.2010 05:29:58,sl 135.720,0.0,-529.4400000000023,0.0,0.0,136.52,10.08.2010 02:10:00,5420,-0.3381609064429175,-214.4,IS,0.23,0.0,Phase3-EA-S4v1-GBPJPY-M5-194,GBPJPYMT4,1380,3h 19m,Buy
66067.03,1.3868,10.08.2010 13:45:00,,0.0,-497.4899999999907,0.0,0.0,1.38581,10.08.2010 05:00:00,5421,-0.31775398410827127,31.95,IS,0.34,0.0,Phase3-EA-S4v1-EURCHF-M15-221,EURCHFMT4,1310,8h 45m,Buy
66109.96,1.38452,10.08.2010 21:19:58,tp 1.38452,0.0,-454.5599999999977,0.0,0.0,1.38342,10.08.2010 20:10:00,5422,-0.2903339786051132,42.93,IS,0.41,0.0,Phase3-EA-SA2v2-EURCHF-M5-43,EURCHFMT4,2820,1h 9m,Buy
66067.96,1.5843,10.08.2010 22:29:58,sl 1.58430,0.0,-496.5599999999977,0.0,0.0,1.5873,10.08.2010 21:30:00,5423,-0.31715997979618765,-42.0,IS,0.14,0.0,Phase3-EA-B1v1-GBPUSD-M30-14,GBPUSDMT4,344,59m 58s,Buy
66203.19,112173,11.08.2010 03:29:58,tp 112.173,-0.74,-361.3299999999872,0.0,0.0,113463,09.08.2010 14:00:00,5424,-0.23078664310406188,135.23,IS,0.09,0.0,Phase3-EA-TR1v1-EURJPY-M30-91,EURJPYMT4,772,1d 13h 29m,Sell
66010.85,1.37921,11.08.2010 03:34:59,sl 1.37921,-0.94,-553.6699999999837,0.0,0.0,1.38411,10.08.2010 21:30:00,5425,-0.3536369542728993,-192.34,IS,0.41,0.0,Phase3-EA-SA2v2-EURCHF-M5-43,EURCHFMT4,2822,6h 4m,Buy
65887.95,85437,11.08.2010 05:15:00,,-0.92,-676.5699999999779,0.0,0.0,85823,10.08.2010 18:00:00,5426,-0.4321349434724921,-122.9,IS,0.27,0.0,Phase3-EA-S1v2-USDJPY-M15-0,USDJPYMT4,1852,11h 15m,Buy
65795.26,134913,11.08.2010 06:30:00,,0.0,-769.2599999999802,0.0,0.0,135257,11.08.2010 01:05:00,5427,-0.49133737324393867,-92.69,IS,0.23,0.0,Phase3-EA-S4v1-GBPJPY-M5-194,GBPJPYMT4,1382,5h 25m,Buy
65669.46,1.37755,11.08.2010 09:29:57,sl 1.37755,0.0,-895.0599999999686,0.0,0.0,1.38145,11.08.2010 01:15:00,5428,-0.5716876339543401,-125.8,IS,0.34,0.0,Phase3-EA-S4v1-EURCHF-M15-221,EURCHFMT4,1312,8h 14m,Buy
66007.84,111107,11.08.2010 10:29:58,tp 111.107,-0.7,-556.6799999999639,0.0,0.0,112807,10.08.2010 17:00:00,5429,-0.355559484358247,338.38,IS,0.17,0.0,Phase3-EA-T1v2-EURJPY-M15-322,EURJPYMT4,654,17h 29m,Sell
66202.74,133223,11.08.2010 13:59:58,tp 133.223,-0.61,-361.77999999996973,0.0,0.0,135073,10.08.2010 18:00:00,5430,-0.23107406454538365,194.9,IS,0.09,0.0,Phase3-EA-B1v1-GBPJPY-M30-1,GBPJPYMT4,612,19h 59m,Sell
66336.2,110272,11.08.2010 14:29:57,tp 110.272,0.0,-228.31999999997788,0.0,0.0,111532,11.08.2010 09:30:00,5431,-0.14583125218917933,133.46,IS,0.09,0.0,Phase3-EA-TR1v1-EURJPY-M30-91,EURJPYMT4,774,4h 59m,Sell
66265.34,133732,11.08.2010 17:59:58,sl 133.732,0.0,-299.1799999999639,0.0,0.0,133062,11.08.2010 17:00:00,5432,-0.1910905484843975,-70.86,IS,0.09,0.0,Phase3-EA-B1v1-GBPJPY-M30-1,GBPJPYMT4,614,59m 58s,Sell
66307.99,1.36169,11.08.2010 21:14:58,tp 1.36169,0.0,-256.52999999996973,0.0,0.0,1.36059,11.08.2010 21:05:00,5433,-0.16384938298917917,42.65,IS,0.41,0.0,Phase3-EA-SA2v2-EURCHF-M5-43,EURCHFMT4,2824,9m 58s,Buy
66342.8,85.33,11.08.2010 23:45:00,,0.0,-221.71999999997206,0.0,0.0,85.22,11.08.2010 22:00:00,5434,-0.1416157377162925,34.81,IS,0.27,0.0,Phase3-EA-S1v2-USDJPY-M15-0,USDJPYMT4,1854,1h 45m,Buy
66474.7,109257,12.08.2010 01:59:58,tp 109.257,-1.11,-89.81999999997788,0.0,0.0,110517,11.08.2010 14:30:00,5435,-0.057369319690040874,131.9,IS,0.09,0.0,Phase3-EA-TR1v1-EURJPY-M30-91,EURJPYMT4,776,11h 29m,Sell
66517.25,1.36233,12.08.2010 02:19:58,tp 1.36233,0.0,-47.26999999998952,0.0,0.0,1.36123,12.08.2010 01:55:00,5436,-0.030192025626233562,42.55,IS,0.41,0.0,Phase3-EA-SA2v2-EURCHF-M5-43,EURCHFMT4,2826,24m 58s,Buy
66486.14,133141,12.08.2010 05:50:00,,0.0,-78.37999999997555,0.0,0.0,133256,12.08.2010 00:25:00,5437,-0.05006242793704195,-31.11,IS,0.23,0.0,Phase3-EA-S4v1-GBPJPY-M5-194,GBPJPYMT4,1384,5h 25m,Buy
66621.75,110728,12.08.2010 10:29:58,tp 110.728,0.0,-0.0,0.0,0.0,109438,12.08.2010 05:30:00,5438,-0.0,135.61,IS,0.09,0.0,Phase3-EA-TR1v1-EURJPY-M30-91,EURJPYMT4,778,4h 59m,Buy
66576.09,109651,12.08.2010 15:29:58,sl 109.651,0.0,-45.66000000000349,0.0,0.0,109421,12.08.2010 13:00:00,5439,-0.02915303908940076,-45.66,IS,0.17,0.0,Phase3-EA-T1v2-EURJPY-M15-322,EURJPYMT4,656,2h 29m,Sell
66619.02,1.34764,12.08.2010 23:44:59,tp 1.34764,0.0,-2.7300000000104774,0.0,0.0,1.34654,12.08.2010 22:30:00,5440,-0.001743052928479269,42.93,IS,0.41,0.0,Phase3-EA-SA2v2-EURCHF-M5-43,EURCHFMT4,2828,1h 14m,Buy
66634.77,85.92,13.08.2010 00:30:00,,-0.91,-0.0,0.0,0.0,85867,12.08.2010 22:30:00,5441,-0.0,15.75,IS,0.27,0.0,Phase3-EA-S1v2-USDJPY-M15-0,USDJPYMT4,1856,2h 0m,Buy
66537.23,134519,13.08.2010 07:35:00,,0.0,-97.54000000000815,0.0,0.0,134154,13.08.2010 02:10:00,5442,-0.06227225283377902,-97.54,IS,0.23,0.0,Phase3-EA-S4v1-GBPJPY-M5-194,GBPJPYMT4,1386,5h 25m,Sell
66410.92,1.3519,13.08.2010 09:14:57,sl 1.35190,0.0,-223.85000000000582,0.0,0.0,1348,13.08.2010 05:00:00,5443,-0.14291207501374442,-126.31,IS,0.34,0.0,Phase3-EA-S4v1-EURCHF-M15-221,EURCHFMT4,1314,4h 14m,Sell
66453.78,1.34366,13.08.2010 21:59:58,tp 1.34366,0.0,-180.9900000000198,0.0,0.0,1.34256,13.08.2010 21:50:00,5444,-0.11554905721125647,42.86,IS,0.41,0.0,Phase3-EA-SA2v2-EURCHF-M5-43,EURCHFMT4,2830,9m 58s,Buy
66506.01,1.0514,16.08.2010 01:00:00,tp 1.05140,-2.93,-128.7600000000093,0.0,0.0,1.0524,13.08.2010 22:15:00,5445,-0.08220397042113282,52.23,IS,0.58,0.0,Phase3-EA-SA2v2-USDCHF-M15-107,USDCHFMT4,1112,2d 2h 45m,Sell
66430.94,86137,16.08.2010 01:15:00,,-1.41,-203.8300000000163,0.0,0.0,85902,13.08.2010 17:00:00,5446,-0.1301307493859866,-75.07,IS,0.27,0.0,Phase3-EA-S1v2-USDJPY-M15-0,USDJPYMT4,1858,2d 8h 15m,Sell
66472.89,1.34331,16.08.2010 06:04:58,tp 1.34331,-0.94,-161.88000000000466,0.0,0.0,1.34221,13.08.2010 23:05:00,5447,-0.10334870093019884,41.95,IS,0.41,0.0,Phase3-EA-SA2v2-EURCHF-M5-43,EURCHFMT4,2832,2d 6h 59m,Buy
66602.14,1.34465,16.08.2010 06:14:58,tp 1.34465,0.0,-32.63000000000466,0.0,0.0,1.34065,16.08.2010 01:30:00,5448,-0.02083190086083996,129.25,IS,0.34,0.0,Phase3-EA-S4v1-EURCHF-M15-221,EURCHFMT4,1316,4h 44m,Buy
66706.65,133.91,16.08.2010 08:29:58,tp 133.910,0.0,-0.0,0.0,0.0,133.52,16.08.2010 03:30:00,5449,-0.0,104.51,IS,0.23,0.0,Phase3-EA-S4v1-GBPJPY-M5-194,GBPJPYMT4,1388,4h 59m,Buy
66664.65,1.55804,16.08.2010 11:29:58,sl 1.55804,0.0,-42.0,0.0,0.0,1.56104,16.08.2010 08:30:00,5450,-0.026801670509834803,-42.0,IS,0.14,0.0,Phase3-EA-B1v1-GBPUSD-M30-14,GBPUSDMT4,346,2h 59m,Buy
66684.59,85306,16.08.2010 21:45:00,,0.0,-22.05999999999767,0.0,0.0,85369,16.08.2010 20:15:00,5451,-0.014077258367783174,19.94,IS,0.27,0.0,Phase3-EA-S1v2-USDJPY-M15-0,USDJPYMT4,1860,1h 30m,Sell
66727.97,1.3328,16.08.2010 21:49:58,tp 1.33280,0.0,-0.0,0.0,0.0,1.3317,16.08.2010 21:30:00,5452,-0.0,43.38,IS,0.41,0.0,Phase3-EA-SA2v2-EURCHF-M5-43,EURCHFMT4,2834,19m 58s,Buy
66771.35,1.33185,17.08.2010 02:04:58,tp 1.33185,0.0,-0.0,0.0,0.0,1.33295,17.08.2010 01:40:00,5453,-0.0,43.38,IS,0.41,0.0,Phase3-EA-SA2v2-EURCHF-M5-43,EURCHFMT4,2836,24m 58s,Sell
66814.74,1.33265,17.08.2010 02:09:57,tp 1.33265,0.0,-0.0,0.0,0.0,1.33155,17.08.2010 02:05:00,5454,-0.0,43.39,IS,0.41,0.0,Phase3-EA-SA2v2-EURCHF-M5-43,EURCHFMT4,2838,4m 57s,Buy
66945.62,1.33582,17.08.2010 06:29:58,tp 1.33582,0.0,-0.0,0.0,0.0,1.33182,17.08.2010 03:30:00,5455,-0.0,130.88,IS,0.34,0.0,Phase3-EA-S4v1-EURCHF-M15-221,EURCHFMT4,1318,2h 59m,Buy
66998.21,133621,17.08.2010 07:35:00,,0.0,-0.0,0.0,0.0,133426,17.08.2010 02:10:00,5456,-0.0,52.59,IS,0.23,0.0,Phase3-EA-S4v1-GBPJPY-M5-194,GBPJPYMT4,1390,5h 25m,Buy
67020.64,85.56,18.08.2010 01:00:00,,-0.92,-0.0,0.0,0.0,85486,17.08.2010 22:15:00,5457,-0.0,22.43,IS,0.27,0.0,Phase3-EA-S1v2-USDJPY-M15-0,USDJPYMT4,1862,2h 45m,Buy
67061.9,1.34345,18.08.2010 02:19:57,tp 1.34345,-1.96,-0.0,0.0,0.0,1.34455,17.08.2010 20:55:00,5458,-0.0,41.26,IS,0.41,0.0,Phase3-EA-SA2v2-EURCHF-M5-43,EURCHFMT4,2840,5h 24m,Sell
66989.86,132967,18.08.2010 03:59:58,sl 132.967,-1.52,-72.04000000000815,0.0,0.0,133637,12.08.2010 08:00:00,5459,-0.045867266345312394,-72.04,IS,0.09,0.0,Phase3-EA-B1v1-GBPJPY-M30-1,GBPJPYMT4,616,5d 19h 59m,Buy
66797.18,1.33855,18.08.2010 04:14:57,sl 1.33855,0.0,-264.72000000000116,0.0,0.0,1.34345,18.08.2010 02:50:00,5460,-0.16854501314449996,-192.68,IS,0.41,0.0,Phase3-EA-SA2v2-EURCHF-M5-43,EURCHFMT4,2842,1h 24m,Buy
66670.09,1.3373,18.08.2010 10:14:58,sl 1.33730,0.0,-391.8099999999977,0.0,0.0,1.3412,18.08.2010 04:45:00,5461,-0.24946215473007646,-127.09,IS,0.34,0.0,Phase3-EA-S4v1-EURCHF-M15-221,EURCHFMT4,1320,5h 29m,Buy
66624.27,109965,18.08.2010 20:14:58,sl 109.965,0.0,-437.63000000000466,0.0,0.0,109735,18.08.2010 17:45:00,5462,-0.278635366056316,-45.82,IS,0.17,0.0,Phase3-EA-T1v2-EURJPY-M15-322,EURJPYMT4,658,2h 29m,Sell
66667.56,1.34054,18.08.2010 21:24:59,tp 1.34054,0.0,-394.3399999999965,0.0,0.0,1.34164,18.08.2010 20:55:00,5463,-0.25107298460033706,43.29,IS,0.41,0.0,Phase3-EA-SA2v2-EURCHF-M5-43,EURCHFMT4,2844,29m 59s,Sell
66472.26,1.33481,19.08.2010 03:24:57,sl 1.33481,-2.83,-589.6399999999849,0.0,0.0,1.33971,18.08.2010 23:35:00,5464,-0.37541886351813225,-195.3,IS,0.41,0.0,Phase3-EA-SA2v2-EURCHF-M5-43,EURCHFMT4,2846,3h 49m,Buy
66577.0,133452,19.08.2010 05:00:00,tp 133.452,0.0,-484.8999999999942,0.0,0.0,133062,19.08.2010 03:10:00,5465,-0.30873178027261516,104.74,IS,0.23,0.0,Phase3-EA-S4v1-GBPJPY-M5-194,GBPJPYMT4,1392,1h 50m,Buy
66585.9,1.04305,19.08.2010 07:00:00,,0.0,-476.0,0.0,0.0,1.04321,19.08.2010 02:45:00,5466,-0.30306522460252955,8.9,IS,0.58,0.0,Phase3-EA-SA2v2-USDCHF-M15-107,USDCHFMT4,1114,4h 15m,Sell
66458.65,1.33241,19.08.2010 11:29:58,sl 1.33241,0.0,-603.25,0.0,0.0,1.33631,19.08.2010 04:00:00,5467,-0.38408423685184023,-127.25,IS,0.34,0.0,Phase3-EA-S4v1-EURCHF-M15-221,EURCHFMT4,1322,7h 29m,Buy
66352.21,85625,19.08.2010 12:00:00,,-4.27,-709.6900000000023,0.0,0.0,85301,18.08.2010 17:30:00,5468,-0.4518536958995166,-106.44,IS,0.27,0.0,Phase3-EA-S1v2-USDJPY-M15-0,USDJPYMT4,1864,18h 30m,Sell
66310.21,1.56029,19.08.2010 18:59:58,sl 1.56029,0.0,-751.6900000000023,0.0,0.0,1.56329,19.08.2010 12:00:00,5469,-0.47859474512915157,-42.0,IS,0.14,0.0,Phase3-EA-B1v1-GBPUSD-M30-14,GBPUSDMT4,348,6h 59m,Buy
66353.91,1.32369,19.08.2010 22:39:57,tp 1.32369,0.0,-707.9899999999907,0.0,0.0,1.32479,19.08.2010 21:50:00,5470,-0.4507713200973573,43.7,IS,0.41,0.0,Phase3-EA-SA2v2-EURCHF-M5-43,EURCHFMT4,2848,49m 57s,Sell
66393.64,85291,20.08.2010 01:00:00,,-1.42,-668.2599999999802,0.0,0.0,85421,19.08.2010 19:15:00,5471,-0.42547556090941263,39.73,IS,0.27,0.0,Phase3-EA-S1v2-USDJPY-M15-0,USDJPYMT4,1866,5h 45m,Sell
66422.73,85383,20.08.2010 04:00:00,,0.0,-639.1699999999837,0.0,0.0,85291,20.08.2010 01:00:00,5472,-0.406954200859651,29.09,IS,0.27,0.0,Phase3-EA-S1v2-USDJPY-M15-0,USDJPYMT4,1868,3h 0m,Buy
66466.43,1.32252,20.08.2010 04:29:58,tp 1.32252,0.0,-595.4699999999721,0.0,0.0,1.32142,20.08.2010 02:15:00,5473,-0.37913077582785676,43.7,IS,0.41,0.0,Phase3-EA-SA2v2-EURCHF-M5-43,EURCHFMT4,2850,2h 14m,Buy
66548.75,133252,20.08.2010 06:10:00,,0.0,-513.1499999999651,0.0,0.0,132946,20.08.2010 00:45:00,5474,-0.3267183193377678,82.32,IS,0.23,0.0,Phase3-EA-S4v1-GBPJPY-M5-194,GBPJPYMT4,1394,5h 25m,Buy
66502.92,109427,20.08.2010 09:44:58,sl 109.427,0.0,-558.9799999999523,0.0,0.0,109197,20.08.2010 08:00:00,5475,-0.35589789758047796,-45.83,IS,0.17,0.0,Phase3-EA-T1v2-EURJPY-M15-322,EURJPYMT4,660,1h 44m,Sell
66473.58,1.32151,20.08.2010 10:45:00,,0.0,-588.3199999999488,0.0,0.0,1.3224,20.08.2010 02:00:00,5476,-0.3745784305423207,-29.34,IS,0.34,0.0,Phase3-EA-S4v1-EURCHF-M15-221,EURCHFMT4,1324,8h 45m,Buy
66608.09,108868,20.08.2010 12:59:58,tp 108.868,-1.48,-453.80999999993946,0.0,0.0,110158,18.08.2010 00:30:00,5477,-0.28893703692616723,134.51,IS,0.09,0.0,Phase3-EA-TR1v1-EURJPY-M30-91,EURJPYMT4,780,2d 12h 29m,Sell
66651.68,1.31536,20.08.2010 21:14:58,tp 1.31536,0.0,-410.21999999994296,0.0,0.0,1.31426,20.08.2010 20:25:00,5478,-0.2611836479756983,43.59,IS,0.41,0.0,Phase3-EA-SA2v2-EURCHF-M5-43,EURCHFMT4,2852,49m 58s,Buy
66695.24,1.31492,20.08.2010 23:04:58,tp 1.31492,0.0,-366.6599999999453,0.0,0.0,1.31602,20.08.2010 22:00:00,5479,-0.23344935977467837,43.56,IS,0.41,0.0,Phase3-EA-SA2v2-EURCHF-M5-43,EURCHFMT4,2854,1h 4m,Sell
66737.86,1.31533,23.08.2010 01:34:59,tp 1.31533,-0.95,-324.03999999994994,0.0,0.0,1.31423,20.08.2010 23:35:00,5480,-0.2063135617230851,42.62,IS,0.41,0.0,Phase3-EA-SA2v2-EURCHF-M5-43,EURCHFMT4,2856,2d 1h 59m,Buy
66842.64,133213,23.08.2010 03:19:59,tp 133.213,0.0,-219.2599999999511,0.0,0.0,132823,23.08.2010 02:30:00,5481,-0.13960101081162987,104.78,IS,0.23,0.0,Phase3-EA-S4v1-GBPJPY-M5-194,GBPJPYMT4,1396,49m 59s,Buy
66947.62,132865,23.08.2010 04:09:58,tp 132.865,0.0,-114.27999999994063,0.0,0.0,133255,23.08.2010 03:25:00,5482,-0.07276112157050228,104.98,IS,0.23,0.0,Phase3-EA-S4v1-GBPJPY-M5-194,GBPJPYMT4,1398,44m 58s,Sell
67003.71,1.03413,23.08.2010 04:59:58,tp 1.03413,0.0,-58.18999999994412,0.0,0.0,1.03513,23.08.2010 02:45:00,5483,-0.037049087015975334,56.09,IS,0.58,0.0,Phase3-EA-SA2v2-USDCHF-M15-107,USDCHFMT4,1116,2h 14m,Sell
66904.44,85369,23.08.2010 11:15:00,,-0.91,-157.45999999993364,0.0,0.0,85.68,20.08.2010 22:30:00,5484,-0.10025346694515587,-99.27,IS,0.27,0.0,Phase3-EA-S1v2-USDJPY-M15-0,USDJPYMT4,1870,2d 12h 45m,Buy
66821.53,107898,23.08.2010 17:59:58,sl 107.898,-0.52,-240.36999999993714,0.0,0.0,108678,20.08.2010 17:30:00,5485,-0.15304157150775416,-82.91,IS,0.09,0.0,Phase3-EA-TR1v1-EURJPY-M30-91,EURJPYMT4,782,3d 0h 29m,Buy
66867.71,85073,24.08.2010 00:15:00,,-1.43,-194.18999999994412,0.0,0.0,85223,23.08.2010 19:45:00,5486,-0.12363915118812664,46.18,IS,0.27,0.0,Phase3-EA-S1v2-USDJPY-M15-0,USDJPYMT4,1872,4h 30m,Sell
66909.08,1.31643,24.08.2010 00:59:58,tp 1.31643,-1.97,-152.81999999994878,0.0,0.0,1.31753,23.08.2010 21:20:00,5487,-0.09729921769693917,41.37,IS,0.41,0.0,Phase3-EA-SA2v2-EURCHF-M5-43,EURCHFMT4,2858,3h 39m,Sell
66826.02,107.28,24.08.2010 04:59:57,sl 107.280,-0.52,-235.87999999994645,0.0,0.0,108.06,23.08.2010 21:00:00,5488,-0.15018282600678245,-83.06,IS,0.09,0.0,Phase3-EA-TR1v1-EURJPY-M30-91,EURJPYMT4,784,7h 59m,Buy
66869.32,1.31709,24.08.2010 08:49:58,tp 1.31709,0.0,-192.5799999999581,0.0,0.0,1.31599,24.08.2010 01:55:00,5489,-0.12261407763433285,43.3,IS,0.41,0.0,Phase3-EA-SA2v2-EURCHF-M5-43,EURCHFMT4,2860,6h 54m,Buy
67003.36,106126,24.08.2010 11:29:58,tp 106.126,0.0,-58.53999999994994,0.0,0.0,107386,24.08.2010 05:00:00,5490,-0.03727192909289267,134.04,IS,0.09,0.0,Phase3-EA-TR1v1-EURJPY-M30-91,EURJPYMT4,786,6h 29m,Sell
66987.36,1.31572,24.08.2010 12:00:00,,0.0,-74.53999999994994,0.0,0.0,1.31621,24.08.2010 03:15:00,5491,-0.04745899546608694,-16.0,IS,0.34,0.0,Phase3-EA-S4v1-EURCHF-M15-221,EURCHFMT4,1326,8h 45m,Buy
67184.94,129408,24.08.2010 15:29:58,tp 129.408,0.0,-0.0,0.0,0.0,131258,24.08.2010 07:00:00,5492,-0.0,197.58,IS,0.09,0.0,Phase3-EA-B1v1-GBPJPY-M30-1,GBPJPYMT4,618,8h 29m,Sell
67112.96,129826,24.08.2010 17:59:58,sl 129.826,0.0,-71.98000000001048,0.0,0.0,129156,24.08.2010 15:30:00,5493,-0.04579319112887693,-71.98,IS,0.09,0.0,Phase3-EA-B1v1-GBPJPY-M30-1,GBPJPYMT4,620,2h 29m,Sell
67241.68,83905,24.08.2010 23:59:58,tp 83.905,0.0,-0.0,0.0,0.0,84305,24.08.2010 18:45:00,5494,-0.0,128.72,IS,0.27,0.0,Phase3-EA-S1v2-USDJPY-M15-0,USDJPYMT4,1874,5h 14m,Sell
67285.38,1.30329,25.08.2010 00:39:57,tp 1.30329,0.0,-0.0,0.0,0.0,1.30219,25.08.2010 00:05:00,5495,-0.0,43.7,IS,0.41,0.0,Phase3-EA-SA2v2-EURCHF-M5-43,EURCHFMT4,2862,34m 57s,Buy
67238.83,106294,25.08.2010 00:59:58,sl 106.294,0.0,-46.54999999998836,0.0,0.0,106064,25.08.2010 00:15:00,5496,-0.029595884881346495,-46.55,IS,0.17,0.0,Phase3-EA-T1v2-EURJPY-M15-322,EURJPYMT4,662,44m 58s,Sell
67193.1,1.03121,25.08.2010 03:30:00,,-2.98,-92.27999999999884,0.0,0.0,1.03045,24.08.2010 23:15:00,5497,-0.05867042442215474,-45.73,IS,0.58,0.0,Phase3-EA-SA2v2-USDCHF-M15-107,USDCHFMT4,1118,4h 15m,Sell
67298.52,129966,25.08.2010 03:39:57,tp 129.966,-0.99,-0.0,0.0,0.0,129576,24.08.2010 23:50:00,5498,-0.0,105.42,IS,0.23,0.0,Phase3-EA-S4v1-GBPJPY-M5-194,GBPJPYMT4,1400,3h 49m,Buy
67169.89,1.29954,25.08.2010 08:29:58,sl 1.29954,0.0,-128.63000000000466,0.0,0.0,1.30344,25.08.2010 01:15:00,5499,-0.08177445026183636,-128.63,IS,0.34,0.0,Phase3-EA-S4v1-EURCHF-M15-221,EURCHFMT4,1328,7h 14m,Buy
67156.25,130015,25.08.2010 09:10:00,,0.0,-142.27000000001863,0.0,0.0,129965,25.08.2010 03:45:00,5500,-0.09044586052050502,-13.64,IS,0.23,0.0,Phase3-EA-S4v1-GBPJPY-M5-194,GBPJPYMT4,1402,5h 25m,Sell
67114.25,1.54215,25.08.2010 10:59:58,sl 1.54215,0.0,-184.27000000001863,0.0,0.0,1.53915,25.08.2010 10:30:00,5501,-0.1171466838976099,-42.0,IS,0.14,0.0,Phase3-EA-B1v1-GBPUSD-M30-14,GBPUSDMT4,350,29m 58s,Sell
67037.09,107132,25.08.2010 10:59:58,sl 107.132,-0.38,-261.4300000000221,0.0,0.0,106412,24.08.2010 13:30:00,5502,-0.1661999108446934,-77.16,IS,0.09,0.0,Phase3-EA-TR1v1-EURJPY-M30-91,EURJPYMT4,788,21h 29m,Sell
67012.36,1.02923,26.08.2010 02:30:00,,-8.95,-286.1600000000326,0.0,0.0,1.02895,25.08.2010 22:15:00,5503,-0.1819216099426954,-24.73,IS,0.58,0.0,Phase3-EA-SA2v2-USDCHF-M15-107,USDCHFMT4,1120,4h 15m,Sell
67043.35,84762,26.08.2010 02:45:00,,-2.78,-255.1700000000419,0.0,0.0,84656,25.08.2010 23:45:00,5504,-0.16222021669373748,30.99,IS,0.27,0.0,Phase3-EA-S1v2-USDJPY-M15-0,USDJPYMT4,1876,3h 0m,Buy
66842.24,1.30636,26.08.2010 05:14:57,sl 1.30636,-5.97,-456.28000000002794,0.0,0.0,1.30146,25.08.2010 21:25:00,5505,-0.2900726592977659,-201.11,IS,0.41,0.0,Phase3-EA-SA2v2-EURCHF-M5-43,EURCHFMT4,2864,7h 49m,Sell
66713.29,1.30777,26.08.2010 07:29:58,sl 1.30777,0.0,-585.2300000000396,0.0,0.0,1.30387,26.08.2010 01:00:00,5506,-0.3720505444043846,-128.95,IS,0.34,0.0,Phase3-EA-S4v1-EURCHF-M15-221,EURCHFMT4,1330,6h 29m,Sell
66527.69,131834,26.08.2010 07:45:00,,0.0,-770.8300000000454,0.0,0.0,131.15,26.08.2010 02:20:00,5507,-0.4900427543755947,-185.6,IS,0.23,0.0,Phase3-EA-S4v1-GBPJPY-M5-194,GBPJPYMT4,1404,5h 25m,Sell
66613.58,107441,26.08.2010 14:00:00,,-2.96,-684.9400000000314,0.0,0.0,106999,25.08.2010 18:45:00,5508,-0.4354395705694063,85.89,IS,0.17,0.0,Phase3-EA-T1v2-EURJPY-M15-322,EURJPYMT4,664,19h 15m,Buy
66567.39,107.46,26.08.2010 18:44:58,sl 107.460,0.0,-731.1300000000338,0.0,0.0,107.69,26.08.2010 17:30:00,5509,-0.46480411894532386,-46.19,IS,0.17,0.0,Phase3-EA-T1v2-EURJPY-M15-322,EURJPYMT4,666,1h 14m,Buy
66624.03,1.02409,26.08.2010 23:14:57,tp 1.02409,0.0,-674.4900000000198,0.0,0.0,1.02309,26.08.2010 22:30:00,5510,-0.42879615141961924,56.64,IS,0.58,0.0,Phase3-EA-SA2v2-USDCHF-M15-107,USDCHFMT4,1122,44m 57s,Buy
66668.08,1.30209,27.08.2010 06:34:58,tp 1.30209,0.0,-630.4400000000314,0.0,0.0,1.30099,27.08.2010 01:25:00,5511,-0.40079207356816304,44.05,IS,0.41,0.0,Phase3-EA-SA2v2-EURCHF-M5-43,EURCHFMT4,2866,5h 9m,Buy
66688.65,1.30229,27.08.2010 10:15:00,,0.0,-609.8700000000244,0.0,0.0,1.30167,27.08.2010 01:30:00,5512,-0.38771502745227654,20.57,IS,0.34,0.0,Phase3-EA-S4v1-EURCHF-M15-221,EURCHFMT4,1332,8h 45m,Buy
66605.35,108126,27.08.2010 15:59:57,sl 108.126,-0.37,-693.1700000000128,0.0,0.0,107346,26.08.2010 12:00:00,5513,-0.4406716604835272,-83.3,IS,0.09,0.0,Phase3-EA-TR1v1-EURJPY-M30-91,EURJPYMT4,790,1d 3h 59m,Sell
66658.78,1.02806,30.08.2010 01:00:00,tp 1.02806,-2.99,-639.7400000000198,0.0,0.0,1.02906,27.08.2010 22:15:00,5514,-0.4067043987445146,53.43,IS,0.58,0.0,Phase3-EA-SA2v2-USDCHF-M15-107,USDCHFMT4,1124,2d 2h 45m,Sell
66784.0,85621,30.08.2010 01:14:58,tp 85.621,-0.92,-514.5200000000186,0.0,0.0,85221,27.08.2010 23:30:00,5515,-0.3270978010473454,125.22,IS,0.27,0.0,Phase3-EA-S1v2-USDJPY-M15-0,USDJPYMT4,1878,2d 1h 44m,Buy
66717.49,1.31205,30.08.2010 06:35:00,,-1.99,-581.0300000000279,0.0,0.0,1.31043,27.08.2010 22:15:00,5516,-0.3693804620666667,-66.51,IS,0.41,0.0,Phase3-EA-SA2v2-EURCHF-M5-43,EURCHFMT4,2868,2d 8h 20m,Sell
66789.39,132561,30.08.2010 06:50:00,,0.0,-509.13000000003376,0.0,0.0,132828,30.08.2010 01:25:00,5517,-0.32367119538062655,71.9,IS,0.23,0.0,Phase3-EA-S4v1-GBPJPY-M5-194,GBPJPYMT4,1406,5h 25m,Sell
66921.73,1.30849,30.08.2010 11:29:58,tp 1.30849,0.0,-376.79000000003725,0.0,0.0,1.31249,30.08.2010 04:00:00,5518,-0.23953817238715114,132.34,IS,0.34,0.0,Phase3-EA-S4v1-EURCHF-M15-221,EURCHFMT4,1334,7h 29m,Sell
67058.83,107464,30.08.2010 13:59:58,tp 107.464,0.0,-239.69000000003143,0.0,0.0,108754,30.08.2010 07:00:00,5519,-0.15237905607759789,137.1,IS,0.09,0.0,Phase3-EA-TR1v1-EURJPY-M30-91,EURJPYMT4,792,6h 59m,Sell
67016.83,1.54996,30.08.2010 17:29:58,sl 1.54996,0.0,-281.69000000003143,0.0,0.0,1.55296,30.08.2010 02:00:00,5520,-0.17907987945470277,-42.0,IS,0.14,0.0,Phase3-EA-B1v1-GBPUSD-M30-14,GBPUSDMT4,352,15h 29m,Buy
67060.79,1.29986,30.08.2010 21:49:57,tp 1.29986,0.0,-237.73000000003958,0.0,0.0,1.29876,30.08.2010 20:40:00,5521,-0.15113301765333817,43.96,IS,0.41,0.0,Phase3-EA-SA2v2-EURCHF-M5-43,EURCHFMT4,2870,1h 9m,Buy
67079.28,84699,30.08.2010 22:00:00,,0.0,-219.2400000000489,0.0,0.0,84757,30.08.2010 17:00:00,5522,-0.13937829802851862,18.49,IS,0.27,0.0,Phase3-EA-S1v2-USDJPY-M15-0,USDJPYMT4,1880,5h 0m,Sell
67132.85,1.02535,31.08.2010 01:29:58,tp 1.02535,-3.0,-165.6700000000419,0.0,0.0,1.02635,30.08.2010 22:45:00,5523,-0.10532203354490682,53.57,IS,0.58,0.0,Phase3-EA-SA2v2-USDCHF-M15-107,USDCHFMT4,1126,2h 44m,Sell
66936.97,1.29449,31.08.2010 03:39:58,sl 1.29449,0.0,-361.55000000004657,0.0,0.0,1.29939,31.08.2010 01:05:00,5524,-0.22984958790460755,-195.88,IS,0.41,0.0,Phase3-EA-SA2v2-EURCHF-M5-43,EURCHFMT4,2872,2h 34m,Buy
66807.69,1.29451,31.08.2010 03:44:58,sl 1.29451,0.0,-490.8300000000454,0.0,0.0,1.29841,31.08.2010 02:30:00,5525,-0.3120372651948954,-129.28,IS,0.34,0.0,Phase3-EA-S4v1-EURCHF-M15-221,EURCHFMT4,1336,1h 14m,Buy
66942.14,106211,31.08.2010 09:59:57,tp 106.211,-0.37,-356.38000000003376,0.0,0.0,107471,30.08.2010 15:00:00,5526,-0.22656284369365579,134.45,IS,0.09,0.0,Phase3-EA-TR1v1-EURJPY-M30-91,EURJPYMT4,794,18h 59m,Sell
66811.91,1.29075,31.08.2010 12:14:57,sl 1.29075,0.0,-486.61000000004424,0.0,0.0,1.29465,31.08.2010 05:15:00,5527,-0.30935446817938556,-130.23,IS,0.34,0.0,Phase3-EA-S4v1-EURCHF-M15-221,EURCHFMT4,1338,6h 59m,Buy
67009.62,128826,31.08.2010 18:29:58,tp 128.826,-0.62,-288.9000000000524,0.0,0.0,130676,30.08.2010 23:00:00,5528,-0.1836635208011191,197.71,IS,0.09,0.0,Phase3-EA-B1v1-GBPJPY-M30-1,GBPJPYMT4,622,19h 29m,Sell
67053.97,1.29031,31.08.2010 21:24:58,tp 1.29031,0.0,-244.55000000004657,0.0,0.0,1.29141,31.08.2010 20:45:00,5529,-0.1554687227826725,44.35,IS,0.41,0.0,Phase3-EA-SA2v2-EURCHF-M5-43,EURCHFMT4,2874,39m 58s,Sell
67097.45,1.2872,01.09.2010 00:14:58,tp 1.28720,-0.97,-201.0700000000361,0.0,0.0,1.2861,31.08.2010 22:30:00,5530,-0.12782701324846296,43.48,IS,0.41,0.0,Phase3-EA-SA2v2-EURCHF-M5-43,EURCHFMT4,2876,1h 44m,Buy
67123.61,1.01512,01.09.2010 02:45:00,,-0.69,-174.9100000000326,0.0,0.0,1.01465,31.08.2010 22:30:00,5531,-0.11119621468786398,26.16,IS,0.58,0.0,Phase3-EA-SA2v2-USDCHF-M15-107,USDCHFMT4,1128,4h 15m,Buy
67230.04,129377,01.09.2010 03:59:58,tp 129.377,0.0,-68.48000000003958,0.0,0.0,128987,01.09.2010 02:20:00,5532,-0.04353505678250476,106.43,IS,0.23,0.0,Phase3-EA-S4v1-GBPJPY-M5-194,GBPJPYMT4,1408,1h 39m,Buy
67164.22,84292,01.09.2010 10:00:00,,-1.44,-134.30000000004657,0.0,0.0,84091,31.08.2010 23:45:00,5533,-0.08537906141777216,-65.82,IS,0.27,0.0,Phase3-EA-S1v2-USDJPY-M15-0,USDJPYMT4,1882,10h 15m,Sell
67033.72,1.29359,01.09.2010 10:14:57,sl 1.29359,0.0,-264.80000000004657,0.0,0.0,1.28969,01.09.2010 05:30:00,5534,-0.16834233405377663,-130.5,IS,0.34,0.0,Phase3-EA-S4v1-EURCHF-M15-221,EURCHFMT4,1340,4h 44m,Sell
67171.27,108007,01.09.2010 16:59:58,tp 108.007,-0.52,-127.25000000005821,0.0,0.0,106717,31.08.2010 10:30:00,5535,-0.08089713749376552,137.55,IS,0.09,0.0,Phase3-EA-TR1v1-EURJPY-M30-91,EURJPYMT4,796,1d 6h 29m,Buy
67215.65,1.3008,01.09.2010 22:04:57,tp 1.30080,0.0,-82.87000000005355,0.0,0.0,1.2997,01.09.2010 21:10:00,5536,-0.05268326745862172,44.38,IS,0.41,0.0,Phase3-EA-SA2v2-EURCHF-M5-43,EURCHFMT4,2878,54m 57s,Buy
67235.24,84505,02.09.2010 03:00:00,,-2.78,-63.28000000005704,0.0,0.0,84435,01.09.2010 22:30:00,5537,-0.040229240554874306,19.59,IS,0.27,0.0,Phase3-EA-S1v2-USDJPY-M15-0,USDJPYMT4,1884,4h 30m,Buy
67368.94,1.29821,02.09.2010 08:59:58,tp 1.29821,0.0,-0.0,0.0,0.0,1.30221,02.09.2010 04:45:00,5538,-0.0,133.7,IS,0.34,0.0,Phase3-EA-S4v1-EURCHF-M15-221,EURCHFMT4,1342,4h 14m,Sell
67413.44,1.29891,02.09.2010 22:19:58,tp 1.29891,0.0,-0.0,0.0,0.0,1.30001,02.09.2010 21:35:00,5539,-0.0,44.5,IS,0.41,0.0,Phase3-EA-SA2v2-EURCHF-M5-43,EURCHFMT4,2880,44m 58s,Sell
67457.98,1.29958,03.09.2010 05:44:57,tp 1.29958,0.0,-0.0,0.0,0.0,1.29848,03.09.2010 00:10:00,5540,-0.0,44.54,IS,0.41,0.0,Phase3-EA-SA2v2-EURCHF-M5-43,EURCHFMT4,2882,5h 34m,Buy
67515.89,129689,03.09.2010 08:50:00,,0.0,-0.0,0.0,0.0,129901,03.09.2010 03:25:00,5541,-0.0,57.91,IS,0.23,0.0,Phase3-EA-S4v1-GBPJPY-M5-194,GBPJPYMT4,1410,5h 25m,Sell
67431.37,108.93,03.09.2010 15:59:58,sl 108.930,-1.49,-84.51999999998952,0.0,0.0,108.15,01.09.2010 21:30:00,5542,-0.05365807855955966,-84.52,IS,0.09,0.0,Phase3-EA-TR1v1-EURJPY-M30-91,EURJPYMT4,798,1d 18h 29m,Sell
67447.37,84359,03.09.2010 23:15:00,,0.0,-68.51999999998952,0.0,0.0,84411,03.09.2010 23:00:00,5543,-0.043500373200436836,16.0,IS,0.27,0.0,Phase3-EA-S1v2-USDJPY-M15-0,USDJPYMT4,1886,15m 0s,Buy
67491.72,1.31016,03.09.2010 23:29:57,tp 1.31016,0.0,-24.169999999983702,0.0,0.0,1.31126,03.09.2010 20:35:00,5544,-0.015344483658114567,44.35,IS,0.41,0.0,Phase3-EA-SA2v2-EURCHF-M5-43,EURCHFMT4,2884,2h 54m,Sell
67548.06,1.01713,06.09.2010 02:29:58,tp 1.01713,-0.68,-0.0,0.0,0.0,1.01613,03.09.2010 23:30:00,5545,-0.0,56.34,IS,0.58,0.0,Phase3-EA-SA2v2-USDCHF-M15-107,USDCHFMT4,1130,2d 2h 59m,Buy
67558.64,84447,06.09.2010 03:00:00,,-0.93,-0.0,0.0,0.0,84409,03.09.2010 23:00:00,5546,-0.0,10.58,IS,0.27,0.0,Phase3-EA-S1v2-USDJPY-M15-0,USDJPYMT4,1887,2d 4h 0m,Sell
67601.96,1.31136,06.09.2010 03:19:58,tp 1.31136,-0.97,-0.0,0.0,0.0,1.31026,03.09.2010 23:35:00,5547,-0.0,43.32,IS,0.41,0.0,Phase3-EA-SA2v2-EURCHF-M5-43,EURCHFMT4,2886,2d 3h 44m,Buy
67735.86,1.31302,06.09.2010 10:29:57,tp 1.31302,0.0,-0.0,0.0,0.0,1.30902,06.09.2010 05:00:00,5548,-0.0,133.9,IS,0.34,0.0,Phase3-EA-S4v1-EURCHF-M15-221,EURCHFMT4,1344,5h 29m,Buy
67536.9,1.29786,07.09.2010 02:24:58,sl 1.29786,0.0,-198.95999999999185,0.0,0.0,1.30276,07.09.2010 00:35:00,5549,-0.12613491947867275,-198.96,IS,0.41,0.0,Phase3-EA-SA2v2-EURCHF-M5-43,EURCHFMT4,2888,1h 49m,Buy
67532.52,129305,07.09.2010 07:55:00,,0.0,-203.3399999999965,0.0,0.0,129321,07.09.2010 02:30:00,5550,-0.12891171354440054,-4.38,IS,0.23,0.0,Phase3-EA-S4v1-GBPJPY-M5-194,GBPJPYMT4,1412,5h 25m,Buy
67333.6,1.29158,07.09.2010 07:59:57,sl 1.29158,0.0,-402.2600000000093,0.0,0.0,1.29648,07.09.2010 02:30:00,5551,-0.2550212741731713,-198.92,IS,0.41,0.0,Phase3-EA-SA2v2-EURCHF-M5-43,EURCHFMT4,2890,5h 29m,Buy
67471.18,107185,07.09.2010 10:29:58,tp 107.185,-0.74,-264.6800000000221,0.0,0.0,108475,03.09.2010 18:00:00,5552,-0.16779950988952183,137.58,IS,0.09,0.0,Phase3-EA-TR1v1-EURJPY-M30-91,EURJPYMT4,800,3d 16h 29m,Sell
67272.22,1.28111,07.09.2010 22:14:58,sl 1.28111,0.0,-463.64000000001397,0.0,0.0,1.28601,07.09.2010 20:50:00,5553,-0.2939344293681946,-198.96,IS,0.41,0.0,Phase3-EA-SA2v2-EURCHF-M5-43,EURCHFMT4,2892,1h 24m,Buy
67316.89,1.28267,07.09.2010 22:49:58,tp 1.28267,0.0,-418.97000000000116,0.0,0.0,1.28157,07.09.2010 22:15:00,5554,-0.26561493372528067,44.67,IS,0.41,0.0,Phase3-EA-SA2v2-EURCHF-M5-43,EURCHFMT4,2894,34m 58s,Buy
67295.97,128411,08.09.2010 06:45:00,,0.0,-439.89000000001397,0.0,0.0,128487,08.09.2010 01:20:00,5555,-0.2788776122309881,-20.92,IS,0.23,0.0,Phase3-EA-S4v1-GBPJPY-M5-194,GBPJPYMT4,1414,5h 25m,Buy
67340.62,1.28194,08.09.2010 06:54:57,tp 1.28194,0.0,-395.2400000000198,0.0,0.0,1.28304,08.09.2010 02:55:00,5556,-0.2505707960130436,44.65,IS,0.41,0.0,Phase3-EA-SA2v2-EURCHF-M5-43,EURCHFMT4,2896,3h 59m,Sell
67476.31,105887,08.09.2010 06:59:58,tp 105.887,-0.38,-259.55000000001746,0.0,0.0,107147,07.09.2010 12:00:00,5557,-0.16454723738788227,135.69,IS,0.09,0.0,Phase3-EA-TR1v1-EURJPY-M30-91,EURJPYMT4,802,18h 59m,Sell
67429.52,106161,08.09.2010 11:59:58,sl 106.161,0.0,-306.3400000000256,0.0,0.0,105931,08.09.2010 11:15:00,5558,-0.19421075207630392,-46.79,IS,0.17,0.0,Phase3-EA-T1v2-EURJPY-M15-322,EURJPYMT4,668,44m 58s,Sell
67381.32,1.55079,08.09.2010 18:29:58,sl 1.55079,-6.2,-354.54000000003725,0.0,0.0,1.54779,30.08.2010 17:30:00,5559,-0.22476816622424192,-48.2,IS,0.14,0.0,Phase3-EA-B1v1-GBPUSD-M30-14,GBPUSDMT4,354,9d 0h 59m,Sell
67425.93,1.28825,08.09.2010 21:24:59,tp 1.28825,0.0,-309.9300000000512,0.0,0.0,1.28715,08.09.2010 21:05:00,5560,-0.19648670885621788,44.61,IS,0.41,0.0,Phase3-EA-SA2v2-EURCHF-M5-43,EURCHFMT4,2898,19m 59s,Buy
67532.86,129539,09.09.2010 04:04:58,tp 129.539,0.0,-203.0000000000582,0.0,0.0,129929,09.09.2010 02:20:00,5561,-0.12869616332015962,106.93,IS,0.23,0.0,Phase3-EA-S4v1-GBPJPY-M5-194,GBPJPYMT4,1416,1h 44m,Sell
67486.25,106666,09.09.2010 04:14:57,sl 106.666,0.0,-249.61000000004424,0.0,0.0,106896,09.09.2010 03:00:00,5562,-0.15824556318394842,-46.61,IS,0.17,0.0,Phase3-EA-T1v2-EURJPY-M15-322,EURJPYMT4,670,1h 14m,Buy
67530.84,1.28616,09.09.2010 07:19:57,tp 1.28616,0.0,-205.02000000004773,0.0,0.0,1.28726,09.09.2010 01:55:00,5563,-0.1299767852408754,44.59,IS,0.41,0.0,Phase3-EA-SA2v2-EURCHF-M5-43,EURCHFMT4,2900,5h 24m,Sell
67458.76,129293,09.09.2010 15:59:58,sl 129.293,0.0,-277.1000000000349,0.0,0.0,128623,09.09.2010 12:30:00,5564,-0.17567343278822908,-72.08,IS,0.09,0.0,Phase3-EA-B1v1-GBPJPY-M30-1,GBPJPYMT4,624,3h 29m,Sell
67416.76,1.54423,09.09.2010 18:29:58,sl 1.54423,0.0,-319.1000000000349,0.0,0.0,1.54723,09.09.2010 18:00:00,5565,-0.20230022519928895,-42.0,IS,0.14,0.0,Phase3-EA-B1v1-GBPUSD-M30-14,GBPUSDMT4,356,29m 58s,Buy
67370.14,106547,09.09.2010 20:59:57,sl 106.547,0.0,-365.72000000003027,0.0,0.0,106317,09.09.2010 20:30:00,5566,-0.23185596477556247,-46.62,IS,0.17,0.0,Phase3-EA-T1v2-EURJPY-M15-322,EURJPYMT4,672,29m 57s,Sell
67323.52,106.36,09.09.2010 23:59:58,sl 106.360,0.0,-412.3400000000256,0.0,0.0,106.59,09.09.2010 22:45:00,5567,-0.26141170435183597,-46.62,IS,0.17,0.0,Phase3-EA-T1v2-EURJPY-M15-322,EURJPYMT4,674,1h 14m,Buy
67380.61,1.01596,10.09.2010 04:14:58,tp 1.01596,0.0,-355.2500000000291,0.0,0.0,1.01496,10.09.2010 00:45:00,5568,-0.22521828581023323,57.09,IS,0.58,0.0,Phase3-EA-SA2v2-USDCHF-M15-107,USDCHFMT4,1132,3h 29m,Buy
67424.95,1.28947,10.09.2010 04:39:58,tp 1.28947,0.0,-310.9100000000326,0.0,0.0,1.28837,10.09.2010 00:20:00,5569,-0.1971080006791308,44.34,IS,0.41,0.0,Phase3-EA-SA2v2-EURCHF-M5-43,EURCHFMT4,2902,4h 19m,Buy
67558.16,1.2917,10.09.2010 04:44:58,tp 1.29170,0.0,-177.70000000004075,0.0,0.0,1.2877,10.09.2010 03:15:00,5570,-0.1126566907487244,133.21,IS,0.34,0.0,Phase3-EA-S4v1-EURCHF-M15-221,EURCHFMT4,1346,1h 29m,Buy
67692.03,1.28768,10.09.2010 08:14:58,tp 1.28768,0.0,-43.8300000000454,0.0,0.0,1.29168,10.09.2010 05:30:00,5571,-0.02778695979471341,133.87,IS,0.34,0.0,Phase3-EA-S4v1-EURCHF-M15-221,EURCHFMT4,1348,2h 44m,Sell
67645.42,106419,10.09.2010 08:14:59,sl 106.419,0.0,-90.44000000003143,0.0,0.0,106649,10.09.2010 03:15:00,5572,-0.057336359658502194,-46.61,IS,0.17,0.0,Phase3-EA-T1v2-EURJPY-M15-322,EURJPYMT4,676,4h 59m,Buy
67625.42,106716,10.09.2010 23:45:00,,0.0,-110.44000000003143,0.0,0.0,106815,10.09.2010 10:15:00,5573,-0.07001578461614975,-20.0,IS,0.17,0.0,Phase3-EA-T1v2-EURJPY-M15-322,EURJPYMT4,678,13h 30m,Buy
67668.68,1.29644,13.09.2010 01:14:58,tp 1.29644,-0.97,-67.18000000002212,0.0,0.0,1.29534,10.09.2010 23:15:00,5574,-0.042590188432752175,43.26,IS,0.41,0.0,Phase3-EA-SA2v2-EURCHF-M5-43,EURCHFMT4,2904,2d 1h 59m,Buy
67711.64,84275,13.09.2010 01:15:00,,-0.93,-24.220000000030268,0.0,0.0,84138,10.09.2010 19:00:00,5575,-0.015354783623730384,42.96,IS,0.27,0.0,Phase3-EA-S1v2-USDJPY-M15-0,USDJPYMT4,1890,2d 6h 15m,Buy
67627.56,107465,13.09.2010 02:59:57,sl 107.465,-0.75,-108.30000000001746,0.0,0.0,106685,09.09.2010 01:00:00,5576,-0.06865908614567261,-84.08,IS,0.09,0.0,Phase3-EA-TR1v1-EURJPY-M30-91,EURJPYMT4,804,4d 1h 59m,Sell
67594.48,129676,13.09.2010 07:20:00,,0.0,-141.38000000000466,0.0,0.0,129555,13.09.2010 01:55:00,5577,-0.08963085502561355,-33.08,IS,0.23,0.0,Phase3-EA-S4v1-GBPJPY-M5-194,GBPJPYMT4,1418,5h 25m,Sell
67493.78,1.29968,13.09.2010 09:55:00,,0.0,-242.0800000000163,0.0,0.0,1.29719,13.09.2010 01:35:00,5578,-0.1534717596873764,-100.7,IS,0.41,0.0,Phase3-EA-SA2v2-EURCHF-M5-43,EURCHFMT4,2906,8h 20m,Sell
67574.26,107619,13.09.2010 13:00:00,,0.0,-161.60000000000582,0.0,0.0,107221,13.09.2010 02:00:00,5579,-0.10244975365779597,80.48,IS,0.17,0.0,Phase3-EA-T1v2-EURJPY-M15-322,EURJPYMT4,680,11h 0m,Buy
67657.79,1.2976,13.09.2010 13:00:00,,0.0,-78.07000000000698,0.0,0.0,1.30009,13.09.2010 04:15:00,5580,-0.04949413532218168,83.53,IS,0.34,0.0,Phase3-EA-S4v1-EURCHF-M15-221,EURCHFMT4,1350,8h 45m,Sell
67651.08,107634,13.09.2010 21:45:00,,0.0,-84.77999999999884,0.0,0.0,107667,13.09.2010 14:30:00,5581,-0.053748082395467266,-6.71,IS,0.17,0.0,Phase3-EA-T1v2-EURJPY-M15-322,EURJPYMT4,682,7h 15m,Buy
67660.29,83604,14.09.2010 03:00:00,,-1.45,-75.57000000000698,0.0,0.0,83637,13.09.2010 23:45:00,5582,-0.04790920720247573,9.21,IS,0.27,0.0,Phase3-EA-S1v2-USDJPY-M15-0,USDJPYMT4,1892,3h 15m,Sell
67439.83,128184,14.09.2010 03:49:58,sl 128.184,0.0,-296.02999999999884,0.0,0.0,128984,14.09.2010 01:35:00,5583,-0.18767450851061962,-220.46,IS,0.23,0.0,Phase3-EA-S4v1-GBPJPY-M5-194,GBPJPYMT4,1420,2h 14m,Buy
67414.43,1.29689,14.09.2010 05:40:00,,-0.98,-321.429999999993,0.0,0.0,1.29749,13.09.2010 21:20:00,5584,-0.20377737820682834,-25.4,IS,0.41,0.0,Phase3-EA-SA2v2-EURCHF-M5-43,EURCHFMT4,2908,8h 20m,Buy
67282.76,1.29257,14.09.2010 06:14:58,sl 1.29257,0.0,-453.1000000000058,0.0,0.0,1.29647,14.09.2010 03:30:00,5585,-0.28725237241550916,-131.67,IS,0.34,0.0,Phase3-EA-S4v1-EURCHF-M15-221,EURCHFMT4,1352,2h 44m,Buy
67390.26,128665,14.09.2010 08:59:58,tp 128.665,0.0,-345.6000000000058,0.0,0.0,128275,14.09.2010 03:55:00,5586,-0.21910046326815352,107.5,IS,0.23,0.0,Phase3-EA-S4v1-GBPJPY-M5-194,GBPJPYMT4,1422,5h 4m,Buy
67257.96,1.28757,14.09.2010 12:44:58,sl 1.28757,0.0,-477.8999999999942,0.0,0.0,1.29147,14.09.2010 06:45:00,5587,-0.30297485936298474,-132.3,IS,0.34,0.0,Phase3-EA-S4v1-EURCHF-M15-221,EURCHFMT4,1354,5h 59m,Buy
67303.31,1.29472,14.09.2010 22:44:58,tp 1.29472,0.0,-432.54999999998836,0.0,0.0,1.29582,14.09.2010 20:10:00,5588,-0.2742242632715152,45.35,IS,0.41,0.0,Phase3-EA-SA2v2-EURCHF-M5-43,EURCHFMT4,2910,2h 34m,Sell
67301.2,83064,15.09.2010 00:15:00,,-1.46,-434.6599999999744,0.0,0.0,83062,14.09.2010 22:00:00,5589,-0.2755619426045382,-2.11,IS,0.27,0.0,Phase3-EA-S1v2-USDJPY-M15-0,USDJPYMT4,1894,2h 15m,Sell
67356.4,995,15.09.2010 02:29:57,tp 0.99500,-3.09,-379.45999999996275,0.0,0.0,996,14.09.2010 23:30:00,5590,-0.24056672972142354,55.2,IS,0.58,0.0,Phase3-EA-SA2v2-USDCHF-M15-107,USDCHFMT4,1134,2h 59m,Sell
67400.69,1.29572,15.09.2010 03:19:57,tp 1.29572,-0.99,-335.1699999999546,0.0,0.0,1.29462,14.09.2010 22:50:00,5591,-0.21248814315270784,44.29,IS,0.41,0.0,Phase3-EA-SA2v2-EURCHF-M5-43,EURCHFMT4,2912,4h 29m,Buy
67508.92,129419,15.09.2010 04:34:59,tp 129.419,0.0,-226.93999999994412,0.0,0.0,129029,15.09.2010 00:10:00,5592,-0.14387343499439142,108.23,IS,0.23,0.0,Phase3-EA-S4v1-GBPJPY-M5-194,GBPJPYMT4,1424,4h 24m,Buy
67423.46,108439,15.09.2010 04:59:58,sl 108.439,-0.76,-312.39999999993597,0.0,0.0,107659,13.09.2010 19:00:00,5593,-0.1980526178384143,-85.46,IS,0.09,0.0,Phase3-EA-TR1v1-EURJPY-M30-91,EURJPYMT4,806,1d 9h 59m,Sell
67559.67,1.29786,15.09.2010 05:14:58,tp 1.29786,0.0,-176.18999999994412,0.0,0.0,1.29386,15.09.2010 01:15:00,5594,-0.11169939416436075,136.21,IS,0.34,0.0,Phase3-EA-S4v1-EURCHF-M15-221,EURCHFMT4,1356,3h 59m,Buy
67694.01,109473,15.09.2010 05:29:58,tp 109.473,-0.53,-41.84999999994761,0.0,0.0,108213,14.09.2010 22:30:00,5595,-0.026531696723844308,134.34,IS,0.09,0.0,Phase3-EA-TR1v1-EURJPY-M30-91,EURJPYMT4,807,6h 59m,Buy
67561.77,1.30095,15.09.2010 07:14:57,sl 1.30095,0.0,-174.0899999999383,0.0,0.0,1.29705,15.09.2010 05:45:00,5596,-0.11036805454380406,-132.24,IS,0.34,0.0,Phase3-EA-S4v1-EURCHF-M15-221,EURCHFMT4,1358,1h 29m,Sell
67606.76,1.30421,15.09.2010 20:44:58,tp 1.30421,0.0,-129.0999999999476,0.0,0.0,1.30311,15.09.2010 20:00:00,5597,-0.08184568810158178,44.99,IS,0.41,0.0,Phase3-EA-SA2v2-EURCHF-M5-43,EURCHFMT4,2914,44m 58s,Buy
67661.28,85682,15.09.2010 23:30:00,,0.0,-74.57999999995809,0.0,0.0,85509,15.09.2010 20:00:00,5598,-0.04728157566704118,54.52,IS,0.27,0.0,Phase3-EA-S1v2-USDJPY-M15-0,USDJPYMT4,1896,3h 30m,Buy
67700.16,1.30395,16.09.2010 02:04:57,tp 1.30395,-6.13,-35.699999999953434,0.0,0.0,1.30505,15.09.2010 22:05:00,5599,-0.022632773549371373,38.88,IS,0.41,0.0,Phase3-EA-SA2v2-EURCHF-M5-43,EURCHFMT4,2916,3h 59m,Sell
67528.15,133042,16.09.2010 08:40:00,,0.0,-207.70999999996275,0.0,0.0,133.68,16.09.2010 03:15:00,5600,-0.1316821678976251,-172.01,IS,0.23,0.0,Phase3-EA-S4v1-GBPJPY-M5-194,GBPJPYMT4,1426,5h 25m,Buy
67327.47,1.29944,16.09.2010 08:59:58,sl 1.29944,0.0,-408.38999999995576,0.0,0.0,1.30434,16.09.2010 02:10:00,5601,-0.2589075179226563,-200.68,IS,0.41,0.0,Phase3-EA-SA2v2-EURCHF-M5-43,EURCHFMT4,2918,6h 49m,Buy
67463.04,1.30644,16.09.2010 11:44:58,tp 1.30644,0.0,-272.8199999999488,0.0,0.0,1.30244,16.09.2010 05:00:00,5602,-0.17296003584723788,135.57,IS,0.34,0.0,Phase3-EA-S4v1-EURCHF-M15-221,EURCHFMT4,1360,6h 44m,Buy
67593.89,112074,16.09.2010 13:29:57,tp 112.074,-1.54,-141.96999999994296,0.0,0.0,110814,15.09.2010 11:30:00,5603,-0.09000489806182504,130.85,IS,0.09,0.0,Phase3-EA-TR1v1-EURJPY-M30-91,EURJPYMT4,810,1d 1h 59m,Buy
67602.08,85667,16.09.2010 18:00:00,,0.0,-133.77999999994063,0.0,0.0,85641,16.09.2010 17:30:00,5604,-0.08481267354166688,8.19,IS,0.27,0.0,Phase3-EA-S1v2-USDJPY-M15-0,USDJPYMT4,1898,30m 0s,Buy
67604.92,85678,16.09.2010 18:15:00,,0.0,-130.93999999994412,0.0,0.0,85669,16.09.2010 18:00:00,5605,-0.08301219519768314,2.84,IS,0.27,0.0,Phase3-EA-S1v2-USDJPY-M15-0,USDJPYMT4,1900,15m 0s,Buy
67649.38,1.32602,16.09.2010 20:49:58,tp 1.32602,0.0,-86.47999999995227,0.0,0.0,1.32492,16.09.2010 20:30:00,5606,-0.054825833516837785,44.46,IS,0.41,0.0,Phase3-EA-SA2v2-EURCHF-M5-43,EURCHFMT4,2920,19m 58s,Buy
67577.83,1.01569,17.09.2010 02:30:00,,-3.03,-158.02999999994063,0.0,0.0,1.01449,16.09.2010 22:15:00,5607,-0.10018647630281455,-71.55,IS,0.58,0.0,Phase3-EA-SA2v2-USDCHF-M15-107,USDCHFMT4,1136,4h 15m,Sell
67481.78,1.32975,17.09.2010 06:00:00,,-2.02,-254.079999999929,0.0,0.0,1.32742,16.09.2010 21:40:00,5608,-0.1610794146619096,-96.05,IS,0.41,0.0,Phase3-EA-SA2v2-EURCHF-M5-43,EURCHFMT4,2922,8h 20m,Sell
67436.18,112.16,17.09.2010 14:59:57,sl 112.160,0.0,-299.6799999999348,0.0,0.0,112.39,17.09.2010 06:15:00,5609,-0.18998850356534971,-45.6,IS,0.17,0.0,Phase3-EA-T1v2-EURJPY-M15-322,EURJPYMT4,684,8h 44m,Buy
67479.85,1.31888,20.09.2010 03:19:57,tp 1.31888,-0.97,-256.009999999922,0.0,0.0,1.31778,17.09.2010 22:20:00,5610,-0.16230297917031813,43.67,IS,0.41,0.0,Phase3-EA-SA2v2-EURCHF-M5-43,EURCHFMT4,2924,2d 4h 59m,Buy
67583.54,134324,20.09.2010 05:05:00,tp 134.324,-0.96,-152.31999999991967,0.0,0.0,133934,17.09.2010 23:45:00,5611,-0.09656650047739289,103.69,IS,0.23,0.0,Phase3-EA-S4v1-GBPJPY-M5-194,GBPJPYMT4,1428,2d 5h 20m,Buy
67452.36,1.3221,20.09.2010 07:44:57,sl 1.32210,0.0,-283.4999999999127,0.0,0.0,1.3182,20.09.2010 03:45:00,5612,-0.1797308487745988,-131.18,IS,0.34,0.0,Phase3-EA-S4v1-EURCHF-M15-221,EURCHFMT4,1362,3h 59m,Sell
67410.36,1.56422,20.09.2010 10:29:58,sl 1.56422,0.0,-325.4999999999127,0.0,0.0,1.56722,20.09.2010 09:00:00,5613,-0.2063576411856587,-42.0,IS,0.14,0.0,Phase3-EA-B1v1-GBPUSD-M30-14,GBPUSDMT4,358,1h 29m,Buy
67455.21,1.3139,20.09.2010 21:29:57,tp 1.31390,0.0,-280.64999999990687,0.0,0.0,1.3128,20.09.2010 21:00:00,5614,-0.17792403071813034,44.85,IS,0.41,0.0,Phase3-EA-SA2v2-EURCHF-M5-43,EURCHFMT4,2926,29m 57s,Buy
67590.71,1.31577,21.09.2010 07:14:58,tp 1.31577,0.0,-145.14999999990687,0.0,0.0,1.31177,21.09.2010 04:00:00,5615,-0.09202092663006813,135.5,IS,0.34,0.0,Phase3-EA-S4v1-EURCHF-M15-221,EURCHFMT4,1364,3h 14m,Buy
67545.01,111829,21.09.2010 09:44:58,sl 111.829,0.0,-190.8499999999185,0.0,0.0,112059,21.09.2010 05:00:00,5616,-0.12099341265830017,-45.7,IS,0.17,0.0,Phase3-EA-T1v2-EURJPY-M15-322,EURJPYMT4,686,4h 44m,Buy
67499.27,112021,21.09.2010 14:14:58,sl 112.021,0.0,-236.5899999999092,0.0,0.0,112251,21.09.2010 12:15:00,5617,-0.14999125753643425,-45.74,IS,0.17,0.0,Phase3-EA-T1v2-EURJPY-M15-322,EURJPYMT4,688,1h 59m,Buy
67483.14,112049,21.09.2010 19:15:00,,0.0,-252.71999999991385,0.0,0.0,112.13,21.09.2010 18:45:00,5618,-0.16021721376477996,-16.13,IS,0.17,0.0,Phase3-EA-T1v2-EURJPY-M15-322,EURJPYMT4,690,30m 0s,Buy
67497.7,85326,21.09.2010 20:45:00,,0.0,-238.15999999991618,0.0,0.0,85372,21.09.2010 20:00:00,5619,-0.150986592395614,14.56,IS,0.27,0.0,Phase3-EA-S1v2-USDJPY-M15-0,USDJPYMT4,1902,45m 0s,Sell
67542.57,1.31865,21.09.2010 20:49:58,tp 1.31865,0.0,-193.28999999992084,0.0,0.0,1.31975,21.09.2010 20:05:00,5620,-0.12254030250313465,44.87,IS,0.41,0.0,Phase3-EA-SA2v2-EURCHF-M5-43,EURCHFMT4,2928,44m 58s,Sell
67587.59,1.32121,21.09.2010 21:29:57,tp 1.32121,0.0,-148.26999999993131,0.0,0.0,1.32231,21.09.2010 21:25:00,5621,-0.09399891692347664,45.02,IS,0.41,0.0,Phase3-EA-SA2v2-EURCHF-M5-43,EURCHFMT4,2930,4m 57s,Sell
67645.74,0.99749,22.09.2010 04:44:58,tp 0.99749,0.0,-90.11999999993714,0.0,0.0,0.99649,22.09.2010 02:45:00,5622,-0.05713348885912005,58.15,IS,0.58,0.0,Phase3-EA-SA2v2-USDCHF-M15-107,USDCHFMT4,1138,1h 59m,Buy
67751.38,132989,22.09.2010 08:24:58,tp 132.989,0.0,-0.0,0.0,0.0,132599,22.09.2010 03:55:00,5623,-0.0,105.64,IS,0.23,0.0,Phase3-EA-S4v1-GBPJPY-M5-194,GBPJPYMT4,1430,4h 29m,Buy
67888.21,1.32099,22.09.2010 10:44:57,tp 1.32099,0.0,-0.0,0.0,0.0,1.32499,22.09.2010 05:00:00,5624,-0.0,136.83,IS,0.34,0.0,Phase3-EA-S4v1-EURCHF-M15-221,EURCHFMT4,1366,5h 44m,Sell
67937.11,112.7,22.09.2010 11:15:00,,-0.98,-0.0,0.0,0.0,112451,21.09.2010 21:30:00,5625,-0.0,48.9,IS,0.17,0.0,Phase3-EA-T1v2-EURJPY-M15-322,EURJPYMT4,692,13h 45m,Buy
68069.12,113311,22.09.2010 13:29:58,tp 113.311,-2.05,-0.0,0.0,0.0,112051,16.09.2010 13:30:00,5626,-0.0,132.01,IS,0.09,0.0,Phase3-EA-TR1v1-EURJPY-M30-91,EURJPYMT4,812,5d 23h 59m,Buy
68022.81,112902,22.09.2010 18:29:58,sl 112.902,0.0,-46.30999999999767,0.0,0.0,113132,22.09.2010 12:45:00,5627,-0.029297309936309936,-46.31,IS,0.17,0.0,Phase3-EA-T1v2-EURJPY-M15-322,EURJPYMT4,694,5h 44m,Buy
68068.51,1.32059,22.09.2010 20:54:58,tp 1.32059,0.0,-0.6099999999860302,0.0,0.0,1.31949,22.09.2010 20:25:00,5628,-3.8590712720234686E-4,45.7,IS,0.41,0.0,Phase3-EA-SA2v2-EURCHF-M5-43,EURCHFMT4,2932,29m 58s,Buy
68114.21,1.32034,22.09.2010 22:04:58,tp 1.32034,0.0,-0.0,0.0,0.0,1.32144,22.09.2010 21:30:00,5629,-0.0,45.7,IS,0.41,0.0,Phase3-EA-SA2v2-EURCHF-M5-43,EURCHFMT4,2934,34m 58s,Sell
68159.92,1.32099,23.09.2010 01:49:57,tp 1.32099,0.0,-0.0,0.0,0.0,1.32209,23.09.2010 00:25:00,5630,-0.0,45.71,IS,0.41,0.0,Phase3-EA-SA2v2-EURCHF-M5-43,EURCHFMT4,2936,1h 24m,Sell
68119.62,1.32324,23.09.2010 09:45:00,,0.0,-40.29999999998836,0.0,0.0,1.32207,23.09.2010 01:00:00,5631,-0.025480538938049767,-40.3,IS,0.34,0.0,Phase3-EA-S4v1-EURCHF-M15-221,EURCHFMT4,1368,8h 45m,Sell
68165.37,1.31439,23.09.2010 21:49:57,tp 1.31439,0.0,-0.0,0.0,0.0,1.31549,23.09.2010 21:25:00,5632,-0.0,45.75,IS,0.41,0.0,Phase3-EA-SA2v2-EURCHF-M5-43,EURCHFMT4,2938,24m 57s,Sell
68118.39,112704,24.09.2010 04:44:58,sl 112.704,-0.71,-46.98000000001048,0.0,0.0,112474,23.09.2010 22:15:00,5633,-0.029703088609099756,-46.98,IS,0.17,0.0,Phase3-EA-T1v2-EURJPY-M15-322,EURJPYMT4,696,6h 29m,Sell
68163.13,1.31384,24.09.2010 05:14:58,tp 1.31384,-1.0,-2.2400000000197906,0.0,0.0,1.31274,23.09.2010 22:35:00,5634,-0.001416239218496306,44.74,IS,0.41,0.0,Phase3-EA-SA2v2-EURCHF-M5-43,EURCHFMT4,2940,6h 39m,Buy
68109.54,132.7,24.09.2010 07:15:00,,0.0,-55.8300000000163,0.0,0.0,132503,24.09.2010 01:50:00,5635,-0.03529849802141664,-53.59,IS,0.23,0.0,Phase3-EA-S4v1-GBPJPY-M5-194,GBPJPYMT4,1432,5h 25m,Sell
68247.74,1.30975,24.09.2010 09:45:00,tp 1.30975,0.0,-0.0,0.0,0.0,1.31375,24.09.2010 05:45:00,5636,-0.0,138.2,IS,0.34,0.0,Phase3-EA-S4v1-EURCHF-M15-221,EURCHFMT4,1370,4h 0m,Sell
68273.71,84216,24.09.2010 23:45:00,,0.0,-0.0,0.0,0.0,84297,24.09.2010 19:15:00,5637,-0.0,25.97,IS,0.27,0.0,Phase3-EA-S1v2-USDJPY-M15-0,USDJPYMT4,1904,4h 30m,Sell
68317.51,1.32608,27.09.2010 01:00:00,tp 1.32608,-2.09,-0.0,0.0,0.0,1.32718,24.09.2010 20:05:00,5638,-0.0,43.8,IS,0.41,0.0,Phase3-EA-SA2v2-EURCHF-M5-43,EURCHFMT4,2942,2d 4h 55m,Sell
68363.35,1.3276,27.09.2010 01:14:58,tp 1.32760,0.0,-0.0,0.0,0.0,1.3265,27.09.2010 01:05:00,5639,-0.0,45.84,IS,0.41,0.0,Phase3-EA-SA2v2-EURCHF-M5-43,EURCHFMT4,2944,9m 58s,Buy
68356.16,0.9848,27.09.2010 04:00:00,,-0.71,-7.190000000002328,0.0,0.0,0.98491,24.09.2010 23:45:00,5640,-0.004540191906777881,-7.19,IS,0.58,0.0,Phase3-EA-SA2v2-USDCHF-M15-107,USDCHFMT4,1140,2d 4h 15m,Buy
68401.97,1.32557,27.09.2010 22:59:58,tp 1.32557,0.0,-0.0,0.0,0.0,1.32667,27.09.2010 21:15:00,5641,-0.0,45.81,IS,0.41,0.0,Phase3-EA-SA2v2-EURCHF-M5-43,EURCHFMT4,2946,1h 44m,Sell
68436.65,133329,28.09.2010 06:25:00,,0.0,-0.0,0.0,0.0,133202,28.09.2010 01:00:00,5642,-0.0,34.68,IS,0.23,0.0,Phase3-EA-S4v1-GBPJPY-M5-194,GBPJPYMT4,1434,5h 25m,Buy
68381.01,1.32389,28.09.2010 07:55:00,,-1.0,-55.64000000001397,0.0,0.0,1.3252,27.09.2010 23:35:00,5643,-0.03511813712295355,-55.64,IS,0.41,0.0,Phase3-EA-SA2v2-EURCHF-M5-43,EURCHFMT4,2948,8h 20m,Buy
68246.25,1.32062,28.09.2010 09:14:58,sl 1.32062,0.0,-190.40000000002328,0.0,0.0,1.32452,28.09.2010 01:45:00,5644,-0.12017421474136403,-134.76,IS,0.34,0.0,Phase3-EA-S4v1-EURCHF-M15-221,EURCHFMT4,1372,7h 29m,Buy
68199.08,113564,28.09.2010 16:14:58,sl 113.564,-0.71,-237.5700000000361,0.0,0.0,113334,27.09.2010 23:30:00,5645,-0.14994636657619065,-47.17,IS,0.17,0.0,Phase3-EA-T1v2-EURJPY-M15-322,EURJPYMT4,698,16h 44m,Sell
68245.23,1.32398,28.09.2010 21:49:58,tp 1.32398,0.0,-191.4200000000419,0.0,0.0,1.32508,28.09.2010 20:30:00,5646,-0.12081800517749015,46.15,IS,0.41,0.0,Phase3-EA-SA2v2-EURCHF-M5-43,EURCHFMT4,2950,1h 19m,Sell
68159.28,113943,28.09.2010 22:59:58,sl 113.943,-2.23,-277.37000000005355,0.0,0.0,113163,22.09.2010 16:00:00,5647,-0.17506681692654674,-85.95,IS,0.09,0.0,Phase3-EA-TR1v1-EURJPY-M30-91,EURJPYMT4,814,6d 6h 59m,Sell
68203.36,1.32489,29.09.2010 02:04:57,tp 1.32489,-2.1,-233.29000000006636,0.0,0.0,1.32599,28.09.2010 23:00:00,5648,-0.1472449714129063,44.08,IS,0.41,0.0,Phase3-EA-SA2v2-EURCHF-M5-43,EURCHFMT4,2952,3h 4m,Sell
68249.55,1.32607,29.09.2010 03:34:58,tp 1.32607,0.0,-187.10000000006403,0.0,0.0,1.32497,29.09.2010 02:05:00,5649,-0.11809136333043148,46.19,IS,0.41,0.0,Phase3-EA-SA2v2-EURCHF-M5-43,EURCHFMT4,2954,1h 29m,Buy
68262.59,83837,29.09.2010 05:00:00,,-1.45,-174.06000000005588,0.0,0.0,83882,28.09.2010 21:45:00,5650,-0.10986094442167006,13.04,IS,0.27,0.0,Phase3-EA-S1v2-USDJPY-M15-0,USDJPYMT4,1906,7h 15m,Sell
68262.86,132585,29.09.2010 07:05:00,,0.0,-173.79000000006636,0.0,0.0,132586,29.09.2010 01:40:00,5651,-0.10969052930623463,0.27,IS,0.23,0.0,Phase3-EA-S4v1-GBPJPY-M5-194,GBPJPYMT4,1436,5h 25m,Sell
68309.04,1.33042,29.09.2010 22:24:57,tp 1.33042,0.0,-127.61000000007334,0.0,0.0,1.33152,29.09.2010 21:15:00,5652,-0.080543232894708,46.18,IS,0.41,0.0,Phase3-EA-SA2v2-EURCHF-M5-43,EURCHFMT4,2956,1h 9m,Sell
68279.19,113694,30.09.2010 05:30:00,,-2.99,-157.46000000007916,0.0,0.0,113826,29.09.2010 14:15:00,5653,-0.09938357065747047,-29.85,IS,0.17,0.0,Phase3-EA-T1v2-EURJPY-M15-322,EURJPYMT4,700,15h 15m,Buy
68143.7,1.32658,30.09.2010 09:14:58,sl 1.32658,0.0,-292.95000000006985,0.0,0.0,1.33048,30.09.2010 04:30:00,5654,-0.18490040025465693,-135.49,IS,0.34,0.0,Phase3-EA-S4v1-EURCHF-M15-221,EURCHFMT4,1374,4h 44m,Buy
68154.18,1.33116,30.09.2010 10:50:00,,0.0,-282.4700000000594,0.0,0.0,1.33091,30.09.2010 02:30:00,5655,-0.17828576910712227,10.48,IS,0.41,0.0,Phase3-EA-SA2v2-EURCHF-M5-43,EURCHFMT4,2958,8h 20m,Buy
68076.7,114.0,30.09.2010 16:59:58,sl 114.000,0.0,-359.95000000006985,0.0,0.0,113.81,29.09.2010 06:00:00,5656,-0.22718859556805193,-77.48,IS,0.09,0.0,Phase3-EA-TR1v1-EURJPY-M30-91,EURJPYMT4,816,1d 10h 59m,Sell
68268.83,131413,30.09.2010 17:29:58,tp 131.413,-7.42,-167.8200000000652,0.0,0.0,133263,20.09.2010 22:00:00,5657,-0.10592246175368214,192.13,IS,0.09,0.0,Phase3-EA-B1v1-GBPJPY-M30-1,GBPJPYMT4,626,9d 19h 29m,Sell
68314.77,1.33669,30.09.2010 20:39:58,tp 1.33669,0.0,-121.88000000006286,0.0,0.0,1.33779,30.09.2010 20:30:00,5658,-0.07692664544476477,45.94,IS,0.41,0.0,Phase3-EA-SA2v2-EURCHF-M5-43,EURCHFMT4,2960,9m 58s,Sell
68267.94,113906,30.09.2010 23:29:58,sl 113.906,0.0,-168.71000000005006,0.0,0.0,113676,30.09.2010 19:45:00,5659,-0.1064842004675371,-46.83,IS,0.17,0.0,Phase3-EA-T1v2-EURJPY-M15-322,EURJPYMT4,702,3h 44m,Sell
68299.31,83568,01.10.2010 01:15:00,,-0.94,-137.34000000005472,0.0,0.0,83468,30.09.2010 22:15:00,5660,-0.08668448872155196,31.37,IS,0.27,0.0,Phase3-EA-S1v2-USDJPY-M15-0,USDJPYMT4,1908,3h 0m,Buy
68358.34,0.98247,01.10.2010 02:44:58,tp 0.98247,0.0,-78.31000000005588,0.0,0.0,0.98347,01.10.2010 01:15:00,5661,-0.04942669514916902,59.03,IS,0.58,0.0,Phase3-EA-SA2v2-USDCHF-M15-107,USDCHFMT4,1142,1h 29m,Sell
68402.27,1.33698,01.10.2010 04:14:57,tp 1.33698,-2.09,-34.380000000062864,0.0,0.0,1.33808,30.09.2010 21:15:00,5662,-0.021699524699659373,43.93,IS,0.41,0.0,Phase3-EA-SA2v2-EURCHF-M5-43,EURCHFMT4,2962,6h 59m,Sell
68412.75,131219,01.10.2010 06:45:00,,0.0,-23.900000000052387,0.0,0.0,131257,01.10.2010 01:20:00,5663,-0.015084893552124709,10.48,IS,0.23,0.0,Phase3-EA-S4v1-GBPJPY-M5-194,GBPJPYMT4,1438,5h 25m,Sell
68509.93,1.3372,01.10.2010 10:00:00,,0.0,-0.0,0.0,0.0,1.34,01.10.2010 01:15:00,5664,-0.0,97.18,IS,0.34,0.0,Phase3-EA-S4v1-EURCHF-M15-221,EURCHFMT4,1376,8h 45m,Sell
68424.23,114.59,01.10.2010 17:29:58,sl 114.590,-1.51,-85.70000000001164,0.0,0.0,113.28,30.09.2010 09:30:00,5665,-0.05406601340371023,-85.7,IS,0.09,0.0,Phase3-EA-TR1v1-EURJPY-M30-91,EURJPYMT4,817,1d 7h 59m,Sell
68470.48,1.34345,01.10.2010 22:44:57,tp 1.34345,0.0,-39.45000000001164,0.0,0.0,1.34455,01.10.2010 20:45:00,5666,-0.024888030674173958,46.25,IS,0.41,0.0,Phase3-EA-SA2v2-EURCHF-M5-43,EURCHFMT4,2964,1h 59m,Sell
68447.18,0.97566,04.10.2010 02:30:00,,-0.71,-62.75,0.0,0.0,0.97604,01.10.2010 22:15:00,5667,-0.03958742521683029,-23.3,IS,0.58,0.0,Phase3-EA-SA2v2-USDCHF-M15-107,USDCHFMT4,1144,2d 4h 15m,Buy
68493.41,1.34382,04.10.2010 02:39:57,tp 1.34382,0.0,-16.519999999989523,0.0,0.0,1.34492,04.10.2010 01:55:00,5668,-0.010422059993332615,46.23,IS,0.41,0.0,Phase3-EA-SA2v2-EURCHF-M5-43,EURCHFMT4,2966,44m 57s,Sell
68600.86,132061,04.10.2010 04:24:57,tp 132.061,0.0,-0.0,0.0,0.0,131671,04.10.2010 01:05:00,5669,-0.0,107.45,IS,0.23,0.0,Phase3-EA-S4v1-GBPJPY-M5-194,GBPJPYMT4,1440,3h 19m,Buy
68739.97,1.34145,04.10.2010 10:44:57,tp 1.34145,0.0,-0.0,0.0,0.0,1.34545,04.10.2010 06:00:00,5670,-0.0,139.11,IS,0.34,0.0,Phase3-EA-S4v1-EURCHF-M15-221,EURCHFMT4,1378,4h 44m,Sell
68786.35,1.33157,04.10.2010 21:04:58,tp 1.33157,0.0,-0.0,0.0,0.0,1.33047,04.10.2010 20:10:00,5671,-0.0,46.38,IS,0.41,0.0,Phase3-EA-SA2v2-EURCHF-M5-43,EURCHFMT4,2968,54m 58s,Buy
68738.81,114256,05.10.2010 02:14:58,sl 114.256,-0.71,-47.54000000000815,0.0,0.0,114026,04.10.2010 22:30:00,5672,-0.0299396012314712,-47.54,IS,0.17,0.0,Phase3-EA-T1v2-EURJPY-M15-322,EURJPYMT4,704,3h 44m,Sell
68798.47,0.97212,05.10.2010 02:59:58,tp 0.97212,0.0,-0.0,0.0,0.0,0.97112,05.10.2010 01:00:00,5673,-0.0,59.66,IS,0.58,0.0,Phase3-EA-SA2v2-USDCHF-M15-107,USDCHFMT4,1146,1h 59m,Buy
68761.2,1.32942,05.10.2010 07:45:00,,-1.01,-37.26999999998952,0.0,0.0,1.33028,04.10.2010 23:25:00,5674,-0.023469999427569766,-37.27,IS,0.41,0.0,Phase3-EA-SA2v2-EURCHF-M5-43,EURCHFMT4,2970,8h 20m,Buy
68714.53,114337,05.10.2010 08:14:58,sl 114.337,0.0,-83.94000000000233,0.0,0.0,114567,05.10.2010 07:45:00,5675,-0.05285945135365749,-46.67,IS,0.17,0.0,Phase3-EA-T1v2-EURJPY-M15-322,EURJPYMT4,706,29m 58s,Buy
68810.41,1.3314,05.10.2010 10:00:00,,0.0,-0.0,0.0,0.0,1.32866,05.10.2010 01:15:00,5676,-0.0,95.88,IS,0.34,0.0,Phase3-EA-S4v1-EURCHF-M15-221,EURCHFMT4,1380,8h 45m,Buy
68945.54,115.29,05.10.2010 20:59:58,tp 115.290,-1.06,-0.0,0.0,0.0,114.03,01.10.2010 06:00:00,5677,-0.0,135.13,IS,0.09,0.0,Phase3-EA-TR1v1-EURJPY-M30-91,EURJPYMT4,819,4d 14h 59m,Buy
68992.26,1.33727,05.10.2010 21:39:57,tp 1.33727,0.0,-0.0,0.0,0.0,1.33837,05.10.2010 20:50:00,5678,-0.0,46.72,IS,0.41,0.0,Phase3-EA-SA2v2-EURCHF-M5-43,EURCHFMT4,2972,49m 57s,Sell
69038.94,1.33819,06.10.2010 03:24:57,tp 1.33819,0.0,-0.0,0.0,0.0,1.33709,06.10.2010 00:05:00,5679,-0.0,46.68,IS,0.41,0.0,Phase3-EA-SA2v2-EURCHF-M5-43,EURCHFMT4,2974,3h 19m,Buy
69179.76,1.34004,06.10.2010 09:29:58,tp 1.34004,0.0,-0.0,0.0,0.0,1.33604,06.10.2010 05:30:00,5680,-0.0,140.82,IS,0.34,0.0,Phase3-EA-S4v1-EURCHF-M15-221,EURCHFMT4,1382,3h 59m,Buy
69169.95,1.33905,07.10.2010 04:25:00,,-6.4,-9.809999999997672,0.0,0.0,1.33897,06.10.2010 20:05:00,5681,-0.006162843818835809,-9.81,IS,0.41,0.0,Phase3-EA-SA2v2-EURCHF-M5-43,EURCHFMT4,2976,8h 20m,Sell
69214.68,115411,07.10.2010 04:30:00,,-3.01,-0.0,0.0,0.0,115178,06.10.2010 17:45:00,5682,-0.0,44.73,IS,0.17,0.0,Phase3-EA-T1v2-EURJPY-M15-322,EURJPYMT4,708,10h 45m,Buy
69355.97,1.34264,07.10.2010 09:44:58,tp 1.34264,0.0,-0.0,0.0,0.0,1.33864,07.10.2010 05:45:00,5683,-0.0,141.29,IS,0.34,0.0,Phase3-EA-S4v1-EURCHF-M15-221,EURCHFMT4,1384,3h 59m,Buy
69308.7,115336,07.10.2010 10:29:58,sl 115.336,0.0,-47.26999999998952,0.0,0.0,115566,07.10.2010 10:00:00,5684,-0.029663149739535672,-47.27,IS,0.17,0.0,Phase3-EA-T1v2-EURJPY-M15-322,EURJPYMT4,710,29m 58s,Buy
69570.11,1.59524,07.10.2010 11:29:58,tp 1.59524,-3.19,-0.0,0.0,0.0,1.57634,01.10.2010 10:30:00,5685,-0.0,261.41,IS,0.14,0.0,Phase3-EA-B1v1-GBPUSD-M30-14,GBPUSDMT4,360,6d 0h 59m,Buy
69571.79,0.96652,08.10.2010 02:30:00,,-0.72,-0.0,0.0,0.0,0.96648,07.10.2010 22:15:00,5686,-0.0,1.68,IS,0.58,0.0,Phase3-EA-SA2v2-USDCHF-M15-107,USDCHFMT4,1148,4h 15m,Buy
69618.47,1.34552,08.10.2010 03:04:57,tp 1.34552,0.0,-0.0,0.0,0.0,1.34442,08.10.2010 00:45:00,5687,-0.0,46.68,IS,0.41,0.0,Phase3-EA-SA2v2-EURCHF-M5-43,EURCHFMT4,2978,2h 19m,Buy
69757.74,113837,08.10.2010 15:59:58,tp 113.837,-1.52,-0.0,0.0,0.0,115127,06.10.2010 00:30:00,5688,-0.0,139.27,IS,0.09,0.0,Phase3-EA-TR1v1-EURJPY-M30-91,EURJPYMT4,822,2d 15h 29m,Sell
69804.64,1.33772,08.10.2010 21:44:59,tp 1.33772,0.0,-0.0,0.0,0.0,1.33662,08.10.2010 21:05:00,5689,-0.0,46.9,IS,0.41,0.0,Phase3-EA-SA2v2-EURCHF-M5-43,EURCHFMT4,2980,39m 59s,Buy
69861.69,0.9628,11.10.2010 01:00:00,tp 0.96280,-3.19,-0.0,0.0,0.0,0.9638,08.10.2010 22:15:00,5690,-0.0,57.05,IS,0.58,0.0,Phase3-EA-SA2v2-USDCHF-M15-107,USDCHFMT4,1150,2d 2h 45m,Sell
69992.55,81.61,11.10.2010 01:00:00,tp 81.610,-1.48,-0.0,0.0,0.0,82.01,08.10.2010 20:15:00,5691,-0.0,130.86,IS,0.27,0.0,Phase3-EA-S1v2-USDJPY-M15-0,USDJPYMT4,1910,2d 4h 45m,Sell
69781.95,1.3444,11.10.2010 01:00:00,sl 1.34440,-2.13,-210.60000000000582,0.0,0.0,1.3395,08.10.2010 21:55:00,5692,-0.13163112907445126,-210.6,IS,0.41,0.0,Phase3-EA-SA2v2-EURCHF-M5-43,EURCHFMT4,2982,2d 3h 5m,Sell
69891.59,130712,11.10.2010 03:04:59,tp 130.712,0.0,-100.95999999999185,0.0,0.0,130322,11.10.2010 01:25:00,5693,-0.06310293823055631,109.64,IS,0.23,0.0,Phase3-EA-S4v1-GBPJPY-M5-194,GBPJPYMT4,1442,1h 39m,Buy
69938.5,1.3429,11.10.2010 08:29:57,tp 1.34290,0.0,-54.04999999998836,0.0,0.0,1344,11.10.2010 01:05:00,5694,-0.03378282301268928,46.91,IS,0.41,0.0,Phase3-EA-SA2v2-EURCHF-M5-43,EURCHFMT4,2984,7h 24m,Sell
70080.26,1.3407,11.10.2010 10:14:58,tp 1.34070,0.0,-0.0,0.0,0.0,1.3447,11.10.2010 02:45:00,5695,-0.0,141.76,IS,0.34,0.0,Phase3-EA-S4v1-EURCHF-M15-221,EURCHFMT4,1386,7h 29m,Sell
70063.95,1.33788,12.10.2010 04:40:00,,-1.02,-16.30999999999767,0.0,0.0,1.33824,11.10.2010 20:20:00,5696,-0.010188639123898023,-16.31,IS,0.41,0.0,Phase3-EA-SA2v2-EURCHF-M5-43,EURCHFMT4,2986,8h 20m,Buy
70173.47,130162,12.10.2010 06:59:58,tp 130.162,0.0,-0.0,0.0,0.0,130552,12.10.2010 03:05:00,5697,-0.0,109.52,IS,0.23,0.0,Phase3-EA-S4v1-GBPJPY-M5-194,GBPJPYMT4,1444,3h 54m,Sell
70524.19,113552,12.10.2010 08:44:58,tp 113.552,-2.17,-0.0,0.0,0.0,115252,07.10.2010 11:00:00,5698,-0.0,350.72,IS,0.17,0.0,Phase3-EA-T1v2-EURJPY-M15-322,EURJPYMT4,712,4d 21h 44m,Sell
70661.55,113147,12.10.2010 09:29:58,tp 113.147,-1.14,-0.0,0.0,0.0,114407,07.10.2010 20:30:00,5699,-0.0,137.36,IS,0.09,0.0,Phase3-EA-TR1v1-EURJPY-M30-91,EURJPYMT4,823,4d 12h 59m,Sell
70801.77,1.34068,12.10.2010 11:44:57,tp 1.34068,0.0,-0.0,0.0,0.0,1.33668,12.10.2010 04:30:00,5700,-0.0,140.22,IS,0.34,0.0,Phase3-EA-S4v1-EURCHF-M15-221,EURCHFMT4,1388,7h 14m,Buy
70850.66,81736,12.10.2010 21:30:00,,0.0,-0.0,0.0,0.0,81884,12.10.2010 20:15:00,5701,-0.0,48.89,IS,0.27,0.0,Phase3-EA-S1v2-USDJPY-M15-0,USDJPYMT4,1912,1h 15m,Sell
70742.53,1.33397,13.10.2010 05:40:00,,-2.14,-108.13000000000466,0.0,0.0,1.3315,12.10.2010 21:20:00,5702,-0.06722384601965867,-108.13,IS,0.41,0.0,Phase3-EA-SA2v2-EURCHF-M5-43,EURCHFMT4,2988,8h 20m,Sell
70603.91,1.3381,13.10.2010 10:29:58,sl 1.33810,0.0,-246.75,0.0,0.0,1.3342,13.10.2010 05:00:00,5703,-0.15340316290899902,-138.62,IS,0.34,0.0,Phase3-EA-S4v1-EURCHF-M15-221,EURCHFMT4,1390,5h 29m,Sell
70745.14,114643,13.10.2010 11:29:57,tp 114.643,-0.54,-105.51999999998952,0.0,0.0,113353,12.10.2010 13:00:00,5704,-0.0656012228983018,141.23,IS,0.09,0.0,Phase3-EA-TR1v1-EURJPY-M30-91,EURJPYMT4,826,22h 29m,Buy
70792.17,1.3388,13.10.2010 22:24:59,tp 1.33880,0.0,-58.48999999999069,0.0,0.0,1.3399,13.10.2010 21:20:00,5705,-0.03636292197992269,47.03,IS,0.41,0.0,Phase3-EA-SA2v2-EURCHF-M5-43,EURCHFMT4,2990,1h 4m,Sell
70836.21,1.33902,14.10.2010 03:04:57,tp 1.33902,-3.08,-14.449999999982538,0.0,0.0,1.33792,13.10.2010 23:20:00,5706,-0.00898348816223853,44.04,IS,0.41,0.0,Phase3-EA-SA2v2-EURCHF-M5-43,EURCHFMT4,2992,3h 44m,Buy
70978.32,1.34175,14.10.2010 03:14:57,tp 1.34175,0.0,-0.0,0.0,0.0,1.33775,14.10.2010 01:45:00,5707,-0.0,142.11,IS,0.34,0.0,Phase3-EA-S4v1-EURCHF-M15-221,EURCHFMT4,1392,1h 29m,Buy
71088.54,129825,14.10.2010 05:19:57,tp 129.825,0.0,-0.0,0.0,0.0,130215,14.10.2010 02:20:00,5708,-0.0,110.22,IS,0.23,0.0,Phase3-EA-S4v1-GBPJPY-M5-194,GBPJPYMT4,1446,2h 59m,Sell
71231.67,1.33742,14.10.2010 05:44:57,tp 1.33742,0.0,-0.0,0.0,0.0,1.34142,14.10.2010 04:15:00,5709,-0.0,143.13,IS,0.34,0.0,Phase3-EA-S4v1-EURCHF-M15-221,EURCHFMT4,1394,1h 29m,Sell
71279.06,1.33962,14.10.2010 21:14:57,tp 1.33962,0.0,-0.0,0.0,0.0,1.33852,14.10.2010 20:00:00,5710,-0.0,47.39,IS,0.41,0.0,Phase3-EA-SA2v2-EURCHF-M5-43,EURCHFMT4,2994,1h 14m,Buy
71308.25,81483,15.10.2010 02:00:00,,-0.96,-0.0,0.0,0.0,81392,14.10.2010 21:00:00,5711,-0.0,29.19,IS,0.27,0.0,Phase3-EA-S1v2-USDJPY-M15-0,USDJPYMT4,1914,5h 0m,Buy
71353.39,1.34057,15.10.2010 02:09:58,tp 1.34057,-2.15,-0.0,0.0,0.0,1.34167,14.10.2010 23:20:00,5712,-0.0,45.14,IS,0.41,0.0,Phase3-EA-SA2v2-EURCHF-M5-43,EURCHFMT4,2996,2h 49m,Sell
71400.57,1.3407,15.10.2010 02:34:58,tp 1.34070,0.0,-0.0,0.0,0.0,1.3396,15.10.2010 02:30:00,5713,-0.0,47.18,IS,0.41,0.0,Phase3-EA-SA2v2-EURCHF-M5-43,EURCHFMT4,2998,4m 58s,Buy
71385.79,114.34,15.10.2010 03:45:00,,-1.02,-14.779999999998836,0.0,0.0,114406,14.10.2010 15:45:00,5714,-0.00915734064631794,-14.78,IS,0.17,0.0,Phase3-EA-T1v2-EURJPY-M15-322,EURJPYMT4,714,12h 0m,Buy
71528.11,1.34322,15.10.2010 08:59:57,tp 1.34322,0.0,-0.0,0.0,0.0,1.33922,15.10.2010 04:00:00,5715,-0.0,142.32,IS,0.34,0.0,Phase3-EA-S4v1-EURCHF-M15-221,EURCHFMT4,1396,4h 59m,Buy
71588.62,0.95853,15.10.2010 22:59:59,tp 0.95853,0.0,-0.0,0.0,0.0,0.95953,15.10.2010 22:00:00,5716,-0.0,60.51,IS,0.58,0.0,Phase3-EA-SA2v2-USDCHF-M15-107,USDCHFMT4,1152,59m 59s,Sell
71635.7,1.33904,18.10.2010 01:49:58,tp 1.33904,0.0,-0.0,0.0,0.0,1.33794,18.10.2010 01:10:00,5717,-0.0,47.08,IS,0.41,0.0,Phase3-EA-SA2v2-EURCHF-M5-43,EURCHFMT4,3000,39m 58s,Buy
71696.18,0.95901,18.10.2010 02:14:58,tp 0.95901,0.0,-0.0,0.0,0.0,0.95801,18.10.2010 01:45:00,5718,-0.0,60.48,IS,0.58,0.0,Phase3-EA-SA2v2-USDCHF-M15-107,USDCHFMT4,1154,29m 58s,Buy
71837.09,113.0,18.10.2010 05:29:58,tp 113.000,-1.94,-0.0,0.0,0.0,114.29,13.10.2010 14:30:00,5719,-0.0,140.91,IS,0.09,0.0,Phase3-EA-TR1v1-EURJPY-M30-91,EURJPYMT4,828,4d 14h 59m,Sell
71731.25,1.33503,18.10.2010 11:15:00,,0.0,-105.83999999999651,0.0,0.0,1.33752,18.10.2010 02:55:00,5720,-0.06539909979844331,-105.84,IS,0.41,0.0,Phase3-EA-SA2v2-EURCHF-M5-43,EURCHFMT4,3002,8h 20m,Buy
71787.01,1.33797,18.10.2010 12:30:00,,0.0,-50.079999999987194,0.0,0.0,1.33639,18.10.2010 03:45:00,5721,-0.03094469877083628,55.76,IS,0.34,0.0,Phase3-EA-S4v1-EURCHF-M15-221,EURCHFMT4,1398,8h 45m,Buy
71847.65,0.95642,18.10.2010 22:59:57,tp 0.95642,0.0,-0.0,0.0,0.0,0.95742,18.10.2010 22:15:00,5722,-0.0,60.64,IS,0.58,0.0,Phase3-EA-SA2v2-USDCHF-M15-107,USDCHFMT4,1156,44m 57s,Sell
71805.65,1.59007,18.10.2010 23:59:58,sl 1.59007,0.0,-42.0,0.0,0.0,1.59307,18.10.2010 23:00:00,5723,-0.025950330449654353,-42.0,IS,0.14,0.0,Phase3-EA-B1v1-GBPUSD-M30-14,GBPUSDMT4,362,59m 58s,Buy
71850.53,1.33619,19.10.2010 01:29:57,tp 1.33619,-2.14,-0.0,0.0,0.0,1.33729,18.10.2010 20:25:00,5724,-0.0,44.88,IS,0.41,0.0,Phase3-EA-SA2v2-EURCHF-M5-43,EURCHFMT4,3004,5h 4m,Sell
71911.06,0.95825,19.10.2010 02:14:58,tp 0.95825,0.0,-0.0,0.0,0.0,0.95925,19.10.2010 00:15:00,5725,-0.0,60.53,IS,0.58,0.0,Phase3-EA-SA2v2-USDCHF-M15-107,USDCHFMT4,1158,1h 59m,Sell
71958.14,1.3374,19.10.2010 02:19:58,tp 1.33740,0.0,-0.0,0.0,0.0,1.3363,19.10.2010 01:35:00,5726,-0.0,47.08,IS,0.41,0.0,Phase3-EA-SA2v2-EURCHF-M5-43,EURCHFMT4,3006,44m 58s,Buy
72099.88,1.34048,19.10.2010 03:14:58,tp 1.34048,0.0,-0.0,0.0,0.0,1.33648,19.10.2010 02:00:00,5727,-0.0,141.74,IS,0.34,0.0,Phase3-EA-S4v1-EURCHF-M15-221,EURCHFMT4,1400,1h 14m,Buy
72146.88,1.33821,19.10.2010 04:19:58,tp 1.33821,0.0,-0.0,0.0,0.0,1.33931,19.10.2010 02:45:00,5728,-0.0,47.0,IS,0.41,0.0,Phase3-EA-SA2v2-EURCHF-M5-43,EURCHFMT4,3008,1h 34m,Sell
72207.3,0.95997,19.10.2010 04:44:58,tp 0.95997,0.0,-0.0,0.0,0.0,0.95897,19.10.2010 02:30:00,5729,-0.0,60.42,IS,0.58,0.0,Phase3-EA-SA2v2-USDCHF-M15-107,USDCHFMT4,1160,2h 14m,Buy
72254.92,129203,19.10.2010 05:20:00,,-1.02,-0.0,0.0,0.0,129031,18.10.2010 23:55:00,5730,-0.0,47.62,IS,0.23,0.0,Phase3-EA-S4v1-GBPJPY-M5-194,GBPJPYMT4,1448,5h 25m,Buy
72607.71,112385,19.10.2010 20:59:58,tp 112.385,-1.46,-0.0,0.0,0.0,114085,15.10.2010 17:30:00,5731,-0.0,352.79,IS,0.17,0.0,Phase3-EA-T1v2-EURJPY-M15-322,EURJPYMT4,716,4d 3h 29m,Sell
72400.65,1.33475,19.10.2010 21:04:59,sl 1.33475,0.0,-207.05999999999767,0.0,0.0,1.33965,19.10.2010 20:00:00,5732,-0.1273371354900685,-207.06,IS,0.41,0.0,Phase3-EA-SA2v2-EURCHF-M5-43,EURCHFMT4,3010,1h 4m,Buy
72539.51,111803,19.10.2010 21:29:58,tp 111.803,-0.39,-68.20000000001164,0.0,0.0,113063,18.10.2010 05:00:00,5733,-0.04194143069846543,138.86,IS,0.09,0.0,Phase3-EA-TR1v1-EURJPY-M30-91,EURJPYMT4,829,1d 16h 29m,Sell
72538.88,81611,20.10.2010 00:45:00,,-0.96,-68.8300000000163,0.0,0.0,81.61,19.10.2010 18:45:00,5734,-0.04232886620198778,-0.63,IS,0.27,0.0,Phase3-EA-S1v2-USDJPY-M15-0,USDJPYMT4,1916,6h 0m,Buy
72597.57,81434,20.10.2010 02:45:00,,0.0,-10.14000000001397,0.0,0.0,81611,20.10.2010 00:45:00,5735,-0.00623586667570312,58.69,IS,0.27,0.0,Phase3-EA-S1v2-USDJPY-M15-0,USDJPYMT4,1918,2h 0m,Sell
72706.1,127697,20.10.2010 02:49:58,tp 127.697,-1.64,-0.0,0.0,0.0,128087,19.10.2010 23:25:00,5736,-0.0,108.53,IS,0.23,0.0,Phase3-EA-S4v1-GBPJPY-M5-194,GBPJPYMT4,1450,3h 24m,Sell
72908.98,127531,20.10.2010 02:59:58,tp 127.531,-1.28,-0.0,0.0,0.0,129381,18.10.2010 08:30:00,5737,-0.0,202.88,IS,0.09,0.0,Phase3-EA-B1v1-GBPJPY-M30-1,GBPJPYMT4,628,1d 18h 29m,Sell
72828.42,1.33298,20.10.2010 05:30:00,,-1.01,-80.55999999999767,0.0,0.0,1.33486,19.10.2010 21:10:00,5738,-0.049450926523508826,-80.56,IS,0.41,0.0,Phase3-EA-SA2v2-EURCHF-M5-43,EURCHFMT4,3012,8h 20m,Buy
72938.66,128001,20.10.2010 07:24:58,tp 128.001,0.0,-0.0,0.0,0.0,127611,20.10.2010 03:05:00,5739,-0.0,110.24,IS,0.23,0.0,Phase3-EA-S4v1-GBPJPY-M5-194,GBPJPYMT4,1452,4h 19m,Buy
72858.57,112567,20.10.2010 14:59:58,sl 112.567,-0.39,-80.08999999999651,0.0,0.0,111847,19.10.2010 21:30:00,5740,-0.04915346670949455,-80.09,IS,0.09,0.0,Phase3-EA-TR1v1-EURJPY-M30-91,EURJPYMT4,832,17h 29m,Sell
72784.41,128188,20.10.2010 16:59:58,sl 128.188,0.0,-154.25,0.0,0.0,127518,20.10.2010 03:00:00,5741,-0.09466752703133806,-74.16,IS,0.09,0.0,Phase3-EA-B1v1-GBPJPY-M30-1,GBPJPYMT4,630,13h 59m,Sell
72824.6,1.34099,21.10.2010 04:39:58,tp 1.34099,-6.4,-114.05999999999767,0.0,0.0,1.34209,20.10.2010 20:30:00,5742,-0.07000180313253938,40.19,IS,0.41,0.0,Phase3-EA-SA2v2-EURCHF-M5-43,EURCHFMT4,3014,8h 9m,Sell
72965.67,1.34585,21.10.2010 09:29:58,tp 1.34585,0.0,-0.0,0.0,0.0,1.34185,21.10.2010 05:00:00,5743,-0.0,141.07,IS,0.34,0.0,Phase3-EA-S4v1-EURCHF-M15-221,EURCHFMT4,1402,4h 29m,Buy
72947.05,113258,21.10.2010 20:00:00,,0.0,-18.619999999995343,0.0,0.0,113347,21.10.2010 10:45:00,5744,-0.011425719294128233,-18.62,IS,0.17,0.0,Phase3-EA-T1v2-EURJPY-M15-322,EURJPYMT4,718,9h 15m,Buy
72993.67,1.3466,21.10.2010 21:34:58,tp 1.34660,0.0,-0.0,0.0,0.0,1.3455,21.10.2010 20:55:00,5745,-0.0,46.62,IS,0.41,0.0,Phase3-EA-SA2v2-EURCHF-M5-43,EURCHFMT4,3016,39m 58s,Buy
73050.5,0.96655,22.10.2010 02:29:57,tp 0.96655,-3.18,-0.0,0.0,0.0,0.96755,21.10.2010 23:00:00,5746,-0.0,56.83,IS,0.58,0.0,Phase3-EA-SA2v2-USDCHF-M15-107,USDCHFMT4,1162,3h 29m,Sell
73097.09,1.34732,22.10.2010 02:54:57,tp 1.34732,0.0,-0.0,0.0,0.0,1.34622,22.10.2010 01:50:00,5747,-0.0,46.59,IS,0.41,0.0,Phase3-EA-SA2v2-EURCHF-M5-43,EURCHFMT4,3018,1h 4m,Buy
73152.97,127647,22.10.2010 08:55:00,,0.0,-0.0,0.0,0.0,127.45,22.10.2010 03:30:00,5748,-0.0,55.88,IS,0.23,0.0,Phase3-EA-S4v1-GBPJPY-M5-194,GBPJPYMT4,1454,5h 25m,Buy
73016.22,1.35296,22.10.2010 10:29:58,sl 1.35296,0.0,-136.75,0.0,0.0,1.34906,22.10.2010 04:30:00,5749,-0.0838170460519352,-136.75,IS,0.34,0.0,Phase3-EA-S4v1-EURCHF-M15-221,EURCHFMT4,1404,5h 59m,Sell
72968.04,113031,22.10.2010 11:14:57,sl 113.031,0.0,-184.92999999999302,0.0,0.0,112801,22.10.2010 10:30:00,5750,-0.113347614818163,-48.18,IS,0.17,0.0,Phase3-EA-T1v2-EURJPY-M15-322,EURJPYMT4,720,44m 57s,Sell
73027.37,0.97755,25.10.2010 01:59:58,tp 0.97755,0.0,-125.60000000000582,0.0,0.0,0.97655,25.10.2010 01:30:00,5751,-0.07698296880529103,59.33,IS,0.58,0.0,Phase3-EA-SA2v2-USDCHF-M15-107,USDCHFMT4,1164,29m 58s,Buy
72925.53,1.3653,25.10.2010 04:35:00,,-2.1,-227.44000000000233,0.0,0.0,1.36293,22.10.2010 20:15:00,5752,-0.13940291739709204,-101.84,IS,0.41,0.0,Phase3-EA-SA2v2-EURCHF-M5-43,EURCHFMT4,3020,2d 8h 20m,Sell
73065.73,1.36178,25.10.2010 09:44:58,tp 1.36178,0.0,-87.23999999999069,0.0,0.0,1.36578,25.10.2010 04:15:00,5753,-0.05347129138990893,140.2,IS,0.34,0.0,Phase3-EA-S4v1-EURCHF-M15-221,EURCHFMT4,1406,5h 29m,Sell
72786.51,80537,25.10.2010 10:44:58,sl 80.537,-0.96,-366.45999999999185,0.0,0.0,81367,22.10.2010 22:00:00,5754,-0.22461129576739663,-279.22,IS,0.27,0.0,Phase3-EA-S1v2-USDJPY-M15-0,USDJPYMT4,1920,2d 12h 44m,Buy
72832.99,1.35655,25.10.2010 20:44:59,tp 1.35655,0.0,-319.9799999999814,0.0,0.0,1.35545,25.10.2010 20:25:00,5755,-0.1961226939356246,46.48,IS,0.41,0.0,Phase3-EA-SA2v2-EURCHF-M5-43,EURCHFMT4,3022,19m 59s,Buy
72749.54,112509,26.10.2010 02:29:57,sl 112.509,-3.26,-403.429999999993,0.0,0.0,113229,20.10.2010 19:30:00,5756,-0.24727101198341228,-83.45,IS,0.09,0.0,Phase3-EA-TR1v1-EURJPY-M30-91,EURJPYMT4,834,5d 6h 59m,Buy
72795.89,1.35624,26.10.2010 03:09:57,tp 1.35624,0.0,-357.0799999999872,0.0,0.0,1.35514,26.10.2010 01:00:00,5757,-0.21886208997604348,46.35,IS,0.41,0.0,Phase3-EA-SA2v2-EURCHF-M5-43,EURCHFMT4,3024,2h 9m,Buy
72760.08,0.97188,26.10.2010 05:45:00,,0.0,-392.88999999998487,0.0,0.0,0.97128,26.10.2010 01:30:00,5758,-0.24081081698971518,-35.81,IS,0.58,0.0,Phase3-EA-SA2v2-USDCHF-M15-107,USDCHFMT4,1166,4h 15m,Sell
72785.46,126969,26.10.2010 08:45:00,,0.0,-367.5099999999802,0.0,0.0,127058,26.10.2010 03:20:00,5759,-0.22525486357985408,25.38,IS,0.23,0.0,Phase3-EA-S4v1-GBPJPY-M5-194,GBPJPYMT4,1456,5h 25m,Sell
72925.31,1.35897,26.10.2010 10:44:57,tp 1.35897,0.0,-227.6599999999744,0.0,0.0,1.35497,26.10.2010 02:30:00,5760,-0.1395377601768294,139.85,IS,0.34,0.0,Phase3-EA-S4v1-EURCHF-M15-221,EURCHFMT4,1408,8h 14m,Buy
72971.03,1.36486,26.10.2010 21:34:57,tp 1.36486,0.0,-181.93999999997322,0.0,0.0,1.36596,26.10.2010 20:30:00,5761,-0.1115149788569422,45.72,IS,0.41,0.0,Phase3-EA-SA2v2-EURCHF-M5-43,EURCHFMT4,3026,1h 4m,Sell
73029.2,0.98503,27.10.2010 02:44:58,tp 0.98503,-0.71,-123.76999999996042,0.0,0.0,0.98403,26.10.2010 23:45:00,5762,-0.07586132204639635,58.17,IS,0.58,0.0,Phase3-EA-SA2v2-USDCHF-M15-107,USDCHFMT4,1168,2h 59m,Buy
73074.01,1.36517,27.10.2010 03:54:58,tp 1.36517,-1.0,-78.95999999996275,0.0,0.0,1.36407,26.10.2010 23:15:00,5763,-0.04839629949731394,44.81,IS,0.41,0.0,Phase3-EA-SA2v2-EURCHF-M5-43,EURCHFMT4,3028,4h 39m,Buy
73119.49,1.36454,27.10.2010 21:14:57,tp 1.36454,0.0,-33.47999999995227,0.0,0.0,1.36344,27.10.2010 20:05:00,5764,-0.020520619391698646,45.48,IS,0.41,0.0,Phase3-EA-SA2v2-EURCHF-M5-43,EURCHFMT4,3030,1h 9m,Buy
73113.38,81674,28.10.2010 03:00:00,,-4.46,-39.5899999999383,0.0,0.0,81669,27.10.2010 17:15:00,5765,-0.02426557113850781,-6.11,IS,0.27,0.0,Phase3-EA-S1v2-USDJPY-M15-0,USDJPYMT4,1922,9h 45m,Sell
73028.89,0.98849,28.10.2010 06:30:00,,0.0,-124.07999999992899,0.0,0.0,0.98993,28.10.2010 02:15:00,5766,-0.07605132778148568,-84.49,IS,0.58,0.0,Phase3-EA-SA2v2-USDCHF-M15-107,USDCHFMT4,1170,4h 15m,Buy
73096.11,1.36238,28.10.2010 12:30:00,,0.0,-56.85999999992782,0.0,0.0,1.36433,28.10.2010 03:45:00,5767,-0.034850729349228414,67.22,IS,0.34,0.0,Phase3-EA-S4v1-EURCHF-M15-221,EURCHFMT4,1410,8h 45m,Sell
73048.03,112557,28.10.2010 13:29:57,sl 112.557,0.0,-104.93999999991502,0.0,0.0,112327,28.10.2010 11:30:00,5768,-0.06432000594283697,-48.08,IS,0.17,0.0,Phase3-EA-T1v2-EURJPY-M15-322,EURJPYMT4,722,1h 59m,Sell
73057.53,81003,29.10.2010 03:00:00,,-1.5,-95.43999999991502,0.0,0.0,81036,28.10.2010 21:15:00,5769,-0.058497249544347873,9.5,IS,0.27,0.0,Phase3-EA-S1v2-USDJPY-M15-0,USDJPYMT4,1924,5h 45m,Sell
73103.34,1.36787,29.10.2010 06:24:58,tp 1.36787,0.0,-49.629999999917345,0.0,0.0,1.36897,29.10.2010 00:20:00,5770,-0.030419305269108708,45.81,IS,0.41,0.0,Phase3-EA-SA2v2-EURCHF-M5-43,EURCHFMT4,3032,6h 4m,Sell
73241.59,1.36749,29.10.2010 06:44:58,tp 1.36749,0.0,-0.0,0.0,0.0,1.37149,29.10.2010 04:30:00,5771,-0.0,138.25,IS,0.34,0.0,Phase3-EA-S4v1-EURCHF-M15-221,EURCHFMT4,1412,2h 14m,Sell
73151.87,111891,29.10.2010 10:29:57,sl 111.891,-2.7,-89.72000000000116,0.0,0.0,112671,26.10.2010 06:00:00,5772,-0.054961483773835536,-89.72,IS,0.09,0.0,Phase3-EA-TR1v1-EURJPY-M30-91,EURJPYMT4,836,3d 4h 29m,Buy
73415.94,1.60311,29.10.2010 19:59:58,tp 1.60311,-0.53,-0.0,0.0,0.0,1.58421,28.10.2010 13:30:00,5773,-0.0,264.07,IS,0.14,0.0,Phase3-EA-B1v1-GBPUSD-M30-14,GBPUSDMT4,364,1d 6h 29m,Buy
73210.46,1.37462,01.11.2010 03:04:58,sl 1.37462,-2.09,-205.48000000001048,0.0,0.0,1.36972,29.10.2010 23:20:00,5774,-0.1257404877394521,-205.48,IS,0.41,0.0,Phase3-EA-SA2v2-EURCHF-M5-43,EURCHFMT4,3034,2d 3h 44m,Sell
73076.21,1.37545,01.11.2010 03:14:58,sl 1.37545,0.0,-339.7300000000105,0.0,0.0,1.37155,01.11.2010 02:45:00,5775,-0.20789281633114268,-134.25,IS,0.34,0.0,Phase3-EA-S4v1-EURCHF-M15-221,EURCHFMT4,1414,29m 58s,Sell
72993.65,113.05,01.11.2010 03:29:57,sl 113.050,-1.94,-422.29000000000815,0.0,0.0,112.33,27.10.2010 21:00:00,5776,-0.2584142036572491,-82.56,IS,0.09,0.0,Phase3-EA-TR1v1-EURJPY-M30-91,EURJPYMT4,837,4d 6h 29m,Sell
73086.06,129162,01.11.2010 08:40:00,,0.0,-329.88000000000466,0.0,0.0,129485,01.11.2010 03:15:00,5777,-0.20186525255737262,92.41,IS,0.23,0.0,Phase3-EA-S4v1-GBPJPY-M5-194,GBPJPYMT4,1458,5h 25m,Sell
72951.74,1.37909,01.11.2010 11:29:57,sl 1.37909,0.0,-464.20000000001164,0.0,0.0,1.37519,01.11.2010 04:15:00,5778,-0.2840604166276628,-134.32,IS,0.34,0.0,Phase3-EA-S4v1-EURCHF-M15-221,EURCHFMT4,1416,7h 14m,Sell
72996.19,1.37939,02.11.2010 02:34:58,tp 1.37939,-0.99,-419.75,0.0,0.0,1.37829,01.11.2010 22:05:00,5779,-0.2568598877196434,44.45,IS,0.41,0.0,Phase3-EA-SA2v2-EURCHF-M5-43,EURCHFMT4,3036,4h 29m,Buy
73041.65,1.37918,02.11.2010 03:04:58,tp 1.37918,0.0,-374.29000000000815,0.0,0.0,1.38028,02.11.2010 02:55:00,5780,-0.22904130404904685,45.46,IS,0.41,0.0,Phase3-EA-SA2v2-EURCHF-M5-43,EURCHFMT4,3038,9m 58s,Sell
73057.42,80641,02.11.2010 04:00:00,,-0.97,-358.5200000000186,0.0,0.0,80591,01.11.2010 22:30:00,5781,-0.21939108265694185,15.77,IS,0.27,0.0,Phase3-EA-S1v2-USDJPY-M15-0,USDJPYMT4,1926,5h 30m,Buy
73168.66,129434,02.11.2010 04:04:59,tp 129.434,0.0,-247.28000000002794,0.0,0.0,129044,02.11.2010 00:15:00,5782,-0.1513193878149389,111.24,IS,0.23,0.0,Phase3-EA-S4v1-GBPJPY-M5-194,GBPJPYMT4,1460,3h 49m,Buy
73087.85,112621,02.11.2010 12:29:58,sl 112.621,-0.39,-328.0900000000256,0.0,0.0,111901,01.11.2010 16:00:00,5783,-0.2007698881761629,-80.81,IS,0.09,0.0,Phase3-EA-TR1v1-EURJPY-M30-91,EURJPYMT4,840,20h 29m,Sell
73045.85,1.60441,02.11.2010 12:59:58,sl 1.60441,0.0,-370.0900000000256,0.0,0.0,1.60741,02.11.2010 11:30:00,5784,-0.22647117533333985,-42.0,IS,0.14,0.0,Phase3-EA-B1v1-GBPUSD-M30-14,GBPUSDMT4,366,1h 29m,Buy
73003.85,1.60279,02.11.2010 15:59:58,sl 1.60279,0.0,-412.0900000000256,0.0,0.0,1.59979,02.11.2010 13:00:00,5785,-0.2521724624905168,-42.0,IS,0.14,0.0,Phase3-EA-B1v1-GBPUSD-M30-14,GBPUSDMT4,368,2h 59m,Sell
73016.82,1.37324,03.11.2010 05:20:00,,-2.09,-399.12000000002445,0.0,0.0,1.3736,02.11.2010 21:00:00,5786,-0.24423566024221643,12.97,IS,0.41,0.0,Phase3-EA-SA2v2-EURCHF-M5-43,EURCHFMT4,3040,8h 20m,Sell
73027.23,1.37432,03.11.2010 12:30:00,,0.0,-388.71000000002095,0.0,0.0,1.37462,03.11.2010 03:45:00,5787,-0.23786541263968544,10.41,IS,0.34,0.0,Phase3-EA-S4v1-EURCHF-M15-221,EURCHFMT4,1418,8h 45m,Sell
73165.94,114001,03.11.2010 16:59:58,tp 114.001,-0.55,-250.0000000000291,0.0,0.0,112741,02.11.2010 12:30:00,5788,-0.15298385212607105,138.71,IS,0.09,0.0,Phase3-EA-TR1v1-EURJPY-M30-91,EURJPYMT4,842,1d 4h 29m,Buy
73253.45,81449,03.11.2010 21:30:00,,0.0,-162.4900000000198,0.0,0.0,81185,03.11.2010 21:00:00,5789,-0.09943338452786167,87.51,IS,0.27,0.0,Phase3-EA-S1v2-USDJPY-M15-0,USDJPYMT4,1928,30m 0s,Buy
73217.93,81344,03.11.2010 21:45:00,,0.0,-198.0100000000093,0.0,0.0,81451,03.11.2010 21:30:00,5790,-0.12116933023792491,-35.52,IS,0.27,0.0,Phase3-EA-S1v2-USDJPY-M15-0,USDJPYMT4,1930,15m 0s,Buy
73264.35,1.3721,04.11.2010 02:09:58,tp 1.37210,0.0,-151.5899999999965,0.0,0.0,1.3732,04.11.2010 01:40:00,5791,-0.09276328857515151,46.42,IS,0.41,0.0,Phase3-EA-SA2v2-EURCHF-M5-43,EURCHFMT4,3042,29m 58s,Sell
73193.24,81141,04.11.2010 10:30:00,,-2.9,-222.69999999998254,0.0,0.0,81346,03.11.2010 21:45:00,5792,-0.13627801547387755,-71.11,IS,0.27,0.0,Phase3-EA-S1v2-USDJPY-M15-0,USDJPYMT4,1932,12h 45m,Buy
73547.42,114949,04.11.2010 11:44:58,tp 114.949,-3.08,-0.0,0.0,0.0,113249,03.11.2010 11:30:00,5793,-0.0,354.18,IS,0.17,0.0,Phase3-EA-T1v2-EURJPY-M15-322,EURJPYMT4,724,1d 0h 14m,Buy
73460.59,115238,04.11.2010 12:29:58,sl 115.238,0.0,-86.8299999999872,0.0,0.0,114458,04.11.2010 04:30:00,5794,-0.05309163544126049,-86.83,IS,0.09,0.0,Phase3-EA-TR1v1-EURJPY-M30-91,EURJPYMT4,844,7h 59m,Sell
73323.53,1.37876,04.11.2010 13:44:57,sl 1.37876,0.0,-223.88999999998487,0.0,0.0,1.37486,04.11.2010 06:45:00,5795,-0.13689607576810736,-137.06,IS,0.34,0.0,Phase3-EA-S4v1-EURCHF-M15-221,EURCHFMT4,1420,6h 59m,Sell
73114.06,1.35964,04.11.2010 21:04:58,sl 1.35964,0.0,-433.35999999998603,0.0,0.0,1.36454,04.11.2010 20:10:00,5796,-0.26497513687466656,-209.47,IS,0.41,0.0,Phase3-EA-SA2v2-EURCHF-M5-43,EURCHFMT4,3044,54m 58s,Buy
73161.12,1.36055,04.11.2010 21:14:58,tp 1.36055,0.0,-386.29999999998836,0.0,0.0,1.35945,04.11.2010 21:10:00,5797,-0.23620060775033208,47.06,IS,0.41,0.0,Phase3-EA-SA2v2-EURCHF-M5-43,EURCHFMT4,3046,4m 58s,Buy
73132.53,80722,05.11.2010 02:45:00,,-1.5,-414.88999999998487,0.0,0.0,80641,04.11.2010 21:15:00,5798,-0.25368177620899474,-28.59,IS,0.27,0.0,Phase3-EA-S1v2-USDJPY-M15-0,USDJPYMT4,1934,5h 30m,Sell
73193.0,0.95919,05.11.2010 03:44:58,tp 0.95919,0.0,-354.4199999999837,0.0,0.0,0.95819,05.11.2010 02:30:00,5799,-0.21670779031548376,60.47,IS,0.58,0.0,Phase3-EA-SA2v2-USDCHF-M15-107,USDCHFMT4,1172,1h 14m,Buy
73335.16,1.35877,05.11.2010 08:29:58,tp 1.35877,0.0,-212.2599999999802,0.0,0.0,1.36277,05.11.2010 03:15:00,5800,-0.1297849883538243,142.16,IS,0.34,0.0,Phase3-EA-S4v1-EURCHF-M15-221,EURCHFMT4,1422,5h 14m,Sell
73307.39,114638,05.11.2010 09:00:00,,0.0,-240.02999999996973,0.0,0.0,114.77,05.11.2010 02:15:00,5801,-0.14676477317708198,-27.77,IS,0.17,0.0,Phase3-EA-T1v2-EURJPY-M15-322,EURJPYMT4,726,6h 45m,Buy
73316.39,81344,08.11.2010 05:00:00,,-0.96,-231.02999999996973,0.0,0.0,81314,05.11.2010 23:30:00,5802,-0.14126178205683074,9.0,IS,0.27,0.0,Phase3-EA-S1v2-USDJPY-M15-0,USDJPYMT4,1936,2d 5h 30m,Buy
73360.99,1.34836,08.11.2010 05:14:58,tp 1.34836,-2.13,-186.4299999999639,0.0,0.0,1.34946,05.11.2010 21:40:00,5803,-0.11399140383869329,44.6,IS,0.41,0.0,Phase3-EA-SA2v2-EURCHF-M5-43,EURCHFMT4,3048,2d 7h 34m,Sell
73502.81,113686,08.11.2010 05:29:58,tp 113.686,-0.78,-44.609999999956926,0.0,0.0,114976,04.11.2010 18:00:00,5804,-0.027276492652685627,141.82,IS,0.09,0.0,Phase3-EA-TR1v1-EURJPY-M30-91,EURJPYMT4,846,3d 11h 29m,Sell
73643.89,1.34761,08.11.2010 05:29:58,tp 1.34761,0.0,-0.0,0.0,0.0,1.35161,08.11.2010 03:30:00,5805,-0.0,141.08,IS,0.34,0.0,Phase3-EA-S4v1-EURCHF-M15-221,EURCHFMT4,1424,1h 59m,Sell
73690.6,1.34317,08.11.2010 22:44:57,tp 1.34317,0.0,-0.0,0.0,0.0,1.34427,08.11.2010 21:20:00,5806,-0.0,46.71,IS,0.41,0.0,Phase3-EA-SA2v2-EURCHF-M5-43,EURCHFMT4,3050,1h 24m,Sell
74045.19,112412,09.11.2010 02:59:58,tp 112.412,-1.46,-0.0,0.0,0.0,114112,05.11.2010 22:30:00,5807,-0.0,354.59,IS,0.17,0.0,Phase3-EA-T1v2-EURJPY-M15-322,EURJPYMT4,728,3d 4h 29m,Sell
74155.78,130812,09.11.2010 04:49:58,tp 130.812,0.0,-0.0,0.0,0.0,130422,09.11.2010 03:10:00,5808,-0.0,110.59,IS,0.23,0.0,Phase3-EA-S4v1-GBPJPY-M5-194,GBPJPYMT4,1462,1h 39m,Buy
74018.2,1.33761,09.11.2010 10:59:58,sl 1.33761,0.0,-137.5799999999872,0.0,0.0,1.34151,09.11.2010 05:00:00,5809,-0.08381063402092032,-137.58,IS,0.34,0.0,Phase3-EA-S4v1-EURCHF-M15-221,EURCHFMT4,1426,5h 59m,Buy
73809.75,1.33752,09.11.2010 10:59:58,sl 1.33752,0.0,-346.02999999999884,0.0,0.0,1.34242,09.11.2010 02:55:00,5810,-0.21079367415512182,-208.45,IS,0.41,0.0,Phase3-EA-SA2v2-EURCHF-M5-43,EURCHFMT4,3052,8h 4m,Buy
73856.34,1.33414,10.11.2010 03:09:58,tp 1.33414,0.0,-299.4400000000023,0.0,0.0,1.33304,10.11.2010 00:15:00,5811,-0.1824120966072606,46.59,IS,0.41,0.0,Phase3-EA-SA2v2-EURCHF-M5-43,EURCHFMT4,3054,2h 54m,Buy
73996.71,1.33619,10.11.2010 08:59:58,tp 1.33619,0.0,-159.07000000000698,0.0,0.0,1.33219,10.11.2010 02:00:00,5812,-0.09690185749171117,140.37,IS,0.34,0.0,Phase3-EA-S4v1-EURCHF-M15-221,EURCHFMT4,1428,6h 59m,Buy
73917.2,113564,10.11.2010 16:59:58,sl 113.564,-0.77,-238.5800000000163,0.0,0.0,112844,08.11.2010 15:30:00,5813,-0.14533755680123853,-79.51,IS,0.09,0.0,Phase3-EA-TR1v1-EURJPY-M30-91,EURJPYMT4,848,2d 1h 29m,Sell
73957.33,1.33717,11.11.2010 01:29:58,tp 1.33717,-6.33,-198.45000000001164,0.0,0.0,1.33827,10.11.2010 20:25:00,5814,-0.12089126560149849,40.13,IS,0.41,0.0,Phase3-EA-SA2v2-EURCHF-M5-43,EURCHFMT4,3056,5h 4m,Sell
74052.9,113123,11.11.2010 02:30:00,,-3.04,-102.88000000000466,0.0,0.0,112646,10.11.2010 09:00:00,5815,-0.06267217639245148,95.57,IS,0.17,0.0,Phase3-EA-T1v2-EURJPY-M15-322,EURJPYMT4,730,17h 30m,Buy
74099.37,1.33825,11.11.2010 03:34:57,tp 1.33825,0.0,-56.41000000000349,0.0,0.0,1.33715,11.11.2010 01:35:00,5816,-0.03436370013897985,46.47,IS,0.41,0.0,Phase3-EA-SA2v2-EURCHF-M5-43,EURCHFMT4,3058,1h 59m,Buy
73998.83,0.96915,11.11.2010 06:30:00,,0.0,-156.95000000001164,0.0,0.0,0.97083,11.11.2010 02:15:00,5817,-0.09561040129078095,-100.54,IS,0.58,0.0,Phase3-EA-SA2v2-USDCHF-M15-107,USDCHFMT4,1174,4h 15m,Buy
73930.31,82226,11.11.2010 08:00:00,,-2.85,-225.47000000000116,0.0,0.0,82426,10.11.2010 21:15:00,5818,-0.13735124038885566,-68.52,IS,0.27,0.0,Phase3-EA-S1v2-USDJPY-M15-0,USDJPYMT4,1938,10h 45m,Buy
73882.75,113211,11.11.2010 11:14:57,sl 113.211,0.0,-273.02999999999884,0.0,0.0,113441,11.11.2010 04:45:00,5819,-0.1663237200663898,-47.56,IS,0.17,0.0,Phase3-EA-T1v2-EURJPY-M15-322,EURJPYMT4,732,6h 29m,Buy
73829.49,1.33507,11.11.2010 11:30:00,,0.0,-326.29000000000815,0.0,0.0,1.33659,11.11.2010 02:45:00,5820,-0.19876851122757175,-53.26,IS,0.34,0.0,Phase3-EA-S4v1-EURCHF-M15-221,EURCHFMT4,1430,8h 45m,Buy
73875.67,1.33436,11.11.2010 20:39:59,tp 1.33436,0.0,-280.11000000001513,0.0,0.0,1.33546,11.11.2010 20:30:00,5821,-0.17063669643555346,46.18,IS,0.41,0.0,Phase3-EA-SA2v2-EURCHF-M5-43,EURCHFMT4,3060,9m 59s,Sell
73921.87,1.33333,11.11.2010 23:14:58,tp 1.33333,0.0,-233.9100000000035,0.0,0.0,1.33223,11.11.2010 22:45:00,5822,-0.14249269809445841,46.2,IS,0.41,0.0,Phase3-EA-SA2v2-EURCHF-M5-43,EURCHFMT4,3062,29m 58s,Buy
73967.08,1.33293,12.11.2010 00:29:58,tp 1.33293,-1.01,-188.70000000001164,0.0,0.0,1.33183,11.11.2010 23:40:00,5823,-0.11495178543211304,45.21,IS,0.41,0.0,Phase3-EA-SA2v2-EURCHF-M5-43,EURCHFMT4,3064,49m 58s,Buy
73865.2,132328,12.11.2010 08:25:00,,0.0,-290.5800000000163,0.0,0.0,132693,12.11.2010 03:00:00,5824,-0.17701478437129423,-101.88,IS,0.23,0.0,Phase3-EA-S4v1-GBPJPY-M5-194,GBPJPYMT4,1464,5h 25m,Buy
73791.56,132177,12.11.2010 09:29:58,sl 132.177,-0.39,-364.22000000003027,0.0,0.0,132847,11.11.2010 10:00:00,5825,-0.22187461203012776,-73.64,IS,0.09,0.0,Phase3-EA-B1v1-GBPJPY-M30-1,GBPJPYMT4,632,23h 29m,Buy
73655.18,1.32665,12.11.2010 10:14:59,sl 1.32665,0.0,-500.6000000000349,0.0,0.0,1.33055,12.11.2010 03:15:00,5826,-0.3049542331071344,-136.38,IS,0.34,0.0,Phase3-EA-S4v1-EURCHF-M15-221,EURCHFMT4,1432,6h 59m,Buy
73448.55,1.32671,12.11.2010 10:14:59,sl 1.32671,0.0,-707.2300000000396,0.0,0.0,1.33161,12.11.2010 02:35:00,5827,-0.43082857027637966,-206.63,IS,0.41,0.0,Phase3-EA-SA2v2-EURCHF-M5-43,EURCHFMT4,3066,7h 39m,Buy
73588.15,111896,12.11.2010 10:29:58,tp 111.896,-1.53,-567.6300000000338,0.0,0.0,113186,10.11.2010 19:30:00,5828,-0.34578739779984197,139.6,IS,0.09,0.0,Phase3-EA-TR1v1-EURJPY-M30-91,EURJPYMT4,850,1d 14h 59m,Sell
73729.67,113071,12.11.2010 16:59:58,tp 113.071,0.0,-426.11000000004424,0.0,0.0,111781,12.11.2010 12:30:00,5829,-0.2595766046130352,141.52,IS,0.09,0.0,Phase3-EA-TR1v1-EURJPY-M30-91,EURJPYMT4,852,4h 29m,Buy
73667.99,82247,12.11.2010 17:00:00,,-0.95,-487.79000000003725,0.0,0.0,82432,11.11.2010 23:30:00,5830,-0.2971506699307432,-61.68,IS,0.27,0.0,Phase3-EA-S1v2-USDJPY-M15-0,USDJPYMT4,1940,17h 30m,Buy
73714.1,1.33953,12.11.2010 20:24:57,tp 1.33953,0.0,-441.6800000000512,0.0,0.0,1.33843,12.11.2010 20:05:00,5831,-0.2690614975604581,46.11,IS,0.41,0.0,Phase3-EA-SA2v2-EURCHF-M5-43,EURCHFMT4,3068,19m 57s,Buy
73758.1,1.33948,15.11.2010 02:14:57,tp 1.33948,-2.09,-397.6800000000512,0.0,0.0,1.34058,12.11.2010 23:25:00,5832,-0.24225768961656483,44.0,IS,0.41,0.0,Phase3-EA-SA2v2-EURCHF-M5-43,EURCHFMT4,3070,2d 2h 49m,Sell
73835.61,82585,15.11.2010 04:15:00,,-0.95,-320.1700000000419,0.0,0.0,82345,12.11.2010 22:30:00,5833,-0.19504034521357805,77.51,IS,0.27,0.0,Phase3-EA-S1v2-USDJPY-M15-0,USDJPYMT4,1942,2d 5h 45m,Buy
73793.08,1.60887,15.11.2010 10:29:58,sl 1.60887,-0.53,-362.70000000004075,0.0,0.0,1.61187,12.11.2010 16:30:00,5834,-0.22094866230116328,-42.53,IS,0.14,0.0,Phase3-EA-B1v1-GBPUSD-M30-14,GBPUSDMT4,370,2d 17h 59m,Buy
73745.94,113059,15.11.2010 17:14:58,sl 113.059,0.0,-409.8400000000547,0.0,0.0,113289,15.11.2010 16:15:00,5835,-0.24966528744833383,-47.14,IS,0.17,0.0,Phase3-EA-T1v2-EURJPY-M15-322,EURJPYMT4,734,59m 58s,Buy
73791.76,1339,15.11.2010 22:39:57,tp 1.33900,0.0,-364.02000000004773,0.0,0.0,1.3379,15.11.2010 20:20:00,5836,-0.22175277653948433,45.82,IS,0.41,0.0,Phase3-EA-SA2v2-EURCHF-M5-43,EURCHFMT4,3072,2h 19m,Buy
73837.54,1.33833,16.11.2010 03:54:58,tp 1.33833,0.0,-318.2400000000489,0.0,0.0,1.33723,16.11.2010 02:55:00,5837,-0.19386463272877064,45.78,IS,0.41,0.0,Phase3-EA-SA2v2-EURCHF-M5-43,EURCHFMT4,3074,59m 58s,Buy
73841.2,133383,16.11.2010 04:50:00,,-1.6,-314.5800000000454,0.0,0.0,133402,15.11.2010 23:25:00,5838,-0.1916350432497992,3.66,IS,0.23,0.0,Phase3-EA-S4v1-GBPJPY-M5-194,GBPJPYMT4,1466,5h 25m,Sell
73800.41,83067,16.11.2010 06:00:00,,-1.46,-355.37000000005355,0.0,0.0,82946,15.11.2010 22:45:00,5839,-0.21648339156869978,-40.79,IS,0.27,0.0,Phase3-EA-S1v2-USDJPY-M15-0,USDJPYMT4,1944,7h 15m,Sell
73665.52,1.34247,16.11.2010 08:29:58,sl 1.34247,0.0,-490.2600000000675,0.0,0.0,1.33857,16.11.2010 04:30:00,5840,-0.2986553382403393,-134.89,IS,0.34,0.0,Phase3-EA-S4v1-EURCHF-M15-221,EURCHFMT4,1434,3h 59m,Sell
73710.77,1.34151,16.11.2010 21:19:58,tp 1.34151,0.0,-445.0100000000675,0.0,0.0,1.34261,16.11.2010 21:10:00,5841,-0.2710900584798581,45.25,IS,0.41,0.0,Phase3-EA-SA2v2-EURCHF-M5-43,EURCHFMT4,3076,9m 58s,Sell
73754.02,1.34265,17.11.2010 00:24:57,tp 1.34265,-2.06,-401.7600000000675,0.0,0.0,1.34375,16.11.2010 22:30:00,5842,-0.24474313362591757,43.25,IS,0.41,0.0,Phase3-EA-SA2v2-EURCHF-M5-43,EURCHFMT4,3078,1h 54m,Sell
73818.73,83455,17.11.2010 03:15:00,,0.0,-337.05000000007567,0.0,0.0,83255,17.11.2010 00:15:00,5843,-0.20532326062480133,64.71,IS,0.27,0.0,Phase3-EA-S1v2-USDJPY-M15-0,USDJPYMT4,1946,3h 0m,Buy
73851.04,83166,18.11.2010 02:00:00,,-4.38,-304.740000000078,0.0,0.0,83279,17.11.2010 21:45:00,5844,-0.18564073710963927,32.31,IS,0.27,0.0,Phase3-EA-S1v2-USDJPY-M15-0,USDJPYMT4,1948,4h 15m,Sell
73828.01,112567,18.11.2010 02:30:00,,-3.0,-327.77000000007683,0.0,0.0,112665,17.11.2010 20:15:00,5845,-0.19967009385845363,-23.03,IS,0.17,0.0,Phase3-EA-T1v2-EURJPY-M15-322,EURJPYMT4,736,6h 15m,Buy
73749.11,113098,18.11.2010 05:59:58,sl 113.098,-1.13,-406.670000000071,0.0,0.0,113179,15.11.2010 08:00:00,5846,-0.24773419492147689,-78.9,IS,0.09,0.0,Phase3-EA-TR1v1-EURJPY-M30-91,EURJPYMT4,854,2d 21h 59m,Sell
73624.88,1.34436,18.11.2010 06:20:00,,-6.2,-530.9000000000815,0.0,0.0,1.34151,17.11.2010 22:00:00,5847,-0.32341230994125286,-124.23,IS,0.41,0.0,Phase3-EA-SA2v2-EURCHF-M5-43,EURCHFMT4,3080,8h 20m,Sell
73582.88,1.59062,18.11.2010 11:29:58,sl 1.59062,0.0,-572.9000000000815,0.0,0.0,1.59362,18.11.2010 10:30:00,5848,-0.3489977629786055,-42.0,IS,0.14,0.0,Phase3-EA-B1v1-GBPUSD-M30-14,GBPUSDMT4,372,59m 58s,Buy
73448.97,1.34622,18.11.2010 11:59:58,sl 1.34622,0.0,-706.810000000085,0.0,0.0,1.34232,18.11.2010 03:30:00,5849,-0.4305727157460338,-133.91,IS,0.34,0.0,Phase3-EA-S4v1-EURCHF-M15-221,EURCHFMT4,1436,8h 29m,Sell
73363.03,113959,18.11.2010 20:29:58,sl 113.959,-1.89,-792.7500000000873,0.0,0.0,112378,17.11.2010 01:00:00,5850,-0.48292542608008493,-85.94,IS,0.09,0.0,Phase3-EA-TR1v1-EURJPY-M30-91,EURJPYMT4,855,1d 19h 29m,Sell
73408.26,1.35774,18.11.2010 22:04:57,tp 1.35774,0.0,-747.5200000000768,0.0,0.0,1.35884,18.11.2010 21:05:00,5851,-0.45537232986866283,45.23,IS,0.41,0.0,Phase3-EA-SA2v2-EURCHF-M5-43,EURCHFMT4,3082,59m 57s,Sell
73424.78,83517,19.11.2010 03:45:00,,-0.94,-731.0000000000873,0.0,0.0,83463,18.11.2010 23:15:00,5852,-0.4453087183406438,16.52,IS,0.27,0.0,Phase3-EA-S1v2-USDJPY-M15-0,USDJPYMT4,1950,4h 30m,Buy
73470.06,1.35742,19.11.2010 06:24:57,tp 1.35742,0.0,-685.7200000000885,0.0,0.0,1.35852,19.11.2010 01:30:00,5853,-0.4177251632565652,45.28,IS,0.41,0.0,Phase3-EA-SA2v2-EURCHF-M5-43,EURCHFMT4,3084,4h 54m,Sell
73606.84,1.35512,19.11.2010 08:14:58,tp 1.35512,0.0,-548.9400000000896,0.0,0.0,1.35912,19.11.2010 02:30:00,5854,-0.3344018711982541,136.78,IS,0.34,0.0,Phase3-EA-S4v1-EURCHF-M15-221,EURCHFMT4,1438,5h 44m,Sell
73559.85,113751,19.11.2010 11:44:58,sl 113.751,0.0,-595.9300000000803,0.0,0.0,113981,19.11.2010 10:15:00,5855,-0.36302711972741986,-46.99,IS,0.17,0.0,Phase3-EA-T1v2-EURJPY-M15-322,EURJPYMT4,738,1h 29m,Buy
73487.61,133375,19.11.2010 16:29:58,sl 133.375,0.0,-668.170000000071,0.0,0.0,134045,19.11.2010 03:00:00,5856,-0.4070340989516608,-72.24,IS,0.09,0.0,Phase3-EA-B1v1-GBPJPY-M30-1,GBPJPYMT4,634,13h 29m,Buy
73532.78,1.36313,19.11.2010 20:49:57,tp 1.36313,0.0,-623.0000000000582,0.0,0.0,1.36203,19.11.2010 20:40:00,5857,-0.3795175533874335,45.17,IS,0.41,0.0,Phase3-EA-SA2v2-EURCHF-M5-43,EURCHFMT4,3086,9m 57s,Buy
73667.47,114.44,22.11.2010 02:00:00,tp 114.440,-1.06,-488.3100000000559,0.0,0.0,113.18,18.11.2010 07:30:00,5858,-0.2974674422064551,134.69,IS,0.09,0.0,Phase3-EA-TR1v1-EURJPY-M30-91,EURJPYMT4,857,3d 18h 30m,Buy
73711.93,1.36109,22.11.2010 02:00:00,tp 1.36109,-0.99,-443.85000000006403,0.0,0.0,1.35999,19.11.2010 22:15:00,5859,-0.27038341263406246,44.46,IS,0.41,0.0,Phase3-EA-SA2v2-EURCHF-M5-43,EURCHFMT4,3088,2d 3h 45m,Buy
73611.39,0.99342,22.11.2010 02:30:00,,-0.7,-544.3900000000722,0.0,0.0,0.99513,19.11.2010 22:15:00,5860,-0.33163011378586355,-100.54,IS,0.58,0.0,Phase3-EA-SA2v2-USDCHF-M15-107,USDCHFMT4,1176,2d 4h 15m,Buy
73529.4,1.36457,22.11.2010 10:30:00,,0.0,-626.3800000000629,0.0,0.0,1.36259,22.11.2010 02:10:00,5861,-0.38157657317948995,-81.99,IS,0.41,0.0,Phase3-EA-SA2v2-EURCHF-M5-43,EURCHFMT4,3090,8h 20m,Sell
73632.5,114659,22.11.2010 12:30:00,,-1.0,-523.280000000057,0.0,0.0,114148,19.11.2010 22:30:00,5862,-0.31877037774731826,103.1,IS,0.17,0.0,Phase3-EA-T1v2-EURJPY-M15-322,EURJPYMT4,740,2d 14h 0m,Buy
73589.44,1.59128,22.11.2010 20:29:58,sl 1.59128,-1.06,-566.3400000000547,0.0,0.0,1.59428,18.11.2010 12:00:00,5863,-0.34500155888513606,-43.06,IS,0.14,0.0,Phase3-EA-B1v1-GBPUSD-M30-14,GBPUSDMT4,374,4d 8h 29m,Buy
73634.92,1.34804,22.11.2010 21:44:57,tp 1.34804,0.0,-520.8600000000442,0.0,0.0,1.34694,22.11.2010 20:35:00,5864,-0.31729616831039636,45.48,IS,0.41,0.0,Phase3-EA-SA2v2-EURCHF-M5-43,EURCHFMT4,3092,1h 9m,Buy
73774.05,113261,22.11.2010 21:59:58,tp 113.261,0.0,-381.7300000000396,0.0,0.0,114551,22.11.2010 11:00:00,5865,-0.23254130923689642,139.13,IS,0.09,0.0,Phase3-EA-TR1v1-EURJPY-M30-91,EURJPYMT4,860,10h 59m,Sell
73817.58,1.34764,23.11.2010 01:24:58,tp 1.34764,-2.07,-338.20000000004075,0.0,0.0,1.34874,22.11.2010 23:55:00,5866,-0.2060238146960409,43.53,IS,0.41,0.0,Phase3-EA-SA2v2-EURCHF-M5-43,EURCHFMT4,3094,1h 29m,Sell
73876.23,0.98889,23.11.2010 02:59:57,tp 0.98889,0.0,-279.55000000004657,0.0,0.0,0.98789,23.11.2010 02:00:00,5867,-0.17029555706174124,58.65,IS,0.58,0.0,Phase3-EA-SA2v2-USDCHF-M15-107,USDCHFMT4,1178,59m 57s,Buy
73742.11,1.34244,23.11.2010 04:14:58,sl 1.34244,0.0,-413.6700000000419,0.0,0.0,1.34634,23.11.2010 02:30:00,5868,-0.25199843709435127,-134.12,IS,0.34,0.0,Phase3-EA-S4v1-EURCHF-M15-221,EURCHFMT4,1440,1h 44m,Buy
73539.05,1.34109,23.11.2010 09:29:57,sl 1.34109,0.0,-616.7300000000396,0.0,0.0,1.34599,23.11.2010 01:55:00,5869,-0.3756980107554173,-203.06,IS,0.41,0.0,Phase3-EA-SA2v2-EURCHF-M5-43,EURCHFMT4,3096,7h 34m,Buy
73405.14,1.33984,23.11.2010 09:44:58,sl 1.33984,0.0,-750.6400000000431,0.0,0.0,1.34374,23.11.2010 04:30:00,5870,-0.4572729635228456,-133.91,IS,0.34,0.0,Phase3-EA-S4v1-EURCHF-M15-221,EURCHFMT4,1442,5h 14m,Buy
73540.78,112522,23.11.2010 16:29:57,tp 112.522,-0.38,-615.0000000000291,0.0,0.0,113782,22.11.2010 18:30:00,5871,-0.37464413376125333,135.64,IS,0.09,0.0,Phase3-EA-TR1v1-EURJPY-M30-91,EURJPYMT4,861,21h 59m,Sell
73889.33,111523,23.11.2010 17:59:57,tp 111.523,0.0,-266.45000000004075,0.0,0.0,113223,23.11.2010 14:15:00,5872,-0.16231533242389673,348.55,IS,0.17,0.0,Phase3-EA-T1v2-EURJPY-M15-322,EURJPYMT4,742,3h 44m,Sell
74089.58,130869,23.11.2010 20:29:58,tp 130.869,-0.63,-66.20000000004075,0.0,0.0,132719,22.11.2010 22:30:00,5873,-0.0403275474065188,200.25,IS,0.09,0.0,Phase3-EA-B1v1-GBPJPY-M30-1,GBPJPYMT4,636,21h 59m,Sell
73987.09,131779,24.11.2010 08:30:00,,0.0,-168.69000000003143,0.0,0.0,131408,24.11.2010 03:05:00,5874,-0.10276214459218636,-102.49,IS,0.23,0.0,Phase3-EA-S4v1-GBPJPY-M5-194,GBPJPYMT4,1468,5h 25m,Sell
73959.97,83128,24.11.2010 09:30:00,,-1.46,-195.81000000002678,0.0,0.0,83049,23.11.2010 21:45:00,5875,-0.1192830371248741,-27.12,IS,0.27,0.0,Phase3-EA-S1v2-USDJPY-M15-0,USDJPYMT4,1952,11h 45m,Sell
74096.2,110619,24.11.2010 12:29:58,tp 110.619,-0.38,-59.5800000000163,0.0,0.0,111879,23.11.2010 17:30:00,5876,-0.03629479266585451,136.23,IS,0.09,0.0,Phase3-EA-TR1v1-EURJPY-M30-91,EURJPYMT4,864,18h 59m,Sell
74049.31,111521,24.11.2010 16:44:58,sl 111.521,0.0,-106.47000000003027,0.0,0.0,111291,24.11.2010 10:15:00,5877,-0.06485912344970747,-46.89,IS,0.17,0.0,Phase3-EA-T1v2-EURJPY-M15-322,EURJPYMT4,744,6h 29m,Sell
74096.88,83436,24.11.2010 19:15:00,,0.0,-58.90000000002328,0.0,0.0,83289,24.11.2010 18:00:00,5878,-0.03588055199763496,47.57,IS,0.27,0.0,Phase3-EA-S1v2-USDJPY-M15-0,USDJPYMT4,1954,1h 15m,Buy
74155.12,0.99585,24.11.2010 23:59:58,tp 0.99585,0.0,-0.6600000000325963,0.0,0.0,0.99685,24.11.2010 23:15:00,5879,-4.020571191782561E-4,58.24,IS,0.58,0.0,Phase3-EA-SA2v2-USDCHF-M15-107,USDCHFMT4,1180,44m 58s,Sell
74197.44,1.32859,25.11.2010 02:09:57,tp 1.32859,-2.96,-0.0,0.0,0.0,1.32749,24.11.2010 20:45:00,5880,-0.0,42.32,IS,0.41,0.0,Phase3-EA-SA2v2-EURCHF-M5-43,EURCHFMT4,3098,5h 24m,Buy
74242.71,1.32737,25.11.2010 03:44:58,tp 1.32737,0.0,-0.0,0.0,0.0,1.32847,25.11.2010 02:10:00,5881,-0.0,45.27,IS,0.41,0.0,Phase3-EA-SA2v2-EURCHF-M5-43,EURCHFMT4,3100,1h 34m,Sell
74192.85,131494,25.11.2010 08:50:00,,0.0,-49.85999999998603,0.0,0.0,131675,25.11.2010 03:25:00,5882,-0.030357511758047594,-49.86,IS,0.23,0.0,Phase3-EA-S4v1-GBPJPY-M5-194,GBPJPYMT4,1470,5h 25m,Buy
74237.94,1.33677,25.11.2010 21:04:58,tp 1.33677,0.0,-4.769999999989523,0.0,0.0,1.33787,25.11.2010 21:00:00,5883,-0.0029042384894827425,45.09,IS,0.41,0.0,Phase3-EA-SA2v2-EURCHF-M5-43,EURCHFMT4,3102,4m 58s,Sell
74283.01,1.33691,25.11.2010 21:44:57,tp 1.33691,0.0,-0.0,0.0,0.0,1.33801,25.11.2010 21:30:00,5884,-0.0,45.07,IS,0.41,0.0,Phase3-EA-SA2v2-EURCHF-M5-43,EURCHFMT4,3104,14m 57s,Sell
74150.35,1.33176,26.11.2010 06:44:58,sl 1.33176,0.0,-132.6600000000035,0.0,0.0,1.33566,26.11.2010 01:45:00,5885,-0.08075089444733417,-132.66,IS,0.34,0.0,Phase3-EA-S4v1-EURCHF-M15-221,EURCHFMT4,1444,4h 59m,Buy
73949.2,1.32939,26.11.2010 09:19:58,sl 1.32939,0.0,-333.8099999999977,0.0,0.0,1.33429,26.11.2010 02:10:00,5886,-0.20319204036984564,-201.15,IS,0.41,0.0,Phase3-EA-SA2v2-EURCHF-M5-43,EURCHFMT4,3106,7h 9m,Buy
73871.44,110933,26.11.2010 12:59:57,sl 110.933,-0.53,-411.570000000007,0.0,0.0,111653,25.11.2010 18:30:00,5887,-0.25052499342446116,-77.76,IS,0.09,0.0,Phase3-EA-TR1v1-EURJPY-M30-91,EURJPYMT4,866,18h 29m,Buy
73916.45,1.32681,26.11.2010 20:49:57,tp 1.32681,0.0,-366.5599999999977,0.0,0.0,1.32571,26.11.2010 20:35:00,5888,-0.22312715112779924,45.01,IS,0.41,0.0,Phase3-EA-SA2v2-EURCHF-M5-43,EURCHFMT4,3108,14m 57s,Buy
73928.69,84074,29.11.2010 02:30:00,,-0.93,-354.320000000007,0.0,0.0,84033,26.11.2010 23:00:00,5889,-0.21567659370254225,12.24,IS,0.27,0.0,Phase3-EA-S1v2-USDJPY-M15-0,USDJPYMT4,1956,2d 3h 30m,Buy
73971.62,1.32673,29.11.2010 03:34:58,tp 1.32673,-2.04,-311.39000000001397,0.0,0.0,1.32783,26.11.2010 22:45:00,5890,-0.18954485920364733,42.93,IS,0.41,0.0,Phase3-EA-SA2v2-EURCHF-M5-43,EURCHFMT4,3110,2d 4h 49m,Sell
74107.23,1.32541,29.11.2010 03:44:58,tp 1.32541,0.0,-175.78000000002794,0.0,0.0,1.32941,29.11.2010 02:45:00,5891,-0.10699828302392796,135.61,IS,0.34,0.0,Phase3-EA-S4v1-EURCHF-M15-221,EURCHFMT4,1446,59m 58s,Sell
74060.75,111318,29.11.2010 05:44:58,sl 111.318,0.0,-222.26000000003842,0.0,0.0,111088,29.11.2010 04:15:00,5892,-0.1352909226584285,-46.48,IS,0.17,0.0,Phase3-EA-T1v2-EURJPY-M15-322,EURJPYMT4,746,1h 29m,Sell
74196.7,1.3276,29.11.2010 10:44:58,tp 1.32760,0.0,-86.31000000002678,0.0,0.0,1.3236,29.11.2010 05:30:00,5893,-0.05253738655021401,135.95,IS,0.34,0.0,Phase3-EA-S4v1-EURCHF-M15-221,EURCHFMT4,1448,5h 14m,Buy
74154.7,1.56111,29.11.2010 11:29:58,sl 1.56111,0.0,-128.31000000002678,0.0,0.0,1.56411,29.11.2010 11:00:00,5894,-0.07810302477415451,-42.0,IS,0.14,0.0,Phase3-EA-B1v1-GBPUSD-M30-14,GBPUSDMT4,376,29m 58s,Buy
74212.75,0.99914,30.11.2010 04:29:58,tp 0.99914,0.0,-70.26000000003842,0.0,0.0,1.00014,30.11.2010 02:15:00,5895,-0.04276766051464384,58.05,IS,0.58,0.0,Phase3-EA-SA2v2-USDCHF-M15-107,USDCHFMT4,1182,2h 14m,Sell
74346.91,109821,30.11.2010 11:59:59,tp 109.821,-0.74,-0.0,0.0,0.0,111081,26.11.2010 13:00:00,5896,-0.0,134.16,IS,0.09,0.0,Phase3-EA-TR1v1-EURJPY-M30-91,EURJPYMT4,868,3d 22h 59m,Sell
74690.29,109238,30.11.2010 12:44:58,tp 109.238,-0.71,-0.0,0.0,0.0,110938,29.11.2010 13:15:00,5897,-0.0,343.38,IS,0.17,0.0,Phase3-EA-T1v2-EURJPY-M15-322,EURJPYMT4,748,23h 29m,Sell
74735.31,1.30362,30.11.2010 21:44:58,tp 1.30362,0.0,-0.0,0.0,0.0,1.30472,30.11.2010 20:35:00,5898,-0.0,45.02,IS,0.41,0.0,Phase3-EA-SA2v2-EURCHF-M5-43,EURCHFMT4,3112,1h 9m,Sell
74778.21,1.30244,01.12.2010 01:04:57,tp 1.30244,-2.04,-0.0,0.0,0.0,1.30354,30.11.2010 21:45:00,5899,-0.0,42.9,IS,0.41,0.0,Phase3-EA-SA2v2-EURCHF-M5-43,EURCHFMT4,3114,3h 19m,Sell
74775.73,1.00271,01.12.2010 03:30:00,,-3.06,-2.4800000000104774,0.0,0.0,1.00272,30.11.2010 23:15:00,5900,-0.0015050533684098626,-2.48,IS,0.58,0.0,Phase3-EA-SA2v2-USDCHF-M15-107,USDCHFMT4,1184,4h 15m,Sell
74831.46,83583,01.12.2010 03:30:00,,-1.45,-0.0,0.0,0.0,83.76,30.11.2010 19:00:00,5901,-0.0,55.73,IS,0.27,0.0,Phase3-EA-S1v2-USDJPY-M15-0,USDJPYMT4,1958,8h 30m,Sell
74837.8,130004,01.12.2010 09:10:00,,0.0,-0.0,0.0,0.0,129981,01.12.2010 03:45:00,5902,-0.0,6.34,IS,0.23,0.0,Phase3-EA-S4v1-GBPJPY-M5-194,GBPJPYMT4,1472,5h 25m,Buy
74973.53,1.30599,01.12.2010 09:14:58,tp 1.30599,0.0,-0.0,0.0,0.0,1.30199,01.12.2010 05:00:00,5903,-0.0,135.73,IS,0.34,0.0,Phase3-EA-S4v1-EURCHF-M15-221,EURCHFMT4,1450,4h 14m,Buy
74900.89,131034,01.12.2010 13:29:58,sl 131.034,-0.62,-72.64000000001397,0.0,0.0,130364,30.11.2010 12:00:00,5904,-0.044031306113177036,-72.64,IS,0.09,0.0,Phase3-EA-B1v1-GBPJPY-M30-1,GBPJPYMT4,638,1d 1h 29m,Sell
74823.17,109953,01.12.2010 15:59:58,sl 109.953,-0.38,-150.36000000001513,0.0,0.0,109233,30.11.2010 14:00:00,5905,-0.09114189409659544,-77.72,IS,0.09,0.0,Phase3-EA-TR1v1-EURJPY-M30-91,EURJPYMT4,870,1d 1h 59m,Sell
74868.09,1.31594,01.12.2010 21:24:58,tp 1.31594,0.0,-105.44000000000233,0.0,0.0,1.31704,01.12.2010 20:45:00,5906,-0.06391328354312495,44.92,IS,0.41,0.0,Phase3-EA-SA2v2-EURCHF-M5-43,EURCHFMT4,3116,39m 58s,Sell
74803.53,131127,02.12.2010 07:30:00,,0.0,-170.0,0.0,0.0,131363,02.12.2010 02:05:00,5907,-0.10304683424062028,-64.56,IS,0.23,0.0,Phase3-EA-S4v1-GBPJPY-M5-194,GBPJPYMT4,1474,5h 25m,Buy
74841.83,84117,02.12.2010 09:15:00,,-2.79,-131.70000000001164,0.0,0.0,83989,01.12.2010 20:00:00,5908,-0.07983098864406406,38.3,IS,0.27,0.0,Phase3-EA-S1v2-USDJPY-M15-0,USDJPYMT4,1960,13h 15m,Buy
74795.35,110376,02.12.2010 11:44:58,sl 110.376,0.0,-178.18000000002212,0.0,0.0,110606,02.12.2010 10:15:00,5909,-0.10800520544115294,-46.48,IS,0.17,0.0,Phase3-EA-T1v2-EURJPY-M15-322,EURJPYMT4,750,1h 29m,Buy
74850.7,0.9923,03.12.2010 00:14:58,tp 0.99230,-3.1,-122.8300000000163,0.0,0.0,0.9933,02.12.2010 23:15:00,5910,-0.0744543685281004,55.35,IS,0.58,0.0,Phase3-EA-SA2v2-USDCHF-M15-107,USDCHFMT4,1186,59m 58s,Sell
74894.07,1.3115,03.12.2010 00:59:58,tp 1.31150,-2.06,-79.46000000002095,0.0,0.0,1.3126,02.12.2010 23:40:00,5911,-0.04816530263977557,43.37,IS,0.41,0.0,Phase3-EA-SA2v2-EURCHF-M5-43,EURCHFMT4,3118,1h 19m,Sell
74846.4,110597,03.12.2010 03:14:58,sl 110.597,-0.99,-127.13000000003376,0.0,0.0,110827,02.12.2010 23:30:00,5912,-0.0770608472765502,-47.67,IS,0.17,0.0,Phase3-EA-T1v2-EURJPY-M15-322,EURJPYMT4,752,3h 44m,Buy
74923.36,83672,03.12.2010 03:15:00,,-1.45,-50.17000000004191,0.0,0.0,83915,02.12.2010 23:00:00,5913,-0.03041093925797787,76.96,IS,0.27,0.0,Phase3-EA-S1v2-USDJPY-M15-0,USDJPYMT4,1962,4h 15m,Sell
74943.15,130.58,03.12.2010 08:35:00,,0.0,-30.38000000003376,0.0,0.0,130508,03.12.2010 03:10:00,5914,-0.01841507543666778,19.79,IS,0.23,0.0,Phase3-EA-S4v1-GBPJPY-M5-194,GBPJPYMT4,1476,5h 25m,Buy
75080.28,1.30861,03.12.2010 11:29:57,tp 1.30861,0.0,-0.0,0.0,0.0,1.31261,03.12.2010 06:15:00,5915,-0.0,137.13,IS,0.34,0.0,Phase3-EA-S4v1-EURCHF-M15-221,EURCHFMT4,1452,5h 14m,Sell
75126.44,1.30666,03.12.2010 20:24:58,tp 1.30666,0.0,-0.0,0.0,0.0,1.30556,03.12.2010 20:05:00,5916,-0.0,46.16,IS,0.41,0.0,Phase3-EA-SA2v2-EURCHF-M5-43,EURCHFMT4,3120,19m 58s,Buy
75172.68,1.30665,03.12.2010 23:39:58,tp 1.30665,0.0,-0.0,0.0,0.0,1.30775,03.12.2010 22:50:00,5917,-0.0,46.24,IS,0.41,0.0,Phase3-EA-SA2v2-EURCHF-M5-43,EURCHFMT4,3122,49m 58s,Sell
75232.04,0.97703,03.12.2010 23:44:58,tp 0.97703,0.0,-0.0,0.0,0.0,0.97803,03.12.2010 22:30:00,5918,-0.0,59.36,IS,0.58,0.0,Phase3-EA-SA2v2-USDCHF-M15-107,USDCHFMT4,1188,1h 14m,Sell
75278.34,1.30755,03.12.2010 23:54:58,tp 1.30755,0.0,-0.0,0.0,0.0,1.30645,03.12.2010 23:45:00,5919,-0.0,46.3,IS,0.41,0.0,Phase3-EA-SA2v2-EURCHF-M5-43,EURCHFMT4,3124,9m 58s,Buy
75334.66,82692,06.12.2010 02:00:00,,-1.47,-0.0,0.0,0.0,82869,03.12.2010 22:15:00,5920,-0.0,56.32,IS,0.27,0.0,Phase3-EA-S1v2-USDJPY-M15-0,USDJPYMT4,1964,2d 3h 45m,Sell
75286.44,110534,06.12.2010 05:29:58,sl 110.534,-1.01,-48.220000000001164,0.0,0.0,110764,03.12.2010 22:00:00,5921,-0.029165088554330452,-48.22,IS,0.17,0.0,Phase3-EA-T1v2-EURJPY-M15-322,EURJPYMT4,754,2d 7h 29m,Buy
75150.63,1.30061,06.12.2010 10:29:58,sl 1.30061,0.0,-184.02999999999884,0.0,0.0,1.30451,06.12.2010 06:15:00,5922,-0.1113075745884129,-135.81,IS,0.34,0.0,Phase3-EA-S4v1-EURCHF-M15-221,EURCHFMT4,1454,4h 14m,Buy
75196.56,1.30713,07.12.2010 01:24:57,tp 1.30713,0.0,-138.10000000000582,0.0,0.0,1.30603,07.12.2010 00:15:00,5923,-0.08352755556518267,45.93,IS,0.41,0.0,Phase3-EA-SA2v2-EURCHF-M5-43,EURCHFMT4,3126,1h 9m,Buy
75204.73,82623,07.12.2010 02:00:00,,0.0,-129.92999999999302,0.0,0.0,82648,07.12.2010 00:15:00,5924,-0.0785860629586035,8.17,IS,0.27,0.0,Phase3-EA-S1v2-USDJPY-M15-0,USDJPYMT4,1966,1h 45m,Sell
75240.63,0.98216,07.12.2010 02:30:00,,-0.71,-94.02999999999884,0.0,0.0,0.98154,06.12.2010 22:15:00,5925,-0.056872527514798675,35.9,IS,0.58,0.0,Phase3-EA-SA2v2-USDCHF-M15-107,USDCHFMT4,1190,4h 15m,Buy
75286.55,1.30667,07.12.2010 03:49:58,tp 1.30667,0.0,-48.10999999998603,0.0,0.0,1.30557,07.12.2010 02:40:00,5926,-0.029098556830120213,45.92,IS,0.41,0.0,Phase3-EA-SA2v2-EURCHF-M5-43,EURCHFMT4,3128,1h 9m,Buy
75323.0,1.30654,07.12.2010 12:00:00,,0.0,-11.659999999974389,0.0,0.0,1.30549,07.12.2010 03:15:00,5927,-0.007052362765299417,36.45,IS,0.34,0.0,Phase3-EA-S4v1-EURCHF-M15-221,EURCHFMT4,1456,8h 45m,Buy
75586.54,1.58045,07.12.2010 12:59:58,tp 1.58045,-1.06,-0.0,0.0,0.0,1.56155,03.12.2010 11:30:00,5928,-0.0,263.54,IS,0.14,0.0,Phase3-EA-B1v1-GBPUSD-M30-14,GBPUSDMT4,378,4d 1h 29m,Buy
75632.32,1.31013,07.12.2010 22:29:58,tp 1.31013,0.0,-0.0,0.0,0.0,1.31123,07.12.2010 22:20:00,5929,-0.0,45.78,IS,0.41,0.0,Phase3-EA-SA2v2-EURCHF-M5-43,EURCHFMT4,3130,9m 58s,Sell
75678.0,1.31014,07.12.2010 23:44:58,tp 1.31014,0.0,-0.0,0.0,0.0,1.31124,07.12.2010 23:00:00,5930,-0.0,45.68,IS,0.41,0.0,Phase3-EA-SA2v2-EURCHF-M5-43,EURCHFMT4,3132,44m 58s,Sell
75723.64,1.31029,08.12.2010 01:24:57,tp 1.31029,0.0,-0.0,0.0,0.0,1.30919,08.12.2010 00:55:00,5931,-0.0,45.64,IS,0.41,0.0,Phase3-EA-SA2v2-EURCHF-M5-43,EURCHFMT4,3134,29m 57s,Buy
75715.83,0.98715,08.12.2010 03:15:00,,-3.11,-7.809999999997672,0.0,0.0,0.98707,07.12.2010 23:00:00,5932,-0.004712665012666673,-7.81,IS,0.58,0.0,Phase3-EA-SA2v2-USDCHF-M15-107,USDCHFMT4,1192,4h 15m,Sell
75669.1,110764,08.12.2010 05:44:57,sl 110.764,0.0,-54.54000000000815,0.0,0.0,110994,08.12.2010 04:30:00,5933,-0.03291021124083935,-46.73,IS,0.17,0.0,Phase3-EA-T1v2-EURJPY-M15-322,EURJPYMT4,756,1h 14m,Buy
75622.44,110742,08.12.2010 10:29:58,sl 110.742,0.0,-101.20000000001164,0.0,0.0,110972,08.12.2010 08:00:00,5934,-0.061065518474015916,-46.66,IS,0.17,0.0,Phase3-EA-T1v2-EURJPY-M15-322,EURJPYMT4,758,2h 29m,Buy
75488.29,1.30382,08.12.2010 12:14:58,sl 1.30382,0.0,-235.35000000000582,0.0,0.0,1.30772,08.12.2010 06:45:00,5935,-0.1420135353049244,-134.15,IS,0.34,0.0,Phase3-EA-S4v1-EURCHF-M15-221,EURCHFMT4,1458,5h 29m,Buy
75483.43,110898,08.12.2010 13:15:00,,0.0,-240.20999999999185,0.0,0.0,110922,08.12.2010 13:00:00,5936,-0.14494612838578239,-4.86,IS,0.17,0.0,Phase3-EA-T1v2-EURJPY-M15-322,EURJPYMT4,760,15m 0s,Buy
75441.43,1.57708,08.12.2010 13:59:58,sl 1.57708,0.0,-282.20999999999185,0.0,0.0,1.57408,08.12.2010 05:30:00,5937,-0.17028952538092443,-42.0,IS,0.14,0.0,Phase3-EA-B1v1-GBPUSD-M30-14,GBPUSDMT4,380,8h 29m,Sell
75572.6,111.28,08.12.2010 17:59:58,tp 111.280,-3.69,-151.03999999997905,0.0,0.0,110.02,01.12.2010 16:00:00,5938,-0.09113968290823145,131.17,IS,0.09,0.0,Phase3-EA-TR1v1-EURJPY-M30-91,EURJPYMT4,872,7d 1h 59m,Buy
75618.28,1.3075,08.12.2010 21:09:57,tp 1.30750,0.0,-105.35999999998603,0.0,0.0,1.3086,08.12.2010 21:00:00,5939,-0.06357572160494786,45.68,IS,0.41,0.0,Phase3-EA-SA2v2-EURCHF-M5-43,EURCHFMT4,3136,9m 57s,Sell
75620.3,84075,09.12.2010 03:15:00,,-2.8,-103.33999999999651,0.0,0.0,84.06,08.12.2010 21:15:00,5940,-0.06235682489233069,2.02,IS,0.27,0.0,Phase3-EA-S1v2-USDJPY-M15-0,USDJPYMT4,1968,6h 0m,Buy
75666.12,1.30857,09.12.2010 04:09:57,tp 1.30857,0.0,-57.51999999998952,0.0,0.0,1.30747,09.12.2010 02:20:00,5941,-0.034708385599054856,45.82,IS,0.41,0.0,Phase3-EA-SA2v2-EURCHF-M5-43,EURCHFMT4,3138,1h 49m,Buy
75645.71,1.30669,09.12.2010 11:15:00,,0.0,-77.92999999999302,0.0,0.0,1.30728,09.12.2010 02:30:00,5942,-0.04702406971026765,-20.41,IS,0.34,0.0,Phase3-EA-S4v1-EURCHF-M15-221,EURCHFMT4,1460,8h 45m,Buy
75691.55,1.30097,09.12.2010 22:14:57,tp 1.30097,0.0,-32.08999999999651,0.0,0.0,1.30207,09.12.2010 21:15:00,5943,-0.019363562132714743,45.84,IS,0.41,0.0,Phase3-EA-SA2v2-EURCHF-M5-43,EURCHFMT4,3140,59m 57s,Sell
75636.06,0.98248,10.12.2010 05:15:00,,0.0,-87.5799999999872,0.0,0.0,0.98342,10.12.2010 01:00:00,5944,-0.052847016877005104,-55.49,IS,0.58,0.0,Phase3-EA-SA2v2-USDCHF-M15-107,USDCHFMT4,1194,4h 15m,Buy
75661.55,83683,10.12.2010 05:30:00,,0.0,-62.08999999999651,0.0,0.0,83762,10.12.2010 01:45:00,5945,-0.037465988557816195,25.49,IS,0.27,0.0,Phase3-EA-S1v2-USDJPY-M15-0,USDJPYMT4,1970,3h 45m,Sell
75614.96,111026,10.12.2010 19:59:58,sl 111.026,0.0,-108.67999999999302,0.0,0.0,110796,10.12.2010 12:00:00,5946,-0.06557905679599664,-46.59,IS,0.17,0.0,Phase3-EA-T1v2-EURJPY-M15-322,EURJPYMT4,762,7h 59m,Sell
75658.85,1.29686,13.12.2010 02:00:00,tp 1.29686,-2.09,-64.78999999997905,0.0,0.0,1.29796,10.12.2010 21:25:00,5947,-0.03909520693606479,43.89,IS,0.41,0.0,Phase3-EA-SA2v2-EURCHF-M5-43,EURCHFMT4,3142,2d 4h 35m,Sell
75589.53,0.98163,13.12.2010 02:15:00,,-3.14,-134.10999999998603,0.0,0.0,0.98051,10.12.2010 22:00:00,5948,-0.08092388026233675,-69.32,IS,0.58,0.0,Phase3-EA-SA2v2-USDCHF-M15-107,USDCHFMT4,1196,2d 4h 15m,Sell
75626.85,83992,13.12.2010 02:15:00,,-0.93,-96.78999999997905,0.0,0.0,83873,10.12.2010 22:15:00,5949,-0.05840446178950633,37.32,IS,0.27,0.0,Phase3-EA-S1v2-USDJPY-M15-0,USDJPYMT4,1972,2d 4h 0m,Buy
75672.71,1.29725,13.12.2010 06:24:57,tp 1.29725,0.0,-50.929999999993015,0.0,0.0,1.29615,13.12.2010 02:20:00,5950,-0.030731885927676346,45.86,IS,0.41,0.0,Phase3-EA-SA2v2-EURCHF-M5-43,EURCHFMT4,3144,4h 4m,Buy
75732.05,132.77,13.12.2010 08:50:00,,0.0,-0.0,0.0,0.0,132553,13.12.2010 03:25:00,5951,-0.0,59.34,IS,0.23,0.0,Phase3-EA-S4v1-GBPJPY-M5-194,GBPJPYMT4,1478,5h 25m,Buy
75870.23,1.30004,13.12.2010 10:29:58,tp 1.30004,0.0,-0.0,0.0,0.0,1.29604,13.12.2010 02:45:00,5952,-0.0,138.18,IS,0.34,0.0,Phase3-EA-S4v1-EURCHF-M15-221,EURCHFMT4,1462,7h 44m,Buy
75916.83,1.29582,13.12.2010 23:39:57,tp 1.29582,0.0,-0.0,0.0,0.0,1.29692,13.12.2010 22:00:00,5953,-0.0,46.6,IS,0.41,0.0,Phase3-EA-SA2v2-EURCHF-M5-43,EURCHFMT4,3146,1h 39m,Sell
75903.46,0.96793,14.12.2010 03:30:00,,-3.18,-13.369999999995343,0.0,0.0,0.96776,13.12.2010 23:15:00,5954,-0.008058254247019631,-13.37,IS,0.58,0.0,Phase3-EA-SA2v2-USDCHF-M15-107,USDCHFMT4,1198,4h 15m,Sell
76049.23,111694,14.12.2010 03:45:00,,-1.0,-0.0,0.0,0.0,110973,13.12.2010 07:45:00,5955,-0.0,145.77,IS,0.17,0.0,Phase3-EA-T1v2-EURJPY-M15-322,EURJPYMT4,764,20h 0m,Buy
76095.8,1.29731,14.12.2010 05:44:59,tp 1.29731,0.0,-0.0,0.0,0.0,1.29621,14.12.2010 01:05:00,5956,-0.0,46.57,IS,0.41,0.0,Phase3-EA-SA2v2-EURCHF-M5-43,EURCHFMT4,3148,4h 39m,Buy
76102.27,83406,14.12.2010 10:00:00,,0.0,-0.0,0.0,0.0,83426,14.12.2010 00:30:00,5957,-0.0,6.47,IS,0.27,0.0,Phase3-EA-S1v2-USDJPY-M15-0,USDJPYMT4,1974,9h 30m,Sell
76243.21,1.29946,14.12.2010 11:14:58,tp 1.29946,0.0,-0.0,0.0,0.0,1.29546,14.12.2010 04:15:00,5958,-0.0,140.94,IS,0.34,0.0,Phase3-EA-S4v1-EURCHF-M15-221,EURCHFMT4,1464,6h 59m,Buy
76196.1,111554,14.12.2010 13:44:57,sl 111.554,0.0,-47.10999999998603,0.0,0.0,111784,14.12.2010 05:30:00,5959,-0.02833799948881282,-47.11,IS,0.17,0.0,Phase3-EA-T1v2-EURJPY-M15-322,EURJPYMT4,766,8h 14m,Buy
76153.57,1.57901,14.12.2010 17:29:58,sl 1.57901,-0.53,-89.63999999998487,0.0,0.0,1.58201,13.12.2010 18:30:00,5960,-0.05392099923959893,-42.53,IS,0.14,0.0,Phase3-EA-B1v1-GBPUSD-M30-14,GBPUSDMT4,382,22h 59m,Buy
76200.66,1.2854,14.12.2010 21:09:58,tp 1.28540,0.0,-42.54999999998836,0.0,0.0,1.2843,14.12.2010 20:55:00,5961,-0.025595030317321445,47.09,IS,0.41,0.0,Phase3-EA-SA2v2-EURCHF-M5-43,EURCHFMT4,3150,14m 58s,Buy
76130.76,83428,14.12.2010 22:30:00,,0.0,-112.44999999998254,0.0,0.0,83212,14.12.2010 17:00:00,5962,-0.06764186038033224,-69.9,IS,0.27,0.0,Phase3-EA-S1v2-USDJPY-M15-0,USDJPYMT4,1976,5h 30m,Sell
76200.16,83643,14.12.2010 22:45:00,,0.0,-43.04999999998836,0.0,0.0,83428,14.12.2010 22:30:00,5963,-0.02589579448086232,69.4,IS,0.27,0.0,Phase3-EA-S1v2-USDJPY-M15-0,USDJPYMT4,1978,15m 0s,Buy
76195.32,83.63,14.12.2010 23:00:00,,0.0,-47.889999999984866,0.0,0.0,83645,14.12.2010 22:45:00,5964,-0.028807191583935885,-4.84,IS,0.27,0.0,Phase3-EA-S1v2-USDJPY-M15-0,USDJPYMT4,1980,15m 0s,Buy
76241.17,1.28468,15.12.2010 04:19:57,tp 1.28468,-1.03,-2.0399999999790452,0.0,0.0,1.28358,14.12.2010 23:00:00,5965,-0.0012271177872341644,45.85,IS,0.41,0.0,Phase3-EA-SA2v2-EURCHF-M5-43,EURCHFMT4,3152,5h 19m,Buy
76127.85,0.96222,15.12.2010 07:00:00,,0.0,-115.35999999998603,0.0,0.0,0.96034,15.12.2010 02:45:00,5966,-0.06939230781214223,-113.32,IS,0.58,0.0,Phase3-EA-SA2v2-USDCHF-M15-107,USDCHFMT4,1200,4h 15m,Sell
76113.3,132096,15.12.2010 08:15:00,,0.0,-129.9099999999744,0.0,0.0,132043,15.12.2010 02:50:00,5967,-0.07814454497117468,-14.55,IS,0.23,0.0,Phase3-EA-S4v1-GBPJPY-M5-194,GBPJPYMT4,1480,5h 25m,Sell
76065.67,111645,15.12.2010 09:14:59,sl 111.645,-1.0,-177.53999999997905,0.0,0.0,111875,14.12.2010 21:00:00,5968,-0.10679533919008122,-47.63,IS,0.17,0.0,Phase3-EA-T1v2-EURJPY-M15-322,EURJPYMT4,768,12h 14m,Buy
76052.97,1.28305,15.12.2010 10:30:00,,0.0,-190.2399999999907,0.0,0.0,1.28341,15.12.2010 01:45:00,5969,-0.11443474894402644,-12.7,IS,0.34,0.0,Phase3-EA-S4v1-EURCHF-M15-221,EURCHFMT4,1466,8h 45m,Buy
76099.74,1.27954,15.12.2010 20:54:57,tp 1.27954,0.0,-143.47000000000116,0.0,0.0,1.27844,15.12.2010 20:35:00,5970,-0.08630126908641932,46.77,IS,0.41,0.0,Phase3-EA-SA2v2-EURCHF-M5-43,EURCHFMT4,3154,19m 57s,Buy
76159.67,0.96778,15.12.2010 23:14:58,tp 0.96778,0.0,-83.54000000000815,0.0,0.0,0.96878,15.12.2010 23:00:00,5971,-0.050251676444414264,59.93,IS,0.58,0.0,Phase3-EA-SA2v2-USDCHF-M15-107,USDCHFMT4,1202,14m 58s,Sell
76206.31,1.28003,16.12.2010 05:09:57,tp 1.28003,0.0,-36.89999999999418,0.0,0.0,1.27893,16.12.2010 00:20:00,5972,-0.02219639526931306,46.64,IS,0.41,0.0,Phase3-EA-SA2v2-EURCHF-M5-43,EURCHFMT4,3156,4h 49m,Buy
76222.48,1.27905,16.12.2010 10:15:00,,0.0,-20.729999999981374,0.0,0.0,1.27859,16.12.2010 01:30:00,5973,-0.012469682220393465,16.17,IS,0.34,0.0,Phase3-EA-S4v1-EURCHF-M15-221,EURCHFMT4,1468,8h 45m,Buy
76269.2,1.27649,16.12.2010 20:04:58,tp 1.27649,0.0,-0.0,0.0,0.0,1.27539,16.12.2010 20:00:00,5974,-0.0,46.72,IS,0.41,0.0,Phase3-EA-SA2v2-EURCHF-M5-43,EURCHFMT4,3158,4m 58s,Buy
76314.97,1.2775,17.12.2010 01:04:58,tp 1.27750,-1.02,-0.0,0.0,0.0,1.2764,16.12.2010 23:55:00,5975,-0.0,45.77,IS,0.41,0.0,Phase3-EA-SA2v2-EURCHF-M5-43,EURCHFMT4,3160,1h 9m,Buy
76139.5,0.9619,17.12.2010 04:45:00,,0.0,-175.47000000000116,0.0,0.0,0.96481,17.12.2010 00:30:00,5976,-0.10550463376808542,-175.47,IS,0.58,0.0,Phase3-EA-SA2v2-USDCHF-M15-107,USDCHFMT4,1204,4h 15m,Buy
76143.33,131187,17.12.2010 09:00:00,,0.0,-171.64000000001397,0.0,0.0,131173,17.12.2010 03:35:00,5977,-0.10320177432014324,3.83,IS,0.23,0.0,Phase3-EA-S4v1-GBPJPY-M5-194,GBPJPYMT4,1482,5h 25m,Buy
76093.89,111879,17.12.2010 12:14:58,sl 111.879,-2.83,-221.0800000000163,0.0,0.0,111649,15.12.2010 20:30:00,5978,-0.1329285030686151,-49.44,IS,0.17,0.0,Phase3-EA-T1v2-EURJPY-M15-322,EURJPYMT4,770,1d 15h 44m,Sell
76017.27,130756,17.12.2010 12:59:58,sl 130.756,-4.65,-297.70000000001164,0.0,0.0,131426,07.12.2010 21:30:00,5979,-0.17899771740331707,-76.62,IS,0.09,0.0,Phase3-EA-B1v1-GBPJPY-M30-1,GBPJPYMT4,640,9d 15h 29m,Buy
75937.02,110727,17.12.2010 18:59:58,sl 110.727,-3.15,-377.95000000001164,0.0,0.0,111477,09.12.2010 07:00:00,5980,-0.22724953742889864,-80.25,IS,0.09,0.0,Phase3-EA-TR1v1-EURJPY-M30-91,EURJPYMT4,874,8d 11h 59m,Sell
75983.57,1.27566,17.12.2010 22:39:57,tp 1.27566,0.0,-331.4000000000233,0.0,0.0,1.27456,17.12.2010 22:25:00,5981,-0.1992604754701415,46.55,IS,0.41,0.0,Phase3-EA-SA2v2-EURCHF-M5-43,EURCHFMT4,3162,14m 57s,Buy
76118.54,110187,20.12.2010 06:59:58,tp 110.187,-3.39,-196.43000000002212,0.0,0.0,111447,13.12.2010 13:00:00,5982,-0.11810722750935894,134.97,IS,0.09,0.0,Phase3-EA-TR1v1-EURJPY-M30-91,EURJPYMT4,875,6d 17h 59m,Buy
76106.2,130114,20.12.2010 09:05:00,,0.0,-208.77000000001863,0.0,0.0,130159,20.12.2010 03:40:00,5983,-0.12552688432076714,-12.34,IS,0.23,0.0,Phase3-EA-S4v1-GBPJPY-M5-194,GBPJPYMT4,1484,5h 25m,Buy
75968.96,1.2712,20.12.2010 12:44:57,sl 1.27120,0.0,-346.0100000000093,0.0,0.0,1.2751,20.12.2010 04:30:00,5984,-0.2080450124243231,-137.24,IS,0.34,0.0,Phase3-EA-S4v1-EURCHF-M15-221,EURCHFMT4,1470,8h 14m,Buy
75926.96,1.55268,20.12.2010 18:29:58,sl 1.55268,0.0,-388.0100000000093,0.0,0.0,1.55568,20.12.2010 16:30:00,5985,-0.2332983014096742,-42.0,IS,0.14,0.0,Phase3-EA-B1v1-GBPUSD-M30-14,GBPUSDMT4,384,1h 59m,Buy
75973.8,1.26757,21.12.2010 04:19:59,tp 1.26757,0.0,-341.1700000000128,0.0,0.0,1.26647,21.12.2010 00:50:00,5986,-0.20513487150315615,46.84,IS,0.41,0.0,Phase3-EA-SA2v2-EURCHF-M5-43,EURCHFMT4,3164,3h 29m,Buy
76115.16,1.26903,21.12.2010 04:29:58,tp 1.26903,0.0,-199.81000000002678,0.0,0.0,1.26503,21.12.2010 04:00:00,5987,-0.12013951600389713,141.36,IS,0.34,0.0,Phase3-EA-S4v1-EURCHF-M15-221,EURCHFMT4,1472,29m 58s,Buy
76256.53,1.26544,21.12.2010 11:29:58,tp 1.26544,0.0,-58.44000000003143,0.0,0.0,1.26944,21.12.2010 06:00:00,5988,-0.03513814781677886,141.37,IS,0.34,0.0,Phase3-EA-S4v1-EURCHF-M15-221,EURCHFMT4,1474,5h 29m,Sell
76303.47,1.25698,21.12.2010 21:54:58,tp 1.25698,0.0,-11.500000000029104,0.0,0.0,1.25588,21.12.2010 21:35:00,5989,-0.006914591031720777,46.94,IS,0.41,0.0,Phase3-EA-SA2v2-EURCHF-M5-43,EURCHFMT4,3166,19m 58s,Buy
76326.68,83834,22.12.2010 03:45:00,,-0.94,-0.0,0.0,0.0,83759,21.12.2010 23:30:00,5990,-0.0,23.21,IS,0.27,0.0,Phase3-EA-S1v2-USDJPY-M15-0,USDJPYMT4,1982,4h 15m,Buy
76373.81,1.25631,22.12.2010 04:09:58,tp 1.25631,0.0,-0.0,0.0,0.0,1.25521,22.12.2010 01:20:00,5991,-0.0,47.13,IS,0.41,0.0,Phase3-EA-SA2v2-EURCHF-M5-43,EURCHFMT4,3168,2h 49m,Buy
76322.49,1.25384,22.12.2010 10:15:00,,0.0,-51.320000000006985,0.0,0.0,1.25528,22.12.2010 01:30:00,5992,-0.03084620109379414,-51.32,IS,0.34,0.0,Phase3-EA-S4v1-EURCHF-M15-221,EURCHFMT4,1476,8h 45m,Buy
76369.87,1.24621,22.12.2010 20:49:58,tp 1.24621,0.0,-3.9400000000023283,0.0,0.0,1.24511,22.12.2010 20:05:00,5993,-0.002368161190756122,47.38,IS,0.41,0.0,Phase3-EA-SA2v2-EURCHF-M5-43,EURCHFMT4,3170,44m 58s,Buy
76311.32,0.95096,23.12.2010 04:30:00,,0.0,-62.48999999999069,0.0,0.0,0.95192,23.12.2010 00:15:00,5994,-0.03755999817518796,-58.55,IS,0.58,0.0,Phase3-EA-SA2v2-USDCHF-M15-107,USDCHFMT4,1206,4h 15m,Buy
76508.06,128242,23.12.2010 06:59:57,tp 128.242,-3.11,-0.0,0.0,0.0,130092,20.12.2010 04:00:00,5995,-0.0,196.74,IS,0.09,0.0,Phase3-EA-B1v1-GBPJPY-M30-1,GBPJPYMT4,642,3d 2h 59m,Sell
76641.9,109175,23.12.2010 06:59:58,tp 109.175,-2.27,-0.0,0.0,0.0,110435,17.12.2010 22:30:00,5996,-0.0,133.84,IS,0.09,0.0,Phase3-EA-TR1v1-EURJPY-M30-91,EURJPYMT4,877,5d 8h 29m,Sell
76649.04,1.24759,23.12.2010 12:30:00,,0.0,-0.0,0.0,0.0,1.24779,23.12.2010 03:45:00,5997,-0.0,7.14,IS,0.34,0.0,Phase3-EA-S4v1-EURCHF-M15-221,EURCHFMT4,1478,8h 45m,Sell
76587.01,128222,24.12.2010 05:30:00,,0.0,-62.029999999998836,0.0,0.0,127998,24.12.2010 00:05:00,5998,-0.03722193659201327,-62.03,IS,0.23,0.0,Phase3-EA-S4v1-GBPJPY-M5-194,GBPJPYMT4,1486,5h 25m,Sell
76530.9,1.25636,24.12.2010 08:40:00,,0.0,-118.13999999998487,0.0,0.0,1.25767,24.12.2010 00:20:00,5999,-0.0708914974847649,-56.11,IS,0.41,0.0,Phase3-EA-SA2v2-EURCHF-M5-43,EURCHFMT4,3172,8h 20m,Buy
76672.81,1.26054,24.12.2010 10:44:58,tp 1.26054,0.0,-0.0,0.0,0.0,1.25654,24.12.2010 03:00:00,6000,-0.0,141.91,IS,0.34,0.0,Phase3-EA-S4v1-EURCHF-M15-221,EURCHFMT4,1480,7h 44m,Buy
76717.56,1.26148,27.12.2010 02:00:00,tp 1.26148,-2.13,-0.0,0.0,0.0,1.26258,24.12.2010 22:25:00,6001,-0.0,44.75,IS,0.41,0.0,Phase3-EA-SA2v2-EURCHF-M5-43,EURCHFMT4,3174,2d 3h 35m,Sell
76696.19,127759,27.12.2010 07:35:00,,0.0,-21.369999999995343,0.0,0.0,127836,27.12.2010 02:10:00,6002,-0.012818085869296156,-21.37,IS,0.23,0.0,Phase3-EA-S4v1-GBPJPY-M5-194,GBPJPYMT4,1488,5h 25m,Buy
76742.17,1.26403,28.12.2010 00:19:58,tp 1.26403,-1.02,-0.0,0.0,0.0,1.26293,27.12.2010 22:50:00,6003,-0.0,45.98,IS,0.41,0.0,Phase3-EA-SA2v2-EURCHF-M5-43,EURCHFMT4,3176,1h 29m,Buy
76655.04,0.95986,28.12.2010 02:15:00,,-0.72,-87.13000000000466,0.0,0.0,0.96129,27.12.2010 22:00:00,6004,-0.05225432774444799,-87.13,IS,0.58,0.0,Phase3-EA-SA2v2-USDCHF-M15-107,USDCHFMT4,1208,4h 15m,Buy
76702.24,1.26321,28.12.2010 08:04:58,tp 1.26321,0.0,-39.929999999993015,0.0,0.0,1.26431,28.12.2010 02:55:00,6005,-0.023947151461440743,47.2,IS,0.41,0.0,Phase3-EA-SA2v2-EURCHF-M5-43,EURCHFMT4,3178,5h 9m,Sell
76714.51,127711,28.12.2010 08:30:00,,0.0,-27.660000000003492,0.0,0.0,127755,28.12.2010 03:05:00,6006,-0.016588485084489117,12.27,IS,0.23,0.0,Phase3-EA-S4v1-GBPJPY-M5-194,GBPJPYMT4,1490,5h 25m,Sell
76856.92,1.26118,28.12.2010 11:14:58,tp 1.26118,0.0,-0.0,0.0,0.0,1.26518,28.12.2010 04:15:00,6007,-0.0,142.41,IS,0.34,0.0,Phase3-EA-S4v1-EURCHF-M15-221,EURCHFMT4,1482,6h 59m,Sell
76814.92,1.54151,28.12.2010 12:59:58,sl 1.54151,0.0,-42.0,0.0,0.0,1.54451,28.12.2010 03:00:00,6008,-0.025171266495869628,-42.0,IS,0.14,0.0,Phase3-EA-B1v1-GBPUSD-M30-14,GBPUSDMT4,386,9h 59m,Buy
76772.92,1.54719,28.12.2010 15:59:58,sl 1.54719,0.0,-84.0,0.0,0.0,1.55019,28.12.2010 15:00:00,6009,-0.050342532991739256,-42.0,IS,0.14,0.0,Phase3-EA-B1v1-GBPUSD-M30-14,GBPUSDMT4,388,59m 58s,Buy
76685.68,107.96,28.12.2010 17:59:58,sl 107.960,-1.59,-171.2399999999907,0.0,0.0,108.74,23.12.2010 21:00:00,6010,-0.1026268493988686,-87.24,IS,0.09,0.0,Phase3-EA-TR1v1-EURJPY-M30-91,EURJPYMT4,880,4d 20h 59m,Buy
77035.59,107662,28.12.2010 19:14:58,tp 107.662,-2.16,-0.0,0.0,0.0,109362,23.12.2010 05:30:00,6011,-0.0,349.91,IS,0.17,0.0,Phase3-EA-T1v2-EURJPY-M15-322,EURJPYMT4,772,5d 13h 44m,Sell
77082.99,1.24713,28.12.2010 21:09:58,tp 1.24713,0.0,-0.0,0.0,0.0,1.24603,28.12.2010 20:40:00,6012,-0.0,47.4,IS,0.41,0.0,Phase3-EA-SA2v2-EURCHF-M5-43,EURCHFMT4,3180,29m 58s,Buy
77128.2,1.24772,29.12.2010 01:44:58,tp 1.24772,-2.15,-0.0,0.0,0.0,1.24882,28.12.2010 23:30:00,6013,-0.0,45.21,IS,0.41,0.0,Phase3-EA-SA2v2-EURCHF-M5-43,EURCHFMT4,3182,2h 14m,Sell
77237.15,126449,29.12.2010 02:44:58,tp 126.449,0.0,-0.0,0.0,0.0,126839,29.12.2010 00:15:00,6014,-0.0,108.95,IS,0.23,0.0,Phase3-EA-S4v1-GBPJPY-M5-194,GBPJPYMT4,1492,2h 29m,Sell
77165.15,82308,29.12.2010 04:00:00,,-1.47,-72.0,0.0,0.0,82093,28.12.2010 18:00:00,6015,-0.04305263513519573,-72.0,IS,0.27,0.0,Phase3-EA-S1v2-USDJPY-M15-0,USDJPYMT4,1984,10h 0m,Sell
77212.57,1.24884,29.12.2010 04:59:57,tp 1.24884,0.0,-24.579999999987194,0.0,0.0,1.24774,29.12.2010 02:15:00,6016,-0.01469769127253555,47.42,IS,0.41,0.0,Phase3-EA-SA2v2-EURCHF-M5-43,EURCHFMT4,3184,2h 44m,Buy
77284.14,126687,29.12.2010 08:25:00,,0.0,-0.0,0.0,0.0,126431,29.12.2010 03:00:00,6017,-0.0,71.57,IS,0.23,0.0,Phase3-EA-S4v1-GBPJPY-M5-194,GBPJPYMT4,1494,5h 25m,Buy
77427.09,1.25048,29.12.2010 11:29:58,tp 1.25048,0.0,-0.0,0.0,0.0,1.24648,29.12.2010 03:15:00,6018,-0.0,142.95,IS,0.34,0.0,Phase3-EA-S4v1-EURCHF-M15-221,EURCHFMT4,1484,8h 14m,Buy
77474.76,1.25149,29.12.2010 23:14:59,tp 1.25149,0.0,-0.0,0.0,0.0,1.25039,29.12.2010 22:55:00,6019,-0.0,47.67,IS,0.41,0.0,Phase3-EA-SA2v2-EURCHF-M5-43,EURCHFMT4,3186,19m 59s,Buy
77334.07,1.2448,30.12.2010 11:14:58,sl 1.24480,0.0,-140.69000000000233,0.0,0.0,1.2487,30.12.2010 02:30:00,6020,-0.08400668853026107,-140.69,IS,0.34,0.0,Phase3-EA-S4v1-EURCHF-M15-221,EURCHFMT4,1486,8h 44m,Buy
77283.98,108152,30.12.2010 15:14:57,sl 108.152,-2.19,-190.77999999999884,0.0,0.0,107922,29.12.2010 02:30:00,6021,-0.11391567302440005,-50.09,IS,0.17,0.0,Phase3-EA-T1v2-EURJPY-M15-322,EURJPYMT4,774,1d 12h 44m,Sell
77332.09,1.24403,30.12.2010 21:24:58,tp 1.24403,0.0,-142.6700000000128,0.0,0.0,1.24293,30.12.2010 21:10:00,6022,-0.08518895623436792,48.11,IS,0.41,0.0,Phase3-EA-SA2v2-EURCHF-M5-43,EURCHFMT4,3188,14m 58s,Buy
77380.34,1.24374,31.12.2010 04:19:57,tp 1.24374,0.0,-94.4200000000128,0.0,0.0,1.24264,31.12.2010 00:15:00,6023,-0.056378644758178935,48.25,IS,0.41,0.0,Phase3-EA-SA2v2-EURCHF-M5-43,EURCHFMT4,3190,4h 4m,Buy
77436.89,125846,31.12.2010 04:30:00,,-1.01,-37.87000000002445,0.0,0.0,125642,30.12.2010 23:05:00,6024,-0.022612362603191324,56.55,IS,0.23,0.0,Phase3-EA-S4v1-GBPJPY-M5-194,GBPJPYMT4,1496,5h 25m,Buy
77498.85,0.93606,31.12.2010 05:29:58,tp 0.93606,0.0,-0.0,0.0,0.0,0.93506,31.12.2010 01:15:00,6025,-0.0,61.96,IS,0.58,0.0,Phase3-EA-SA2v2-USDCHF-M15-107,USDCHFMT4,1210,4h 14m,Buy
77357.38,1.24816,31.12.2010 06:29:58,sl 1.24816,0.0,-141.47000000000116,0.0,0.0,1.24426,31.12.2010 05:30:00,6026,-0.08446028136909663,-141.47,IS,0.34,0.0,Phase3-EA-S4v1-EURCHF-M15-221,EURCHFMT4,1488,59m 58s,Sell
77405.66,1.2491,31.12.2010 23:14:59,tp 1.24910,0.0,-93.19000000000233,0.0,0.0,1248,31.12.2010 21:20:00,6027,-0.0556362028754241,48.28,IS,0.41,0.0,Phase3-EA-SA2v2-EURCHF-M5-43,EURCHFMT4,3192,1h 54m,Buy
77454.01,1.24632,03.01.2011 02:54:57,tp 1.24632,0.0,-44.83999999999651,0.0,0.0,1.24522,03.01.2011 02:10:00,6028,-0.02677033305004571,48.35,IS,0.41,0.0,Phase3-EA-SA2v2-EURCHF-M5-43,EURCHFMT4,3194,44m 57s,Buy
77515.32,0.93454,03.01.2011 03:29:57,tp 0.93454,-0.75,-0.0,0.0,0.0,0.93354,31.12.2010 23:15:00,6029,-0.0,61.31,IS,0.58,0.0,Phase3-EA-SA2v2-USDCHF-M15-107,USDCHFMT4,1212,2d 4h 14m,Buy
77466.21,108132,03.01.2011 04:29:58,sl 108.132,-1.03,-49.10999999998603,0.0,0.0,108362,31.12.2010 05:45:00,6030,-0.029316721598947493,-49.11,IS,0.17,0.0,Phase3-EA-T1v2-EURJPY-M15-322,EURJPYMT4,776,2d 22h 44m,Buy
77463.66,126239,03.01.2011 07:35:00,,0.0,-51.65999999997439,0.0,0.0,126248,03.01.2011 02:10:00,6031,-0.030838970429674355,-2.55,IS,0.23,0.0,Phase3-EA-S4v1-GBPJPY-M5-194,GBPJPYMT4,1498,5h 25m,Buy
77321.87,1.24195,03.01.2011 10:44:58,sl 1.24195,0.0,-193.44999999998254,0.0,0.0,1.24585,03.01.2011 02:45:00,6032,-0.1154819750217368,-141.79,IS,0.34,0.0,Phase3-EA-S4v1-EURCHF-M15-221,EURCHFMT4,1490,7h 59m,Buy
77384.05,0.93279,04.01.2011 01:14:57,tp 0.93279,0.0,-131.26999999998952,0.0,0.0,0.93379,04.01.2011 00:15:00,6033,-0.07836298196486714,62.18,IS,0.58,0.0,Phase3-EA-SA2v2-USDCHF-M15-107,USDCHFMT4,1214,59m 57s,Sell
77431.27,1.24798,04.01.2011 03:04:58,tp 1.24798,-1.05,-84.04999999998836,0.0,0.0,1.24688,03.01.2011 22:35:00,6034,-0.05017451538163096,47.22,IS,0.41,0.0,Phase3-EA-SA2v2-EURCHF-M5-43,EURCHFMT4,3196,4h 29m,Buy
77540.79,126832,04.01.2011 04:19:58,tp 126.832,0.0,-0.0,0.0,0.0,126442,04.01.2011 02:25:00,6035,-0.0,109.52,IS,0.23,0.0,Phase3-EA-S4v1-GBPJPY-M5-194,GBPJPYMT4,1500,1h 54m,Buy
77458.92,109358,04.01.2011 05:59:58,sl 109.358,-2.71,-81.86999999999534,0.0,0.0,108638,28.12.2010 15:30:00,6036,-0.04886571204540417,-81.87,IS,0.09,0.0,Phase3-EA-TR1v1-EURJPY-M30-91,EURJPYMT4,881,6d 14h 29m,Sell
77380.88,127133,04.01.2011 07:29:58,sl 127.133,-4.47,-159.9100000000035,0.0,0.0,126463,28.12.2010 17:30:00,6037,-0.09544541362136554,-78.04,IS,0.09,0.0,Phase3-EA-B1v1-GBPJPY-M30-1,GBPJPYMT4,644,6d 13h 59m,Sell
77525.97,1.25024,04.01.2011 08:44:58,tp 1.25024,0.0,-14.820000000006985,0.0,0.0,1.24624,04.01.2011 03:45:00,6038,-0.00884560709067146,145.09,IS,0.34,0.0,Phase3-EA-S4v1-EURCHF-M15-221,EURCHFMT4,1492,4h 59m,Buy
77573.54,1.26313,04.01.2011 21:39:58,tp 1.26313,0.0,-0.0,0.0,0.0,1.26203,04.01.2011 20:15:00,6039,-0.0,47.57,IS,0.41,0.0,Phase3-EA-SA2v2-EURCHF-M5-43,EURCHFMT4,3198,1h 24m,Buy
77621.06,1.26375,04.01.2011 22:44:59,tp 1.26375,0.0,-0.0,0.0,0.0,1.26485,04.01.2011 22:10:00,6040,-0.0,47.52,IS,0.41,0.0,Phase3-EA-SA2v2-EURCHF-M5-43,EURCHFMT4,3200,34m 59s,Sell
77668.54,1.26267,05.01.2011 08:39:58,tp 1.26267,0.0,-0.0,0.0,0.0,1.26157,05.01.2011 02:35:00,6041,-0.0,47.48,IS,0.41,0.0,Phase3-EA-SA2v2-EURCHF-M5-43,EURCHFMT4,3202,6h 4m,Buy
77629.57,127.58,05.01.2011 09:20:00,,0.0,-38.970000000001164,0.0,0.0,127719,05.01.2011 03:55:00,6042,-0.023242285046438136,-38.97,IS,0.23,0.0,Phase3-EA-S4v1-GBPJPY-M5-194,GBPJPYMT4,1502,5h 25m,Buy
77620.28,1.25906,05.01.2011 14:00:00,,0.0,-48.26000000000931,0.0,0.0,1.25932,05.01.2011 05:15:00,6043,-0.028782978607679945,-9.29,IS,0.34,0.0,Phase3-EA-S4v1-EURCHF-M15-221,EURCHFMT4,1494,8h 45m,Buy
77542.09,109621,05.01.2011 19:59:58,sl 109.621,-0.38,-126.45000000001164,0.0,0.0,109746,04.01.2011 12:00:00,6044,-0.07541665240241943,-78.19,IS,0.09,0.0,Phase3-EA-TR1v1-EURJPY-M30-91,EURJPYMT4,884,1d 7h 59m,Sell
77602.06,0.96722,05.01.2011 22:59:58,tp 0.96722,0.0,-66.48000000001048,0.0,0.0,0.96822,05.01.2011 22:45:00,6045,-0.03964965639947151,59.97,IS,0.58,0.0,Phase3-EA-SA2v2-USDCHF-M15-107,USDCHFMT4,1216,14m 58s,Sell
77801.53,129076,05.01.2011 23:29:57,tp 129.076,-0.39,-0.0,0.0,0.0,127226,04.01.2011 10:30:00,6046,-0.0,199.47,IS,0.09,0.0,Phase3-EA-B1v1-GBPJPY-M30-1,GBPJPYMT4,646,1d 12h 59m,Buy
77841.86,1.27004,06.01.2011 00:09:58,tp 1.27004,-6.37,-0.0,0.0,0.0,1.27114,05.01.2011 21:35:00,6047,-0.0,40.33,IS,0.41,0.0,Phase3-EA-SA2v2-EURCHF-M5-43,EURCHFMT4,3204,2h 34m,Sell
77845.27,83181,06.01.2011 03:00:00,,-4.38,-0.0,0.0,0.0,83205,05.01.2011 22:15:00,6048,-0.0,3.41,IS,0.27,0.0,Phase3-EA-S1v2-USDJPY-M15-0,USDJPYMT4,1986,4h 45m,Sell
77891.98,1.2712,06.01.2011 03:04:58,tp 1.27120,0.0,-0.0,0.0,0.0,1.2701,06.01.2011 00:10:00,6049,-0.0,46.71,IS,0.41,0.0,Phase3-EA-SA2v2-EURCHF-M5-43,EURCHFMT4,3206,2h 54m,Buy
77884.43,109566,06.01.2011 04:15:00,,0.0,-7.5499999999883585,0.0,0.0,109603,06.01.2011 03:30:00,6050,-0.004496939043775859,-7.55,IS,0.17,0.0,Phase3-EA-T1v2-EURJPY-M15-322,EURJPYMT4,778,45m 0s,Buy
77881.94,128993,06.01.2011 07:25:00,,0.0,-10.039999999979045,0.0,0.0,129002,06.01.2011 02:00:00,6051,-0.005980035496620531,-2.49,IS,0.23,0.0,Phase3-EA-S4v1-GBPJPY-M5-194,GBPJPYMT4,1504,5h 25m,Buy
77839.94,1.55176,06.01.2011 18:29:58,sl 1.55176,0.0,-52.039999999979045,0.0,0.0,1.55476,06.01.2011 17:30:00,6052,-0.030996120243491698,-42.0,IS,0.14,0.0,Phase3-EA-B1v1-GBPUSD-M30-14,GBPUSDMT4,390,59m 58s,Buy
77978.08,108456,06.01.2011 18:59:58,tp 108.456,-1.52,-0.0,0.0,0.0,108901,04.01.2011 21:00:00,6053,-0.0,138.14,IS,0.09,0.0,Phase3-EA-TR1v1-EURJPY-M30-91,EURJPYMT4,885,1d 21h 59m,Sell
78024.79,1.25533,07.01.2011 03:24:58,tp 1.25533,0.0,-0.0,0.0,0.0,1.25423,07.01.2011 01:50:00,6054,-0.0,46.71,IS,0.41,0.0,Phase3-EA-SA2v2-EURCHF-M5-43,EURCHFMT4,3208,1h 34m,Buy
77887.09,1.2505,07.01.2011 11:44:59,sl 1.25050,0.0,-137.70000000001164,0.0,0.0,1.2544,07.01.2011 03:15:00,6055,-0.08195219288773495,-137.7,IS,0.34,0.0,Phase3-EA-S4v1-EURCHF-M15-221,EURCHFMT4,1496,8h 29m,Buy
78023.43,107.61,07.01.2011 19:29:58,tp 107.610,-0.38,-1.360000000015134,0.0,0.0,108.87,06.01.2011 12:30:00,6056,-8.094043742087899E-4,136.34,IS,0.09,0.0,Phase3-EA-TR1v1-EURJPY-M30-91,EURJPYMT4,887,1d 6h 59m,Sell
78070.13,1.24856,07.01.2011 21:19:58,tp 1.24856,0.0,-0.0,0.0,0.0,1.24746,07.01.2011 20:10:00,6057,-0.0,46.7,IS,0.41,0.0,Phase3-EA-SA2v2-EURCHF-M5-43,EURCHFMT4,3210,1h 9m,Buy
78096.66,82947,10.01.2011 03:45:00,,-1.46,-0.0,0.0,0.0,83033,07.01.2011 23:00:00,6058,-0.0,26.53,IS,0.27,0.0,Phase3-EA-S1v2-USDJPY-M15-0,USDJPYMT4,1988,2d 4h 45m,Sell
78143.31,1.24778,10.01.2011 04:04:57,tp 1.24778,0.0,-0.0,0.0,0.0,1.24668,10.01.2011 02:30:00,6059,-0.0,46.65,IS,0.41,0.0,Phase3-EA-SA2v2-EURCHF-M5-43,EURCHFMT4,3212,1h 34m,Buy
78049.86,1.24417,10.01.2011 12:00:00,,0.0,-93.45000000001164,0.0,0.0,1.24682,10.01.2011 03:15:00,6060,-0.055577590330541014,-93.45,IS,0.34,0.0,Phase3-EA-S4v1-EURCHF-M15-221,EURCHFMT4,1498,8h 45m,Buy
78049.37,82722,11.01.2011 00:30:00,,-1.47,-93.94000000000233,0.0,0.0,82725,10.01.2011 23:15:00,6061,-0.05586900840717498,-0.49,IS,0.27,0.0,Phase3-EA-S1v2-USDJPY-M15-0,USDJPYMT4,1990,1h 15m,Sell
78050.02,82718,11.01.2011 00:45:00,,0.0,-93.29000000000815,0.0,0.0,82.72,11.01.2011 00:30:00,6062,-0.05548243340755461,0.65,IS,0.27,0.0,Phase3-EA-S1v2-USDJPY-M15-0,USDJPYMT4,1992,15m 0s,Sell
78085.83,0.96844,11.01.2011 04:00:00,,-0.72,-57.48000000001048,0.0,0.0,0.96783,10.01.2011 23:45:00,6063,-0.03418512458212608,35.81,IS,0.58,0.0,Phase3-EA-SA2v2-USDCHF-M15-107,USDCHFMT4,1218,4h 15m,Buy
78131.34,1.25409,11.01.2011 04:49:58,tp 1.25409,-1.02,-11.970000000001164,0.0,0.0,1.25299,10.01.2011 23:35:00,6064,-0.007118927300765733,45.51,IS,0.41,0.0,Phase3-EA-SA2v2-EURCHF-M5-43,EURCHFMT4,3214,5h 14m,Buy
78083.44,107395,11.01.2011 04:59:58,sl 107.395,-0.72,-59.86999999999534,0.0,0.0,107165,10.01.2011 16:15:00,6065,-0.03560653111919548,-47.9,IS,0.17,0.0,Phase3-EA-T1v2-EURJPY-M15-322,EURJPYMT4,780,12h 44m,Sell
78002.31,129171,11.01.2011 08:15:00,,0.0,-141.0,0.0,0.0,128878,11.01.2011 02:50:00,6066,-0.08385703837993908,-81.13,IS,0.23,0.0,Phase3-EA-S4v1-GBPJPY-M5-194,GBPJPYMT4,1506,5h 25m,Sell
77991.08,1.25434,11.01.2011 14:30:00,,0.0,-152.23000000001048,0.0,0.0,1.25402,11.01.2011 05:45:00,6067,-0.09053586491190783,-11.23,IS,0.34,0.0,Phase3-EA-S4v1-EURCHF-M15-221,EURCHFMT4,1500,8h 45m,Sell
78037.31,1.26482,11.01.2011 20:09:58,tp 1.26482,0.0,-106.0,0.0,0.0,1.26592,11.01.2011 20:00:00,6068,-0.06304146147711732,46.23,IS,0.41,0.0,Phase3-EA-SA2v2-EURCHF-M5-43,EURCHFMT4,3216,9m 58s,Sell
78083.52,1.26458,11.01.2011 21:14:58,tp 1.26458,0.0,-59.79000000000815,0.0,0.0,1.26568,11.01.2011 20:40:00,6069,-0.03555895265771093,46.21,IS,0.41,0.0,Phase3-EA-SA2v2-EURCHF-M5-43,EURCHFMT4,3218,34m 58s,Sell
78129.85,1.26385,11.01.2011 23:54:57,tp 1.26385,0.0,-13.460000000020955,0.0,0.0,1.26275,11.01.2011 23:00:00,6070,-0.008005076146069058,46.33,IS,0.41,0.0,Phase3-EA-SA2v2-EURCHF-M5-43,EURCHFMT4,3220,54m 57s,Buy
78146.4,83341,12.01.2011 01:45:00,,-0.94,-0.0,0.0,0.0,83287,11.01.2011 22:00:00,6071,-0.0,16.55,IS,0.27,0.0,Phase3-EA-S1v2-USDJPY-M15-0,USDJPYMT4,1994,3h 45m,Buy
78139.72,0.97351,12.01.2011 03:15:00,,-0.72,-6.679999999993015,0.0,0.0,0.97361,11.01.2011 23:00:00,6072,-0.003972728527041325,-6.68,IS,0.58,0.0,Phase3-EA-SA2v2-USDCHF-M15-107,USDCHFMT4,1220,4h 15m,Buy
78189.81,129926,12.01.2011 07:55:00,,0.0,-0.0,0.0,0.0,130107,12.01.2011 02:30:00,6073,-0.0,50.09,IS,0.23,0.0,Phase3-EA-S4v1-GBPJPY-M5-194,GBPJPYMT4,1508,5h 25m,Sell
77983.56,1.26811,12.01.2011 10:49:58,sl 1.26811,0.0,-206.25,0.0,0.0,1.26321,12.01.2011 02:35:00,6074,-0.12262930792299484,-206.25,IS,0.41,0.0,Phase3-EA-SA2v2-EURCHF-M5-43,EURCHFMT4,3222,8h 14m,Sell
77936.54,108005,12.01.2011 13:59:57,sl 108.005,0.0,-253.26999999998952,0.0,0.0,108235,12.01.2011 12:30:00,6075,-0.1505858172977242,-47.02,IS,0.17,0.0,Phase3-EA-T1v2-EURJPY-M15-322,EURJPYMT4,782,1h 29m,Buy
78076.32,1.26166,12.01.2011 13:59:58,tp 1.26166,0.0,-113.48999999999069,0.0,0.0,1.26566,12.01.2011 06:00:00,6076,-0.06747733409056747,139.78,IS,0.34,0.0,Phase3-EA-S4v1-EURCHF-M15-221,EURCHFMT4,1502,7h 59m,Sell
78034.32,1.55998,12.01.2011 14:29:58,sl 1.55998,0.0,-155.4899999999907,0.0,0.0,1.56298,12.01.2011 04:30:00,6077,-0.09244912043125006,-42.0,IS,0.14,0.0,Phase3-EA-B1v1-GBPUSD-M30-14,GBPUSDMT4,392,9h 59m,Buy
78172.42,108538,12.01.2011 16:59:58,tp 108.538,-1.06,-17.389999999984866,0.0,0.0,107248,10.01.2011 07:30:00,6078,-0.010339508677716481,138.1,IS,0.09,0.0,Phase3-EA-TR1v1-EURJPY-M30-91,EURJPYMT4,890,2d 9h 29m,Buy
78218.97,1.26938,12.01.2011 21:54:58,tp 1.26938,0.0,-0.0,0.0,0.0,1.27048,12.01.2011 20:40:00,6079,-0.0,46.55,IS,0.41,0.0,Phase3-EA-SA2v2-EURCHF-M5-43,EURCHFMT4,3224,1h 14m,Sell
78158.63,83098,13.01.2011 03:15:00,,-2.83,-60.33999999999651,0.0,0.0,83275,12.01.2011 19:00:00,6080,-0.03586991407687046,-60.34,IS,0.27,0.0,Phase3-EA-S1v2-USDJPY-M15-0,USDJPYMT4,1996,8h 15m,Buy
78202.21,1.27015,13.01.2011 03:49:58,tp 1.27015,-3.06,-16.760000000009313,0.0,0.0,1.26905,12.01.2011 23:35:00,6081,-0.009963204506607851,43.58,IS,0.41,0.0,Phase3-EA-SA2v2-EURCHF-M5-43,EURCHFMT4,3226,4h 14m,Buy
78321.68,108774,13.01.2011 07:00:00,,-3.01,-0.0,0.0,0.0,108176,12.01.2011 16:00:00,6082,-0.0,119.47,IS,0.17,0.0,Phase3-EA-T1v2-EURJPY-M15-322,EURJPYMT4,784,15h 0m,Buy
78457.04,110066,13.01.2011 17:29:58,tp 110.066,-1.59,-0.0,0.0,0.0,108806,12.01.2011 21:00:00,6083,-0.0,135.36,IS,0.09,0.0,Phase3-EA-TR1v1-EURJPY-M30-91,EURJPYMT4,892,20h 29m,Buy
78503.84,1.28615,13.01.2011 22:59:58,tp 1.28615,0.0,-0.0,0.0,0.0,1.28725,13.01.2011 21:55:00,6084,-0.0,46.8,IS,0.41,0.0,Phase3-EA-SA2v2-EURCHF-M5-43,EURCHFMT4,3228,1h 4m,Sell
78564.05,0.96328,14.01.2011 01:14:57,tp 0.96328,0.0,-0.0,0.0,0.0,0.96428,14.01.2011 00:15:00,6085,-0.0,60.21,IS,0.58,0.0,Phase3-EA-SA2v2-USDCHF-M15-107,USDCHFMT4,1222,59m 57s,Sell
78586.09,82688,14.01.2011 03:15:00,,-1.47,-0.0,0.0,0.0,82.76,13.01.2011 21:30:00,6086,-0.0,22.04,IS,0.27,0.0,Phase3-EA-S1v2-USDJPY-M15-0,USDJPYMT4,1998,5h 45m,Sell
78632.86,1.28615,14.01.2011 03:34:59,tp 1.28615,0.0,-0.0,0.0,0.0,1.28725,14.01.2011 00:05:00,6087,-0.0,46.77,IS,0.41,0.0,Phase3-EA-SA2v2-EURCHF-M5-43,EURCHFMT4,3230,3h 29m,Sell
78918.47,110418,14.01.2011 04:15:00,,-1.01,-0.0,0.0,0.0,109023,13.01.2011 11:30:00,6088,-0.0,285.61,IS,0.17,0.0,Phase3-EA-T1v2-EURJPY-M15-322,EURJPYMT4,786,16h 45m,Buy
78926.06,110533,14.01.2011 19:45:00,,0.0,-0.0,0.0,0.0,110496,14.01.2011 11:00:00,6089,-0.0,7.59,IS,0.17,0.0,Phase3-EA-T1v2-EURJPY-M15-322,EURJPYMT4,788,8h 45m,Buy
78970.63,82988,14.01.2011 20:00:00,,0.0,-0.0,0.0,0.0,82851,14.01.2011 17:15:00,6090,-0.0,44.57,IS,0.27,0.0,Phase3-EA-S1v2-USDJPY-M15-0,USDJPYMT4,2000,2h 45m,Buy
79027.62,0.9638,17.01.2011 02:00:00,tp 0.96380,-3.19,-0.0,0.0,0.0,0.9648,14.01.2011 23:00:00,6091,-0.0,56.99,IS,0.58,0.0,Phase3-EA-SA2v2-USDCHF-M15-107,USDCHFMT4,1224,2d 3h 0m,Sell
79072.31,1.28823,17.01.2011 02:00:00,tp 1.28823,-2.13,-0.0,0.0,0.0,1.28933,14.01.2011 22:40:00,6092,-0.0,44.69,IS,0.41,0.0,Phase3-EA-SA2v2-EURCHF-M5-43,EURCHFMT4,3232,2d 3h 20m,Sell
79024.17,110534,17.01.2011 05:44:58,sl 110.534,-1.0,-48.14000000001397,0.0,0.0,110764,14.01.2011 21:30:00,6093,-0.02847302435272457,-48.14,IS,0.17,0.0,Phase3-EA-T1v2-EURJPY-M15-322,EURJPYMT4,790,2d 8h 14m,Buy
78886.69,1.28329,17.01.2011 09:59:57,sl 1.28329,0.0,-185.62000000002445,0.0,0.0,1.28719,17.01.2011 04:30:00,6094,-0.10978734483489608,-137.48,IS,0.34,0.0,Phase3-EA-S4v1-EURCHF-M15-221,EURCHFMT4,1504,5h 29m,Buy
78869.54,82678,18.01.2011 01:15:00,,-1.47,-202.77000000001863,0.0,0.0,82.63,17.01.2011 18:15:00,6095,-0.11993093369341122,-17.15,IS,0.27,0.0,Phase3-EA-S1v2-USDJPY-M15-0,USDJPYMT4,2002,7h 0m,Sell
78861.74,131508,18.01.2011 08:45:00,,0.0,-210.57000000000698,0.0,0.0,131.48,18.01.2011 03:20:00,6096,-0.12454434436958188,-7.8,IS,0.23,0.0,Phase3-EA-S4v1-GBPJPY-M5-194,GBPJPYMT4,1510,5h 25m,Sell
78814.31,110058,18.01.2011 10:14:58,sl 110.058,0.0,-258.0,0.0,0.0,109828,18.01.2011 01:30:00,6097,-0.15259743005818047,-47.43,IS,0.17,0.0,Phase3-EA-T1v2-EURJPY-M15-322,EURJPYMT4,792,8h 44m,Sell
78675.73,1.27748,18.01.2011 10:44:57,sl 1.27748,0.0,-396.5799999999872,0.0,0.0,1.28138,18.01.2011 02:15:00,6098,-0.23456235973826067,-138.58,IS,0.34,0.0,Phase3-EA-S4v1-EURCHF-M15-221,EURCHFMT4,1506,8h 29m,Buy
78615.42,1.27958,18.01.2011 11:00:00,,0.0,-456.88999999998487,0.0,0.0,1.28099,18.01.2011 02:40:00,6099,-0.27023348767162697,-60.31,IS,0.41,0.0,Phase3-EA-SA2v2-EURCHF-M5-43,EURCHFMT4,3234,8h 20m,Buy
78662.18,1.28952,18.01.2011 20:19:59,tp 1.28952,0.0,-410.12999999997555,0.0,0.0,1.29062,18.01.2011 20:15:00,6100,-0.24257668213084427,46.76,IS,0.41,0.0,Phase3-EA-SA2v2-EURCHF-M5-43,EURCHFMT4,3236,4m 59s,Sell
78665.48,82606,19.01.2011 04:00:00,,-0.95,-406.8299999999872,0.0,0.0,82593,18.01.2011 23:15:00,6101,-0.24062485453708374,3.3,IS,0.27,0.0,Phase3-EA-S1v2-USDJPY-M15-0,USDJPYMT4,2004,4h 45m,Buy
78774.47,131628,19.01.2011 04:54:59,tp 131.628,0.0,-297.8399999999965,0.0,0.0,132018,19.01.2011 03:15:00,6102,-0.17616131228111603,108.99,IS,0.23,0.0,Phase3-EA-S4v1-GBPJPY-M5-194,GBPJPYMT4,1512,1h 39m,Sell
78762.69,110547,19.01.2011 07:30:00,,0.0,-309.61999999999534,0.0,0.0,110604,19.01.2011 07:15:00,6103,-0.18312874532795784,-11.78,IS,0.17,0.0,Phase3-EA-T1v2-EURJPY-M15-322,EURJPYMT4,794,15m 0s,Buy
78724.24,1.29045,19.01.2011 08:15:00,,-2.13,-348.070000000007,0.0,0.0,1.2896,18.01.2011 23:55:00,6104,-0.20587049410989122,-38.45,IS,0.41,0.0,Phase3-EA-SA2v2-EURCHF-M5-43,EURCHFMT4,3238,8h 20m,Sell
78513.22,1.28443,19.01.2011 21:59:58,sl 1.28443,0.0,-559.0899999999965,0.0,0.0,1.28933,19.01.2011 20:55:00,6105,-0.3306809967877038,-211.02,IS,0.41,0.0,Phase3-EA-SA2v2-EURCHF-M5-43,EURCHFMT4,3240,1h 4m,Buy
78560.45,1.28668,19.01.2011 23:54:58,tp 1.28668,0.0,-511.85999999998603,0.0,0.0,1.28558,19.01.2011 22:05:00,6106,-0.30274620368053534,47.23,IS,0.41,0.0,Phase3-EA-SA2v2-EURCHF-M5-43,EURCHFMT4,3242,1h 49m,Buy
78571.24,131097,20.01.2011 04:40:00,,-4.88,-501.0699999999779,0.0,0.0,131153,19.01.2011 23:15:00,6107,-0.29636431891181825,10.79,IS,0.23,0.0,Phase3-EA-S4v1-GBPJPY-M5-194,GBPJPYMT4,1514,5h 25m,Sell
78523.62,110665,20.01.2011 09:29:58,sl 110.665,0.0,-548.6899999999732,0.0,0.0,110435,20.01.2011 07:00:00,6108,-0.32452978255278664,-47.62,IS,0.17,0.0,Phase3-EA-T1v2-EURJPY-M15-322,EURJPYMT4,796,2h 29m,Sell
78665.97,1.28269,20.01.2011 10:44:58,tp 1.28269,0.0,-406.3399999999674,0.0,0.0,1.28669,20.01.2011 05:45:00,6109,-0.24033503771254291,142.35,IS,0.34,0.0,Phase3-EA-S4v1-EURCHF-M15-221,EURCHFMT4,1508,4h 59m,Sell
78618.35,110549,20.01.2011 11:44:58,sl 110.549,0.0,-453.95999999996275,0.0,0.0,110319,20.01.2011 11:00:00,6110,-0.2685005013535113,-47.62,IS,0.17,0.0,Phase3-EA-T1v2-EURJPY-M15-322,EURJPYMT4,798,44m 58s,Sell
78576.35,1.59638,20.01.2011 16:59:58,sl 1.59638,0.0,-495.95999999996275,0.0,0.0,1.59938,20.01.2011 13:00:00,6111,-0.2933419434560058,-42.0,IS,0.14,0.0,Phase3-EA-B1v1-GBPUSD-M30-14,GBPUSDMT4,394,3h 59m,Buy
78709.85,111406,20.01.2011 17:59:58,tp 111.406,-3.73,-362.45999999996275,0.0,0.0,110146,13.01.2011 17:30:00,6112,-0.21438164534450543,133.5,IS,0.09,0.0,Phase3-EA-TR1v1-EURJPY-M30-91,EURJPYMT4,894,7d 0h 29m,Buy
78731.63,83.06,21.01.2011 04:15:00,,0.0,-340.6799999999639,0.0,0.0,82993,21.01.2011 00:30:00,6113,-0.20149958322564113,21.78,IS,0.27,0.0,Phase3-EA-S1v2-USDJPY-M15-0,USDJPYMT4,2006,3h 45m,Buy
78613.37,1.30295,21.01.2011 04:55:00,,-2.12,-458.9399999999732,0.0,0.0,1.30021,20.01.2011 20:35:00,6114,-0.2714459866313847,-118.26,IS,0.41,0.0,Phase3-EA-SA2v2-EURCHF-M5-43,EURCHFMT4,3244,8h 20m,Sell
78550.56,1.30451,24.01.2011 07:05:00,,-2.14,-521.7499999999709,0.0,0.0,1.30309,21.01.2011 22:45:00,6115,-0.30859577183275666,-62.81,IS,0.41,0.0,Phase3-EA-SA2v2-EURCHF-M5-43,EURCHFMT4,3246,2d 8h 20m,Sell
78638.64,112409,24.01.2011 13:15:00,,-1.01,-433.6699999999837,0.0,0.0,111975,21.01.2011 10:15:00,6116,-0.25649971896639007,88.08,IS,0.17,0.0,Phase3-EA-T1v2-EURJPY-M15-322,EURJPYMT4,800,3d 3h 0m,Buy
78774.4,112.7,24.01.2011 16:59:57,tp 112.700,-1.06,-297.9099999999744,0.0,0.0,111.44,20.01.2011 18:00:00,6117,-0.1762027146846071,135.76,IS,0.09,0.0,Phase3-EA-TR1v1-EURJPY-M30-91,EURJPYMT4,896,3d 22h 59m,Buy
78726.96,112402,24.01.2011 21:14:57,sl 112.402,0.0,-345.3499999999767,0.0,0.0,112632,24.01.2011 16:30:00,6118,-0.2042617150022832,-47.44,IS,0.17,0.0,Phase3-EA-T1v2-EURJPY-M15-322,EURJPYMT4,802,4h 44m,Buy
78746.78,82438,25.01.2011 04:30:00,,-1.47,-325.52999999996973,0.0,0.0,82503,24.01.2011 23:00:00,6119,-0.1925389201815305,19.82,IS,0.27,0.0,Phase3-EA-S1v2-USDJPY-M15-0,USDJPYMT4,2008,5h 30m,Sell
78726.26,1.29532,25.01.2011 05:05:00,,-1.04,-346.04999999995925,0.0,0.0,1.29577,24.01.2011 20:45:00,6120,-0.20467573903731445,-20.52,IS,0.41,0.0,Phase3-EA-SA2v2-EURCHF-M5-43,EURCHFMT4,3248,8h 20m,Buy
78651.9,131394,25.01.2011 11:29:58,sl 131.394,-1.17,-420.4099999999453,0.0,0.0,132064,20.01.2011 23:00:00,6121,-0.2486569208168655,-74.36,IS,0.09,0.0,Phase3-EA-B1v1-GBPJPY-M30-1,GBPJPYMT4,648,4d 12h 29m,Buy
78604.48,112.4,25.01.2011 11:59:58,sl 112.400,0.0,-467.8299999999581,0.0,0.0,112.63,25.01.2011 02:15:00,6122,-0.27670409187640377,-47.42,IS,0.17,0.0,Phase3-EA-T1v2-EURJPY-M15-322,EURJPYMT4,804,9h 44m,Buy
78556.85,112188,25.01.2011 22:44:58,sl 112.188,0.0,-515.4599999999627,0.0,0.0,111958,25.01.2011 22:00:00,6123,-0.30487547014644967,-47.63,IS,0.17,0.0,Phase3-EA-T1v2-EURJPY-M15-322,EURJPYMT4,806,44m 58s,Sell
78553.03,0.94245,26.01.2011 02:45:00,,-0.74,-519.2799999999697,0.0,0.0,0.9425,25.01.2011 22:30:00,6124,-0.3071348584519664,-3.82,IS,0.58,0.0,Phase3-EA-SA2v2-USDCHF-M15-107,USDCHFMT4,1226,4h 15m,Buy
78598.72,1.28776,26.01.2011 03:29:58,tp 1.28776,-2.18,-473.5899999999674,0.0,0.0,1.28886,25.01.2011 23:55:00,6125,-0.2801109182218942,45.69,IS,0.41,0.0,Phase3-EA-SA2v2-EURCHF-M5-43,EURCHFMT4,3250,3h 34m,Sell
78633.24,82137,26.01.2011 04:30:00,,0.0,-439.0699999999779,0.0,0.0,82242,26.01.2011 01:00:00,6126,-0.25969361866527874,34.52,IS,0.27,0.0,Phase3-EA-S1v2-USDJPY-M15-0,USDJPYMT4,2010,3h 30m,Sell
78630.44,129809,26.01.2011 08:50:00,,0.0,-441.86999999996624,0.0,0.0,129819,26.01.2011 03:25:00,6127,-0.26134971480543817,-2.8,IS,0.23,0.0,Phase3-EA-S4v1-GBPJPY-M5-194,GBPJPYMT4,1516,5h 25m,Buy
78489.92,1.29329,26.01.2011 11:29:58,sl 1.29329,0.0,-582.3899999999558,0.0,0.0,1.28939,26.01.2011 05:45:00,6128,-0.3444620825254921,-140.52,IS,0.34,0.0,Phase3-EA-S4v1-EURCHF-M15-221,EURCHFMT4,1510,5h 44m,Sell
78415.9,130556,26.01.2011 18:29:58,sl 130.556,-0.63,-656.4099999999453,0.0,0.0,129886,25.01.2011 21:30:00,6129,-0.38824216691659647,-74.02,IS,0.09,0.0,Phase3-EA-B1v1-GBPJPY-M30-1,GBPJPYMT4,650,20h 59m,Sell
78463.65,1.29125,26.01.2011 20:39:58,tp 1.29125,0.0,-608.6599999999453,0.0,0.0,1.29235,26.01.2011 20:25:00,6130,-0.359999813097689,47.75,IS,0.41,0.0,Phase3-EA-SA2v2-EURCHF-M5-43,EURCHFMT4,3252,14m 58s,Sell
78525.08,0.94424,26.01.2011 22:29:57,tp 0.94424,0.0,-547.2299999999523,0.0,0.0,0.94524,26.01.2011 22:15:00,6131,-0.32366624670825894,61.43,IS,0.58,0.0,Phase3-EA-SA2v2-USDCHF-M15-107,USDCHFMT4,1228,14m 57s,Sell
78496.35,112452,27.01.2011 04:00:00,,-3.04,-575.9599999999627,0.0,0.0,112576,26.01.2011 19:00:00,6132,-0.34065897603218576,-28.73,IS,0.17,0.0,Phase3-EA-T1v2-EURJPY-M15-322,EURJPYMT4,808,9h 0m,Buy
78557.84,0.94329,27.01.2011 04:44:58,tp 0.94329,0.0,-514.4699999999721,0.0,0.0,0.94229,27.01.2011 01:15:00,6133,-0.30428992186832493,61.49,IS,0.58,0.0,Phase3-EA-SA2v2-USDCHF-M15-107,USDCHFMT4,1230,3h 29m,Buy
78773.44,113698,27.01.2011 22:45:00,,0.0,-298.86999999996624,0.0,0.0,112647,27.01.2011 09:30:00,6134,-0.17677051907551644,215.6,IS,0.17,0.0,Phase3-EA-T1v2-EURJPY-M15-322,EURJPYMT4,810,13h 15m,Buy
78818.98,1.29746,28.01.2011 04:24:58,tp 1.29746,-2.17,-253.3299999999581,0.0,0.0,1.29856,27.01.2011 23:55:00,6135,-0.14983529828152117,45.54,IS,0.41,0.0,Phase3-EA-SA2v2-EURCHF-M5-43,EURCHFMT4,3254,4h 29m,Sell
78683.96,131287,28.01.2011 08:50:00,,0.0,-388.3499999999476,0.0,0.0,131772,28.01.2011 03:25:00,6136,-0.22969462001196275,-135.02,IS,0.23,0.0,Phase3-EA-S4v1-GBPJPY-M5-194,GBPJPYMT4,1518,5h 25m,Buy
78605.08,113161,28.01.2011 11:29:58,sl 113.161,-0.53,-467.22999999995227,0.0,0.0,113881,27.01.2011 15:30:00,6137,-0.27634921413207897,-78.88,IS,0.09,0.0,Phase3-EA-TR1v1-EURJPY-M30-91,EURJPYMT4,898,19h 59m,Buy
78586.01,1.29604,28.01.2011 14:15:00,,0.0,-486.29999999995925,0.0,0.0,1.29657,28.01.2011 05:30:00,6138,-0.28762841177243,-19.07,IS,0.34,0.0,Phase3-EA-S4v1-EURCHF-M15-221,EURCHFMT4,1512,8h 45m,Buy
78723.99,111776,28.01.2011 19:59:58,tp 111.776,0.0,-348.3199999999488,0.0,0.0,113036,28.01.2011 11:30:00,6139,-0.20601835983665737,137.98,IS,0.09,0.0,Phase3-EA-TR1v1-EURJPY-M30-91,EURJPYMT4,900,8h 29m,Sell
78449.84,82024,28.01.2011 19:59:58,sl 82.024,-0.94,-622.469999999943,0.0,0.0,82854,27.01.2011 17:00:00,6140,-0.3681679158461507,-274.15,IS,0.27,0.0,Phase3-EA-S1v2-USDJPY-M15-0,USDJPYMT4,2012,1d 2h 59m,Buy
78279.86,1.27865,31.01.2011 04:30:00,,-1.04,-792.4499999999534,0.0,0.0,1.28253,28.01.2011 20:10:00,6141,-0.46870478081239536,-169.98,IS,0.41,0.0,Phase3-EA-SA2v2-EURCHF-M5-43,EURCHFMT4,3256,2d 8h 20m,Buy
78424.25,1.28314,31.01.2011 11:44:57,tp 1.28314,0.0,-648.0599999999395,0.0,0.0,1.27914,31.01.2011 03:15:00,6142,-0.38330345164145424,144.39,IS,0.34,0.0,Phase3-EA-S4v1-EURCHF-M15-221,EURCHFMT4,1514,8h 29m,Buy
78350.1,131246,31.01.2011 18:59:58,sl 131.246,-0.64,-722.2099999999336,0.0,0.0,130576,28.01.2011 18:00:00,6143,-0.4271604262104976,-74.15,IS,0.09,0.0,Phase3-EA-B1v1-GBPJPY-M30-1,GBPJPYMT4,652,3d 0h 59m,Sell
78459.57,131449,01.02.2011 05:54:59,tp 131.449,0.0,-612.7399999999325,0.0,0.0,131839,01.02.2011 03:20:00,6144,-0.3624129817590666,109.47,IS,0.23,0.0,Phase3-EA-S4v1-GBPJPY-M5-194,GBPJPYMT4,1520,2h 34m,Sell
78417.79,1.29266,01.02.2011 07:20:00,,-2.17,-654.5199999999313,0.0,0.0,1.29175,31.01.2011 23:00:00,6145,-0.38712430202197595,-41.78,IS,0.41,0.0,Phase3-EA-SA2v2-EURCHF-M5-43,EURCHFMT4,3258,8h 20m,Sell
78389.25,1.29301,01.02.2011 10:00:00,,0.0,-683.0599999999395,0.0,0.0,1.29222,01.02.2011 01:15:00,6146,-0.404004653393533,-28.54,IS,0.34,0.0,Phase3-EA-S4v1-EURCHF-M15-221,EURCHFMT4,1516,8h 45m,Sell
78433.65,81492,01.02.2011 19:00:00,,0.0,-638.6599999999453,0.0,0.0,81626,01.02.2011 17:45:00,6147,-0.37774370031375654,44.4,IS,0.27,0.0,Phase3-EA-S1v2-USDJPY-M15-0,USDJPYMT4,2014,1h 15m,Sell
78481.92,1.29322,01.02.2011 20:44:57,tp 1.29322,0.0,-590.3899999999558,0.0,0.0,1.29212,01.02.2011 20:40:00,6148,-0.3491937857831101,48.27,IS,0.41,0.0,Phase3-EA-SA2v2-EURCHF-M5-43,EURCHFMT4,3260,4m 57s,Buy
78530.14,1.29324,01.02.2011 23:59:57,tp 1.29324,0.0,-542.1699999999546,0.0,0.0,1.29434,01.02.2011 23:30:00,6149,-0.3206734443978169,48.22,IS,0.41,0.0,Phase3-EA-SA2v2-EURCHF-M5-43,EURCHFMT4,3262,29m 57s,Sell
78578.37,1.29425,02.02.2011 03:19:58,tp 1.29425,0.0,-493.9399999999441,0.0,0.0,1.29315,02.02.2011 01:55:00,6150,-0.2921471883834462,48.23,IS,0.41,0.0,Phase3-EA-SA2v2-EURCHF-M5-43,EURCHFMT4,3264,1h 24m,Buy
78719.69,112898,02.02.2011 10:29:57,tp 112.898,-1.08,-352.61999999993714,0.0,0.0,111608,31.01.2011 08:00:00,6151,-0.20856165033762017,141.32,IS,0.09,0.0,Phase3-EA-TR1v1-EURJPY-M30-91,EURJPYMT4,902,2d 2h 29m,Buy
78709.08,81412,02.02.2011 11:15:00,,0.0,-363.22999999992317,0.0,0.0,81.38,02.02.2011 01:15:00,6152,-0.21483707178302777,-10.61,IS,0.27,0.0,Phase3-EA-S1v2-USDJPY-M15-0,USDJPYMT4,2016,10h 0m,Sell
78854.48,1.29111,02.02.2011 12:59:58,tp 1.29111,0.0,-217.829999999929,0.0,0.0,1.29511,02.02.2011 06:30:00,6153,-0.12883836507582408,145.4,IS,0.34,0.0,Phase3-EA-S4v1-EURCHF-M15-221,EURCHFMT4,1518,6h 29m,Sell
78812.48,1.61394,02.02.2011 22:29:57,sl 1.61394,0.0,-259.829999999929,0.0,0.0,1.61694,02.02.2011 11:00:00,6154,-0.15367980717831858,-42.0,IS,0.14,0.0,Phase3-EA-B1v1-GBPUSD-M30-14,GBPUSDMT4,396,11h 29m,Buy
78874.03,0.94233,02.02.2011 22:29:58,tp 0.94233,0.0,-198.27999999994063,0.0,0.0,0.94333,02.02.2011 22:15:00,6155,-0.11727526524002699,61.55,IS,0.58,0.0,Phase3-EA-SA2v2-USDCHF-M15-107,USDCHFMT4,1232,14m 58s,Sell
78921.92,1.29851,02.02.2011 22:59:57,tp 1.29851,0.0,-150.38999999992666,0.0,0.0,1.29961,02.02.2011 20:20:00,6156,-0.08895010661410298,47.89,IS,0.41,0.0,Phase3-EA-SA2v2-EURCHF-M5-43,EURCHFMT4,3266,2h 39m,Sell
78887.61,0.93997,03.02.2011 03:45:00,,-2.22,-184.69999999992433,0.0,0.0,0.94049,02.02.2011 23:30:00,6157,-0.10924319896021079,-34.31,IS,0.58,0.0,Phase3-EA-SA2v2-USDCHF-M15-107,USDCHFMT4,1234,4h 15m,Buy
78903.58,81637,03.02.2011 04:30:00,,-2.88,-168.72999999992317,0.0,0.0,81.58,02.02.2011 23:15:00,6158,-0.09979753633219017,15.97,IS,0.27,0.0,Phase3-EA-S1v2-USDJPY-M15-0,USDJPYMT4,2018,5h 15m,Buy
78849.86,1.29715,03.02.2011 08:00:00,,-3.14,-222.44999999992433,0.0,0.0,1.29831,02.02.2011 23:40:00,6159,-0.13157092370709572,-53.72,IS,0.41,0.0,Phase3-EA-SA2v2-EURCHF-M5-43,EURCHFMT4,3268,8h 20m,Buy
78767.85,111827,03.02.2011 16:59:58,sl 111.827,-2.7,-304.45999999993364,0.0,0.0,112547,31.01.2011 16:30:00,6160,-0.18007679672675775,-82.01,IS,0.09,0.0,Phase3-EA-TR1v1-EURJPY-M30-91,EURJPYMT4,903,3d 0h 29m,Buy
79116.63,111119,03.02.2011 19:14:58,tp 111.119,-4.37,-0.0,0.0,0.0,112819,28.01.2011 15:00:00,6161,-0.0,348.78,IS,0.17,0.0,Phase3-EA-T1v2-EURJPY-M15-322,EURJPYMT4,812,6d 4h 14m,Sell
79164.33,1.28938,03.02.2011 23:24:57,tp 1.28938,0.0,-0.0,0.0,0.0,1.28828,03.02.2011 20:00:00,6162,-0.0,47.7,IS,0.41,0.0,Phase3-EA-SA2v2-EURCHF-M5-43,EURCHFMT4,3270,3h 24m,Buy
79212.04,1.28854,03.02.2011 23:54:58,tp 1.28854,0.0,-0.0,0.0,0.0,1.28964,03.02.2011 23:40:00,6163,-0.0,47.71,IS,0.41,0.0,Phase3-EA-SA2v2-EURCHF-M5-43,EURCHFMT4,3272,14m 58s,Sell
79233.23,81562,04.02.2011 04:15:00,,0.0,-0.0,0.0,0.0,81626,04.02.2011 00:30:00,6164,-0.0,21.19,IS,0.27,0.0,Phase3-EA-S1v2-USDJPY-M15-0,USDJPYMT4,2020,3h 45m,Sell
79280.93,1.28974,04.02.2011 05:34:58,tp 1.28974,0.0,-0.0,0.0,0.0,1.28864,04.02.2011 01:30:00,6165,-0.0,47.7,IS,0.41,0.0,Phase3-EA-SA2v2-EURCHF-M5-43,EURCHFMT4,3274,4h 4m,Buy
79233.05,111368,04.02.2011 16:14:58,sl 111.368,0.0,-47.88000000000466,0.0,0.0,111138,04.02.2011 11:15:00,6166,-0.0282843436647026,-47.88,IS,0.17,0.0,Phase3-EA-T1v2-EURJPY-M15-322,EURJPYMT4,814,4h 59m,Sell
79157.23,130874,04.02.2011 16:59:57,sl 130.874,-1.99,-123.70000000001164,0.0,0.0,131544,01.02.2011 03:00:00,6167,-0.07307379514042817,-75.82,IS,0.09,0.0,Phase3-EA-B1v1-GBPJPY-M30-1,GBPJPYMT4,654,3d 13h 59m,Buy
79109.53,111326,04.02.2011 19:44:57,sl 111.326,0.0,-171.40000000002328,0.0,0.0,111096,04.02.2011 17:15:00,6168,-0.10125180668609467,-47.7,IS,0.17,0.0,Phase3-EA-T1v2-EURJPY-M15-322,EURJPYMT4,816,2h 29m,Sell
79030.39,111904,04.02.2011 20:59:58,sl 111.904,-0.39,-250.54000000003725,0.0,0.0,111184,03.02.2011 21:30:00,6169,-0.14800249502412183,-79.14,IS,0.09,0.0,Phase3-EA-TR1v1-EURJPY-M30-91,EURJPYMT4,906,23h 29m,Sell
79077.52,1.29863,04.02.2011 22:49:58,tp 1.29863,0.0,-203.4100000000326,0.0,0.0,1.29973,04.02.2011 21:00:00,6170,-0.12016120185542017,47.13,IS,0.41,0.0,Phase3-EA-SA2v2-EURCHF-M5-43,EURCHFMT4,3276,1h 49m,Sell
79124.85,1.29741,07.02.2011 05:19:58,tp 1.29741,0.0,-156.0800000000454,0.0,0.0,1.29631,07.02.2011 02:35:00,6171,-0.09220176188779525,47.33,IS,0.41,0.0,Phase3-EA-SA2v2-EURCHF-M5-43,EURCHFMT4,3278,2h 44m,Buy
78986.11,1.3021,07.02.2011 10:29:58,sl 1.30210,0.0,-294.8200000000361,0.0,0.0,1.2982,07.02.2011 06:15:00,6172,-0.1741601963080165,-138.74,IS,0.34,0.0,Phase3-EA-S4v1-EURCHF-M15-221,EURCHFMT4,1520,4h 14m,Sell
79002.98,0.95542,08.02.2011 03:15:00,,-0.73,-277.95000000004075,0.0,0.0,0.95513,07.02.2011 23:00:00,6173,-0.16419451381797148,16.87,IS,0.58,0.0,Phase3-EA-SA2v2-USDCHF-M15-107,USDCHFMT4,1236,4h 15m,Buy
78863.96,1.30213,08.02.2011 13:44:58,sl 1.30213,0.0,-416.97000000003027,0.0,0.0,1.29823,08.02.2011 05:00:00,6174,-0.24631835375669908,-139.02,IS,0.34,0.0,Phase3-EA-S4v1-EURCHF-M15-221,EURCHFMT4,1522,8h 44m,Sell
78816.36,111846,08.02.2011 17:44:58,sl 111.846,0.0,-464.5700000000361,0.0,0.0,112076,08.02.2011 14:45:00,6175,-0.27443729190289534,-47.6,IS,0.17,0.0,Phase3-EA-T1v2-EURJPY-M15-322,EURJPYMT4,818,2h 59m,Buy
78712.21,0.9651,09.02.2011 03:15:00,,-3.19,-568.7200000000303,0.0,0.0,0.96342,08.02.2011 23:00:00,6176,-0.33596223744755543,-104.15,IS,0.58,0.0,Phase3-EA-SA2v2-USDCHF-M15-107,USDCHFMT4,1238,4h 15m,Sell
78701.93,132274,09.02.2011 04:30:00,,-1.62,-579.0000000000291,0.0,0.0,132243,08.02.2011 23:05:00,6177,-0.3420349829127409,-10.28,IS,0.23,0.0,Phase3-EA-S4v1-GBPJPY-M5-194,GBPJPYMT4,1522,5h 25m,Sell
78549.58,1.31449,09.02.2011 06:20:00,,-2.13,-731.3500000000349,0.0,0.0,1.31096,08.02.2011 22:00:00,6178,-0.43203330700040143,-152.35,IS,0.41,0.0,Phase3-EA-SA2v2-EURCHF-M5-43,EURCHFMT4,3280,8h 20m,Sell
78463.81,112675,09.02.2011 12:29:57,sl 112.675,-0.76,-817.1200000000244,0.0,0.0,111895,07.02.2011 13:30:00,6179,-0.48270056172306247,-85.77,IS,0.09,0.0,Phase3-EA-TR1v1-EURJPY-M30-91,EURJPYMT4,908,1d 22h 59m,Sell
78410.54,1.31551,09.02.2011 12:45:00,,0.0,-870.390000000014,0.0,0.0,1314,09.02.2011 04:00:00,6180,-0.5141689616190162,-53.27,IS,0.34,0.0,Phase3-EA-S4v1-EURCHF-M15-221,EURCHFMT4,1524,8h 45m,Sell
78457.58,1.31587,09.02.2011 20:19:58,tp 1.31587,0.0,-823.3500000000058,0.0,0.0,1.31477,09.02.2011 20:10:00,6181,-0.4863808345098326,47.04,IS,0.41,0.0,Phase3-EA-SA2v2-EURCHF-M5-43,EURCHFMT4,3282,9m 58s,Buy
78504.6,1.31391,10.02.2011 08:04:59,tp 1.31391,0.0,-776.3300000000163,0.0,0.0,1.31501,10.02.2011 00:05:00,6182,-0.45860452208055336,47.02,IS,0.41,0.0,Phase3-EA-SA2v2-EURCHF-M5-43,EURCHFMT4,3284,7h 59m,Sell
78711.99,113069,10.02.2011 10:15:00,,-4.04,-568.9400000000023,0.0,0.0,112041,08.02.2011 19:45:00,6183,-0.3360921989263659,207.39,IS,0.17,0.0,Phase3-EA-T1v2-EURJPY-M15-322,EURJPYMT4,820,1d 14h 30m,Buy
78853.17,1.31136,10.02.2011 12:29:58,tp 1.31136,0.0,-427.7600000000093,0.0,0.0,1.31536,10.02.2011 05:30:00,6184,-0.2526923735591535,141.18,IS,0.34,0.0,Phase3-EA-S4v1-EURCHF-M15-221,EURCHFMT4,1526,6h 59m,Sell
78909.86,0.96887,11.02.2011 00:59:58,tp 0.96887,-3.17,-371.070000000007,0.0,0.0,0.96987,10.02.2011 22:30:00,6185,-0.21920366340142794,56.69,IS,0.58,0.0,Phase3-EA-SA2v2-USDCHF-M15-107,USDCHFMT4,1240,2h 29m,Sell
79043.17,113398,11.02.2011 02:59:58,tp 113.398,-2.68,-237.7600000000093,0.0,0.0,112138,08.02.2011 10:30:00,6186,-0.14045291457224934,133.31,IS,0.09,0.0,Phase3-EA-TR1v1-EURJPY-M30-91,EURJPYMT4,909,2d 16h 29m,Buy
79087.63,1.3163,11.02.2011 04:24:57,tp 1.31630,-2.11,-193.30000000001746,0.0,0.0,1.3174,10.02.2011 20:20:00,6187,-0.11418888116931859,44.46,IS,0.41,0.0,Phase3-EA-SA2v2-EURCHF-M5-43,EURCHFMT4,3286,8h 4m,Sell
79091.09,113328,11.02.2011 07:45:00,,0.0,-189.8400000000256,0.0,0.0,113311,11.02.2011 07:00:00,6188,-0.11214494154777242,3.46,IS,0.17,0.0,Phase3-EA-T1v2-EURJPY-M15-322,EURJPYMT4,822,45m 0s,Buy
79118.93,134015,11.02.2011 07:55:00,,0.0,-162.0000000000291,0.0,0.0,134116,11.02.2011 02:30:00,6189,-0.09569890713621969,27.84,IS,0.23,0.0,Phase3-EA-S4v1-GBPJPY-M5-194,GBPJPYMT4,1524,5h 25m,Sell
79046.75,133519,11.02.2011 13:29:59,sl 133.519,0.0,-234.18000000002212,0.0,0.0,134189,11.02.2011 03:30:00,6190,-0.13833808687134577,-72.18,IS,0.09,0.0,Phase3-EA-B1v1-GBPJPY-M30-1,GBPJPYMT4,656,9h 59m,Buy
79305.84,1.59843,11.02.2011 13:59:58,tp 1.59843,-5.51,-0.0,0.0,0.0,1.61733,03.02.2011 17:00:00,6191,-0.0,259.09,IS,0.14,0.0,Phase3-EA-B1v1-GBPUSD-M30-14,GBPUSDMT4,398,7d 20h 59m,Sell
79322.25,1.3161,11.02.2011 14:00:00,,0.0,-0.0,0.0,0.0,1.31563,11.02.2011 05:15:00,6192,-0.0,16.41,IS,0.34,0.0,Phase3-EA-S4v1-EURCHF-M15-221,EURCHFMT4,1528,8h 45m,Buy
79368.6,1.31759,11.02.2011 22:39:59,tp 1.31759,0.0,-0.0,0.0,0.0,1.31649,11.02.2011 22:30:00,6193,-0.0,46.35,IS,0.41,0.0,Phase3-EA-SA2v2-EURCHF-M5-43,EURCHFMT4,3288,9m 59s,Buy
79193.45,1.31925,14.02.2011 10:25:00,,0.0,-175.14999999999418,0.0,0.0,1.31509,14.02.2011 02:05:00,6194,-0.10341350167622224,-175.15,IS,0.41,0.0,Phase3-EA-SA2v2-EURCHF-M5-43,EURCHFMT4,3290,8h 20m,Sell
79333.18,1.31965,14.02.2011 10:29:58,tp 1.31965,0.0,-35.4199999999837,0.0,0.0,1.31565,14.02.2011 03:00:00,6195,-0.020912967338682434,139.73,IS,0.34,0.0,Phase3-EA-S4v1-EURCHF-M15-221,EURCHFMT4,1530,7h 29m,Buy
79379.67,1.30756,14.02.2011 22:04:57,tp 1.30756,0.0,-0.0,0.0,0.0,1.30866,14.02.2011 21:15:00,6196,-0.0,46.49,IS,0.41,0.0,Phase3-EA-SA2v2-EURCHF-M5-43,EURCHFMT4,3292,49m 57s,Sell
79426.16,1.30784,14.02.2011 22:39:58,tp 1.30784,0.0,-0.0,0.0,0.0,1.30674,14.02.2011 22:20:00,6197,-0.0,46.49,IS,0.41,0.0,Phase3-EA-SA2v2-EURCHF-M5-43,EURCHFMT4,3294,19m 58s,Buy
79423.28,83334,15.02.2011 02:45:00,,-0.94,-2.8800000000046566,0.0,0.0,83.34,14.02.2011 17:45:00,6198,-0.001699855559498401,-2.88,IS,0.27,0.0,Phase3-EA-S1v2-USDJPY-M15-0,USDJPYMT4,2022,9h 0m,Buy
79351.89,133901,15.02.2011 08:40:00,,0.0,-74.27000000001863,0.0,0.0,133642,15.02.2011 03:15:00,6199,-0.04383620569575478,-71.39,IS,0.23,0.0,Phase3-EA-S4v1-GBPJPY-M5-194,GBPJPYMT4,1526,5h 25m,Sell
79304.37,113037,15.02.2011 12:14:58,sl 113.037,-0.71,-121.79000000000815,0.0,0.0,112807,14.02.2011 02:15:00,6200,-0.07188382242742687,-47.52,IS,0.17,0.0,Phase3-EA-T1v2-EURJPY-M15-322,EURJPYMT4,824,1d 9h 59m,Sell
79246.09,1.31062,15.02.2011 12:45:00,,0.0,-180.07000000000698,0.0,0.0,1.30896,15.02.2011 04:00:00,6201,-0.10628228840222015,-58.28,IS,0.34,0.0,Phase3-EA-S4v1-EURCHF-M15-221,EURCHFMT4,1532,8h 45m,Sell
79292.78,1.30543,15.02.2011 20:49:57,tp 1.30543,0.0,-133.38000000000466,0.0,0.0,1.30433,15.02.2011 20:35:00,6202,-0.07872456059914516,46.69,IS,0.41,0.0,Phase3-EA-SA2v2-EURCHF-M5-43,EURCHFMT4,3296,14m 57s,Buy
79305.35,83795,15.02.2011 21:30:00,,0.0,-120.80999999999767,0.0,0.0,83756,15.02.2011 20:30:00,6203,-0.07130539935509231,12.57,IS,0.27,0.0,Phase3-EA-S1v2-USDJPY-M15-0,USDJPYMT4,2024,1h 0m,Buy
79351.0,1.3054,16.02.2011 04:04:57,tp 1.30540,-1.02,-75.16000000000349,0.0,0.0,1.3043,15.02.2011 22:20:00,6204,-0.04436150828184,45.65,IS,0.41,0.0,Phase3-EA-SA2v2-EURCHF-M5-43,EURCHFMT4,3298,5h 44m,Buy
79309.0,1.61285,16.02.2011 13:29:58,sl 1.61285,0.0,-117.16000000000349,0.0,0.0,1.61585,16.02.2011 08:00:00,6205,-0.06915106852448492,-42.0,IS,0.14,0.0,Phase3-EA-B1v1-GBPUSD-M30-14,GBPUSDMT4,400,5h 29m,Buy
79329.5,113.25,16.02.2011 15:00:00,,0.0,-96.66000000000349,0.0,0.0,113149,16.02.2011 04:15:00,6206,-0.0570514022155749,20.5,IS,0.17,0.0,Phase3-EA-T1v2-EURJPY-M15-322,EURJPYMT4,826,10h 45m,Buy
79376.56,1.30237,16.02.2011 20:24:58,tp 1.30237,0.0,-49.60000000000582,0.0,0.0,1.30127,16.02.2011 20:10:00,6207,-0.029275290191317454,47.06,IS,0.41,0.0,Phase3-EA-SA2v2-EURCHF-M5-43,EURCHFMT4,3300,14m 58s,Buy
79398.52,83601,17.02.2011 03:00:00,,0.0,-27.64000000001397,0.0,0.0,83669,17.02.2011 01:00:00,6208,-0.01631389155016791,21.96,IS,0.27,0.0,Phase3-EA-S1v2-USDJPY-M15-0,USDJPYMT4,2026,2h 0m,Sell
79388.41,113344,17.02.2011 10:00:00,,-2.99,-37.75,0.0,0.0,113379,16.02.2011 19:30:00,6209,-0.022281092837139197,-10.11,IS,0.17,0.0,Phase3-EA-T1v2-EURJPY-M15-322,EURJPYMT4,828,14h 30m,Buy
79530.2,1.29853,17.02.2011 10:59:58,tp 1.29853,0.0,-0.0,0.0,0.0,1.30253,17.02.2011 06:30:00,6210,-0.0,141.79,IS,0.34,0.0,Phase3-EA-S4v1-EURCHF-M15-221,EURCHFMT4,1534,4h 29m,Sell
79576.69,1.29286,18.02.2011 02:39:58,tp 1.29286,-1.04,-0.0,0.0,0.0,1.29176,17.02.2011 23:05:00,6211,-0.0,46.49,IS,0.41,0.0,Phase3-EA-SA2v2-EURCHF-M5-43,EURCHFMT4,3302,3h 34m,Buy
79612.51,83279,18.02.2011 03:00:00,,-1.46,-0.0,0.0,0.0,83394,17.02.2011 22:00:00,6212,-0.0,35.82,IS,0.27,0.0,Phase3-EA-S1v2-USDJPY-M15-0,USDJPYMT4,2028,5h 0m,Sell
79614.83,0.94985,18.02.2011 03:30:00,,-0.73,-0.0,0.0,0.0,0.9498,17.02.2011 23:15:00,6213,-0.0,2.32,IS,0.58,0.0,Phase3-EA-SA2v2-USDCHF-M15-107,USDCHFMT4,1242,4h 15m,Buy
79626.98,134678,18.02.2011 08:50:00,,0.0,-0.0,0.0,0.0,134634,18.02.2011 03:25:00,6214,-0.0,12.15,IS,0.23,0.0,Phase3-EA-S4v1-GBPJPY-M5-194,GBPJPYMT4,1528,5h 25m,Buy
79674.45,1.29187,18.02.2011 09:29:58,tp 1.29187,0.0,-0.0,0.0,0.0,1.29297,18.02.2011 02:45:00,6215,-0.0,47.47,IS,0.41,0.0,Phase3-EA-SA2v2-EURCHF-M5-43,EURCHFMT4,3304,6h 44m,Sell
79691.95,1293,18.02.2011 12:30:00,,0.0,-0.0,0.0,0.0,1.29349,18.02.2011 03:45:00,6216,-0.0,17.5,IS,0.34,0.0,Phase3-EA-S4v1-EURCHF-M15-221,EURCHFMT4,1536,8h 45m,Sell
79739.7,1.29549,18.02.2011 22:09:58,tp 1.29549,0.0,-0.0,0.0,0.0,1.29439,18.02.2011 21:05:00,6217,-0.0,47.75,IS,0.41,0.0,Phase3-EA-SA2v2-EURCHF-M5-43,EURCHFMT4,3306,1h 4m,Buy
79785.24,1.29392,21.02.2011 03:39:58,tp 1.29392,-2.17,-0.0,0.0,0.0,1.29502,18.02.2011 23:35:00,6218,-0.0,45.54,IS,0.41,0.0,Phase3-EA-SA2v2-EURCHF-M5-43,EURCHFMT4,3308,2d 4h 4m,Sell
79817.06,134876,21.02.2011 07:25:00,,0.0,-0.0,0.0,0.0,134991,21.02.2011 02:00:00,6219,-0.0,31.82,IS,0.23,0.0,Phase3-EA-S4v1-GBPJPY-M5-194,GBPJPYMT4,1530,5h 25m,Sell
79799.28,113671,21.02.2011 16:45:00,,0.0,-17.779999999998836,0.0,0.0,113758,21.02.2011 10:45:00,6220,-0.010470090578649064,-17.78,IS,0.17,0.0,Phase3-EA-T1v2-EURJPY-M15-322,EURJPYMT4,830,6h 0m,Buy
79846.93,1.29459,21.02.2011 22:09:58,tp 1.29459,0.0,-0.0,0.0,0.0,1.29349,21.02.2011 20:35:00,6221,-0.0,47.65,IS,0.41,0.0,Phase3-EA-SA2v2-EURCHF-M5-43,EURCHFMT4,3310,1h 34m,Buy
79759.05,114089,22.02.2011 01:29:58,sl 114.089,-3.41,-87.88000000000466,0.0,0.0,113309,11.02.2011 07:00:00,6222,-0.05174070558708634,-87.88,IS,0.09,0.0,Phase3-EA-TR1v1-EURJPY-M30-91,EURJPYMT4,912,10d 18h 29m,Sell
79891.79,113992,22.02.2011 01:29:58,tp 113.992,-3.7,-0.0,0.0,0.0,112732,15.02.2011 08:30:00,6223,-0.0,132.74,IS,0.09,0.0,Phase3-EA-TR1v1-EURJPY-M30-91,EURJPYMT4,913,6d 16h 59m,Buy
79999.8,134464,22.02.2011 03:39:58,tp 134.464,0.0,-0.0,0.0,0.0,134854,22.02.2011 00:50:00,6224,-0.0,108.01,IS,0.23,0.0,Phase3-EA-S4v1-GBPJPY-M5-194,GBPJPYMT4,1532,2h 49m,Sell
80108.02,134572,22.02.2011 04:04:58,tp 134.572,0.0,-0.0,0.0,0.0,134182,22.02.2011 03:55:00,6225,-0.0,108.22,IS,0.23,0.0,Phase3-EA-S4v1-GBPJPY-M5-194,GBPJPYMT4,1534,9m 58s,Buy
79968.19,1.28699,22.02.2011 08:59:58,sl 1.28699,0.0,-139.8299999999872,0.0,0.0,1.29089,22.02.2011 05:00:00,6226,-0.08220070987833916,-139.83,IS,0.34,0.0,Phase3-EA-S4v1-EURCHF-M15-221,EURCHFMT4,1538,3h 59m,Buy
79883.76,112438,22.02.2011 11:59:58,sl 112.438,0.0,-224.2599999999802,0.0,0.0,113218,22.02.2011 09:00:00,6227,-0.13183387826157764,-84.43,IS,0.09,0.0,Phase3-EA-TR1v1-EURJPY-M30-91,EURJPYMT4,916,2h 59m,Buy
79836.72,113.81,22.02.2011 15:44:58,sl 113.810,0.0,-271.29999999998836,0.0,0.0,113.58,22.02.2011 03:15:00,6228,-0.15948689544442893,-47.04,IS,0.17,0.0,Phase3-EA-T1v2-EURJPY-M15-322,EURJPYMT4,832,12h 29m,Sell
79884.74,1.28358,22.02.2011 20:24:58,tp 1.28358,0.0,-223.27999999999884,0.0,0.0,1.28248,22.02.2011 20:20:00,6229,-0.13125777373694594,48.02,IS,0.41,0.0,Phase3-EA-SA2v2-EURCHF-M5-43,EURCHFMT4,3312,4m 58s,Buy
79809.33,133413,22.02.2011 20:29:58,sl 133.413,-2.72,-298.6900000000023,0.0,0.0,134083,15.02.2011 11:30:00,6230,-0.17558842904643898,-75.41,IS,0.09,0.0,Phase3-EA-B1v1-GBPJPY-M30-1,GBPJPYMT4,658,7d 8h 59m,Buy
79857.34,1.28323,22.02.2011 21:09:58,tp 1.28323,0.0,-250.67999999999302,0.0,0.0,1.28213,22.02.2011 21:00:00,6231,-0.14736518595654274,48.01,IS,0.41,0.0,Phase3-EA-SA2v2-EURCHF-M5-43,EURCHFMT4,3314,9m 58s,Buy
79904.4,1.2821,23.02.2011 02:29:58,tp 1.28210,-1.05,-203.61999999999534,0.0,0.0,1281,22.02.2011 21:30:00,6232,-0.11970041153850082,47.06,IS,0.41,0.0,Phase3-EA-SA2v2-EURCHF-M5-43,EURCHFMT4,3316,4h 59m,Buy
79939.68,82654,23.02.2011 05:30:00,,0.0,-168.3399999999965,0.0,0.0,82762,23.02.2011 01:00:00,6233,-0.09896064865136661,35.28,IS,0.27,0.0,Phase3-EA-S1v2-USDJPY-M15-0,USDJPYMT4,2030,4h 30m,Sell
79946.64,133569,23.02.2011 06:55:00,,0.0,-161.38000000000466,0.0,0.0,133594,23.02.2011 01:30:00,6234,-0.09486913080288902,6.96,IS,0.23,0.0,Phase3-EA-S4v1-GBPJPY-M5-194,GBPJPYMT4,1536,5h 25m,Sell
79899.35,113283,23.02.2011 09:59:58,sl 113.283,0.0,-208.6700000000128,0.0,0.0,113053,23.02.2011 07:30:00,6235,-0.12266911342570018,-47.29,IS,0.17,0.0,Phase3-EA-T1v2-EURJPY-M15-322,EURJPYMT4,834,2h 29m,Sell
79801.64,1.28427,23.02.2011 10:50:00,,0.0,-306.38000000000466,0.0,0.0,1.28204,23.02.2011 02:30:00,6236,-0.1801090859796055,-97.71,IS,0.41,0.0,Phase3-EA-SA2v2-EURCHF-M5-43,EURCHFMT4,3318,8h 20m,Sell
79720.48,1.28564,23.02.2011 13:15:00,,0.0,-387.54000000000815,0.0,0.0,1.2834,23.02.2011 04:30:00,6237,-0.22781994640817524,-81.16,IS,0.34,0.0,Phase3-EA-S4v1-EURCHF-M15-221,EURCHFMT4,1540,8h 45m,Sell
79768.8,1.28297,23.02.2011 21:39:58,tp 1.28297,0.0,-339.22000000000116,0.0,0.0,1.28187,23.02.2011 20:25:00,6238,-0.19941446617273015,48.32,IS,0.41,0.0,Phase3-EA-SA2v2-EURCHF-M5-43,EURCHFMT4,3320,1h 14m,Buy
79847.67,82335,24.02.2011 03:15:00,,-4.42,-260.3500000000058,0.0,0.0,82589,23.02.2011 21:45:00,6239,-0.1530498091741975,78.87,IS,0.27,0.0,Phase3-EA-S1v2-USDJPY-M15-0,USDJPYMT4,2032,5h 30m,Sell
79604.21,0.9291,24.02.2011 03:59:58,sl 0.92910,0.0,-503.8099999999977,0.0,0.0,933,24.02.2011 01:15:00,6240,-0.29617063322469894,-243.46,IS,0.58,0.0,Phase3-EA-SA2v2-USDCHF-M15-107,USDCHFMT4,1244,2h 44m,Buy
79713.39,133.41,24.02.2011 06:19:57,tp 133.410,0.0,-394.63000000000466,0.0,0.0,133.8,24.02.2011 02:55:00,6241,-0.2319878862854347,109.18,IS,0.23,0.0,Phase3-EA-S4v1-GBPJPY-M5-194,GBPJPYMT4,1538,3h 24m,Sell
79497.1,1.27782,24.02.2011 09:19:58,sl 1.27782,0.0,-610.9200000000128,0.0,0.0,1.28272,24.02.2011 01:05:00,6242,-0.35913650632110855,-216.29,IS,0.41,0.0,Phase3-EA-SA2v2-EURCHF-M5-43,EURCHFMT4,3322,8h 14m,Buy
79354.52,1.27555,24.02.2011 10:44:57,sl 1.27555,0.0,-753.5,0.0,0.0,1.27945,24.02.2011 05:45:00,6243,-0.4429538360390061,-142.58,IS,0.34,0.0,Phase3-EA-S4v1-EURCHF-M15-221,EURCHFMT4,1542,4h 59m,Buy
79266.61,112285,24.02.2011 10:59:59,sl 112.285,-2.13,-841.4100000000035,0.0,0.0,113065,22.02.2011 14:30:00,6244,-0.494632763346492,-87.91,IS,0.09,0.0,Phase3-EA-TR1v1-EURJPY-M30-91,EURJPYMT4,918,1d 20h 29m,Buy
79261.0,81784,24.02.2011 18:15:00,,0.0,-847.0199999999895,0.0,0.0,81767,24.02.2011 17:15:00,6245,-0.49793066781918294,-5.61,IS,0.27,0.0,Phase3-EA-S1v2-USDJPY-M15-0,USDJPYMT4,2034,1h 0m,Sell
79309.8,1.2756,24.02.2011 22:04:58,tp 1.27560,0.0,-798.2200000000012,0.0,0.0,1.2745,24.02.2011 21:55:00,6246,-0.46924301393902584,48.8,IS,0.41,0.0,Phase3-EA-SA2v2-EURCHF-M5-43,EURCHFMT4,3324,9m 58s,Buy
79262.04,112895,24.02.2011 22:44:58,sl 112.895,0.0,-845.9800000000105,0.0,0.0,112665,24.02.2011 20:45:00,6247,-0.4973192915889622,-47.76,IS,0.17,0.0,Phase3-EA-T1v2-EURJPY-M15-322,EURJPYMT4,836,1h 59m,Sell
79310.75,1.27703,24.02.2011 22:49:57,tp 1.27703,0.0,-797.2700000000186,0.0,0.0,1.27813,24.02.2011 22:40:00,6248,-0.46868454526718867,48.71,IS,0.41,0.0,Phase3-EA-SA2v2-EURCHF-M5-43,EURCHFMT4,3326,9m 57s,Sell
79359.54,1.2773,25.02.2011 03:29:57,tp 1.27730,0.0,-748.4800000000105,0.0,0.0,1.2784,25.02.2011 02:45:00,6249,-0.4400027700046184,48.79,IS,0.41,0.0,Phase3-EA-SA2v2-EURCHF-M5-43,EURCHFMT4,3328,44m 57s,Sell
79325.35,132.24,25.02.2011 05:20:00,,-1.63,-782.6700000000128,0.0,0.0,132124,24.02.2011 23:55:00,6250,-0.46010176357352967,-34.19,IS,0.23,0.0,Phase3-EA-S4v1-GBPJPY-M5-194,GBPJPYMT4,1540,5h 25m,Sell
79285.38,1.27488,28.02.2011 07:15:00,,-1.06,-822.640000000014,0.0,0.0,1.27576,25.02.2011 22:55:00,6251,-0.4835985981143121,-39.97,IS,0.41,0.0,Phase3-EA-SA2v2-EURCHF-M5-43,EURCHFMT4,3330,2d 8h 20m,Buy
79432.08,1.27785,28.02.2011 11:29:58,tp 1.27785,0.0,-675.9400000000023,0.0,0.0,1.27385,28.02.2011 04:15:00,6252,-0.39735927794586173,146.7,IS,0.34,0.0,Phase3-EA-S4v1-EURCHF-M15-221,EURCHFMT4,1544,7h 14m,Buy
79357.1,132914,28.02.2011 14:59:58,sl 132.914,-1.28,-750.9200000000128,0.0,0.0,132244,24.02.2011 14:00:00,6253,-0.44143715269862793,-74.98,IS,0.09,0.0,Phase3-EA-B1v1-GBPJPY-M30-1,GBPJPYMT4,660,4d 0h 59m,Sell
79405.66,1.28238,28.02.2011 23:54:57,tp 1.28238,0.0,-702.3600000000151,0.0,0.0,1.28128,28.02.2011 21:15:00,6254,-0.41289058564082687,48.56,IS,0.41,0.0,Phase3-EA-SA2v2-EURCHF-M5-43,EURCHFMT4,3332,2h 39m,Buy
79294.25,133577,01.03.2011 08:35:00,,0.0,-813.7700000000186,0.0,0.0,133179,01.03.2011 03:10:00,6255,-0.4783842643045392,-111.41,IS,0.23,0.0,Phase3-EA-S4v1-GBPJPY-M5-194,GBPJPYMT4,1542,5h 25m,Sell
79214.26,113594,01.03.2011 11:29:58,sl 113.594,-1.16,-893.7600000000093,0.0,0.0,112874,24.02.2011 10:00:00,6256,-0.5254073264740893,-79.99,IS,0.09,0.0,Phase3-EA-TR1v1-EURJPY-M30-91,EURJPYMT4,919,5d 1h 29m,Sell
79071.69,1.28766,01.03.2011 11:59:58,sl 1.28766,0.0,-1036.3300000000163,0.0,0.0,1.28376,01.03.2011 04:15:00,6257,-0.6092187775744,-142.57,IS,0.34,0.0,Phase3-EA-S4v1-EURCHF-M15-221,EURCHFMT4,1546,7h 44m,Sell
79157.83,113574,01.03.2011 17:45:00,,0.0,-950.1900000000023,0.0,0.0,113158,01.03.2011 03:00:00,6258,-0.5585803655818239,86.14,IS,0.17,0.0,Phase3-EA-T1v2-EURJPY-M15-322,EURJPYMT4,838,14h 45m,Buy
79206.38,1.28279,01.03.2011 21:59:57,tp 1.28279,0.0,-901.640000000014,0.0,0.0,1.28169,01.03.2011 20:20:00,6259,-0.5300396771416266,48.55,IS,0.41,0.0,Phase3-EA-SA2v2-EURCHF-M5-43,EURCHFMT4,3334,1h 39m,Buy
79235.08,81.84,02.03.2011 03:30:00,,0.0,-872.9400000000023,0.0,0.0,81927,02.03.2011 01:15:00,6260,-0.5131680446342283,28.7,IS,0.27,0.0,Phase3-EA-S1v2-USDJPY-M15-0,USDJPYMT4,2036,2h 15m,Sell
79192.55,1.62413,02.03.2011 07:00:00,sl 1.62413,-0.53,-915.4700000000012,0.0,0.0,1.62713,01.03.2011 05:30:00,6261,-0.5381698052801983,-42.53,IS,0.14,0.0,Phase3-EA-B1v1-GBPUSD-M30-14,GBPUSDMT4,402,1d 1h 30m,Buy
79213.78,0.92867,02.03.2011 07:00:00,,0.0,-894.2399999999907,0.0,0.0,0.92833,02.03.2011 01:00:00,6262,-0.5256895001188012,21.23,IS,0.58,0.0,Phase3-EA-SA2v2-USDCHF-M15-107,USDCHFMT4,1246,6h 0m,Buy
79046.24,1.27732,02.03.2011 07:25:00,,-1.06,-1061.7799999999988,0.0,0.0,1.28109,01.03.2011 23:05:00,6263,-0.6241798593623031,-167.54,IS,0.41,0.0,Phase3-EA-SA2v2-EURCHF-M5-43,EURCHFMT4,3336,8h 20m,Buy
79012.17,1.27847,02.03.2011 11:00:00,,0.0,-1095.8500000000058,0.0,0.0,1.2794,02.03.2011 02:15:00,6264,-0.6442083095200364,-34.07,IS,0.34,0.0,Phase3-EA-S4v1-EURCHF-M15-221,EURCHFMT4,1548,8h 45m,Buy
78933.0,113547,02.03.2011 23:59:58,sl 113.547,0.0,-1175.0200000000186,0.0,0.0,113396,01.03.2011 16:00:00,6265,-0.6907493250465312,-79.17,IS,0.09,0.0,Phase3-EA-TR1v1-EURJPY-M30-91,EURJPYMT4,922,1d 7h 59m,Sell
78933.06,0.92352,03.03.2011 02:45:00,,-9.99,-1174.960000000021,0.0,0.0,0.92368,02.03.2011 22:30:00,6266,-0.6907140533409422,0.06,IS,0.58,0.0,Phase3-EA-SA2v2-USDCHF-M15-107,USDCHFMT4,1248,4h 15m,Sell
78966.95,133545,03.03.2011 04:35:00,,-4.89,-1141.070000000007,0.0,0.0,133683,02.03.2011 23:10:00,6267,-0.6707914182999759,33.89,IS,0.23,0.0,Phase3-EA-S4v1-GBPJPY-M5-194,GBPJPYMT4,1544,5h 25m,Sell
78976.04,81786,03.03.2011 05:45:00,,-4.45,-1131.9800000000105,0.0,0.0,81827,02.03.2011 22:15:00,6268,-0.6654477549030375,9.09,IS,0.27,0.0,Phase3-EA-S1v2-USDJPY-M15-0,USDJPYMT4,2038,7h 30m,Sell
78959.17,1.28045,03.03.2011 06:45:00,,-6.66,-1148.8500000000058,0.0,0.0,1.28022,02.03.2011 22:25:00,6269,-0.6753649827915259,-16.87,IS,0.41,0.0,Phase3-EA-SA2v2-EURCHF-M5-43,EURCHFMT4,3338,8h 20m,Sell
79105.99,1.28392,03.03.2011 09:14:59,tp 1.28392,0.0,-1002.0299999999988,0.0,0.0,1.27992,03.03.2011 05:45:00,6270,-0.5890551192118976,146.82,IS,0.34,0.0,Phase3-EA-S4v1-EURCHF-M15-221,EURCHFMT4,1550,3h 29m,Buy
79018.72,114176,03.03.2011 16:59:57,sl 114.176,-1.53,-1089.2999999999884,0.0,0.0,112827,02.03.2011 00:30:00,6271,-0.640357814993078,-87.27,IS,0.09,0.0,Phase3-EA-TR1v1-EURJPY-M30-91,EURJPYMT4,923,1d 16h 29m,Sell
79024.45,82343,04.03.2011 02:30:00,,-1.48,-1083.5699999999779,0.0,0.0,82365,03.03.2011 23:00:00,6272,-0.6369893671091919,5.73,IS,0.27,0.0,Phase3-EA-S1v2-USDJPY-M15-0,USDJPYMT4,2040,3h 30m,Sell
78949.68,1.30114,04.03.2011 06:40:00,,-2.2,-1158.3399999999674,0.0,0.0,1.29949,03.03.2011 22:20:00,6273,-0.6809437908923794,-74.77,IS,0.41,0.0,Phase3-EA-SA2v2-EURCHF-M5-43,EURCHFMT4,3340,8h 20m,Sell
78929.26,1.30141,04.03.2011 10:30:00,,0.0,-1178.7599999999802,0.0,0.0,1.30085,04.03.2011 01:45:00,6274,-0.6929479280283081,-20.42,IS,0.34,0.0,Phase3-EA-S4v1-EURCHF-M15-221,EURCHFMT4,1552,8h 45m,Sell
79127.99,134927,04.03.2011 16:59:57,tp 134.927,-2.38,-980.0299999999697,0.0,0.0,133077,28.02.2011 18:30:00,6275,-0.5761221604954131,198.73,IS,0.09,0.0,Phase3-EA-B1v1-GBPJPY-M30-1,GBPJPYMT4,662,3d 22h 29m,Buy
79136.46,115043,04.03.2011 20:30:00,,0.0,-971.5599999999686,0.0,0.0,115002,04.03.2011 11:00:00,6276,-0.5711429713895725,8.47,IS,0.17,0.0,Phase3-EA-T1v2-EURJPY-M15-322,EURJPYMT4,840,9h 30m,Buy
79140.76,82337,07.03.2011 03:15:00,,-0.95,-967.2599999999802,0.0,0.0,82321,04.03.2011 23:30:00,6277,-0.5686151658222698,4.3,IS,0.27,0.0,Phase3-EA-S1v2-USDJPY-M15-0,USDJPYMT4,2042,2d 3h 45m,Buy
79189.5,1.29426,07.03.2011 03:54:58,tp 1.29426,0.0,-918.5199999999895,0.0,0.0,1.29536,07.03.2011 02:35:00,6278,-0.5399627836477018,48.74,IS,0.41,0.0,Phase3-EA-SA2v2-EURCHF-M5-43,EURCHFMT4,3342,1h 19m,Sell
79219.13,82001,07.03.2011 18:45:00,,0.0,-888.8899999999849,0.0,0.0,82091,07.03.2011 17:00:00,6279,-0.5225444397036568,29.63,IS,0.27,0.0,Phase3-EA-S1v2-USDJPY-M15-0,USDJPYMT4,2044,1h 45m,Sell
79244.18,1.29421,08.03.2011 04:20:00,,-1.06,-863.8399999999965,0.0,0.0,1.29362,07.03.2011 20:00:00,6280,-0.5078185026196861,25.05,IS,0.41,0.0,Phase3-EA-SA2v2-EURCHF-M5-43,EURCHFMT4,3344,8h 20m,Buy
79195.99,115075,08.03.2011 09:29:58,sl 115.075,-0.72,-912.0299999999988,0.0,0.0,114845,07.03.2011 19:15:00,6281,-0.5361475608263494,-48.19,IS,0.17,0.0,Phase3-EA-T1v2-EURJPY-M15-322,EURJPYMT4,842,14h 14m,Sell
79053.23,1.29889,08.03.2011 09:44:59,sl 1.29889,0.0,-1054.7900000000081,0.0,0.0,1.29499,08.03.2011 06:15:00,6282,-0.6200707056610311,-142.76,IS,0.34,0.0,Phase3-EA-S4v1-EURCHF-M15-221,EURCHFMT4,1554,3h 29m,Sell
79101.52,1.29916,08.03.2011 20:24:58,tp 1.29916,0.0,-1006.5,0.0,0.0,1.30026,08.03.2011 20:00:00,6283,-0.5916828612783804,48.29,IS,0.41,0.0,Phase3-EA-SA2v2-EURCHF-M5-43,EURCHFMT4,3346,24m 58s,Sell
79117.22,82705,09.03.2011 02:15:00,,-0.95,-990.7999999999884,0.0,0.0,82654,08.03.2011 23:00:00,6284,-0.5824534316488946,15.7,IS,0.27,0.0,Phase3-EA-S1v2-USDJPY-M15-0,USDJPYMT4,2046,3h 15m,Buy
79163.23,1.29883,09.03.2011 03:54:58,tp 1.29883,-2.19,-944.789999999979,0.0,0.0,1.29993,08.03.2011 21:15:00,6285,-0.5554059120786773,46.01,IS,0.41,0.0,Phase3-EA-SA2v2-EURCHF-M5-43,EURCHFMT4,3348,6h 39m,Sell
79193.6,0.9357,09.03.2011 05:30:00,,0.0,-914.4199999999837,0.0,0.0,0.93521,09.03.2011 01:15:00,6286,-0.5375525504323567,30.37,IS,0.58,0.0,Phase3-EA-SA2v2-USDCHF-M15-107,USDCHFMT4,1250,4h 15m,Buy
79184.44,133768,09.03.2011 07:55:00,,0.0,-923.5799999999872,0.0,0.0,133735,09.03.2011 02:30:00,6287,-0.5429373641524878,-9.16,IS,0.23,0.0,Phase3-EA-S4v1-GBPJPY-M5-194,GBPJPYMT4,1546,5h 25m,Sell
79330.13,1.29635,09.03.2011 11:29:58,tp 1.29635,0.0,-777.8899999999849,0.0,0.0,1.30035,09.03.2011 06:45:00,6288,-0.45729178436148077,145.69,IS,0.34,0.0,Phase3-EA-S4v1-EURCHF-M15-221,EURCHFMT4,1556,4h 44m,Sell
79282.8,114916,09.03.2011 16:59:58,sl 114.916,0.0,-825.2199999999721,0.0,0.0,115146,09.03.2011 14:45:00,6289,-0.4851152814546732,-47.33,IS,0.17,0.0,Phase3-EA-T1v2-EURJPY-M15-322,EURJPYMT4,844,2h 14m,Buy
79235.51,114881,09.03.2011 21:59:58,sl 114.881,0.0,-872.5099999999802,0.0,0.0,115111,09.03.2011 19:00:00,6290,-0.5129152640774843,-47.29,IS,0.17,0.0,Phase3-EA-T1v2-EURJPY-M15-322,EURJPYMT4,846,2h 59m,Buy
79284.09,1.29158,10.03.2011 05:44:57,tp 1.29158,0.0,-823.929999999993,0.0,0.0,1.29268,10.03.2011 02:55:00,6291,-0.4843569397844927,48.58,IS,0.41,0.0,Phase3-EA-SA2v2-EURCHF-M5-43,EURCHFMT4,3350,2h 49m,Sell
79430.02,1.28915,10.03.2011 10:44:58,tp 1.28915,0.0,-678.0,0.0,0.0,1.29315,10.03.2011 04:30:00,6292,-0.3985702731711296,145.93,IS,0.34,0.0,Phase3-EA-S4v1-EURCHF-M15-221,EURCHFMT4,1558,6h 14m,Sell
79348.51,114348,10.03.2011 11:29:58,sl 114.348,-3.21,-759.5100000000093,0.0,0.0,115068,04.03.2011 01:30:00,6293,-0.44648688521564656,-81.51,IS,0.09,0.0,Phase3-EA-TR1v1-EURJPY-M30-91,EURJPYMT4,926,6d 9h 59m,Buy
79287.45,0.93094,11.03.2011 07:00:00,,0.0,-820.570000000007,0.0,0.0,0.93192,11.03.2011 02:45:00,6294,-0.48238172427144044,-61.06,IS,0.58,0.0,Phase3-EA-SA2v2-USDCHF-M15-107,USDCHFMT4,1252,4h 15m,Buy
79227.23,1.2875,11.03.2011 10:10:00,,0.0,-880.7900000000081,0.0,0.0,1.28613,11.03.2011 01:50:00,6295,-0.5177827594489712,-60.22,IS,0.41,0.0,Phase3-EA-SA2v2-EURCHF-M5-43,EURCHFMT4,3352,8h 20m,Sell
79085.16,1.29088,11.03.2011 11:14:58,sl 1.29088,0.0,-1022.8600000000151,0.0,0.0,1.28698,11.03.2011 04:15:00,6296,-0.6013002796693623,-142.07,IS,0.34,0.0,Phase3-EA-S4v1-EURCHF-M15-221,EURCHFMT4,1560,6h 59m,Sell
79043.16,1.6056,11.03.2011 11:59:58,sl 1.60560,0.0,-1064.8600000000151,0.0,0.0,1.6026,11.03.2011 11:00:00,6297,-0.6259904735826182,-42.0,IS,0.14,0.0,Phase3-EA-B1v1-GBPUSD-M30-14,GBPUSDMT4,404,59m 58s,Sell
79174.22,81482,14.03.2011 02:00:00,tp 81.482,-1.48,-933.8000000000175,0.0,0.0,81882,11.03.2011 23:15:00,6298,-0.5489453113380646,131.06,IS,0.27,0.0,Phase3-EA-S1v2-USDJPY-M15-0,USDJPYMT4,2048,2d 2h 45m,Sell
78955.9,1.2929,14.03.2011 02:00:00,sl 1.29290,-2.21,-1152.1200000000244,0.0,0.0,1288,11.03.2011 20:30:00,6299,-0.6772872907462117,-218.32,IS,0.41,0.0,Phase3-EA-SA2v2-EURCHF-M5-43,EURCHFMT4,3354,2d 5h 30m,Sell
79065.67,131395,14.03.2011 03:49:58,tp 131.395,0.0,-1042.350000000035,0.0,0.0,131005,14.03.2011 02:15:00,6300,-0.6127577053686444,109.77,IS,0.23,0.0,Phase3-EA-S4v1-GBPJPY-M5-194,GBPJPYMT4,1548,1h 34m,Buy
79096.03,1.2928,14.03.2011 11:45:00,,0.0,-1011.9900000000489,0.0,0.0,1.29363,14.03.2011 03:00:00,6301,-0.5949102223399276,30.36,IS,0.34,0.0,Phase3-EA-S4v1-EURCHF-M15-221,EURCHFMT4,1562,8h 45m,Sell
79142.6,1.29274,15.03.2011 00:09:58,tp 1.29274,-2.22,-965.4200000000419,0.0,0.0,1.29384,14.03.2011 22:30:00,6302,-0.5675335001842016,46.57,IS,0.41,0.0,Phase3-EA-SA2v2-EURCHF-M5-43,EURCHFMT4,3356,1h 39m,Sell
79191.38,1.29395,15.03.2011 02:54:58,tp 1.29395,0.0,-916.6400000000431,0.0,0.0,1.29285,15.03.2011 01:05:00,6303,-0.5388576035392351,48.78,IS,0.41,0.0,Phase3-EA-SA2v2-EURCHF-M5-43,EURCHFMT4,3358,1h 49m,Buy
79240.16,1.29271,15.03.2011 03:49:58,tp 1.29271,0.0,-867.8600000000442,0.0,0.0,1.29381,15.03.2011 02:55:00,6304,-0.5101817068942687,48.78,IS,0.41,0.0,Phase3-EA-SA2v2-EURCHF-M5-43,EURCHFMT4,3360,54m 58s,Sell
79192.33,114088,15.03.2011 05:14:57,sl 114.088,0.0,-915.6900000000314,0.0,0.0,114318,15.03.2011 01:15:00,6305,-0.5382991348673808,-47.83,IS,0.17,0.0,Phase3-EA-T1v2-EURJPY-M15-322,EURJPYMT4,848,3h 59m,Buy
79302.12,131789,15.03.2011 05:34:57,tp 131.789,0.0,-805.9000000000233,0.0,0.0,132179,15.03.2011 02:00:00,6306,-0.4737577922546056,109.79,IS,0.23,0.0,Phase3-EA-S4v1-GBPJPY-M5-194,GBPJPYMT4,1550,3h 34m,Sell
79327.27,81587,15.03.2011 05:45:00,,0.0,-780.7500000000291,0.0,0.0,81663,15.03.2011 00:45:00,6307,-0.45897306899464757,25.15,IS,0.27,0.0,Phase3-EA-S1v2-USDJPY-M15-0,USDJPYMT4,2050,5h 0m,Sell
79183.81,1.28504,15.03.2011 07:14:58,sl 1.28504,0.0,-924.210000000021,0.0,0.0,1.28894,15.03.2011 06:15:00,6308,-0.5433077170612065,-143.46,IS,0.34,0.0,Phase3-EA-S4v1-EURCHF-M15-221,EURCHFMT4,1564,59m 58s,Buy
79140.75,1.60268,15.03.2011 12:29:58,sl 1.60268,-1.06,-967.2700000000186,0.0,0.0,1.60568,11.03.2011 21:00:00,6309,-0.5686210444398908,-43.06,IS,0.14,0.0,Phase3-EA-B1v1-GBPUSD-M30-14,GBPUSDMT4,406,3d 15h 29m,Buy
79053.48,112994,15.03.2011 12:59:57,sl 112.994,-1.08,-1054.5400000000081,0.0,0.0,113774,11.03.2011 22:30:00,6310,-0.6199237402210712,-87.27,IS,0.09,0.0,Phase3-EA-TR1v1-EURJPY-M30-91,EURJPYMT4,928,3d 14h 29m,Buy
79102.73,1.28053,15.03.2011 20:44:58,tp 1.28053,0.0,-1005.2900000000081,0.0,0.0,1.27943,15.03.2011 20:30:00,6311,-0.5909715485489795,49.25,IS,0.41,0.0,Phase3-EA-SA2v2-EURCHF-M5-43,EURCHFMT4,3362,14m 58s,Buy
79142.53,80729,15.03.2011 23:45:00,,0.0,-965.4900000000198,0.0,0.0,80848,15.03.2011 20:15:00,6312,-0.5675746505073773,39.8,IS,0.27,0.0,Phase3-EA-S1v2-USDJPY-M15-0,USDJPYMT4,2052,3h 30m,Sell
79189.52,1.28204,16.03.2011 01:09:57,tp 1.28204,-2.24,-918.5000000000291,0.0,0.0,1.28314,15.03.2011 21:55:00,6313,-0.5399510264125282,46.99,IS,0.41,0.0,Phase3-EA-SA2v2-EURCHF-M5-43,EURCHFMT4,3364,3h 14m,Sell
79238.69,1.28276,16.03.2011 02:34:58,tp 1.28276,0.0,-869.3300000000163,0.0,0.0,1.28166,16.03.2011 01:25:00,6314,-0.5110458636812162,49.17,IS,0.41,0.0,Phase3-EA-SA2v2-EURCHF-M5-43,EURCHFMT4,3366,1h 9m,Buy
79287.83,1.28233,16.03.2011 05:44:57,tp 1.28233,0.0,-820.1900000000023,0.0,0.0,1.28343,16.03.2011 02:50:00,6315,-0.4821583368026987,49.14,IS,0.41,0.0,Phase3-EA-SA2v2-EURCHF-M5-43,EURCHFMT4,3368,2h 54m,Sell
79398.8,129681,16.03.2011 06:19:58,tp 129.681,0.0,-709.2200000000012,0.0,0.0,130071,16.03.2011 02:35:00,6316,-0.4169233173133171,110.97,IS,0.23,0.0,Phase3-EA-S4v1-GBPJPY-M5-194,GBPJPYMT4,1552,3h 44m,Sell
79547.01,1.28017,16.03.2011 06:29:58,tp 1.28017,0.0,-561.0100000000093,0.0,0.0,1.28417,16.03.2011 03:45:00,6317,-0.32979632588752084,148.21,IS,0.34,0.0,Phase3-EA-S4v1-EURCHF-M15-221,EURCHFMT4,1566,2h 44m,Sell
79610.31,0.91632,16.03.2011 06:44:57,tp 0.91632,0.0,-497.71000000002095,0.0,0.0,0.91732,16.03.2011 02:30:00,6318,-0.2925846764896921,63.3,IS,0.58,0.0,Phase3-EA-SA2v2-USDCHF-M15-107,USDCHFMT4,1254,4h 14m,Sell
79562.02,113149,16.03.2011 08:44:58,sl 113.149,0.0,-546.0000000000291,0.0,0.0,112919,16.03.2011 05:45:00,6319,-0.32097252087234274,-48.29,IS,0.17,0.0,Phase3-EA-T1v2-EURJPY-M15-322,EURJPYMT4,850,2h 59m,Sell
79520.02,1.60774,16.03.2011 11:29:57,sl 1.60774,0.0,-588.0000000000291,0.0,0.0,1.61074,16.03.2011 10:30:00,6320,-0.3456627147855985,-42.0,IS,0.14,0.0,Phase3-EA-B1v1-GBPUSD-M30-14,GBPUSDMT4,408,59m 57s,Buy
79478.02,1.60818,16.03.2011 12:29:58,sl 1.60818,0.0,-630.0000000000291,0.0,0.0,1.61118,16.03.2011 11:30:00,6321,-0.37035290869885434,-42.0,IS,0.14,0.0,Phase3-EA-B1v1-GBPUSD-M30-14,GBPUSDMT4,410,59m 58s,Buy
79503.48,80586,16.03.2011 17:30:00,,0.0,-604.5400000000373,0.0,0.0,80662,16.03.2011 17:15:00,6322,-0.3553859482933474,25.46,IS,0.27,0.0,Phase3-EA-S1v2-USDJPY-M15-0,USDJPYMT4,2054,15m 0s,Sell
79415.83,112115,16.03.2011 18:29:57,sl 112.115,-0.55,-692.1900000000314,0.0,0.0,112895,15.03.2011 19:00:00,6323,-0.4069120315432695,-87.65,IS,0.09,0.0,Phase3-EA-TR1v1-EURJPY-M30-91,EURJPYMT4,930,23h 29m,Buy
79776.27,111.25,16.03.2011 20:44:58,tp 111.250,0.0,-331.7500000000291,0.0,0.0,112.95,16.03.2011 11:45:00,6324,-0.19502313882674607,360.44,IS,0.17,0.0,Phase3-EA-T1v2-EURJPY-M15-322,EURJPYMT4,852,8h 59m,Sell
79825.9,1.26381,16.03.2011 21:44:58,tp 1.26381,0.0,-282.12000000002445,0.0,0.0,1.26271,16.03.2011 21:00:00,6325,-0.16584755968591272,49.63,IS,0.41,0.0,Phase3-EA-SA2v2-EURCHF-M5-43,EURCHFMT4,3370,44m 58s,Buy
79876.26,1.25128,17.03.2011 00:29:57,tp 1.25128,0.0,-231.76000000003842,0.0,0.0,1.25018,17.03.2011 00:25:00,6326,-0.13624284146040752,50.36,IS,0.41,0.0,Phase3-EA-SA2v2-EURCHF-M5-43,EURCHFMT4,3372,4m 57s,Buy
80017.57,109745,17.03.2011 00:29:58,tp 109.745,-1.19,-90.45000000004075,0.0,0.0,111005,16.03.2011 21:30:00,6327,-0.05317209617749987,141.31,IS,0.09,0.0,Phase3-EA-TR1v1-EURJPY-M30-91,EURJPYMT4,932,2h 59m,Sell
80081.96,0.90081,17.03.2011 00:44:58,tp 0.90081,0.0,-26.060000000026776,0.0,0.0,0.89981,17.03.2011 00:30:00,6328,-0.015319677461431135,64.39,IS,0.58,0.0,Phase3-EA-SA2v2-USDCHF-M15-107,USDCHFMT4,1256,14m 58s,Buy
80197.76,124362,17.03.2011 00:49:58,tp 124.362,0.0,-0.0,0.0,0.0,123972,17.03.2011 00:45:00,6329,-0.0,115.8,IS,0.23,0.0,Phase3-EA-S4v1-GBPJPY-M5-194,GBPJPYMT4,1554,4m 58s,Buy
80113.59,108715,17.03.2011 00:59:58,sl 108.715,0.0,-84.1700000000128,0.0,0.0,107995,17.03.2011 00:30:00,6330,-0.04945423488535501,-84.17,IS,0.09,0.0,Phase3-EA-TR1v1-EURJPY-M30-91,EURJPYMT4,934,29m 58s,Sell
80029.62,108306,17.03.2011 01:29:58,sl 108.306,0.0,-168.14000000001397,0.0,0.0,107586,17.03.2011 01:00:00,6331,-0.09879095941098986,-83.97,IS,0.09,0.0,Phase3-EA-TR1v1-EURJPY-M30-91,EURJPYMT4,936,29m 58s,Sell
79947.03,109372,17.03.2011 02:29:58,sl 109.372,0.0,-250.73000000001048,0.0,0.0,108652,17.03.2011 01:30:00,6332,-0.14731686245460013,-82.59,IS,0.09,0.0,Phase3-EA-TR1v1-EURJPY-M30-91,EURJPYMT4,938,59m 58s,Sell
80097.67,1.25657,17.03.2011 03:14:58,tp 1.25657,0.0,-100.08999999999651,0.0,0.0,1.25257,17.03.2011 02:00:00,6333,-0.058808059518525094,150.64,IS,0.34,0.0,Phase3-EA-S4v1-EURCHF-M15-221,EURCHFMT4,1568,1h 14m,Buy
80048.12,110082,17.03.2011 07:29:58,sl 110.082,0.0,-149.63999999998487,0.0,0.0,109852,17.03.2011 07:15:00,6334,-0.08792125113749139,-49.55,IS,0.17,0.0,Phase3-EA-T1v2-EURJPY-M15-322,EURJPYMT4,854,14m 58s,Sell
80199.13,1.2557,17.03.2011 08:29:58,tp 1.25570,0.0,-0.0,0.0,0.0,1.2517,17.03.2011 06:30:00,6335,-0.0,151.01,IS,0.34,0.0,Phase3-EA-S4v1-EURCHF-M15-221,EURCHFMT4,1570,1h 59m,Buy
80149.17,109927,17.03.2011 13:59:57,sl 109.927,0.0,-49.95999999999185,0.0,0.0,109697,17.03.2011 13:45:00,6336,-0.029353851573737093,-49.96,IS,0.17,0.0,Phase3-EA-T1v2-EURJPY-M15-322,EURJPYMT4,856,14m 57s,Sell
80099.54,110.41,17.03.2011 15:59:57,sl 110.410,0.0,-99.58999999999651,0.0,0.0,110.18,17.03.2011 14:00:00,6337,-0.058513812614668766,-49.63,IS,0.17,0.0,Phase3-EA-T1v2-EURJPY-M15-322,EURJPYMT4,858,1h 59m,Sell
80049.85,110228,17.03.2011 17:29:58,sl 110.228,0.0,-149.27999999999884,0.0,0.0,109998,17.03.2011 17:00:00,6338,-0.08770902647974688,-49.69,IS,0.17,0.0,Phase3-EA-T1v2-EURJPY-M15-322,EURJPYMT4,860,29m 58s,Sell
80099.89,1.26314,17.03.2011 20:34:57,tp 1.26314,0.0,-99.23999999999069,0.0,0.0,1.26424,17.03.2011 20:20:00,6339,-0.058308171140469794,50.04,IS,0.41,0.0,Phase3-EA-SA2v2-EURCHF-M5-43,EURCHFMT4,3374,14m 57s,Sell
80213.21,127529,18.03.2011 02:14:57,tp 127.529,0.0,-0.0,0.0,0.0,127919,18.03.2011 01:30:00,6340,-0.0,113.32,IS,0.23,0.0,Phase3-EA-S4v1-GBPJPY-M5-194,GBPJPYMT4,1556,44m 57s,Sell
80262.24,1.2617,18.03.2011 02:59:57,tp 1.26170,-1.1,-0.0,0.0,0.0,1.2606,17.03.2011 22:25:00,6341,-0.0,49.03,IS,0.41,0.0,Phase3-EA-SA2v2-EURCHF-M5-43,EURCHFMT4,3376,4h 34m,Buy
79979.4,79665,18.03.2011 03:14:58,sl 79.665,-1.54,-282.8399999999965,0.0,0.0,78835,17.03.2011 17:30:00,6342,-0.16612021549816122,-282.84,IS,0.27,0.0,Phase3-EA-S1v2-USDJPY-M15-0,USDJPYMT4,2056,9h 44m,Sell
79753.45,131561,18.03.2011 05:14:57,sl 131.561,0.0,-508.79000000000815,0.0,0.0,130761,18.03.2011 03:45:00,6343,-0.2988272678663267,-225.95,IS,0.23,0.0,Phase3-EA-S4v1-GBPJPY-M5-194,GBPJPYMT4,1558,1h 29m,Sell
79679.74,131579,18.03.2011 10:59:58,sl 131.579,0.0,-582.5,0.0,0.0,132249,18.03.2011 08:30:00,6344,-0.34211930960147113,-73.71,IS,0.09,0.0,Phase3-EA-B1v1-GBPJPY-M30-1,GBPJPYMT4,664,2h 29m,Buy
79631.66,114775,18.03.2011 16:14:58,sl 114.775,0.0,-630.5799999999872,0.0,0.0,115005,18.03.2011 14:15:00,6345,-0.3703581017141481,-48.08,IS,0.17,0.0,Phase3-EA-T1v2-EURJPY-M15-322,EURJPYMT4,862,1h 59m,Buy
79681.62,1.27691,18.03.2011 22:19:59,tp 1.27691,0.0,-580.6199999999953,0.0,0.0,1.27581,18.03.2011 20:45:00,6346,-0.3410151305421538,49.96,IS,0.41,0.0,Phase3-EA-SA2v2-EURCHF-M5-43,EURCHFMT4,3378,1h 34m,Buy
79731.63,1.27746,18.03.2011 23:19:59,tp 1.27746,0.0,-530.609999999986,0.0,0.0,1.27856,18.03.2011 23:05:00,6347,-0.3116427929058057,50.01,IS,0.41,0.0,Phase3-EA-SA2v2-EURCHF-M5-43,EURCHFMT4,3380,14m 59s,Sell
79796.02,0.90079,18.03.2011 23:44:58,tp 0.90079,0.0,-466.21999999997206,0.0,0.0,0.90179,18.03.2011 23:15:00,6348,-0.2738246601242718,64.39,IS,0.58,0.0,Phase3-EA-SA2v2-USDCHF-M15-107,USDCHFMT4,1258,29m 58s,Sell
79724.81,1.28099,21.03.2011 11:05:00,,0.0,-537.4299999999639,0.0,0.0,1.27942,21.03.2011 02:45:00,6349,-0.31564837864224254,-71.21,IS,0.41,0.0,Phase3-EA-SA2v2-EURCHF-M5-43,EURCHFMT4,3382,8h 20m,Sell
79669.27,1.28219,21.03.2011 12:45:00,,0.0,-592.9699999999721,0.0,0.0,1.28071,21.03.2011 04:00:00,6350,-0.3482686472349782,-55.54,IS,0.34,0.0,Phase3-EA-S4v1-EURCHF-M15-221,EURCHFMT4,1572,8h 45m,Sell
79634.01,81.11,22.03.2011 01:00:00,,-0.97,-628.2299999999814,0.0,0.0,81213,21.03.2011 17:00:00,6351,-0.36897787789000147,-35.26,IS,0.27,0.0,Phase3-EA-S1v2-USDJPY-M15-0,USDJPYMT4,2058,8h 0m,Buy
79681.6,1.28582,22.03.2011 04:04:57,tp 1.28582,-2.27,-580.6399999999849,0.0,0.0,1.28692,21.03.2011 21:10:00,6352,-0.34102687712788504,47.59,IS,0.41,0.0,Phase3-EA-SA2v2-EURCHF-M5-43,EURCHFMT4,3384,6h 54m,Sell
79792.45,131908,22.03.2011 05:49:57,tp 131.908,0.0,-469.78999999997905,0.0,0.0,132298,22.03.2011 01:30:00,6353,-0.27592142567839995,110.85,IS,0.23,0.0,Phase3-EA-S4v1-GBPJPY-M5-194,GBPJPYMT4,1560,4h 19m,Sell
80055.99,1.63585,22.03.2011 12:59:57,tp 1.63585,-1.06,-206.2499999999709,0.0,0.0,1.61695,18.03.2011 18:00:00,6354,-0.12113666541681282,263.54,IS,0.14,0.0,Phase3-EA-B1v1-GBPUSD-M30-14,GBPUSDMT4,412,3d 18h 59m,Buy
80007.74,115123,22.03.2011 16:14:57,sl 115.123,0.0,-254.4999999999709,0.0,0.0,115353,22.03.2011 11:15:00,6355,-0.14947530350826516,-48.25,IS,0.17,0.0,Phase3-EA-T1v2-EURJPY-M15-322,EURJPYMT4,864,4h 59m,Buy
80118.62,132234,23.03.2011 03:39:57,tp 132.234,0.0,-143.61999999996624,0.0,0.0,132624,23.03.2011 02:05:00,6356,-0.08435223218017465,110.88,IS,0.23,0.0,Phase3-EA-S4v1-GBPJPY-M5-194,GBPJPYMT4,1562,1h 34m,Sell
80021.73,1.28035,23.03.2011 08:05:00,,-1.09,-240.5099999999802,0.0,0.0,1.28246,22.03.2011 23:45:00,6357,-0.14125856678496662,-96.89,IS,0.41,0.0,Phase3-EA-SA2v2-EURCHF-M5-43,EURCHFMT4,3386,8h 20m,Buy
79874.28,1.27596,23.03.2011 10:44:58,sl 1.27596,0.0,-387.95999999999185,0.0,0.0,1.27986,23.03.2011 04:45:00,6358,-0.22786027013387805,-147.45,IS,0.34,0.0,Phase3-EA-S4v1-EURCHF-M15-221,EURCHFMT4,1574,5h 59m,Buy
79923.91,1.28172,23.03.2011 20:29:57,tp 1.28172,0.0,-338.3299999999872,0.0,0.0,1.28282,23.03.2011 20:25:00,6359,-0.1987111176265431,49.63,IS,0.41,0.0,Phase3-EA-SA2v2-EURCHF-M5-43,EURCHFMT4,3388,4m 57s,Sell
79973.59,1.28189,23.03.2011 22:59:58,tp 1.28189,0.0,-288.6499999999942,0.0,0.0,1.28299,23.03.2011 22:35:00,6360,-0.16953259865487152,49.68,IS,0.41,0.0,Phase3-EA-SA2v2-EURCHF-M5-43,EURCHFMT4,3390,24m 58s,Sell
80000.5,0.90762,24.03.2011 03:30:00,,-10.15,-261.7399999999907,0.0,0.0,0.9082,23.03.2011 23:15:00,6361,-0.1537275675452118,26.91,IS,0.58,0.0,Phase3-EA-SA2v2-USDCHF-M15-107,USDCHFMT4,1260,4h 15m,Sell
80046.81,1.28181,24.03.2011 06:59:58,tp 1.28181,-3.25,-215.42999999999302,0.0,0.0,1.28071,23.03.2011 23:40:00,6362,-0.1265283482702876,46.31,IS,0.41,0.0,Phase3-EA-SA2v2-EURCHF-M5-43,EURCHFMT4,3392,7h 19m,Buy
80151.77,1.28235,24.03.2011 09:45:00,,0.0,-110.47000000000116,0.0,0.0,1.27954,24.03.2011 01:00:00,6363,-0.06488226632047196,104.96,IS,0.34,0.0,Phase3-EA-S4v1-EURCHF-M15-221,EURCHFMT4,1576,8h 45m,Buy
80068.39,113607,24.03.2011 10:59:57,sl 113.607,-3.27,-193.85000000000582,0.0,0.0,114327,18.03.2011 05:00:00,6364,-0.1138537822596518,-83.38,IS,0.09,0.0,Phase3-EA-TR1v1-EURJPY-M30-91,EURJPYMT4,940,6d 5h 59m,Buy
80017.82,114765,24.03.2011 17:59:59,sl 114.765,-2.21,-244.4200000000128,0.0,0.0,114535,23.03.2011 15:30:00,6365,-0.14355502429664543,-50.57,IS,0.17,0.0,Phase3-EA-T1v2-EURJPY-M15-322,EURJPYMT4,866,1d 2h 29m,Sell
80078.35,0.90757,25.03.2011 01:59:58,tp 0.90757,-3.38,-183.89000000001397,0.0,0.0,0.90857,24.03.2011 23:00:00,6366,-0.10800398256243658,60.53,IS,0.58,0.0,Phase3-EA-SA2v2-USDCHF-M15-107,USDCHFMT4,1262,2h 59m,Sell
80125.77,1.28664,25.03.2011 02:14:57,tp 1.28664,-2.26,-136.47000000000116,0.0,0.0,1.28774,24.03.2011 22:40:00,6367,-0.0801528277790784,47.42,IS,0.41,0.0,Phase3-EA-SA2v2-EURCHF-M5-43,EURCHFMT4,3394,3h 34m,Sell
80175.41,1.28703,25.03.2011 02:39:58,tp 1.28703,0.0,-86.8299999999872,0.0,0.0,1.28593,25.03.2011 02:25:00,6368,-0.05099780197886929,49.64,IS,0.41,0.0,Phase3-EA-SA2v2-EURCHF-M5-43,EURCHFMT4,3396,14m 58s,Buy
80127.14,114656,25.03.2011 11:14:58,sl 114.656,0.0,-135.09999999997672,0.0,0.0,114886,25.03.2011 10:00:00,6369,-0.07934818665605285,-48.27,IS,0.17,0.0,Phase3-EA-T1v2-EURJPY-M15-322,EURJPYMT4,868,1h 14m,Buy
80186.18,81401,25.03.2011 19:30:00,,0.0,-76.05999999996857,0.0,0.0,81223,25.03.2011 17:15:00,6370,-0.04467226555927407,59.04,IS,0.27,0.0,Phase3-EA-S1v2-USDJPY-M15-0,USDJPYMT4,2060,2h 15m,Buy
80232.98,1.29347,28.03.2011 02:00:00,tp 1.29347,-2.23,-29.25999999998021,0.0,0.0,1.29457,25.03.2011 22:35:00,6371,-0.017185254933789314,46.8,IS,0.41,0.0,Phase3-EA-SA2v2-EURCHF-M5-43,EURCHFMT4,3398,2d 3h 25m,Sell
80130.88,922,28.03.2011 02:45:00,,-3.34,-131.35999999998603,0.0,0.0,0.92043,25.03.2011 22:30:00,6372,-0.07715157512316648,-102.1,IS,0.58,0.0,Phase3-EA-SA2v2-USDCHF-M15-107,USDCHFMT4,1264,2d 4h 15m,Sell
80278.43,1.29653,28.03.2011 09:59:58,tp 1.29653,0.0,-0.0,0.0,0.0,1.29253,28.03.2011 05:30:00,6373,-0.0,147.55,IS,0.34,0.0,Phase3-EA-S4v1-EURCHF-M15-221,EURCHFMT4,1578,4h 29m,Buy
80236.43,1.60041,28.03.2011 21:59:58,sl 1.60041,0.0,-42.0,0.0,0.0,1.60341,28.03.2011 19:30:00,6374,-0.024665484641830434,-42.0,IS,0.14,0.0,Phase3-EA-B1v1-GBPUSD-M30-14,GBPUSDMT4,414,2h 29m,Buy
80285.58,1.29259,28.03.2011 22:09:58,tp 1.29259,0.0,-0.0,0.0,0.0,1.29369,28.03.2011 20:25:00,6375,-0.0,49.15,IS,0.41,0.0,Phase3-EA-SA2v2-EURCHF-M5-43,EURCHFMT4,3400,1h 44m,Sell
80235.44,0.91625,29.03.2011 03:30:00,,-0.76,-50.14000000001397,0.0,0.0,0.91703,28.03.2011 23:15:00,6376,-0.02944465409226897,-50.14,IS,0.58,0.0,Phase3-EA-SA2v2-USDCHF-M15-107,USDCHFMT4,1266,4h 15m,Buy
80186.51,114.84,29.03.2011 04:44:58,sl 114.840,-1.02,-99.07000000000698,0.0,0.0,115.07,28.03.2011 18:00:00,6377,-0.058178737154377345,-48.93,IS,0.17,0.0,Phase3-EA-T1v2-EURJPY-M15-322,EURJPYMT4,870,10h 44m,Buy
80066.9,1.29001,29.03.2011 06:40:00,,-1.07,-218.67999999999302,0.0,0.0,1.29266,28.03.2011 22:20:00,6378,-0.12841956435770602,-119.61,IS,0.41,0.0,Phase3-EA-SA2v2-EURCHF-M5-43,EURCHFMT4,3402,8h 20m,Buy
80136.43,130822,29.03.2011 08:50:00,,0.0,-149.14999999999418,0.0,0.0,130575,29.03.2011 03:25:00,6379,-0.0875881563195158,69.53,IS,0.23,0.0,Phase3-EA-S4v1-GBPJPY-M5-194,GBPJPYMT4,1564,5h 25m,Buy
80131.97,1.29099,29.03.2011 10:45:00,,0.0,-153.60999999998603,0.0,0.0,1.29111,29.03.2011 02:00:00,6380,-0.09020728590171052,-4.46,IS,0.34,0.0,Phase3-EA-S4v1-EURCHF-M15-221,EURCHFMT4,1580,8h 45m,Buy
80045.15,115541,29.03.2011 11:29:58,sl 115.541,-0.78,-240.42999999999302,0.0,0.0,114761,25.03.2011 08:00:00,6381,-0.14119222543681792,-86.82,IS,0.09,0.0,Phase3-EA-TR1v1-EURJPY-M30-91,EURJPYMT4,942,4d 3h 29m,Sell
79967.49,132145,30.03.2011 03:59:58,sl 132.145,-4.49,-318.0899999999965,0.0,0.0,131475,23.03.2011 16:00:00,6382,-0.18679796609906513,-77.66,IS,0.09,0.0,Phase3-EA-B1v1-GBPJPY-M30-1,GBPJPYMT4,666,6d 11h 59m,Sell
79919.58,0.92002,30.03.2011 04:30:00,,0.0,-366.0,0.0,0.0,0.92078,30.03.2011 00:15:00,6383,-0.2149330554002282,-47.91,IS,0.58,0.0,Phase3-EA-SA2v2-USDCHF-M15-107,USDCHFMT4,1268,4h 15m,Buy
80028.18,132245,30.03.2011 05:44:58,tp 132.245,0.0,-257.3999999999942,0.0,0.0,131855,30.03.2011 02:35:00,6384,-0.15115783732245214,108.6,IS,0.23,0.0,Phase3-EA-S4v1-GBPJPY-M5-194,GBPJPYMT4,1566,3h 9m,Buy
79913.08,1.30005,30.03.2011 06:10:00,,-2.23,-372.5,0.0,0.0,1.29751,29.03.2011 21:50:00,6385,-0.2187501725043306,-115.1,IS,0.41,0.0,Phase3-EA-SA2v2-EURCHF-M5-43,EURCHFMT4,3404,8h 20m,Sell
80049.44,116736,30.03.2011 07:29:58,tp 116.736,-0.54,-236.14000000001397,0.0,0.0,115476,29.03.2011 12:00:00,6386,-0.13867292814812265,136.36,IS,0.09,0.0,Phase3-EA-TR1v1-EURJPY-M30-91,EURJPYMT4,944,19h 29m,Buy
80396.99,116845,30.03.2011 07:59:58,tp 116.845,-1.01,-0.0,0.0,0.0,115145,29.03.2011 08:15:00,6387,-0.0,347.55,IS,0.17,0.0,Phase3-EA-T1v2-EURJPY-M15-322,EURJPYMT4,872,23h 44m,Buy
80380.41,1.29944,30.03.2011 12:00:00,,0.0,-16.579999999987194,0.0,0.0,1.29899,30.03.2011 03:15:00,6388,-0.009730218826040995,-16.58,IS,0.34,0.0,Phase3-EA-S4v1-EURCHF-M15-221,EURCHFMT4,1582,8h 45m,Sell
80330.01,82861,31.03.2011 01:15:00,,-2.83,-66.97999999998137,0.0,0.0,83007,30.03.2011 17:00:00,6389,-0.03930820608977973,-50.4,IS,0.27,0.0,Phase3-EA-S1v2-USDJPY-M15-0,USDJPYMT4,2062,8h 15m,Buy
80244.49,117457,31.03.2011 02:59:58,sl 117.457,-1.14,-152.4999999999709,0.0,0.0,116677,30.03.2011 09:30:00,6390,-0.08949688606586939,-85.52,IS,0.09,0.0,Phase3-EA-TR1v1-EURJPY-M30-91,EURJPYMT4,946,17h 29m,Sell
80307.58,0.91937,31.03.2011 02:59:58,tp 0.91937,0.0,-89.40999999997439,0.0,0.0,0.91837,31.03.2011 00:30:00,6391,-0.05247158415179422,63.09,IS,0.58,0.0,Phase3-EA-SA2v2-USDCHF-M15-107,USDCHFMT4,1270,2h 29m,Buy
80256.12,1.29701,31.03.2011 06:55:00,,-3.21,-140.86999999996624,0.0,0.0,1.29809,30.03.2011 22:35:00,6392,-0.08267164813179283,-51.46,IS,0.41,0.0,Phase3-EA-SA2v2-EURCHF-M5-43,EURCHFMT4,3406,8h 20m,Buy
80214.12,1.60505,31.03.2011 15:59:58,sl 1.60505,0.0,-182.86999999996624,0.0,0.0,1.60805,31.03.2011 03:00:00,6393,-0.10731997085157796,-42.0,IS,0.14,0.0,Phase3-EA-B1v1-GBPUSD-M30-14,GBPUSDMT4,416,12h 59m,Buy
80129.51,117933,31.03.2011 21:59:58,sl 117.933,0.0,-267.47999999995227,0.0,0.0,117153,31.03.2011 06:00:00,6394,-0.15697460383540357,-84.61,IS,0.09,0.0,Phase3-EA-TR1v1-EURJPY-M30-91,EURJPYMT4,948,15h 59m,Sell
80047.31,0.91942,01.04.2011 03:30:00,,-3.35,-349.6799999999639,0.0,0.0,0.91817,31.03.2011 23:15:00,6395,-0.20521489258698986,-82.2,IS,0.58,0.0,Phase3-EA-SA2v2-USDCHF-M15-107,USDCHFMT4,1272,4h 15m,Sell
79919.4,1.30261,01.04.2011 04:40:00,,-2.23,-477.5899999999674,0.0,0.0,1.29979,31.03.2011 20:20:00,6396,-0.28028077256527084,-127.91,IS,0.41,0.0,Phase3-EA-SA2v2-EURCHF-M5-43,EURCHFMT4,3408,8h 20m,Sell
80117.1,133987,01.04.2011 04:59:57,tp 133.987,-1.56,-279.88999999995576,0.0,0.0,132137,30.03.2011 04:00:00,6397,-0.16425759633427545,197.7,IS,0.09,0.0,Phase3-EA-B1v1-GBPJPY-M30-1,GBPJPYMT4,668,2d 0h 59m,Buy
79963.12,134.17,01.04.2011 07:20:00,,0.0,-433.86999999996624,0.0,0.0,133.61,01.04.2011 01:55:00,6398,-0.2546230423436272,-153.98,IS,0.23,0.0,Phase3-EA-S4v1-GBPJPY-M5-194,GBPJPYMT4,1568,5h 25m,Sell
79819.11,1.3057,01.04.2011 10:44:58,sl 1.30570,0.0,-577.8799999999756,0.0,0.0,1.3018,01.04.2011 02:30:00,6399,-0.3391374460311626,-144.01,IS,0.34,0.0,Phase3-EA-S4v1-EURCHF-M15-221,EURCHFMT4,1584,8h 14m,Sell
80161.5,119345,01.04.2011 17:59:58,tp 119.345,-1.0,-235.48999999996158,0.0,0.0,117645,31.03.2011 20:45:00,6400,-0.13820079803050603,342.39,IS,0.17,0.0,Phase3-EA-T1v2-EURJPY-M15-322,EURJPYMT4,874,21h 14m,Buy
80210.28,1.31534,01.04.2011 22:59:58,tp 1.31534,0.0,-186.70999999996275,0.0,0.0,1.31424,01.04.2011 22:35:00,6401,-0.10957353178595626,48.78,IS,0.41,0.0,Phase3-EA-SA2v2-EURCHF-M5-43,EURCHFMT4,3410,24m 58s,Buy
80289.11,84294,04.04.2011 01:15:00,,-0.93,-107.87999999997555,0.0,0.0,84045,01.04.2011 19:00:00,6402,-0.06331097750023373,78.83,IS,0.27,0.0,Phase3-EA-S1v2-USDJPY-M15-0,USDJPYMT4,2064,2d 6h 15m,Buy
80423.42,119824,04.04.2011 01:29:58,tp 119.824,-0.52,-0.0,0.0,0.0,118564,01.04.2011 06:30:00,6403,-0.0,134.31,IS,0.09,0.0,Phase3-EA-TR1v1-EURJPY-M30-91,EURJPYMT4,950,2d 18h 59m,Buy
80472.21,1.3151,04.04.2011 04:59:58,tp 1.31510,0.0,-0.0,0.0,0.0,1.3162,04.04.2011 01:25:00,6404,-0.0,48.79,IS,0.41,0.0,Phase3-EA-SA2v2-EURCHF-M5-43,EURCHFMT4,3412,3h 34m,Sell
80455.83,135.87,04.04.2011 06:55:00,,0.0,-16.380000000004657,0.0,0.0,135.81,04.04.2011 01:30:00,6405,-0.009608604241128013,-16.38,IS,0.23,0.0,Phase3-EA-S4v1-GBPJPY-M5-194,GBPJPYMT4,1570,5h 25m,Sell
80434.61,119698,04.04.2011 08:15:00,,0.0,-37.60000000000582,0.0,0.0,119803,04.04.2011 06:45:00,6406,-0.022056380919802596,-21.22,IS,0.17,0.0,Phase3-EA-T1v2-EURJPY-M15-322,EURJPYMT4,876,1h 30m,Buy
80388.13,119624,04.04.2011 09:59:58,sl 119.624,0.0,-84.0800000000163,0.0,0.0,119854,04.04.2011 09:15:00,6407,-0.0493218220142839,-46.48,IS,0.17,0.0,Phase3-EA-T1v2-EURJPY-M15-322,EURJPYMT4,878,44m 58s,Buy
80535.51,1.31219,04.04.2011 09:59:58,tp 1.31219,0.0,-0.0,0.0,0.0,1.31619,04.04.2011 01:30:00,6408,-0.0,147.38,IS,0.34,0.0,Phase3-EA-S4v1-EURCHF-M15-221,EURCHFMT4,1586,8h 29m,Sell
80598.29,0.92393,05.04.2011 02:59:58,tp 0.92393,0.0,-0.0,0.0,0.0,0.92293,05.04.2011 00:15:00,6409,-0.0,62.78,IS,0.58,0.0,Phase3-EA-SA2v2-USDCHF-M15-107,USDCHFMT4,1274,2h 44m,Buy
80644.92,1.31189,05.04.2011 03:54:57,tp 1.31189,-2.22,-0.0,0.0,0.0,1.31299,04.04.2011 22:35:00,6410,-0.0,46.63,IS,0.41,0.0,Phase3-EA-SA2v2-EURCHF-M5-43,EURCHFMT4,3414,5h 19m,Sell
80557.95,136004,05.04.2011 06:30:00,,0.0,-86.97000000000116,0.0,0.0,135685,05.04.2011 01:05:00,6411,-0.05096547849183037,-86.97,IS,0.23,0.0,Phase3-EA-S4v1-GBPJPY-M5-194,GBPJPYMT4,1572,5h 25m,Sell
80414.26,1.30788,05.04.2011 09:59:59,sl 1.30788,0.0,-230.6600000000035,0.0,0.0,1.31178,05.04.2011 05:30:00,6412,-0.13516956730971155,-143.69,IS,0.34,0.0,Phase3-EA-S4v1-EURCHF-M15-221,EURCHFMT4,1588,4h 29m,Buy
80610.98,136219,05.04.2011 10:59:58,tp 136.219,-0.78,-33.94000000000233,0.0,0.0,134369,01.04.2011 10:30:00,6413,-0.01988925307592064,196.72,IS,0.09,0.0,Phase3-EA-B1v1-GBPJPY-M30-1,GBPJPYMT4,670,4d 0h 29m,Buy
80527.54,120429,05.04.2011 18:29:58,sl 120.429,-0.37,-117.38000000000466,0.0,0.0,119649,04.04.2011 05:00:00,6414,-0.0687861086049351,-83.44,IS,0.09,0.0,Phase3-EA-TR1v1-EURJPY-M30-91,EURJPYMT4,952,1d 13h 29m,Sell
80722.94,138906,06.04.2011 03:59:58,tp 138.906,-0.38,-0.0,0.0,0.0,137056,05.04.2011 16:00:00,6415,-0.0,195.4,IS,0.09,0.0,Phase3-EA-B1v1-GBPJPY-M30-1,GBPJPYMT4,672,11h 59m,Buy
80507.16,139185,06.04.2011 04:29:57,sl 139.185,0.0,-215.77999999999884,0.0,0.0,138385,06.04.2011 00:45:00,6416,-0.1263919189770272,-215.78,IS,0.23,0.0,Phase3-EA-S4v1-GBPJPY-M5-194,GBPJPYMT4,1574,3h 44m,Sell
80845.57,121473,06.04.2011 04:29:58,tp 121.473,-0.98,-0.0,0.0,0.0,119773,05.04.2011 16:45:00,6417,-0.0,338.41,IS,0.17,0.0,Phase3-EA-T1v2-EURJPY-M15-322,EURJPYMT4,880,11h 44m,Buy
80626.49,1.32109,06.04.2011 04:44:57,sl 1.32109,-2.22,-219.0799999999872,0.0,0.0,1.31619,05.04.2011 20:40:00,6418,-0.12823276600030492,-219.08,IS,0.41,0.0,Phase3-EA-SA2v2-EURCHF-M5-43,EURCHFMT4,3416,8h 4m,Sell
80483.2,1.32023,06.04.2011 04:44:58,sl 1.32023,0.0,-362.36999999999534,0.0,0.0,1.31633,06.04.2011 02:45:00,6419,-0.21210383154798526,-143.29,IS,0.34,0.0,Phase3-EA-S4v1-EURCHF-M15-221,EURCHFMT4,1590,1h 59m,Sell
80615.76,121923,06.04.2011 09:59:58,tp 121.923,-0.52,-229.80999999999767,0.0,0.0,120663,05.04.2011 23:30:00,6420,-0.13451329174060386,132.56,IS,0.09,0.0,Phase3-EA-TR1v1-EURJPY-M30-91,EURJPYMT4,954,10h 29m,Buy
80762.78,1.31625,06.04.2011 10:29:58,tp 1.31625,0.0,-82.79000000000815,0.0,0.0,1.32025,06.04.2011 06:00:00,6421,-0.048458967943978956,147.02,IS,0.34,0.0,Phase3-EA-S4v1-EURCHF-M15-221,EURCHFMT4,1592,4h 29m,Sell
80691.88,138829,06.04.2011 11:29:57,sl 138.829,0.0,-153.69000000000233,0.0,0.0,139499,06.04.2011 07:00:00,6422,-0.08995843439194957,-70.9,IS,0.09,0.0,Phase3-EA-B1v1-GBPJPY-M30-1,GBPJPYMT4,674,4h 29m,Buy
80683.89,121705,06.04.2011 14:30:00,,0.0,-161.67999999999302,0.0,0.0,121745,06.04.2011 13:45:00,6423,-0.09463517257134205,-7.99,IS,0.17,0.0,Phase3-EA-T1v2-EURJPY-M15-322,EURJPYMT4,882,45m 0s,Buy
80601.76,122384,06.04.2011 17:59:59,sl 122.384,0.0,-243.80999999999767,0.0,0.0,121604,06.04.2011 11:00:00,6424,-0.14270782672327859,-82.13,IS,0.09,0.0,Phase3-EA-TR1v1-EURJPY-M30-91,EURJPYMT4,956,6h 59m,Sell
80640.98,85374,06.04.2011 21:30:00,,0.0,-204.5899999999965,0.0,0.0,85.25,06.04.2011 19:15:00,6425,-0.11975142229324205,39.22,IS,0.27,0.0,Phase3-EA-S1v2-USDJPY-M15-0,USDJPYMT4,2066,2h 15m,Buy
80683.41,1.31616,07.04.2011 01:19:59,tp 1.31616,-6.69,-162.1600000000035,0.0,0.0,1.31726,06.04.2011 21:50:00,6426,-0.09491612805646846,42.43,IS,0.41,0.0,Phase3-EA-SA2v2-EURCHF-M5-43,EURCHFMT4,3418,3h 29m,Sell
80708.75,0.9181,07.04.2011 02:30:00,,-10.04,-136.82000000000698,0.0,0.0,0.91866,06.04.2011 22:15:00,6427,-0.08008401973782929,25.34,IS,0.58,0.0,Phase3-EA-SA2v2-USDCHF-M15-107,USDCHFMT4,1276,4h 15m,Sell
80799.81,139123,07.04.2011 04:35:00,,-4.68,-45.76000000000931,0.0,0.0,139478,06.04.2011 23:10:00,6428,-0.02678442291480505,91.06,IS,0.23,0.0,Phase3-EA-S4v1-GBPJPY-M5-194,GBPJPYMT4,1576,5h 25m,Sell
80722.26,121709,07.04.2011 08:29:58,sl 121.709,-1.55,-123.30999999999767,0.0,0.0,122211,06.04.2011 19:30:00,6429,-0.07217629347954274,-77.55,IS,0.09,0.0,Phase3-EA-TR1v1-EURJPY-M30-91,EURJPYMT4,958,12h 59m,Sell
80503.27,1.31108,07.04.2011 09:34:57,sl 1.31108,0.0,-342.29999999998836,0.0,0.0,1.31598,07.04.2011 01:25:00,6430,-0.20035638032638967,-218.99,IS,0.41,0.0,Phase3-EA-SA2v2-EURCHF-M5-43,EURCHFMT4,3420,8h 9m,Buy
80358.73,1.31154,07.04.2011 09:44:57,sl 1.31154,0.0,-486.8399999999965,0.0,0.0,1.31544,07.04.2011 03:15:00,6431,-0.2849591007832374,-144.54,IS,0.34,0.0,Phase3-EA-S4v1-EURCHF-M15-221,EURCHFMT4,1594,6h 29m,Buy
80286.69,138651,07.04.2011 13:59:58,sl 138.651,-1.14,-558.8800000000047,0.0,0.0,139321,06.04.2011 20:30:00,6432,-0.32712583650837684,-72.04,IS,0.09,0.0,Phase3-EA-B1v1-GBPJPY-M30-1,GBPJPYMT4,676,17h 29m,Buy
80244.69,1.63068,07.04.2011 14:29:58,sl 1.63068,0.0,-600.8800000000047,0.0,0.0,1.63368,07.04.2011 12:00:00,6433,-0.35170944145640093,-42.0,IS,0.14,0.0,Phase3-EA-B1v1-GBPUSD-M30-14,GBPUSDMT4,418,2h 29m,Buy
80168.71,122098,07.04.2011 15:59:57,sl 122.098,0.0,-676.8600000000151,0.0,0.0,122429,06.04.2011 23:00:00,6434,-0.39618235345523733,-75.98,IS,0.09,0.0,Phase3-EA-TR1v1-EURJPY-M30-91,EURJPYMT4,959,16h 59m,Buy
80304.38,120921,07.04.2011 18:59:57,tp 120.921,-1.11,-541.1900000000023,0.0,0.0,121378,07.04.2011 13:30:00,6435,-0.3167714562338387,135.67,IS,0.09,0.0,Phase3-EA-TR1v1-EURJPY-M30-91,EURJPYMT4,961,5h 29m,Sell
80357.99,84865,08.04.2011 00:15:00,,-1.43,-487.5800000000163,0.0,0.0,85038,07.04.2011 23:45:00,6436,-0.2853922404894761,53.61,IS,0.27,0.0,Phase3-EA-S1v2-USDJPY-M15-0,USDJPYMT4,2068,30m 0s,Sell
80311.97,121598,08.04.2011 03:44:58,sl 121.598,0.0,-533.6000000000058,0.0,0.0,121368,08.04.2011 02:45:00,6437,-0.3123288476253763,-46.02,IS,0.17,0.0,Phase3-EA-T1v2-EURJPY-M15-322,EURJPYMT4,884,59m 58s,Sell
80094.67,139557,08.04.2011 05:04:58,sl 139.557,-1.57,-750.8999999999942,0.0,0.0,138757,07.04.2011 23:50:00,6438,-0.4395197370350276,-217.3,IS,0.23,0.0,Phase3-EA-S4v1-GBPJPY-M5-194,GBPJPYMT4,1578,5h 14m,Sell
80055.09,1.31123,08.04.2011 07:55:00,,-2.24,-790.4799999999814,0.0,0.0,1.3104,07.04.2011 23:35:00,6439,-0.46268685807889615,-39.58,IS,0.41,0.0,Phase3-EA-SA2v2-EURCHF-M5-43,EURCHFMT4,3422,8h 20m,Sell
80050.01,85008,08.04.2011 09:45:00,,0.0,-795.5599999999686,0.0,0.0,84992,08.04.2011 00:30:00,6440,-0.4656603036297449,-5.08,IS,0.27,0.0,Phase3-EA-S1v2-USDJPY-M15-0,USDJPYMT4,2070,9h 15m,Sell
79904.59,1.3161,08.04.2011 10:59:58,sl 1.31610,0.0,-940.9799999999814,0.0,0.0,1.3122,08.04.2011 05:00:00,6441,-0.5507781091426492,-145.42,IS,0.34,0.0,Phase3-EA-S4v1-EURCHF-M15-221,EURCHFMT4,1596,5h 59m,Sell
79954.16,1.31497,08.04.2011 22:49:58,tp 1.31497,0.0,-891.4099999999744,0.0,0.0,1.31387,08.04.2011 22:10:00,6442,-0.5217636020647033,49.57,IS,0.41,0.0,Phase3-EA-SA2v2-EURCHF-M5-43,EURCHFMT4,3424,39m 58s,Buy
80003.8,1.31386,08.04.2011 23:39:58,tp 1.31386,0.0,-841.7699999999604,0.0,0.0,1.31496,08.04.2011 23:15:00,6443,-0.49270812231183997,49.64,IS,0.41,0.0,Phase3-EA-SA2v2-EURCHF-M5-43,EURCHFMT4,3426,24m 58s,Sell
80053.44,1.31494,11.04.2011 03:09:58,tp 1.31494,0.0,-792.1299999999464,0.0,0.0,1.31604,11.04.2011 02:45:00,6444,-0.46365264255897665,49.64,IS,0.41,0.0,Phase3-EA-SA2v2-EURCHF-M5-43,EURCHFMT4,3428,24m 58s,Sell
80158.97,139.03,11.04.2011 03:19:58,tp 139.030,0.0,-686.5999999999476,0.0,0.0,139.42,11.04.2011 02:50:00,6445,-0.4018834085074301,105.53,IS,0.23,0.0,Phase3-EA-S4v1-GBPJPY-M5-194,GBPJPYMT4,1580,29m 58s,Sell
80112.99,122668,11.04.2011 03:59:57,sl 122.668,0.0,-732.5799999999581,0.0,0.0,122898,11.04.2011 01:15:00,6446,-0.4287966026862493,-45.98,IS,0.17,0.0,Phase3-EA-T1v2-EURJPY-M15-322,EURJPYMT4,886,2h 44m,Buy
80153.77,1.31388,11.04.2011 13:30:00,,0.0,-691.7999999999593,0.0,0.0,1.31279,11.04.2011 04:45:00,6447,-0.40492709292957324,40.78,IS,0.34,0.0,Phase3-EA-S4v1-EURCHF-M15-221,EURCHFMT4,1598,8h 45m,Buy
80202.42,1.30882,12.04.2011 01:19:58,tp 1.30882,-1.09,-643.1499999999651,0.0,0.0,1.30772,11.04.2011 20:05:00,6448,-0.37645108386478204,48.65,IS,0.41,0.0,Phase3-EA-SA2v2-EURCHF-M5-43,EURCHFMT4,3430,5h 14m,Buy
80252.13,1.30771,12.04.2011 02:39:57,tp 1.30771,0.0,-593.4399999999732,0.0,0.0,1.30881,12.04.2011 01:25:00,6449,-0.3473546314370183,49.71,IS,0.41,0.0,Phase3-EA-SA2v2-EURCHF-M5-43,EURCHFMT4,3432,1h 14m,Sell
80257.7,0.90626,12.04.2011 03:00:00,,-3.39,-587.8699999999662,0.0,0.0,0.9064,11.04.2011 22:45:00,6450,-0.34409437716176433,5.57,IS,0.58,0.0,Phase3-EA-SA2v2-USDCHF-M15-107,USDCHFMT4,1278,4h 15m,Sell
80394.7,121339,12.04.2011 04:29:57,tp 121.339,-0.74,-450.86999999996624,0.0,0.0,122629,08.04.2011 19:30:00,6451,-0.26390499911701903,137.0,IS,0.09,0.0,Phase3-EA-TR1v1-EURJPY-M30-91,EURJPYMT4,964,3d 8h 59m,Sell
80176.1,137056,12.04.2011 05:24:58,sl 137.056,0.0,-669.4699999999721,0.0,0.0,137856,12.04.2011 02:55:00,6452,-0.3918568096322146,-218.6,IS,0.23,0.0,Phase3-EA-S4v1-GBPJPY-M5-194,GBPJPYMT4,1582,2h 29m,Buy
80029.76,1.30358,12.04.2011 06:14:57,sl 1.30358,0.0,-815.8099999999686,0.0,0.0,1.30748,12.04.2011 03:15:00,6453,-0.4775131131582565,-146.34,IS,0.34,0.0,Phase3-EA-S4v1-EURCHF-M15-221,EURCHFMT4,1600,2h 59m,Buy
80376.02,120357,12.04.2011 06:29:58,tp 120.357,0.0,-469.54999999995925,0.0,0.0,122057,12.04.2011 02:15:00,6454,-0.27483885007961234,346.26,IS,0.17,0.0,Phase3-EA-T1v2-EURJPY-M15-322,EURJPYMT4,888,4h 14m,Sell
80514.27,122147,12.04.2011 16:29:58,tp 122.147,0.0,-331.29999999995925,0.0,0.0,120857,12.04.2011 08:00:00,6455,-0.19391781712569964,138.25,IS,0.09,0.0,Phase3-EA-TR1v1-EURJPY-M30-91,EURJPYMT4,966,8h 29m,Buy
80467.57,121138,12.04.2011 18:44:59,sl 121.138,0.0,-377.9999999999709,0.0,0.0,120908,12.04.2011 18:30:00,6456,-0.22125244453219992,-46.7,IS,0.17,0.0,Phase3-EA-T1v2-EURJPY-M15-322,EURJPYMT4,890,14m 59s,Sell
80517.88,1.29846,12.04.2011 21:49:57,tp 1.29846,0.0,-327.6899999999732,0.0,0.0,1.29956,12.04.2011 21:35:00,6457,-0.1918047977480324,50.31,IS,0.41,0.0,Phase3-EA-SA2v2-EURCHF-M5-43,EURCHFMT4,3434,14m 57s,Sell
80624.67,136406,13.04.2011 04:09:58,tp 136.406,0.0,-220.89999999996508,0.0,0.0,136796,13.04.2011 03:50:00,6458,-0.1292980555480397,106.79,IS,0.23,0.0,Phase3-EA-S4v1-GBPJPY-M5-194,GBPJPYMT4,1584,19m 58s,Sell
80576.57,1.30109,13.04.2011 12:15:00,,0.0,-268.9999999999709,0.0,0.0,1.29982,13.04.2011 03:30:00,6459,-0.15745213645280404,-48.1,IS,0.34,0.0,Phase3-EA-S4v1-EURCHF-M15-221,EURCHFMT4,1602,8h 45m,Sell
80585.75,83784,14.04.2011 02:15:00,,-4.35,-259.8199999999779,0.0,0.0,83826,13.04.2011 22:00:00,6460,-0.15207886279988286,9.18,IS,0.27,0.0,Phase3-EA-S1v2-USDJPY-M15-0,USDJPYMT4,2072,4h 15m,Sell
80467.6,135746,14.04.2011 05:00:00,,-2.96,-377.96999999997206,0.0,0.0,136164,13.04.2011 23:35:00,6461,-0.22123488481438058,-118.15,IS,0.23,0.0,Phase3-EA-S4v1-GBPJPY-M5-194,GBPJPYMT4,1586,5h 25m,Buy
80518.04,1.29543,14.04.2011 08:04:58,tp 1.29543,0.0,-327.52999999996973,0.0,0.0,1.29433,14.04.2011 02:15:00,6462,-0.19171114591965693,50.44,IS,0.41,0.0,Phase3-EA-SA2v2-EURCHF-M5-43,EURCHFMT4,3436,5h 49m,Buy
80475.4,1.29255,14.04.2011 12:15:00,,0.0,-370.1699999999837,0.0,0.0,1.29367,14.04.2011 03:30:00,6463,-0.21666935818118294,-42.64,IS,0.34,0.0,Phase3-EA-S4v1-EURCHF-M15-221,EURCHFMT4,1604,8h 45m,Buy
80390.93,120.16,14.04.2011 12:59:58,sl 120.160,0.0,-454.63999999998487,0.0,0.0,120.94,14.04.2011 08:00:00,6464,-0.26611167032307875,-84.47,IS,0.09,0.0,Phase3-EA-TR1v1-EURJPY-M30-91,EURJPYMT4,968,4h 59m,Buy
80288.64,83545,15.04.2011 06:00:00,,-1.46,-556.929999999993,0.0,0.0,83233,14.04.2011 17:30:00,6465,-0.3259844548500689,-102.29,IS,0.27,0.0,Phase3-EA-S1v2-USDJPY-M15-0,USDJPYMT4,2074,12h 30m,Sell
80266.15,1.29317,15.04.2011 06:05:00,,-2.3,-579.4199999999837,0.0,0.0,1.29273,14.04.2011 21:45:00,6466,-0.33914838997580304,-22.49,IS,0.41,0.0,Phase3-EA-SA2v2-EURCHF-M5-43,EURCHFMT4,3438,8h 20m,Sell
80373.56,136321,15.04.2011 06:09:58,tp 136.321,0.0,-472.0099999999802,0.0,0.0,136711,15.04.2011 01:30:00,6467,-0.276278746940866,107.41,IS,0.23,0.0,Phase3-EA-S4v1-GBPJPY-M5-194,GBPJPYMT4,1588,4h 39m,Sell
80295.87,120602,15.04.2011 06:59:57,sl 120.602,0.0,-549.6999999999825,0.0,0.0,120219,14.04.2011 18:00:00,6468,-0.32175256285543863,-77.69,IS,0.09,0.0,Phase3-EA-TR1v1-EURJPY-M30-91,EURJPYMT4,970,12h 59m,Buy
80402.95,1.29056,15.04.2011 12:00:00,,0.0,-442.61999999999534,0.0,0.0,1.29337,15.04.2011 03:15:00,6469,-0.2590760767165313,107.08,IS,0.34,0.0,Phase3-EA-S4v1-EURCHF-M15-221,EURCHFMT4,1606,8h 45m,Sell
80434.47,83077,15.04.2011 21:00:00,,0.0,-411.1000000000058,0.0,0.0,83174,15.04.2011 20:15:00,6470,-0.2406266665269727,31.52,IS,0.27,0.0,Phase3-EA-S1v2-USDJPY-M15-0,USDJPYMT4,2076,45m 0s,Sell
80484.96,1.28961,15.04.2011 21:44:58,tp 1.28961,0.0,-360.61000000001513,0.0,0.0,1.28851,15.04.2011 21:20:00,6471,-0.21107366143588918,50.49,IS,0.41,0.0,Phase3-EA-SA2v2-EURCHF-M5-43,EURCHFMT4,3440,24m 58s,Buy
80592.9,135389,18.04.2011 02:59:57,tp 135.389,0.0,-252.6700000000128,0.0,0.0,135779,18.04.2011 02:10:00,6472,-0.14789379671946584,107.94,IS,0.23,0.0,Phase3-EA-S4v1-GBPJPY-M5-194,GBPJPYMT4,1590,49m 57s,Sell
80657.03,0.89356,18.04.2011 03:14:58,tp 0.89356,-0.78,-188.54000000000815,0.0,0.0,0.89256,15.04.2011 23:15:00,6473,-0.11035697325953965,64.13,IS,0.58,0.0,Phase3-EA-SA2v2-USDCHF-M15-107,USDCHFMT4,1280,2d 3h 59m,Buy
80571.57,119439,18.04.2011 03:59:58,sl 119.439,-1.06,-274.0,0.0,0.0,121322,15.04.2011 03:00:00,6474,-0.1603787560894906,-85.46,IS,0.09,0.0,Phase3-EA-TR1v1-EURJPY-M30-91,EURJPYMT4,971,3d 0h 59m,Buy
80464.03,1.28546,18.04.2011 07:15:00,,-1.1,-381.54000000000815,0.0,0.0,1.28778,15.04.2011 22:55:00,6475,-0.22332449123498377,-107.54,IS,0.41,0.0,Phase3-EA-SA2v2-EURCHF-M5-43,EURCHFMT4,3442,2d 8h 20m,Buy
80316.13,1.28261,18.04.2011 10:44:57,sl 1.28261,0.0,-529.4400000000023,0.0,0.0,1.28651,18.04.2011 02:30:00,6476,-0.30989390008766526,-147.9,IS,0.34,0.0,Phase3-EA-S4v1-EURCHF-M15-221,EURCHFMT4,1608,8h 14m,Buy
80231.45,118526,18.04.2011 11:59:58,sl 118.526,0.0,-614.1199999999953,0.0,0.0,119306,18.04.2011 07:30:00,6477,-0.35945913025429643,-84.68,IS,0.09,0.0,Phase3-EA-TR1v1-EURJPY-M30-91,EURJPYMT4,974,4h 29m,Buy
80434.01,133075,18.04.2011 18:29:57,tp 133.075,0.0,-411.5599999999977,0.0,0.0,134925,18.04.2011 04:30:00,6478,-0.24089591553354153,202.56,IS,0.09,0.0,Phase3-EA-B1v1-GBPJPY-M30-1,GBPJPYMT4,678,13h 59m,Sell
80571.97,116564,18.04.2011 18:29:57,tp 116.564,0.0,-273.6000000000058,0.0,0.0,117824,18.04.2011 17:00:00,6479,-0.16014462651856046,137.96,IS,0.09,0.0,Phase3-EA-TR1v1-EURJPY-M30-91,EURJPYMT4,976,1h 29m,Sell
80529.97,1.62272,18.04.2011 18:59:58,sl 1.62272,0.0,-315.6000000000058,0.0,0.0,1.61972,18.04.2011 18:00:00,6480,-0.18472823146658454,-42.0,IS,0.14,0.0,Phase3-EA-B1v1-GBPUSD-M30-14,GBPUSDMT4,420,59m 58s,Sell
80580.21,1.27719,18.04.2011 21:29:57,tp 1.27719,0.0,-265.36000000001513,0.0,0.0,1.27829,18.04.2011 21:05:00,6481,-0.1553215573573345,50.24,IS,0.41,0.0,Phase3-EA-SA2v2-EURCHF-M5-43,EURCHFMT4,3444,24m 57s,Sell
80501.7,117658,18.04.2011 21:59:58,sl 117.658,0.0,-343.87000000002445,0.0,0.0,116938,18.04.2011 18:30:00,6482,-0.20127533889232502,-78.51,IS,0.09,0.0,Phase3-EA-TR1v1-EURJPY-M30-91,EURJPYMT4,978,3h 29m,Sell
80554.0,82349,19.04.2011 02:00:00,,-1.47,-291.5700000000361,0.0,0.0,82513,18.04.2011 21:15:00,6483,-0.17066289749276847,52.3,IS,0.27,0.0,Phase3-EA-S1v2-USDJPY-M15-0,USDJPYMT4,2078,4h 45m,Sell
80529.27,0.89609,19.04.2011 03:15:00,,-0.78,-316.30000000004657,0.0,0.0,0.89646,18.04.2011 23:00:00,6484,-0.18513795821574214,-24.73,IS,0.58,0.0,Phase3-EA-SA2v2-USDCHF-M15-107,USDCHFMT4,1282,4h 15m,Buy
80481.89,117458,19.04.2011 05:59:58,sl 117.458,0.0,-363.6800000000512,0.0,0.0,117228,19.04.2011 05:15:00,6485,-0.2128706058928254,-47.38,IS,0.17,0.0,Phase3-EA-T1v2-EURJPY-M15-322,EURJPYMT4,892,44m 58s,Sell
80436.74,134036,19.04.2011 06:25:00,,0.0,-408.8300000000454,0.0,0.0,134198,19.04.2011 01:00:00,6486,-0.2392979812119479,-45.15,IS,0.23,0.0,Phase3-EA-S4v1-GBPJPY-M5-194,GBPJPYMT4,1592,5h 25m,Buy
80361.06,1.27461,19.04.2011 07:10:00,,-1.1,-484.5100000000384,0.0,0.0,1.27624,18.04.2011 22:50:00,6487,-0.28359529603257394,-75.68,IS,0.41,0.0,Phase3-EA-SA2v2-EURCHF-M5-43,EURCHFMT4,3446,8h 20m,Buy
80420.95,1.27626,19.04.2011 10:15:00,,0.0,-424.62000000002445,0.0,0.0,1.27468,19.04.2011 01:30:00,6488,-0.24854024602453803,59.89,IS,0.34,0.0,Phase3-EA-S4v1-EURCHF-M15-221,EURCHFMT4,1610,8h 45m,Buy
80428.16,82425,19.04.2011 22:15:00,,0.0,-417.4100000000326,0.0,0.0,82447,19.04.2011 21:45:00,6489,-0.24432006050846533,7.21,IS,0.27,0.0,Phase3-EA-S1v2-USDJPY-M15-0,USDJPYMT4,2080,30m 0s,Sell
80292.97,1.29208,20.04.2011 04:40:00,,-2.28,-552.6000000000349,0.0,0.0,1.28917,19.04.2011 20:20:00,6490,-0.32345000224473763,-135.19,IS,0.41,0.0,Phase3-EA-SA2v2-EURCHF-M5-43,EURCHFMT4,3448,8h 20m,Sell
80071.33,135695,20.04.2011 06:24:58,sl 135.695,0.0,-774.2400000000489,0.0,0.0,134895,20.04.2011 02:20:00,6491,-0.453181197499033,-221.64,IS,0.23,0.0,Phase3-EA-S4v1-GBPJPY-M5-194,GBPJPYMT4,1594,4h 4m,Sell
79956.34,82771,20.04.2011 10:45:00,,-1.47,-889.2300000000396,0.0,0.0,82423,19.04.2011 22:15:00,6492,-0.5204875959031535,-114.99,IS,0.27,0.0,Phase3-EA-S1v2-USDJPY-M15-0,USDJPYMT4,2082,12h 30m,Sell
80093.48,120357,20.04.2011 13:59:58,tp 120.357,0.0,-752.0900000000256,0.0,0.0,119097,20.04.2011 04:30:00,6493,-0.4402162725085733,137.14,IS,0.09,0.0,Phase3-EA-TR1v1-EURJPY-M30-91,EURJPYMT4,980,9h 29m,Buy
80014.87,119399,20.04.2011 16:59:57,sl 119.399,0.0,-830.7000000000116,0.0,0.0,120119,20.04.2011 14:00:00,6494,-0.48622858643628364,-78.61,IS,0.09,0.0,Phase3-EA-TR1v1-EURJPY-M30-91,EURJPYMT4,982,2h 59m,Buy
80065.53,1.29148,20.04.2011 20:54:57,tp 1.29148,0.0,-780.0400000000081,0.0,0.0,1.29038,20.04.2011 20:45:00,6495,-0.4565760762775458,50.66,IS,0.41,0.0,Phase3-EA-SA2v2-EURCHF-M5-43,EURCHFMT4,3450,9m 57s,Buy
80174.49,135009,21.04.2011 03:09:58,tp 135.009,0.0,-671.0800000000163,0.0,0.0,135399,21.04.2011 00:10:00,6496,-0.39279918115524803,108.96,IS,0.23,0.0,Phase3-EA-S4v1-GBPJPY-M5-194,GBPJPYMT4,1596,2h 59m,Sell
79948.33,1.29494,21.04.2011 08:24:57,sl 1.29494,0.0,-897.2400000000198,0.0,0.0,1.29004,21.04.2011 02:40:00,6497,-0.5251760405610866,-226.16,IS,0.41,0.0,Phase3-EA-SA2v2-EURCHF-M5-43,EURCHFMT4,3452,5h 44m,Sell
80211.33,1.65205,21.04.2011 11:59:58,tp 1.65205,-1.6,-634.2400000000198,0.0,0.0,1.63315,20.04.2011 04:30:00,6498,-0.37123584767226897,263.0,IS,0.14,0.0,Phase3-EA-B1v1-GBPUSD-M30-14,GBPUSDMT4,422,1d 7h 29m,Buy
80365.42,1.2889,21.04.2011 14:44:58,tp 1.28890,0.0,-480.1500000000233,0.0,0.0,1.2929,21.04.2011 06:45:00,6499,-0.28104328370938925,154.09,IS,0.34,0.0,Phase3-EA-S4v1-EURCHF-M15-221,EURCHFMT4,1612,7h 59m,Sell
80297.81,0.88619,22.04.2011 02:15:00,,-3.47,-547.7600000000093,0.0,0.0,0.88521,21.04.2011 22:00:00,6500,-0.32061703443642653,-67.61,IS,0.58,0.0,Phase3-EA-SA2v2-USDCHF-M15-107,USDCHFMT4,1284,4h 15m,Sell
80291.71,81827,22.04.2011 03:15:00,,-1.48,-553.8600000000151,0.0,0.0,81813,21.04.2011 21:00:00,6501,-0.32418751039316673,-6.1,IS,0.27,0.0,Phase3-EA-S1v2-USDJPY-M15-0,USDJPYMT4,2084,6h 15m,Sell
80401.46,134859,22.04.2011 04:14:58,tp 134.859,0.0,-444.11000000001513,0.0,0.0,135249,22.04.2011 01:10:00,6502,-0.25994820936827046,109.75,IS,0.23,0.0,Phase3-EA-S4v1-GBPJPY-M5-194,GBPJPYMT4,1598,3h 4m,Sell
80280.69,1.28987,22.04.2011 04:40:00,,-2.31,-564.8800000000047,0.0,0.0,1.28731,21.04.2011 20:20:00,6503,-0.33063778007238026,-120.77,IS,0.41,0.0,Phase3-EA-SA2v2-EURCHF-M5-43,EURCHFMT4,3454,8h 20m,Sell
80197.41,1.29172,22.04.2011 10:15:00,,0.0,-648.1600000000035,0.0,0.0,1.28955,22.04.2011 01:30:00,6504,-0.3793835567407474,-83.28,IS,0.34,0.0,Phase3-EA-S4v1-EURCHF-M15-221,EURCHFMT4,1614,8h 45m,Sell
80248.31,1.2887,22.04.2011 21:59:58,tp 1.28870,0.0,-597.2600000000093,0.0,0.0,1.2876,22.04.2011 21:10:00,6505,-0.34959056883945494,50.9,IS,0.41,0.0,Phase3-EA-SA2v2-EURCHF-M5-43,EURCHFMT4,3456,49m 58s,Buy
80299.2,1.28841,25.04.2011 06:04:57,tp 1.28841,0.0,-546.3699999999953,0.0,0.0,1.28951,25.04.2011 01:05:00,6506,-0.3198034341774242,50.89,IS,0.41,0.0,Phase3-EA-SA2v2-EURCHF-M5-43,EURCHFMT4,3458,4h 59m,Sell
80281.56,135619,25.04.2011 07:50:00,,0.0,-564.0100000000093,0.0,0.0,135556,25.04.2011 02:25:00,6507,-0.3301285482556025,-17.64,IS,0.23,0.0,Phase3-EA-S4v1-GBPJPY-M5-194,GBPJPYMT4,1600,5h 25m,Sell
80414.2,1.28726,25.04.2011 13:15:00,,0.0,-431.36999999999534,0.0,0.0,1.2907,25.04.2011 04:30:00,6508,-0.25249118253402486,132.64,IS,0.34,0.0,Phase3-EA-S4v1-EURCHF-M15-221,EURCHFMT4,1616,8h 45m,Sell
80334.93,119101,25.04.2011 22:59:58,sl 119.101,0.0,-510.63999999998487,0.0,0.0,119821,25.04.2011 04:00:00,6509,-0.2988898102537776,-79.27,IS,0.09,0.0,Phase3-EA-TR1v1-EURJPY-M30-91,EURJPYMT4,984,18h 59m,Buy
80443.45,135138,26.04.2011 01:49:57,tp 135.138,-1.01,-402.11999999999534,0.0,0.0,134748,25.04.2011 23:00:00,6510,-0.2353704576595081,108.52,IS,0.23,0.0,Phase3-EA-S4v1-GBPJPY-M5-194,GBPJPYMT4,1602,2h 49m,Buy
80492.29,1.28329,26.04.2011 02:29:57,tp 1.28329,-2.33,-353.27999999999884,0.0,0.0,1.28439,25.04.2011 22:15:00,6511,-0.20678323704852208,48.84,IS,0.41,0.0,Phase3-EA-SA2v2-EURCHF-M5-43,EURCHFMT4,3460,4h 14m,Sell
80543.31,1.28472,26.04.2011 04:19:58,tp 1.28472,0.0,-302.2600000000093,0.0,0.0,1.28362,26.04.2011 02:30:00,6512,-0.17692001027595228,51.02,IS,0.41,0.0,Phase3-EA-SA2v2-EURCHF-M5-43,EURCHFMT4,3462,1h 49m,Buy
80505.3,134407,26.04.2011 08:50:00,,0.0,-340.2700000000186,0.0,0.0,134542,26.04.2011 03:25:00,6513,-0.19916817275391954,-38.01,IS,0.23,0.0,Phase3-EA-S4v1-GBPJPY-M5-194,GBPJPYMT4,1604,5h 25m,Buy
80417.08,1.28082,26.04.2011 12:15:00,,0.0,-428.4900000000198,0.0,0.0,1.28309,26.04.2011 03:30:00,6514,-0.2508054496233175,-88.22,IS,0.34,0.0,Phase3-EA-S4v1-EURCHF-M15-221,EURCHFMT4,1618,8h 45m,Buy
80375.08,1.64794,26.04.2011 13:29:57,sl 1.64794,0.0,-470.4900000000198,0.0,0.0,1.65094,26.04.2011 11:00:00,6515,-0.2753890545713416,-42.0,IS,0.14,0.0,Phase3-EA-B1v1-GBPUSD-M30-14,GBPUSDMT4,424,2h 29m,Buy
80143.65,1.27756,27.04.2011 01:19:58,sl 1.27756,-1.12,-701.9200000000128,0.0,0.0,1.28246,26.04.2011 23:05:00,6516,-0.41085057107422374,-231.43,IS,0.41,0.0,Phase3-EA-SA2v2-EURCHF-M5-43,EURCHFMT4,3464,2h 14m,Buy
79883.82,0.87056,27.04.2011 01:29:58,sl 0.87056,0.0,-961.75,0.0,0.0,0.87446,27.04.2011 00:30:00,6517,-0.5629352871133854,-259.83,IS,0.58,0.0,Phase3-EA-SA2v2-USDCHF-M15-107,USDCHFMT4,1286,59m 58s,Buy
79935.68,1.27779,27.04.2011 01:59:58,tp 1.27779,0.0,-909.890000000014,0.0,0.0,1.27669,27.04.2011 01:25:00,6518,-0.532580388241857,51.86,IS,0.41,0.0,Phase3-EA-SA2v2-EURCHF-M5-43,EURCHFMT4,3466,34m 58s,Buy
80091.51,1.28212,27.04.2011 08:44:58,tp 1.28212,0.0,-754.0600000000268,0.0,0.0,1.27812,27.04.2011 02:00:00,6519,-0.4413693606454218,155.83,IS,0.34,0.0,Phase3-EA-S4v1-EURCHF-M15-221,EURCHFMT4,1620,6h 44m,Buy
80017.08,135.33,27.04.2011 11:59:57,sl 135.330,-0.64,-828.4900000000198,0.0,0.0,134.66,26.04.2011 03:00:00,6520,-0.4849350205568804,-74.43,IS,0.09,0.0,Phase3-EA-B1v1-GBPJPY-M30-1,GBPJPYMT4,680,1d 8h 59m,Sell
80158.17,120432,27.04.2011 12:59:58,tp 120.432,-0.54,-687.4000000000233,0.0,0.0,119142,26.04.2011 10:30:00,6521,-0.4023516676493415,141.09,IS,0.09,0.0,Phase3-EA-TR1v1-EURJPY-M30-91,EURJPYMT4,986,1d 2h 29m,Buy
80209.56,1.29,27.04.2011 20:04:57,tp 1.29000,0.0,-636.0100000000093,0.0,0.0,1.2889,27.04.2011 20:00:00,6522,-0.37227187102364384,51.39,IS,0.41,0.0,Phase3-EA-SA2v2-EURCHF-M5-43,EURCHFMT4,3468,4m 57s,Buy
80260.94,1.29133,27.04.2011 21:29:59,tp 1.29133,0.0,-584.6300000000047,0.0,0.0,1.29243,27.04.2011 20:55:00,6523,-0.34219792763722495,51.38,IS,0.41,0.0,Phase3-EA-SA2v2-EURCHF-M5-43,EURCHFMT4,3470,34m 59s,Sell
80312.47,1291,27.04.2011 22:14:59,tp 1.29100,0.0,-533.1000000000058,0.0,0.0,1.2921,27.04.2011 22:00:00,6524,-0.3120361856617094,51.53,IS,0.41,0.0,Phase3-EA-SA2v2-EURCHF-M5-43,EURCHFMT4,3472,14m 59s,Sell
80664.84,121412,27.04.2011 23:14:58,tp 121.412,0.0,-180.73000000001048,0.0,0.0,119712,27.04.2011 01:45:00,6525,-0.1057855933870632,352.37,IS,0.17,0.0,Phase3-EA-T1v2-EURJPY-M15-322,EURJPYMT4,894,21h 29m,Buy
80728.72,0.87525,28.04.2011 00:44:58,tp 0.87525,-2.39,-116.85000000000582,0.0,0.0,0.87425,27.04.2011 22:45:00,6526,-0.06839510090897048,63.88,IS,0.58,0.0,Phase3-EA-SA2v2-USDCHF-M15-107,USDCHFMT4,1288,1h 59m,Buy
80780.5,1.29215,28.04.2011 04:54:57,tp 1.29215,0.0,-65.07000000000698,0.0,0.0,1.29325,28.04.2011 00:20:00,6527,-0.03808702795162144,51.78,IS,0.41,0.0,Phase3-EA-SA2v2-EURCHF-M5-43,EURCHFMT4,3474,4h 34m,Sell
80768.4,136689,28.04.2011 05:55:00,,0.0,-77.1700000000128,0.0,0.0,136646,28.04.2011 00:30:00,6528,-0.04516944747236512,-12.1,IS,0.23,0.0,Phase3-EA-S4v1-GBPJPY-M5-194,GBPJPYMT4,1606,5h 25m,Sell
80758.66,1.29461,28.04.2011 11:30:00,,0.0,-86.91000000000349,0.0,0.0,1.29436,28.04.2011 02:45:00,6529,-0.05087050252459193,-9.74,IS,0.34,0.0,Phase3-EA-S4v1-EURCHF-M15-221,EURCHFMT4,1622,8h 45m,Sell
80810.32,1.29292,28.04.2011 20:04:57,tp 1.29292,0.0,-35.25,0.0,0.0,1.29182,28.04.2011 20:00:00,6530,-0.020632668438520234,51.66,IS,0.41,0.0,Phase3-EA-SA2v2-EURCHF-M5-43,EURCHFMT4,3476,4m 57s,Buy
80862.03,1.29234,28.04.2011 21:09:59,tp 1.29234,0.0,-0.0,0.0,0.0,1.29124,28.04.2011 20:30:00,6531,-0.0,51.71,IS,0.41,0.0,Phase3-EA-SA2v2-EURCHF-M5-43,EURCHFMT4,3478,39m 59s,Buy
80866.5,81533,29.04.2011 04:45:00,,-1.49,-0.0,0.0,0.0,81551,28.04.2011 21:30:00,6532,-0.0,4.47,IS,0.27,0.0,Phase3-EA-S1v2-USDJPY-M15-0,USDJPYMT4,2086,7h 15m,Sell
80791.38,1.29493,29.04.2011 06:25:00,,-2.35,-75.11999999999534,0.0,0.0,1.29338,28.04.2011 22:05:00,6533,-0.04396414744844387,-75.12,IS,0.41,0.0,Phase3-EA-SA2v2-EURCHF-M5-43,EURCHFMT4,3480,8h 20m,Sell
80788.28,135769,29.04.2011 06:50:00,,0.0,-78.22000000000116,0.0,0.0,135758,29.04.2011 01:25:00,6534,-0.0457784293585935,-3.1,IS,0.23,0.0,Phase3-EA-S4v1-GBPJPY-M5-194,GBPJPYMT4,1608,5h 25m,Sell
80706.29,120345,29.04.2011 18:29:57,sl 120.345,-2.15,-160.20999999999185,0.0,0.0,121065,27.04.2011 19:00:00,6535,-0.09376325962081031,-81.99,IS,0.09,0.0,Phase3-EA-TR1v1-EURJPY-M30-91,EURJPYMT4,988,1d 23h 29m,Buy
80628.31,1.28235,02.05.2011 04:20:00,,-1.14,-238.19000000000233,0.0,0.0,1.28397,29.04.2011 20:00:00,6536,-0.13940122844443018,-77.98,IS,0.41,0.0,Phase3-EA-SA2v2-EURCHF-M5-43,EURCHFMT4,3482,2d 8h 20m,Buy
80585.78,1.66497,02.05.2011 07:59:58,sl 1.66497,-0.53,-280.72000000000116,0.0,0.0,1.66797,29.04.2011 18:00:00,6537,-0.16429200574717756,-42.53,IS,0.14,0.0,Phase3-EA-B1v1-GBPUSD-M30-14,GBPUSDMT4,426,2d 13h 59m,Buy
80505.82,120791,02.05.2011 11:59:58,sl 120.791,-0.39,-360.679999999993,0.0,0.0,120071,29.04.2011 23:30:00,6538,-0.2110887739843638,-79.96,IS,0.09,0.0,Phase3-EA-TR1v1-EURJPY-M30-91,EURJPYMT4,990,2d 12h 29m,Sell
80516.62,81198,03.05.2011 01:45:00,,-1.5,-349.88000000000466,0.0,0.0,81235,02.05.2011 21:45:00,6539,-0.2047680499103128,10.8,IS,0.27,0.0,Phase3-EA-S1v2-USDJPY-M15-0,USDJPYMT4,2088,4h 0m,Sell
80375.74,1.2809,03.05.2011 06:15:00,,-1.14,-490.7600000000093,0.0,0.0,1.28385,02.05.2011 21:55:00,6540,-0.28721838394302524,-140.88,IS,0.41,0.0,Phase3-EA-SA2v2-EURCHF-M5-43,EURCHFMT4,3484,8h 20m,Buy
80222.05,1.27799,03.05.2011 10:29:57,sl 1.27799,0.0,-644.4500000000116,0.0,0.0,1.28189,03.05.2011 02:30:00,6541,-0.37716579903024383,-153.69,IS,0.34,0.0,Phase3-EA-S4v1-EURCHF-M15-221,EURCHFMT4,1624,7h 59m,Buy
80274.41,1.27841,03.05.2011 22:44:57,tp 1.27841,0.0,-592.0900000000256,0.0,0.0,1.27731,03.05.2011 21:45:00,6542,-0.34652199231565317,52.36,IS,0.41,0.0,Phase3-EA-SA2v2-EURCHF-M5-43,EURCHFMT4,3486,59m 57s,Buy
80326.75,1.27775,04.05.2011 02:14:58,tp 1.27775,0.0,-539.7500000000291,0.0,0.0,1.27665,04.05.2011 00:10:00,6543,-0.315889890645638,52.34,IS,0.41,0.0,Phase3-EA-SA2v2-EURCHF-M5-43,EURCHFMT4,3488,2h 4m,Buy
80330.11,81012,04.05.2011 02:15:00,,-0.97,-536.3900000000431,0.0,0.0,80999,03.05.2011 23:15:00,6544,-0.3139234431559393,3.36,IS,0.27,0.0,Phase3-EA-S1v2-USDJPY-M15-0,USDJPYMT4,2090,3h 0m,Buy
80382.4,1.27673,04.05.2011 04:19:58,tp 1.27673,0.0,-484.1000000000349,0.0,0.0,1.27783,04.05.2011 02:20:00,6545,-0.28332060409737125,52.29,IS,0.41,0.0,Phase3-EA-SA2v2-EURCHF-M5-43,EURCHFMT4,3490,1h 59m,Sell
80250.83,0.86405,04.05.2011 07:00:00,,0.0,-615.6700000000419,0.0,0.0,0.86209,04.05.2011 02:45:00,6546,-0.3603222398773556,-131.57,IS,0.58,0.0,Phase3-EA-SA2v2-USDCHF-M15-107,USDCHFMT4,1290,4h 15m,Sell
80161.22,1.28024,04.05.2011 11:45:00,,0.0,-705.2800000000279,0.0,0.0,1.27797,04.05.2011 03:00:00,6547,-0.41276669212515493,-89.61,IS,0.34,0.0,Phase3-EA-S4v1-EURCHF-M15-221,EURCHFMT4,1626,8h 45m,Sell
80213.68,1.2765,04.05.2011 22:04:58,tp 1.27650,0.0,-652.8200000000361,0.0,0.0,1.2776,04.05.2011 21:25:00,6548,-0.38206436018765294,52.46,IS,0.41,0.0,Phase3-EA-SA2v2-EURCHF-M5-43,EURCHFMT4,3492,39m 58s,Sell
80266.05,1.27678,04.05.2011 23:14:58,tp 1.27678,0.0,-600.4500000000407,0.0,0.0,1.27788,04.05.2011 23:00:00,6549,-0.35141470095076605,52.37,IS,0.41,0.0,Phase3-EA-SA2v2-EURCHF-M5-43,EURCHFMT4,3494,14m 58s,Sell
80311.24,1.27637,05.05.2011 00:09:58,tp 1.27637,-7.14,-555.2600000000384,0.0,0.0,1.27747,04.05.2011 23:55:00,6550,-0.3249671527186654,45.19,IS,0.41,0.0,Phase3-EA-SA2v2-EURCHF-M5-43,EURCHFMT4,3496,14m 58s,Sell
80267.56,0.86178,05.05.2011 03:30:00,,-10.7,-598.9400000000314,0.0,0.0,0.86129,04.05.2011 23:15:00,6551,-0.3505309700848507,-43.68,IS,0.58,0.0,Phase3-EA-SA2v2-USDCHF-M15-107,USDCHFMT4,1292,4h 15m,Sell
80276.79,80506,05.05.2011 03:30:00,,-4.52,-589.710000000021,0.0,0.0,80547,04.05.2011 22:45:00,6552,-0.3451290920104414,9.23,IS,0.27,0.0,Phase3-EA-S1v2-USDJPY-M15-0,USDJPYMT4,2092,4h 45m,Sell
80296.5,132954,05.05.2011 06:55:00,,0.0,-570.0000000000291,0.0,0.0,133023,05.05.2011 01:30:00,6553,-0.33359377057529066,19.71,IS,0.23,0.0,Phase3-EA-S4v1-GBPJPY-M5-194,GBPJPYMT4,1610,5h 25m,Sell
80501.39,132565,05.05.2011 11:29:58,tp 132.565,-2.59,-365.11000000001513,0.0,0.0,134415,03.05.2011 10:30:00,6554,-0.21368144135919862,204.89,IS,0.09,0.0,Phase3-EA-B1v1-GBPJPY-M30-1,GBPJPYMT4,682,2d 0h 59m,Sell
80857.17,119132,05.05.2011 12:44:57,tp 119.132,-4.41,-9.330000000016298,0.0,0.0,120832,29.04.2011 14:00:00,6555,-0.005460403297320597,355.78,IS,0.17,0.0,Phase3-EA-T1v2-EURJPY-M15-322,EURJPYMT4,896,5d 22h 44m,Sell
80996.94,119064,05.05.2011 12:59:57,tp 119.064,-1.56,-0.0,0.0,0.0,120324,03.05.2011 02:00:00,6556,-0.0,139.77,IS,0.09,0.0,Phase3-EA-TR1v1-EURJPY-M30-91,EURJPYMT4,992,2d 10h 59m,Sell
80842.51,1.27205,05.05.2011 13:59:57,sl 1.27205,0.0,-154.42999999999302,0.0,0.0,1.27595,05.05.2011 06:00:00,6557,-0.0903115576220212,-154.43,IS,0.34,0.0,Phase3-EA-S4v1-EURCHF-M15-221,EURCHFMT4,1628,7h 59m,Buy
80893.2,1.26655,06.05.2011 02:34:58,tp 1.26655,-1.13,-103.73999999999069,0.0,0.0,1.26545,05.05.2011 21:20:00,6558,-0.06066775230012343,50.69,IS,0.41,0.0,Phase3-EA-SA2v2-EURCHF-M5-43,EURCHFMT4,3498,5h 14m,Buy
80832.6,131936,06.05.2011 06:35:00,,0.0,-164.3399999999965,0.0,0.0,131724,06.05.2011 01:10:00,6559,-0.09610698296706158,-60.6,IS,0.23,0.0,Phase3-EA-S4v1-GBPJPY-M5-194,GBPJPYMT4,1612,5h 25m,Sell
80689.37,80403,06.05.2011 10:15:00,,-1.52,-307.570000000007,0.0,0.0,79981,05.05.2011 17:00:00,6560,-0.17986871577936248,-143.23,IS,0.27,0.0,Phase3-EA-S1v2-USDJPY-M15-0,USDJPYMT4,2094,17h 15m,Sell
80628.59,1.26797,06.05.2011 12:15:00,,0.0,-368.3500000000058,0.0,0.0,1.26641,06.05.2011 03:30:00,6561,-0.2154132114878815,-60.78,IS,0.34,0.0,Phase3-EA-S4v1-EURCHF-M15-221,EURCHFMT4,1630,8h 45m,Sell
80579.88,116955,06.05.2011 15:44:58,sl 116.955,0.0,-417.0599999999977,0.0,0.0,116725,06.05.2011 11:15:00,6562,-0.24389910135233864,-48.71,IS,0.17,0.0,Phase3-EA-T1v2-EURJPY-M15-322,EURJPYMT4,898,4h 29m,Sell
80720.5,115638,06.05.2011 19:59:58,tp 115.638,-0.39,-276.4400000000023,0.0,0.0,116898,05.05.2011 18:00:00,6563,-0.16166371164302842,140.62,IS,0.09,0.0,Phase3-EA-TR1v1-EURJPY-M30-91,EURJPYMT4,994,1d 1h 59m,Sell
80771.86,1.25939,06.05.2011 23:34:57,tp 1.25939,0.0,-225.0800000000163,0.0,0.0,1.25829,06.05.2011 22:25:00,6564,-0.13162808644412952,51.36,IS,0.41,0.0,Phase3-EA-SA2v2-EURCHF-M5-43,EURCHFMT4,3500,1h 9m,Buy
80883.09,131786,09.05.2011 04:19:58,tp 131.786,0.0,-113.85000000000582,0.0,0.0,132176,09.05.2011 01:30:00,6565,-0.06658013880248724,111.23,IS,0.23,0.0,Phase3-EA-S4v1-GBPJPY-M5-194,GBPJPYMT4,1614,2h 49m,Sell
80934.62,1.2589,09.05.2011 08:24:57,tp 1.25890,0.0,-62.320000000006985,0.0,0.0,1.26,09.05.2011 01:30:00,6566,-0.03644509661986173,51.53,IS,0.41,0.0,Phase3-EA-SA2v2-EURCHF-M5-43,EURCHFMT4,3502,6h 54m,Sell
80847.64,115468,09.05.2011 15:59:58,sl 115.468,0.0,-149.30000000001746,0.0,0.0,116248,09.05.2011 03:00:00,6567,-0.0873115039368643,-86.98,IS,0.09,0.0,Phase3-EA-TR1v1-EURJPY-M30-91,EURJPYMT4,996,12h 59m,Buy
80896.96,1.25074,10.05.2011 03:39:58,tp 1.25074,-2.35,-99.98000000001048,0.0,0.0,1.25184,09.05.2011 23:35:00,6568,-0.058468882542582624,49.32,IS,0.41,0.0,Phase3-EA-SA2v2-EURCHF-M5-43,EURCHFMT4,3504,4h 4m,Sell
80872.91,131796,10.05.2011 05:30:00,,0.0,-124.02999999999884,0.0,0.0,131712,10.05.2011 00:05:00,6569,-0.07253346170989892,-24.05,IS,0.23,0.0,Phase3-EA-S4v1-GBPJPY-M5-194,GBPJPYMT4,1616,5h 25m,Sell
81028.38,1.25467,10.05.2011 10:29:58,tp 1.25467,0.0,-0.0,0.0,0.0,1.25067,10.05.2011 04:15:00,6570,-0.0,155.47,IS,0.34,0.0,Phase3-EA-S4v1-EURCHF-M15-221,EURCHFMT4,1632,6h 14m,Buy
81172.32,116175,10.05.2011 10:59:57,tp 116.175,0.0,-0.0,0.0,0.0,114885,10.05.2011 08:30:00,6571,-0.0,143.94,IS,0.09,0.0,Phase3-EA-TR1v1-EURJPY-M30-91,EURJPYMT4,998,2h 29m,Buy
81123.14,116008,10.05.2011 10:59:58,sl 116.008,-0.74,-49.179999999993015,0.0,0.0,115778,09.05.2011 15:30:00,6572,-0.028731280851946747,-49.18,IS,0.17,0.0,Phase3-EA-T1v2-EURJPY-M15-322,EURJPYMT4,900,19h 29m,Sell
81174.32,1.26619,10.05.2011 21:04:58,tp 1.26619,0.0,-0.0,0.0,0.0,1.26729,10.05.2011 20:55:00,6573,-0.0,51.18,IS,0.41,0.0,Phase3-EA-SA2v2-EURCHF-M5-43,EURCHFMT4,3506,9m 58s,Sell
81128.72,0.88008,11.05.2011 02:15:00,,-0.79,-45.60000000000582,0.0,0.0,0.88076,10.05.2011 22:00:00,6574,-0.026639509945186764,-45.6,IS,0.58,0.0,Phase3-EA-SA2v2-USDCHF-M15-107,USDCHFMT4,1294,4h 15m,Buy
81177.63,1.26676,11.05.2011 05:09:57,tp 1.26676,-2.33,-0.0,0.0,0.0,1.26786,10.05.2011 22:05:00,6575,-0.0,48.91,IS,0.41,0.0,Phase3-EA-SA2v2-EURCHF-M5-43,EURCHFMT4,3508,7h 4m,Sell
81244.19,132307,11.05.2011 06:50:00,,0.0,-0.0,0.0,0.0,132541,11.05.2011 01:25:00,6576,-0.0,66.56,IS,0.23,0.0,Phase3-EA-S4v1-GBPJPY-M5-194,GBPJPYMT4,1618,5h 25m,Sell
81202.19,1.63435,11.05.2011 08:59:57,sl 1.63435,0.0,-42.0,0.0,0.0,1.63735,11.05.2011 03:30:00,6577,-0.024526379551913557,-42.0,IS,0.14,0.0,Phase3-EA-B1v1-GBPUSD-M30-14,GBPUSDMT4,428,5h 29m,Buy
81153.98,116201,11.05.2011 15:44:57,sl 116.201,0.0,-90.20999999999185,0.0,0.0,116431,11.05.2011 13:45:00,6578,-0.052679159508998145,-48.21,IS,0.17,0.0,Phase3-EA-T1v2-EURJPY-M15-322,EURJPYMT4,902,1h 59m,Buy
81073.57,115729,11.05.2011 18:29:58,sl 115.729,-0.55,-170.61999999999534,0.0,0.0,116449,10.05.2011 23:30:00,6579,-0.0996354971225566,-80.41,IS,0.09,0.0,Phase3-EA-TR1v1-EURJPY-M30-91,EURJPYMT4,1000,18h 59m,Buy
81124.34,1.26062,11.05.2011 20:44:58,tp 1.26062,0.0,-119.85000000000582,0.0,0.0,1.25952,11.05.2011 20:15:00,6580,-0.06998777593564244,50.77,IS,0.41,0.0,Phase3-EA-SA2v2-EURCHF-M5-43,EURCHFMT4,3510,29m 58s,Buy
81175.13,1.26021,11.05.2011 21:44:57,tp 1.26021,0.0,-69.05999999999767,0.0,0.0,1.25911,11.05.2011 21:30:00,6581,-0.04032837552035936,50.79,IS,0.41,0.0,Phase3-EA-SA2v2-EURCHF-M5-43,EURCHFMT4,3512,14m 57s,Buy
81174.23,81049,12.05.2011 00:15:00,,-2.9,-69.95999999999185,0.0,0.0,81043,11.05.2011 18:15:00,6582,-0.040853940796468396,-0.9,IS,0.27,0.0,Phase3-EA-S1v2-USDJPY-M15-0,USDJPYMT4,2096,6h 0m,Buy
81225.11,1.25943,12.05.2011 02:04:58,tp 1.25943,0.0,-19.079999999987194,0.0,0.0,1.25833,12.05.2011 01:15:00,6583,-0.011141983853576109,50.88,IS,0.41,0.0,Phase3-EA-SA2v2-EURCHF-M5-43,EURCHFMT4,3514,49m 58s,Buy
81143.91,115393,12.05.2011 03:59:58,sl 115.393,-1.17,-100.27999999999884,0.0,0.0,114673,11.05.2011 21:30:00,6584,-0.05855965098728245,-81.2,IS,0.09,0.0,Phase3-EA-TR1v1-EURJPY-M30-91,EURJPYMT4,1002,6h 29m,Sell
81091.19,132852,12.05.2011 06:30:00,,0.0,-153.0,0.0,0.0,132666,12.05.2011 01:05:00,6585,-0.08934609693911368,-52.72,IS,0.23,0.0,Phase3-EA-S4v1-GBPJPY-M5-194,GBPJPYMT4,1620,5h 25m,Sell
81096.19,81034,12.05.2011 09:30:00,,0.0,-148.0,0.0,0.0,81049,12.05.2011 00:15:00,6586,-0.08642628984960016,5.0,IS,0.27,0.0,Phase3-EA-S1v2-USDJPY-M15-0,USDJPYMT4,2098,9h 15m,Sell
81172.08,1.2609,12.05.2011 10:45:00,,0.0,-72.10999999998603,0.0,0.0,1.25892,12.05.2011 02:00:00,6587,-0.04210945784495581,75.89,IS,0.34,0.0,Phase3-EA-S4v1-EURCHF-M15-221,EURCHFMT4,1634,8h 45m,Buy
81085.45,114606,12.05.2011 12:29:58,sl 114.606,0.0,-158.7399999999907,0.0,0.0,115386,12.05.2011 04:00:00,6588,-0.09269803547786976,-86.63,IS,0.09,0.0,Phase3-EA-TR1v1-EURJPY-M30-91,EURJPYMT4,1004,8h 29m,Buy
81441.24,114.45,12.05.2011 12:59:58,tp 114.450,-2.2,-0.0,0.0,0.0,116.15,11.05.2011 16:45:00,6589,-0.0,355.79,IS,0.17,0.0,Phase3-EA-T1v2-EURJPY-M15-322,EURJPYMT4,904,20h 14m,Sell
81492.29,1.25964,12.05.2011 20:29:58,tp 1.25964,0.0,-0.0,0.0,0.0,1.26074,12.05.2011 20:25:00,6590,-0.0,51.05,IS,0.41,0.0,Phase3-EA-SA2v2-EURCHF-M5-43,EURCHFMT4,3516,4m 58s,Sell
81571.35,131.53,13.05.2011 05:10:00,,-1.65,-0.0,0.0,0.0,131814,12.05.2011 23:45:00,6591,-0.0,79.06,IS,0.23,0.0,Phase3-EA-S4v1-GBPJPY-M5-194,GBPJPYMT4,1622,5h 25m,Sell
81406.54,0.88682,13.05.2011 06:30:00,,0.0,-164.80999999999767,0.0,0.0,0.8843,13.05.2011 02:15:00,6592,-0.09605916139262043,-164.81,IS,0.58,0.0,Phase3-EA-SA2v2-USDCHF-M15-107,USDCHFMT4,1296,4h 15m,Sell
81457.12,1.25907,13.05.2011 21:24:58,tp 1.25907,0.0,-114.23000000001048,0.0,0.0,1.25797,13.05.2011 20:50:00,6593,-0.06657871491948421,50.58,IS,0.41,0.0,Phase3-EA-SA2v2-EURCHF-M5-43,EURCHFMT4,3518,34m 58s,Buy
81568.05,130894,16.05.2011 04:44:58,tp 130.894,0.0,-3.3000000000174623,0.0,0.0,130504,16.05.2011 03:00:00,6594,-0.0019233980498594096,110.93,IS,0.23,0.0,Phase3-EA-S4v1-GBPJPY-M5-194,GBPJPYMT4,1624,1h 44m,Buy
81618.59,1.25795,16.05.2011 05:14:57,tp 1.25795,0.0,-0.0,0.0,0.0,1.25685,16.05.2011 01:20:00,6595,-0.0,50.54,IS,0.41,0.0,Phase3-EA-SA2v2-EURCHF-M5-43,EURCHFMT4,3520,3h 54m,Buy
81696.46,1.2593,16.05.2011 10:30:00,,0.0,-0.0,0.0,0.0,1.25726,16.05.2011 01:45:00,6596,-0.0,77.87,IS,0.34,0.0,Phase3-EA-S4v1-EURCHF-M15-221,EURCHFMT4,1636,8h 45m,Buy
81747.56,1.2541,16.05.2011 20:44:58,tp 1.25410,0.0,-0.0,0.0,0.0,1253,16.05.2011 20:15:00,6597,-0.0,51.1,IS,0.41,0.0,Phase3-EA-SA2v2-EURCHF-M5-43,EURCHFMT4,3522,29m 58s,Buy
81761.68,114337,17.05.2011 00:15:00,,-1.03,-0.0,0.0,0.0,114265,16.05.2011 15:45:00,6598,-0.0,14.12,IS,0.17,0.0,Phase3-EA-T1v2-EURJPY-M15-322,EURJPYMT4,906,8h 30m,Buy
81721.7,0.88486,17.05.2011 04:30:00,,0.0,-39.98000000001048,0.0,0.0,0.88425,17.05.2011 00:15:00,6599,-0.023276437445191776,-39.98,IS,0.58,0.0,Phase3-EA-SA2v2-USDCHF-M15-107,USDCHFMT4,1298,4h 15m,Sell
81750.73,1.25304,17.05.2011 07:40:00,,-1.11,-10.950000000011642,0.0,0.0,1.25239,16.05.2011 23:20:00,6600,-0.006375112306779744,29.03,IS,0.41,0.0,Phase3-EA-SA2v2-EURCHF-M5-43,EURCHFMT4,3524,8h 20m,Buy
81524.73,131948,17.05.2011 08:44:57,sl 131.948,0.0,-236.95000000001164,0.0,0.0,131148,17.05.2011 03:45:00,6601,-0.13795277270227657,-226.0,IS,0.23,0.0,Phase3-EA-S4v1-GBPJPY-M5-194,GBPJPYMT4,1626,4h 59m,Sell
81666.98,115376,17.05.2011 08:59:57,tp 115.376,-0.55,-94.70000000001164,0.0,0.0,114086,16.05.2011 07:30:00,6602,-0.05513453291794284,142.25,IS,0.09,0.0,Phase3-EA-TR1v1-EURJPY-M30-91,EURJPYMT4,1006,1d 1h 29m,Buy
81786.06,1.25493,17.05.2011 09:45:00,,0.0,-0.0,0.0,0.0,1.25183,17.05.2011 01:00:00,6603,-0.0,119.08,IS,0.34,0.0,Phase3-EA-S4v1-EURCHF-M15-221,EURCHFMT4,1638,8h 45m,Buy
81706.7,115292,17.05.2011 15:59:58,sl 115.292,0.0,-79.35999999998603,0.0,0.0,116012,17.05.2011 14:00:00,6604,-0.04619699642682651,-79.36,IS,0.09,0.0,Phase3-EA-TR1v1-EURJPY-M30-91,EURJPYMT4,1008,1h 59m,Buy
81786.36,81342,17.05.2011 23:30:00,,0.0,-0.0,0.0,0.0,81582,17.05.2011 20:45:00,6605,-0.0,79.66,IS,0.27,0.0,Phase3-EA-S1v2-USDJPY-M15-0,USDJPYMT4,2100,2h 45m,Sell
81699.78,116057,18.05.2011 01:59:58,sl 116.057,-0.39,-86.5799999999872,0.0,0.0,115277,17.05.2011 16:00:00,6606,-0.050399810555382396,-86.58,IS,0.09,0.0,Phase3-EA-TR1v1-EURJPY-M30-91,EURJPYMT4,1010,9h 59m,Sell
81626.48,0.87982,18.05.2011 02:30:00,,-0.79,-159.87999999997555,0.0,0.0,0.88092,17.05.2011 22:15:00,6607,-0.09306908883800527,-73.3,IS,0.58,0.0,Phase3-EA-SA2v2-USDCHF-M15-107,USDCHFMT4,1300,4h 15m,Buy
81736.81,132047,18.05.2011 05:14:57,tp 132.047,0.0,-49.54999999998836,0.0,0.0,132437,18.05.2011 02:15:00,6608,-0.028843966424335645,110.33,IS,0.23,0.0,Phase3-EA-S4v1-GBPJPY-M5-194,GBPJPYMT4,1628,2h 59m,Sell
81729.71,115802,18.05.2011 07:45:00,,-1.02,-56.64999999999418,0.0,0.0,115831,17.05.2011 21:15:00,6609,-0.032977007021974376,-7.1,IS,0.17,0.0,Phase3-EA-T1v2-EURJPY-M15-322,EURJPYMT4,908,10h 30m,Buy
81637.12,1.25601,18.05.2011 09:55:00,,0.0,-149.2399999999907,0.0,0.0,1.25402,18.05.2011 01:35:00,6610,-0.0868753491255014,-92.59,IS,0.41,0.0,Phase3-EA-SA2v2-EURCHF-M5-43,EURCHFMT4,3526,8h 20m,Sell
81600.43,1.25517,18.05.2011 12:00:00,,0.0,-185.92999999999302,0.0,0.0,1.25422,18.05.2011 03:15:00,6611,-0.10823327300257891,-36.69,IS,0.34,0.0,Phase3-EA-S4v1-EURCHF-M15-221,EURCHFMT4,1640,8h 45m,Sell
81602.09,81561,18.05.2011 21:30:00,,0.0,-184.26999999998952,0.0,0.0,81556,18.05.2011 21:15:00,6612,-0.10726695646848186,1.66,IS,0.27,0.0,Phase3-EA-S1v2-USDJPY-M15-0,USDJPYMT4,2102,15m 0s,Buy
81653.43,1.25401,19.05.2011 07:29:58,tp 1.25401,0.0,-132.92999999999302,0.0,0.0,1.25511,19.05.2011 00:50:00,6613,-0.07738099811882214,51.34,IS,0.41,0.0,Phase3-EA-SA2v2-EURCHF-M5-43,EURCHFMT4,3528,6h 39m,Sell
81715.12,1.25429,19.05.2011 10:45:00,,0.0,-71.23999999999069,0.0,0.0,1.25589,19.05.2011 02:00:00,6614,-0.041470114390915955,61.69,IS,0.34,0.0,Phase3-EA-S4v1-EURCHF-M15-221,EURCHFMT4,1642,8h 45m,Sell
81628.2,116719,19.05.2011 12:59:58,sl 116.719,-1.16,-158.1600000000035,0.0,0.0,115939,18.05.2011 06:30:00,6615,-0.09206784520028453,-86.92,IS,0.09,0.0,Phase3-EA-TR1v1-EURJPY-M30-91,EURJPYMT4,1012,1d 6h 29m,Sell
81554.45,132.27,19.05.2011 17:29:58,sl 132.270,0.0,-231.9100000000035,0.0,0.0,132.94,19.05.2011 16:30:00,6616,-0.1349990767602291,-73.75,IS,0.09,0.0,Phase3-EA-B1v1-GBPJPY-M30-1,GBPJPYMT4,684,59m 58s,Buy
81506.52,116861,19.05.2011 21:14:58,sl 116.861,0.0,-279.8399999999965,0.0,0.0,117091,19.05.2011 19:45:00,6617,-0.16290001138623375,-47.93,IS,0.17,0.0,Phase3-EA-T1v2-EURJPY-M15-322,EURJPYMT4,910,1h 29m,Buy
81557.68,1.26188,19.05.2011 21:14:58,tp 1.26188,0.0,-228.67999999999302,0.0,0.0,1.26298,19.05.2011 20:50:00,6618,-0.13311883434749594,51.16,IS,0.41,0.0,Phase3-EA-SA2v2-EURCHF-M5-43,EURCHFMT4,3530,24m 58s,Sell
81607.78,1.26119,20.05.2011 01:39:57,tp 1.26119,-1.12,-178.5799999999872,0.0,0.0,1.26009,19.05.2011 23:05:00,6619,-0.1039547028064319,50.1,IS,0.41,0.0,Phase3-EA-SA2v2-EURCHF-M5-43,EURCHFMT4,3532,2h 34m,Buy
81591.51,132.47,20.05.2011 04:55:00,,-1.63,-194.84999999997672,0.0,0.0,132418,19.05.2011 23:30:00,6620,-0.1134257690773451,-16.27,IS,0.23,0.0,Phase3-EA-S4v1-GBPJPY-M5-194,GBPJPYMT4,1630,5h 25m,Sell
81594.3,1.26124,20.05.2011 10:00:00,,0.0,-192.05999999996857,0.0,0.0,1.2613,20.05.2011 01:40:00,6621,-0.11180165875798788,2.79,IS,0.41,0.0,Phase3-EA-SA2v2-EURCHF-M5-43,EURCHFMT4,3534,8h 20m,Sell
81748.99,1.25859,20.05.2011 11:44:58,tp 1.25859,0.0,-37.36999999996624,0.0,0.0,1.26259,20.05.2011 06:00:00,6622,-0.02175376438499904,154.69,IS,0.34,0.0,Phase3-EA-S4v1-EURCHF-M15-221,EURCHFMT4,1644,5h 44m,Sell
81701.06,116642,20.05.2011 12:29:57,sl 116.642,0.0,-85.29999999995925,0.0,0.0,116872,20.05.2011 01:00:00,6623,-0.0496546990110037,-47.93,IS,0.17,0.0,Phase3-EA-T1v2-EURJPY-M15-322,EURJPYMT4,912,11h 29m,Buy
81752.49,1.24563,20.05.2011 21:24:57,tp 1.24563,0.0,-33.86999999996624,0.0,0.0,1.24673,20.05.2011 20:35:00,6624,-0.01971635000588303,51.43,IS,0.41,0.0,Phase3-EA-SA2v2-EURCHF-M5-43,EURCHFMT4,3536,49m 57s,Sell
81818.57,0.87773,20.05.2011 23:29:58,tp 0.87773,0.0,-0.0,0.0,0.0,0.87873,20.05.2011 23:15:00,6625,-0.0,66.08,IS,0.58,0.0,Phase3-EA-SA2v2-USDCHF-M15-107,USDCHFMT4,1302,14m 58s,Sell
81588.81,1.23971,23.05.2011 01:54:57,sl 1.23971,-1.12,-229.7600000000093,0.0,0.0,1.24461,20.05.2011 22:40:00,6626,-0.1337224492090752,-229.76,IS,0.41,0.0,Phase3-EA-SA2v2-EURCHF-M5-43,EURCHFMT4,3538,2d 3h 14m,Buy
81730.1,115386,23.05.2011 01:59:57,tp 115.386,-0.78,-88.47000000000116,0.0,0.0,116676,19.05.2011 15:00:00,6627,-0.051490359860404594,141.29,IS,0.09,0.0,Phase3-EA-TR1v1-EURJPY-M30-91,EURJPYMT4,1014,3d 10h 59m,Sell
81781.49,1.24029,23.05.2011 03:24:58,tp 1.24029,0.0,-37.079999999987194,0.0,0.0,1.23919,23.05.2011 01:55:00,6628,-0.021580903624088592,51.39,IS,0.41,0.0,Phase3-EA-SA2v2-EURCHF-M5-43,EURCHFMT4,3540,1h 29m,Buy
81630.55,1.23512,23.05.2011 04:14:57,sl 1.23512,0.0,-188.01999999998952,0.0,0.0,1.23902,23.05.2011 03:15:00,6629,-0.10942938240027811,-150.94,IS,0.34,0.0,Phase3-EA-S4v1-EURCHF-M15-221,EURCHFMT4,1646,59m 57s,Buy
81769.75,113936,23.05.2011 10:59:57,tp 113.936,0.0,-48.81999999997788,0.0,0.0,115196,23.05.2011 03:00:00,6630,-0.02841369241984605,139.2,IS,0.09,0.0,Phase3-EA-TR1v1-EURJPY-M30-91,EURJPYMT4,1016,7h 59m,Sell
81619.39,1.2328,23.05.2011 12:44:57,sl 1.23280,0.0,-199.1799999999639,0.0,0.0,1.2367,23.05.2011 05:00:00,6631,-0.11592460582110764,-150.36,IS,0.34,0.0,Phase3-EA-S4v1-EURCHF-M15-221,EURCHFMT4,1648,7h 44m,Buy
81637.2,81862,23.05.2011 21:15:00,,0.0,-181.36999999996624,0.0,0.0,81808,23.05.2011 19:00:00,6632,-0.10555902077404453,17.81,IS,0.27,0.0,Phase3-EA-S1v2-USDJPY-M15-0,USDJPYMT4,2104,2h 15m,Buy
81745.05,131.78,24.05.2011 02:24:58,tp 131.780,-1.63,-73.51999999996042,0.0,0.0,132.17,23.05.2011 23:15:00,6633,-0.04278932131722457,107.85,IS,0.23,0.0,Phase3-EA-S4v1-GBPJPY-M5-194,GBPJPYMT4,1632,3h 9m,Sell
81516.2,1.24472,24.05.2011 02:39:57,sl 1.24472,-2.32,-302.36999999996624,0.0,0.0,1.23982,23.05.2011 20:30:00,6634,-0.17598214209323604,-228.85,IS,0.41,0.0,Phase3-EA-SA2v2-EURCHF-M5-43,EURCHFMT4,3542,6h 9m,Sell
81567.05,1.24321,24.05.2011 03:49:58,tp 1.24321,0.0,-251.51999999996042,0.0,0.0,1.24431,24.05.2011 02:40:00,6635,-0.1463869708611592,50.85,IS,0.41,0.0,Phase3-EA-SA2v2-EURCHF-M5-43,EURCHFMT4,3544,1h 9m,Sell
81721.39,1.24068,24.05.2011 09:59:58,tp 1.24068,0.0,-97.17999999996391,0.0,0.0,1.24468,24.05.2011 03:30:00,6636,-0.0565596605768305,154.34,IS,0.34,0.0,Phase3-EA-S4v1-EURCHF-M15-221,EURCHFMT4,1650,6h 29m,Sell
81862.4,115867,24.05.2011 16:29:58,tp 115.867,-0.54,-0.0,0.0,0.0,114577,23.05.2011 14:00:00,6637,-0.0,141.01,IS,0.09,0.0,Phase3-EA-TR1v1-EURJPY-M30-91,EURJPYMT4,1018,1d 2h 29m,Buy
81913.73,1.23941,24.05.2011 20:09:58,tp 1.23941,0.0,-0.0,0.0,0.0,1.23831,24.05.2011 20:05:00,6638,-0.0,51.33,IS,0.41,0.0,Phase3-EA-SA2v2-EURCHF-M5-43,EURCHFMT4,3546,4m 58s,Buy
82033.83,115602,24.05.2011 23:30:00,,0.0,-0.0,0.0,0.0,115023,24.05.2011 11:00:00,6639,-0.0,120.1,IS,0.17,0.0,Phase3-EA-T1v2-EURJPY-M15-322,EURJPYMT4,914,12h 30m,Buy
82060.51,82053,25.05.2011 02:00:00,,-0.96,-0.0,0.0,0.0,81969,24.05.2011 20:15:00,6640,-0.0,26.68,IS,0.27,0.0,Phase3-EA-S1v2-USDJPY-M15-0,USDJPYMT4,2106,5h 45m,Buy
81909.75,1.23585,25.05.2011 05:14:58,sl 1.23585,0.0,-150.7600000000093,0.0,0.0,1.23975,25.05.2011 03:45:00,6641,-0.08762033775211364,-150.76,IS,0.34,0.0,Phase3-EA-S4v1-EURCHF-M15-221,EURCHFMT4,1652,1h 29m,Buy
81962.24,132516,25.05.2011 06:40:00,,0.0,-98.27000000001863,0.0,0.0,132703,25.05.2011 01:15:00,6642,-0.05711362822301212,52.49,IS,0.23,0.0,Phase3-EA-S4v1-GBPJPY-M5-194,GBPJPYMT4,1634,5h 25m,Sell
81811.5,1.23265,25.05.2011 10:29:58,sl 1.23265,0.0,-249.0100000000093,0.0,0.0,1.23655,25.05.2011 06:15:00,6643,-0.1447223421574243,-150.74,IS,0.34,0.0,Phase3-EA-S4v1-EURCHF-M15-221,EURCHFMT4,1654,4h 14m,Buy
81856.13,1.22863,26.05.2011 00:14:58,tp 1.22863,-7.05,-204.38000000000466,0.0,0.0,1.22973,25.05.2011 22:30:00,6644,-0.11878379298073952,44.63,IS,0.41,0.0,Phase3-EA-SA2v2-EURCHF-M5-43,EURCHFMT4,3548,1h 44m,Sell
81907.78,1.22947,26.05.2011 03:24:58,tp 1.22947,0.0,-152.73000000001048,0.0,0.0,1.22837,26.05.2011 02:35:00,6645,-0.0887652837946432,51.65,IS,0.41,0.0,Phase3-EA-SA2v2-EURCHF-M5-43,EURCHFMT4,3550,49m 58s,Buy
81919.3,133.51,26.05.2011 06:45:00,,0.0,-141.21000000002095,0.0,0.0,133551,26.05.2011 01:20:00,6646,-0.08206996480483576,11.52,IS,0.23,0.0,Phase3-EA-S4v1-GBPJPY-M5-194,GBPJPYMT4,1636,5h 25m,Sell
81915.39,1.23356,26.05.2011 15:00:00,,0.0,-145.12000000002445,0.0,0.0,1.23346,26.05.2011 06:15:00,6647,-0.08434242116335958,-3.91,IS,0.34,0.0,Phase3-EA-S4v1-EURCHF-M15-221,EURCHFMT4,1656,8h 45m,Sell
82178.39,1.63819,26.05.2011 19:59:58,tp 1.63819,-1.6,-0.0,0.0,0.0,1.61929,25.05.2011 12:30:00,6648,-0.0,263.0,IS,0.14,0.0,Phase3-EA-B1v1-GBPUSD-M30-14,GBPUSDMT4,430,1d 7h 29m,Buy
82228.13,1.22312,27.05.2011 00:04:58,tp 1.22312,-2.37,-0.0,0.0,0.0,1.22422,26.05.2011 21:40:00,6649,-0.0,49.74,IS,0.41,0.0,Phase3-EA-SA2v2-EURCHF-M5-43,EURCHFMT4,3552,2h 24m,Sell
82295.1,0.86604,27.05.2011 00:44:57,tp 0.86604,0.0,-0.0,0.0,0.0,0.86504,27.05.2011 00:15:00,6650,-0.0,66.97,IS,0.58,0.0,Phase3-EA-SA2v2-USDCHF-M15-107,USDCHFMT4,1304,29m 57s,Buy
82333.63,81365,27.05.2011 00:45:00,,-0.96,-0.0,0.0,0.0,81246,26.05.2011 21:45:00,6651,-0.0,38.53,IS,0.27,0.0,Phase3-EA-S1v2-USDJPY-M15-0,USDJPYMT4,2108,3h 0m,Buy
82385.74,1.22387,27.05.2011 02:29:57,tp 1.22387,0.0,-0.0,0.0,0.0,1.22277,27.05.2011 00:30:00,6652,-0.0,52.11,IS,0.41,0.0,Phase3-EA-SA2v2-EURCHF-M5-43,EURCHFMT4,3554,1h 59m,Buy
82437.99,1.22271,27.05.2011 04:29:58,tp 1.22271,0.0,-0.0,0.0,0.0,1.22381,27.05.2011 02:50:00,6653,-0.0,52.25,IS,0.41,0.0,Phase3-EA-SA2v2-EURCHF-M5-43,EURCHFMT4,3556,1h 39m,Sell
82597.2,1.22025,27.05.2011 06:29:58,tp 1.22025,0.0,-0.0,0.0,0.0,1.22425,27.05.2011 03:00:00,6654,-0.0,159.21,IS,0.34,0.0,Phase3-EA-S4v1-EURCHF-M15-221,EURCHFMT4,1658,3h 29m,Sell
82636.34,133263,27.05.2011 07:25:00,,0.0,-0.0,0.0,0.0,133125,27.05.2011 02:00:00,6655,-0.0,39.14,IS,0.23,0.0,Phase3-EA-S4v1-GBPJPY-M5-194,GBPJPYMT4,1638,5h 25m,Buy
82643.89,115432,27.05.2011 14:45:00,,0.0,-0.0,0.0,0.0,115396,27.05.2011 14:15:00,6656,-0.0,7.55,IS,0.17,0.0,Phase3-EA-T1v2-EURJPY-M15-322,EURJPYMT4,916,30m 0s,Buy
82696.8,1.21746,27.05.2011 22:59:57,tp 1.21746,0.0,-0.0,0.0,0.0,1.21856,27.05.2011 20:50:00,6657,-0.0,52.91,IS,0.41,0.0,Phase3-EA-SA2v2-EURCHF-M5-43,EURCHFMT4,3558,2h 9m,Sell
82460.15,1.21301,27.05.2011 23:24:58,sl 1.21301,0.0,-236.64999999999418,0.0,0.0,1.21791,27.05.2011 23:00:00,6658,-0.13703207007888635,-236.65,IS,0.41,0.0,Phase3-EA-SA2v2-EURCHF-M5-43,EURCHFMT4,3560,24m 58s,Buy
82513.37,1.2132,27.05.2011 23:34:58,tp 1.21320,0.0,-183.42999999999302,0.0,0.0,1.2121,27.05.2011 23:25:00,6659,-0.10621505436116536,53.22,IS,0.41,0.0,Phase3-EA-SA2v2-EURCHF-M5-43,EURCHFMT4,3562,9m 58s,Buy
82519.55,80828,30.05.2011 01:30:00,,-1.5,-177.25,0.0,0.0,80851,27.05.2011 23:00:00,6660,-0.1026365282969922,6.18,IS,0.27,0.0,Phase3-EA-S1v2-USDJPY-M15-0,USDJPYMT4,2110,2d 2h 30m,Sell
82521.22,80821,30.05.2011 04:30:00,,0.0,-175.5799999999872,0.0,0.0,80826,30.05.2011 01:30:00,6661,-0.101669515590322,1.67,IS,0.27,0.0,Phase3-EA-S1v2-USDJPY-M15-0,USDJPYMT4,2112,3h 0m,Sell
82510.72,115411,30.05.2011 07:15:00,,-1.03,-186.0799999999872,0.0,0.0,115456,27.05.2011 21:00:00,6662,-0.10774953560227359,-10.5,IS,0.17,0.0,Phase3-EA-T1v2-EURJPY-M15-322,EURJPYMT4,918,2d 10h 15m,Buy
82563.83,1.21633,31.05.2011 03:14:58,tp 1.21633,0.0,-132.97000000000116,0.0,0.0,1.21743,31.05.2011 01:20:00,6663,-0.07699621533230562,53.11,IS,0.41,0.0,Phase3-EA-SA2v2-EURCHF-M5-43,EURCHFMT4,3564,1h 54m,Sell
82474.27,116436,31.05.2011 04:59:58,sl 116.436,-2.7,-222.52999999999884,0.0,0.0,115656,24.05.2011 21:30:00,6664,-0.12885589078662654,-89.56,IS,0.09,0.0,Phase3-EA-TR1v1-EURJPY-M30-91,EURJPYMT4,1020,6d 7h 29m,Sell
82318.3,1.22169,31.05.2011 07:29:58,sl 1.22169,0.0,-378.5,0.0,0.0,1.21779,31.05.2011 01:45:00,6665,-0.21917024519273087,-155.97,IS,0.34,0.0,Phase3-EA-S4v1-EURCHF-M15-221,EURCHFMT4,1660,5h 44m,Sell
82457.36,117.37,31.05.2011 10:29:58,tp 117.370,0.0,-239.44000000000233,0.0,0.0,116.11,31.05.2011 03:30:00,6666,-0.13864761825349534,139.06,IS,0.09,0.0,Phase3-EA-TR1v1-EURJPY-M30-91,EURJPYMT4,1021,6h 59m,Buy
82377.83,116882,31.05.2011 17:29:57,sl 116.882,0.0,-318.97000000000116,0.0,0.0,117602,31.05.2011 10:30:00,6667,-0.1846994269725908,-79.53,IS,0.09,0.0,Phase3-EA-TR1v1-EURJPY-M30-91,EURJPYMT4,1024,6h 59m,Buy
82400.56,81395,01.06.2011 02:45:00,,-1.49,-296.2399999999907,0.0,0.0,81468,31.05.2011 22:45:00,6668,-0.17153763127052193,22.73,IS,0.27,0.0,Phase3-EA-S1v2-USDJPY-M15-0,USDJPYMT4,2114,4h 0m,Sell
82453.51,133888,01.06.2011 04:40:00,,-1.64,-243.28999999997905,0.0,0.0,134081,31.05.2011 23:15:00,6669,-0.14087695892453078,52.95,IS,0.23,0.0,Phase3-EA-S4v1-GBPJPY-M5-194,GBPJPYMT4,1640,5h 25m,Sell
82300.09,1.22926,01.06.2011 06:25:00,,-2.4,-396.70999999999185,0.0,0.0,1.22612,31.05.2011 22:05:00,6670,-0.22971473704202502,-153.42,IS,0.41,0.0,Phase3-EA-SA2v2-EURCHF-M5-43,EURCHFMT4,3566,8h 20m,Sell
82250.95,117075,01.06.2011 06:29:58,sl 117.075,-1.02,-445.8500000000058,0.0,0.0,117305,31.05.2011 23:15:00,6671,-0.25816923069796655,-49.14,IS,0.17,0.0,Phase3-EA-T1v2-EURJPY-M15-322,EURJPYMT4,920,7h 14m,Buy
82411.22,1.22536,01.06.2011 10:44:58,tp 1.22536,0.0,-285.5800000000163,0.0,0.0,1.22936,01.06.2011 02:30:00,6672,-0.16536496333459352,160.27,IS,0.34,0.0,Phase3-EA-S4v1-EURCHF-M15-221,EURCHFMT4,1662,8h 14m,Sell
82404.39,0.84211,02.06.2011 02:15:00,,-10.96,-292.4100000000035,0.0,0.0,0.84217,01.06.2011 22:00:00,6673,-0.16931987158997938,-6.83,IS,0.58,0.0,Phase3-EA-SA2v2-USDCHF-M15-107,USDCHFMT4,1306,4h 15m,Sell
82454.4,1.20955,02.06.2011 03:49:58,tp 1.20955,-3.51,-242.39999999999418,0.0,0.0,1.20845,01.06.2011 22:55:00,6674,-0.14036160484733604,50.01,IS,0.41,0.0,Phase3-EA-SA2v2-EURCHF-M5-43,EURCHFMT4,3568,4h 54m,Buy
82615.76,1.21087,02.06.2011 04:14:58,tp 1.21087,0.0,-81.04000000000815,0.0,0.0,1.20687,02.06.2011 01:00:00,6675,-0.04692617350177198,161.36,IS,0.34,0.0,Phase3-EA-S4v1-EURCHF-M15-221,EURCHFMT4,1664,3h 14m,Buy
82535.84,116575,02.06.2011 04:29:57,sl 116.575,0.0,-160.96000000002095,0.0,0.0,115855,02.06.2011 01:00:00,6676,-0.09320381153560515,-79.92,IS,0.09,0.0,Phase3-EA-TR1v1-EURJPY-M30-91,EURJPYMT4,1026,3h 29m,Sell
82461.47,132698,02.06.2011 04:29:58,sl 132.698,0.0,-235.3300000000163,0.0,0.0,132028,02.06.2011 00:30:00,6677,-0.1362677247059681,-74.37,IS,0.09,0.0,Phase3-EA-B1v1-GBPJPY-M30-1,GBPJPYMT4,686,3h 59m,Sell
82445.96,80935,02.06.2011 08:00:00,,-4.5,-250.8400000000256,0.0,0.0,80902,01.06.2011 20:15:00,6678,-0.1452487828379134,-15.51,IS,0.27,0.0,Phase3-EA-S1v2-USDJPY-M15-0,USDJPYMT4,2116,11h 45m,Sell
82288.81,1.21462,02.06.2011 11:14:57,sl 1.21462,0.0,-407.9900000000198,0.0,0.0,1.21072,02.06.2011 05:00:00,6679,-0.23624641568345206,-157.15,IS,0.34,0.0,Phase3-EA-S4v1-EURCHF-M15-221,EURCHFMT4,1666,6h 14m,Sell
82342.31,1.21893,02.06.2011 21:24:58,tp 1.21893,0.0,-354.4900000000198,0.0,0.0,1.22003,02.06.2011 20:10:00,6680,-0.20526726609874638,53.5,IS,0.41,0.0,Phase3-EA-SA2v2-EURCHF-M5-43,EURCHFMT4,3570,1h 14m,Sell
82363.35,80951,03.06.2011 01:00:00,,-0.97,-333.45000000001164,0.0,0.0,80885,02.06.2011 21:45:00,6681,-0.19308406409384057,21.04,IS,0.27,0.0,Phase3-EA-S1v2-USDJPY-M15-0,USDJPYMT4,2118,3h 15m,Buy
82314.54,0.84371,03.06.2011 07:00:00,,0.0,-382.2600000000093,0.0,0.0,843,03.06.2011 02:45:00,6682,-0.22134747140653988,-48.81,IS,0.58,0.0,Phase3-EA-SA2v2-USDCHF-M15-107,USDCHFMT4,1308,4h 15m,Sell
82334.3,1.22055,03.06.2011 09:45:00,,0.0,-362.5,0.0,0.0,1.22104,03.06.2011 01:00:00,6683,-0.20990545279356654,19.76,IS,0.34,0.0,Phase3-EA-S4v1-EURCHF-M15-221,EURCHFMT4,1668,8h 45m,Sell
82285.76,117167,03.06.2011 18:14:58,sl 117.167,0.0,-411.04000000000815,0.0,0.0,117397,03.06.2011 17:30:00,6684,-0.23801251673453602,-48.54,IS,0.17,0.0,Phase3-EA-T1v2-EURJPY-M15-322,EURJPYMT4,922,44m 58s,Buy
82339.66,1.22323,03.06.2011 21:14:57,tp 1.22323,0.0,-357.14000000001397,0.0,0.0,1.22433,03.06.2011 21:00:00,6685,-0.2068017473398546,53.9,IS,0.41,0.0,Phase3-EA-SA2v2-EURCHF-M5-43,EURCHFMT4,3572,14m 57s,Sell
82392.52,1.22344,06.06.2011 01:54:58,tp 1.22344,-1.18,-304.28000000002794,0.0,0.0,1.22234,03.06.2011 22:25:00,6686,-0.17619318945112356,52.86,IS,0.41,0.0,Phase3-EA-SA2v2-EURCHF-M5-43,EURCHFMT4,3574,2d 3h 29m,Buy
82424.5,80209,06.06.2011 02:00:00,,0.0,-272.30000000001746,0.0,0.0,80304,06.06.2011 01:30:00,6687,-0.15767518564328784,31.98,IS,0.27,0.0,Phase3-EA-S1v2-USDJPY-M15-0,USDJPYMT4,2120,30m 0s,Sell
82478.61,1.22142,06.06.2011 02:14:59,tp 1.22142,0.0,-218.19000000003143,0.0,0.0,1.22252,06.06.2011 02:00:00,6688,-0.1263428158483721,54.11,IS,0.41,0.0,Phase3-EA-SA2v2-EURCHF-M5-43,EURCHFMT4,3576,14m 59s,Sell
82429.78,0.83378,06.06.2011 03:30:00,,-0.83,-267.0200000000186,0.0,0.0,0.83447,03.06.2011 23:15:00,6689,-0.1546178041515643,-48.83,IS,0.58,0.0,Phase3-EA-SA2v2-USDCHF-M15-107,USDCHFMT4,1310,2d 4h 15m,Buy
82541.59,131816,06.06.2011 04:19:57,tp 131.816,0.0,-155.21000000002095,0.0,0.0,132206,06.06.2011 03:20:00,6690,-0.08987427676715548,111.81,IS,0.23,0.0,Phase3-EA-S4v1-GBPJPY-M5-194,GBPJPYMT4,1642,59m 57s,Sell
82499.59,1.6411,06.06.2011 11:29:58,sl 1.64110,0.0,-197.21000000002095,0.0,0.0,1.6441,06.06.2011 10:00:00,6691,-0.11419435681496182,-42.0,IS,0.14,0.0,Phase3-EA-B1v1-GBPUSD-M30-14,GBPUSDMT4,432,1h 29m,Buy
82259.13,1.21636,06.06.2011 23:24:58,sl 1.21636,0.0,-437.6700000000128,0.0,0.0,1.22126,06.06.2011 21:05:00,6692,-0.2534326055838978,-240.46,IS,0.41,0.0,Phase3-EA-SA2v2-EURCHF-M5-43,EURCHFMT4,3578,2h 19m,Buy
82311.98,1.21806,07.06.2011 02:19:58,tp 1.21806,-1.18,-384.820000000007,0.0,0.0,1.21696,06.06.2011 23:30:00,6693,-0.2228298381904048,52.85,IS,0.41,0.0,Phase3-EA-SA2v2-EURCHF-M5-43,EURCHFMT4,3580,2h 49m,Buy
82337.53,0.83545,07.06.2011 03:45:00,,-0.83,-359.2700000000186,0.0,0.0,0.83507,06.06.2011 23:30:00,6694,-0.20803512282799605,25.55,IS,0.58,0.0,Phase3-EA-SA2v2-USDCHF-M15-107,USDCHFMT4,1312,4h 15m,Buy
82500.6,1.22148,07.06.2011 09:29:58,tp 1.22148,0.0,-196.20000000001164,0.0,0.0,1.21748,07.06.2011 01:00:00,6695,-0.11360951679475917,163.07,IS,0.34,0.0,Phase3-EA-S4v1-EURCHF-M15-221,EURCHFMT4,1670,8h 29m,Buy
82412.27,117733,07.06.2011 13:29:58,sl 117.733,-0.78,-284.52999999999884,0.0,0.0,116953,03.06.2011 04:30:00,6696,-0.16475696133338827,-88.33,IS,0.09,0.0,Phase3-EA-TR1v1-EURJPY-M30-91,EURJPYMT4,1028,4d 8h 59m,Sell
82466.13,1.22935,07.06.2011 22:34:57,tp 1.22935,0.0,-230.6700000000128,0.0,0.0,1.23045,07.06.2011 21:55:00,6697,-0.13356935391970948,53.86,IS,0.41,0.0,Phase3-EA-SA2v2-EURCHF-M5-43,EURCHFMT4,3582,39m 57s,Sell
82457.01,117665,08.06.2011 01:00:00,,0.0,-239.79000000000815,0.0,0.0,117708,08.06.2011 00:45:00,6698,-0.13885028558723045,-9.12,IS,0.17,0.0,Phase3-EA-T1v2-EURJPY-M15-322,EURJPYMT4,924,15m 0s,Buy
82509.74,1229,08.06.2011 01:34:57,tp 1.22900,-1.18,-187.05999999999767,0.0,0.0,1.2279,07.06.2011 22:50:00,6699,-0.10831700413672847,52.73,IS,0.41,0.0,Phase3-EA-SA2v2-EURCHF-M5-43,EURCHFMT4,3584,2h 44m,Buy
82563.67,1.22803,08.06.2011 02:04:58,tp 1.22803,0.0,-133.13000000000466,0.0,0.0,1.22913,08.06.2011 01:50:00,6700,-0.07708886325629928,53.93,IS,0.41,0.0,Phase3-EA-SA2v2-EURCHF-M5-43,EURCHFMT4,3586,14m 58s,Sell
82489.02,131322,08.06.2011 04:30:00,,-1.03,-207.77999999999884,0.0,0.0,131578,07.06.2011 23:05:00,6701,-0.12031491029364694,-74.65,IS,0.23,0.0,Phase3-EA-S4v1-GBPJPY-M5-194,GBPJPYMT4,1644,5h 25m,Buy
82407.3,116622,08.06.2011 13:59:58,sl 116.622,-0.55,-289.5,0.0,0.0,117342,07.06.2011 09:00:00,6702,-0.16763483747237934,-81.72,IS,0.09,0.0,Phase3-EA-TR1v1-EURJPY-M30-91,EURJPYMT4,1029,1d 4h 59m,Buy
82248.81,1.22211,08.06.2011 14:14:58,sl 1.22211,0.0,-447.9899999999907,0.0,0.0,1.22601,08.06.2011 06:30:00,6703,-0.25940839668134597,-158.49,IS,0.34,0.0,Phase3-EA-S4v1-EURCHF-M15-221,EURCHFMT4,1672,7h 44m,Buy
82302.75,1.21951,08.06.2011 21:39:58,tp 1.21951,0.0,-394.04999999998836,0.0,0.0,1.21841,08.06.2011 21:05:00,6704,-0.22817446530566193,53.94,IS,0.41,0.0,Phase3-EA-SA2v2-EURCHF-M5-43,EURCHFMT4,3588,34m 58s,Buy
82372.16,0.83566,08.06.2011 23:59:58,tp 0.83566,0.0,-324.63999999998487,0.0,0.0,0.83666,08.06.2011 22:15:00,6705,-0.18798263777903523,69.41,IS,0.58,0.0,Phase3-EA-SA2v2-USDCHF-M15-107,USDCHFMT4,1314,1h 44m,Sell
82422.59,1.21904,09.06.2011 00:04:57,tp 1.21904,-3.53,-274.20999999999185,0.0,0.0,1.21794,08.06.2011 23:05:00,6706,-0.15878117023592322,50.43,IS,0.41,0.0,Phase3-EA-SA2v2-EURCHF-M5-43,EURCHFMT4,3590,59m 57s,Buy
82383.72,0.83555,09.06.2011 06:30:00,,0.0,-313.0799999999872,0.0,0.0,0.83611,09.06.2011 02:15:00,6707,-0.18128882527064036,-38.87,IS,0.58,0.0,Phase3-EA-SA2v2-USDCHF-M15-107,USDCHFMT4,1316,4h 15m,Buy
82293.82,131522,09.06.2011 09:15:00,,0.0,-402.9799999999814,0.0,0.0,131209,09.06.2011 03:50:00,6708,-0.23334537756344148,-89.9,IS,0.23,0.0,Phase3-EA-S4v1-GBPJPY-M5-194,GBPJPYMT4,1646,5h 25m,Sell
82129.42,1.22308,09.06.2011 10:10:00,,0.0,-567.3799999999756,0.0,0.0,1.21973,09.06.2011 01:50:00,6709,-0.3285411194648515,-164.4,IS,0.41,0.0,Phase3-EA-SA2v2-EURCHF-M5-43,EURCHFMT4,3592,8h 20m,Sell
82181.84,1.22223,10.06.2011 02:54:58,tp 1.22223,-1.17,-514.9599999999627,0.0,0.0,1.22113,09.06.2011 22:40:00,6710,-0.29818734336708197,52.42,IS,0.41,0.0,Phase3-EA-SA2v2-EURCHF-M5-43,EURCHFMT4,3594,4h 14m,Buy
82093.67,115889,10.06.2011 09:29:57,sl 115.889,-0.55,-603.1299999999756,0.0,0.0,116669,09.06.2011 02:00:00,6711,-0.34924213998173426,-88.17,IS,0.09,0.0,Phase3-EA-TR1v1-EURJPY-M30-91,EURJPYMT4,1032,1d 7h 29m,Buy
82039.95,1.2191,10.06.2011 09:45:00,,0.0,-656.8499999999767,0.0,0.0,1.22043,10.06.2011 01:00:00,6712,-0.3803486804619291,-53.72,IS,0.34,0.0,Phase3-EA-S4v1-EURCHF-M15-221,EURCHFMT4,1674,8h 45m,Buy
82093.53,1.20736,10.06.2011 21:14:58,tp 1.20736,0.0,-603.2699999999895,0.0,0.0,1.20626,10.06.2011 20:50:00,6713,-0.349323206915235,53.58,IS,0.41,0.0,Phase3-EA-SA2v2-EURCHF-M5-43,EURCHFMT4,3596,24m 58s,Buy
82144.61,1.20869,13.06.2011 01:00:00,tp 1.20869,-2.43,-552.1900000000023,0.0,0.0,1.20979,10.06.2011 23:35:00,6714,-0.31974535718091035,51.08,IS,0.41,0.0,Phase3-EA-SA2v2-EURCHF-M5-43,EURCHFMT4,3598,2d 1h 25m,Sell
82198.16,1.20865,13.06.2011 03:14:57,tp 1.20865,0.0,-498.64000000001397,0.0,0.0,1.20755,13.06.2011 02:05:00,6715,-0.288737255119964,53.55,IS,0.41,0.0,Phase3-EA-SA2v2-EURCHF-M5-43,EURCHFMT4,3600,1h 9m,Buy
82266.94,0.84326,13.06.2011 04:29:58,tp 0.84326,0.0,-429.86000000001513,0.0,0.0,0.84226,13.06.2011 02:15:00,6716,-0.24891022879405708,68.78,IS,0.58,0.0,Phase3-EA-SA2v2-USDCHF-M15-107,USDCHFMT4,1318,2h 14m,Buy
82272.17,80176,14.06.2011 01:45:00,,-1.51,-424.63000000000466,0.0,0.0,80196,13.06.2011 23:00:00,6717,-0.2458817997785742,5.23,IS,0.27,0.0,Phase3-EA-S1v2-USDJPY-M15-0,USDJPYMT4,2122,2h 45m,Sell
82276.19,0.83728,14.06.2011 03:15:00,,-0.83,-420.61000000001513,0.0,0.0,0.83721,13.06.2011 23:00:00,6718,-0.2435540206882902,4.02,IS,0.58,0.0,Phase3-EA-SA2v2-USDCHF-M15-107,USDCHFMT4,1320,4h 15m,Buy
82327.62,1.20364,14.06.2011 04:14:58,tp 1.20364,-2.45,-369.1800000000221,0.0,0.0,1.20474,13.06.2011 20:45:00,6719,-0.21377350362023045,51.43,IS,0.41,0.0,Phase3-EA-SA2v2-EURCHF-M5-43,EURCHFMT4,3602,7h 29m,Sell
82439.52,131583,14.06.2011 06:04:57,tp 131.583,0.0,-257.28000000002794,0.0,0.0,131193,14.06.2011 02:10:00,6720,-0.14897786177857839,111.9,IS,0.23,0.0,Phase3-EA-S4v1-GBPJPY-M5-194,GBPJPYMT4,1648,3h 54m,Buy
82602.21,1.20744,14.06.2011 08:29:58,tp 1.20744,0.0,-94.59000000002561,0.0,0.0,1.20344,14.06.2011 05:00:00,6721,-0.054772294564824374,162.69,IS,0.34,0.0,Phase3-EA-S4v1-EURCHF-M15-221,EURCHFMT4,1676,3h 29m,Buy
82520.88,116368,14.06.2011 10:29:58,sl 116.368,-0.78,-175.9200000000128,0.0,0.0,115648,10.06.2011 10:30:00,6722,-0.10186639242881908,-81.33,IS,0.09,0.0,Phase3-EA-TR1v1-EURJPY-M30-91,EURJPYMT4,1034,3d 23h 59m,Sell
82470.86,116588,14.06.2011 17:44:58,sl 116.588,-1.48,-225.94000000000233,0.0,0.0,116358,10.06.2011 05:15:00,6723,-0.13083044966670046,-50.02,IS,0.17,0.0,Phase3-EA-T1v2-EURJPY-M15-322,EURJPYMT4,926,4d 12h 29m,Sell
82390.11,132299,14.06.2011 17:59:57,sl 132.299,-5.86,-306.6900000000023,0.0,0.0,131629,03.06.2011 11:30:00,6724,-0.17758869880623288,-80.75,IS,0.09,0.0,Phase3-EA-B1v1-GBPJPY-M30-1,GBPJPYMT4,688,11d 6h 29m,Sell
82302.93,116.61,14.06.2011 17:59:57,sl 116.610,0.0,-393.86999999999534,0.0,0.0,115.83,14.06.2011 13:30:00,6725,-0.22807023639117538,-87.18,IS,0.09,0.0,Phase3-EA-TR1v1-EURJPY-M30-91,EURJPYMT4,1036,4h 29m,Sell
82356.33,1.22312,14.06.2011 20:54:58,tp 1.22312,0.0,-340.47000000000116,0.0,0.0,1.22422,14.06.2011 20:50:00,6726,-0.19714899175896786,53.4,IS,0.41,0.0,Phase3-EA-SA2v2-EURCHF-M5-43,EURCHFMT4,3604,4m 58s,Sell
82347.27,80471,14.06.2011 22:00:00,,0.0,-349.52999999999884,0.0,0.0,80498,14.06.2011 21:00:00,6727,-0.2023951804549933,-9.06,IS,0.27,0.0,Phase3-EA-S1v2-USDJPY-M15-0,USDJPYMT4,2124,1h 0m,Buy
82366.08,80532,15.06.2011 01:15:00,,-0.97,-330.72000000000116,0.0,0.0,80473,14.06.2011 22:00:00,6728,-0.19150325889072708,18.81,IS,0.27,0.0,Phase3-EA-S1v2-USDJPY-M15-0,USDJPYMT4,2126,3h 15m,Buy
82477.61,131543,15.06.2011 04:39:58,tp 131.543,0.0,-219.19000000000233,0.0,0.0,131933,15.06.2011 01:35:00,6729,-0.126921865373303,111.53,IS,0.23,0.0,Phase3-EA-S4v1-GBPJPY-M5-194,GBPJPYMT4,1650,3h 4m,Sell
82298.35,1.21787,15.06.2011 06:20:00,,-1.16,-398.45000000001164,0.0,0.0,1.22154,14.06.2011 22:00:00,6730,-0.2307222832154456,-179.26,IS,0.41,0.0,Phase3-EA-SA2v2-EURCHF-M5-43,EURCHFMT4,3606,8h 20m,Buy
82299.72,845,15.06.2011 06:30:00,,0.0,-397.0800000000163,0.0,0.0,0.84498,15.06.2011 02:15:00,6731,-0.22992898536626985,1.37,IS,0.58,0.0,Phase3-EA-SA2v2-USDCHF-M15-107,USDCHFMT4,1322,4h 15m,Buy
82460.32,1.22395,15.06.2011 08:14:58,tp 1.22395,0.0,-236.48000000001048,0.0,0.0,1.21995,15.06.2011 03:15:00,6732,-0.13693363165965466,160.6,IS,0.34,0.0,Phase3-EA-S4v1-EURCHF-M15-221,EURCHFMT4,1678,4h 59m,Buy
82603.94,114856,15.06.2011 18:59:58,tp 114.856,-0.39,-92.86000000001513,0.0,0.0,116146,14.06.2011 23:30:00,6733,-0.05377053888665866,143.62,IS,0.09,0.0,Phase3-EA-TR1v1-EURJPY-M30-91,EURJPYMT4,1038,19h 29m,Sell
82714.67,131245,16.06.2011 04:34:58,tp 131.245,0.0,-0.0,0.0,0.0,130855,16.06.2011 01:10:00,6734,-0.0,110.73,IS,0.23,0.0,Phase3-EA-S4v1-GBPJPY-M5-194,GBPJPYMT4,1652,3h 24m,Buy
82764.11,1.21049,16.06.2011 04:59:58,tp 1.21049,-3.46,-0.0,0.0,0.0,1.20939,15.06.2011 21:30:00,6735,-0.0,49.44,IS,0.41,0.0,Phase3-EA-SA2v2-EURCHF-M5-43,EURCHFMT4,3608,7h 29m,Buy
82773.44,80993,16.06.2011 07:45:00,,0.0,-0.0,0.0,0.0,80965,16.06.2011 01:00:00,6736,-0.0,9.33,IS,0.27,0.0,Phase3-EA-S1v2-USDJPY-M15-0,USDJPYMT4,2128,6h 45m,Buy
82932.59,1.20618,16.06.2011 07:59:57,tp 1.20618,0.0,-0.0,0.0,0.0,1.21018,16.06.2011 05:15:00,6737,-0.0,159.15,IS,0.34,0.0,Phase3-EA-S4v1-EURCHF-M15-221,EURCHFMT4,1680,2h 44m,Sell
82884.07,114617,16.06.2011 23:44:58,sl 114.617,0.0,-48.51999999998952,0.0,0.0,114387,16.06.2011 08:00:00,6738,-0.028057175342131598,-48.52,IS,0.17,0.0,Phase3-EA-T1v2-EURJPY-M15-322,EURJPYMT4,928,15h 44m,Sell
82937.24,1.20485,16.06.2011 23:59:59,tp 1.20485,0.0,-0.0,0.0,0.0,1.20595,16.06.2011 23:45:00,6739,-0.0,53.17,IS,0.41,0.0,Phase3-EA-SA2v2-EURCHF-M5-43,EURCHFMT4,3610,14m 59s,Sell
83005.61,0.84837,17.06.2011 01:44:59,tp 0.84837,0.0,-0.0,0.0,0.0,0.84737,17.06.2011 00:15:00,6740,-0.0,68.37,IS,0.58,0.0,Phase3-EA-SA2v2-USDCHF-M15-107,USDCHFMT4,1324,1h 29m,Buy
82941.98,129837,17.06.2011 08:50:00,,0.0,-63.63000000000466,0.0,0.0,130.06,17.06.2011 03:25:00,6741,-0.036779154155755216,-63.63,IS,0.23,0.0,Phase3-EA-S4v1-GBPJPY-M5-194,GBPJPYMT4,1654,5h 25m,Buy
82899.98,1.61248,17.06.2011 11:59:58,sl 1.61248,0.0,-105.63000000000466,0.0,0.0,1.60948,17.06.2011 11:00:00,6742,-0.061055823565492856,-42.0,IS,0.14,0.0,Phase3-EA-B1v1-GBPUSD-M30-14,GBPUSDMT4,434,59m 58s,Sell
82953.19,1.21227,17.06.2011 20:59:58,tp 1.21227,0.0,-52.420000000012806,0.0,0.0,1.21117,17.06.2011 20:00:00,6743,-0.030299595487113286,53.21,IS,0.41,0.0,Phase3-EA-SA2v2-EURCHF-M5-43,EURCHFMT4,3612,59m 58s,Buy
83006.38,1.21238,17.06.2011 22:19:58,tp 1.21238,0.0,-0.0,0.0,0.0,1.21348,17.06.2011 21:25:00,6744,-0.0,53.19,IS,0.41,0.0,Phase3-EA-SA2v2-EURCHF-M5-43,EURCHFMT4,3614,54m 58s,Sell
82963.85,1.6135,20.06.2011 07:29:58,sl 1.61350,-0.53,-42.529999999998836,0.0,0.0,1.6165,17.06.2011 13:30:00,6745,-0.02458290844534106,-42.53,IS,0.14,0.0,Phase3-EA-B1v1-GBPUSD-M30-14,GBPUSDMT4,436,2d 17h 59m,Buy
82888.7,129953,20.06.2011 15:29:58,sl 129.953,0.0,-117.67999999999302,0.0,0.0,129283,20.06.2011 08:00:00,6746,-0.06802061288144,-75.15,IS,0.09,0.0,Phase3-EA-B1v1-GBPJPY-M30-1,GBPJPYMT4,690,7h 29m,Sell
82648.17,1.21265,21.06.2011 02:49:58,sl 1.21265,-2.42,-358.20999999999185,0.0,0.0,1.20775,20.06.2011 20:05:00,6747,-0.2070501677452542,-240.53,IS,0.41,0.0,Phase3-EA-SA2v2-EURCHF-M5-43,EURCHFMT4,3616,6h 44m,Sell
82701.6,1.21129,21.06.2011 03:39:58,tp 1.21129,0.0,-304.77999999999884,0.0,0.0,1.21239,21.06.2011 02:55:00,6748,-0.176166913613243,53.43,IS,0.41,0.0,Phase3-EA-SA2v2-EURCHF-M5-43,EURCHFMT4,3618,44m 58s,Sell
82700.8,130048,21.06.2011 04:25:00,,-1.66,-305.5799999999872,0.0,0.0,130051,20.06.2011 23:00:00,6749,-0.17662932430583614,-0.8,IS,0.23,0.0,Phase3-EA-S4v1-GBPJPY-M5-194,GBPJPYMT4,1656,5h 25m,Sell
82862.16,1.20747,21.06.2011 05:14:58,tp 1.20747,0.0,-144.22000000000116,0.0,0.0,1.21147,21.06.2011 03:30:00,6750,-0.08336108760844611,161.36,IS,0.34,0.0,Phase3-EA-S4v1-EURCHF-M15-221,EURCHFMT4,1682,1h 44m,Sell
83023.36,1.21265,21.06.2011 14:44:58,tp 1.21265,0.0,-0.0,0.0,0.0,1.20865,21.06.2011 06:00:00,6751,-0.0,161.2,IS,0.34,0.0,Phase3-EA-S4v1-EURCHF-M15-221,EURCHFMT4,1684,8h 44m,Buy
82940.18,115337,21.06.2011 18:59:58,sl 115.337,-2.34,-83.17999999999302,0.0,0.0,114617,15.06.2011 21:00:00,6752,-0.04807443341754144,-83.18,IS,0.09,0.0,Phase3-EA-TR1v1-EURJPY-M30-91,EURJPYMT4,1040,5d 21h 59m,Sell
82993.79,1.21114,21.06.2011 21:14:59,tp 1.21114,0.0,-29.570000000006985,0.0,0.0,1.21004,21.06.2011 20:45:00,6753,-0.01709017788118725,53.61,IS,0.41,0.0,Phase3-EA-SA2v2-EURCHF-M5-43,EURCHFMT4,3620,29m 59s,Buy
83061.9,0.84133,22.06.2011 00:59:58,tp 0.84133,-0.83,-0.0,0.0,0.0,0.84033,21.06.2011 22:15:00,6754,-0.0,68.11,IS,0.58,0.0,Phase3-EA-SA2v2-USDCHF-M15-107,USDCHFMT4,1326,2h 44m,Buy
83085.75,130114,22.06.2011 04:25:00,,-1.66,-0.0,0.0,0.0,130203,21.06.2011 23:00:00,6755,-0.0,23.85,IS,0.23,0.0,Phase3-EA-S4v1-GBPJPY-M5-194,GBPJPYMT4,1658,5h 25m,Sell
83102.29,115249,22.06.2011 04:30:00,,-1.04,-0.0,0.0,0.0,115166,21.06.2011 14:00:00,6756,-0.0,16.54,IS,0.17,0.0,Phase3-EA-T1v2-EURJPY-M15-322,EURJPYMT4,930,14h 30m,Buy
83263.93,1.21396,22.06.2011 09:44:58,tp 1.21396,0.0,-0.0,0.0,0.0,1.20996,22.06.2011 02:30:00,6757,-0.0,161.64,IS,0.34,0.0,Phase3-EA-S4v1-EURCHF-M15-221,EURCHFMT4,1686,7h 14m,Buy
83220.87,1.61421,22.06.2011 11:59:58,sl 1.61421,-1.06,-43.05999999999767,0.0,0.0,1.61721,20.06.2011 15:00:00,6758,-0.024852258632248315,-43.06,IS,0.14,0.0,Phase3-EA-B1v1-GBPUSD-M30-14,GBPUSDMT4,438,1d 20h 59m,Buy
83172.09,115268,22.06.2011 12:44:58,sl 115.268,0.0,-91.83999999999651,0.0,0.0,115498,22.06.2011 09:00:00,6759,-0.053005839126468224,-48.78,IS,0.17,0.0,Phase3-EA-T1v2-EURJPY-M15-322,EURJPYMT4,932,3h 44m,Buy
83123.25,115343,22.06.2011 18:44:58,sl 115.343,0.0,-140.67999999999302,0.0,0.0,115573,22.06.2011 18:00:00,6760,-0.08119404887098719,-48.84,IS,0.17,0.0,Phase3-EA-T1v2-EURJPY-M15-322,EURJPYMT4,934,44m 58s,Buy
83176.99,1.20558,22.06.2011 22:34:58,tp 1.20558,0.0,-86.94000000000233,0.0,0.0,1.20668,22.06.2011 22:10:00,6761,-0.05017778368527272,53.74,IS,0.41,0.0,Phase3-EA-SA2v2-EURCHF-M5-43,EURCHFMT4,3622,24m 58s,Sell
83226.98,1.2055,23.06.2011 04:04:58,tp 1.20550,-3.52,-36.95000000001164,0.0,0.0,1.2044,22.06.2011 23:10:00,6762,-0.02132584664333289,49.99,IS,0.41,0.0,Phase3-EA-SA2v2-EURCHF-M5-43,EURCHFMT4,3624,4h 54m,Buy
83069.39,1.19931,23.06.2011 10:14:58,sl 1.19931,0.0,-194.54000000000815,0.0,0.0,1.20321,23.06.2011 01:45:00,6763,-0.11227957255731656,-157.59,IS,0.34,0.0,Phase3-EA-S4v1-EURCHF-M15-221,EURCHFMT4,1688,8h 29m,Buy
83212.21,114085,23.06.2011 16:59:58,tp 114.085,-1.18,-51.720000000001164,0.0,0.0,115375,22.06.2011 02:30:00,6764,-0.029850413758940576,142.82,IS,0.09,0.0,Phase3-EA-TR1v1-EURJPY-M30-91,EURJPYMT4,1042,1d 14h 29m,Sell
82972.44,1.19425,23.06.2011 22:49:58,sl 1.19425,0.0,-291.4899999999907,0.0,0.0,1.18935,23.06.2011 21:05:00,6765,-0.16823466950102697,-239.77,IS,0.41,0.0,Phase3-EA-SA2v2-EURCHF-M5-43,EURCHFMT4,3626,1h 44m,Sell
82891.95,114833,23.06.2011 22:59:58,sl 114.833,0.0,-371.9799999999814,0.0,0.0,114113,23.06.2011 17:00:00,6766,-0.21468980877900057,-80.49,IS,0.09,0.0,Phase3-EA-TR1v1-EURJPY-M30-91,EURJPYMT4,1044,5h 59m,Sell
82961.09,0.83888,24.06.2011 02:59:57,tp 0.83888,0.0,-302.8399999999674,0.0,0.0,0.83788,24.06.2011 01:30:00,6767,-0.17478536934950478,69.14,IS,0.58,0.0,Phase3-EA-SA2v2-USDCHF-M15-107,USDCHFMT4,1328,1h 29m,Buy
83012.49,1.19391,24.06.2011 04:19:57,tp 1.19391,-2.44,-251.43999999997322,0.0,0.0,1.19501,23.06.2011 22:55:00,6768,-0.1451196449255037,51.4,IS,0.41,0.0,Phase3-EA-SA2v2-EURCHF-M5-43,EURCHFMT4,3628,5h 24m,Sell
83128.58,1.1925,24.06.2011 09:45:00,,0.0,-135.34999999997672,0.0,0.0,1.19536,24.06.2011 01:00:00,6769,-0.07811781713595942,116.09,IS,0.34,0.0,Phase3-EA-S4v1-EURCHF-M15-221,EURCHFMT4,1690,8h 45m,Sell
83086.58,1.59959,24.06.2011 13:59:58,sl 1.59959,0.0,-177.34999999997672,0.0,0.0,1.60259,24.06.2011 12:00:00,6770,-0.10235829234623545,-42.0,IS,0.14,0.0,Phase3-EA-B1v1-GBPUSD-M30-14,GBPUSDMT4,440,1h 59m,Buy
83140.44,1.18586,24.06.2011 20:19:57,tp 1.18586,0.0,-123.48999999999069,0.0,0.0,1.18476,24.06.2011 20:05:00,6771,-0.07127276865992287,53.86,IS,0.41,0.0,Phase3-EA-SA2v2-EURCHF-M5-43,EURCHFMT4,3630,14m 57s,Buy
83194.32,1.18622,24.06.2011 23:49:57,tp 1.18622,0.0,-69.60999999998603,0.0,0.0,1.18732,24.06.2011 22:40:00,6772,-0.04017570189016608,53.88,IS,0.41,0.0,Phase3-EA-SA2v2-EURCHF-M5-43,EURCHFMT4,3632,1h 9m,Sell
83224.54,128.56,27.06.2011 09:00:00,,0.0,-39.389999999984866,0.0,0.0,128666,27.06.2011 03:35:00,6773,-0.022734102822200137,30.22,IS,0.23,0.0,Phase3-EA-S4v1-GBPJPY-M5-194,GBPJPYMT4,1660,5h 25m,Sell
83386.91,1.18679,27.06.2011 10:29:58,tp 1.18679,0.0,-0.0,0.0,0.0,1.18279,27.06.2011 03:15:00,6774,-0.0,162.37,IS,0.34,0.0,Phase3-EA-S4v1-EURCHF-M15-221,EURCHFMT4,1692,7h 14m,Buy
83260.58,80684,27.06.2011 13:45:00,,-1.51,-126.3299999999872,0.0,0.0,80311,24.06.2011 17:15:00,6775,-0.07286017150890294,-126.33,IS,0.27,0.0,Phase3-EA-S1v2-USDJPY-M15-0,USDJPYMT4,2130,2d 20h 30m,Sell
83208.54,115515,27.06.2011 17:44:58,sl 115.515,-3.7,-178.36999999999534,0.0,0.0,115285,22.06.2011 23:15:00,6776,-0.10287397128191242,-52.04,IS,0.17,0.0,Phase3-EA-T1v2-EURJPY-M15-322,EURJPYMT4,936,4d 18h 29m,Sell
83262.61,1.19353,28.06.2011 02:59:58,tp 1.19353,0.0,-124.29999999998836,0.0,0.0,1.19463,28.06.2011 01:50:00,6777,-0.0716893795500412,54.07,IS,0.41,0.0,Phase3-EA-SA2v2-EURCHF-M5-43,EURCHFMT4,3634,1h 9m,Sell
83425.39,1.19065,28.06.2011 09:44:58,tp 1.19065,0.0,-0.0,0.0,0.0,1.19465,28.06.2011 02:45:00,6778,-0.0,162.78,IS,0.34,0.0,Phase3-EA-S4v1-EURCHF-M15-221,EURCHFMT4,1694,6h 59m,Sell
83402.37,80819,28.06.2011 10:00:00,,-0.97,-23.019999999989523,0.0,0.0,80885,27.06.2011 21:30:00,6779,-0.013273719609331438,-23.02,IS,0.27,0.0,Phase3-EA-S1v2-USDJPY-M15-0,USDJPYMT4,2132,12h 30m,Buy
83404.35,1.19343,29.06.2011 04:30:00,,-2.46,-21.039999999979045,0.0,0.0,1.19352,28.06.2011 20:10:00,6780,-0.01213201827020775,1.98,IS,0.41,0.0,Phase3-EA-SA2v2-EURCHF-M5-43,EURCHFMT4,3636,8h 20m,Sell
83392.36,81042,29.06.2011 07:45:00,,0.0,-33.02999999996973,0.0,0.0,81078,29.06.2011 00:30:00,6781,-0.019045654157081458,-11.99,IS,0.27,0.0,Phase3-EA-S1v2-USDJPY-M15-0,USDJPYMT4,2134,7h 15m,Buy
83531.23,116731,29.06.2011 10:29:57,tp 116.731,-1.09,-0.0,0.0,0.0,115471,27.06.2011 21:00:00,6782,-0.0,138.87,IS,0.09,0.0,Phase3-EA-TR1v1-EURJPY-M30-91,EURJPYMT4,1046,1d 13h 29m,Buy
83694.97,1.19791,29.06.2011 11:29:57,tp 1.19791,0.0,-0.0,0.0,0.0,1.19391,29.06.2011 05:00:00,6783,-0.0,163.74,IS,0.34,0.0,Phase3-EA-S4v1-EURCHF-M15-221,EURCHFMT4,1696,6h 29m,Buy
83614.99,116313,29.06.2011 15:59:57,sl 116.313,0.0,-79.98000000001048,0.0,0.0,117033,29.06.2011 14:00:00,6784,-0.04604623841439419,-79.98,IS,0.09,0.0,Phase3-EA-TR1v1-EURJPY-M30-91,EURJPYMT4,1048,1h 59m,Buy
83719.37,116146,29.06.2011 17:30:00,,-1.03,-0.0,0.0,0.0,115645,28.06.2011 16:00:00,6785,-0.0,104.38,IS,0.17,0.0,Phase3-EA-T1v2-EURJPY-M15-322,EURJPYMT4,938,1d 1h 30m,Buy
83755.13,80.78,29.06.2011 23:15:00,,0.0,-0.0,0.0,0.0,80887,29.06.2011 20:15:00,6786,-0.0,35.76,IS,0.27,0.0,Phase3-EA-S1v2-USDJPY-M15-0,USDJPYMT4,2136,3h 0m,Sell
83809.24,1.20517,30.06.2011 03:19:59,tp 1.20517,0.0,-0.0,0.0,0.0,1.20627,30.06.2011 02:30:00,6787,-0.0,54.11,IS,0.41,0.0,Phase3-EA-SA2v2-EURCHF-M5-43,EURCHFMT4,3638,49m 59s,Sell
83757.59,116479,30.06.2011 04:29:58,sl 116.479,-3.09,-51.64999999999418,0.0,0.0,116709,29.06.2011 20:45:00,6788,-0.02971648687952043,-51.65,IS,0.17,0.0,Phase3-EA-T1v2-EURJPY-M15-322,EURJPYMT4,940,7h 44m,Buy
83598.44,1.20937,30.06.2011 10:44:58,sl 1.20937,0.0,-210.79999999998836,0.0,0.0,1.20547,30.06.2011 03:15:00,6789,-0.12128238982000515,-159.15,IS,0.34,0.0,Phase3-EA-S4v1-EURCHF-M15-221,EURCHFMT4,1698,7h 29m,Sell
83652.12,1.22029,30.06.2011 22:34:58,tp 1.22029,0.0,-157.11999999999534,0.0,0.0,1.21919,30.06.2011 20:45:00,6790,-0.0903979558278923,53.68,IS,0.41,0.0,Phase3-EA-SA2v2-EURCHF-M5-43,EURCHFMT4,3640,1h 49m,Buy
83697.72,80597,01.07.2011 01:15:00,,-0.97,-111.51999999998952,0.0,0.0,80458,30.06.2011 22:15:00,6791,-0.06416229654993573,45.6,IS,0.27,0.0,Phase3-EA-S1v2-USDJPY-M15-0,USDJPYMT4,2138,3h 0m,Buy
83750.12,1.2199,01.07.2011 02:24:58,tp 1.21990,-1.17,-59.11999999999534,0.0,0.0,1.2188,30.06.2011 23:15:00,6792,-0.034014302116501596,52.4,IS,0.41,0.0,Phase3-EA-SA2v2-EURCHF-M5-43,EURCHFMT4,3642,3h 9m,Buy
83803.69,1.21876,01.07.2011 02:34:58,tp 1.21876,0.0,-5.5499999999883585,0.0,0.0,1.21986,01.07.2011 02:25:00,6793,-0.003193155898954715,53.57,IS,0.41,0.0,Phase3-EA-SA2v2-EURCHF-M5-43,EURCHFMT4,3644,9m 58s,Sell
83872.64,0.84113,01.07.2011 04:44:57,tp 0.84113,0.0,-0.0,0.0,0.0,0.84213,01.07.2011 02:45:00,6794,-0.0,68.95,IS,0.58,0.0,Phase3-EA-SA2v2-USDCHF-M15-107,USDCHFMT4,1330,1h 59m,Sell
83834.29,116891,01.07.2011 15:15:00,,0.0,-38.35000000000582,0.0,0.0,117073,01.07.2011 04:00:00,6795,-0.02205637413684281,-38.35,IS,0.17,0.0,Phase3-EA-T1v2-EURJPY-M15-322,EURJPYMT4,942,11h 15m,Buy
83764.6,1.23261,04.07.2011 05:30:00,,-2.42,-108.04000000000815,0.0,0.0,1.23122,01.07.2011 21:10:00,6796,-0.062137435769082545,-69.69,IS,0.41,0.0,Phase3-EA-SA2v2-EURCHF-M5-43,EURCHFMT4,3646,2d 8h 20m,Sell
83733.24,117152,04.07.2011 08:30:00,,-1.03,-139.39999999999418,0.0,0.0,117296,01.07.2011 17:45:00,6797,-0.08017362593677427,-31.36,IS,0.17,0.0,Phase3-EA-T1v2-EURJPY-M15-322,EURJPYMT4,944,2d 14h 45m,Buy
83736.04,1.23363,04.07.2011 12:30:00,,0.0,-136.60000000000582,0.0,0.0,1.2337,04.07.2011 03:45:00,6798,-0.0785632518146649,2.8,IS,0.34,0.0,Phase3-EA-S4v1-EURCHF-M15-221,EURCHFMT4,1700,8h 45m,Sell
83789.19,1.23251,05.07.2011 03:19:58,tp 1.23251,0.0,-83.45000000001164,0.0,0.0,1.23361,05.07.2011 02:40:00,6799,-0.047994900175215384,53.15,IS,0.41,0.0,Phase3-EA-SA2v2-EURCHF-M5-43,EURCHFMT4,3648,39m 58s,Sell
83722.01,0.84875,05.07.2011 03:30:00,,-3.63,-150.63000000000466,0.0,0.0,0.84782,04.07.2011 23:15:00,6800,-0.08663237643369573,-67.18,IS,0.58,0.0,Phase3-EA-SA2v2-USDCHF-M15-107,USDCHFMT4,1332,4h 15m,Sell
83565.37,1.22506,05.07.2011 11:14:58,sl 1.22506,0.0,-307.2700000000186,0.0,0.0,1.22896,05.07.2011 06:45:00,6801,-0.17672130589379592,-156.64,IS,0.34,0.0,Phase3-EA-S4v1-EURCHF-M15-221,EURCHFMT4,1702,4h 29m,Buy
83551.32,117332,05.07.2011 17:00:00,,0.0,-321.320000000007,0.0,0.0,117399,05.07.2011 10:45:00,6802,-0.18480193318512153,-14.05,IS,0.17,0.0,Phase3-EA-T1v2-EURJPY-M15-322,EURJPYMT4,946,6h 15m,Buy
83509.32,1.60666,05.07.2011 19:59:58,sl 1.60666,0.0,-363.320000000007,0.0,0.0,1.60966,05.07.2011 12:30:00,6803,-0.20895754501686228,-42.0,IS,0.14,0.0,Phase3-EA-B1v1-GBPUSD-M30-14,GBPUSDMT4,442,7h 29m,Buy
83428.89,116971,05.07.2011 21:29:59,sl 116.971,-0.55,-443.75,0.0,0.0,117004,01.07.2011 14:00:00,6804,-0.2552155416746418,-80.43,IS,0.09,0.0,Phase3-EA-TR1v1-EURJPY-M30-91,EURJPYMT4,1050,4d 7h 29m,Sell
83425.28,1.21397,06.07.2011 05:45:00,,-1.17,-447.35999999998603,0.0,0.0,1.21402,05.07.2011 21:25:00,6805,-0.25729177402493336,-3.61,IS,0.41,0.0,Phase3-EA-SA2v2-EURCHF-M5-43,EURCHFMT4,3650,8h 20m,Buy
83413.91,129925,06.07.2011 09:00:00,,0.0,-458.7299999999814,0.0,0.0,129965,06.07.2011 03:35:00,6806,-0.2638310432279519,-11.37,IS,0.23,0.0,Phase3-EA-S4v1-GBPJPY-M5-194,GBPJPYMT4,1662,5h 25m,Buy
83556.21,115714,06.07.2011 17:29:58,tp 115.714,-1.17,-316.429999999993,0.0,0.0,117691,04.07.2011 02:30:00,6807,-0.18198952980756083,142.3,IS,0.09,0.0,Phase3-EA-TR1v1-EURJPY-M30-91,EURJPYMT4,1051,2d 14h 59m,Buy
83609.88,1.20165,06.07.2011 21:14:58,tp 1.20165,0.0,-262.7599999999802,0.0,0.0,1.20275,06.07.2011 20:55:00,6808,-0.15112210868827905,53.67,IS,0.41,0.0,Phase3-EA-SA2v2-EURCHF-M5-43,EURCHFMT4,3652,19m 58s,Sell
83663.61,1.20128,06.07.2011 21:49:57,tp 1.20128,0.0,-209.02999999996973,0.0,0.0,1.20018,06.07.2011 21:20:00,6809,-0.1202201795520961,53.73,IS,0.41,0.0,Phase3-EA-SA2v2-EURCHF-M5-43,EURCHFMT4,3654,29m 57s,Buy
83737.51,129319,07.07.2011 07:35:00,,0.0,-135.12999999997555,0.0,0.0,129579,07.07.2011 02:10:00,6810,-0.07771780540053658,73.9,IS,0.23,0.0,Phase3-EA-S4v1-GBPJPY-M5-194,GBPJPYMT4,1664,5h 25m,Sell
83611.05,1.20408,07.07.2011 09:25:00,,0.0,-261.5899999999674,0.0,0.0,1.20149,07.07.2011 01:05:00,6811,-0.15044920235867318,-126.46,IS,0.41,0.0,Phase3-EA-SA2v2-EURCHF-M5-43,EURCHFMT4,3656,8h 20m,Sell
83964.94,115.52,07.07.2011 14:59:58,tp 115.520,-2.94,-0.0,0.0,0.0,117.22,05.07.2011 21:15:00,6812,-0.0,353.89,IS,0.17,0.0,Phase3-EA-T1v2-EURJPY-M15-322,EURJPYMT4,948,1d 17h 44m,Sell
83884.05,116578,07.07.2011 17:59:58,sl 116.578,-1.17,-80.89000000001397,0.0,0.0,115858,06.07.2011 17:00:00,6813,-0.046497874801677816,-80.89,IS,0.09,0.0,Phase3-EA-TR1v1-EURJPY-M30-91,EURJPYMT4,1053,1d 0h 59m,Sell
83937.42,1.21212,07.07.2011 21:54:58,tp 1.21212,0.0,-27.520000000018626,0.0,0.0,1.21322,07.07.2011 21:45:00,6814,-0.015819279447927045,53.37,IS,0.41,0.0,Phase3-EA-SA2v2-EURCHF-M5-43,EURCHFMT4,3658,9m 58s,Sell
83953.74,81248,08.07.2011 01:30:00,,-0.96,-11.200000000011642,0.0,0.0,81196,07.07.2011 19:45:00,6815,-0.0064380788450889214,16.32,IS,0.27,0.0,Phase3-EA-S1v2-USDJPY-M15-0,USDJPYMT4,2140,5h 45m,Buy
84022.35,0.84534,08.07.2011 02:44:58,tp 0.84534,0.0,-0.0,0.0,0.0,0.84434,08.07.2011 00:15:00,6816,-0.0,68.61,IS,0.58,0.0,Phase3-EA-SA2v2-USDCHF-M15-107,USDCHFMT4,1334,2h 29m,Buy
84075.75,1.21181,08.07.2011 06:04:59,tp 1.21181,0.0,-0.0,0.0,0.0,1.21291,08.07.2011 00:55:00,6817,-0.0,53.4,IS,0.41,0.0,Phase3-EA-SA2v2-EURCHF-M5-43,EURCHFMT4,3660,5h 9m,Sell
84236.5,1.21625,08.07.2011 10:29:58,tp 1.21625,0.0,-0.0,0.0,0.0,1.21225,08.07.2011 04:15:00,6818,-0.0,160.75,IS,0.34,0.0,Phase3-EA-S4v1-EURCHF-M15-221,EURCHFMT4,1704,6h 14m,Buy
84379.02,115245,08.07.2011 15:59:58,tp 115.245,0.0,-0.0,0.0,0.0,116535,08.07.2011 08:00:00,6819,-0.0,142.52,IS,0.09,0.0,Phase3-EA-TR1v1-EURJPY-M30-91,EURJPYMT4,1056,7h 59m,Sell
84432.93,1.19249,08.07.2011 22:09:57,tp 1.19249,0.0,-0.0,0.0,0.0,1.19139,08.07.2011 21:35:00,6820,-0.0,53.91,IS,0.41,0.0,Phase3-EA-SA2v2-EURCHF-M5-43,EURCHFMT4,3662,34m 57s,Buy
84436.65,80657,11.07.2011 01:45:00,,-0.97,-0.0,0.0,0.0,80643,08.07.2011 21:30:00,6821,-0.0,3.72,IS,0.27,0.0,Phase3-EA-S1v2-USDJPY-M15-0,USDJPYMT4,2142,2d 4h 15m,Buy
84490.52,1.19028,11.07.2011 03:04:58,tp 1.19028,0.0,-0.0,0.0,0.0,1.18918,11.07.2011 01:15:00,6822,-0.0,53.87,IS,0.41,0.0,Phase3-EA-SA2v2-EURCHF-M5-43,EURCHFMT4,3664,1h 49m,Buy
84385.46,1.18733,11.07.2011 10:15:00,,0.0,-105.05999999999767,0.0,0.0,1.18992,11.07.2011 01:30:00,6823,-0.060209574709272254,-105.06,IS,0.34,0.0,Phase3-EA-S4v1-EURCHF-M15-221,EURCHFMT4,1706,8h 45m,Buy
84589.4,127968,11.07.2011 16:29:58,tp 127.968,-3.23,-0.0,0.0,0.0,129818,06.07.2011 09:30:00,6824,-0.0,203.94,IS,0.09,0.0,Phase3-EA-B1v1-GBPJPY-M30-1,GBPJPYMT4,692,5d 6h 59m,Sell
84730.36,112523,11.07.2011 17:59:58,tp 112.523,0.0,-0.0,0.0,0.0,113783,11.07.2011 14:00:00,6825,-0.0,140.96,IS,0.09,0.0,Phase3-EA-TR1v1-EURJPY-M30-91,EURJPYMT4,1058,3h 59m,Sell
84784.34,1.17192,11.07.2011 20:44:58,tp 1.17192,0.0,-0.0,0.0,0.0,1.17302,11.07.2011 20:05:00,6826,-0.0,53.98,IS,0.41,0.0,Phase3-EA-SA2v2-EURCHF-M5-43,EURCHFMT4,3666,39m 58s,Sell
84838.32,1.1725,11.07.2011 23:54:57,tp 1.17250,0.0,-0.0,0.0,0.0,1.1714,11.07.2011 21:25:00,6827,-0.0,53.98,IS,0.41,0.0,Phase3-EA-SA2v2-EURCHF-M5-43,EURCHFMT4,3668,2h 29m,Buy
84892.27,1.17135,12.07.2011 03:24:57,tp 1.17135,0.0,-0.0,0.0,0.0,1.17245,12.07.2011 00:05:00,6828,-0.0,53.95,IS,0.41,0.0,Phase3-EA-SA2v2-EURCHF-M5-43,EURCHFMT4,3670,3h 19m,Sell
84961.72,0.83513,12.07.2011 03:59:58,tp 0.83513,0.0,-0.0,0.0,0.0,0.83613,12.07.2011 01:00:00,6829,-0.0,69.45,IS,0.58,0.0,Phase3-EA-SA2v2-USDCHF-M15-107,USDCHFMT4,1336,2h 59m,Sell
85124.52,1.16986,12.07.2011 04:44:58,tp 1.16986,0.0,-0.0,0.0,0.0,1.17386,12.07.2011 01:45:00,6830,-0.0,162.8,IS,0.34,0.0,Phase3-EA-S4v1-EURCHF-M15-221,EURCHFMT4,1708,2h 59m,Sell
85286.81,1.17179,12.07.2011 08:44:58,tp 1.17179,0.0,-0.0,0.0,0.0,1.16779,12.07.2011 05:45:00,6831,-0.0,162.29,IS,0.34,0.0,Phase3-EA-S4v1-EURCHF-M15-221,EURCHFMT4,1710,2h 59m,Buy
85165.41,127076,12.07.2011 08:55:00,,0.0,-121.39999999999418,0.0,0.0,127499,12.07.2011 03:30:00,6832,-0.0692579207756671,-121.4,IS,0.23,0.0,Phase3-EA-S4v1-GBPJPY-M5-194,GBPJPYMT4,1666,5h 25m,Buy
85306.99,111176,12.07.2011 09:59:57,tp 111.176,-0.39,-0.0,0.0,0.0,112436,11.07.2011 18:00:00,6833,-0.0,141.58,IS,0.09,0.0,Phase3-EA-TR1v1-EURJPY-M30-91,EURJPYMT4,1060,15h 59m,Sell
85668.75,110.72,12.07.2011 10:29:58,tp 110.720,0.0,-0.0,0.0,0.0,112.42,12.07.2011 03:30:00,6834,-0.0,361.76,IS,0.17,0.0,Phase3-EA-T1v2-EURJPY-M15-322,EURJPYMT4,950,6h 59m,Sell
85876.83,125597,12.07.2011 11:29:57,tp 125.597,-0.65,-0.0,0.0,0.0,127447,11.07.2011 21:30:00,6835,-0.0,208.08,IS,0.09,0.0,Phase3-EA-B1v1-GBPJPY-M30-1,GBPJPYMT4,694,13h 59m,Sell
85633.78,1.15913,13.07.2011 00:04:58,sl 1.15913,-1.18,-243.04999999998836,0.0,0.0,1.16403,12.07.2011 22:20:00,6836,-0.13819330266527335,-243.05,IS,0.41,0.0,Phase3-EA-SA2v2-EURCHF-M5-43,EURCHFMT4,3672,1h 44m,Buy
85543.82,110439,13.07.2011 00:29:58,sl 110.439,-0.56,-333.0099999999802,0.0,0.0,111219,12.07.2011 12:30:00,6837,-0.18934273491282513,-89.96,IS,0.09,0.0,Phase3-EA-TR1v1-EURJPY-M30-91,EURJPYMT4,1062,11h 59m,Buy
85657.17,126124,13.07.2011 00:59:57,tp 126.124,0.0,-219.6599999999744,0.0,0.0,125734,13.07.2011 00:20:00,6838,-0.1248942228490099,113.35,IS,0.23,0.0,Phase3-EA-S4v1-GBPJPY-M5-194,GBPJPYMT4,1668,39m 57s,Buy
85711.45,1.16051,13.07.2011 01:44:57,tp 1.16051,0.0,-165.37999999997555,0.0,0.0,1.15941,13.07.2011 00:15:00,6839,-0.0940317152634463,54.28,IS,0.41,0.0,Phase3-EA-SA2v2-EURCHF-M5-43,EURCHFMT4,3674,1h 29m,Buy
85874.98,1.16309,13.07.2011 02:44:57,tp 1.16309,0.0,-1.849999999976717,0.0,0.0,1.15909,13.07.2011 01:00:00,6840,-0.0010518724950732375,163.53,IS,0.34,0.0,Phase3-EA-S4v1-EURCHF-M15-221,EURCHFMT4,1712,1h 44m,Buy
85825.0,111154,13.07.2011 02:59:58,sl 111.154,-0.75,-51.829999999987194,0.0,0.0,110924,12.07.2011 23:00:00,6841,-0.029469487254226254,-49.98,IS,0.17,0.0,Phase3-EA-T1v2-EURJPY-M15-322,EURJPYMT4,952,3h 59m,Sell
85841.49,126591,13.07.2011 08:35:00,,0.0,-35.33999999999651,0.0,0.0,126648,13.07.2011 03:10:00,6842,-0.02009360755478507,16.49,IS,0.23,0.0,Phase3-EA-S4v1-GBPJPY-M5-194,GBPJPYMT4,1670,5h 25m,Sell
85600.08,1.16685,13.07.2011 08:59:58,sl 1.16685,0.0,-276.75,0.0,0.0,1.16195,13.07.2011 02:25:00,6843,-0.15735443946766603,-241.41,IS,0.41,0.0,Phase3-EA-SA2v2-EURCHF-M5-43,EURCHFMT4,3676,6h 34m,Sell
85864.15,1.6085,13.07.2011 18:29:58,tp 1.60850,-0.53,-12.679999999993015,0.0,0.0,1.5896,12.07.2011 17:30:00,6844,-0.007209590939291441,264.07,IS,0.14,0.0,Phase3-EA-B1v1-GBPUSD-M30-14,GBPUSDMT4,444,1d 0h 59m,Buy
85919.14,1.16018,13.07.2011 21:34:58,tp 1.16018,0.0,-0.0,0.0,0.0,1.15908,13.07.2011 20:10:00,6845,-0.0,54.99,IS,0.41,0.0,Phase3-EA-SA2v2-EURCHF-M5-43,EURCHFMT4,3678,1h 24m,Buy
85896.07,79033,14.07.2011 00:15:00,,-4.62,-23.070000000006985,0.0,0.0,78979,13.07.2011 23:30:00,6846,-0.013113979524915241,-23.07,IS,0.27,0.0,Phase3-EA-S1v2-USDJPY-M15-0,USDJPYMT4,2144,45m 0s,Sell
85805.62,112097,14.07.2011 00:29:58,sl 112.097,-1.2,-113.52000000001863,0.0,0.0,111317,13.07.2011 17:00:00,6847,-0.06452964697304601,-90.45,IS,0.09,0.0,Phase3-EA-TR1v1-EURJPY-M30-91,EURJPYMT4,1064,7h 29m,Sell
85861.27,1.15323,14.07.2011 01:09:58,tp 1.15323,0.0,-57.87000000002445,0.0,0.0,1.15213,14.07.2011 00:30:00,6848,-0.03289579519319184,55.65,IS,0.41,0.0,Phase3-EA-SA2v2-EURCHF-M5-43,EURCHFMT4,3680,39m 58s,Buy
85932.65,0.8125,14.07.2011 01:44:57,tp 0.81250,0.0,-0.0,0.0,0.0,0.8115,14.07.2011 01:15:00,6849,-0.0,71.38,IS,0.58,0.0,Phase3-EA-SA2v2-USDCHF-M15-107,USDCHFMT4,1338,29m 57s,Buy
85843.38,112673,14.07.2011 08:59:58,sl 112.673,0.0,-89.26999999998952,0.0,0.0,111893,14.07.2011 04:30:00,6850,-0.05074100799367798,-89.27,IS,0.09,0.0,Phase3-EA-TR1v1-EURJPY-M30-91,EURJPYMT4,1066,4h 29m,Sell
86009.82,1.15765,14.07.2011 09:44:58,tp 1.15765,0.0,-0.0,0.0,0.0,1.15365,14.07.2011 01:15:00,6851,-0.0,166.44,IS,0.34,0.0,Phase3-EA-S4v1-EURCHF-M15-221,EURCHFMT4,1714,8h 29m,Buy
85960.35,112042,14.07.2011 10:14:57,sl 112.042,0.0,-49.470000000001164,0.0,0.0,112272,14.07.2011 09:30:00,6852,-0.028106386336853903,-49.47,IS,0.17,0.0,Phase3-EA-T1v2-EURJPY-M15-322,EURJPYMT4,954,44m 57s,Buy
86015.65,1.15667,14.07.2011 20:29:58,tp 1.15667,0.0,-0.0,0.0,0.0,1.15557,14.07.2011 20:05:00,6853,-0.0,55.3,IS,0.41,0.0,Phase3-EA-SA2v2-EURCHF-M5-43,EURCHFMT4,3682,24m 58s,Buy
86069.73,1.15518,15.07.2011 02:39:57,tp 1.15518,-1.21,-0.0,0.0,0.0,1.15408,14.07.2011 22:15:00,6854,-0.0,54.08,IS,0.41,0.0,Phase3-EA-SA2v2-EURCHF-M5-43,EURCHFMT4,3684,4h 24m,Buy
86125.05,1.15395,15.07.2011 03:29:58,tp 1.15395,0.0,-0.0,0.0,0.0,1.15285,15.07.2011 02:45:00,6855,-0.0,55.32,IS,0.41,0.0,Phase3-EA-SA2v2-EURCHF-M5-43,EURCHFMT4,3686,44m 58s,Buy
86083.05,1.61324,15.07.2011 10:29:58,sl 1.61324,0.0,-42.0,0.0,0.0,1.61624,15.07.2011 05:00:00,6856,-0.023846693017262444,-42.0,IS,0.14,0.0,Phase3-EA-B1v1-GBPUSD-M30-14,GBPUSDMT4,446,5h 29m,Buy
85920.99,1.15902,15.07.2011 12:59:58,sl 1.15902,0.0,-204.05999999999767,0.0,0.0,1.15512,15.07.2011 06:15:00,6857,-0.11586086135958377,-162.06,IS,0.34,0.0,Phase3-EA-S4v1-EURCHF-M15-221,EURCHFMT4,1716,6h 44m,Sell
85976.36,1.15365,15.07.2011 23:49:58,tp 1.15365,0.0,-148.69000000000233,0.0,0.0,1.15255,15.07.2011 21:10:00,6858,-0.0844229710651621,55.37,IS,0.41,0.0,Phase3-EA-SA2v2-EURCHF-M5-43,EURCHFMT4,3688,2h 39m,Buy
85813.21,1.14117,18.07.2011 07:44:58,sl 1.14117,0.0,-311.8399999999965,0.0,0.0,1.14507,18.07.2011 02:45:00,6859,-0.17705601786911992,-163.15,IS,0.34,0.0,Phase3-EA-S4v1-EURCHF-M15-221,EURCHFMT4,1718,4h 59m,Buy
85843.34,1.14576,18.07.2011 10:45:00,,0.0,-281.70999999999185,0.0,0.0,1.14516,18.07.2011 02:25:00,6860,-0.15994885452125734,30.13,IS,0.41,0.0,Phase3-EA-SA2v2-EURCHF-M5-43,EURCHFMT4,3690,8h 20m,Buy
85896.16,1.15149,19.07.2011 03:39:59,tp 1.15149,-2.51,-228.88999999998487,0.0,0.0,1.15259,18.07.2011 21:05:00,6861,-0.12995879916001998,52.82,IS,0.41,0.0,Phase3-EA-SA2v2-EURCHF-M5-43,EURCHFMT4,3692,6h 34m,Sell
85959.3,0.81751,19.07.2011 06:45:00,,0.0,-165.7499999999709,0.0,0.0,0.81662,19.07.2011 02:30:00,6862,-0.09410927065739419,63.14,IS,0.58,0.0,Phase3-EA-SA2v2-USDCHF-M15-107,USDCHFMT4,1340,4h 15m,Buy
85942.14,127095,19.07.2011 07:50:00,,0.0,-182.9099999999744,0.0,0.0,127036,19.07.2011 02:25:00,6863,-0.1038523480901634,-17.16,IS,0.23,0.0,Phase3-EA-S4v1-GBPJPY-M5-194,GBPJPYMT4,1672,5h 25m,Sell
86108.1,1.1565,19.07.2011 09:29:58,tp 1.15650,0.0,-16.949999999982538,0.0,0.0,1.1525,19.07.2011 04:00:00,6864,-0.009623843967671,165.96,IS,0.34,0.0,Phase3-EA-S4v1-EURCHF-M15-221,EURCHFMT4,1720,5h 29m,Buy
86057.88,111895,19.07.2011 10:29:58,sl 111.895,-0.75,-67.1699999999837,0.0,0.0,111665,18.07.2011 02:30:00,6865,-0.03813767547545547,-50.22,IS,0.17,0.0,Phase3-EA-T1v2-EURJPY-M15-322,EURJPYMT4,956,1d 7h 59m,Sell
86037.63,111713,19.07.2011 19:45:00,,0.0,-87.4199999999837,0.0,0.0,111807,19.07.2011 10:45:00,6866,-0.049635188180207006,-20.25,IS,0.17,0.0,Phase3-EA-T1v2-EURJPY-M15-322,EURJPYMT4,958,9h 0m,Buy
86092.31,1.16327,19.07.2011 21:24:58,tp 1.16327,0.0,-32.73999999999069,0.0,0.0,1.16437,19.07.2011 21:20:00,6867,-0.01858906498535596,54.68,IS,0.41,0.0,Phase3-EA-SA2v2-EURCHF-M5-43,EURCHFMT4,3694,4m 58s,Sell
86162.64,0.82473,19.07.2011 22:44:58,tp 0.82473,0.0,-0.0,0.0,0.0,0.82573,19.07.2011 22:30:00,6868,-0.0,70.33,IS,0.58,0.0,Phase3-EA-SA2v2-USDCHF-M15-107,USDCHFMT4,1342,14m 58s,Sell
86037.29,1.1669,20.07.2011 06:15:00,,-2.49,-125.35000000000582,0.0,0.0,1.16443,19.07.2011 21:55:00,6869,-0.07115583644750431,-125.35,IS,0.41,0.0,Phase3-EA-SA2v2-EURCHF-M5-43,EURCHFMT4,3696,8h 20m,Sell
86150.74,127307,20.07.2011 08:39:58,tp 127.307,0.0,-11.89999999999418,0.0,0.0,127697,20.07.2011 03:30:00,6870,-0.006755121290186261,113.45,IS,0.23,0.0,Phase3-EA-S4v1-GBPJPY-M5-194,GBPJPYMT4,1674,5h 9m,Sell
86316.08,1.1644,20.07.2011 10:44:57,tp 1.16440,0.0,-0.0,0.0,0.0,1.1684,20.07.2011 04:45:00,6871,-0.0,165.34,IS,0.34,0.0,Phase3-EA-S4v1-EURCHF-M15-221,EURCHFMT4,1722,5h 59m,Sell
86371.1,1.16446,20.07.2011 23:44:57,tp 1.16446,0.0,-0.0,0.0,0.0,1.16556,20.07.2011 23:10:00,6872,-0.0,55.02,IS,0.41,0.0,Phase3-EA-SA2v2-EURCHF-M5-43,EURCHFMT4,3698,34m 57s,Sell
86319.22,112111,21.07.2011 00:59:57,sl 112.111,-2.27,-51.88000000000466,0.0,0.0,111881,20.07.2011 17:30:00,6873,-0.029415250004113287,-51.88,IS,0.17,0.0,Phase3-EA-T1v2-EURJPY-M15-322,EURJPYMT4,960,7h 29m,Sell
86463.82,112412,21.07.2011 01:59:58,tp 112.412,-2.8,-0.0,0.0,0.0,111122,18.07.2011 13:00:00,6874,-0.0,144.6,IS,0.09,0.0,Phase3-EA-TR1v1-EURJPY-M30-91,EURJPYMT4,1068,2d 12h 59m,Buy
86518.65,1.17231,21.07.2011 03:04:58,tp 1.17231,0.0,-0.0,0.0,0.0,1.17341,21.07.2011 01:50:00,6875,-0.0,54.83,IS,0.41,0.0,Phase3-EA-SA2v2-EURCHF-M5-43,EURCHFMT4,3700,1h 14m,Sell
86589.21,0.82196,21.07.2011 03:14:58,tp 0.82196,0.0,-0.0,0.0,0.0,0.82296,21.07.2011 02:00:00,6876,-0.0,70.56,IS,0.58,0.0,Phase3-EA-SA2v2-USDCHF-M15-107,USDCHFMT4,1344,1h 14m,Sell
86615.63,78685,21.07.2011 04:15:00,,0.0,-0.0,0.0,0.0,78762,21.07.2011 00:15:00,6877,-0.0,26.42,IS,0.27,0.0,Phase3-EA-S1v2-USDJPY-M15-0,USDJPYMT4,2146,4h 0m,Sell
86686.08,127068,21.07.2011 06:35:00,,0.0,-0.0,0.0,0.0,127309,21.07.2011 01:10:00,6878,-0.0,70.45,IS,0.23,0.0,Phase3-EA-S4v1-GBPJPY-M5-194,GBPJPYMT4,1676,5h 25m,Sell
86851.85,1.1672,21.07.2011 10:59:58,tp 1.16720,0.0,-0.0,0.0,0.0,1.1712,21.07.2011 03:15:00,6879,-0.0,165.77,IS,0.34,0.0,Phase3-EA-S4v1-EURCHF-M15-221,EURCHFMT4,1724,7h 44m,Sell
86906.88,1.17788,21.07.2011 20:34:58,tp 1.17788,0.0,-0.0,0.0,0.0,1.17898,21.07.2011 20:25:00,6880,-0.0,55.03,IS,0.41,0.0,Phase3-EA-SA2v2-EURCHF-M5-43,EURCHFMT4,3702,9m 58s,Sell
86939.59,78406,21.07.2011 23:15:00,,0.0,-0.0,0.0,0.0,78501,21.07.2011 20:00:00,6881,-0.0,32.71,IS,0.27,0.0,Phase3-EA-S1v2-USDJPY-M15-0,USDJPYMT4,2148,3h 15m,Sell
86994.93,1.17556,21.07.2011 23:54:57,tp 1.17556,0.0,-0.0,0.0,0.0,1.17446,21.07.2011 22:15:00,6882,-0.0,55.34,IS,0.41,0.0,Phase3-EA-SA2v2-EURCHF-M5-43,EURCHFMT4,3704,1h 39m,Buy
87050.16,1.17619,22.07.2011 02:24:57,tp 1.17619,0.0,-0.0,0.0,0.0,1.17729,22.07.2011 00:30:00,6883,-0.0,55.23,IS,0.41,0.0,Phase3-EA-SA2v2-EURCHF-M5-43,EURCHFMT4,3706,1h 54m,Sell
87076.28,0.81708,22.07.2011 02:30:00,,-0.85,-0.0,0.0,0.0,0.8167,21.07.2011 22:15:00,6884,-0.0,26.12,IS,0.58,0.0,Phase3-EA-SA2v2-USDCHF-M15-107,USDCHFMT4,1346,4h 15m,Buy
87126.8,112888,22.07.2011 14:45:00,,-1.06,-0.0,0.0,0.0,112.65,21.07.2011 16:00:00,6885,-0.0,50.52,IS,0.17,0.0,Phase3-EA-T1v2-EURJPY-M15-322,EURJPYMT4,962,22h 45m,Buy
87044.15,112475,22.07.2011 16:29:57,sl 112.475,0.0,-82.64999999999418,0.0,0.0,113195,22.07.2011 02:00:00,6886,-0.04666148770259168,-82.65,IS,0.09,0.0,Phase3-EA-TR1v1-EURJPY-M30-91,EURJPYMT4,1070,14h 29m,Buy
87111.32,0.81765,25.07.2011 01:00:00,tp 0.81765,-3.76,-15.479999999981374,0.0,0.0,0.81865,22.07.2011 23:30:00,6887,-0.008739501870965529,67.17,IS,0.58,0.0,Phase3-EA-SA2v2-USDCHF-M15-107,USDCHFMT4,1348,2d 1h 30m,Sell
87163.91,1173,25.07.2011 01:00:00,tp 1.17300,-2.5,-0.0,0.0,0.0,1.1741,22.07.2011 20:35:00,6888,-0.0,52.59,IS,0.41,0.0,Phase3-EA-SA2v2-EURCHF-M5-43,EURCHFMT4,3708,2d 4h 25m,Sell
87000.83,1.16664,25.07.2011 08:14:57,sl 1.16664,0.0,-163.0799999999872,0.0,0.0,1.17054,25.07.2011 03:15:00,6889,-0.09205035043536076,-163.08,IS,0.34,0.0,Phase3-EA-S4v1-EURCHF-M15-221,EURCHFMT4,1726,4h 59m,Buy
86753.52,1.16551,25.07.2011 09:09:58,sl 1.16551,0.0,-410.38999999998487,0.0,0.0,1.17041,25.07.2011 02:25:00,6890,-0.23164424402237724,-247.31,IS,0.41,0.0,Phase3-EA-SA2v2-EURCHF-M5-43,EURCHFMT4,3710,6h 44m,Buy
86809.49,1.15823,25.07.2011 20:59:58,tp 1.15823,0.0,-354.4199999999837,0.0,0.0,1.15933,25.07.2011 20:10:00,6891,-0.2000520309130588,55.97,IS,0.41,0.0,Phase3-EA-SA2v2-EURCHF-M5-43,EURCHFMT4,3712,49m 58s,Sell
86881.61,0.80425,26.07.2011 04:14:58,tp 0.80425,0.0,-282.29999999998836,0.0,0.0,0.80525,26.07.2011 02:15:00,6892,-0.15934396570948808,72.12,IS,0.58,0.0,Phase3-EA-SA2v2-USDCHF-M15-107,USDCHFMT4,1350,1h 59m,Sell
86830.68,112943,26.07.2011 05:14:58,sl 112.943,-0.76,-333.2299999999814,0.0,0.0,112713,25.07.2011 07:15:00,6893,-0.1880913556265389,-50.93,IS,0.17,0.0,Phase3-EA-T1v2-EURJPY-M15-322,EURJPYMT4,964,21h 59m,Sell
87000.48,1.1599,26.07.2011 06:14:58,tp 1.15990,0.0,-163.42999999999302,0.0,0.0,1.1559,26.07.2011 05:00:00,6894,-0.09224790760149343,169.8,IS,0.34,0.0,Phase3-EA-S4v1-EURCHF-M15-221,EURCHFMT4,1728,1h 14m,Buy
87055.51,1.16364,27.07.2011 03:14:59,tp 1.16364,-1.23,-108.39999999999418,0.0,0.0,1.16254,26.07.2011 20:50:00,6895,-0.061186276595495186,55.03,IS,0.41,0.0,Phase3-EA-SA2v2-EURCHF-M5-43,EURCHFMT4,3714,6h 24m,Buy
87225.49,1.15957,27.07.2011 09:29:57,tp 1.15957,0.0,-0.0,0.0,0.0,1.16357,27.07.2011 04:15:00,6896,-0.0,169.98,IS,0.34,0.0,Phase3-EA-S4v1-EURCHF-M15-221,EURCHFMT4,1730,5h 14m,Sell
87281.7,1.15298,27.07.2011 22:34:58,tp 1.15298,0.0,-0.0,0.0,0.0,1.15188,27.07.2011 21:40:00,6897,-0.0,56.21,IS,0.41,0.0,Phase3-EA-SA2v2-EURCHF-M5-43,EURCHFMT4,3716,54m 58s,Buy
87276.96,77986,28.07.2011 04:15:00,,-3.01,-4.739999999990687,0.0,0.0,77991,27.07.2011 23:00:00,6898,-0.002673710822939246,-4.74,IS,0.27,0.0,Phase3-EA-S1v2-USDJPY-M15-0,USDJPYMT4,2150,5h 15m,Buy
87424.27,111698,28.07.2011 05:29:58,tp 111.698,-1.61,-0.0,0.0,0.0,112988,26.07.2011 14:00:00,6899,-0.0,147.31,IS,0.09,0.0,Phase3-EA-TR1v1-EURJPY-M30-91,EURJPYMT4,1072,1d 15h 29m,Sell
87343.4,1.14978,28.07.2011 08:30:00,,0.0,-80.86999999999534,0.0,0.0,1.15136,28.07.2011 00:10:00,6900,-0.04558000999524773,-80.87,IS,0.41,0.0,Phase3-EA-SA2v2-EURCHF-M5-43,EURCHFMT4,3718,8h 20m,Buy
87341.28,1.1508,28.07.2011 10:15:00,,0.0,-82.98999999999069,0.0,0.0,1.15085,28.07.2011 01:30:00,6901,-0.04677488598374431,-2.12,IS,0.34,0.0,Phase3-EA-S4v1-EURCHF-M15-221,EURCHFMT4,1732,8h 45m,Buy
87250.91,111009,28.07.2011 13:29:58,sl 111.009,0.0,-173.35999999998603,0.0,0.0,111789,28.07.2011 07:00:00,6902,-0.09770929309726678,-90.37,IS,0.09,0.0,Phase3-EA-TR1v1-EURJPY-M30-91,EURJPYMT4,1074,6h 29m,Buy
87305.98,1.14843,29.07.2011 00:14:57,tp 1.14843,-1.23,-118.28999999997905,0.0,0.0,1.14733,28.07.2011 21:30:00,6903,-0.06667069843374811,55.07,IS,0.41,0.0,Phase3-EA-SA2v2-EURCHF-M5-43,EURCHFMT4,3720,2h 44m,Buy
87263.45,1.63255,29.07.2011 05:59:57,sl 1.63255,-0.53,-160.81999999997788,0.0,0.0,1.63555,28.07.2011 23:30:00,6904,-0.09064148890113953,-42.53,IS,0.14,0.0,Phase3-EA-B1v1-GBPUSD-M30-14,GBPUSDMT4,448,6h 29m,Buy
87172.31,110364,29.07.2011 15:59:57,sl 110.364,-0.57,-251.95999999999185,0.0,0.0,111144,28.07.2011 14:00:00,6905,-0.1420098839916274,-91.14,IS,0.09,0.0,Phase3-EA-TR1v1-EURJPY-M30-91,EURJPYMT4,1076,1d 1h 59m,Buy
87229.47,1.1341,29.07.2011 21:29:58,tp 1.13410,0.0,-194.79999999998836,0.0,0.0,1.1352,29.07.2011 21:15:00,6906,-0.10979332196209025,57.16,IS,0.41,0.0,Phase3-EA-SA2v2-EURCHF-M5-43,EURCHFMT4,3722,14m 58s,Sell
87345.23,126606,01.08.2011 01:00:00,tp 126.606,-1.08,-79.03999999997905,0.0,0.0,126216,29.07.2011 23:10:00,6907,-0.04454858402403404,115.76,IS,0.23,0.0,Phase3-EA-S4v1-GBPJPY-M5-194,GBPJPYMT4,1678,2d 1h 50m,Buy
87401.39,1.13261,01.08.2011 01:00:00,tp 1.13261,-1.25,-22.879999999975553,0.0,0.0,1.13151,29.07.2011 23:05:00,6908,-0.012895642743788968,56.16,IS,0.41,0.0,Phase3-EA-SA2v2-EURCHF-M5-43,EURCHFMT4,3724,2d 1h 55m,Buy
87350.1,111447,01.08.2011 03:29:58,sl 111.447,-0.78,-74.1699999999837,0.0,0.0,111217,29.07.2011 04:30:00,6909,-0.04180375097498425,-51.29,IS,0.17,0.0,Phase3-EA-T1v2-EURJPY-M15-322,EURJPYMT4,966,2d 22h 59m,Sell
87182.8,1.14095,01.08.2011 03:44:57,sl 1.14095,0.0,-241.46999999997206,0.0,0.0,1.13705,01.08.2011 01:45:00,6910,-0.13609750233154236,-167.3,IS,0.34,0.0,Phase3-EA-S4v1-EURCHF-M15-221,EURCHFMT4,1734,1h 59m,Sell
87388.44,128.48,01.08.2011 04:29:57,tp 128.480,-7.84,-35.82999999995809,0.0,0.0,126.63,13.07.2011 03:30:00,6911,-0.020194531447111537,205.64,IS,0.09,0.0,Phase3-EA-B1v1-GBPJPY-M30-1,GBPJPYMT4,696,19d 0h 59m,Buy
87536.73,112.2,01.08.2011 04:29:57,tp 112.200,-0.57,-0.0,0.0,0.0,110.91,29.07.2011 18:00:00,6912,-0.0,148.29,IS,0.09,0.0,Phase3-EA-TR1v1-EURJPY-M30-91,EURJPYMT4,1078,2d 10h 29m,Buy
87369.64,1.14463,01.08.2011 09:29:58,sl 1.14463,0.0,-167.0899999999965,0.0,0.0,1.14073,01.08.2011 04:30:00,6913,-0.09411573593813315,-167.09,IS,0.34,0.0,Phase3-EA-S4v1-EURCHF-M15-221,EURCHFMT4,1736,4h 59m,Sell
87285.34,109515,01.08.2011 20:29:58,sl 109.515,0.0,-251.38999999998487,0.0,0.0,108795,01.08.2011 18:00:00,6914,-0.14159886802014698,-84.3,IS,0.09,0.0,Phase3-EA-TR1v1-EURJPY-M30-91,EURJPYMT4,1080,2h 29m,Sell
87028.6,1.1168,01.08.2011 22:44:57,sl 1.11680,0.0,-508.12999999997555,0.0,0.0,1.1119,01.08.2011 20:10:00,6915,-0.286211196973142,-256.74,IS,0.41,0.0,Phase3-EA-SA2v2-EURCHF-M5-43,EURCHFMT4,3726,2h 34m,Sell
87083.57,1.11531,02.08.2011 00:09:59,tp 1.11531,-2.62,-453.1599999999744,0.0,0.0,1.11641,01.08.2011 22:50:00,6916,-0.25524858996781913,54.97,IS,0.41,0.0,Phase3-EA-SA2v2-EURCHF-M5-43,EURCHFMT4,3728,1h 19m,Sell
86968.75,0.78451,02.08.2011 03:00:00,,-3.92,-567.9799999999814,0.0,0.0,0.78301,01.08.2011 22:45:00,6917,-0.31992253096020246,-114.82,IS,0.58,0.0,Phase3-EA-SA2v2-USDCHF-M15-107,USDCHFMT4,1352,4h 15m,Sell
86678.77,77701,02.08.2011 04:29:57,sl 77.701,-1.57,-857.9599999999919,0.0,0.0,76871,01.08.2011 19:00:00,6918,-0.4832577461576494,-289.98,IS,0.27,0.0,Phase3-EA-S1v2-USDJPY-M15-0,USDJPYMT4,2152,9h 29m,Sell
86736.39,1.11665,02.08.2011 05:29:57,tp 1.11665,0.0,-800.3399999999965,0.0,0.0,1.11775,02.08.2011 00:50:00,6919,-0.45080249027905156,57.62,IS,0.41,0.0,Phase3-EA-SA2v2-EURCHF-M5-43,EURCHFMT4,3730,4h 39m,Sell
86687.11,126333,02.08.2011 06:25:00,,0.0,-849.6199999999953,0.0,0.0,126167,02.08.2011 01:00:00,6920,-0.4785601266847682,-49.28,IS,0.23,0.0,Phase3-EA-S4v1-GBPJPY-M5-194,GBPJPYMT4,1680,5h 25m,Sell
86861.19,1113,02.08.2011 08:14:58,tp 1.11300,0.0,-675.5400000000081,0.0,0.0,1117,02.08.2011 01:00:00,6921,-0.3805071773035404,174.08,IS,0.34,0.0,Phase3-EA-S4v1-EURCHF-M15-221,EURCHFMT4,1738,7h 14m,Sell
86909.89,77057,02.08.2011 22:45:00,,0.0,-626.8399999999965,0.0,0.0,77196,02.08.2011 22:00:00,6922,-0.35307623385876047,48.7,IS,0.27,0.0,Phase3-EA-S1v2-USDJPY-M15-0,USDJPYMT4,2154,45m 0s,Sell
86985.61,0.76601,02.08.2011 23:29:57,tp 0.76601,0.0,-551.1199999999953,0.0,0.0,0.76501,02.08.2011 23:00:00,6923,-0.31042590454380625,75.72,IS,0.58,0.0,Phase3-EA-SA2v2-USDCHF-M15-107,USDCHFMT4,1354,29m 57s,Buy
87044.83,1.08222,03.08.2011 00:19:57,tp 1.08222,0.0,-491.8999999999942,0.0,0.0,1.08112,03.08.2011 00:15:00,6924,-0.2770694267039806,59.22,IS,0.41,0.0,Phase3-EA-SA2v2-EURCHF-M5-43,EURCHFMT4,3732,4m 57s,Buy
87120.88,0.76263,03.08.2011 00:29:57,tp 0.76263,0.0,-415.8500000000058,0.0,0.0,0.76163,03.08.2011 00:15:00,6925,-0.234233220359531,76.05,IS,0.58,0.0,Phase3-EA-SA2v2-USDCHF-M15-107,USDCHFMT4,1356,14m 57s,Buy
87069.5,109.86,03.08.2011 06:44:58,sl 109.860,-0.77,-467.2300000000105,0.0,0.0,109.63,02.08.2011 18:45:00,6926,-0.2631737105893582,-51.38,IS,0.17,0.0,Phase3-EA-T1v2-EURJPY-M15-322,EURJPYMT4,968,11h 59m,Sell
87018.7,109.6,03.08.2011 09:59:58,sl 109.600,0.0,-518.0299999999988,0.0,0.0,109.37,03.08.2011 09:30:00,6927,-0.2917875078582322,-50.8,IS,0.17,0.0,Phase3-EA-T1v2-EURJPY-M15-322,EURJPYMT4,970,29m 58s,Sell
86967.88,109785,03.08.2011 17:29:58,sl 109.785,0.0,-568.8500000000058,0.0,0.0,110015,03.08.2011 10:45:00,6928,-0.3204125704016321,-50.82,IS,0.17,0.0,Phase3-EA-T1v2-EURJPY-M15-322,EURJPYMT4,972,6h 44m,Buy
87026.6,1.1003,03.08.2011 20:59:58,tp 1.10030,0.0,-510.13000000000466,0.0,0.0,1.1014,03.08.2011 20:50:00,6929,-0.28733772442468913,58.72,IS,0.41,0.0,Phase3-EA-SA2v2-EURCHF-M5-43,EURCHFMT4,3734,9m 58s,Sell
87102.09,0.7683,04.08.2011 00:59:57,tp 0.76830,0.0,-434.64000000001397,0.0,0.0,0.7693,04.08.2011 00:15:00,6930,-0.24481694576666682,75.49,IS,0.58,0.0,Phase3-EA-SA2v2-USDCHF-M15-107,USDCHFMT4,1358,44m 57s,Sell
86863.47,127561,04.08.2011 04:04:58,sl 127.561,0.0,-673.2600000000093,0.0,0.0,126761,04.08.2011 01:55:00,6931,-0.379222936008796,-238.62,IS,0.23,0.0,Phase3-EA-S4v1-GBPJPY-M5-194,GBPJPYMT4,1682,2h 9m,Sell
86594.7,1.10682,04.08.2011 04:04:58,sl 1.10682,-7.99,-942.0299999999988,0.0,0.0,1.10192,03.08.2011 23:45:00,6932,-0.5306113275827476,-268.77,IS,0.41,0.0,Phase3-EA-SA2v2-EURCHF-M5-43,EURCHFMT4,3736,4h 19m,Sell
86966.2,111934,04.08.2011 04:14:57,tp 111.934,-3.24,-570.5299999999988,0.0,0.0,110234,03.08.2011 23:15:00,6933,-0.321358853460914,371.5,IS,0.17,0.0,Phase3-EA-T1v2-EURJPY-M15-322,EURJPYMT4,974,4h 59m,Buy
86794.08,1.10893,04.08.2011 04:14:58,sl 1.10893,0.0,-742.6499999999942,0.0,0.0,1.10503,04.08.2011 03:15:00,6934,-0.4183078059396463,-172.12,IS,0.34,0.0,Phase3-EA-S4v1-EURCHF-M15-221,EURCHFMT4,1740,59m 58s,Sell
86500.97,77711,04.08.2011 04:14:58,sl 77.711,-4.73,-1035.7599999999802,0.0,0.0,76881,03.08.2011 22:00:00,6935,-0.583406036598725,-293.11,IS,0.27,0.0,Phase3-EA-S1v2-USDJPY-M15-0,USDJPYMT4,2156,6h 14m,Sell
86648.01,111927,04.08.2011 04:29:57,tp 111.927,0.0,-888.7199999999721,0.0,0.0,110667,04.08.2011 03:00:00,6936,-0.500583738362181,147.04,IS,0.09,0.0,Phase3-EA-TR1v1-EURJPY-M30-91,EURJPYMT4,1082,1h 29m,Buy
86477.59,1.11193,04.08.2011 08:44:57,sl 1.11193,0.0,-1059.1399999999849,0.0,0.0,1.10803,04.08.2011 04:45:00,6937,-0.596575142507122,-170.42,IS,0.34,0.0,Phase3-EA-S4v1-EURCHF-M15-221,EURCHFMT4,1742,3h 59m,Sell
86619.32,114125,04.08.2011 13:29:57,tp 114.125,0.0,-917.4099999999744,0.0,0.0,112865,04.08.2011 06:00:00,6938,-0.5167437746543906,141.73,IS,0.09,0.0,Phase3-EA-TR1v1-EURJPY-M30-91,EURJPYMT4,1084,7h 29m,Buy
86543.73,129963,04.08.2011 15:29:57,sl 129.963,0.0,-992.9999999999709,0.0,0.0,130633,04.08.2011 12:30:00,6939,-0.5593208796849927,-75.59,IS,0.09,0.0,Phase3-EA-B1v1-GBPJPY-M30-1,GBPJPYMT4,698,2h 59m,Buy
86690.46,111717,04.08.2011 17:29:58,tp 111.717,0.0,-846.2699999999604,0.0,0.0,113007,04.08.2011 16:00:00,6940,-0.47667319320343454,146.73,IS,0.09,0.0,Phase3-EA-TR1v1-EURJPY-M30-91,EURJPYMT4,1086,1h 29m,Sell
86428.22,1.0806,04.08.2011 23:54:59,sl 1.08060,0.0,-1108.509999999951,0.0,0.0,1.0855,04.08.2011 20:10:00,6941,-0.6243834726481391,-262.24,IS,0.41,0.0,Phase3-EA-SA2v2-EURCHF-M5-43,EURCHFMT4,3738,3h 44m,Buy
86487.1,1.08019,05.08.2011 00:09:57,tp 1.08019,0.0,-1049.6299999999464,0.0,0.0,1.07909,05.08.2011 00:05:00,6942,-0.5912185044750716,58.88,IS,0.41,0.0,Phase3-EA-SA2v2-EURCHF-M5-43,EURCHFMT4,3740,4m 57s,Buy
86597.75,78698,05.08.2011 03:30:00,,-1.54,-938.9799999999523,0.0,0.0,79025,04.08.2011 22:00:00,6943,-0.5288933732191371,110.65,IS,0.27,0.0,Phase3-EA-S1v2-USDJPY-M15-0,USDJPYMT4,2158,5h 30m,Sell
86775.66,1.07861,05.08.2011 04:59:58,tp 1.07861,0.0,-761.0699999999488,0.0,0.0,1.07461,05.08.2011 02:45:00,6944,-0.42868312376821877,177.91,IS,0.34,0.0,Phase3-EA-S4v1-EURCHF-M15-221,EURCHFMT4,1744,2h 14m,Buy
86889.93,128.63,05.08.2011 07:44:58,tp 128.630,0.0,-646.7999999999593,0.0,0.0,128.24,05.08.2011 03:15:00,6945,-0.3643189778250162,114.27,IS,0.23,0.0,Phase3-EA-S4v1-GBPJPY-M5-194,GBPJPYMT4,1684,4h 29m,Buy
86807.32,111511,05.08.2011 07:59:58,sl 111.511,0.0,-729.4099999999453,0.0,0.0,110791,05.08.2011 07:00:00,6946,-0.41085019421048524,-82.61,IS,0.09,0.0,Phase3-EA-TR1v1-EURJPY-M30-91,EURJPYMT4,1088,59m 58s,Sell
86866.05,1.09439,05.08.2011 20:39:57,tp 1.09439,0.0,-670.6799999999348,0.0,0.0,1.09549,05.08.2011 20:25:00,6947,-0.37776971559627937,58.73,IS,0.41,0.0,Phase3-EA-SA2v2-EURCHF-M5-43,EURCHFMT4,3742,14m 57s,Sell
86924.74,1.09458,05.08.2011 21:04:58,tp 1.09458,0.0,-611.9899999999325,0.0,0.0,1.09568,05.08.2011 21:00:00,6948,-0.3447117675311087,58.69,IS,0.41,0.0,Phase3-EA-SA2v2-EURCHF-M5-43,EURCHFMT4,3744,4m 58s,Sell
86942.99,78.41,05.08.2011 23:30:00,,0.0,-593.7399999999325,0.0,0.0,78463,05.08.2011 23:00:00,6949,-0.3344322045358908,18.25,IS,0.27,0.0,Phase3-EA-S1v2-USDJPY-M15-0,USDJPYMT4,2160,30m 0s,Sell
87002.21,1.09024,08.08.2011 01:34:58,tp 1.09024,0.0,-534.5199999999313,0.0,0.0,1.08914,08.08.2011 01:15:00,6950,-0.3010757266960651,59.22,IS,0.41,0.0,Phase3-EA-SA2v2-EURCHF-M5-43,EURCHFMT4,3746,19m 58s,Buy
87061.43,1.09011,08.08.2011 01:44:58,tp 1.09011,0.0,-475.29999999993015,0.0,0.0,1.08901,08.08.2011 01:35:00,6951,-0.26771924885623943,59.22,IS,0.41,0.0,Phase3-EA-SA2v2-EURCHF-M5-43,EURCHFMT4,3748,9m 58s,Buy
87073.86,128459,08.08.2011 04:30:00,,-1.7,-462.86999999993714,0.0,0.0,128507,05.08.2011 23:05:00,6952,-0.26071788074497987,12.43,IS,0.23,0.0,Phase3-EA-S4v1-GBPJPY-M5-194,GBPJPYMT4,1686,2d 5h 25m,Sell
86983.19,110427,08.08.2011 15:59:58,sl 110.427,-0.56,-553.5399999999499,0.0,0.0,111207,05.08.2011 11:00:00,6953,-0.3117890027601329,-90.67,IS,0.09,0.0,Phase3-EA-TR1v1-EURJPY-M30-91,EURJPYMT4,1090,3d 4h 59m,Buy
87042.84,1.07405,08.08.2011 22:34:58,tp 1.07405,0.0,-493.88999999995576,0.0,0.0,1.07515,08.08.2011 22:20:00,6954,-0.27819032151823203,59.65,IS,0.41,0.0,Phase3-EA-SA2v2-EURCHF-M5-43,EURCHFMT4,3750,14m 58s,Sell
87119.7,0.75463,08.08.2011 22:44:58,tp 0.75463,0.0,-417.02999999996973,0.0,0.0,0.75563,08.08.2011 22:00:00,6955,-0.2348978715559138,76.86,IS,0.58,0.0,Phase3-EA-SA2v2-USDCHF-M15-107,USDCHFMT4,1360,44m 58s,Sell
87149.62,77609,08.08.2011 23:30:00,,0.0,-387.1099999999569,0.0,0.0,77695,08.08.2011 22:30:00,6956,-0.21804502088100683,29.92,IS,0.27,0.0,Phase3-EA-S1v2-USDJPY-M15-0,USDJPYMT4,2162,1h 0m,Sell
87209.37,1.07019,09.08.2011 02:14:59,tp 1.07019,0.0,-327.3599999999569,0.0,0.0,1.06909,09.08.2011 01:30:00,6957,-0.18439001326652615,59.75,IS,0.41,0.0,Phase3-EA-SA2v2-EURCHF-M5-43,EURCHFMT4,3752,44m 59s,Buy
86971.64,125882,09.08.2011 04:24:59,sl 125.882,0.0,-565.0899999999674,0.0,0.0,126682,09.08.2011 01:30:00,6958,-0.3182946987927327,-237.73,IS,0.23,0.0,Phase3-EA-S4v1-GBPJPY-M5-194,GBPJPYMT4,1688,2h 54m,Buy
86795.48,1.06424,09.08.2011 04:44:58,sl 1.06424,0.0,-741.2499999999709,0.0,0.0,1.06814,09.08.2011 04:00:00,6959,-0.4175192367235616,-176.16,IS,0.34,0.0,Phase3-EA-S4v1-EURCHF-M15-221,EURCHFMT4,1746,44m 58s,Buy
86618.99,1.06134,09.08.2011 05:14:58,sl 1.06134,0.0,-917.7399999999616,0.0,0.0,1.06524,09.08.2011 05:00:00,6960,-0.5169296516838859,-176.49,IS,0.34,0.0,Phase3-EA-S4v1-EURCHF-M15-221,EURCHFMT4,1748,14m 58s,Buy
86834.41,125554,09.08.2011 05:29:58,tp 125.554,-0.67,-702.3199999999488,0.0,0.0,127404,08.08.2011 13:00:00,6961,-0.39559137987950344,215.42,IS,0.09,0.0,Phase3-EA-B1v1-GBPJPY-M30-1,GBPJPYMT4,700,16h 29m,Sell
87016.04,1.06652,09.08.2011 05:59:58,tp 1.06652,0.0,-520.6899999999441,0.0,0.0,1.06252,09.08.2011 05:30:00,6962,-0.2932857893687373,181.63,IS,0.34,0.0,Phase3-EA-S4v1-EURCHF-M15-221,EURCHFMT4,1750,29m 58s,Buy
86965.33,109929,09.08.2011 12:44:58,sl 109.929,0.0,-571.399999999936,0.0,0.0,109699,09.08.2011 12:15:00,6963,-0.32184889290229446,-50.71,IS,0.17,0.0,Phase3-EA-T1v2-EURJPY-M15-322,EURJPYMT4,976,29m 58s,Sell
87017.52,77086,09.08.2011 20:00:00,,0.0,-519.2099999999336,0.0,0.0,77235,09.08.2011 17:00:00,6964,-0.29245215905459865,52.19,IS,0.27,0.0,Phase3-EA-S1v2-USDJPY-M15-0,USDJPYMT4,2164,3h 0m,Sell
86932.45,110.92,10.08.2011 00:29:58,sl 110.920,-0.82,-604.2799999999406,0.0,0.0,110.2,08.08.2011 18:00:00,6965,-0.34036900420546234,-85.07,IS,0.09,0.0,Phase3-EA-TR1v1-EURJPY-M30-91,EURJPYMT4,1092,1d 6h 29m,Sell
87012.82,0.72167,10.08.2011 00:59:58,tp 0.72167,0.0,-523.9099999999453,0.0,0.0,0.72267,10.08.2011 00:45:00,6966,-0.29509949856570244,80.37,IS,0.58,0.0,Phase3-EA-SA2v2-USDCHF-M15-107,USDCHFMT4,1362,14m 58s,Sell
87129.3,125651,10.08.2011 02:04:59,tp 125.651,0.0,-407.4299999999348,0.0,0.0,126041,10.08.2011 01:05:00,6967,-0.2294905397885466,116.48,IS,0.23,0.0,Phase3-EA-S4v1-GBPJPY-M5-194,GBPJPYMT4,1690,59m 59s,Sell
87191.72,1.03687,10.08.2011 03:09:58,tp 1.03687,0.0,-345.009999999922,0.0,0.0,1.03797,10.08.2011 00:55:00,6968,-0.19433161802626522,62.42,IS,0.41,0.0,Phase3-EA-SA2v2-EURCHF-M5-43,EURCHFMT4,3754,2h 14m,Sell
87259.06,76977,10.08.2011 05:00:00,,0.0,-277.6699999999255,0.0,0.0,77169,10.08.2011 00:45:00,6969,-0.1564014387332274,67.34,IS,0.27,0.0,Phase3-EA-S1v2-USDJPY-M15-0,USDJPYMT4,2166,4h 15m,Sell
87207.09,110139,10.08.2011 05:29:57,sl 110.139,-1.08,-329.63999999992666,0.0,0.0,110369,09.08.2011 23:15:00,6970,-0.18567425456125417,-51.97,IS,0.17,0.0,Phase3-EA-T1v2-EURJPY-M15-322,EURJPYMT4,978,6h 14m,Buy
87094.06,125185,10.08.2011 07:35:00,,0.0,-442.6699999999255,0.0,0.0,125563,10.08.2011 02:10:00,6971,-0.24933995348451288,-113.03,IS,0.23,0.0,Phase3-EA-S4v1-GBPJPY-M5-194,GBPJPYMT4,1692,5h 25m,Buy
87009.55,109268,10.08.2011 21:29:58,sl 109.268,0.0,-527.1799999999348,0.0,0.0,108548,10.08.2011 17:30:00,6972,-0.2969413709489493,-84.51,IS,0.09,0.0,Phase3-EA-TR1v1-EURJPY-M30-91,EURJPYMT4,1094,3h 59m,Sell
87071.59,1.03203,10.08.2011 23:04:57,tp 1.03203,0.0,-465.13999999992666,0.0,0.0,1.03093,10.08.2011 23:00:00,6973,-0.26199648940246134,62.04,IS,0.41,0.0,Phase3-EA-SA2v2-EURCHF-M5-43,EURCHFMT4,3756,4m 57s,Buy
87133.66,1.03065,11.08.2011 00:39:58,tp 1.03065,0.0,-403.0699999999197,0.0,0.0,1.02955,11.08.2011 00:10:00,6974,-0.22703470994420108,62.07,IS,0.41,0.0,Phase3-EA-SA2v2-EURCHF-M5-43,EURCHFMT4,3758,29m 58s,Buy
87040.53,108311,11.08.2011 01:29:58,sl 108.311,-1.72,-496.19999999992433,0.0,0.0,109091,10.08.2011 22:30:00,6975,-0.2794914607247323,-93.13,IS,0.09,0.0,Phase3-EA-TR1v1-EURJPY-M30-91,EURJPYMT4,1096,2h 59m,Buy
87003.37,76628,11.08.2011 01:30:00,,-4.74,-533.3599999999278,0.0,0.0,76536,10.08.2011 17:15:00,6976,-0.3004223407741753,-37.16,IS,0.27,0.0,Phase3-EA-S1v2-USDJPY-M15-0,USDJPYMT4,2168,8h 15m,Sell
87065.52,1.02837,11.08.2011 03:04:58,tp 1.02837,0.0,-471.20999999993364,0.0,0.0,1.02727,11.08.2011 01:20:00,6977,-0.26541550021786103,62.15,IS,0.41,0.0,Phase3-EA-SA2v2-EURCHF-M5-43,EURCHFMT4,3760,1h 44m,Buy
87182.22,123957,11.08.2011 03:14:58,tp 123.957,0.0,-354.509999999922,0.0,0.0,123567,11.08.2011 01:30:00,6978,-0.1996826234210362,116.7,IS,0.23,0.0,Phase3-EA-S4v1-GBPJPY-M5-194,GBPJPYMT4,1694,1h 44m,Buy
87322.43,77028,11.08.2011 03:29:58,tp 77.028,0.0,-214.29999999993015,0.0,0.0,76628,11.08.2011 01:30:00,6979,-0.12070741643147873,140.21,IS,0.27,0.0,Phase3-EA-S1v2-USDJPY-M15-0,USDJPYMT4,2170,1h 59m,Buy
87509.41,1.03098,11.08.2011 03:44:58,tp 1.03098,0.0,-27.319999999919673,0.0,0.0,1.02698,11.08.2011 02:15:00,6980,-0.015388364987864571,186.98,IS,0.34,0.0,Phase3-EA-S4v1-EURCHF-M15-221,EURCHFMT4,1752,1h 29m,Buy
87626.46,123729,11.08.2011 04:34:58,tp 123.729,0.0,-0.0,0.0,0.0,124119,11.08.2011 03:35:00,6981,-0.0,117.05,IS,0.23,0.0,Phase3-EA-S4v1-GBPJPY-M5-194,GBPJPYMT4,1696,59m 58s,Sell
87444.16,1.03648,11.08.2011 08:29:58,sl 1.03648,0.0,-182.29999999998836,0.0,0.0,1.03258,11.08.2011 06:00:00,6982,-0.10263110574854005,-182.3,IS,0.34,0.0,Phase3-EA-S4v1-EURCHF-M15-221,EURCHFMT4,1754,2h 29m,Sell
87352.57,108187,11.08.2011 14:59:58,sl 108.187,0.0,-273.88999999998487,0.0,0.0,108967,11.08.2011 05:00:00,6983,-0.1541943694649911,-91.59,IS,0.09,0.0,Phase3-EA-TR1v1-EURJPY-M30-91,EURJPYMT4,1098,9h 59m,Buy
87411.58,1.08564,11.08.2011 21:19:59,tp 1.08564,0.0,-214.87999999997555,0.0,0.0,1.08674,11.08.2011 21:15:00,6984,-0.12097296765356658,59.01,IS,0.41,0.0,Phase3-EA-SA2v2-EURCHF-M5-43,EURCHFMT4,3762,4m 59s,Sell
87331.1,124683,11.08.2011 22:29:58,sl 124.683,-2.04,-295.35999999998603,0.0,0.0,124013,10.08.2011 16:00:00,6985,-0.16628153260498788,-80.48,IS,0.09,0.0,Phase3-EA-B1v1-GBPJPY-M30-1,GBPJPYMT4,702,1d 6h 29m,Sell
87390.27,1.08418,12.08.2011 02:39:58,tp 1.08418,0.0,-236.18999999997322,0.0,0.0,1.08308,12.08.2011 02:25:00,6986,-0.13297005412367788,59.17,IS,0.41,0.0,Phase3-EA-SA2v2-EURCHF-M5-43,EURCHFMT4,3764,14m 58s,Buy
87353.72,0.76175,12.08.2011 05:30:00,,0.0,-272.7399999999616,0.0,0.0,0.76127,12.08.2011 01:15:00,6987,-0.15354694340019012,-36.55,IS,0.58,0.0,Phase3-EA-SA2v2-USDCHF-M15-107,USDCHFMT4,1364,4h 15m,Sell
87179.34,1.07721,12.08.2011 07:14:58,sl 1.07721,0.0,-447.11999999996624,0.0,0.0,1.08111,12.08.2011 04:45:00,6988,-0.2517192539895046,-174.38,IS,0.34,0.0,Phase3-EA-S4v1-EURCHF-M15-221,EURCHFMT4,1756,2h 29m,Buy
86920.9,1.10763,12.08.2011 21:09:58,sl 1.10763,0.0,-705.5599999999686,0.0,0.0,1.10273,12.08.2011 20:50:00,6989,-0.3972155950188772,-258.44,IS,0.41,0.0,Phase3-EA-SA2v2-EURCHF-M5-43,EURCHFMT4,3766,19m 58s,Sell
86978.97,1.10492,12.08.2011 21:19:58,tp 1.10492,0.0,-647.4899999999616,0.0,0.0,1.10602,12.08.2011 21:15:00,6990,-0.3645233936430197,58.07,IS,0.41,0.0,Phase3-EA-SA2v2-EURCHF-M5-43,EURCHFMT4,3768,4m 58s,Sell
87036.98,1.10638,12.08.2011 22:14:59,tp 1.10638,0.0,-589.4799999999523,0.0,0.0,1.10748,12.08.2011 22:10:00,6991,-0.33186497101836726,58.01,IS,0.41,0.0,Phase3-EA-SA2v2-EURCHF-M5-43,EURCHFMT4,3770,4m 59s,Sell
87094.6,1.11759,15.08.2011 01:54:59,tp 1.11759,0.0,-531.8599999999569,0.0,0.0,1.11869,15.08.2011 01:30:00,6992,-0.2994261102765638,57.62,IS,0.41,0.0,Phase3-EA-SA2v2-EURCHF-M5-43,EURCHFMT4,3772,24m 59s,Sell
86839.03,1.1241,15.08.2011 02:49:58,sl 1.12410,0.0,-787.4299999999639,0.0,0.0,1.1192,15.08.2011 02:30:00,6993,-0.44330670103990316,-255.57,IS,0.41,0.0,Phase3-EA-SA2v2-EURCHF-M5-43,EURCHFMT4,3774,19m 58s,Sell
86584.63,1.12819,15.08.2011 02:59:58,sl 1.12819,0.0,-1041.829999999958,0.0,0.0,1.12329,15.08.2011 02:50:00,6994,-0.586528606154712,-254.4,IS,0.41,0.0,Phase3-EA-SA2v2-EURCHF-M5-43,EURCHFMT4,3776,9m 58s,Sell
86492.88,109861,15.08.2011 03:29:58,sl 109.861,-0.41,-1133.579999999958,0.0,0.0,109081,12.08.2011 05:30:00,6995,-0.6381819465410487,-91.75,IS,0.09,0.0,Phase3-EA-TR1v1-EURJPY-M30-91,EURJPYMT4,1100,2d 21h 59m,Sell
86324.43,1.12874,15.08.2011 05:14:58,sl 1.12874,0.0,-1302.0299999999697,0.0,0.0,1.12484,15.08.2011 03:30:00,6996,-0.7330157905528087,-168.45,IS,0.34,0.0,Phase3-EA-S4v1-EURCHF-M15-221,EURCHFMT4,1758,1h 44m,Sell
86441.21,125127,15.08.2011 05:39:58,tp 125.127,0.0,-1185.249999999971,0.0,0.0,125517,15.08.2011 03:25:00,6997,-0.6672710811215682,116.78,IS,0.23,0.0,Phase3-EA-S4v1-GBPJPY-M5-194,GBPJPYMT4,1698,2h 14m,Sell
86349.65,110581,15.08.2011 16:59:58,sl 110.581,0.0,-1276.8099999999686,0.0,0.0,109801,15.08.2011 07:30:00,6998,-0.7188174554624167,-91.56,IS,0.09,0.0,Phase3-EA-TR1v1-EURJPY-M30-91,EURJPYMT4,1102,9h 29m,Sell
86407.17,1.13317,15.08.2011 21:54:58,tp 1.13317,0.0,-1219.289999999979,0.0,0.0,1.13427,15.08.2011 20:00:00,6999,-0.6864348926392937,57.52,IS,0.41,0.0,Phase3-EA-SA2v2-EURCHF-M5-43,EURCHFMT4,3778,1h 54m,Sell
86464.68,1.13425,15.08.2011 22:24:58,tp 1.13425,0.0,-1161.7799999999697,0.0,0.0,1.13315,15.08.2011 22:20:00,7000,-0.6540579596080273,57.51,IS,0.41,0.0,Phase3-EA-SA2v2-EURCHF-M5-43,EURCHFMT4,3780,4m 58s,Buy
86416.44,0.78389,16.08.2011 02:45:00,,-0.89,-1210.0199999999604,0.0,0.0,0.78453,15.08.2011 22:30:00,7001,-0.6812160755779062,-48.24,IS,0.58,0.0,Phase3-EA-SA2v2-USDCHF-M15-107,USDCHFMT4,1366,4h 15m,Buy
86472.57,1.13434,16.08.2011 03:39:58,tp 1.13434,-1.26,-1153.8899999999558,0.0,0.0,1.13324,15.08.2011 23:40:00,7002,-0.6496160538243878,56.13,IS,0.41,0.0,Phase3-EA-SA2v2-EURCHF-M5-43,EURCHFMT4,3782,3h 59m,Buy
86642.49,110936,16.08.2011 04:45:00,,-1.08,-983.969999999943,0.0,0.0,110163,15.08.2011 16:00:00,7003,-0.5539546304080721,169.92,IS,0.17,0.0,Phase3-EA-T1v2-EURJPY-M15-322,EURJPYMT4,980,12h 45m,Buy
86658.34,125718,16.08.2011 08:35:00,,0.0,-968.1199999999371,0.0,0.0,125665,16.08.2011 03:10:00,7004,-0.5450314102977317,15.85,IS,0.23,0.0,Phase3-EA-S4v1-GBPJPY-M5-194,GBPJPYMT4,1700,5h 25m,Buy
86607.46,110745,16.08.2011 08:59:58,sl 110.745,0.0,-1018.9999999999418,0.0,0.0,110975,16.08.2011 05:15:00,7005,-0.5736757913206968,-50.88,IS,0.17,0.0,Phase3-EA-T1v2-EURJPY-M15-322,EURJPYMT4,982,3h 44m,Buy
86522.42,110.16,16.08.2011 14:29:57,sl 110.160,-0.57,-1104.03999999995,0.0,0.0,110.88,15.08.2011 20:00:00,7006,-0.6215515413637973,-85.04,IS,0.09,0.0,Phase3-EA-TR1v1-EURJPY-M30-91,EURJPYMT4,1104,18h 29m,Buy
86480.42,1.63593,16.08.2011 15:29:58,sl 1.63593,0.0,-1146.03999999995,0.0,0.0,1.63893,16.08.2011 13:30:00,7007,-0.6451966672082239,-42.0,IS,0.14,0.0,Phase3-EA-B1v1-GBPUSD-M30-14,GBPUSDMT4,450,1h 59m,Buy
86537.1,1.14534,17.08.2011 00:24:57,tp 1.14534,0.0,-1089.359999999957,0.0,0.0,1.14644,17.08.2011 00:20:00,7008,-0.6132870069019875,56.68,IS,0.41,0.0,Phase3-EA-SA2v2-EURCHF-M5-43,EURCHFMT4,3784,4m 57s,Sell
86708.21,1.14271,17.08.2011 03:14:58,tp 1.14271,0.0,-918.2499999999709,0.0,0.0,1.14671,17.08.2011 01:15:00,7009,-0.516955638253428,171.11,IS,0.34,0.0,Phase3-EA-S4v1-EURCHF-M15-221,EURCHFMT4,1760,1h 59m,Sell
86781.23,0.7943,17.08.2011 03:44:58,tp 0.79430,0.0,-845.2299999999814,0.0,0.0,0.7953,17.08.2011 00:30:00,7010,-0.4758468980353381,73.02,IS,0.58,0.0,Phase3-EA-SA2v2-USDCHF-M15-107,USDCHFMT4,1368,3h 14m,Sell
86952.35,1.14535,17.08.2011 07:29:57,tp 1.14535,0.0,-674.109999999986,0.0,0.0,1.14135,17.08.2011 04:45:00,7011,-0.3795098995949058,171.12,IS,0.34,0.0,Phase3-EA-S4v1-EURCHF-M15-221,EURCHFMT4,1762,2h 44m,Buy
86929.55,126002,17.08.2011 08:40:00,,0.0,-696.9099999999744,0.0,0.0,126078,17.08.2011 03:15:00,7012,-0.3923458250533022,-22.8,IS,0.23,0.0,Phase3-EA-S4v1-GBPJPY-M5-194,GBPJPYMT4,1702,5h 25m,Buy
86887.55,1.65086,18.08.2011 05:29:59,sl 1.65086,0.0,-738.9099999999744,0.0,0.0,1.65386,18.08.2011 02:00:00,7013,-0.4159909508977287,-42.0,IS,0.14,0.0,Phase3-EA-B1v1-GBPUSD-M30-14,GBPUSDMT4,452,3h 29m,Buy
87059.39,1.14187,18.08.2011 08:44:58,tp 1.14187,0.0,-567.0699999999779,0.0,0.0,1.13787,18.08.2011 05:00:00,7014,-0.31924860744281985,171.84,IS,0.34,0.0,Phase3-EA-S4v1-EURCHF-M15-221,EURCHFMT4,1764,3h 44m,Buy
87116.21,1.13514,18.08.2011 22:19:58,tp 1.13514,0.0,-510.2499999999709,0.0,0.0,1.13624,18.08.2011 22:15:00,7015,-0.28726013005042744,56.82,IS,0.41,0.0,Phase3-EA-SA2v2-EURCHF-M5-43,EURCHFMT4,3786,4m 58s,Sell
87170.41,1.1356,19.08.2011 02:29:57,tp 1.13560,-2.58,-456.04999999995925,0.0,0.0,1.1367,18.08.2011 22:40:00,7016,-0.2567466581273752,54.2,IS,0.41,0.0,Phase3-EA-SA2v2-EURCHF-M5-43,EURCHFMT4,3788,3h 49m,Sell
87227.13,1.1365,19.08.2011 02:39:58,tp 1.13650,0.0,-399.3299999999581,0.0,0.0,1.1354,19.08.2011 02:30:00,7017,-0.22481447865366327,56.72,IS,0.41,0.0,Phase3-EA-SA2v2-EURCHF-M5-43,EURCHFMT4,3790,9m 58s,Buy
87137.38,0.79484,19.08.2011 04:30:00,,0.0,-489.0799999999581,0.0,0.0,0.79361,19.08.2011 00:15:00,7018,-0.2753418606664557,-89.75,IS,0.58,0.0,Phase3-EA-SA2v2-USDCHF-M15-107,USDCHFMT4,1370,4h 15m,Sell
87095.38,1.64822,19.08.2011 10:59:57,sl 1.64822,0.0,-531.0799999999581,0.0,0.0,1.65122,19.08.2011 10:00:00,7019,-0.29898698651088224,-42.0,IS,0.14,0.0,Phase3-EA-B1v1-GBPUSD-M30-14,GBPUSDMT4,454,59m 57s,Buy
87168.22,0.7867,22.08.2011 01:00:00,tp 0.78670,-0.89,-458.2399999999616,0.0,0.0,0.7857,19.08.2011 23:00:00,7020,-0.2579795825464073,72.84,IS,0.58,0.0,Phase3-EA-SA2v2-USDCHF-M15-107,USDCHFMT4,1372,2d 2h 0m,Buy
87224.45,1.13236,22.08.2011 01:00:00,tp 1.13236,-1.25,-402.0099999999511,0.0,0.0,1.13126,19.08.2011 23:10:00,7021,-0.22632326287420845,56.23,IS,0.41,0.0,Phase3-EA-SA2v2-EURCHF-M5-43,EURCHFMT4,3792,2d 1h 50m,Buy
86936.56,0.78572,22.08.2011 04:59:57,sl 0.78572,0.0,-689.8999999999651,0.0,0.0,0.78962,22.08.2011 01:15:00,7022,-0.3883993409540248,-287.89,IS,0.58,0.0,Phase3-EA-SA2v2-USDCHF-M15-107,USDCHFMT4,1374,3h 44m,Buy
87109.61,1.12919,22.08.2011 05:59:58,tp 1.12919,0.0,-516.8499999999767,0.0,0.0,1.13319,22.08.2011 01:30:00,7023,-0.2909757926831263,173.05,IS,0.34,0.0,Phase3-EA-S4v1-EURCHF-M15-221,EURCHFMT4,1766,4h 29m,Sell
87282.08,1.1327,22.08.2011 09:14:59,tp 1.13270,0.0,-344.37999999997555,0.0,0.0,1.1287,22.08.2011 06:45:00,7024,-0.1938787723405484,172.47,IS,0.34,0.0,Phase3-EA-S4v1-EURCHF-M15-221,EURCHFMT4,1768,2h 29m,Buy
87231.18,110338,22.08.2011 18:29:58,sl 110.338,0.0,-395.27999999996973,0.0,0.0,110568,22.08.2011 11:00:00,7025,-0.222534412947243,-50.9,IS,0.17,0.0,Phase3-EA-T1v2-EURJPY-M15-322,EURJPYMT4,984,7h 29m,Buy
87288.19,1.13496,23.08.2011 00:34:58,tp 1.13496,0.0,-338.2699999999604,0.0,0.0,1.13386,23.08.2011 00:10:00,7026,-0.1904389695093626,57.01,IS,0.41,0.0,Phase3-EA-SA2v2-EURCHF-M5-43,EURCHFMT4,3794,24m 58s,Buy
87345.33,1.13442,23.08.2011 03:34:57,tp 1.13442,0.0,-281.12999999994645,0.0,0.0,1.13332,23.08.2011 01:50:00,7027,-0.15827033877719918,57.14,IS,0.41,0.0,Phase3-EA-SA2v2-EURCHF-M5-43,EURCHFMT4,3796,1h 44m,Buy
87518.02,1.13787,23.08.2011 10:44:58,tp 1.13787,0.0,-108.43999999994412,0.0,0.0,1.13387,23.08.2011 02:00:00,7028,-0.06104946301353077,172.69,IS,0.34,0.0,Phase3-EA-S4v1-EURCHF-M15-221,EURCHFMT4,1770,8h 44m,Buy
87667.74,111068,23.08.2011 12:29:58,tp 111.068,-1.73,-0.0,0.0,0.0,109778,18.08.2011 23:30:00,7029,-0.0,149.72,IS,0.09,0.0,Phase3-EA-TR1v1-EURJPY-M30-91,EURJPYMT4,1106,4d 12h 59m,Buy
87583.04,110156,23.08.2011 16:59:58,sl 110.156,0.0,-84.70000000001164,0.0,0.0,110876,23.08.2011 13:00:00,7030,-0.04767325795893589,-84.7,IS,0.09,0.0,Phase3-EA-TR1v1-EURJPY-M30-91,EURJPYMT4,1108,3h 59m,Buy
87616.22,76484,23.08.2011 17:45:00,,0.0,-51.52000000001863,0.0,0.0,76578,23.08.2011 17:00:00,7031,-0.028997948642797255,33.18,IS,0.27,0.0,Phase3-EA-S1v2-USDJPY-M15-0,USDJPYMT4,2172,45m 0s,Sell
87564.17,110492,24.08.2011 05:44:57,sl 110.492,-1.09,-103.57000000000698,0.0,0.0,110722,23.08.2011 22:15:00,7032,-0.05829420692805956,-52.05,IS,0.17,0.0,Phase3-EA-T1v2-EURJPY-M15-322,EURJPYMT4,986,7h 29m,Buy
87487.7,1.14262,24.08.2011 06:00:00,,-2.59,-180.04000000000815,0.0,0.0,1.14119,23.08.2011 21:40:00,7033,-0.10133522270278662,-76.47,IS,0.41,0.0,Phase3-EA-SA2v2-EURCHF-M5-43,EURCHFMT4,3798,8h 20m,Sell
87445.7,1.65168,24.08.2011 12:29:58,sl 1.65168,0.0,-222.04000000000815,0.0,0.0,1.64868,24.08.2011 03:30:00,7034,-0.12497485474853672,-42.0,IS,0.14,0.0,Phase3-EA-B1v1-GBPUSD-M30-14,GBPUSDMT4,456,8h 59m,Sell
87502.51,1.14557,24.08.2011 21:04:59,tp 1.14557,0.0,-165.23000000001048,0.0,0.0,1.14667,24.08.2011 20:35:00,7035,-0.09299943816475083,56.81,IS,0.41,0.0,Phase3-EA-SA2v2-EURCHF-M5-43,EURCHFMT4,3800,29m 59s,Sell
87559.23,1.14594,25.08.2011 03:54:58,tp 1.14594,0.0,-108.51000000000931,0.0,0.0,1.14704,25.08.2011 00:10:00,7036,-0.06107467793534672,56.72,IS,0.41,0.0,Phase3-EA-SA2v2-EURCHF-M5-43,EURCHFMT4,3802,3h 44m,Sell
87564.01,125942,25.08.2011 06:00:00,,0.0,-103.73000000001048,0.0,0.0,125926,25.08.2011 00:35:00,7037,-0.0583842626691882,4.78,IS,0.23,0.0,Phase3-EA-S4v1-GBPJPY-M5-194,GBPJPYMT4,1704,5h 25m,Buy
87734.77,1.14928,25.08.2011 10:14:58,tp 1.14928,0.0,-0.0,0.0,0.0,1.14528,25.08.2011 04:30:00,7038,-0.0,170.76,IS,0.34,0.0,Phase3-EA-S4v1-EURCHF-M15-221,EURCHFMT4,1772,5h 44m,Buy
87779.58,111197,25.08.2011 18:30:00,,0.0,-0.0,0.0,0.0,110993,25.08.2011 08:30:00,7039,-0.0,44.81,IS,0.17,0.0,Phase3-EA-T1v2-EURJPY-M15-322,EURJPYMT4,988,10h 0m,Buy
87729.09,111343,25.08.2011 23:44:58,sl 111.343,0.0,-50.48999999999069,0.0,0.0,111573,25.08.2011 20:00:00,7040,-0.028400337091577462,-50.49,IS,0.17,0.0,Phase3-EA-T1v2-EURJPY-M15-322,EURJPYMT4,990,3h 44m,Buy
87784.72,1.1421,26.08.2011 02:04:58,tp 1.14210,-1.24,-0.0,0.0,0.0,1141,25.08.2011 21:05:00,7041,-0.0,55.63,IS,0.41,0.0,Phase3-EA-SA2v2-EURCHF-M5-43,EURCHFMT4,3804,4h 59m,Buy
87758.32,111312,26.08.2011 04:00:00,,0.0,-26.39999999999418,0.0,0.0,111432,26.08.2011 02:15:00,7042,-0.014849420130140624,-26.4,IS,0.17,0.0,Phase3-EA-T1v2-EURJPY-M15-322,EURJPYMT4,992,1h 45m,Buy
87741.6,111353,26.08.2011 07:15:00,,0.0,-43.11999999999534,0.0,0.0,111429,26.08.2011 06:30:00,7043,-0.024254052879232414,-16.72,IS,0.17,0.0,Phase3-EA-T1v2-EURJPY-M15-322,EURJPYMT4,994,45m 0s,Buy
87798.58,1.14094,26.08.2011 08:44:58,tp 1.14094,0.0,-0.0,0.0,0.0,1.14204,26.08.2011 02:15:00,7044,-0.0,56.98,IS,0.41,0.0,Phase3-EA-SA2v2-EURCHF-M5-43,EURCHFMT4,3806,6h 29m,Sell
87631.08,1.14672,26.08.2011 11:44:57,sl 1.14672,0.0,-167.5,0.0,0.0,1.14282,26.08.2011 03:15:00,7045,-0.09420772651840063,-167.5,IS,0.34,0.0,Phase3-EA-S4v1-EURCHF-M15-221,EURCHFMT4,1774,8h 29m,Sell
87337.7,76.65,26.08.2011 13:59:58,sl 76.650,-1.01,-460.88000000000466,0.0,0.0,77.48,25.08.2011 23:15:00,7046,-0.2592146686435876,-293.38,IS,0.27,0.0,Phase3-EA-S1v2-USDJPY-M15-0,USDJPYMT4,2174,14h 44m,Buy
87338.57,76687,29.08.2011 01:00:00,,-1.59,-460.0100000000093,0.0,0.0,76694,26.08.2011 19:45:00,7047,-0.2587253508998827,0.87,IS,0.27,0.0,Phase3-EA-S1v2-USDJPY-M15-0,USDJPYMT4,2176,2d 5h 15m,Sell
87264.79,0.80974,29.08.2011 06:45:00,,0.0,-533.7900000000081,0.0,0.0,0.80871,29.08.2011 02:30:00,7048,-0.3002217453030319,-73.78,IS,0.58,0.0,Phase3-EA-SA2v2-USDCHF-M15-107,USDCHFMT4,1376,4h 15m,Sell
87251.77,76717,29.08.2011 08:15:00,,0.0,-546.8099999999977,0.0,0.0,76.68,29.08.2011 01:15:00,7049,-0.3075446384329936,-13.02,IS,0.27,0.0,Phase3-EA-S1v2-USDJPY-M15-0,USDJPYMT4,2178,7h 0m,Sell
87003.15,1.17569,29.08.2011 09:09:58,sl 1.17569,0.0,-795.429999999993,0.0,0.0,1.17079,29.08.2011 01:55:00,7050,-0.447377026295706,-248.62,IS,0.41,0.0,Phase3-EA-SA2v2-EURCHF-M5-43,EURCHFMT4,3808,7h 14m,Sell
86839.04,1.17522,29.08.2011 09:14:58,sl 1.17522,0.0,-959.539999999979,0.0,0.0,1.17132,29.08.2011 02:30:00,7051,-0.539678100916204,-164.11,IS,0.34,0.0,Phase3-EA-S4v1-EURCHF-M15-221,EURCHFMT4,1776,6h 44m,Sell
86894.3,1.18493,29.08.2011 21:34:57,tp 1.18493,0.0,-904.2799999999697,0.0,0.0,1.18383,29.08.2011 20:15:00,7052,-0.5085979876779491,55.26,IS,0.41,0.0,Phase3-EA-SA2v2-EURCHF-M5-43,EURCHFMT4,3810,1h 19m,Buy
86949.59,1.18394,29.08.2011 23:39:57,tp 1.18394,0.0,-848.9899999999616,0.0,0.0,1.18284,29.08.2011 23:05:00,7053,-0.4775010014140498,55.29,IS,0.41,0.0,Phase3-EA-SA2v2-EURCHF-M5-43,EURCHFMT4,3812,34m 57s,Buy
87019.78,0.81639,30.08.2011 00:59:57,tp 0.81639,-0.85,-778.7999999999593,0.0,0.0,0.81539,29.08.2011 23:15:00,7054,-0.43802374574642733,70.19,IS,0.58,0.0,Phase3-EA-SA2v2-USDCHF-M15-107,USDCHFMT4,1378,1h 44m,Buy
87038.06,76934,30.08.2011 01:00:00,,-1.02,-760.5199999999604,0.0,0.0,76879,29.08.2011 21:15:00,7055,-0.4277424487866885,18.28,IS,0.27,0.0,Phase3-EA-S1v2-USDJPY-M15-0,USDJPYMT4,2180,3h 45m,Buy
87066.81,111668,30.08.2011 02:00:00,,-1.08,-731.7699999999604,0.0,0.0,111533,29.08.2011 16:15:00,7056,-0.4115724658768138,28.75,IS,0.17,0.0,Phase3-EA-T1v2-EURJPY-M15-322,EURJPYMT4,996,9h 45m,Buy
87050.95,126061,30.08.2011 07:40:00,,0.0,-747.6299999999464,0.0,0.0,126114,30.08.2011 02:15:00,7057,-0.4204926721011751,-15.86,IS,0.23,0.0,Phase3-EA-S4v1-GBPJPY-M5-194,GBPJPYMT4,1706,5h 25m,Buy
87000.05,111415,30.08.2011 08:14:58,sl 111.415,0.0,-798.5299999999406,0.0,0.0,111645,30.08.2011 04:45:00,7058,-0.4491205722790022,-50.9,IS,0.17,0.0,Phase3-EA-T1v2-EURJPY-M15-322,EURJPYMT4,998,3h 29m,Buy
87055.23,1.18396,30.08.2011 08:24:58,tp 1.18396,0.0,-743.3499999999476,0.0,0.0,1.18506,30.08.2011 00:35:00,7059,-0.41808545377581,55.18,IS,0.41,0.0,Phase3-EA-SA2v2-EURCHF-M5-43,EURCHFMT4,3814,7h 49m,Sell
87221.76,1.18339,30.08.2011 08:44:58,tp 1.18339,0.0,-576.8199999999488,0.0,0.0,1.18739,30.08.2011 03:00:00,7060,-0.3244232884199345,166.53,IS,0.34,0.0,Phase3-EA-S4v1-EURCHF-M15-221,EURCHFMT4,1778,5h 44m,Sell
87179.23,1.63169,30.08.2011 11:29:58,sl 1.63169,-0.53,-619.3499999999476,0.0,0.0,1.63469,29.08.2011 02:00:00,7061,-0.34834361444278505,-42.53,IS,0.14,0.0,Phase3-EA-B1v1-GBPUSD-M30-14,GBPUSDMT4,458,1d 9h 29m,Buy
87016.9,1.17772,31.08.2011 07:59:58,sl 1.17772,0.0,-781.6799999999348,0.0,0.0,1.18162,31.08.2011 03:45:00,7062,-0.4396435562083419,-162.33,IS,0.34,0.0,Phase3-EA-S4v1-EURCHF-M15-221,EURCHFMT4,1780,4h 14m,Buy
86974.9,1.62849,31.08.2011 10:29:58,sl 1.62849,0.0,-823.6799999999348,0.0,0.0,1.63149,31.08.2011 06:00:00,7063,-0.46326579211146324,-42.0,IS,0.14,0.0,Phase3-EA-B1v1-GBPUSD-M30-14,GBPUSDMT4,460,4h 29m,Buy
87125.45,109979,31.08.2011 19:59:58,tp 109.979,-1.23,-673.1299999999464,0.0,0.0,111269,26.08.2011 00:30:00,7064,-0.3785913250825431,150.55,IS,0.09,0.0,Phase3-EA-TR1v1-EURJPY-M30-91,EURJPYMT4,1110,5d 19h 29m,Sell
87181.62,1.15411,31.08.2011 20:19:58,tp 1.15411,0.0,-616.9599999999336,0.0,0.0,1.15301,31.08.2011 20:00:00,7065,-0.34699939673305197,56.17,IS,0.41,0.0,Phase3-EA-SA2v2-EURCHF-M5-43,EURCHFMT4,3816,19m 58s,Buy
87237.61,1.15797,31.08.2011 21:59:57,tp 1.15797,0.0,-560.969999999943,0.0,0.0,1.15907,31.08.2011 21:50:00,7066,-0.3155087065374438,55.99,IS,0.41,0.0,Phase3-EA-SA2v2-EURCHF-M5-43,EURCHFMT4,3818,9m 57s,Sell
87293.48,1.15797,01.09.2011 02:19:58,tp 1.15797,0.0,-505.0999999999476,0.0,0.0,1.15687,01.09.2011 02:05:00,7067,-0.28408550844441327,55.87,IS,0.41,0.0,Phase3-EA-SA2v2-EURCHF-M5-43,EURCHFMT4,3820,14m 58s,Buy
87365.36,0.80685,01.09.2011 02:29:57,tp 0.80685,0.0,-433.21999999994296,0.0,0.0,0.80585,01.09.2011 02:15:00,7068,-0.24365773899878299,71.88,IS,0.58,0.0,Phase3-EA-SA2v2-USDCHF-M15-107,USDCHFMT4,1380,14m 57s,Buy
87312.25,110915,01.09.2011 03:29:58,sl 110.915,-2.33,-486.329999999929,0.0,0.0,110685,31.08.2011 02:15:00,7069,-0.27352861873246026,-53.11,IS,0.17,0.0,Phase3-EA-T1v2-EURJPY-M15-322,EURJPYMT4,1000,1d 1h 14m,Sell
87236.18,76.85,01.09.2011 16:00:00,,-4.75,-562.399999999936,0.0,0.0,76647,31.08.2011 23:00:00,7070,-0.3163129874265223,-76.07,IS,0.27,0.0,Phase3-EA-S1v2-USDJPY-M15-0,USDJPYMT4,2182,17h 0m,Sell
87305.34,0.79424,02.09.2011 01:59:58,tp 0.79424,-3.87,-493.2399999999325,0.0,0.0,0.79524,01.09.2011 23:30:00,7071,-0.27741503897271386,69.16,IS,0.58,0.0,Phase3-EA-SA2v2-USDCHF-M15-107,USDCHFMT4,1382,2h 29m,Sell
87476.74,1.13039,02.09.2011 05:29:57,tp 1.13039,0.0,-321.8399999999383,0.0,0.0,1.13439,02.09.2011 03:30:00,7072,-0.18101381912045522,171.4,IS,0.34,0.0,Phase3-EA-S4v1-EURCHF-M15-221,EURCHFMT4,1782,1h 59m,Sell
87388.24,793,02.09.2011 06:30:00,,0.0,-410.3399999999383,0.0,0.0,0.79421,02.09.2011 02:15:00,7073,-0.2307892447734609,-88.5,IS,0.58,0.0,Phase3-EA-SA2v2-USDCHF-M15-107,USDCHFMT4,1384,4h 15m,Buy
87220.95,1.12702,02.09.2011 08:59:58,sl 1.12702,0.0,-577.6299999999464,0.0,0.0,1.13092,02.09.2011 05:45:00,7074,-0.32487886011235056,-167.29,IS,0.34,0.0,Phase3-EA-S4v1-EURCHF-M15-221,EURCHFMT4,1784,3h 14m,Buy
87366.64,109273,02.09.2011 09:29:58,tp 109.273,-2.05,-431.9399999999441,0.0,0.0,110533,30.08.2011 12:30:00,7075,-0.24293782323792662,145.69,IS,0.09,0.0,Phase3-EA-TR1v1-EURJPY-M30-91,EURJPYMT4,1111,2d 20h 59m,Sell
87440.22,0.78822,02.09.2011 22:59:58,tp 0.78822,0.0,-358.3599999999569,0.0,0.0,0.78922,02.09.2011 22:00:00,7076,-0.20155391567241787,73.58,IS,0.58,0.0,Phase3-EA-SA2v2-USDCHF-M15-107,USDCHFMT4,1386,59m 58s,Sell
87377.35,1.11826,05.09.2011 04:55:00,,-2.6,-421.22999999995227,0.0,0.0,1.1171,02.09.2011 20:35:00,7077,-0.23691415308263525,-62.87,IS,0.41,0.0,Phase3-EA-SA2v2-EURCHF-M5-43,EURCHFMT4,3822,2d 8h 20m,Sell
87351.28,124178,05.09.2011 06:35:00,,0.0,-447.29999999995925,0.0,0.0,124265,05.09.2011 01:10:00,7078,-0.2515768123682195,-26.07,IS,0.23,0.0,Phase3-EA-S4v1-GBPJPY-M5-194,GBPJPYMT4,1708,5h 25m,Buy
87259.17,108572,05.09.2011 07:59:58,sl 108.572,-0.57,-539.4099999999453,0.0,0.0,109352,02.09.2011 11:00:00,7079,-0.3033826254405094,-92.11,IS,0.09,0.0,Phase3-EA-TR1v1-EURJPY-M30-91,EURJPYMT4,1114,2d 20h 59m,Buy
87313.89,1.10745,06.09.2011 00:09:58,tp 1.10745,-2.61,-484.6899999999441,0.0,0.0,1.10855,05.09.2011 22:05:00,7080,-0.2726062266638707,54.72,IS,0.41,0.0,Phase3-EA-SA2v2-EURCHF-M5-43,EURCHFMT4,3824,2h 4m,Sell
87383.82,0.78543,06.09.2011 00:14:57,tp 0.78543,-3.91,-414.7599999999511,0.0,0.0,0.78643,05.09.2011 22:15:00,7081,-0.23327520388517756,69.93,IS,0.58,0.0,Phase3-EA-SA2v2-USDCHF-M15-107,USDCHFMT4,1388,1h 59m,Sell
87758.46,107873,06.09.2011 07:14:58,tp 107.873,-1.54,-40.119999999937136,0.0,0.0,109573,02.09.2011 05:30:00,7082,-0.022564859629327232,374.64,IS,0.17,0.0,Phase3-EA-T1v2-EURJPY-M15-322,EURJPYMT4,1002,4d 1h 44m,Sell
87666.49,107904,06.09.2011 07:29:57,sl 107.904,-0.57,-132.0899999999383,0.0,0.0,108684,05.09.2011 10:30:00,7083,-0.07429193191528195,-91.97,IS,0.09,0.0,Phase3-EA-TR1v1-EURJPY-M30-91,EURJPYMT4,1116,20h 59m,Buy
87723.89,1.10747,06.09.2011 08:14:58,tp 1.10747,0.0,-74.68999999994412,0.0,0.0,1.10637,06.09.2011 00:30:00,7084,-0.04200820951435271,57.4,IS,0.41,0.0,Phase3-EA-SA2v2-EURCHF-M5-43,EURCHFMT4,3826,7h 44m,Buy
87896.91,1.10906,06.09.2011 08:44:58,tp 1.10906,0.0,-0.0,0.0,0.0,1.10506,06.09.2011 02:15:00,7085,-0.0,173.02,IS,0.34,0.0,Phase3-EA-S4v1-EURCHF-M15-221,EURCHFMT4,1786,6h 29m,Buy
88048.22,109481,06.09.2011 10:29:58,tp 109.481,0.0,-0.0,0.0,0.0,108191,06.09.2011 09:30:00,7086,-0.0,151.31,IS,0.09,0.0,Phase3-EA-TR1v1-EURJPY-M30-91,EURJPYMT4,1118,59m 58s,Buy
88006.22,1.60848,06.09.2011 13:29:58,sl 1.60848,0.0,-42.0,0.0,0.0,1.61148,06.09.2011 09:30:00,7087,-0.02358911535313295,-42.0,IS,0.14,0.0,Phase3-EA-B1v1-GBPUSD-M30-14,GBPUSDMT4,462,3h 59m,Buy
88014.6,77621,07.09.2011 01:00:00,,-1.01,-33.61999999999534,0.0,0.0,77594,06.09.2011 23:45:00,7088,-0.018882525194576665,8.38,IS,0.27,0.0,Phase3-EA-S1v2-USDJPY-M15-0,USDJPYMT4,2184,1h 15m,Buy
88049.95,1.20447,07.09.2011 04:25:00,,-2.38,-0.0,0.0,0.0,1.20526,06.09.2011 20:05:00,7089,-0.0,35.35,IS,0.41,0.0,Phase3-EA-SA2v2-EURCHF-M5-43,EURCHFMT4,3828,8h 20m,Sell
87999.37,108814,07.09.2011 08:59:58,sl 108.814,0.0,-50.579999999987194,0.0,0.0,108584,07.09.2011 04:15:00,7090,-0.02840775860930436,-50.58,IS,0.17,0.0,Phase3-EA-T1v2-EURJPY-M15-322,EURJPYMT4,1004,4h 44m,Sell
88035.79,1.20554,07.09.2011 14:30:00,,0.0,-14.159999999974389,0.0,0.0,1.20462,07.09.2011 05:45:00,7091,-0.00795282447424128,36.42,IS,0.34,0.0,Phase3-EA-S4v1-EURCHF-M15-221,EURCHFMT4,1788,8h 45m,Buy
88088.3,1.20967,08.09.2011 09:04:58,tp 1.20967,0.0,-0.0,0.0,0.0,1.20857,08.09.2011 02:30:00,7092,-0.0,52.51,IS,0.41,0.0,Phase3-EA-SA2v2-EURCHF-M5-43,EURCHFMT4,3830,6h 34m,Buy
88246.24,1.21255,08.09.2011 09:59:58,tp 1.21255,0.0,-0.0,0.0,0.0,1.20855,08.09.2011 03:15:00,7093,-0.0,157.94,IS,0.34,0.0,Phase3-EA-S4v1-EURCHF-M15-221,EURCHFMT4,1790,6h 44m,Buy
88195.65,108672,08.09.2011 12:29:59,sl 108.672,0.0,-50.58999999999651,0.0,0.0,108902,08.09.2011 09:00:00,7094,-0.028382085366847803,-50.59,IS,0.17,0.0,Phase3-EA-T1v2-EURJPY-M15-322,EURJPYMT4,1006,3h 29m,Buy
88163.05,0.87188,09.09.2011 07:00:00,,0.0,-83.19000000000233,0.0,0.0,0.87237,09.09.2011 02:45:00,7095,-0.046671391217005295,-32.6,IS,0.58,0.0,Phase3-EA-SA2v2-USDCHF-M15-107,USDCHFMT4,1390,4h 15m,Buy
88312.53,107486,09.09.2011 09:59:57,tp 107.486,-0.41,-0.0,0.0,0.0,108776,08.09.2011 05:30:00,7096,-0.0,149.48,IS,0.09,0.0,Phase3-EA-TR1v1-EURJPY-M30-91,EURJPYMT4,1120,1d 4h 29m,Sell
88364.04,1.21531,09.09.2011 10:19:58,tp 1.21531,0.0,-0.0,0.0,0.0,1.21421,09.09.2011 02:40:00,7097,-0.0,51.51,IS,0.41,0.0,Phase3-EA-SA2v2-EURCHF-M5-43,EURCHFMT4,3832,7h 39m,Buy
88322.04,1.59285,09.09.2011 12:29:58,sl 1.59285,0.0,-42.0,0.0,0.0,1.58985,09.09.2011 12:00:00,7098,-0.023547347324045762,-42.0,IS,0.14,0.0,Phase3-EA-B1v1-GBPUSD-M30-14,GBPUSDMT4,464,29m 58s,Sell
88476.85,1.21737,09.09.2011 13:44:58,tp 1.21737,0.0,-0.0,0.0,0.0,1.21337,09.09.2011 05:30:00,7099,-0.0,154.81,IS,0.34,0.0,Phase3-EA-S4v1-EURCHF-M15-221,EURCHFMT4,1792,8h 14m,Buy
88682.83,122.99,09.09.2011 17:29:58,tp 122.990,-8.13,-0.0,0.0,0.0,124.84,30.08.2011 16:00:00,7100,-0.0,205.98,IS,0.09,0.0,Phase3-EA-B1v1-GBPJPY-M30-1,GBPJPYMT4,704,10d 1h 29m,Sell
89054.96,105935,09.09.2011 17:29:58,tp 105.935,0.0,-0.0,0.0,0.0,107635,09.09.2011 07:30:00,7101,-0.0,372.13,IS,0.17,0.0,Phase3-EA-T1v2-EURJPY-M15-322,EURJPYMT4,1008,9h 59m,Sell
89200.38,106343,09.09.2011 17:29:58,tp 106.343,-0.41,-0.0,0.0,0.0,107603,08.09.2011 22:00:00,7102,-0.0,145.42,IS,0.09,0.0,Phase3-EA-TR1v1-EURJPY-M30-91,EURJPYMT4,1121,19h 29m,Sell
89136.32,77556,09.09.2011 23:00:00,,0.0,-64.05999999999767,0.0,0.0,77.74,09.09.2011 17:00:00,7103,-0.03574769205288378,-64.06,IS,0.27,0.0,Phase3-EA-S1v2-USDJPY-M15-0,USDJPYMT4,2186,6h 0m,Buy
89187.15,1.20688,12.09.2011 02:04:58,tp 1.20688,0.0,-13.230000000010477,0.0,0.0,1.20578,12.09.2011 01:25:00,7104,-0.007382796844521451,50.83,IS,0.41,0.0,Phase3-EA-SA2v2-EURCHF-M5-43,EURCHFMT4,3834,39m 58s,Buy
89213.46,77476,12.09.2011 07:15:00,,-1.57,-0.0,0.0,0.0,77556,09.09.2011 23:00:00,7105,-0.0,26.31,IS,0.27,0.0,Phase3-EA-S1v2-USDJPY-M15-0,USDJPYMT4,2188,2d 8h 15m,Sell
89359.4,104309,12.09.2011 07:59:58,tp 104.309,-0.41,-0.0,0.0,0.0,105569,09.09.2011 18:30:00,7106,-0.0,145.94,IS,0.09,0.0,Phase3-EA-TR1v1-EURJPY-M30-91,EURJPYMT4,1124,2d 13h 29m,Sell
89330.38,1.20526,12.09.2011 10:30:00,,0.0,-29.019999999989523,0.0,0.0,1.20602,12.09.2011 01:45:00,7107,-0.016179804348135342,-29.02,IS,0.34,0.0,Phase3-EA-S4v1-EURCHF-M15-221,EURCHFMT4,1794,8h 45m,Buy
89423.71,77244,12.09.2011 20:00:00,,0.0,-0.0,0.0,0.0,76977,12.09.2011 18:00:00,7108,-0.0,93.33,IS,0.27,0.0,Phase3-EA-S1v2-USDJPY-M15-0,USDJPYMT4,2190,2h 0m,Buy
89373.12,105.14,12.09.2011 21:44:57,sl 105.140,0.0,-50.58999999999651,0.0,0.0,104.91,12.09.2011 21:00:00,7109,-0.028195827630582603,-50.59,IS,0.17,0.0,Phase3-EA-T1v2-EURJPY-M15-322,EURJPYMT4,1010,44m 57s,Sell
89438.06,0.88234,13.09.2011 02:29:58,tp 0.88234,-0.79,-0.0,0.0,0.0,0.88134,12.09.2011 23:00:00,7110,-0.0,64.94,IS,0.58,0.0,Phase3-EA-SA2v2-USDCHF-M15-107,USDCHFMT4,1392,3h 29m,Buy
89386.28,105123,13.09.2011 03:44:58,sl 105.123,-1.08,-51.779999999998836,0.0,0.0,105353,12.09.2011 22:45:00,7111,-0.028856754247119438,-51.78,IS,0.17,0.0,Phase3-EA-T1v2-EURJPY-M15-322,EURJPYMT4,1012,4h 59m,Buy
89452.09,0.88135,13.09.2011 04:29:58,tp 0.88135,0.0,-0.0,0.0,0.0,0.88235,13.09.2011 02:45:00,7112,-0.0,65.81,IS,0.58,0.0,Phase3-EA-SA2v2-USDCHF-M15-107,USDCHFMT4,1394,1h 44m,Sell
89401.21,105229,13.09.2011 16:59:58,sl 105.229,0.0,-50.88000000000466,0.0,0.0,104999,13.09.2011 16:00:00,7113,-0.028352971536862316,-50.88,IS,0.17,0.0,Phase3-EA-T1v2-EURJPY-M15-322,EURJPYMT4,1014,59m 58s,Sell
89350.38,105109,14.09.2011 04:59:57,sl 105.109,0.0,-101.70999999999185,0.0,0.0,105339,14.09.2011 03:15:00,7114,-0.056678080483761224,-50.83,IS,0.17,0.0,Phase3-EA-T1v2-EURJPY-M15-322,EURJPYMT4,1016,1h 44m,Buy
89344.32,1204,14.09.2011 05:15:00,,-2.33,-107.76999999998952,0.0,0.0,1.20392,13.09.2011 20:55:00,7115,-0.06005502638614534,-6.06,IS,0.41,0.0,Phase3-EA-SA2v2-EURCHF-M5-43,EURCHFMT4,3836,8h 20m,Sell
89293.35,105143,14.09.2011 18:14:58,sl 105.143,0.0,-158.7399999999907,0.0,0.0,104913,14.09.2011 17:45:00,7116,-0.08845815058492233,-50.97,IS,0.17,0.0,Phase3-EA-T1v2-EURJPY-M15-322,EURJPYMT4,1018,29m 58s,Sell
89303.55,105196,14.09.2011 20:00:00,,0.0,-148.53999999997905,0.0,0.0,105.15,14.09.2011 19:30:00,7117,-0.08277418223436614,10.2,IS,0.17,0.0,Phase3-EA-T1v2-EURJPY-M15-322,EURJPYMT4,1020,30m 0s,Buy
89260.58,1.20428,15.09.2011 05:10:00,,-7.02,-191.5099999999802,0.0,0.0,1.20351,14.09.2011 20:50:00,7118,-0.10671929204055511,-42.97,IS,0.41,0.0,Phase3-EA-SA2v2-EURCHF-M5-43,EURCHFMT4,3838,8h 20m,Sell
89409.13,105754,15.09.2011 12:59:58,tp 105.754,-2.87,-42.95999999999185,0.0,0.0,104464,12.09.2011 11:30:00,7119,-0.023939537288193053,148.55,IS,0.09,0.0,Phase3-EA-TR1v1-EURJPY-M30-91,EURJPYMT4,1126,3d 1h 29m,Buy
89461.01,1.20639,15.09.2011 22:59:58,tp 1.20639,0.0,-0.0,0.0,0.0,1.20749,15.09.2011 22:00:00,7120,-0.0,51.88,IS,0.41,0.0,Phase3-EA-SA2v2-EURCHF-M5-43,EURCHFMT4,3840,59m 58s,Sell
89654.27,106319,16.09.2011 04:45:00,,-1.09,-0.0,0.0,0.0,105441,15.09.2011 10:30:00,7121,-0.0,193.26,IS,0.17,0.0,Phase3-EA-T1v2-EURJPY-M15-322,EURJPYMT4,1022,18h 15m,Buy
89665.2,1.20677,16.09.2011 09:45:00,,0.0,-0.0,0.0,0.0,1.20705,16.09.2011 01:00:00,7122,-0.0,10.93,IS,0.34,0.0,Phase3-EA-S4v1-EURCHF-M15-221,EURCHFMT4,1796,8h 45m,Sell
89614.27,106243,16.09.2011 09:59:58,sl 106.243,0.0,-50.929999999993015,0.0,0.0,106473,16.09.2011 07:00:00,7123,-0.02834717018097712,-50.93,IS,0.17,0.0,Phase3-EA-T1v2-EURJPY-M15-322,EURJPYMT4,1024,2h 59m,Buy
89665.83,1.20614,16.09.2011 20:39:58,tp 1.20614,0.0,-0.0,0.0,0.0,1.20724,16.09.2011 20:05:00,7124,-0.0,51.56,IS,0.41,0.0,Phase3-EA-SA2v2-EURCHF-M5-43,EURCHFMT4,3842,34m 58s,Sell
89717.25,1.20718,16.09.2011 21:24:58,tp 1.20718,0.0,-0.0,0.0,0.0,1.20828,16.09.2011 21:15:00,7125,-0.0,51.42,IS,0.41,0.0,Phase3-EA-SA2v2-EURCHF-M5-43,EURCHFMT4,3844,9m 58s,Sell
89741.51,76909,19.09.2011 01:15:00,,-1.02,-0.0,0.0,0.0,76837,16.09.2011 23:00:00,7126,-0.0,24.26,IS,0.27,0.0,Phase3-EA-S1v2-USDJPY-M15-0,USDJPYMT4,2192,2d 2h 15m,Buy
89891.63,104986,19.09.2011 04:59:58,tp 104.986,-0.82,-0.0,0.0,0.0,106276,15.09.2011 19:00:00,7127,-0.0,150.12,IS,0.09,0.0,Phase3-EA-TR1v1-EURJPY-M30-91,EURJPYMT4,1128,3d 9h 59m,Sell
89802.18,120.67,19.09.2011 06:50:00,,0.0,-89.45000000001164,0.0,0.0,120969,19.09.2011 01:25:00,7128,-0.04972438128444966,-89.45,IS,0.23,0.0,Phase3-EA-S4v1-GBPJPY-M5-194,GBPJPYMT4,1710,5h 25m,Buy
89806.83,1.20617,19.09.2011 09:55:00,,0.0,-84.80000000001746,0.0,0.0,1.20607,19.09.2011 01:35:00,7129,-0.04713949170398715,4.65,IS,0.41,0.0,Phase3-EA-SA2v2-EURCHF-M5-43,EURCHFMT4,3846,8h 20m,Buy
89827.64,1.20622,19.09.2011 14:30:00,,0.0,-63.99000000001979,0.0,0.0,1.20568,19.09.2011 05:45:00,7130,-0.035571415968613795,20.81,IS,0.34,0.0,Phase3-EA-S4v1-EURCHF-M15-221,EURCHFMT4,1798,8h 45m,Buy
90203.75,104189,19.09.2011 17:29:57,tp 104.189,-0.78,-0.0,0.0,0.0,105889,16.09.2011 23:45:00,7131,-0.0,376.11,IS,0.17,0.0,Phase3-EA-T1v2-EURJPY-M15-322,EURJPYMT4,1026,2d 17h 44m,Sell
90254.91,1.20622,19.09.2011 21:34:58,tp 1.20622,0.0,-0.0,0.0,0.0,1.20512,19.09.2011 21:05:00,7132,-0.0,51.16,IS,0.41,0.0,Phase3-EA-SA2v2-EURCHF-M5-43,EURCHFMT4,3848,29m 58s,Buy
90170.21,104911,19.09.2011 22:59:57,sl 104.911,0.0,-84.70000000001164,0.0,0.0,104191,19.09.2011 17:30:00,7133,-0.04698901128408178,-84.7,IS,0.09,0.0,Phase3-EA-TR1v1-EURJPY-M30-91,EURJPYMT4,1130,5h 29m,Sell
90235.99,0.88173,19.09.2011 23:14:59,tp 0.88173,0.0,-18.920000000012806,0.0,0.0,0.88073,19.09.2011 22:45:00,7134,-0.010496246676449904,65.78,IS,0.58,0.0,Phase3-EA-SA2v2-USDCHF-M15-107,USDCHFMT4,1396,29m 59s,Buy
90284.81,1.20512,20.09.2011 01:24:58,tp 1.20512,-2.32,-0.0,0.0,0.0,1.20622,19.09.2011 21:55:00,7135,-0.0,48.82,IS,0.41,0.0,Phase3-EA-SA2v2-EURCHF-M5-43,EURCHFMT4,3850,3h 29m,Sell
90350.33,0.88529,20.09.2011 02:29:57,tp 0.88529,0.0,-0.0,0.0,0.0,0.88629,20.09.2011 02:15:00,7136,-0.0,65.52,IS,0.58,0.0,Phase3-EA-SA2v2-USDCHF-M15-107,USDCHFMT4,1398,14m 57s,Sell
90299.3,104.45,20.09.2011 02:59:58,sl 104.450,0.0,-51.029999999998836,0.0,0.0,104.22,20.09.2011 02:15:00,7137,-0.02829493020611536,-51.03,IS,0.17,0.0,Phase3-EA-T1v2-EURJPY-M15-322,EURJPYMT4,1028,44m 58s,Sell
90290.3,76529,20.09.2011 04:45:00,,-1.59,-60.029999999998836,0.0,0.0,76508,19.09.2011 22:45:00,7138,-0.033285217720421534,-9.0,IS,0.27,0.0,Phase3-EA-S1v2-USDJPY-M15-0,USDJPYMT4,2194,6h 0m,Sell
90267.15,119876,20.09.2011 07:10:00,,0.0,-83.17999999999302,0.0,0.0,119953,20.09.2011 01:45:00,7139,-0.04612134615999474,-23.15,IS,0.23,0.0,Phase3-EA-S4v1-GBPJPY-M5-194,GBPJPYMT4,1712,5h 25m,Buy
90317.97,1.21563,20.09.2011 23:14:58,tp 1.21563,0.0,-32.35999999998603,0.0,0.0,1.21453,20.09.2011 22:50:00,7140,-0.01794285599587534,50.82,IS,0.41,0.0,Phase3-EA-SA2v2-EURCHF-M5-43,EURCHFMT4,3852,24m 58s,Buy
90383.28,0.8881,21.09.2011 02:14:58,tp 0.88810,0.0,-0.0,0.0,0.0,0.8871,21.09.2011 00:15:00,7141,-0.0,65.31,IS,0.58,0.0,Phase3-EA-SA2v2-USDCHF-M15-107,USDCHFMT4,1400,1h 59m,Buy
90332.03,104492,21.09.2011 04:14:58,sl 104.492,0.0,-51.25,0.0,0.0,104722,21.09.2011 01:00:00,7142,-0.028411724190845124,-51.25,IS,0.17,0.0,Phase3-EA-T1v2-EURJPY-M15-322,EURJPYMT4,1030,3h 14m,Buy
90280.81,104826,21.09.2011 18:44:58,sl 104.826,0.0,-102.47000000000116,0.0,0.0,104596,21.09.2011 09:00:00,7143,-0.05680681712850601,-51.22,IS,0.17,0.0,Phase3-EA-T1v2-EURJPY-M15-322,EURJPYMT4,1032,9h 44m,Sell
90195.96,104909,21.09.2011 19:29:57,sl 104.909,0.0,-187.32000000000698,0.0,0.0,104189,21.09.2011 15:30:00,7144,-0.1038455448864255,-84.85,IS,0.09,0.0,Phase3-EA-TR1v1-EURJPY-M30-91,EURJPYMT4,1132,3h 59m,Sell
90246.4,1.22374,21.09.2011 22:04:57,tp 1.22374,0.0,-136.88000000000466,0.0,0.0,1.22264,21.09.2011 22:00:00,7145,-0.07588286453157098,50.44,IS,0.41,0.0,Phase3-EA-SA2v2-EURCHF-M5-43,EURCHFMT4,3854,4m 57s,Buy
90067.42,0.90059,22.09.2011 03:30:00,,-10.25,-315.86000000001513,0.0,0.0,0.89797,21.09.2011 23:15:00,7146,-0.1751049210326004,-178.98,IS,0.58,0.0,Phase3-EA-SA2v2-USDCHF-M15-107,USDCHFMT4,1402,4h 15m,Sell
90184.31,118926,22.09.2011 04:14:57,tp 118.926,0.0,-198.97000000000116,0.0,0.0,118536,22.09.2011 00:05:00,7147,-0.11030401487321927,116.89,IS,0.23,0.0,Phase3-EA-S4v1-GBPJPY-M5-194,GBPJPYMT4,1714,4h 9m,Buy
90073.19,1.22024,22.09.2011 07:05:00,,-3.28,-310.0899999999965,0.0,0.0,1.22261,21.09.2011 22:45:00,7148,-0.17190617667003052,-111.12,IS,0.41,0.0,Phase3-EA-SA2v2-EURCHF-M5-43,EURCHFMT4,3856,8h 20m,Buy
90223.83,1.22495,22.09.2011 08:59:57,tp 1.22495,0.0,-159.44999999998254,0.0,0.0,1.22095,22.09.2011 04:15:00,7149,-0.08839511067765383,150.64,IS,0.34,0.0,Phase3-EA-S4v1-EURCHF-M15-221,EURCHFMT4,1800,4h 44m,Buy
90439.93,117321,22.09.2011 14:29:58,tp 117.321,-2.05,-0.0,0.0,0.0,119171,21.09.2011 16:00:00,7150,-0.0,216.1,IS,0.09,0.0,Phase3-EA-B1v1-GBPJPY-M30-1,GBPJPYMT4,706,22h 29m,Sell
90354.99,103222,22.09.2011 19:59:58,sl 103.222,0.0,-84.94000000000233,0.0,0.0,102502,22.09.2011 14:00:00,7151,-0.047073837814059306,-84.94,IS,0.09,0.0,Phase3-EA-TR1v1-EURJPY-M30-91,EURJPYMT4,1134,5h 59m,Sell
90404.72,1.22146,22.09.2011 21:24:58,tp 1.22146,0.0,-35.20999999999185,0.0,0.0,1.22036,22.09.2011 21:20:00,7152,-0.019513419230428528,49.73,IS,0.41,0.0,Phase3-EA-SA2v2-EURCHF-M5-43,EURCHFMT4,3858,4m 58s,Buy
90353.49,102.92,23.09.2011 02:44:58,sl 102.920,0.0,-86.44000000000233,0.0,0.0,102.69,23.09.2011 00:45:00,7153,-0.04790513940013286,-51.23,IS,0.17,0.0,Phase3-EA-T1v2-EURJPY-M15-322,EURJPYMT4,1034,1h 59m,Sell
90268.77,117475,23.09.2011 07:10:00,,0.0,-171.1600000000035,0.0,0.0,117194,23.09.2011 01:45:00,7154,-0.0948570529815674,-84.72,IS,0.23,0.0,Phase3-EA-S4v1-GBPJPY-M5-194,GBPJPYMT4,1716,5h 25m,Sell
90318.43,1.22236,23.09.2011 08:54:58,tp 1.22236,0.0,-121.5,0.0,0.0,1.22346,23.09.2011 02:10:00,7155,-0.06733542847195725,49.66,IS,0.41,0.0,Phase3-EA-SA2v2-EURCHF-M5-43,EURCHFMT4,3860,6h 44m,Sell
90468.19,1.22227,23.09.2011 08:59:58,tp 1.22227,0.0,-0.0,0.0,0.0,1.22627,23.09.2011 03:30:00,7156,-0.0,149.76,IS,0.34,0.0,Phase3-EA-S4v1-EURCHF-M15-221,EURCHFMT4,1802,5h 29m,Sell
90416.9,103039,23.09.2011 17:44:57,sl 103.039,0.0,-51.29000000000815,0.0,0.0,102809,23.09.2011 13:15:00,7157,-0.02842052109017552,-51.29,IS,0.17,0.0,Phase3-EA-T1v2-EURJPY-M15-322,EURJPYMT4,1036,4h 29m,Sell
90337.11,118.06,23.09.2011 18:29:58,sl 118.060,-0.68,-131.0800000000163,0.0,0.0,117.39,22.09.2011 15:30:00,7158,-0.07263329897641019,-79.79,IS,0.09,0.0,Phase3-EA-B1v1-GBPJPY-M30-1,GBPJPYMT4,708,1d 2h 59m,Sell
90400.34,0.90629,26.09.2011 02:59:58,tp 0.90629,-0.77,-67.85000000000582,0.0,0.0,0.90529,23.09.2011 23:15:00,7159,-0.037596653460094914,63.23,IS,0.58,0.0,Phase3-EA-SA2v2-USDCHF-M15-107,USDCHFMT4,1404,2d 3h 44m,Buy
90461.21,76743,26.09.2011 03:15:00,,0.0,-6.980000000010477,0.0,0.0,76.57,26.09.2011 01:15:00,7160,-0.003867717629356432,60.87,IS,0.27,0.0,Phase3-EA-S1v2-USDJPY-M15-0,USDJPYMT4,2196,2h 0m,Buy
90508.58,1.22015,26.09.2011 03:54:57,tp 1.22015,-2.27,-0.0,0.0,0.0,1.22125,23.09.2011 22:45:00,7161,-0.0,47.37,IS,0.41,0.0,Phase3-EA-SA2v2-EURCHF-M5-43,EURCHFMT4,3862,2d 5h 9m,Sell
90423.66,102877,26.09.2011 11:59:58,sl 102.877,0.0,-84.9200000000128,0.0,0.0,102157,26.09.2011 09:30:00,7162,-0.04704485515315262,-84.92,IS,0.09,0.0,Phase3-EA-TR1v1-EURJPY-M30-91,EURJPYMT4,1136,2h 29m,Sell
90473.45,1.21866,26.09.2011 21:44:58,tp 1.21866,0.0,-35.13000000000466,0.0,0.0,1.21756,26.09.2011 21:20:00,7163,-0.019461678774496248,49.79,IS,0.41,0.0,Phase3-EA-SA2v2-EURCHF-M5-43,EURCHFMT4,3864,24m 58s,Buy
90416.12,0.90246,27.09.2011 02:45:00,,-0.77,-92.45999999999185,0.0,0.0,0.90334,26.09.2011 22:30:00,7164,-0.05122194191544338,-57.33,IS,0.58,0.0,Phase3-EA-SA2v2-USDCHF-M15-107,USDCHFMT4,1406,4h 15m,Buy
90466.1,1.21853,27.09.2011 02:54:58,tp 1.21853,0.0,-42.47999999998137,0.0,0.0,1.21963,27.09.2011 00:15:00,7165,-0.023533507382297994,49.98,IS,0.41,0.0,Phase3-EA-SA2v2-EURCHF-M5-43,EURCHFMT4,3866,2h 39m,Sell
90413.82,102.95,27.09.2011 03:44:58,sl 102.950,-1.09,-94.75999999998021,0.0,0.0,103.18,26.09.2011 22:30:00,7166,-0.05249611957502519,-52.28,IS,0.17,0.0,Phase3-EA-T1v2-EURJPY-M15-322,EURJPYMT4,1038,5h 14m,Buy
90529.65,118514,27.09.2011 03:54:59,tp 118.514,-1.75,-0.0,0.0,0.0,118904,26.09.2011 23:10:00,7167,-0.0,115.83,IS,0.23,0.0,Phase3-EA-S4v1-GBPJPY-M5-194,GBPJPYMT4,1718,4h 44m,Sell
90478.44,103048,27.09.2011 10:59:58,sl 103.048,0.0,-51.20999999999185,0.0,0.0,103278,27.09.2011 05:15:00,7168,-0.028366531481112237,-51.21,IS,0.17,0.0,Phase3-EA-T1v2-EURJPY-M15-322,EURJPYMT4,1040,5h 44m,Buy
90386.62,103889,27.09.2011 14:59:58,sl 103.889,0.0,-143.02999999999884,0.0,0.0,103109,27.09.2011 12:00:00,7169,-0.07922798277180425,-91.82,IS,0.09,0.0,Phase3-EA-TR1v1-EURJPY-M30-91,EURJPYMT4,1138,2h 59m,Sell
90291.85,1.22318,27.09.2011 15:15:00,,0.0,-237.79999999998836,0.0,0.0,1.22067,27.09.2011 06:30:00,7170,-0.13172351466919024,-94.77,IS,0.34,0.0,Phase3-EA-S4v1-EURCHF-M15-221,EURCHFMT4,1804,8h 45m,Sell
90342.15,1.21993,27.09.2011 22:19:57,tp 1.21993,0.0,-187.5,0.0,0.0,1.22103,27.09.2011 22:05:00,7171,-0.10386105551082583,50.3,IS,0.41,0.0,Phase3-EA-SA2v2-EURCHF-M5-43,EURCHFMT4,3868,14m 57s,Sell
90327.07,0.89639,28.09.2011 03:00:00,,-3.43,-202.5799999999872,0.0,0.0,0.89621,27.09.2011 22:45:00,7172,-0.11221425400203609,-15.08,IS,0.58,0.0,Phase3-EA-SA2v2-USDCHF-M15-107,USDCHFMT4,1408,4h 15m,Sell
90444.04,119727,28.09.2011 03:09:58,tp 119.727,0.0,-85.60999999998603,0.0,0.0,120117,28.09.2011 02:15:00,7173,-0.04742157313216186,116.97,IS,0.23,0.0,Phase3-EA-S4v1-GBPJPY-M5-194,GBPJPYMT4,1720,54m 58s,Sell
90493.15,1.21977,28.09.2011 04:04:57,tp 1.21977,-1.1,-36.5,0.0,0.0,1.21867,27.09.2011 23:30:00,7174,-0.020218285472774093,49.11,IS,0.41,0.0,Phase3-EA-SA2v2-EURCHF-M5-43,EURCHFMT4,3870,4h 34m,Buy
90464.91,119649,28.09.2011 08:45:00,,0.0,-64.73999999999069,0.0,0.0,119743,28.09.2011 03:20:00,7175,-0.03586114524677279,-28.24,IS,0.23,0.0,Phase3-EA-S4v1-GBPJPY-M5-194,GBPJPYMT4,1722,5h 25m,Buy
90582.16,119195,29.09.2011 04:44:58,tp 119.195,0.0,-0.0,0.0,0.0,118805,29.09.2011 03:40:00,7176,-0.0,117.25,IS,0.23,0.0,Phase3-EA-S4v1-GBPJPY-M5-194,GBPJPYMT4,1724,1h 4m,Buy
90582.07,1.21948,29.09.2011 05:25:00,,-3.28,-0.08999999999650754,0.0,0.0,1.21941,28.09.2011 21:05:00,7177,-4.9838810210547564E-5,-0.09,IS,0.41,0.0,Phase3-EA-SA2v2-EURCHF-M5-43,EURCHFMT4,3872,8h 20m,Buy
90575.61,1.22022,29.09.2011 15:30:00,,0.0,-6.5499999999883585,0.0,0.0,1.22005,29.09.2011 06:45:00,7178,-0.003627157854346378,-6.46,IS,0.34,0.0,Phase3-EA-S4v1-EURCHF-M15-221,EURCHFMT4,1806,8h 45m,Sell
90497.0,119956,29.09.2011 19:59:57,sl 119.956,0.0,-85.15999999997439,0.0,0.0,120626,29.09.2011 17:00:00,7179,-0.0471585897521517,-78.61,IS,0.09,0.0,Phase3-EA-B1v1-GBPJPY-M30-1,GBPJPYMT4,710,2h 59m,Buy
90534.96,76.82,29.09.2011 23:45:00,,0.0,-47.19999999998254,0.0,0.0,76712,29.09.2011 18:45:00,7180,-0.02613768713364733,37.96,IS,0.27,0.0,Phase3-EA-S1v2-USDJPY-M15-0,USDJPYMT4,2198,5h 0m,Buy
90584.09,1.21981,30.09.2011 01:14:57,tp 1.21981,-1.1,-0.0,0.0,0.0,1.21871,29.09.2011 21:25:00,7181,-0.0,49.13,IS,0.41,0.0,Phase3-EA-SA2v2-EURCHF-M5-43,EURCHFMT4,3874,3h 49m,Buy
90459.98,119292,30.09.2011 07:25:00,,0.0,-124.10999999998603,0.0,0.0,119705,30.09.2011 02:00:00,7182,-0.0687269847526356,-124.11,IS,0.23,0.0,Phase3-EA-S4v1-GBPJPY-M5-194,GBPJPYMT4,1726,5h 25m,Buy
90483.6,1.21958,30.09.2011 10:35:00,,0.0,-100.48999999999069,0.0,0.0,1.21906,30.09.2011 02:15:00,7183,-0.05564720568683013,23.62,IS,0.41,0.0,Phase3-EA-SA2v2-EURCHF-M5-43,EURCHFMT4,3876,8h 20m,Buy
90631.94,102913,03.10.2011 01:00:00,tp 102.913,-2.46,-0.0,0.0,0.0,104203,27.09.2011 20:30:00,7184,-0.0,148.34,IS,0.09,0.0,Phase3-EA-TR1v1-EURJPY-M30-91,EURJPYMT4,1140,5d 4h 30m,Sell
90690.7,77239,03.10.2011 01:30:00,,-1.02,-0.0,0.0,0.0,77068,30.09.2011 23:15:00,7185,-0.0,58.76,IS,0.27,0.0,Phase3-EA-S1v2-USDJPY-M15-0,USDJPYMT4,2200,2d 2h 15m,Buy
90555.83,0.90871,03.10.2011 03:45:00,,-3.39,-134.86999999999534,0.0,0.0,0.90665,30.09.2011 23:30:00,7186,-0.07464136228372296,-134.87,IS,0.58,0.0,Phase3-EA-SA2v2-USDCHF-M15-107,USDCHFMT4,1410,2d 4h 15m,Sell
90484.84,1.21448,03.10.2011 04:40:00,,-1.08,-205.85999999998603,0.0,0.0,1.21603,30.09.2011 20:20:00,7187,-0.11392949388097202,-70.99,IS,0.41,0.0,Phase3-EA-SA2v2-EURCHF-M5-43,EURCHFMT4,3878,2d 8h 20m,Buy
90245.79,119.29,03.10.2011 07:24:57,sl 119.290,0.0,-444.9099999999744,0.0,0.0,120.09,03.10.2011 03:20:00,7188,-0.24622739299807533,-239.05,IS,0.23,0.0,Phase3-EA-S4v1-GBPJPY-M5-194,GBPJPYMT4,1728,4h 4m,Buy
90392.7,102316,03.10.2011 10:29:58,tp 102.316,-0.41,-297.9999999999709,0.0,0.0,103576,30.09.2011 07:30:00,7189,-0.16492271046598975,146.91,IS,0.09,0.0,Phase3-EA-TR1v1-EURJPY-M30-91,EURJPYMT4,1141,3d 2h 59m,Sell
90415.52,1.21413,03.10.2011 14:15:00,,0.0,-275.1799999999639,0.0,0.0,1.21352,03.10.2011 05:30:00,7190,-0.1522933941813072,22.82,IS,0.34,0.0,Phase3-EA-S4v1-EURCHF-M15-221,EURCHFMT4,1808,8h 45m,Buy
90791.96,101861,03.10.2011 17:44:58,tp 101.861,-0.77,-0.0,0.0,0.0,103561,30.09.2011 21:15:00,7191,-0.0,376.44,IS,0.17,0.0,Phase3-EA-T1v2-EURJPY-M15-322,EURJPYMT4,1042,2d 20h 29m,Sell
90700.24,101807,03.10.2011 17:59:58,sl 101.807,0.0,-91.72000000000116,0.0,0.0,102587,03.10.2011 13:00:00,7192,-0.05073234451355078,-91.72,IS,0.09,0.0,Phase3-EA-TR1v1-EURJPY-M30-91,EURJPYMT4,1144,4h 59m,Buy
90749.32,1.21441,03.10.2011 21:59:58,tp 1.21441,0.0,-42.64000000001397,0.0,0.0,1.21331,03.10.2011 21:25:00,7193,-0.023585119603777654,49.08,IS,0.41,0.0,Phase3-EA-SA2v2-EURCHF-M5-43,EURCHFMT4,3880,34m 58s,Buy
90798.41,1.21408,03.10.2011 22:54:57,tp 1.21408,0.0,-0.0,0.0,0.0,1.21518,03.10.2011 22:50:00,7194,-0.0,49.09,IS,0.41,0.0,Phase3-EA-SA2v2-EURCHF-M5-43,EURCHFMT4,3882,4m 57s,Sell
90788.14,0.92032,04.10.2011 03:45:00,,-3.34,-10.269999999989523,0.0,0.0,0.92021,03.10.2011 23:30:00,7195,-0.005680359688998092,-10.27,IS,0.58,0.0,Phase3-EA-SA2v2-USDCHF-M15-107,USDCHFMT4,1412,4h 15m,Sell
90737.1,101164,04.10.2011 12:59:58,sl 101.164,0.0,-61.30999999999767,0.0,0.0,100934,04.10.2011 10:45:00,7196,-0.03391069644915434,-51.04,IS,0.17,0.0,Phase3-EA-T1v2-EURJPY-M15-322,EURJPYMT4,1044,2h 14m,Sell
90652.38,102031,04.10.2011 18:29:58,sl 102.031,-0.41,-146.02999999999884,0.0,0.0,101311,03.10.2011 22:00:00,7197,-0.08076951561686768,-84.72,IS,0.09,0.0,Phase3-EA-TR1v1-EURJPY-M30-91,EURJPYMT4,1146,20h 29m,Sell
90701.24,1.22475,04.10.2011 22:39:58,tp 1.22475,0.0,-97.1700000000128,0.0,0.0,1.22365,04.10.2011 21:15:00,7198,-0.05374494167289002,48.86,IS,0.41,0.0,Phase3-EA-SA2v2-EURCHF-M5-43,EURCHFMT4,3884,1h 24m,Buy
90750.47,1.2246,04.10.2011 23:14:59,tp 1.22460,0.0,-47.94000000000233,0.0,0.0,1.2257,04.10.2011 23:05:00,7199,-0.026515719911476103,49.23,IS,0.41,0.0,Phase3-EA-SA2v2-EURCHF-M5-43,EURCHFMT4,3886,9m 59s,Sell
90813.66,0.91789,04.10.2011 23:29:57,tp 0.91789,0.0,-0.0,0.0,0.0,0.91689,04.10.2011 23:15:00,7200,-0.0,63.19,IS,0.58,0.0,Phase3-EA-SA2v2-USDCHF-M15-107,USDCHFMT4,1414,14m 57s,Buy
90862.93,1.22225,04.10.2011 23:54:58,tp 1.22225,0.0,-0.0,0.0,0.0,1.22115,04.10.2011 23:40:00,7201,-0.0,49.27,IS,0.41,0.0,Phase3-EA-SA2v2-EURCHF-M5-43,EURCHFMT4,3888,14m 58s,Buy
90912.0,1.22442,05.10.2011 02:29:57,tp 1.22442,0.0,-0.0,0.0,0.0,1.22552,05.10.2011 02:20:00,7202,-0.0,49.07,IS,0.41,0.0,Phase3-EA-SA2v2-EURCHF-M5-43,EURCHFMT4,3890,9m 57s,Sell
91027.03,118591,05.10.2011 03:09:58,tp 118.591,-1.74,-0.0,0.0,0.0,118981,04.10.2011 23:30:00,7203,-0.0,115.03,IS,0.23,0.0,Phase3-EA-S4v1-GBPJPY-M5-194,GBPJPYMT4,1730,3h 39m,Sell
90976.04,101888,05.10.2011 10:59:58,sl 101.888,0.0,-50.98999999999069,0.0,0.0,102118,05.10.2011 10:15:00,7204,-0.02816706433287369,-50.99,IS,0.17,0.0,Phase3-EA-T1v2-EURJPY-M15-322,EURJPYMT4,1046,44m 58s,Buy
90758.53,1.23514,05.10.2011 20:59:57,sl 1.23514,0.0,-268.5,0.0,0.0,1.23024,05.10.2011 20:15:00,7205,-0.1483203917116683,-217.51,IS,0.41,0.0,Phase3-EA-SA2v2-EURCHF-M5-43,EURCHFMT4,3892,44m 57s,Sell
90807.33,1.23328,05.10.2011 21:04:58,tp 1.23328,0.0,-219.70000000001164,0.0,0.0,1.23438,05.10.2011 21:00:00,7206,-0.12136309146761734,48.8,IS,0.41,0.0,Phase3-EA-SA2v2-EURCHF-M5-43,EURCHFMT4,3894,4m 58s,Sell
90856.23,1.23302,05.10.2011 21:34:57,tp 1.23302,0.0,-170.80000000001746,0.0,0.0,1.23412,05.10.2011 21:25:00,7207,-0.09435055085421057,48.9,IS,0.41,0.0,Phase3-EA-SA2v2-EURCHF-M5-43,EURCHFMT4,3896,9m 57s,Sell
90861.26,76777,06.10.2011 02:30:00,,-3.06,-165.77000000001863,0.0,0.0,76754,05.10.2011 21:30:00,7208,-0.0915719602757766,5.03,IS,0.27,0.0,Phase3-EA-S1v2-USDJPY-M15-0,USDJPYMT4,2202,5h 0m,Buy
90924.12,0.92269,06.10.2011 02:44:57,tp 0.92269,0.0,-102.9100000000326,0.0,0.0,0.92369,06.10.2011 01:30:00,7209,-0.05684786410075464,62.86,IS,0.58,0.0,Phase3-EA-SA2v2-USDCHF-M15-107,USDCHFMT4,1416,1h 14m,Sell
90882.12,1.54543,06.10.2011 13:59:58,sl 1.54543,0.0,-144.9100000000326,0.0,0.0,1.54843,06.10.2011 11:30:00,7210,-0.08004881922883683,-42.0,IS,0.14,0.0,Phase3-EA-B1v1-GBPUSD-M30-14,GBPUSDMT4,466,2h 29m,Buy
91095.9,117115,06.10.2011 14:29:58,tp 117.115,-3.4,-0.0,0.0,0.0,118965,03.10.2011 15:30:00,7211,-0.0,213.78,IS,0.09,0.0,Phase3-EA-B1v1-GBPJPY-M30-1,GBPJPYMT4,712,2d 22h 59m,Sell
91144.86,1.23724,06.10.2011 21:04:59,tp 1.23724,0.0,-0.0,0.0,0.0,1.23834,06.10.2011 20:10:00,7212,-0.0,48.96,IS,0.41,0.0,Phase3-EA-SA2v2-EURCHF-M5-43,EURCHFMT4,3898,54m 59s,Sell
91102.33,1.54233,07.10.2011 04:29:57,sl 1.54233,-0.53,-42.529999999998836,0.0,0.0,1.54533,06.10.2011 23:00:00,7213,-0.023478447028526635,-42.53,IS,0.14,0.0,Phase3-EA-B1v1-GBPUSD-M30-14,GBPUSDMT4,468,5h 29m,Buy
91102.99,118332,07.10.2011 04:30:00,,-1.74,-41.86999999999534,0.0,0.0,118.34,06.10.2011 23:05:00,7214,-0.023114097744752593,0.66,IS,0.23,0.0,Phase3-EA-S4v1-GBPJPY-M5-194,GBPJPYMT4,1732,5h 25m,Sell
91152.07,1.23554,07.10.2011 07:19:58,tp 1.23554,0.0,-0.0,0.0,0.0,1.23444,07.10.2011 02:55:00,7215,-0.0,49.08,IS,0.41,0.0,Phase3-EA-SA2v2-EURCHF-M5-43,EURCHFMT4,3900,4h 24m,Buy
91223.32,1.23671,07.10.2011 12:00:00,,0.0,-0.0,0.0,0.0,1.23478,07.10.2011 03:15:00,7216,-0.0,71.25,IS,0.34,0.0,Phase3-EA-S4v1-EURCHF-M15-221,EURCHFMT4,1810,8h 45m,Buy
91131.27,103135,07.10.2011 15:59:58,sl 103.135,-0.41,-92.04999999998836,0.0,0.0,102355,06.10.2011 03:30:00,7217,-0.050793683726789766,-92.05,IS,0.09,0.0,Phase3-EA-TR1v1-EURJPY-M30-91,EURJPYMT4,1148,1d 12h 29m,Sell
91193.94,0.92553,07.10.2011 22:44:57,tp 0.92553,0.0,-29.379999999975553,0.0,0.0,0.92653,07.10.2011 22:00:00,7218,-0.016212041584921566,62.67,IS,0.58,0.0,Phase3-EA-SA2v2-USDCHF-M15-107,USDCHFMT4,1418,44m 57s,Sell
91242.66,1.23955,07.10.2011 22:44:57,tp 1.23955,0.0,-0.0,0.0,0.0,1.24065,07.10.2011 22:05:00,7219,-0.0,48.72,IS,0.41,0.0,Phase3-EA-SA2v2-EURCHF-M5-43,EURCHFMT4,3902,39m 57s,Sell
91140.46,119796,10.10.2011 08:40:00,,0.0,-102.20000000001164,0.0,0.0,119455,10.10.2011 03:15:00,7220,-0.0563884904359776,-102.2,IS,0.23,0.0,Phase3-EA-S4v1-GBPJPY-M5-194,GBPJPYMT4,1734,5h 25m,Sell
91288.71,1.23819,10.10.2011 10:44:58,tp 1.23819,0.0,-0.0,0.0,0.0,1.24219,10.10.2011 04:15:00,7221,-0.0,148.25,IS,0.34,0.0,Phase3-EA-S4v1-EURCHF-M15-221,EURCHFMT4,1812,6h 29m,Sell
91436.47,104678,10.10.2011 17:29:58,tp 104.678,0.0,-0.0,0.0,0.0,103418,10.10.2011 08:00:00,7222,-0.0,147.76,IS,0.09,0.0,Phase3-EA-TR1v1-EURJPY-M30-91,EURJPYMT4,1150,9h 29m,Buy
91429.48,1.23281,11.10.2011 04:35:00,,-1.09,-6.989999999990687,0.0,0.0,1.23294,10.10.2011 20:15:00,7223,-0.003852588181411747,-6.99,IS,0.41,0.0,Phase3-EA-SA2v2-EURCHF-M5-43,EURCHFMT4,3904,8h 20m,Buy
91493.67,0.90351,11.10.2011 04:44:58,tp 0.90351,0.0,-0.0,0.0,0.0,0.90451,11.10.2011 01:30:00,7224,-0.0,64.19,IS,0.58,0.0,Phase3-EA-SA2v2-USDCHF-M15-107,USDCHFMT4,1420,3h 14m,Sell
91451.67,1.56623,11.10.2011 10:59:57,sl 1.56623,0.0,-42.0,0.0,0.0,1.56323,11.10.2011 05:30:00,7225,-0.023141302944615035,-42.0,IS,0.14,0.0,Phase3-EA-B1v1-GBPUSD-M30-14,GBPUSDMT4,470,5h 29m,Sell
91400.69,104393,11.10.2011 11:59:57,sl 104.393,0.0,-92.98000000001048,0.0,0.0,104623,11.10.2011 08:45:00,7226,-0.05123043685215591,-50.98,IS,0.17,0.0,Phase3-EA-T1v2-EURJPY-M15-322,EURJPYMT4,1048,3h 14m,Buy
91550.49,1236,11.10.2011 12:44:57,tp 1.23600,0.0,-0.0,0.0,0.0,1232,11.10.2011 06:00:00,7227,-0.0,149.8,IS,0.34,0.0,Phase3-EA-S4v1-EURCHF-M15-221,EURCHFMT4,1814,6h 44m,Buy
91465.34,104039,11.10.2011 15:59:58,sl 104.039,-0.58,-85.14999999999418,0.0,0.0,104759,10.10.2011 18:00:00,7228,-0.04690155339156286,-85.15,IS,0.09,0.0,Phase3-EA-TR1v1-EURJPY-M30-91,EURJPYMT4,1152,21h 59m,Buy
91386.23,119335,11.10.2011 23:59:58,sl 119.335,-0.42,-164.2599999999802,0.0,0.0,120005,10.10.2011 13:30:00,7229,-0.09047620857425383,-79.11,IS,0.09,0.0,Phase3-EA-B1v1-GBPJPY-M30-1,GBPJPYMT4,714,1d 10h 29m,Buy
91435.76,1.23795,12.10.2011 04:04:59,tp 1.23795,0.0,-114.72999999998137,0.0,0.0,1.23905,12.10.2011 00:55:00,7230,-0.06319454163961832,49.53,IS,0.41,0.0,Phase3-EA-SA2v2-EURCHF-M5-43,EURCHFMT4,3906,3h 9m,Sell
91488.23,119486,12.10.2011 09:05:00,,0.0,-62.25999999998021,0.0,0.0,119311,12.10.2011 03:40:00,7231,-0.03429349047748649,52.47,IS,0.23,0.0,Phase3-EA-S4v1-GBPJPY-M5-194,GBPJPYMT4,1736,5h 25m,Buy
91340.74,1.23449,12.10.2011 12:14:58,sl 1.23449,0.0,-209.7499999999709,0.0,0.0,1.23839,12.10.2011 04:45:00,7232,-0.11553259922348345,-147.49,IS,0.34,0.0,Phase3-EA-S4v1-EURCHF-M15-221,EURCHFMT4,1816,7h 29m,Buy
91488.15,106517,12.10.2011 15:59:58,tp 106.517,0.0,-62.339999999967404,0.0,0.0,105257,12.10.2011 12:00:00,7233,-0.03433755535441808,147.41,IS,0.09,0.0,Phase3-EA-TR1v1-EURJPY-M30-91,EURJPYMT4,1154,3h 59m,Buy
91506.66,77.29,12.10.2011 22:15:00,,0.0,-43.82999999995809,0.0,0.0,77343,12.10.2011 21:45:00,7234,-0.02414204445273488,18.51,IS,0.27,0.0,Phase3-EA-S1v2-USDJPY-M15-0,USDJPYMT4,2204,30m 0s,Sell
91427.13,121277,13.10.2011 02:59:58,sl 121.277,-1.26,-123.35999999995693,0.0,0.0,121947,12.10.2011 19:30:00,7235,-0.06794804023936077,-79.53,IS,0.09,0.0,Phase3-EA-B1v1-GBPJPY-M30-1,GBPJPYMT4,716,7h 29m,Buy
91454.87,121342,13.10.2011 08:20:00,,0.0,-95.61999999996624,0.0,0.0,121249,13.10.2011 02:55:00,7236,-0.05266854416089211,27.74,IS,0.23,0.0,Phase3-EA-S4v1-GBPJPY-M5-194,GBPJPYMT4,1738,5h 25m,Buy
91378.97,77082,13.10.2011 09:15:00,,-3.04,-171.51999999996042,0.0,0.0,77.29,12.10.2011 22:15:00,7237,-0.09447509615642459,-75.9,IS,0.27,0.0,Phase3-EA-S1v2-USDJPY-M15-0,USDJPYMT4,2206,11h 0m,Buy
91429.47,1.23342,13.10.2011 10:39:57,tp 1.23342,0.0,-121.01999999996042,0.0,0.0,1.23452,13.10.2011 02:50:00,7238,-0.06665914258890744,50.5,IS,0.41,0.0,Phase3-EA-SA2v2-EURCHF-M5-43,EURCHFMT4,3908,7h 49m,Sell
91378.83,106.24,13.10.2011 11:14:58,sl 106.240,0.0,-171.6599999999744,0.0,0.0,106.47,13.10.2011 10:45:00,7239,-0.09455220969107492,-50.64,IS,0.17,0.0,Phase3-EA-T1v2-EURJPY-M15-322,EURJPYMT4,1050,29m 58s,Buy
91293.14,105706,13.10.2011 11:59:58,sl 105.706,-1.71,-257.3499999999767,0.0,0.0,106426,12.10.2011 16:00:00,7240,-0.14175120100197808,-85.69,IS,0.09,0.0,Phase3-EA-TR1v1-EURJPY-M30-91,EURJPYMT4,1156,19h 59m,Buy
91368.81,1.23342,13.10.2011 12:45:00,,0.0,-181.6799999999639,0.0,0.0,1.23542,13.10.2011 04:00:00,7241,-0.10007133552763393,75.67,IS,0.34,0.0,Phase3-EA-S4v1-EURCHF-M15-221,EURCHFMT4,1818,8h 45m,Sell
91370.57,76828,13.10.2011 20:15:00,,0.0,-179.9199999999546,0.0,0.0,76833,13.10.2011 18:15:00,7242,-0.0991019082349787,1.76,IS,0.27,0.0,Phase3-EA-S1v2-USDJPY-M15-0,USDJPYMT4,2208,2h 0m,Sell
91418.51,1.23554,14.10.2011 00:54:58,tp 1.23554,-2.28,-131.97999999995227,0.0,0.0,1.23664,13.10.2011 20:50:00,7243,-0.07269603072949678,47.94,IS,0.41,0.0,Phase3-EA-SA2v2-EURCHF-M5-43,EURCHFMT4,3910,4h 4m,Sell
91451.41,121106,14.10.2011 07:20:00,,0.0,-99.07999999995809,0.0,0.0,120996,14.10.2011 01:55:00,7244,-0.054574350088483846,32.9,IS,0.23,0.0,Phase3-EA-S4v1-GBPJPY-M5-194,GBPJPYMT4,1740,5h 25m,Buy
91713.88,1.58118,14.10.2011 16:29:58,tp 1.58118,-2.13,-0.0,0.0,0.0,1.56228,12.10.2011 11:00:00,7245,-0.0,262.47,IS,0.14,0.0,Phase3-EA-B1v1-GBPUSD-M30-14,GBPUSDMT4,472,2d 5h 29m,Buy
91671.88,1.57931,14.10.2011 18:29:57,sl 1.57931,0.0,-42.0,0.0,0.0,1.58231,14.10.2011 16:30:00,7246,-0.023113259152245217,-42.0,IS,0.14,0.0,Phase3-EA-B1v1-GBPUSD-M30-14,GBPUSDMT4,474,1h 59m,Buy
91720.22,1.2376,17.10.2011 01:00:00,tp 1.23760,-2.3,-0.0,0.0,0.0,1.2387,14.10.2011 21:45:00,7247,-0.0,48.34,IS,0.41,0.0,Phase3-EA-SA2v2-EURCHF-M5-43,EURCHFMT4,3912,2d 3h 15m,Sell
91770.8,1.23834,17.10.2011 01:29:58,tp 1.23834,0.0,-0.0,0.0,0.0,1.23724,17.10.2011 01:00:00,7248,-0.0,50.58,IS,0.41,0.0,Phase3-EA-SA2v2-EURCHF-M5-43,EURCHFMT4,3914,29m 58s,Buy
91835.81,0.8922,17.10.2011 02:44:58,tp 0.89220,0.0,-0.0,0.0,0.0,0.8912,17.10.2011 01:15:00,7249,-0.0,65.01,IS,0.58,0.0,Phase3-EA-SA2v2-USDCHF-M15-107,USDCHFMT4,1422,1h 29m,Buy
91843.19,77241,17.10.2011 03:30:00,,-1.01,-0.0,0.0,0.0,77217,14.10.2011 23:15:00,7250,-0.0,7.38,IS,0.27,0.0,Phase3-EA-S1v2-USDJPY-M15-0,USDJPYMT4,2210,2d 4h 15m,Buy
91901.79,1.23912,17.10.2011 10:00:00,,0.0,-0.0,0.0,0.0,1.23758,17.10.2011 01:15:00,7251,-0.0,58.6,IS,0.34,0.0,Phase3-EA-S4v1-EURCHF-M15-221,EURCHFMT4,1820,8h 45m,Buy
91851.24,106869,17.10.2011 13:14:57,sl 106.869,0.0,-50.54999999998836,0.0,0.0,107099,17.10.2011 10:45:00,7252,-0.02778972103572385,-50.55,IS,0.17,0.0,Phase3-EA-T1v2-EURJPY-M15-322,EURJPYMT4,1052,2h 29m,Buy
91766.79,106414,17.10.2011 14:29:57,sl 106.414,-0.57,-135.0,0.0,0.0,107134,14.10.2011 18:30:00,7253,-0.07421587220224696,-84.45,IS,0.09,0.0,Phase3-EA-TR1v1-EURJPY-M30-91,EURJPYMT4,1158,2d 19h 59m,Buy
91687.67,121003,17.10.2011 17:29:58,sl 121.003,-0.42,-214.11999999999534,0.0,0.0,121673,14.10.2011 15:00:00,7254,-0.1177118707847761,-79.12,IS,0.09,0.0,Phase3-EA-B1v1-GBPJPY-M30-1,GBPJPYMT4,718,3d 2h 29m,Buy
91691.36,76799,18.10.2011 04:15:00,,-1.58,-210.42999999999302,0.0,0.0,76814,17.10.2011 22:30:00,7255,-0.11568330361124673,3.69,IS,0.27,0.0,Phase3-EA-S1v2-USDJPY-M15-0,USDJPYMT4,2212,5h 45m,Sell
91628.9,1.23355,18.10.2011 07:35:00,,-1.09,-272.88999999998487,0.0,0.0,1.23489,17.10.2011 23:15:00,7256,-0.1500205138168152,-62.46,IS,0.41,0.0,Phase3-EA-SA2v2-EURCHF-M5-43,EURCHFMT4,3916,8h 20m,Buy
91566.64,121379,18.10.2011 09:10:00,,0.0,-335.1499999999942,0.0,0.0,121171,18.10.2011 03:45:00,7257,-0.1842477745820936,-62.26,IS,0.23,0.0,Phase3-EA-S4v1-GBPJPY-M5-194,GBPJPYMT4,1742,5h 25m,Sell
91524.64,1.57571,18.10.2011 10:29:58,sl 1.57571,0.0,-377.1499999999942,0.0,0.0,1.57871,18.10.2011 06:00:00,7258,-0.20733715704501487,-42.0,IS,0.14,0.0,Phase3-EA-B1v1-GBPUSD-M30-14,GBPUSDMT4,476,4h 29m,Buy
91900.01,104867,18.10.2011 12:14:58,tp 104.867,-0.77,-1.7799999999988358,0.0,0.0,106567,17.10.2011 14:00:00,7259,-9.785500186660237E-4,375.37,IS,0.17,0.0,Phase3-EA-T1v2-EURJPY-M15-322,EURJPYMT4,1054,22h 14m,Sell
91898.5,1.23397,18.10.2011 13:15:00,,0.0,-3.290000000008149,0.0,0.0,1.23401,18.10.2011 04:30:00,7260,-0.0018086682929333133,-1.51,IS,0.34,0.0,Phase3-EA-S4v1-EURCHF-M15-221,EURCHFMT4,1822,8h 45m,Buy
91948.79,1.23529,18.10.2011 22:09:57,tp 1.23529,0.0,-0.0,0.0,0.0,1.23639,18.10.2011 20:40:00,7261,-0.0,50.29,IS,0.41,0.0,Phase3-EA-SA2v2-EURCHF-M5-43,EURCHFMT4,3918,1h 29m,Sell
91999.01,1.23648,19.10.2011 03:59:57,tp 1.23648,0.0,-0.0,0.0,0.0,1.23538,19.10.2011 01:05:00,7262,-0.0,50.22,IS,0.41,0.0,Phase3-EA-SA2v2-EURCHF-M5-43,EURCHFMT4,3920,2h 54m,Buy
92115.95,120884,19.10.2011 08:34:57,tp 120.884,0.0,-0.0,0.0,0.0,120494,19.10.2011 03:20:00,7263,-0.0,116.94,IS,0.23,0.0,Phase3-EA-S4v1-GBPJPY-M5-194,GBPJPYMT4,1744,5h 14m,Buy
91967.88,1.24026,19.10.2011 09:14:58,sl 1.24026,0.0,-148.07000000000698,0.0,0.0,1.23636,19.10.2011 05:15:00,7264,-0.08130534420516522,-148.07,IS,0.34,0.0,Phase3-EA-S4v1-EURCHF-M15-221,EURCHFMT4,1824,3h 59m,Sell
91882.64,106403,19.10.2011 12:29:57,sl 106.403,-0.82,-233.30999999999767,0.0,0.0,105683,17.10.2011 18:30:00,7265,-0.12811068992034857,-85.24,IS,0.09,0.0,Phase3-EA-TR1v1-EURJPY-M30-91,EURJPYMT4,1160,1d 17h 59m,Sell
91946.4,105929,19.10.2011 18:30:00,,0.0,-169.54999999998836,0.0,0.0,105641,19.10.2011 04:45:00,7266,-0.09310002775703496,63.76,IS,0.17,0.0,Phase3-EA-T1v2-EURJPY-M15-322,EURJPYMT4,1056,13h 45m,Buy
91867.91,120975,19.10.2011 21:29:59,sl 120.975,0.0,-248.03999999997905,0.0,0.0,121645,19.10.2011 16:00:00,7267,-0.1361989435851052,-78.49,IS,0.09,0.0,Phase3-EA-B1v1-GBPJPY-M30-1,GBPJPYMT4,720,5h 29m,Buy
91783.56,105622,19.10.2011 21:29:59,sl 105.622,0.0,-332.38999999998487,0.0,0.0,106342,19.10.2011 13:00:00,7268,-0.18251558965592196,-84.35,IS,0.09,0.0,Phase3-EA-TR1v1-EURJPY-M30-91,EURJPYMT4,1162,8h 29m,Buy
91830.28,1.24224,20.10.2011 00:04:58,tp 1.24224,-3.27,-285.6699999999837,0.0,0.0,1.24114,19.10.2011 21:30:00,7269,-0.15686160382985836,46.72,IS,0.41,0.0,Phase3-EA-SA2v2-EURCHF-M5-43,EURCHFMT4,3922,2h 34m,Buy
91880.23,1.2418,20.10.2011 04:14:58,tp 1.24180,0.0,-235.71999999997206,0.0,0.0,1.2429,20.10.2011 01:20:00,7270,-0.1294340226652149,49.95,IS,0.41,0.0,Phase3-EA-SA2v2-EURCHF-M5-43,EURCHFMT4,3924,2h 54m,Sell
91997.07,120819,20.10.2011 05:39:59,tp 120.819,0.0,-118.87999999997555,0.0,0.0,121209,20.10.2011 02:45:00,7271,-0.06527709407109879,116.84,IS,0.23,0.0,Phase3-EA-S4v1-GBPJPY-M5-194,GBPJPYMT4,1746,2h 54m,Sell
91953.47,1.57214,20.10.2011 08:29:57,sl 1.57214,-1.6,-162.47999999998137,0.0,0.0,1.57514,19.10.2011 12:00:00,7272,-0.08921788563823264,-43.6,IS,0.14,0.0,Phase3-EA-B1v1-GBPUSD-M30-14,GBPUSDMT4,478,20h 29m,Buy
92051.47,1.24014,20.10.2011 10:15:00,,0.0,-64.47999999998137,0.0,0.0,1.24275,20.10.2011 01:30:00,7273,-0.03540601468459034,98.0,IS,0.34,0.0,Phase3-EA-S4v1-EURCHF-M15-221,EURCHFMT4,1826,8h 45m,Sell
92000.54,105817,20.10.2011 12:29:58,sl 105.817,0.0,-115.40999999997439,0.0,0.0,105587,20.10.2011 04:30:00,7274,-0.06337171455876,-50.93,IS,0.17,0.0,Phase3-EA-T1v2-EURJPY-M15-322,EURJPYMT4,1058,7h 59m,Sell
91949.73,105518,20.10.2011 20:14:58,sl 105.518,0.0,-166.21999999997206,0.0,0.0,105288,20.10.2011 18:15:00,7275,-0.09127152234605021,-50.81,IS,0.17,0.0,Phase3-EA-T1v2-EURJPY-M15-322,EURJPYMT4,1060,1h 59m,Sell
91927.53,0.89337,21.10.2011 03:15:00,,-0.78,-188.4199999999837,0.0,0.0,0.8937,20.10.2011 23:00:00,7276,-0.10346155841922863,-22.2,IS,0.58,0.0,Phase3-EA-SA2v2-USDCHF-M15-107,USDCHFMT4,1424,4h 15m,Buy
91975.76,1.23037,21.10.2011 04:29:57,tp 1.23037,-2.29,-140.18999999997322,0.0,0.0,1.23147,20.10.2011 21:45:00,7277,-0.07697843049989463,48.23,IS,0.41,0.0,Phase3-EA-SA2v2-EURCHF-M5-43,EURCHFMT4,3926,6h 44m,Sell
91923.73,105701,21.10.2011 05:14:57,sl 105.701,-1.09,-192.21999999997206,0.0,0.0,105931,20.10.2011 22:15:00,7278,-0.10554814117048593,-52.03,IS,0.17,0.0,Phase3-EA-T1v2-EURJPY-M15-322,EURJPYMT4,1062,6h 59m,Buy
91948.9,121322,21.10.2011 05:40:00,,0.0,-167.04999999995925,0.0,0.0,121238,21.10.2011 00:15:00,7279,-0.09172727594697709,25.17,IS,0.23,0.0,Phase3-EA-S4v1-GBPJPY-M5-194,GBPJPYMT4,1748,5h 25m,Buy
92101.84,1.22786,21.10.2011 12:44:59,tp 1.22786,0.0,-14.109999999956926,0.0,0.0,1.22386,21.10.2011 05:45:00,7280,-0.007747811215852806,152.94,IS,0.34,0.0,Phase3-EA-S4v1-EURCHF-M15-221,EURCHFMT4,1828,6h 59m,Buy
92050.52,105571,21.10.2011 16:29:58,sl 105.571,0.0,-65.42999999996391,0.0,0.0,105341,21.10.2011 16:15:00,7281,-0.035927660372396676,-51.32,IS,0.17,0.0,Phase3-EA-T1v2-EURJPY-M15-322,EURJPYMT4,1064,14m 58s,Sell
92101.52,1.22589,21.10.2011 21:59:59,tp 1.22589,0.0,-14.429999999963911,0.0,0.0,1.22479,21.10.2011 20:10:00,7282,-0.007923523447542005,51.0,IS,0.41,0.0,Phase3-EA-SA2v2-EURCHF-M5-43,EURCHFMT4,3928,1h 49m,Buy
92167.25,0.88234,21.10.2011 23:29:57,tp 0.88234,0.0,-0.0,0.0,0.0,0.88134,21.10.2011 23:15:00,7283,-0.0,65.73,IS,0.58,0.0,Phase3-EA-SA2v2-USDCHF-M15-107,USDCHFMT4,1426,14m 57s,Buy
92188.91,76171,24.10.2011 01:00:00,,-1.03,-0.0,0.0,0.0,76107,21.10.2011 21:45:00,7284,-0.0,21.66,IS,0.27,0.0,Phase3-EA-S1v2-USDJPY-M15-0,USDJPYMT4,2214,2d 3h 15m,Buy
92239.86,1.22472,24.10.2011 03:19:58,tp 1.22472,0.0,-0.0,0.0,0.0,1.22362,24.10.2011 01:30:00,7285,-0.0,50.95,IS,0.41,0.0,Phase3-EA-SA2v2-EURCHF-M5-43,EURCHFMT4,3930,1h 49m,Buy
92179.35,121687,24.10.2011 04:55:00,,-1.75,-60.51000000000931,0.0,0.0,121492,21.10.2011 23:30:00,7286,-0.033203493461863465,-60.51,IS,0.23,0.0,Phase3-EA-S4v1-GBPJPY-M5-194,GBPJPYMT4,1750,2d 5h 25m,Sell
92029.56,1.22945,24.10.2011 07:59:57,sl 1.22945,0.0,-210.30000000001746,0.0,0.0,1.22555,24.10.2011 06:30:00,7287,-0.1153973669646239,-149.79,IS,0.34,0.0,Phase3-EA-S4v1-EURCHF-M15-221,EURCHFMT4,1830,1h 29m,Sell
92080.84,1.22689,24.10.2011 21:04:58,tp 1.22689,0.0,-159.02000000001863,0.0,0.0,1.22579,24.10.2011 20:00:00,7288,-0.08725862717410897,51.28,IS,0.41,0.0,Phase3-EA-SA2v2-EURCHF-M5-43,EURCHFMT4,3932,1h 4m,Buy
92132.04,1.22647,24.10.2011 23:34:57,tp 1.22647,0.0,-107.82000000000698,0.0,0.0,1.22757,24.10.2011 22:15:00,7289,-0.05916378557358783,51.2,IS,0.41,0.0,Phase3-EA-SA2v2-EURCHF-M5-43,EURCHFMT4,3934,1h 19m,Sell
92079.6,105815,25.10.2011 01:29:58,sl 105.815,-1.09,-160.2600000000093,0.0,0.0,106045,24.10.2011 18:30:00,7290,-0.08793904911911633,-52.44,IS,0.17,0.0,Phase3-EA-T1v2-EURJPY-M15-322,EURJPYMT4,1066,6h 59m,Buy
91983.19,1.2243,25.10.2011 08:35:00,,0.0,-256.6700000000128,0.0,0.0,1.22637,25.10.2011 00:15:00,7291,-0.14084185534383753,-96.41,IS,0.41,0.0,Phase3-EA-SA2v2-EURCHF-M5-43,EURCHFMT4,3936,8h 20m,Buy
91930.97,1.2237,25.10.2011 12:00:00,,0.0,-308.89000000001397,0.0,0.0,1.22505,25.10.2011 03:15:00,7292,-0.16949639886686318,-52.22,IS,0.34,0.0,Phase3-EA-S4v1-EURCHF-M15-221,EURCHFMT4,1832,8h 45m,Buy
91996.96,0.87889,25.10.2011 22:59:57,tp 0.87889,0.0,-242.90000000002328,0.0,0.0,0.87789,25.10.2011 22:00:00,7293,-0.13328587938995484,65.99,IS,0.58,0.0,Phase3-EA-SA2v2-USDCHF-M15-107,USDCHFMT4,1428,59m 57s,Buy
91919.26,1.2219,26.10.2011 05:15:00,,-1.12,-320.6000000000349,0.0,0.0,1.22354,25.10.2011 20:55:00,7294,-0.1759219964282424,-77.7,IS,0.41,0.0,Phase3-EA-SA2v2-EURCHF-M5-43,EURCHFMT4,3938,8h 20m,Buy
91894.93,76008,26.10.2011 07:00:00,,-1.6,-344.9300000000221,0.0,0.0,75944,25.10.2011 21:45:00,7295,-0.18927253346223,-24.33,IS,0.27,0.0,Phase3-EA-S1v2-USDJPY-M15-0,USDJPYMT4,2216,9h 15m,Sell
91952.64,1.22238,26.10.2011 10:45:00,,0.0,-287.22000000003027,0.0,0.0,1.22089,26.10.2011 02:00:00,7296,-0.15760547665040425,57.71,IS,0.34,0.0,Phase3-EA-S4v1-EURCHF-M15-221,EURCHFMT4,1834,8h 45m,Buy
91996.79,1.22351,27.10.2011 03:04:57,tp 1.22351,-6.98,-243.0700000000361,0.0,0.0,1.22461,26.10.2011 20:15:00,7297,-0.13337916304371358,44.15,IS,0.41,0.0,Phase3-EA-SA2v2-EURCHF-M5-43,EURCHFMT4,3940,6h 49m,Sell
91967.4,121713,27.10.2011 04:50:00,,-5.25,-272.46000000005006,0.0,0.0,121633,26.10.2011 23:25:00,7298,-0.14950626059526673,-29.39,IS,0.23,0.0,Phase3-EA-S4v1-GBPJPY-M5-194,GBPJPYMT4,1752,5h 25m,Sell
91923.34,1.59864,27.10.2011 04:59:58,sl 1.59864,-2.06,-316.52000000004773,0.0,0.0,1.59564,26.10.2011 18:30:00,7299,-0.17368318873820843,-44.06,IS,0.14,0.0,Phase3-EA-B1v1-GBPUSD-M30-14,GBPUSDMT4,480,10h 29m,Sell
92078.4,1.22746,27.10.2011 06:44:58,tp 1.22746,0.0,-161.46000000005006,0.0,0.0,1.22346,27.10.2011 03:30:00,7300,-0.08859752196915076,155.06,IS,0.34,0.0,Phase3-EA-S4v1-EURCHF-M15-221,EURCHFMT4,1836,3h 14m,Buy
92036.4,1.59906,27.10.2011 11:29:58,sl 1.59906,0.0,-203.46000000005006,0.0,0.0,1.60206,27.10.2011 06:00:00,7301,-0.11164407171957301,-42.0,IS,0.14,0.0,Phase3-EA-B1v1-GBPUSD-M30-14,GBPUSDMT4,482,5h 29m,Buy
92185.81,106636,27.10.2011 17:29:58,tp 106.636,-4.05,-54.050000000046566,0.0,0.0,105346,20.10.2011 12:00:00,7302,-0.02965871461931896,149.41,IS,0.09,0.0,Phase3-EA-TR1v1-EURJPY-M30-91,EURJPYMT4,1164,7d 5h 29m,Buy
92238.41,1.21955,27.10.2011 20:29:57,tp 1.21955,0.0,-1.4500000000407454,0.0,0.0,1.21845,27.10.2011 20:25:00,7303,-7.956546937869361E-4,52.6,IS,0.41,0.0,Phase3-EA-SA2v2-EURCHF-M5-43,EURCHFMT4,3942,4m 57s,Buy
92290.87,1.22065,28.10.2011 03:49:58,tp 1.22065,0.0,-0.0,0.0,0.0,1.21955,28.10.2011 01:40:00,7304,-0.0,52.46,IS,0.41,0.0,Phase3-EA-SA2v2-EURCHF-M5-43,EURCHFMT4,3944,2h 9m,Buy
92409.8,1.22263,28.10.2011 11:15:00,,0.0,-0.0,0.0,0.0,1.21961,28.10.2011 02:30:00,7305,-0.0,118.93,IS,0.34,0.0,Phase3-EA-S4v1-EURCHF-M15-221,EURCHFMT4,1838,8h 45m,Buy
92323.88,107302,28.10.2011 14:29:58,sl 107.302,-0.58,-85.9200000000128,0.0,0.0,108022,27.10.2011 22:00:00,7306,-0.047102732418988776,-85.92,IS,0.09,0.0,Phase3-EA-TR1v1-EURJPY-M30-91,EURJPYMT4,1166,16h 29m,Buy
92272.14,107411,31.10.2011 05:29:58,sl 107.411,0.0,-137.6600000000035,0.0,0.0,107181,31.10.2011 02:45:00,7307,-0.07546743650834721,-51.74,IS,0.17,0.0,Phase3-EA-T1v2-EURJPY-M15-322,EURJPYMT4,1068,2h 44m,Sell
92202.81,1.22013,31.10.2011 06:00:00,,-1.14,-206.9899999999907,0.0,0.0,1.22157,28.10.2011 21:40:00,7308,-0.11347526284223225,-69.33,IS,0.41,0.0,Phase3-EA-SA2v2-EURCHF-M5-43,EURCHFMT4,3946,2d 8h 20m,Buy
92272.6,1.22165,31.10.2011 11:30:00,,0.0,-137.19999999998254,0.0,0.0,1.21986,31.10.2011 02:45:00,7309,-0.07521525707499388,69.79,IS,0.34,0.0,Phase3-EA-S4v1-EURCHF-M15-221,EURCHFMT4,1840,8h 45m,Buy
92324.26,1.21669,31.10.2011 20:14:57,tp 1.21669,0.0,-85.53999999997905,0.0,0.0,1.21559,31.10.2011 20:05:00,7310,-0.04689441027838352,51.66,IS,0.41,0.0,Phase3-EA-SA2v2-EURCHF-M5-43,EURCHFMT4,3948,9m 57s,Buy
92345.02,78042,31.10.2011 22:45:00,,0.0,-64.77999999996973,0.0,0.0,77982,31.10.2011 18:30:00,7311,-0.03551344280842891,20.76,IS,0.27,0.0,Phase3-EA-S1v2-USDJPY-M15-0,USDJPYMT4,2218,4h 15m,Buy
92407.71,0.87633,01.11.2011 00:59:58,tp 0.87633,-3.5,-2.0899999999674037,0.0,0.0,0.87733,31.10.2011 23:45:00,7312,-0.0011457717732092235,62.69,IS,0.58,0.0,Phase3-EA-SA2v2-USDCHF-M15-107,USDCHFMT4,1430,1h 14m,Sell
92522.5,125619,01.11.2011 06:04:58,tp 125.619,0.0,-0.0,0.0,0.0,126009,01.11.2011 03:45:00,7313,-0.0,114.79,IS,0.23,0.0,Phase3-EA-S4v1-GBPJPY-M5-194,GBPJPYMT4,1754,2h 19m,Sell
92891.9,106505,01.11.2011 16:59:57,tp 106.505,0.0,-0.0,0.0,0.0,108205,01.11.2011 05:30:00,7314,-0.0,369.4,IS,0.17,0.0,Phase3-EA-T1v2-EURJPY-M15-322,EURJPYMT4,1070,11h 29m,Sell
92942.64,1.2173,01.11.2011 20:54:57,tp 1.21730,0.0,-0.0,0.0,0.0,1.2162,01.11.2011 20:30:00,7315,-0.0,50.74,IS,0.41,0.0,Phase3-EA-SA2v2-EURCHF-M5-43,EURCHFMT4,3950,24m 57s,Buy
92993.67,1.2165,01.11.2011 21:39:58,tp 1.21650,0.0,-0.0,0.0,0.0,1.2154,01.11.2011 21:25:00,7316,-0.0,51.03,IS,0.41,0.0,Phase3-EA-SA2v2-EURCHF-M5-43,EURCHFMT4,3952,14m 58s,Buy
92910.88,107729,01.11.2011 21:59:57,sl 107.729,0.0,-82.79000000000815,0.0,0.0,107009,01.11.2011 13:00:00,7317,-0.04524200208674318,-82.79,IS,0.09,0.0,Phase3-EA-TR1v1-EURJPY-M30-91,EURJPYMT4,1168,8h 59m,Sell
92976.4,0.88521,01.11.2011 22:44:58,tp 0.88521,0.0,-17.270000000018626,0.0,0.0,0.88421,01.11.2011 22:30:00,7318,-0.009437484914105815,65.52,IS,0.58,0.0,Phase3-EA-SA2v2-USDCHF-M15-107,USDCHFMT4,1432,14m 58s,Buy
92926.47,107165,02.11.2011 04:29:58,sl 107.165,0.0,-67.20000000001164,0.0,0.0,106935,02.11.2011 03:30:00,7319,-0.03672258171553773,-49.93,IS,0.17,0.0,Phase3-EA-T1v2-EURJPY-M15-322,EURJPYMT4,1072,59m 58s,Sell
92880.94,1.21455,02.11.2011 06:45:00,,-1.11,-112.73000000001048,0.0,0.0,1.21551,01.11.2011 22:25:00,7320,-0.06160322376178923,-45.53,IS,0.41,0.0,Phase3-EA-SA2v2-EURCHF-M5-43,EURCHFMT4,3954,8h 20m,Buy
92900.66,124809,02.11.2011 08:50:00,,0.0,-93.01000000000931,0.0,0.0,124742,02.11.2011 03:25:00,7321,-0.05082689472264754,19.72,IS,0.23,0.0,Phase3-EA-S4v1-GBPJPY-M5-194,GBPJPYMT4,1756,5h 25m,Buy
92968.0,1.21622,02.11.2011 12:45:00,,0.0,-25.670000000012806,0.0,0.0,1.21447,02.11.2011 04:00:00,7322,-0.014027807628544057,67.34,IS,0.34,0.0,Phase3-EA-S4v1-EURCHF-M15-221,EURCHFMT4,1842,8h 45m,Buy
92926.0,1.59518,02.11.2011 20:59:58,sl 1.59518,0.0,-67.6700000000128,0.0,0.0,1.59818,02.11.2011 11:30:00,7323,-0.036979421200751164,-42.0,IS,0.14,0.0,Phase3-EA-B1v1-GBPUSD-M30-14,GBPUSDMT4,484,9h 29m,Buy
92977.0,1.21605,02.11.2011 21:44:58,tp 1.21605,0.0,-16.670000000012806,0.0,0.0,1.21495,02.11.2011 21:10:00,7324,-0.009109604720213962,51.0,IS,0.41,0.0,Phase3-EA-SA2v2-EURCHF-M5-43,EURCHFMT4,3956,34m 58s,Buy
92892.4,106907,03.11.2011 04:29:58,sl 106.907,-1.69,-101.27000000001863,0.0,0.0,107627,02.11.2011 17:00:00,7325,-0.05534071205852003,-84.6,IS,0.09,0.0,Phase3-EA-TR1v1-EURJPY-M30-91,EURJPYMT4,1170,11h 29m,Buy
92824.37,1.21318,03.11.2011 08:40:00,,0.0,-169.30000000001746,0.0,0.0,1.21465,03.11.2011 00:20:00,7326,-0.09251686137559677,-68.03,IS,0.41,0.0,Phase3-EA-SA2v2-EURCHF-M5-43,EURCHFMT4,3958,8h 20m,Buy
92781.63,124069,03.11.2011 09:05:00,,0.0,-212.04000000000815,0.0,0.0,124214,03.11.2011 03:40:00,7327,-0.11587286052026148,-42.74,IS,0.23,0.0,Phase3-EA-S4v1-GBPJPY-M5-194,GBPJPYMT4,1758,5h 25m,Buy
92736.78,1.21336,03.11.2011 11:45:00,,0.0,-256.89000000001397,0.0,0.0,1.21453,03.11.2011 03:00:00,7328,-0.14038190501344297,-44.85,IS,0.34,0.0,Phase3-EA-S4v1-EURCHF-M15-221,EURCHFMT4,1844,8h 45m,Buy
92802.89,0.87728,04.11.2011 03:44:57,tp 0.87728,0.0,-190.78000000002794,0.0,0.0,0.87828,04.11.2011 02:00:00,7329,-0.10425497231681698,66.11,IS,0.58,0.0,Phase3-EA-SA2v2-USDCHF-M15-107,USDCHFMT4,1434,1h 44m,Sell
92883.47,124945,04.11.2011 04:40:00,,-1.71,-110.20000000004075,0.0,0.0,125224,03.11.2011 23:15:00,7330,-0.0602206622775752,80.58,IS,0.23,0.0,Phase3-EA-S4v1-GBPJPY-M5-194,GBPJPYMT4,1760,5h 25m,Sell
92879.09,1.21393,04.11.2011 07:45:00,,-1.12,-114.5800000000454,0.0,0.0,1214,03.11.2011 23:25:00,7331,-0.06261418769296506,-4.38,IS,0.41,0.0,Phase3-EA-SA2v2-EURCHF-M5-43,EURCHFMT4,3960,8h 20m,Buy
92920.09,1.21451,04.11.2011 10:00:00,,0.0,-73.5800000000454,0.0,0.0,1.21345,04.11.2011 01:15:00,7332,-0.040209041110572406,41.0,IS,0.34,0.0,Phase3-EA-S4v1-EURCHF-M15-221,EURCHFMT4,1846,8h 45m,Buy
92869.98,107606,04.11.2011 17:14:58,sl 107.606,0.0,-123.69000000003143,0.0,0.0,107836,04.11.2011 10:00:00,7333,-0.06759250197016711,-50.11,IS,0.17,0.0,Phase3-EA-T1v2-EURJPY-M15-322,EURJPYMT4,1074,7h 14m,Buy
92935.48,0.88545,04.11.2011 22:14:58,tp 0.88545,0.0,-58.19000000003143,0.0,0.0,0.88445,04.11.2011 22:00:00,7334,-0.03179891413732031,65.5,IS,0.58,0.0,Phase3-EA-SA2v2-USDCHF-M15-107,USDCHFMT4,1436,14m 58s,Buy
92884.74,107867,07.11.2011 02:00:00,sl 107.867,-0.76,-108.93000000002212,0.0,0.0,107637,04.11.2011 23:15:00,7335,-0.059526649200500666,-50.74,IS,0.17,0.0,Phase3-EA-T1v2-EURJPY-M15-322,EURJPYMT4,1076,2d 2h 45m,Sell
92631.63,0.89369,07.11.2011 06:44:57,sl 0.89369,0.0,-362.04000000000815,0.0,0.0,0.88979,07.11.2011 02:45:00,7336,-0.1978429089924297,-253.11,IS,0.58,0.0,Phase3-EA-SA2v2-USDCHF-M15-107,USDCHFMT4,1438,3h 59m,Sell
92483.25,1.23047,07.11.2011 06:44:58,sl 1.23047,0.0,-510.4200000000128,0.0,0.0,1.22657,07.11.2011 04:00:00,7337,-0.2789276809411011,-148.38,IS,0.34,0.0,Phase3-EA-S4v1-EURCHF-M15-221,EURCHFMT4,1848,2h 44m,Sell
92441.25,1.60207,07.11.2011 16:59:58,sl 1.60207,0.0,-552.4200000000128,0.0,0.0,1.60507,07.11.2011 14:30:00,7338,-0.3018792945133082,-42.0,IS,0.14,0.0,Phase3-EA-B1v1-GBPUSD-M30-14,GBPUSDMT4,486,2h 29m,Buy
92391.13,107752,07.11.2011 17:59:57,sl 107.752,0.0,-602.5400000000081,0.0,0.0,107522,07.11.2011 05:00:00,7339,-0.32926822004280615,-50.12,IS,0.17,0.0,Phase3-EA-T1v2-EURJPY-M15-322,EURJPYMT4,1078,12h 59m,Sell
92455.47,0.90149,08.11.2011 02:59:58,tp 0.90149,0.0,-538.2000000000116,0.0,0.0,0.90049,08.11.2011 01:00:00,7340,-0.294108533918146,64.34,IS,0.58,0.0,Phase3-EA-SA2v2-USDCHF-M15-107,USDCHFMT4,1440,1h 59m,Buy
92301.12,1.24208,08.11.2011 04:20:00,,-2.28,-692.5500000000175,0.0,0.0,1.23873,07.11.2011 20:00:00,7341,-0.3784557137960103,-154.35,IS,0.41,0.0,Phase3-EA-SA2v2-EURCHF-M5-43,EURCHFMT4,3962,8h 20m,Sell
92317.7,1.2418,08.11.2011 13:00:00,,0.0,-675.9700000000303,0.0,0.0,1.24224,08.11.2011 04:15:00,7342,-0.36939529110489366,16.58,IS,0.34,0.0,Phase3-EA-S4v1-EURCHF-M15-221,EURCHFMT4,1850,8h 45m,Sell
92266.36,1.2378,09.11.2011 05:00:00,,-2.29,-727.3100000000268,0.0,0.0,1.23673,08.11.2011 20:40:00,7343,-0.39745090636196584,-51.34,IS,0.41,0.0,Phase3-EA-SA2v2-EURCHF-M5-43,EURCHFMT4,3964,8h 20m,Sell
92231.5,124938,09.11.2011 05:15:00,,-1.07,-762.1700000000128,0.0,0.0,125052,08.11.2011 23:50:00,7344,-0.4165007456268901,-34.86,IS,0.23,0.0,Phase3-EA-S4v1-GBPJPY-M5-194,GBPJPYMT4,1762,5h 25m,Buy
92206.59,1.23585,09.11.2011 12:45:00,,0.0,-787.0800000000163,0.0,0.0,1.23651,09.11.2011 04:00:00,7345,-0.4301132383431701,-24.91,IS,0.34,0.0,Phase3-EA-S4v1-EURCHF-M15-221,EURCHFMT4,1852,8h 45m,Buy
92113.88,106.33,09.11.2011 13:29:58,sl 106.330,-2.27,-879.7900000000081,0.0,0.0,107.11,03.11.2011 13:00:00,7346,-0.48077619296886376,-92.71,IS,0.09,0.0,Phase3-EA-TR1v1-EURJPY-M30-91,EURJPYMT4,1172,6d 0h 29m,Buy
92259.33,105877,09.11.2011 14:59:58,tp 105.877,-0.81,-734.3399999999965,0.0,0.0,107137,07.11.2011 12:00:00,7347,-0.4012925693003449,145.45,IS,0.09,0.0,Phase3-EA-TR1v1-EURJPY-M30-91,EURJPYMT4,1173,2d 2h 59m,Sell
92631.18,105648,09.11.2011 16:44:57,tp 105.648,0.0,-362.4899999999907,0.0,0.0,107348,09.11.2011 06:00:00,7348,-0.19808881913783669,371.85,IS,0.17,0.0,Phase3-EA-T1v2-EURJPY-M15-322,EURJPYMT4,1080,10h 44m,Sell
92680.81,1.23221,09.11.2011 22:04:57,tp 1.23221,0.0,-312.85999999998603,0.0,0.0,1.23331,09.11.2011 20:45:00,7349,-0.17096766243334274,49.63,IS,0.41,0.0,Phase3-EA-SA2v2-EURCHF-M5-43,EURCHFMT4,3966,1h 19m,Sell
92727.12,1.23267,10.11.2011 04:44:57,tp 1.23267,-3.25,-266.54999999998836,0.0,0.0,1.23157,09.11.2011 23:55:00,7350,-0.1456607761350366,46.31,IS,0.41,0.0,Phase3-EA-SA2v2-EURCHF-M5-43,EURCHFMT4,3968,4h 49m,Buy
92876.44,1.23509,10.11.2011 06:29:58,tp 1.23509,0.0,-117.22999999998137,0.0,0.0,1.23109,10.11.2011 02:15:00,7351,-0.06406232521593837,149.32,IS,0.34,0.0,Phase3-EA-S4v1-EURCHF-M15-221,EURCHFMT4,1854,4h 14m,Buy
92909.59,123722,10.11.2011 07:40:00,,0.0,-84.0799999999872,0.0,0.0,123.61,10.11.2011 02:15:00,7352,-0.04594694450359237,33.15,IS,0.23,0.0,Phase3-EA-S4v1-GBPJPY-M5-194,GBPJPYMT4,1764,5h 25m,Buy
92959.42,1.23202,10.11.2011 20:59:57,tp 1.23202,0.0,-34.25,0.0,0.0,1.23312,10.11.2011 20:45:00,7353,-0.018716494401145083,49.83,IS,0.41,0.0,Phase3-EA-SA2v2-EURCHF-M5-43,EURCHFMT4,3970,14m 57s,Sell
92988.34,105707,10.11.2011 21:30:00,,0.0,-5.329999999987194,0.0,0.0,105575,10.11.2011 20:45:00,7354,-0.002912669055704047,28.92,IS,0.17,0.0,Phase3-EA-T1v2-EURJPY-M15-322,EURJPYMT4,1082,45m 0s,Buy
93038.06,1.23229,10.11.2011 23:09:57,tp 1.23229,0.0,-0.0,0.0,0.0,1.23339,10.11.2011 21:30:00,7355,-0.0,49.72,IS,0.41,0.0,Phase3-EA-SA2v2-EURCHF-M5-43,EURCHFMT4,3972,1h 39m,Sell
93087.85,1.23352,11.11.2011 03:14:58,tp 1.23352,0.0,-0.0,0.0,0.0,1.23242,11.11.2011 00:45:00,7356,-0.0,49.79,IS,0.41,0.0,Phase3-EA-SA2v2-EURCHF-M5-43,EURCHFMT4,3974,2h 29m,Buy
93132.33,123547,11.11.2011 07:45:00,,0.0,-0.0,0.0,0.0,123697,11.11.2011 02:20:00,7357,-0.0,44.48,IS,0.23,0.0,Phase3-EA-S4v1-GBPJPY-M5-194,GBPJPYMT4,1766,5h 25m,Sell
93081.89,105476,11.11.2011 09:59:58,sl 105.476,0.0,-50.44000000000233,0.0,0.0,105706,11.11.2011 06:45:00,7358,-0.027542924834736814,-50.44,IS,0.17,0.0,Phase3-EA-T1v2-EURJPY-M15-322,EURJPYMT4,1084,3h 14m,Buy
92977.19,1.2359,11.11.2011 12:15:00,,0.0,-155.14000000001397,0.0,0.0,1.23311,11.11.2011 03:30:00,7359,-0.08471469783626599,-104.7,IS,0.34,0.0,Phase3-EA-S4v1-EURCHF-M15-221,EURCHFMT4,1856,8h 45m,Sell
92926.61,105837,11.11.2011 17:44:57,sl 105.837,0.0,-205.72000000000116,0.0,0.0,105607,11.11.2011 13:15:00,7360,-0.11233407012295456,-50.58,IS,0.17,0.0,Phase3-EA-T1v2-EURJPY-M15-322,EURJPYMT4,1086,4h 29m,Sell
92884.73,1.23953,14.11.2011 04:40:00,,-2.28,-247.60000000000582,0.0,0.0,1.23866,11.11.2011 20:20:00,7361,-0.13520277932356622,-41.88,IS,0.41,0.0,Phase3-EA-SA2v2-EURCHF-M5-43,EURCHFMT4,3976,2d 8h 20m,Sell
92728.17,1.23975,15.11.2011 08:15:00,,-2.26,-404.1600000000035,0.0,0.0,1.23632,14.11.2011 23:55:00,7362,-0.22069287274398916,-156.56,IS,0.41,0.0,Phase3-EA-SA2v2-EURCHF-M5-43,EURCHFMT4,3978,8h 20m,Sell
92872.85,104552,15.11.2011 09:59:58,tp 104.552,-2.44,-259.4800000000105,0.0,0.0,105812,09.11.2011 15:30:00,7363,-0.14168989167560403,144.68,IS,0.09,0.0,Phase3-EA-TR1v1-EURJPY-M30-91,EURJPYMT4,1176,5d 18h 29m,Sell
92794.96,1.23951,15.11.2011 10:15:00,,0.0,-337.37000000002445,0.0,0.0,1.23742,15.11.2011 01:30:00,7364,-0.1842219776267923,-77.89,IS,0.34,0.0,Phase3-EA-S4v1-EURCHF-M15-221,EURCHFMT4,1858,8h 45m,Sell
93006.88,121944,15.11.2011 12:29:58,tp 121.944,-4.04,-125.45000000001164,0.0,0.0,123794,09.11.2011 17:30:00,7365,-0.06850237748845944,211.92,IS,0.09,0.0,Phase3-EA-B1v1-GBPJPY-M30-1,GBPJPYMT4,722,5d 18h 59m,Sell
93069.44,0.91599,16.11.2011 01:59:58,tp 0.91599,-0.76,-62.89000000001397,0.0,0.0,0.91499,15.11.2011 23:45:00,7366,-0.034341287526901326,62.56,IS,0.58,0.0,Phase3-EA-SA2v2-USDCHF-M15-107,USDCHFMT4,1442,2h 14m,Buy
93117.52,1.24051,16.11.2011 04:09:58,tp 1.24051,-1.07,-14.810000000026776,0.0,0.0,1.23941,15.11.2011 22:05:00,7367,-0.008087048310927257,48.08,IS,0.41,0.0,Phase3-EA-SA2v2-EURCHF-M5-43,EURCHFMT4,3980,6h 4m,Buy
93025.81,103466,16.11.2011 08:59:58,sl 103.466,-0.57,-106.52000000001863,0.0,0.0,104246,15.11.2011 18:30:00,7368,-0.058165589877013146,-91.71,IS,0.09,0.0,Phase3-EA-TR1v1-EURJPY-M30-91,EURJPYMT4,1178,14h 29m,Buy
93065.18,1.2387,16.11.2011 12:15:00,,0.0,-67.15000000002328,0.0,0.0,1.23976,16.11.2011 03:30:00,7369,-0.03666747427940391,39.37,IS,0.34,0.0,Phase3-EA-S4v1-EURCHF-M15-221,EURCHFMT4,1860,8h 45m,Sell
92980.92,104226,16.11.2011 13:29:57,sl 104.226,0.0,-151.4100000000326,0.0,0.0,103506,16.11.2011 08:30:00,7370,-0.08267791929477016,-84.26,IS,0.09,0.0,Phase3-EA-TR1v1-EURJPY-M30-91,EURJPYMT4,1179,4h 59m,Sell
93029.95,1.23832,17.11.2011 00:34:57,tp 1.23832,0.0,-102.38000000003376,0.0,0.0,1.23722,17.11.2011 00:15:00,7371,-0.055904929511918215,49.03,IS,0.41,0.0,Phase3-EA-SA2v2-EURCHF-M5-43,EURCHFMT4,3982,19m 57s,Buy
93078.98,1.23815,17.11.2011 02:14:58,tp 1.23815,0.0,-53.350000000034925,0.0,0.0,1.23705,17.11.2011 01:35:00,7372,-0.02913193972906628,49.03,IS,0.41,0.0,Phase3-EA-SA2v2-EURCHF-M5-43,EURCHFMT4,3984,39m 58s,Buy
92833.85,0.92276,17.11.2011 02:44:58,sl 0.92276,0.0,-298.4800000000396,0.0,0.0,0.91886,17.11.2011 00:15:00,7373,-0.16298596757876596,-245.13,IS,0.58,0.0,Phase3-EA-SA2v2-USDCHF-M15-107,USDCHFMT4,1444,2h 29m,Sell
92732.08,120.98,17.11.2011 04:50:00,,-3.23,-400.2500000000291,0.0,0.0,121.31,16.11.2011 23:25:00,7374,-0.21855780462140567,-101.77,IS,0.23,0.0,Phase3-EA-S4v1-GBPJPY-M5-194,GBPJPYMT4,1768,5h 25m,Buy
92879.91,1.24144,17.11.2011 08:29:57,tp 1.24144,0.0,-252.4200000000419,0.0,0.0,1.23744,17.11.2011 01:45:00,7375,-0.13783475588392347,147.83,IS,0.34,0.0,Phase3-EA-S4v1-EURCHF-M15-221,EURCHFMT4,1862,6h 44m,Buy
92928.93,1.23936,17.11.2011 23:14:58,tp 1.23936,0.0,-203.4000000000524,0.0,0.0,1.23826,17.11.2011 20:55:00,7376,-0.11106722663335948,49.02,IS,0.41,0.0,Phase3-EA-SA2v2-EURCHF-M5-43,EURCHFMT4,3986,2h 19m,Buy
92991.94,0.92053,18.11.2011 05:14:58,tp 0.92053,0.0,-140.39000000004307,0.0,0.0,0.92153,18.11.2011 01:15:00,7377,-0.0766604127190664,63.01,IS,0.58,0.0,Phase3-EA-SA2v2-USDCHF-M15-107,USDCHFMT4,1446,3h 59m,Sell
93038.8,1.23877,18.11.2011 07:19:57,tp 1.23877,-2.22,-93.53000000005704,0.0,0.0,1.23987,17.11.2011 23:35:00,7378,-0.051072358441601635,46.86,IS,0.41,0.0,Phase3-EA-SA2v2-EURCHF-M5-43,EURCHFMT4,3988,7h 44m,Sell
93031.32,121172,18.11.2011 08:45:00,,0.0,-101.01000000006752,0.0,0.0,121197,18.11.2011 03:20:00,7379,-0.05515683658918511,-7.48,IS,0.23,0.0,Phase3-EA-S4v1-GBPJPY-M5-194,GBPJPYMT4,1770,5h 25m,Buy
93025.78,1.2406,18.11.2011 10:00:00,,0.0,-106.55000000007567,0.0,0.0,1.24045,18.11.2011 01:15:00,7380,-0.05818197147389287,-5.54,IS,0.34,0.0,Phase3-EA-S4v1-EURCHF-M15-221,EURCHFMT4,1864,8h 45m,Sell
93018.63,1.23984,21.11.2011 06:05:00,,-2.23,-113.70000000006985,0.0,0.0,1.23973,18.11.2011 21:45:00,7381,-0.06208625205613313,-7.15,IS,0.41,0.0,Phase3-EA-SA2v2-EURCHF-M5-43,EURCHFMT4,3990,2d 8h 20m,Sell
92925.78,120899,21.11.2011 08:05:00,,0.0,-206.55000000007567,0.0,0.0,121209,21.11.2011 02:40:00,7382,-0.11278729430247246,-92.85,IS,0.23,0.0,Phase3-EA-S4v1-GBPJPY-M5-194,GBPJPYMT4,1772,5h 25m,Buy
93043.71,1.23749,21.11.2011 12:30:00,,0.0,-88.62000000008265,0.0,0.0,1.24068,21.11.2011 03:45:00,7383,-0.04839123709073236,117.93,IS,0.34,0.0,Phase3-EA-S4v1-EURCHF-M15-221,EURCHFMT4,1866,8h 45m,Sell
93020.9,76836,21.11.2011 12:45:00,,-1.02,-111.43000000008033,0.0,0.0,76898,18.11.2011 23:45:00,7384,-0.060846711227930096,-22.81,IS,0.27,0.0,Phase3-EA-S1v2-USDJPY-M15-0,USDJPYMT4,2220,2d 13h 0m,Buy
93069.01,1.23827,22.11.2011 04:14:58,tp 1.23827,-1.07,-63.320000000094296,0.0,0.0,1.23717,21.11.2011 22:50:00,7385,-0.034576090415108084,48.11,IS,0.41,0.0,Phase3-EA-SA2v2-EURCHF-M5-43,EURCHFMT4,3992,5h 24m,Buy
93030.49,120515,22.11.2011 09:15:00,,0.0,-101.84000000008382,0.0,0.0,120386,22.11.2011 03:50:00,7386,-0.05561006076867122,-38.52,IS,0.23,0.0,Phase3-EA-S4v1-GBPJPY-M5-194,GBPJPYMT4,1774,5h 25m,Sell
93122.92,1.23513,22.11.2011 13:30:00,,0.0,-9.410000000090804,0.0,0.0,1.23761,22.11.2011 04:45:00,7387,-0.005138360878218923,92.43,IS,0.34,0.0,Phase3-EA-S4v1-EURCHF-M15-221,EURCHFMT4,1868,8h 45m,Sell
93183.06,0.91343,23.11.2011 01:59:57,tp 0.91343,-3.36,-0.0,0.0,0.0,0.91443,22.11.2011 23:15:00,7388,-0.0,60.14,IS,0.58,0.0,Phase3-EA-SA2v2-USDCHF-M15-107,USDCHFMT4,1448,2h 44m,Sell
93230.17,1.23416,23.11.2011 04:29:57,tp 1.23416,-2.24,-0.0,0.0,0.0,1.23526,22.11.2011 21:45:00,7389,-0.0,47.11,IS,0.41,0.0,Phase3-EA-SA2v2-EURCHF-M5-43,EURCHFMT4,3994,6h 44m,Sell
93085.06,1.22968,23.11.2011 09:29:57,sl 1.22968,0.0,-145.10999999998603,0.0,0.0,1.23358,23.11.2011 06:15:00,7390,-0.0791954731035755,-145.11,IS,0.34,0.0,Phase3-EA-S4v1-EURCHF-M15-221,EURCHFMT4,1870,3h 14m,Buy
93451.9,103215,23.11.2011 19:44:58,tp 103.215,-6.17,-0.0,0.0,0.0,104915,15.11.2011 07:30:00,7391,-0.0,366.84,IS,0.17,0.0,Phase3-EA-T1v2-EURJPY-M15-322,EURJPYMT4,1088,8d 12h 14m,Sell
93514.96,0.91971,23.11.2011 23:14:58,tp 0.91971,0.0,-0.0,0.0,0.0,0.92071,23.11.2011 22:30:00,7392,-0.0,63.06,IS,0.58,0.0,Phase3-EA-SA2v2-USDCHF-M15-107,USDCHFMT4,1450,44m 58s,Sell
93530.9,1.22797,24.11.2011 15:00:00,,0.0,-0.0,0.0,0.0,1.2284,24.11.2011 06:15:00,7393,-0.0,15.94,IS,0.34,0.0,Phase3-EA-S4v1-EURCHF-M15-221,EURCHFMT4,1872,8h 45m,Sell
93436.35,102894,24.11.2011 16:59:58,sl 102.894,-3.42,-94.54999999998836,0.0,0.0,103674,18.11.2011 12:00:00,7394,-0.051517210453383123,-94.55,IS,0.09,0.0,Phase3-EA-TR1v1-EURJPY-M30-91,EURJPYMT4,1182,6d 4h 59m,Buy
93645.39,119446,24.11.2011 17:29:58,tp 119.446,-6.77,-0.0,0.0,0.0,121296,16.11.2011 10:30:00,7395,-0.0,209.04,IS,0.09,0.0,Phase3-EA-B1v1-GBPJPY-M30-1,GBPJPYMT4,724,8d 6h 59m,Sell
93613.35,1.22737,25.11.2011 06:30:00,,-2.23,-32.04000000000815,0.0,0.0,1.2267,24.11.2011 22:10:00,7396,-0.017446667188328584,-32.04,IS,0.41,0.0,Phase3-EA-SA2v2-EURCHF-M5-43,EURCHFMT4,3996,8h 20m,Sell
93487.48,0.92157,25.11.2011 07:00:00,,0.0,-157.9100000000035,0.0,0.0,0.91957,25.11.2011 02:45:00,7397,-0.08598636753147089,-125.87,IS,0.58,0.0,Phase3-EA-SA2v2-USDCHF-M15-107,USDCHFMT4,1452,4h 15m,Sell
93536.04,1.23117,25.11.2011 20:39:57,tp 1.23117,0.0,-109.35000000000582,0.0,0.0,1.23007,25.11.2011 20:10:00,7398,-0.05954410290397463,48.56,IS,0.41,0.0,Phase3-EA-SA2v2-EURCHF-M5-43,EURCHFMT4,3998,29m 57s,Buy
93584.59,1.23117,25.11.2011 20:59:58,tp 1.23117,0.0,-60.80000000001746,0.0,0.0,1.23007,25.11.2011 20:45:00,7399,-0.03310728355338367,48.55,IS,0.41,0.0,Phase3-EA-SA2v2-EURCHF-M5-43,EURCHFMT4,4000,14m 58s,Buy
93647.06,0.92838,28.11.2011 03:29:58,tp 0.92838,0.0,-0.0,0.0,0.0,0.92738,28.11.2011 02:30:00,7400,-0.0,62.47,IS,0.58,0.0,Phase3-EA-SA2v2-USDCHF-M15-107,USDCHFMT4,1454,59m 58s,Buy
93557.33,120345,28.11.2011 05:00:00,,-1.72,-89.73000000001048,0.0,0.0,120048,25.11.2011 23:35:00,7401,-0.04886002531160055,-89.73,IS,0.23,0.0,Phase3-EA-S4v1-GBPJPY-M5-194,GBPJPYMT4,1776,2d 5h 25m,Sell
93485.32,1.23341,28.11.2011 07:00:00,,-2.2,-161.7400000000198,0.0,0.0,1.23183,25.11.2011 22:40:00,7402,-0.08807110769974721,-72.01,IS,0.41,0.0,Phase3-EA-SA2v2-EURCHF-M5-43,EURCHFMT4,4002,2d 8h 20m,Sell
93481.28,1.23483,28.11.2011 11:45:00,,0.0,-165.78000000002794,0.0,0.0,1.23472,28.11.2011 03:00:00,7403,-0.09027097956266085,-4.04,IS,0.34,0.0,Phase3-EA-S4v1-EURCHF-M15-221,EURCHFMT4,1874,8h 45m,Sell
93630.1,104175,28.11.2011 16:59:58,tp 104.175,-0.57,-16.960000000020955,0.0,0.0,102885,25.11.2011 00:30:00,7404,-0.00923510564232333,148.82,IS,0.09,0.0,Phase3-EA-TR1v1-EURJPY-M30-91,EURJPYMT4,1184,3d 16h 29m,Buy
93657.12,78053,29.11.2011 02:00:00,,-1.0,-0.0,0.0,0.0,77972,28.11.2011 21:00:00,7405,-0.0,27.02,IS,0.27,0.0,Phase3-EA-S1v2-USDJPY-M15-0,USDJPYMT4,2222,5h 0m,Buy
93686.25,1.22952,29.11.2011 04:25:00,,-1.07,-0.0,0.0,0.0,1.22884,28.11.2011 20:05:00,7406,-0.0,29.13,IS,0.41,0.0,Phase3-EA-SA2v2-EURCHF-M5-43,EURCHFMT4,4004,8h 20m,Buy
93763.71,121134,29.11.2011 04:30:00,,-1.06,-0.0,0.0,0.0,120867,28.11.2011 23:05:00,7407,-0.0,77.46,IS,0.23,0.0,Phase3-EA-S4v1-GBPJPY-M5-194,GBPJPYMT4,1778,5h 25m,Buy
93713.56,103922,29.11.2011 10:59:58,sl 103.922,0.0,-50.14999999999418,0.0,0.0,104152,29.11.2011 04:15:00,7408,-0.027290480802762453,-50.15,IS,0.17,0.0,Phase3-EA-T1v2-EURJPY-M15-322,EURJPYMT4,1090,6h 44m,Buy
93730.64,1.22831,29.11.2011 13:45:00,,0.0,-33.070000000006985,0.0,0.0,1.22877,29.11.2011 05:00:00,7409,-0.017995936194369882,17.08,IS,0.34,0.0,Phase3-EA-S4v1-EURCHF-M15-221,EURCHFMT4,1876,8h 45m,Sell
93680.28,104105,29.11.2011 14:14:58,sl 104.105,0.0,-83.42999999999302,0.0,0.0,104335,29.11.2011 14:00:00,7410,-0.04540069418493609,-50.36,IS,0.17,0.0,Phase3-EA-T1v2-EURJPY-M15-322,EURJPYMT4,1092,14m 58s,Buy
93743.37,0.91925,30.11.2011 04:14:58,tp 0.91925,0.0,-20.339999999996508,0.0,0.0,0.92025,30.11.2011 01:30:00,7411,-0.011068561904848602,63.09,IS,0.58,0.0,Phase3-EA-SA2v2-USDCHF-M15-107,USDCHFMT4,1456,2h 44m,Sell
93741.41,1.22677,30.11.2011 04:20:00,,-1.07,-22.29999999998836,0.0,0.0,1.22679,29.11.2011 20:00:00,7412,-0.01213514899105395,-1.96,IS,0.41,0.0,Phase3-EA-SA2v2-EURCHF-M5-43,EURCHFMT4,4006,8h 20m,Buy
93773.84,1.22592,30.11.2011 12:45:00,,0.0,-0.0,0.0,0.0,1.2268,30.11.2011 04:00:00,7413,-0.0,32.43,IS,0.34,0.0,Phase3-EA-S4v1-EURCHF-M15-221,EURCHFMT4,1878,8h 45m,Sell
93723.71,104052,30.11.2011 16:14:58,sl 104.052,0.0,-50.13000000000466,0.0,0.0,103822,30.11.2011 07:15:00,7414,-0.027278093552381852,-50.13,IS,0.17,0.0,Phase3-EA-T1v2-EURJPY-M15-322,EURJPYMT4,1094,8h 59m,Sell
93861.73,77377,30.11.2011 16:14:58,tp 77.377,-1.56,-0.0,0.0,0.0,77777,29.11.2011 17:15:00,7415,-0.0,138.02,IS,0.27,0.0,Phase3-EA-S1v2-USDJPY-M15-0,USDJPYMT4,2224,22h 59m,Sell
93770.18,104603,30.11.2011 17:29:57,sl 104.603,-0.8,-91.54999999998836,0.0,0.0,103823,28.11.2011 20:30:00,7416,-0.04979285248756669,-91.55,IS,0.09,0.0,Phase3-EA-TR1v1-EURJPY-M30-91,EURJPYMT4,1186,1d 20h 59m,Sell
93819.59,1.22608,30.11.2011 22:29:58,tp 1.22608,0.0,-42.139999999984866,0.0,0.0,1.22718,30.11.2011 21:40:00,7417,-0.02291939709257863,49.41,IS,0.41,0.0,Phase3-EA-SA2v2-EURCHF-M5-43,EURCHFMT4,4008,49m 58s,Sell
93712.29,1.22961,01.12.2011 08:35:00,,0.0,-149.43999999997322,0.0,0.0,1.22722,01.12.2011 00:15:00,7418,-0.08127846942372015,-107.3,IS,0.41,0.0,Phase3-EA-SA2v2-EURCHF-M5-43,EURCHFMT4,4010,8h 20m,Sell
93761.53,1.22645,01.12.2011 11:15:00,,0.0,-100.19999999998254,0.0,0.0,1.22777,01.12.2011 02:30:00,7419,-0.054497474814352236,49.24,IS,0.34,0.0,Phase3-EA-S4v1-EURCHF-M15-221,EURCHFMT4,1880,8h 45m,Sell
93796.14,104533,01.12.2011 21:30:00,,0.0,-65.58999999999651,0.0,0.0,104375,01.12.2011 03:30:00,7420,-0.035673546637463034,34.61,IS,0.17,0.0,Phase3-EA-T1v2-EURJPY-M15-322,EURJPYMT4,1096,18h 0m,Buy
93845.41,1.23372,02.12.2011 03:59:58,tp 1.23372,0.0,-16.320000000006985,0.0,0.0,1.23262,02.12.2011 00:55:00,7421,-0.008876235418869902,49.27,IS,0.41,0.0,Phase3-EA-SA2v2-EURCHF-M5-43,EURCHFMT4,4012,3h 4m,Buy
93841.26,104692,02.12.2011 10:15:00,,0.0,-20.470000000001164,0.0,0.0,104711,02.12.2011 03:00:00,7422,-0.011133366361776927,-4.15,IS,0.17,0.0,Phase3-EA-T1v2-EURJPY-M15-322,EURJPYMT4,1098,7h 15m,Buy
93799.26,1.57014,02.12.2011 10:29:58,sl 1.57014,0.0,-62.470000000001164,0.0,0.0,1.56714,02.12.2011 06:30:00,7423,-0.033976619277976454,-42.0,IS,0.14,0.0,Phase3-EA-B1v1-GBPUSD-M30-14,GBPUSDMT4,488,3h 59m,Sell
93737.65,1.23512,02.12.2011 13:00:00,,0.0,-124.0799999999872,0.0,0.0,1.23346,02.12.2011 04:15:00,7424,-0.06748549575813678,-61.61,IS,0.34,0.0,Phase3-EA-S4v1-EURCHF-M15-221,EURCHFMT4,1882,8h 45m,Sell
93647.19,105216,02.12.2011 14:59:57,sl 105.216,-0.41,-214.53999999997905,0.0,0.0,104436,01.12.2011 12:00:00,7425,-0.11668551144383257,-90.46,IS,0.09,0.0,Phase3-EA-TR1v1-EURJPY-M30-91,EURJPYMT4,1188,1d 2h 59m,Sell
93597.06,104546,02.12.2011 19:14:58,sl 104.546,0.0,-264.6699999999837,0.0,0.0,104776,02.12.2011 10:30:00,7426,-0.14395056546024182,-50.13,IS,0.17,0.0,Phase3-EA-T1v2-EURJPY-M15-322,EURJPYMT4,1100,8h 44m,Buy
93646.05,1.23451,05.12.2011 02:44:57,tp 1.23451,0.0,-215.67999999999302,0.0,0.0,1.23561,05.12.2011 02:15:00,7427,-0.11730554259442273,48.99,IS,0.41,0.0,Phase3-EA-SA2v2-EURCHF-M5-43,EURCHFMT4,4014,29m 57s,Sell
93709.01,0.92123,05.12.2011 05:14:58,tp 0.92123,0.0,-152.72000000000116,0.0,0.0,0.92023,05.12.2011 02:45:00,7428,-0.08306241869909568,62.96,IS,0.58,0.0,Phase3-EA-SA2v2-USDCHF-M15-107,USDCHFMT4,1458,2h 29m,Buy
93658.91,104749,05.12.2011 10:29:58,sl 104.749,0.0,-202.82000000000698,0.0,0.0,104519,05.12.2011 08:00:00,7429,-0.11031115610627971,-50.1,IS,0.17,0.0,Phase3-EA-T1v2-EURJPY-M15-322,EURJPYMT4,1102,2h 29m,Sell
93653.11,121.48,06.12.2011 04:50:00,,-1.07,-208.61999999999534,0.0,0.0,121496,05.12.2011 23:25:00,7430,-0.1134657005566057,-5.8,IS,0.23,0.0,Phase3-EA-S4v1-GBPJPY-M5-194,GBPJPYMT4,1780,5h 25m,Buy
93570.24,1.23351,06.12.2011 05:35:00,,-1.07,-291.4899999999907,0.0,0.0,1.23535,05.12.2011 21:15:00,7431,-0.1585376141081616,-82.87,IS,0.41,0.0,Phase3-EA-SA2v2-EURCHF-M5-43,EURCHFMT4,4016,8h 20m,Buy
93618.91,1.24096,06.12.2011 21:49:58,tp 1.24096,0.0,-242.81999999997788,0.0,0.0,1.24206,06.12.2011 20:25:00,7432,-0.13206663507407296,48.67,IS,0.41,0.0,Phase3-EA-SA2v2-EURCHF-M5-43,EURCHFMT4,4018,1h 24m,Sell
93667.6,1.24161,07.12.2011 04:34:58,tp 1.24161,0.0,-194.12999999997555,0.0,0.0,1.24051,07.12.2011 02:10:00,7433,-0.1055847783005061,48.69,IS,0.41,0.0,Phase3-EA-SA2v2-EURCHF-M5-43,EURCHFMT4,4020,2h 24m,Buy
93704.79,1.23781,08.12.2011 13:30:00,,0.0,-156.93999999997322,0.0,0.0,1.23882,08.12.2011 04:45:00,7434,-0.08535762173018434,37.19,IS,0.34,0.0,Phase3-EA-S4v1-EURCHF-M15-221,EURCHFMT4,1884,8h 45m,Sell
93662.79,1.57073,08.12.2011 13:59:58,sl 1.57073,0.0,-198.93999999997322,0.0,0.0,1.57373,08.12.2011 13:00:00,7435,-0.10820087464638387,-42.0,IS,0.14,0.0,Phase3-EA-B1v1-GBPUSD-M30-14,GBPUSDMT4,490,59m 58s,Buy
93810.45,103602,08.12.2011 13:59:59,tp 103.602,-2.44,-51.27999999996973,0.0,0.0,104892,02.12.2011 18:30:00,7436,-0.027890524036714773,147.66,IS,0.09,0.0,Phase3-EA-TR1v1-EURJPY-M30-91,EURJPYMT4,1190,5d 19h 29m,Sell
93859.07,1.23498,08.12.2011 21:14:57,tp 1.23498,0.0,-2.6599999999743886,0.0,0.0,1.23608,08.12.2011 20:35:00,7437,-0.0014467393513453739,48.62,IS,0.41,0.0,Phase3-EA-SA2v2-EURCHF-M5-43,EURCHFMT4,4022,39m 57s,Sell
93773.02,77656,09.12.2011 01:15:00,,-1.56,-88.70999999996275,0.0,0.0,77413,08.12.2011 17:45:00,7438,-0.04824821348083831,-86.05,IS,0.27,0.0,Phase3-EA-S1v2-USDJPY-M15-0,USDJPYMT4,2226,7h 30m,Sell
93782.75,77684,09.12.2011 04:00:00,,0.0,-78.97999999995227,0.0,0.0,77656,09.12.2011 01:15:00,7439,-0.04295619322191306,9.73,IS,0.27,0.0,Phase3-EA-S1v2-USDJPY-M15-0,USDJPYMT4,2228,2h 45m,Buy
93709.37,1.23342,09.12.2011 10:05:00,,0.0,-152.35999999995693,0.0,0.0,1.23508,09.12.2011 01:45:00,7440,-0.08286661938836135,-73.38,IS,0.41,0.0,Phase3-EA-SA2v2-EURCHF-M5-43,EURCHFMT4,4024,8h 20m,Buy
93658.31,104296,09.12.2011 14:14:57,sl 104.296,-0.77,-203.4199999999546,0.0,0.0,104066,08.12.2011 03:45:00,7441,-0.11063748829076836,-51.06,IS,0.17,0.0,Phase3-EA-T1v2-EURJPY-M15-322,EURJPYMT4,1104,1d 10h 29m,Sell
93707.09,1.23502,09.12.2011 22:44:58,tp 1.23502,0.0,-154.63999999995576,0.0,0.0,1.23612,09.12.2011 20:45:00,7442,-0.08410668168952583,48.78,IS,0.41,0.0,Phase3-EA-SA2v2-EURCHF-M5-43,EURCHFMT4,4026,1h 59m,Sell
93769.03,0.92517,12.12.2011 02:00:00,tp 0.92517,-0.75,-92.69999999995343,0.0,0.0,0.92417,09.12.2011 23:00:00,7443,-0.050418322507872204,61.94,IS,0.58,0.0,Phase3-EA-SA2v2-USDCHF-M15-107,USDCHFMT4,1460,2d 3h 0m,Buy
93767.15,0.92605,12.12.2011 06:30:00,,0.0,-94.57999999995809,0.0,0.0,0.92608,12.12.2011 02:15:00,7444,-0.05144083001936176,-1.88,IS,0.58,0.0,Phase3-EA-SA2v2-USDCHF-M15-107,USDCHFMT4,1462,4h 15m,Buy
93695.59,1.23582,12.12.2011 10:25:00,,0.0,-166.13999999995576,0.0,0.0,1.23744,12.12.2011 02:05:00,7445,-0.09036138189277093,-71.56,IS,0.41,0.0,Phase3-EA-SA2v2-EURCHF-M5-43,EURCHFMT4,4028,8h 20m,Buy
93770.68,1.2351,12.12.2011 11:15:00,,0.0,-91.04999999995925,0.0,0.0,1.23715,12.12.2011 02:30:00,7446,-0.04952090900045324,75.09,IS,0.34,0.0,Phase3-EA-S4v1-EURCHF-M15-221,EURCHFMT4,1886,8h 45m,Sell
93728.68,1.56182,12.12.2011 16:29:58,sl 1.56182,0.0,-133.04999999995925,0.0,0.0,1.56482,12.12.2011 15:30:00,7447,-0.07236416191665278,-42.0,IS,0.14,0.0,Phase3-EA-B1v1-GBPUSD-M30-14,GBPUSDMT4,492,59m 58s,Buy
93776.9,1.23546,12.12.2011 21:19:58,tp 1.23546,0.0,-84.82999999995809,0.0,0.0,1.23436,12.12.2011 20:00:00,7448,-0.046137932020958304,48.22,IS,0.41,0.0,Phase3-EA-SA2v2-EURCHF-M5-43,EURCHFMT4,4030,1h 19m,Buy
93816.39,77947,12.12.2011 22:15:00,,0.0,-45.339999999967404,0.0,0.0,77833,12.12.2011 18:15:00,7449,-0.024659835409993856,39.49,IS,0.27,0.0,Phase3-EA-S1v2-USDJPY-M15-0,USDJPYMT4,2230,4h 0m,Buy
93866.16,1.23485,13.12.2011 13:45:00,,0.0,-0.0,0.0,0.0,1.23622,13.12.2011 05:00:00,7450,-0.0,49.77,IS,0.34,0.0,Phase3-EA-S4v1-EURCHF-M15-221,EURCHFMT4,1888,8h 45m,Sell
94236.64,101941,13.12.2011 18:59:59,tp 101.941,-0.76,-0.0,0.0,0.0,103641,12.12.2011 04:30:00,7451,-0.0,370.48,IS,0.17,0.0,Phase3-EA-T1v2-EURJPY-M15-322,EURJPYMT4,1106,1d 14h 29m,Sell
94146.47,101931,13.12.2011 18:59:59,sl 101.931,0.0,-90.1700000000128,0.0,0.0,102711,13.12.2011 05:00:00,7452,-0.04894249048398439,-90.17,IS,0.09,0.0,Phase3-EA-TR1v1-EURJPY-M30-91,EURJPYMT4,1192,13h 59m,Buy
94194.27,1.23193,13.12.2011 22:59:58,tp 1.23193,0.0,-42.37000000002445,0.0,0.0,1.23083,13.12.2011 22:20:00,7453,-0.02299759700351914,47.8,IS,0.41,0.0,Phase3-EA-SA2v2-EURCHF-M5-43,EURCHFMT4,4032,39m 58s,Buy
94110.59,120548,13.12.2011 23:29:58,sl 120.548,-6.28,-126.05000000001746,0.0,0.0,121218,28.11.2011 17:00:00,7454,-0.06841744400029069,-83.68,IS,0.09,0.0,Phase3-EA-B1v1-GBPJPY-M30-1,GBPJPYMT4,726,15d 6h 29m,Buy
94164.68,120729,14.12.2011 05:05:00,,-1.06,-71.96000000002095,0.0,0.0,120542,13.12.2011 23:40:00,7455,-0.03905846307228615,54.09,IS,0.23,0.0,Phase3-EA-S4v1-GBPJPY-M5-194,GBPJPYMT4,1782,5h 25m,Buy
94215.94,0.95181,15.12.2011 01:14:58,tp 0.95181,-9.68,-20.70000000001164,0.0,0.0,0.95281,14.12.2011 23:15:00,7456,-0.011235550105566185,51.26,IS,0.58,0.0,Phase3-EA-SA2v2-USDCHF-M15-107,USDCHFMT4,1464,1h 59m,Sell
94132.1,1.23798,15.12.2011 04:20:00,,-6.45,-104.54000000000815,0.0,0.0,1.23618,14.12.2011 20:00:00,7457,-0.05674224193407343,-83.84,IS,0.41,0.0,Phase3-EA-SA2v2-EURCHF-M5-43,EURCHFMT4,4034,8h 20m,Sell
94275.36,1.23418,15.12.2011 10:59:58,tp 1.23418,0.0,-0.0,0.0,0.0,1.23818,15.12.2011 03:30:00,7458,-0.0,143.26,IS,0.34,0.0,Phase3-EA-S4v1-EURCHF-M15-221,EURCHFMT4,1890,7h 29m,Sell
94323.44,1.22291,16.12.2011 06:34:57,tp 1.22291,0.0,-0.0,0.0,0.0,1.22401,16.12.2011 02:00:00,7459,-0.0,48.08,IS,0.41,0.0,Phase3-EA-SA2v2-EURCHF-M5-43,EURCHFMT4,4036,4h 34m,Sell
94270.16,101729,16.12.2011 15:44:57,sl 101.729,-3.05,-53.279999999998836,0.0,0.0,101499,14.12.2011 14:15:00,7460,-0.028905710527103178,-53.28,IS,0.17,0.0,Phase3-EA-T1v2-EURJPY-M15-322,EURJPYMT4,1108,2d 1h 29m,Sell
94262.11,1.22087,19.12.2011 04:25:00,,-1.05,-61.329999999987194,0.0,0.0,1.22103,16.12.2011 20:05:00,7461,-0.03327303353278729,-8.05,IS,0.41,0.0,Phase3-EA-SA2v2-EURCHF-M5-43,EURCHFMT4,4038,2d 8h 20m,Buy
94219.05,1.54668,19.12.2011 06:59:57,sl 1.54668,-1.06,-104.38999999998487,0.0,0.0,1.54968,15.12.2011 13:30:00,7462,-0.05663414267875243,-43.06,IS,0.14,0.0,Phase3-EA-B1v1-GBPUSD-M30-14,GBPUSDMT4,494,3d 17h 29m,Buy
94168.86,101.57,19.12.2011 16:44:57,sl 101.570,0.0,-154.5799999999872,0.0,0.0,101.34,19.12.2011 07:30:00,7463,-0.08386345220118875,-50.19,IS,0.17,0.0,Phase3-EA-T1v2-EURJPY-M15-322,EURJPYMT4,1110,9h 14m,Sell
94199.64,0.93656,20.12.2011 03:45:00,,-3.28,-123.79999999998836,0.0,0.0,0.93711,19.12.2011 23:30:00,7464,-0.06716454510613955,30.78,IS,0.58,0.0,Phase3-EA-SA2v2-USDCHF-M15-107,USDCHFMT4,1466,4h 15m,Sell
94193.1,101435,20.12.2011 08:30:00,,0.0,-130.3399999999965,0.0,0.0,101465,20.12.2011 03:00:00,7465,-0.07071265597039432,-6.54,IS,0.17,0.0,Phase3-EA-T1v2-EURJPY-M15-322,EURJPYMT4,1112,5h 30m,Buy
94143.68,1.21975,20.12.2011 11:05:00,,0.0,-179.7600000000093,0.0,0.0,1.21862,20.12.2011 02:45:00,7466,-0.0975242215531616,-49.42,IS,0.41,0.0,Phase3-EA-SA2v2-EURCHF-M5-43,EURCHFMT4,4040,8h 20m,Sell
94192.12,1.21832,20.12.2011 22:34:58,tp 1.21832,0.0,-131.32000000000698,0.0,0.0,1.21722,20.12.2011 20:00:00,7467,-0.07124433007544058,48.44,IS,0.41,0.0,Phase3-EA-SA2v2-EURCHF-M5-43,EURCHFMT4,4042,2h 34m,Buy
94164.78,1.21885,21.12.2011 07:05:00,,-2.2,-158.6600000000035,0.0,0.0,1.21828,20.12.2011 22:45:00,7468,-0.08607695255687671,-27.34,IS,0.41,0.0,Phase3-EA-SA2v2-EURCHF-M5-43,EURCHFMT4,4044,8h 20m,Sell
94201.44,121915,21.12.2011 08:40:00,,0.0,-122.0,0.0,0.0,122039,21.12.2011 03:15:00,7469,-0.06618800083158155,36.66,IS,0.23,0.0,Phase3-EA-S4v1-GBPJPY-M5-194,GBPJPYMT4,1784,5h 25m,Sell
94250.91,1.21724,21.12.2011 10:15:00,,0.0,-72.52999999999884,0.0,0.0,1.21859,21.12.2011 01:30:00,7470,-0.03934930901897158,49.47,IS,0.34,0.0,Phase3-EA-S4v1-EURCHF-M15-221,EURCHFMT4,1892,8h 45m,Sell
94208.91,1.56482,21.12.2011 19:29:57,sl 1.56482,0.0,-114.52999999999884,0.0,0.0,1.56782,21.12.2011 05:30:00,7471,-0.062135342092138994,-42.0,IS,0.14,0.0,Phase3-EA-B1v1-GBPUSD-M30-14,GBPUSDMT4,496,13h 59m,Buy
94160.65,0.9365,22.12.2011 03:30:00,,-9.86,-162.79000000000815,0.0,0.0,0.93588,21.12.2011 23:15:00,7472,-0.08831757914240737,-48.26,IS,0.58,0.0,Phase3-EA-SA2v2-USDCHF-M15-107,USDCHFMT4,1468,4h 15m,Sell
94171.17,1.22078,22.12.2011 08:40:00,,0.0,-152.27000000001863,0.0,0.0,1.22054,22.12.2011 00:20:00,7473,-0.08261022038218159,10.52,IS,0.41,0.0,Phase3-EA-SA2v2-EURCHF-M5-43,EURCHFMT4,4046,8h 20m,Buy
94121.06,101965,22.12.2011 09:44:57,sl 101.965,0.0,-202.38000000000466,0.0,0.0,101735,22.12.2011 03:30:00,7474,-0.10979612793685067,-50.11,IS,0.17,0.0,Phase3-EA-T1v2-EURJPY-M15-322,EURJPYMT4,1114,6h 14m,Sell
94100.73,1.22161,23.12.2011 04:20:00,,-1.05,-222.70999999999185,0.0,0.0,1.22205,22.12.2011 20:00:00,7475,-0.12082565299345072,-20.33,IS,0.41,0.0,Phase3-EA-SA2v2-EURCHF-M5-43,EURCHFMT4,4048,8h 20m,Buy
94049.59,101.78,23.12.2011 17:44:58,sl 101.780,-1.07,-273.8500000000058,0.0,0.0,102.01,22.12.2011 22:45:00,7476,-0.14857036088302453,-51.14,IS,0.17,0.0,Phase3-EA-T1v2-EURJPY-M15-322,EURJPYMT4,1116,18h 59m,Buy
94052.92,1.22268,26.12.2011 10:00:00,,-1.05,-270.5200000000186,0.0,0.0,1.22258,23.12.2011 21:05:00,7477,-0.14676375397508748,3.33,IS,0.41,0.0,Phase3-EA-SA2v2-EURCHF-M5-43,EURCHFMT4,4050,2d 12h 55m,Buy
93972.98,121437,26.12.2011 15:29:58,sl 121.437,-2.5,-350.46000000002095,0.0,0.0,122107,20.12.2011 17:00:00,7478,-0.19013317025768406,-79.94,IS,0.09,0.0,Phase3-EA-B1v1-GBPJPY-M30-1,GBPJPYMT4,728,5d 22h 29m,Buy
94065.42,1.22051,27.12.2011 15:30:00,,0.0,-258.0200000000186,0.0,0.0,1.22305,27.12.2011 06:45:00,7479,-0.13998219651283528,92.44,IS,0.34,0.0,Phase3-EA-S4v1-EURCHF-M15-221,EURCHFMT4,1894,8h 45m,Sell
94067.44,1.22052,28.12.2011 07:25:00,,-1.05,-256.0000000000291,0.0,0.0,1.22045,27.12.2011 23:05:00,7480,-0.138886296826941,2.02,IS,0.41,0.0,Phase3-EA-SA2v2-EURCHF-M5-43,EURCHFMT4,4052,8h 20m,Buy
93969.21,100862,28.12.2011 18:29:58,sl 100.862,-7.94,-354.2300000000396,0.0,0.0,101642,14.12.2011 10:30:00,7481,-0.19217848798830944,-98.23,IS,0.09,0.0,Phase3-EA-TR1v1-EURJPY-M30-91,EURJPYMT4,1194,14d 7h 59m,Buy
94030.68,0.94353,29.12.2011 03:14:58,tp 0.94353,0.0,-292.7600000000384,0.0,0.0,0.94253,29.12.2011 01:30:00,7482,-0.15882950101193735,61.47,IS,0.58,0.0,Phase3-EA-SA2v2-USDCHF-M15-107,USDCHFMT4,1470,1h 44m,Buy
93967.52,120194,29.12.2011 04:25:00,,-3.19,-355.9200000000419,0.0,0.0,120397,28.12.2011 23:00:00,7483,-0.1930953545572072,-63.16,IS,0.23,0.0,Phase3-EA-S4v1-GBPJPY-M5-194,GBPJPYMT4,1786,5h 25m,Buy
93956.34,1.21866,29.12.2011 12:15:00,,0.0,-367.1000000000349,0.0,0.0,1.21897,29.12.2011 03:30:00,7484,-0.1991607795514418,-11.18,IS,0.34,0.0,Phase3-EA-S4v1-EURCHF-M15-221,EURCHFMT4,1896,8h 45m,Buy
93917.56,77769,29.12.2011 12:45:00,,-3.02,-405.88000000003376,0.0,0.0,77872,28.12.2011 23:15:00,7485,-0.2201998834223324,-38.78,IS,0.27,0.0,Phase3-EA-S1v2-USDJPY-M15-0,USDJPYMT4,2232,13h 30m,Buy
94129.41,119671,29.12.2011 13:29:58,tp 119.671,-2.01,-194.03000000002794,0.0,0.0,121521,28.12.2011 16:30:00,7486,-0.10526604755207883,211.85,IS,0.09,0.0,Phase3-EA-B1v1-GBPJPY-M30-1,GBPJPYMT4,730,20h 59m,Sell
94496.87,100121,29.12.2011 14:59:58,tp 100.121,-3.81,-0.0,0.0,0.0,101821,26.12.2011 18:15:00,7487,-0.0,367.46,IS,0.17,0.0,Phase3-EA-T1v2-EURJPY-M15-322,EURJPYMT4,1118,2d 20h 44m,Sell
94558.58,0.9399,30.12.2011 03:59:57,tp 0.93990,0.0,-0.0,0.0,0.0,0.9409,30.12.2011 02:45:00,7488,-0.0,61.71,IS,0.58,0.0,Phase3-EA-SA2v2-USDCHF-M15-107,USDCHFMT4,1472,1h 14m,Sell
94544.46,1.21784,30.12.2011 06:20:00,,-1.05,-14.119999999995343,0.0,0.0,1.21814,29.12.2011 22:00:00,7489,-0.0076506873860837646,-14.12,IS,0.41,0.0,Phase3-EA-SA2v2-EURCHF-M5-43,EURCHFMT4,4054,8h 20m,Buy
94501.77,1.54579,30.12.2011 15:29:58,sl 1.54579,-0.69,-56.80999999999767,0.0,0.0,1.54279,29.12.2011 12:00:00,7490,-0.03078155456115752,-42.69,IS,0.14,0.0,Phase3-EA-B1v1-GBPUSD-M30-14,GBPUSDMT4,498,1d 3h 29m,Sell
94647.53,99828,30.12.2011 19:29:57,tp 99.828,-1.62,-0.0,0.0,0.0,101088,28.12.2011 17:30:00,7491,-0.0,145.76,IS,0.09,0.0,Phase3-EA-TR1v1-EURJPY-M30-91,EURJPYMT4,1195,2d 1h 59m,Sell
94694.52,1.21591,02.01.2012 02:14:57,tp 1.21591,-1.05,-0.0,0.0,0.0,1.21481,30.12.2011 22:55:00,7492,-0.0,46.99,IS,0.41,0.0,Phase3-EA-SA2v2-EURCHF-M5-43,EURCHFMT4,4056,2d 3h 19m,Buy
94642.87,99719,03.01.2012 05:14:58,sl 99.719,-0.77,-51.64999999999418,0.0,0.0,99489,02.01.2012 16:15:00,7493,-0.027965096094889046,-51.65,IS,0.17,0.0,Phase3-EA-T1v2-EURJPY-M15-322,EURJPYMT4,1120,12h 59m,Sell
94517.97,1.21807,03.01.2012 06:55:00,,-2.18,-176.54999999998836,0.0,0.0,1.21526,02.01.2012 22:35:00,7494,-0.09559027522851679,-124.9,IS,0.41,0.0,Phase3-EA-SA2v2-EURCHF-M5-43,EURCHFMT4,4058,8h 20m,Sell
94529.63,1.21742,03.01.2012 15:00:00,,0.0,-164.88999999998487,0.0,0.0,1.21774,03.01.2012 06:15:00,7495,-0.08927714801716072,11.66,IS,0.34,0.0,Phase3-EA-S4v1-EURCHF-M15-221,EURCHFMT4,1898,8h 45m,Sell
94563.42,1.21719,04.01.2012 08:40:00,,0.0,-131.09999999997672,0.0,0.0,1.21642,04.01.2012 00:20:00,7496,-0.07098207353416681,33.79,IS,0.41,0.0,Phase3-EA-SA2v2-EURCHF-M5-43,EURCHFMT4,4060,8h 20m,Buy
94566.72,119875,04.01.2012 09:20:00,,0.0,-127.79999999998836,0.0,0.0,119864,04.01.2012 03:55:00,7497,-0.06919533941775212,3.3,IS,0.23,0.0,Phase3-EA-S4v1-GBPJPY-M5-194,GBPJPYMT4,1788,5h 25m,Buy
94515.69,99.86,04.01.2012 13:14:58,sl 99.860,0.0,-178.8299999999872,0.0,0.0,100.09,04.01.2012 11:30:00,7498,-0.09682474607258884,-51.03,IS,0.17,0.0,Phase3-EA-T1v2-EURJPY-M15-322,EURJPYMT4,1122,1h 44m,Buy
94517.12,1.21808,05.01.2012 14:30:00,,0.0,-177.39999999999418,0.0,0.0,1.21804,05.01.2012 05:45:00,7499,-0.09605049462214353,1.43,IS,0.34,0.0,Phase3-EA-S4v1-EURCHF-M15-221,EURCHFMT4,1900,8h 45m,Buy
94662.3,98486,05.01.2012 16:29:58,tp 98.486,-2.46,-32.220000000001164,0.0,0.0,99746,30.12.2011 22:30:00,7500,-0.017445022191238318,145.18,IS,0.09,0.0,Phase3-EA-TR1v1-EURJPY-M30-91,EURJPYMT4,1198,5d 17h 59m,Sell
94618.17,1.55,05.01.2012 16:59:58,sl 1.55000,-2.13,-76.35000000000582,0.0,0.0,1553,03.01.2012 04:30:00,7501,-0.04133853023901611,-44.13,IS,0.14,0.0,Phase3-EA-B1v1-GBPUSD-M30-14,GBPUSDMT4,500,2d 12h 29m,Buy
94617.28,119601,06.01.2012 05:30:00,,0.0,-77.24000000001979,0.0,0.0,119598,06.01.2012 00:05:00,7502,-0.04182040701587661,-0.89,IS,0.23,0.0,Phase3-EA-S4v1-GBPJPY-M5-194,GBPJPYMT4,1790,5h 25m,Sell
94664.56,1.21902,06.01.2012 08:49:58,tp 1.21902,0.0,-29.960000000020955,0.0,0.0,1.21792,06.01.2012 01:05:00,7503,-0.01622138003879102,47.28,IS,0.41,0.0,Phase3-EA-SA2v2-EURCHF-M5-43,EURCHFMT4,4062,7h 44m,Buy
94692.72,1.21885,06.01.2012 10:00:00,,0.0,-1.8000000000174623,0.0,0.0,1.21806,06.01.2012 01:15:00,7504,-9.745822453299959E-4,28.16,IS,0.34,0.0,Phase3-EA-S4v1-EURCHF-M15-221,EURCHFMT4,1902,8h 45m,Buy
94601.71,97.94,06.01.2012 18:29:58,sl 97.940,0.0,-92.81000000002678,0.0,0.0,98.72,06.01.2012 04:00:00,7505,-0.05025054343790307,-91.01,IS,0.09,0.0,Phase3-EA-TR1v1-EURJPY-M30-91,EURJPYMT4,1200,14h 29m,Buy
94975.7,97483,09.01.2012 02:00:00,tp 97.483,-1.54,-0.0,0.0,0.0,99183,05.01.2012 03:00:00,7506,-0.0,373.99,IS,0.17,0.0,Phase3-EA-T1v2-EURJPY-M15-322,EURJPYMT4,1124,3d 23h 0m,Sell
94893.23,1.21409,09.01.2012 04:35:00,,-1.03,-82.47000000000116,0.0,0.0,1.21599,06.01.2012 20:15:00,7507,-0.044584234577839686,-82.47,IS,0.41,0.0,Phase3-EA-SA2v2-EURCHF-M5-43,EURCHFMT4,4064,2d 8h 20m,Buy
94944.96,118563,09.01.2012 07:55:00,,0.0,-30.739999999990687,0.0,0.0,118.39,09.01.2012 02:30:00,7508,-0.016618399065385682,51.73,IS,0.23,0.0,Phase3-EA-S4v1-GBPJPY-M5-194,GBPJPYMT4,1792,5h 25m,Buy
94777.78,0.94782,10.01.2012 02:45:00,,-0.73,-197.9199999999837,0.0,0.0,0.95054,09.01.2012 22:30:00,7509,-0.10699783809440014,-167.18,IS,0.58,0.0,Phase3-EA-SA2v2-USDCHF-M15-107,USDCHFMT4,1474,4h 15m,Buy
94704.12,1.21139,10.01.2012 05:05:00,,-1.04,-271.5799999999872,0.0,0.0,1.21307,09.01.2012 20:45:00,7510,-0.14681928491147034,-73.66,IS,0.41,0.0,Phase3-EA-SA2v2-EURCHF-M5-43,EURCHFMT4,4066,8h 20m,Buy
94724.96,98133,10.01.2012 08:00:00,,-1.08,-250.7399999999907,0.0,0.0,98034,09.01.2012 22:45:00,7511,-0.13555294019700437,20.84,IS,0.17,0.0,Phase3-EA-T1v2-EURJPY-M15-322,EURJPYMT4,1126,9h 15m,Buy
94740.0,1.21233,10.01.2012 11:00:00,,0.0,-235.69999999998254,0.0,0.0,1.21191,10.01.2012 02:15:00,7512,-0.12742214247600203,15.04,IS,0.34,0.0,Phase3-EA-S4v1-EURCHF-M15-221,EURCHFMT4,1904,8h 45m,Buy
94701.28,98091,10.01.2012 20:30:00,,0.0,-274.4199999999837,0.0,0.0,98266,10.01.2012 13:00:00,7513,-0.14835462171516753,-38.72,IS,0.17,0.0,Phase3-EA-T1v2-EURJPY-M15-322,EURJPYMT4,1128,7h 30m,Buy
94761.64,0.94936,11.01.2012 00:14:58,tp 0.94936,-0.73,-214.05999999999767,0.0,0.0,0.94836,10.01.2012 23:15:00,7514,-0.1157233085210637,60.36,IS,0.58,0.0,Phase3-EA-SA2v2-USDCHF-M15-107,USDCHFMT4,1476,59m 58s,Buy
94742.5,1.21234,11.01.2012 04:25:00,,-1.04,-233.20000000001164,0.0,0.0,1.21276,10.01.2012 20:05:00,7515,-0.1260706135995221,-19.14,IS,0.41,0.0,Phase3-EA-SA2v2-EURCHF-M5-43,EURCHFMT4,4068,8h 20m,Buy
94699.44,1.54062,11.01.2012 14:29:58,sl 1.54062,-1.06,-276.2600000000093,0.0,0.0,1.54362,09.01.2012 11:30:00,7516,-0.1493493469682822,-43.06,IS,0.14,0.0,Phase3-EA-B1v1-GBPUSD-M30-14,GBPUSDMT4,502,2d 2h 59m,Buy
94908.53,117.81,11.01.2012 19:29:59,tp 117.810,-7.47,-67.1700000000128,0.0,0.0,119.66,29.12.2011 13:30:00,7517,-0.0363128778536925,209.09,IS,0.09,0.0,Phase3-EA-B1v1-GBPJPY-M30-1,GBPJPYMT4,732,13d 5h 59m,Sell
94955.77,1.21185,11.01.2012 22:44:57,tp 1.21185,0.0,-19.93000000002212,0.0,0.0,1.21295,11.01.2012 20:50:00,7518,-0.010774388203435414,47.24,IS,0.41,0.0,Phase3-EA-SA2v2-EURCHF-M5-43,EURCHFMT4,4070,1h 54m,Sell
94902.61,98074,12.01.2012 13:14:57,sl 98.074,-2.32,-73.09000000002561,0.0,0.0,97844,11.01.2012 14:45:00,7519,-0.03951329823324116,-53.16,IS,0.17,0.0,Phase3-EA-T1v2-EURJPY-M15-322,EURJPYMT4,1130,22h 29m,Sell
94950.45,1.20992,12.01.2012 21:59:57,tp 1.20992,0.0,-25.250000000029104,0.0,0.0,1.20882,12.01.2012 21:15:00,7520,-0.013650441652621968,47.84,IS,0.41,0.0,Phase3-EA-SA2v2-EURCHF-M5-43,EURCHFMT4,4072,44m 57s,Buy
94863.19,98742,13.01.2012 09:29:58,sl 98.742,-2.87,-112.51000000003842,0.0,0.0,98022,06.01.2012 19:00:00,7521,-0.06082420555783175,-87.26,IS,0.09,0.0,Phase3-EA-TR1v1-EURJPY-M30-91,EURJPYMT4,1202,6d 14h 29m,Sell
94877.21,1.21028,13.01.2012 14:30:00,,0.0,-98.4900000000489,0.0,0.0,1.21067,13.01.2012 05:45:00,7522,-0.05324483161844972,14.02,IS,0.34,0.0,Phase3-EA-S4v1-EURCHF-M15-221,EURCHFMT4,1906,8h 45m,Sell
95028.15,97213,13.01.2012 18:29:58,tp 97.213,0.0,-0.0,0.0,0.0,98503,13.01.2012 12:00:00,7523,-0.0,150.94,IS,0.09,0.0,Phase3-EA-TR1v1-EURJPY-M30-91,EURJPYMT4,1204,6h 29m,Sell
95022.21,76898,16.01.2012 02:00:00,,-1.02,-5.940000000002328,0.0,0.0,76912,13.01.2012 22:30:00,7524,-0.0032103223212264285,-5.94,IS,0.27,0.0,Phase3-EA-S1v2-USDJPY-M15-0,USDJPYMT4,2234,2d 3h 30m,Buy
95070.45,117509,16.01.2012 04:35:00,,-1.73,-0.0,0.0,0.0,117676,13.01.2012 23:10:00,7525,-0.0,48.24,IS,0.23,0.0,Phase3-EA-S4v1-GBPJPY-M5-194,GBPJPYMT4,1794,2d 5h 25m,Sell
95035.92,1.20726,16.01.2012 05:30:00,,-1.03,-34.529999999998836,0.0,0.0,1.20804,13.01.2012 21:10:00,7526,-0.018657759788231334,-34.53,IS,0.41,0.0,Phase3-EA-SA2v2-EURCHF-M5-43,EURCHFMT4,4074,2d 8h 20m,Buy
95064.78,1.20786,16.01.2012 11:00:00,,0.0,-5.670000000012806,0.0,0.0,1.20705,16.01.2012 02:15:00,7527,-0.0030636981754854956,28.86,IS,0.34,0.0,Phase3-EA-S4v1-EURCHF-M15-221,EURCHFMT4,1908,8h 45m,Buy
95125.5,0.95517,17.01.2012 02:59:57,tp 0.95517,0.0,-0.0,0.0,0.0,0.95617,17.01.2012 02:15:00,7528,-0.0,60.72,IS,0.58,0.0,Phase3-EA-SA2v2-USDCHF-M15-107,USDCHFMT4,1478,44m 57s,Sell
95073.82,97418,17.01.2012 03:59:57,sl 97.418,-0.77,-51.679999999993015,0.0,0.0,97188,16.01.2012 18:00:00,7529,-0.027916197390415117,-51.68,IS,0.17,0.0,Phase3-EA-T1v2-EURJPY-M15-322,EURJPYMT4,1132,9h 59m,Sell
95040.13,1.21011,17.01.2012 10:15:00,,0.0,-85.36999999999534,0.0,0.0,1.20933,17.01.2012 01:55:00,7530,-0.04611466275580361,-33.69,IS,0.41,0.0,Phase3-EA-SA2v2-EURCHF-M5-43,EURCHFMT4,4076,8h 20m,Sell
95036.19,1.20974,17.01.2012 11:15:00,,0.0,-89.30999999999767,0.0,0.0,1.20963,17.01.2012 02:30:00,7531,-0.048242948702365444,-3.94,IS,0.34,0.0,Phase3-EA-S4v1-EURCHF-M15-221,EURCHFMT4,1910,8h 45m,Sell
94951.01,98261,17.01.2012 15:29:58,sl 98.261,-0.82,-174.4899999999907,0.0,0.0,97541,13.01.2012 18:00:00,7532,-0.09425497837952655,-85.18,IS,0.09,0.0,Phase3-EA-TR1v1-EURJPY-M30-91,EURJPYMT4,1205,3d 21h 29m,Sell
94971.74,76828,17.01.2012 20:45:00,,0.0,-153.7599999999802,0.0,0.0,76769,17.01.2012 19:30:00,7533,-0.08305716932566284,20.73,IS,0.27,0.0,Phase3-EA-S1v2-USDJPY-M15-0,USDJPYMT4,2236,1h 15m,Buy
94973.73,1.20918,18.01.2012 07:25:00,,-1.04,-151.76999999998952,0.0,0.0,1.20911,17.01.2012 23:05:00,7534,-0.08198222287042535,1.99,IS,0.41,0.0,Phase3-EA-SA2v2-EURCHF-M5-43,EURCHFMT4,4078,8h 20m,Buy
94881.91,98459,18.01.2012 13:29:58,sl 98.459,-0.41,-243.5899999999965,0.0,0.0,97679,17.01.2012 18:00:00,7535,-0.1315810085590565,-91.82,IS,0.09,0.0,Phase3-EA-TR1v1-EURJPY-M30-91,EURJPYMT4,1208,19h 29m,Sell
94800.74,118336,18.01.2012 17:59:58,sl 118.336,-2.72,-324.7600000000093,0.0,0.0,117666,12.01.2012 06:30:00,7536,-0.17542694010279988,-81.17,IS,0.09,0.0,Phase3-EA-B1v1-GBPJPY-M30-1,GBPJPYMT4,734,6d 11h 29m,Sell
94852.69,0.93903,19.01.2012 00:59:58,tp 0.93903,-9.82,-272.8099999999977,0.0,0.0,0.94003,18.01.2012 23:15:00,7537,-0.1473648957058845,51.95,IS,0.58,0.0,Phase3-EA-SA2v2-USDCHF-M15-107,USDCHFMT4,1480,1h 44m,Sell
94914.39,0.94,19.01.2012 04:14:57,tp 0.94000,0.0,-211.10999999998603,0.0,0.0,939,19.01.2012 02:45:00,7538,-0.1140361538523789,61.7,IS,0.58,0.0,Phase3-EA-SA2v2-USDCHF-M15-107,USDCHFMT4,1482,1h 29m,Buy
94863.27,1.20784,19.01.2012 04:35:00,,-3.14,-262.2299999999814,0.0,0.0,1.20894,18.01.2012 20:15:00,7539,-0.14164985374785266,-51.12,IS,0.41,0.0,Phase3-EA-SA2v2-EURCHF-M5-43,EURCHFMT4,4080,8h 20m,Buy
95044.99,98715,19.01.2012 07:00:00,,-3.25,-80.50999999998021,0.0,0.0,97.88,18.01.2012 02:00:00,7540,-0.04348941663897199,181.72,IS,0.17,0.0,Phase3-EA-T1v2-EURJPY-M15-322,EURJPYMT4,1134,1d 5h 0m,Buy
95072.96,1.20821,19.01.2012 14:30:00,,0.0,-52.539999999979045,0.0,0.0,1.20744,19.01.2012 05:45:00,7541,-0.028380747114783736,27.97,IS,0.34,0.0,Phase3-EA-S4v1-EURCHF-M15-221,EURCHFMT4,1912,8h 45m,Buy
94981.71,99395,19.01.2012 18:59:58,sl 99.395,0.0,-143.78999999997905,0.0,0.0,98615,19.01.2012 05:00:00,7542,-0.07767163356748737,-91.25,IS,0.09,0.0,Phase3-EA-TR1v1-EURJPY-M30-91,EURJPYMT4,1210,13h 59m,Sell
95030.09,1.20873,19.01.2012 23:59:57,tp 1.20873,0.0,-95.40999999997439,0.0,0.0,1.20763,19.01.2012 22:30:00,7543,-0.05153801070083497,48.38,IS,0.41,0.0,Phase3-EA-SA2v2-EURCHF-M5-43,EURCHFMT4,4082,1h 29m,Buy
94937.87,0.93207,20.01.2012 02:45:00,,-0.75,-187.62999999997555,0.0,0.0,0.93354,19.01.2012 22:30:00,7544,-0.10135286602870769,-92.22,IS,0.58,0.0,Phase3-EA-SA2v2-USDCHF-M15-107,USDCHFMT4,1484,4h 15m,Buy
94959.91,77174,20.01.2012 04:15:00,,0.0,-165.5899999999674,0.0,0.0,77111,20.01.2012 00:15:00,7545,-0.08944742890631877,22.04,IS,0.27,0.0,Phase3-EA-S1v2-USDJPY-M15-0,USDJPYMT4,2238,4h 0m,Buy
95202.39,99966,20.01.2012 08:30:00,,-1.08,-0.0,0.0,0.0,98861,19.01.2012 12:00:00,7546,-0.0,242.48,IS,0.17,0.0,Phase3-EA-T1v2-EURJPY-M15-322,EURJPYMT4,1136,20h 30m,Buy
95213.34,1.20768,23.01.2012 05:25:00,,-2.19,-0.0,0.0,0.0,1.20798,20.01.2012 21:05:00,7547,-0.0,10.95,IS,0.41,0.0,Phase3-EA-SA2v2-EURCHF-M5-43,EURCHFMT4,4084,2d 8h 20m,Sell
95191.06,0.93696,23.01.2012 06:45:00,,0.0,-22.279999999998836,0.0,0.0,0.9366,23.01.2012 02:30:00,7548,-0.012029371102534405,-22.28,IS,0.58,0.0,Phase3-EA-SA2v2-USDCHF-M15-107,USDCHFMT4,1486,4h 15m,Sell
95139.4,119763,23.01.2012 07:25:00,,0.0,-73.94000000000233,0.0,0.0,119.59,23.01.2012 02:00:00,7549,-0.03992153049019158,-51.66,IS,0.23,0.0,Phase3-EA-S4v1-GBPJPY-M5-194,GBPJPYMT4,1796,5h 25m,Sell
95145.95,1.20762,23.01.2012 12:30:00,,0.0,-67.39000000001397,0.0,0.0,1.20744,23.01.2012 03:45:00,7550,-0.036385068159784734,6.55,IS,0.34,0.0,Phase3-EA-S4v1-EURCHF-M15-221,EURCHFMT4,1914,8h 45m,Buy
95192.37,1.20687,24.01.2012 01:59:58,tp 1.20687,-2.21,-20.970000000001164,0.0,0.0,1.20797,23.01.2012 22:05:00,7551,-0.011322078636453037,46.42,IS,0.41,0.0,Phase3-EA-SA2v2-EURCHF-M5-43,EURCHFMT4,4086,3h 54m,Sell
95178.06,1.20651,24.01.2012 13:30:00,,0.0,-35.279999999998836,0.0,0.0,1.2069,24.01.2012 04:45:00,7552,-0.019048303972056643,-14.31,IS,0.34,0.0,Phase3-EA-S4v1-EURCHF-M15-221,EURCHFMT4,1916,8h 45m,Buy
95322.35,101027,24.01.2012 19:29:58,tp 101.027,-1.71,-0.0,0.0,0.0,99767,19.01.2012 20:30:00,7553,-0.0,144.29,IS,0.09,0.0,Phase3-EA-TR1v1-EURJPY-M30-91,EURJPYMT4,1212,4d 22h 59m,Buy
95340.44,77754,25.01.2012 03:15:00,,-1.01,-0.0,0.0,0.0,77699,24.01.2012 21:30:00,7554,-0.0,18.09,IS,0.27,0.0,Phase3-EA-S1v2-USDJPY-M15-0,USDJPYMT4,2240,5h 45m,Buy
95294.06,1.20902,25.01.2012 04:25:00,,-2.21,-46.38000000000466,0.0,0.0,1.20802,24.01.2012 20:05:00,7555,-0.025024220294289024,-46.38,IS,0.41,0.0,Phase3-EA-SA2v2-EURCHF-M5-43,EURCHFMT4,4088,8h 20m,Sell
95332.8,0.92833,25.01.2012 05:45:00,,0.0,-7.64000000001397,0.0,0.0,0.92771,25.01.2012 01:30:00,7556,-0.004122144093331145,38.74,IS,0.58,0.0,Phase3-EA-SA2v2-USDCHF-M15-107,USDCHFMT4,1488,4h 15m,Buy
95302.7,121623,25.01.2012 09:10:00,,0.0,-37.74000000001979,0.0,0.0,121521,25.01.2012 03:45:00,7557,-0.02036252854477939,-30.1,IS,0.23,0.0,Phase3-EA-S4v1-GBPJPY-M5-194,GBPJPYMT4,1798,5h 25m,Sell
95488.21,101168,25.01.2012 15:15:00,,-1.07,-0.0,0.0,0.0,100311,24.01.2012 09:30:00,7558,-0.0,185.51,IS,0.17,0.0,Phase3-EA-T1v2-EURJPY-M15-322,EURJPYMT4,1138,1d 5h 45m,Buy
95524.14,78.16,25.01.2012 18:00:00,,0.0,-0.0,0.0,0.0,78056,25.01.2012 17:30:00,7559,-0.0,35.93,IS,0.27,0.0,Phase3-EA-S1v2-USDJPY-M15-0,USDJPYMT4,2242,30m 0s,Buy
95481.88,1.20858,26.01.2012 07:55:00,,-6.68,-42.26000000000931,0.0,0.0,1.20778,25.01.2012 23:35:00,7560,-0.022778706857236604,-42.26,IS,0.41,0.0,Phase3-EA-SA2v2-EURCHF-M5-43,EURCHFMT4,4090,8h 20m,Sell
95502.56,1.20733,26.01.2012 11:45:00,,0.0,-21.580000000016298,0.0,0.0,1.20789,26.01.2012 03:00:00,7561,-0.011631909464728557,20.68,IS,0.34,0.0,Phase3-EA-S4v1-EURCHF-M15-221,EURCHFMT4,1918,8h 45m,Sell
95452.1,101755,26.01.2012 18:44:58,sl 101.755,0.0,-72.04000000000815,0.0,0.0,101985,26.01.2012 13:15:00,7562,-0.03883052631318384,-50.46,IS,0.17,0.0,Phase3-EA-T1v2-EURJPY-M15-322,EURJPYMT4,1140,5h 29m,Buy
95448.13,0.92026,27.01.2012 02:15:00,,-3.34,-76.01000000000931,0.0,0.0,0.92025,26.01.2012 22:00:00,7563,-0.040970409565035136,-3.97,IS,0.58,0.0,Phase3-EA-SA2v2-USDCHF-M15-107,USDCHFMT4,1490,4h 15m,Sell
95363.91,101211,27.01.2012 03:29:58,sl 101.211,-0.57,-160.23000000001048,0.0,0.0,101482,25.01.2012 09:30:00,7564,-0.08636611925542961,-84.22,IS,0.09,0.0,Phase3-EA-TR1v1-EURJPY-M30-91,EURJPYMT4,1214,1d 17h 59m,Sell
95384.21,1.20694,27.01.2012 06:00:00,,-1.07,-139.93000000002212,0.0,0.0,1.20646,26.01.2012 21:40:00,7565,-0.07542414696007854,20.3,IS,0.41,0.0,Phase3-EA-SA2v2-EURCHF-M5-43,EURCHFMT4,4092,8h 20m,Buy
95304.18,120699,27.01.2012 07:29:58,sl 120.699,-2.09,-219.96000000002095,0.0,0.0,121369,24.01.2012 22:00:00,7566,-0.11856139044763693,-80.03,IS,0.09,0.0,Phase3-EA-B1v1-GBPJPY-M30-1,GBPJPYMT4,736,2d 9h 29m,Buy
95145.05,120704,27.01.2012 09:00:00,,0.0,-379.0900000000256,0.0,0.0,121237,27.01.2012 03:35:00,7567,-0.20433459494814257,-159.13,IS,0.23,0.0,Phase3-EA-S4v1-GBPJPY-M5-194,GBPJPYMT4,1800,5h 25m,Buy
95115.44,1.2076,27.01.2012 13:45:00,,0.0,-408.70000000001164,0.0,0.0,1.2068,27.01.2012 05:00:00,7568,-0.22029478212377696,-29.61,IS,0.34,0.0,Phase3-EA-S4v1-EURCHF-M15-221,EURCHFMT4,1920,8h 45m,Sell
95064.48,100988,27.01.2012 19:29:58,sl 100.988,0.0,-459.6600000000035,0.0,0.0,100758,27.01.2012 16:45:00,7569,-0.24776290567901443,-50.96,IS,0.17,0.0,Phase3-EA-T1v2-EURJPY-M15-322,EURJPYMT4,1142,2h 44m,Sell
95062.05,1.20609,30.01.2012 04:20:00,,-1.08,-462.0899999999965,0.0,0.0,1.20612,27.01.2012 20:00:00,7570,-0.24907270827397215,-2.43,IS,0.41,0.0,Phase3-EA-SA2v2-EURCHF-M5-43,EURCHFMT4,4094,2d 8h 20m,Buy
95087.94,76668,30.01.2012 07:00:00,,-1.58,-436.19999999998254,0.0,0.0,76746,27.01.2012 22:45:00,7571,-0.23511765099678228,25.89,IS,0.27,0.0,Phase3-EA-S1v2-USDJPY-M15-0,USDJPYMT4,2244,2d 8h 15m,Sell
95107.23,1.20586,30.01.2012 11:30:00,,0.0,-416.9099999999744,0.0,0.0,1.20638,30.01.2012 02:45:00,7572,-0.2247200822491206,19.29,IS,0.34,0.0,Phase3-EA-S4v1-EURCHF-M15-221,EURCHFMT4,1922,8h 45m,Sell
95256.58,100192,30.01.2012 16:59:58,tp 100.192,-2.04,-267.55999999996857,0.0,0.0,101931,26.01.2012 01:00:00,7573,-0.1442184289332742,149.35,IS,0.09,0.0,Phase3-EA-TR1v1-EURJPY-M30-91,EURJPYMT4,1215,4d 15h 59m,Buy
95231.96,1.20516,31.01.2012 05:00:00,,-2.23,-292.1799999999639,0.0,0.0,1.20466,30.01.2012 20:40:00,7574,-0.15748893917522722,-24.62,IS,0.41,0.0,Phase3-EA-SA2v2-EURCHF-M5-43,EURCHFMT4,4096,8h 20m,Sell
95102.0,0.91491,31.01.2012 05:30:00,,0.0,-422.13999999995576,0.0,0.0,0.91696,31.01.2012 01:15:00,7575,-0.22753912240205237,-129.96,IS,0.58,0.0,Phase3-EA-SA2v2-USDCHF-M15-107,USDCHFMT4,1492,4h 15m,Buy
95110.49,76297,31.01.2012 05:45:00,,0.0,-413.6499999999651,0.0,0.0,76321,31.01.2012 00:15:00,7576,-0.22296289852089562,8.49,IS,0.27,0.0,Phase3-EA-S1v2-USDJPY-M15-0,USDJPYMT4,2246,5h 30m,Sell
95123.6,0.92013,01.02.2012 03:45:00,,-0.76,-400.53999999997905,0.0,0.0,0.91991,31.01.2012 23:30:00,7577,-0.21589643266907385,13.11,IS,0.58,0.0,Phase3-EA-SA2v2-USDCHF-M15-107,USDCHFMT4,1494,4h 15m,Buy
95170.34,1.20323,01.02.2012 04:39:58,tp 1.20323,-2.23,-353.79999999998836,0.0,0.0,1.20433,31.01.2012 21:20:00,7578,-0.19070294571907878,46.74,IS,0.41,0.0,Phase3-EA-SA2v2-EURCHF-M5-43,EURCHFMT4,4098,7h 19m,Sell
95318.25,99331,01.02.2012 10:29:58,tp 99.331,-0.82,-205.88999999998487,0.0,0.0,100591,30.01.2012 15:00:00,7579,-0.11097747171876636,147.91,IS,0.09,0.0,Phase3-EA-TR1v1-EURJPY-M30-91,EURJPYMT4,1217,1d 19h 29m,Sell
95276.25,1.57558,01.02.2012 13:29:58,sl 1.57558,0.0,-247.88999999998487,0.0,0.0,1.57858,01.02.2012 12:30:00,7580,-0.1336160350884712,-42.0,IS,0.14,0.0,Phase3-EA-B1v1-GBPUSD-M30-14,GBPUSDMT4,504,59m 58s,Buy
95321.47,1.20435,01.02.2012 14:15:00,,0.0,-202.6699999999837,0.0,0.0,1.20313,01.02.2012 05:30:00,7581,-0.10924184852708836,45.22,IS,0.34,0.0,Phase3-EA-S4v1-EURCHF-M15-221,EURCHFMT4,1924,8h 45m,Buy
95339.3,0.91464,02.02.2012 02:15:00,,-10.07,-184.8399999999965,0.0,0.0,0.91508,01.02.2012 22:00:00,7582,-0.09963123936324199,17.83,IS,0.58,0.0,Phase3-EA-SA2v2-USDCHF-M15-107,USDCHFMT4,1496,4h 15m,Sell
95336.98,1.20468,02.02.2012 04:20:00,,-3.22,-187.1600000000035,0.0,0.0,1.20466,01.02.2012 20:00:00,7583,-0.10088175048271517,-2.32,IS,0.41,0.0,Phase3-EA-SA2v2-EURCHF-M5-43,EURCHFMT4,4100,8h 20m,Buy
95394.91,1.20593,02.02.2012 09:45:00,,0.0,-129.23000000001048,0.0,0.0,1.20437,02.02.2012 01:00:00,7584,-0.06965670343493319,57.93,IS,0.34,0.0,Phase3-EA-S4v1-EURCHF-M15-221,EURCHFMT4,1926,8h 45m,Buy
95405.17,1.20517,03.02.2012 05:10:00,,-2.24,-118.97000000000116,0.0,0.0,1.20545,02.02.2012 20:50:00,7585,-0.06412642581175741,10.26,IS,0.41,0.0,Phase3-EA-SA2v2-EURCHF-M5-43,EURCHFMT4,4102,8h 20m,Sell
95321.68,121081,03.02.2012 18:29:57,sl 121.081,-4.78,-202.45999999999185,0.0,0.0,120411,27.01.2012 18:30:00,7586,-0.10912865571024423,-83.49,IS,0.09,0.0,Phase3-EA-B1v1-GBPJPY-M30-1,GBPJPYMT4,738,6d 23h 59m,Sell
95384.04,0.91885,06.02.2012 02:00:00,tp 0.91885,-0.76,-140.10000000000582,0.0,0.0,0.91785,03.02.2012 22:45:00,7587,-0.07551577924037571,62.36,IS,0.58,0.0,Phase3-EA-SA2v2-USDCHF-M15-107,USDCHFMT4,1498,2d 3h 15m,Buy
95379.85,76545,06.02.2012 02:00:00,,-1.02,-144.29000000000815,0.0,0.0,76554,03.02.2012 22:30:00,7588,-0.0777742454432118,-4.19,IS,0.27,0.0,Phase3-EA-S1v2-USDJPY-M15-0,USDJPYMT4,2248,2d 3h 30m,Buy
95426.63,1.20612,06.02.2012 03:54:58,tp 1.20612,-2.23,-97.51000000000931,0.0,0.0,1.20722,03.02.2012 20:35:00,7589,-0.05255919795666976,46.78,IS,0.41,0.0,Phase3-EA-SA2v2-EURCHF-M5-43,EURCHFMT4,4104,2d 7h 19m,Sell
95472.19,100369,06.02.2012 04:30:00,,-1.09,-51.95000000001164,0.0,0.0,100159,03.02.2012 09:15:00,7590,-0.028001746834676905,45.56,IS,0.17,0.0,Phase3-EA-T1v2-EURJPY-M15-322,EURJPYMT4,1144,2d 19h 15m,Buy
95540.48,121102,06.02.2012 08:10:00,,0.0,-0.0,0.0,0.0,120874,06.02.2012 02:45:00,7591,-0.0,68.29,IS,0.23,0.0,Phase3-EA-S4v1-GBPJPY-M5-194,GBPJPYMT4,1802,5h 25m,Buy
95566.97,1.20721,06.02.2012 12:00:00,,0.0,-0.0,0.0,0.0,1.20649,06.02.2012 03:15:00,7592,-0.0,26.49,IS,0.34,0.0,Phase3-EA-S4v1-EURCHF-M15-221,EURCHFMT4,1928,8h 45m,Buy
95487.92,120489,06.02.2012 13:29:58,sl 120.489,-0.42,-79.04999999998836,0.0,0.0,121159,03.02.2012 23:00:00,7593,-0.04259917592014798,-79.05,IS,0.09,0.0,Phase3-EA-B1v1-GBPJPY-M30-1,GBPJPYMT4,740,2d 14h 29m,Buy
95484.18,1.20602,07.02.2012 07:20:00,,-1.07,-82.78999999997905,0.0,0.0,1.20608,06.02.2012 23:00:00,7594,-0.04461462080238682,-3.74,IS,0.41,0.0,Phase3-EA-SA2v2-EURCHF-M5-43,EURCHFMT4,4106,8h 20m,Buy
95632.1,100874,07.02.2012 10:59:58,tp 100.874,-3.48,-0.0,0.0,0.0,99584,01.02.2012 12:00:00,7595,-0.0,147.92,IS,0.09,0.0,Phase3-EA-TR1v1-EURJPY-M30-91,EURJPYMT4,1220,5d 22h 59m,Buy
95680.57,1.20729,07.02.2012 12:30:00,,0.0,-0.0,0.0,0.0,1.20598,07.02.2012 03:45:00,7596,-0.0,48.47,IS,0.34,0.0,Phase3-EA-S4v1-EURCHF-M15-221,EURCHFMT4,1930,8h 45m,Buy
95589.1,101464,07.02.2012 18:29:58,sl 101.464,0.0,-91.47000000000116,0.0,0.0,100684,07.02.2012 15:00:00,7597,-0.04926202025338515,-91.47,IS,0.09,0.0,Phase3-EA-TR1v1-EURJPY-M30-91,EURJPYMT4,1222,3h 29m,Sell
95638.51,1.20872,07.02.2012 23:44:57,tp 1.20872,0.0,-42.05999999999767,0.0,0.0,1.20982,07.02.2012 21:15:00,7598,-0.02265180465570393,49.41,IS,0.41,0.0,Phase3-EA-SA2v2-EURCHF-M5-43,EURCHFMT4,4108,2h 29m,Sell
96012.52,102223,08.02.2012 08:59:58,tp 102.223,-1.09,-0.0,0.0,0.0,100523,07.02.2012 08:45:00,7599,-0.0,374.01,IS,0.17,0.0,Phase3-EA-T1v2-EURJPY-M15-322,EURJPYMT4,1146,1d 0h 14m,Buy
96161.57,1.21251,08.02.2012 11:29:58,tp 1.21251,0.0,-0.0,0.0,0.0,1.20851,08.02.2012 02:45:00,7600,-0.0,149.05,IS,0.34,0.0,Phase3-EA-S4v1-EURCHF-M15-221,EURCHFMT4,1932,8h 44m,Buy
96083.22,121945,08.02.2012 15:29:58,sl 121.945,0.0,-78.35000000000582,0.0,0.0,122615,08.02.2012 10:30:00,7601,-0.0420870967085235,-78.35,IS,0.09,0.0,Phase3-EA-B1v1-GBPJPY-M30-1,GBPJPYMT4,742,4h 59m,Buy
96029.21,101995,09.02.2012 02:14:58,sl 101.995,-3.25,-132.36000000001513,0.0,0.0,102225,08.02.2012 21:30:00,7602,-0.0710995292959846,-54.01,IS,0.17,0.0,Phase3-EA-T1v2-EURJPY-M15-322,EURJPYMT4,1148,4h 44m,Buy
96040.93,1.2101,09.02.2012 09:15:00,,0.0,-120.64000000001397,0.0,0.0,1.20984,09.02.2012 00:55:00,7603,-0.0648039227430311,11.72,IS,0.41,0.0,Phase3-EA-SA2v2-EURCHF-M5-43,EURCHFMT4,4110,8h 20m,Buy
95948.7,102557,09.02.2012 09:29:58,sl 102.557,-1.23,-212.87000000002445,0.0,0.0,101777,08.02.2012 01:30:00,7604,-0.11434690844089038,-92.23,IS,0.09,0.0,Phase3-EA-TR1v1-EURJPY-M30-91,EURJPYMT4,1224,1d 7h 59m,Sell
95916.07,0.91186,10.02.2012 02:15:00,,-3.37,-245.5000000000291,0.0,0.0,0.9114,09.02.2012 22:00:00,7605,-0.13187469357936155,-32.63,IS,0.58,0.0,Phase3-EA-SA2v2-USDCHF-M15-107,USDCHFMT4,1500,4h 15m,Sell
95979.72,0.91129,10.02.2012 03:59:58,tp 0.91129,0.0,-181.85000000003492,0.0,0.0,0.91229,10.02.2012 02:30:00,7606,-0.09768396345176643,63.65,IS,0.58,0.0,Phase3-EA-SA2v2-USDCHF-M15-107,USDCHFMT4,1502,1h 29m,Sell
95972.79,1.21049,10.02.2012 04:30:00,,-1.08,-188.78000000002794,0.0,0.0,1.21062,09.02.2012 20:10:00,7607,-0.10140653626848312,-6.93,IS,0.41,0.0,Phase3-EA-SA2v2-EURCHF-M5-43,EURCHFMT4,4112,8h 20m,Buy
95928.04,122573,10.02.2012 07:45:00,,0.0,-233.53000000002794,0.0,0.0,122724,10.02.2012 02:20:00,7608,-0.12544479507775289,-44.75,IS,0.23,0.0,Phase3-EA-S4v1-GBPJPY-M5-194,GBPJPYMT4,1804,5h 25m,Buy
95891.56,1.20976,10.02.2012 13:30:00,,0.0,-270.0100000000384,0.0,0.0,1.21074,10.02.2012 04:45:00,7609,-0.1450406762255163,-36.48,IS,0.34,0.0,Phase3-EA-S4v1-EURCHF-M15-221,EURCHFMT4,1934,8h 45m,Buy
95888.52,102707,10.02.2012 15:15:00,,-1.07,-273.05000000004657,0.0,0.0,102716,09.02.2012 17:00:00,7610,-0.14667366632116718,-3.04,IS,0.17,0.0,Phase3-EA-T1v2-EURJPY-M15-322,EURJPYMT4,1150,22h 15m,Buy
95912.11,1.20965,13.02.2012 05:10:00,,-1.07,-249.46000000005006,0.0,0.0,1.2091,10.02.2012 20:50:00,7611,-0.1340018780460702,23.59,IS,0.41,0.0,Phase3-EA-SA2v2-EURCHF-M5-43,EURCHFMT4,4114,2d 8h 20m,Buy
95931.87,1.20924,13.02.2012 13:00:00,,0.0,-229.70000000004075,0.0,0.0,1.20977,13.02.2012 04:15:00,7612,-0.12338744242436304,19.76,IS,0.34,0.0,Phase3-EA-S4v1-EURCHF-M15-221,EURCHFMT4,1936,8h 45m,Sell
95790.75,0.91783,14.02.2012 03:45:00,,-3.36,-370.8200000000361,0.0,0.0,0.91565,13.02.2012 23:30:00,7613,-0.19919256160121307,-141.12,IS,0.58,0.0,Phase3-EA-SA2v2-USDCHF-M15-107,USDCHFMT4,1504,4h 15m,Sell
95837.65,1.20775,14.02.2012 04:34:58,tp 1.20775,-2.24,-323.9200000000419,0.0,0.0,1.20885,13.02.2012 21:20:00,7614,-0.17399939203351222,46.9,IS,0.41,0.0,Phase3-EA-SA2v2-EURCHF-M5-43,EURCHFMT4,4116,7h 14m,Sell
95953.07,122208,14.02.2012 06:59:59,tp 122.208,0.0,-208.5000000000291,0.0,0.0,121818,14.02.2012 02:25:00,7615,-0.11199948517840105,115.42,IS,0.23,0.0,Phase3-EA-S4v1-GBPJPY-M5-194,GBPJPYMT4,1806,4h 34m,Buy
95935.68,1.20792,14.02.2012 10:30:00,,0.0,-225.89000000004307,0.0,0.0,1.20839,14.02.2012 01:45:00,7616,-0.12134083312685999,-17.39,IS,0.34,0.0,Phase3-EA-S4v1-EURCHF-M15-221,EURCHFMT4,1938,8h 45m,Buy
96196.15,1.56862,14.02.2012 18:29:58,tp 1.56862,-4.13,-0.0,0.0,0.0,1.58752,08.02.2012 14:00:00,7617,-0.0,260.47,IS,0.14,0.0,Phase3-EA-B1v1-GBPUSD-M30-14,GBPUSDMT4,506,6d 4h 29m,Sell
96224.01,78492,15.02.2012 04:00:00,,0.0,-0.0,0.0,0.0,78411,15.02.2012 00:30:00,7618,-0.0,27.86,IS,0.27,0.0,Phase3-EA-S1v2-USDJPY-M15-0,USDJPYMT4,2250,3h 30m,Buy
96222.49,1.2074,15.02.2012 05:20:00,,-1.07,-1.5199999999895226,0.0,0.0,1.20741,14.02.2012 21:00:00,7619,-8.162212810203798E-4,-1.52,IS,0.41,0.0,Phase3-EA-SA2v2-EURCHF-M5-43,EURCHFMT4,4118,8h 20m,Buy
96172.71,102705,15.02.2012 16:14:58,sl 102.705,0.0,-51.29999999998836,0.0,0.0,102935,15.02.2012 01:15:00,7620,-0.027547468234621453,-49.78,IS,0.17,0.0,Phase3-EA-T1v2-EURJPY-M15-322,EURJPYMT4,1152,14h 59m,Buy
96225.67,0.92131,16.02.2012 01:14:57,tp 0.92131,-9.99,-0.0,0.0,0.0,0.92231,15.02.2012 22:30:00,7621,-0.0,52.96,IS,0.58,0.0,Phase3-EA-SA2v2-USDCHF-M15-107,USDCHFMT4,1506,2h 44m,Sell
96218.93,1.20643,16.02.2012 06:35:00,,-3.2,-6.739999999990687,0.0,0.0,1.20651,15.02.2012 22:15:00,7622,-0.0036192647340136702,-6.74,IS,0.41,0.0,Phase3-EA-SA2v2-EURCHF-M5-43,EURCHFMT4,4120,8h 20m,Buy
96202.22,78378,16.02.2012 07:15:00,,-4.65,-23.449999999982538,0.0,0.0,78343,15.02.2012 22:15:00,7623,-0.012592248963304844,-16.71,IS,0.27,0.0,Phase3-EA-S1v2-USDJPY-M15-0,USDJPYMT4,2252,9h 0m,Sell
96340.25,103583,16.02.2012 22:59:59,tp 103.583,-5.68,-0.0,0.0,0.0,102323,08.02.2012 09:30:00,7624,-0.0,138.03,IS,0.09,0.0,Phase3-EA-TR1v1-EURJPY-M30-91,EURJPYMT4,1225,8d 13h 29m,Buy
96357.16,0.9191,17.02.2012 03:00:00,,-0.76,-0.0,0.0,0.0,0.91882,16.02.2012 22:45:00,7625,-0.0,16.91,IS,0.58,0.0,Phase3-EA-SA2v2-USDCHF-M15-107,USDCHFMT4,1508,4h 15m,Buy
96338.7,1.20666,17.02.2012 06:40:00,,-1.07,-18.45999999999185,0.0,0.0,1.20705,16.02.2012 22:20:00,7626,-0.009905710089159879,-18.46,IS,0.41,0.0,Phase3-EA-SA2v2-EURCHF-M5-43,EURCHFMT4,4122,8h 20m,Buy
96352.0,1.20721,17.02.2012 09:45:00,,0.0,-5.1600000000034925,0.0,0.0,1.20685,17.02.2012 01:00:00,7627,-0.0027688767096490864,13.3,IS,0.34,0.0,Phase3-EA-S4v1-EURCHF-M15-221,EURCHFMT4,1940,8h 45m,Buy
96401.08,1.20839,17.02.2012 21:34:59,tp 1.20839,0.0,-0.0,0.0,0.0,1.20729,17.02.2012 20:10:00,7628,-0.0,49.08,IS,0.41,0.0,Phase3-EA-SA2v2-EURCHF-M5-43,EURCHFMT4,4124,1h 24m,Buy
96542.54,104933,20.02.2012 02:00:00,tp 104.933,-1.11,-0.0,0.0,0.0,103673,16.02.2012 23:00:00,7629,-0.0,141.46,IS,0.09,0.0,Phase3-EA-TR1v1-EURJPY-M30-91,EURJPYMT4,1228,3d 3h 0m,Buy
96750.94,126678,20.02.2012 02:29:57,tp 126.678,-0.41,-0.0,0.0,0.0,124828,17.02.2012 04:00:00,7630,-0.0,208.4,IS,0.09,0.0,Phase3-EA-B1v1-GBPJPY-M30-1,GBPJPYMT4,744,2d 22h 29m,Buy
96863.64,126289,20.02.2012 04:09:58,tp 126.289,0.0,-0.0,0.0,0.0,126679,20.02.2012 02:30:00,7631,-0.0,112.7,IS,0.23,0.0,Phase3-EA-S4v1-GBPJPY-M5-194,GBPJPYMT4,1808,1h 39m,Sell
96837.67,1.20903,20.02.2012 06:00:00,,-2.23,-25.970000000001164,0.0,0.0,1.2085,17.02.2012 21:40:00,7632,-0.01389783480617263,-25.97,IS,0.41,0.0,Phase3-EA-SA2v2-EURCHF-M5-43,EURCHFMT4,4126,2d 8h 20m,Sell
96883.41,1.20836,20.02.2012 12:45:00,,0.0,-0.0,0.0,0.0,1.20959,20.02.2012 04:00:00,7633,-0.0,45.74,IS,0.34,0.0,Phase3-EA-S4v1-EURCHF-M15-221,EURCHFMT4,1942,8h 45m,Sell
96841.41,1.58465,20.02.2012 17:59:58,sl 1.58465,0.0,-42.0,0.0,0.0,1.58765,20.02.2012 14:30:00,7634,-0.02247390498707185,-42.0,IS,0.14,0.0,Phase3-EA-B1v1-GBPUSD-M30-14,GBPUSDMT4,508,3h 29m,Buy
96829.26,105127,21.02.2012 02:30:00,,-1.05,-54.14999999999418,0.0,0.0,105179,20.02.2012 13:30:00,7635,-0.028975284644043094,-12.15,IS,0.17,0.0,Phase3-EA-T1v2-EURJPY-M15-322,EURJPYMT4,1154,13h 0m,Buy
96941.74,126351,21.02.2012 05:54:57,tp 126.351,0.0,-0.0,0.0,0.0,125961,21.02.2012 02:35:00,7636,-0.0,112.48,IS,0.23,0.0,Phase3-EA-S4v1-GBPJPY-M5-194,GBPJPYMT4,1810,3h 19m,Buy
96936.16,1.20692,21.02.2012 06:55:00,,-1.08,-5.579999999987194,0.0,0.0,1.20702,20.02.2012 22:35:00,7637,-0.0029848871632344844,-5.58,IS,0.41,0.0,Phase3-EA-SA2v2-EURCHF-M5-43,EURCHFMT4,4128,8h 20m,Buy
96946.23,1.20713,21.02.2012 10:45:00,,0.0,-0.0,0.0,0.0,1.20686,21.02.2012 02:00:00,7638,-0.0,10.07,IS,0.34,0.0,Phase3-EA-S4v1-EURCHF-M15-221,EURCHFMT4,1944,8h 45m,Buy
96897.18,105591,21.02.2012 21:14:57,sl 105.591,0.0,-49.04999999998836,0.0,0.0,105821,21.02.2012 19:15:00,7639,-0.02623749085498449,-49.05,IS,0.17,0.0,Phase3-EA-T1v2-EURJPY-M15-322,EURJPYMT4,1156,1h 59m,Buy
96944.39,1.20719,22.02.2012 00:34:58,tp 1.20719,-2.25,-1.8399999999965075,0.0,0.0,1.20829,21.02.2012 20:50:00,7640,-9.842402277898325E-4,47.21,IS,0.41,0.0,Phase3-EA-SA2v2-EURCHF-M5-43,EURCHFMT4,4130,3h 44m,Sell
96895.43,105559,22.02.2012 04:14:58,sl 105.559,0.0,-50.79999999998836,0.0,0.0,105789,22.02.2012 03:00:00,7641,-0.027173588897721163,-48.96,IS,0.17,0.0,Phase3-EA-T1v2-EURJPY-M15-322,EURJPYMT4,1158,1h 14m,Buy
96795.4,126254,22.02.2012 08:10:00,,0.0,-150.8299999999872,0.0,0.0,125906,22.02.2012 02:45:00,7642,-0.0806809530205487,-100.03,IS,0.23,0.0,Phase3-EA-S4v1-GBPJPY-M5-194,GBPJPYMT4,1812,5h 25m,Sell
96807.09,1.20751,22.02.2012 09:05:00,,0.0,-139.13999999998487,0.0,0.0,1.20725,22.02.2012 00:45:00,7643,-0.07442781809506649,11.69,IS,0.41,0.0,Phase3-EA-SA2v2-EURCHF-M5-43,EURCHFMT4,4132,8h 20m,Buy
96816.79,1.20754,22.02.2012 09:45:00,,0.0,-129.43999999997322,0.0,0.0,1.20728,22.02.2012 01:00:00,7644,-0.06923916037246271,9.7,IS,0.34,0.0,Phase3-EA-S4v1-EURCHF-M15-221,EURCHFMT4,1946,8h 45m,Buy
96774.79,1.58093,22.02.2012 10:59:58,sl 1.58093,0.0,-171.43999999997322,0.0,0.0,1.57793,22.02.2012 03:30:00,7645,-0.09170551339814284,-42.0,IS,0.14,0.0,Phase3-EA-B1v1-GBPUSD-M30-14,GBPUSDMT4,510,7h 29m,Sell
96686.17,106035,22.02.2012 10:59:58,sl 106.035,-0.8,-260.05999999996857,0.0,0.0,105255,20.02.2012 04:00:00,7646,-0.1391095182823254,-88.62,IS,0.09,0.0,Phase3-EA-TR1v1-EURJPY-M30-91,EURJPYMT4,1230,2d 6h 59m,Sell
96662.16,125636,23.02.2012 04:30:00,,-3.09,-284.0699999999779,0.0,0.0,125709,22.02.2012 23:05:00,7647,-0.15195278342867752,-24.01,IS,0.23,0.0,Phase3-EA-S4v1-GBPJPY-M5-194,GBPJPYMT4,1814,5h 25m,Buy
96626.5,1.20563,23.02.2012 04:35:00,,-3.24,-319.7299999999814,0.0,0.0,1.20635,22.02.2012 20:15:00,7648,-0.17102778697381638,-35.66,IS,0.41,0.0,Phase3-EA-SA2v2-EURCHF-M5-43,EURCHFMT4,4134,8h 20m,Buy
96612.61,1.20533,23.02.2012 13:30:00,,0.0,-333.61999999999534,0.0,0.0,1.2057,23.02.2012 04:45:00,7649,-0.17845773086731664,-13.89,IS,0.34,0.0,Phase3-EA-S4v1-EURCHF-M15-221,EURCHFMT4,1948,8h 45m,Buy
96523.27,107045,24.02.2012 04:29:58,sl 107.045,-1.57,-422.95999999999185,0.0,0.0,106265,22.02.2012 23:30:00,7650,-0.22624687323194007,-89.34,IS,0.09,0.0,Phase3-EA-TR1v1-EURJPY-M30-91,EURJPYMT4,1232,1d 4h 59m,Sell
96536.47,1.20528,24.02.2012 05:10:00,,-2.27,-409.7599999999802,0.0,0.0,1.20562,23.02.2012 20:50:00,7651,-0.21918601942386293,13.2,IS,0.41,0.0,Phase3-EA-SA2v2-EURCHF-M5-43,EURCHFMT4,4136,8h 20m,Sell
96569.79,1.20457,24.02.2012 15:00:00,,0.0,-376.4399999999732,0.0,0.0,1.20545,24.02.2012 06:15:00,7652,-0.20136271269015296,33.32,IS,0.34,0.0,Phase3-EA-S4v1-EURCHF-M15-221,EURCHFMT4,1950,8h 45m,Sell
96927.48,108.08,24.02.2012 15:29:58,tp 108.080,-1.04,-18.749999999970896,0.0,0.0,106.38,23.02.2012 09:15:00,7653,-0.010029621886448773,357.69,IS,0.17,0.0,Phase3-EA-T1v2-EURJPY-M15-322,EURJPYMT4,1160,1d 6h 14m,Buy
97068.09,108695,24.02.2012 18:29:58,tp 108.695,0.0,-0.0,0.0,0.0,107435,24.02.2012 08:30:00,7654,-0.0,140.61,IS,0.09,0.0,Phase3-EA-TR1v1-EURJPY-M30-91,EURJPYMT4,1234,9h 59m,Buy
97272.77,129436,27.02.2012 02:00:00,tp 129.436,-0.4,-0.0,0.0,0.0,127586,24.02.2012 17:00:00,7655,-0.0,204.68,IS,0.09,0.0,Phase3-EA-B1v1-GBPJPY-M30-1,GBPJPYMT4,746,2d 9h 0m,Buy
97044.47,129354,27.02.2012 02:00:00,sl 129.354,-1.65,-228.29999999998836,0.0,0.0,128554,24.02.2012 23:10:00,7656,-0.12190773917638317,-228.3,IS,0.23,0.0,Phase3-EA-S4v1-GBPJPY-M5-194,GBPJPYMT4,1816,2d 2h 50m,Sell
97154.63,129.15,27.02.2012 03:09:58,tp 129.150,0.0,-118.13999999998487,0.0,0.0,129.54,27.02.2012 02:20:00,7657,-0.06308445162635479,110.16,IS,0.23,0.0,Phase3-EA-S4v1-GBPJPY-M5-194,GBPJPYMT4,1818,49m 58s,Sell
97186.04,1.20484,27.02.2012 05:05:00,,-1.1,-86.72999999998137,0.0,0.0,1.20413,24.02.2012 20:45:00,7658,-0.046312125355961374,31.41,IS,0.41,0.0,Phase3-EA-SA2v2-EURCHF-M5-43,EURCHFMT4,4138,2d 8h 20m,Buy
97107.7,0.89585,27.02.2012 06:30:00,,0.0,-165.06999999997788,0.0,0.0,0.89464,27.02.2012 02:15:00,7659,-0.08814415464671004,-78.34,IS,0.58,0.0,Phase3-EA-SA2v2-USDCHF-M15-107,USDCHFMT4,1510,4h 15m,Sell
97091.26,128679,27.02.2012 09:05:00,,0.0,-181.5099999999802,0.0,0.0,128737,27.02.2012 03:40:00,7660,-0.09692279342051698,-16.44,IS,0.23,0.0,Phase3-EA-S4v1-GBPJPY-M5-194,GBPJPYMT4,1820,5h 25m,Buy
97010.43,108022,27.02.2012 12:59:57,sl 108.022,-0.54,-262.3399999999674,0.0,0.0,108742,24.02.2012 18:30:00,7661,-0.14008443405838816,-80.83,IS,0.09,0.0,Phase3-EA-TR1v1-EURJPY-M30-91,EURJPYMT4,1236,2d 18h 29m,Buy
96998.32,1.20513,27.02.2012 13:45:00,,0.0,-274.44999999995343,0.0,0.0,1.20481,27.02.2012 05:00:00,7662,-0.14655093743738234,-12.11,IS,0.34,0.0,Phase3-EA-S4v1-EURCHF-M15-221,EURCHFMT4,1952,8h 45m,Sell
97109.91,127125,28.02.2012 03:44:59,tp 127.125,0.0,-162.85999999995693,0.0,0.0,127515,28.02.2012 01:00:00,7663,-0.08696405782856559,111.59,IS,0.23,0.0,Phase3-EA-S4v1-GBPJPY-M5-194,GBPJPYMT4,1822,2h 44m,Sell
97113.57,1.20522,28.02.2012 07:35:00,,-2.28,-159.19999999995343,0.0,0.0,1.20535,27.02.2012 23:15:00,7664,-0.0850096893424245,3.66,IS,0.41,0.0,Phase3-EA-SA2v2-EURCHF-M5-43,EURCHFMT4,4140,8h 20m,Sell
97064.83,107802,28.02.2012 07:59:58,sl 107.802,0.0,-207.93999999994412,0.0,0.0,107572,28.02.2012 04:15:00,7665,-0.11103589699663424,-48.74,IS,0.17,0.0,Phase3-EA-T1v2-EURJPY-M15-322,EURJPYMT4,1162,3h 44m,Sell
97176.37,127505,28.02.2012 08:49:57,tp 127.505,0.0,-96.39999999993597,0.0,0.0,127115,28.02.2012 03:55:00,7666,-0.05147571641084595,111.54,IS,0.23,0.0,Phase3-EA-S4v1-GBPJPY-M5-194,GBPJPYMT4,1824,4h 54m,Buy
97210.84,1.20572,28.02.2012 10:15:00,,0.0,-61.92999999993481,0.0,0.0,1.20481,28.02.2012 01:30:00,7667,-0.03306940993073083,34.47,IS,0.34,0.0,Phase3-EA-S4v1-EURCHF-M15-221,EURCHFMT4,1954,8h 45m,Buy
97130.08,108522,28.02.2012 11:29:58,sl 108.522,-0.39,-142.68999999994412,0.0,0.0,107802,27.02.2012 16:00:00,7668,-0.07619367193636527,-80.76,IS,0.09,0.0,Phase3-EA-TR1v1-EURJPY-M30-91,EURJPYMT4,1238,19h 29m,Sell
97053.9,128268,29.02.2012 03:59:58,sl 128.268,-1.3,-218.86999999993714,0.0,0.0,127598,27.02.2012 15:30:00,7669,-0.1168723034320135,-76.18,IS,0.09,0.0,Phase3-EA-B1v1-GBPJPY-M30-1,GBPJPYMT4,748,1d 12h 29m,Sell
96944.4,128301,29.02.2012 04:30:00,,-1.66,-328.36999999993714,0.0,0.0,127923,28.02.2012 23:05:00,7670,-0.17534316387798213,-109.5,IS,0.23,0.0,Phase3-EA-S4v1-GBPJPY-M5-194,GBPJPYMT4,1826,5h 25m,Sell
96957.97,1.20516,29.02.2012 06:30:00,,-1.1,-314.79999999993015,0.0,0.0,1.20484,28.02.2012 22:10:00,7671,-0.16809704902636383,13.57,IS,0.41,0.0,Phase3-EA-SA2v2-EURCHF-M5-43,EURCHFMT4,4142,8h 20m,Buy
96927.08,108157,29.02.2012 09:15:00,,-1.04,-345.6899999999441,0.0,0.0,108298,28.02.2012 21:00:00,7672,-0.18459170545720208,-30.89,IS,0.17,0.0,Phase3-EA-T1v2-EURJPY-M15-322,EURJPYMT4,1164,12h 15m,Buy
96878.56,108232,29.02.2012 13:29:58,sl 108.232,0.0,-394.20999999993364,0.0,0.0,108462,29.02.2012 13:15:00,7673,-0.21050043741005858,-48.52,IS,0.17,0.0,Phase3-EA-T1v2-EURJPY-M15-322,EURJPYMT4,1166,14m 58s,Buy
96830.47,108351,29.02.2012 23:59:58,sl 108.351,0.0,-442.29999999993015,0.0,0.0,108121,29.02.2012 21:45:00,7674,-0.23617955776482047,-48.09,IS,0.17,0.0,Phase3-EA-T1v2-EURJPY-M15-322,EURJPYMT4,1168,2h 14m,Sell
96941.18,128941,01.03.2012 07:14:57,tp 128.941,0.0,-331.5899999999383,0.0,0.0,129331,01.03.2012 01:50:00,7675,-0.17706258096141672,110.71,IS,0.23,0.0,Phase3-EA-S4v1-GBPJPY-M5-194,GBPJPYMT4,1828,5h 24m,Sell
96943.45,1.20503,01.03.2012 08:35:00,,0.0,-329.3199999999488,0.0,0.0,1.20498,01.03.2012 00:15:00,7676,-0.17585044531564745,2.27,IS,0.41,0.0,Phase3-EA-SA2v2-EURCHF-M5-43,EURCHFMT4,4144,8h 20m,Buy
96940.44,1.20548,01.03.2012 15:00:00,,0.0,-332.3299999999581,0.0,0.0,1.2054,01.03.2012 06:15:00,7677,-0.17745772650234068,-3.01,IS,0.34,0.0,Phase3-EA-S4v1-EURCHF-M15-221,EURCHFMT4,1956,8h 45m,Sell
96891.52,108197,02.03.2012 03:29:57,sl 108.197,-0.73,-381.2499999999709,0.0,0.0,107967,01.03.2012 21:30:00,7678,-0.20358005063948711,-48.92,IS,0.17,0.0,Phase3-EA-T1v2-EURJPY-M15-322,EURJPYMT4,1170,5h 59m,Sell
96862.09,1.20606,02.03.2012 04:40:00,,-2.26,-410.6799999999639,0.0,0.0,1.20546,01.03.2012 20:20:00,7679,-0.21929509559770125,-29.43,IS,0.41,0.0,Phase3-EA-SA2v2-EURCHF-M5-43,EURCHFMT4,4146,8h 20m,Sell
96786.43,129883,02.03.2012 08:55:00,,0.0,-486.3399999999674,0.0,0.0,129615,02.03.2012 03:30:00,7680,-0.2596960572537943,-75.66,IS,0.23,0.0,Phase3-EA-S4v1-GBPJPY-M5-194,GBPJPYMT4,1830,5h 25m,Sell
96813.73,1.20538,02.03.2012 13:30:00,,0.0,-459.03999999997905,0.0,0.0,1.20611,02.03.2012 04:45:00,7681,-0.2451183906768604,27.3,IS,0.34,0.0,Phase3-EA-S4v1-EURCHF-M15-221,EURCHFMT4,1958,8h 45m,Sell
96863.09,1.20684,02.03.2012 20:44:58,tp 1.20684,0.0,-409.679999999993,0.0,0.0,1.20574,02.03.2012 20:00:00,7682,-0.218761115137023,49.36,IS,0.41,0.0,Phase3-EA-SA2v2-EURCHF-M5-43,EURCHFMT4,4148,44m 58s,Buy
96971.37,129145,05.03.2012 03:04:57,tp 129.145,-1.63,-301.3999999999942,0.0,0.0,129535,02.03.2012 23:40:00,7683,-0.1609417108531014,108.28,IS,0.23,0.0,Phase3-EA-S4v1-GBPJPY-M5-194,GBPJPYMT4,1832,2d 3h 24m,Sell
96923.48,107.96,05.03.2012 04:59:58,sl 107.960,0.0,-349.29000000000815,0.0,0.0,107.73,05.03.2012 03:30:00,7684,-0.18651403511573386,-47.89,IS,0.17,0.0,Phase3-EA-T1v2-EURJPY-M15-322,EURJPYMT4,1172,1h 29m,Sell
96914.19,1.20579,05.03.2012 13:00:00,,0.0,-358.5800000000163,0.0,0.0,1.20604,05.03.2012 04:15:00,7685,-0.1914747135955834,-9.29,IS,0.34,0.0,Phase3-EA-S4v1-EURCHF-M15-221,EURCHFMT4,1960,8h 45m,Buy
96840.04,128.98,05.03.2012 16:29:57,sl 128.980,0.0,-432.7300000000105,0.0,0.0,128.31,05.03.2012 12:30:00,7686,-0.2310693647560239,-74.15,IS,0.09,0.0,Phase3-EA-B1v1-GBPJPY-M30-1,GBPJPYMT4,750,3h 59m,Sell
96866.89,81457,05.03.2012 23:45:00,,0.0,-405.88000000000466,0.0,0.0,81376,05.03.2012 20:45:00,7687,-0.21673198938639288,26.85,IS,0.27,0.0,Phase3-EA-S1v2-USDJPY-M15-0,USDJPYMT4,2254,3h 0m,Buy
96977.14,128996,06.03.2012 06:20:00,tp 128.996,0.0,-295.63000000000466,0.0,0.0,129386,06.03.2012 02:35:00,7688,-0.1578606435949039,110.25,IS,0.23,0.0,Phase3-EA-S4v1-GBPJPY-M5-194,GBPJPYMT4,1834,3h 45m,Sell
96964.84,1.20537,06.03.2012 07:10:00,,-1.08,-307.929999999993,0.0,0.0,1.20562,05.03.2012 22:50:00,7689,-0.16442860326143116,-12.3,IS,0.41,0.0,Phase3-EA-SA2v2-EURCHF-M5-43,EURCHFMT4,4150,8h 20m,Buy
96877.77,106626,06.03.2012 12:59:58,sl 106.626,-0.54,-395.0,0.0,0.0,107406,05.03.2012 16:00:00,7690,-0.2109222819740421,-87.07,IS,0.09,0.0,Phase3-EA-TR1v1-EURJPY-M30-91,EURJPYMT4,1240,20h 59m,Buy
96887.79,1.20582,06.03.2012 13:15:00,,0.0,-384.9800000000105,0.0,0.0,1.20555,06.03.2012 04:30:00,7691,-0.20557179775789602,10.02,IS,0.34,0.0,Phase3-EA-S4v1-EURCHF-M15-221,EURCHFMT4,1962,8h 45m,Buy
97244.06,106057,06.03.2012 18:29:58,tp 106.057,-0.73,-28.710000000020955,0.0,0.0,107757,05.03.2012 07:00:00,7692,-0.01533057902652954,356.27,IS,0.17,0.0,Phase3-EA-T1v2-EURJPY-M15-322,EURJPYMT4,1174,1d 11h 29m,Sell
97507.28,1.57339,06.03.2012 19:29:58,tp 1.57339,-1.38,-0.0,0.0,0.0,1.59229,02.03.2012 10:30:00,7693,-0.0,263.22,IS,0.14,0.0,Phase3-EA-B1v1-GBPUSD-M30-14,GBPUSDMT4,512,4d 8h 59m,Sell
97543.95,80631,07.03.2012 03:00:00,,-1.5,-0.0,0.0,0.0,80745,06.03.2012 23:00:00,7694,-0.0,36.67,IS,0.27,0.0,Phase3-EA-S1v2-USDJPY-M15-0,USDJPYMT4,2256,4h 0m,Sell
97654.92,127264,07.03.2012 04:34:58,tp 127.264,0.0,-0.0,0.0,0.0,126874,07.03.2012 02:05:00,7695,-0.0,110.97,IS,0.23,0.0,Phase3-EA-S4v1-GBPJPY-M5-194,GBPJPYMT4,1836,2h 29m,Buy
97671.72,1.20534,07.03.2012 04:55:00,,-1.07,-0.0,0.0,0.0,1.20494,06.03.2012 20:35:00,7696,-0.0,16.8,IS,0.41,0.0,Phase3-EA-SA2v2-EURCHF-M5-43,EURCHFMT4,4152,8h 20m,Buy
97623.24,106.08,07.03.2012 12:29:58,sl 106.080,0.0,-48.48000000001048,0.0,0.0,105.85,07.03.2012 12:00:00,7697,-0.025832341708175527,-48.48,IS,0.17,0.0,Phase3-EA-T1v2-EURJPY-M15-322,EURJPYMT4,1176,29m 58s,Sell
97609.52,1.20544,07.03.2012 12:30:00,,0.0,-62.20000000001164,0.0,0.0,1.20507,07.03.2012 03:45:00,7698,-0.033142979666841405,-13.72,IS,0.34,0.0,Phase3-EA-S4v1-EURCHF-M15-221,EURCHFMT4,1964,8h 45m,Sell
97561.07,105992,07.03.2012 14:14:58,sl 105.992,0.0,-110.65000000002328,0.0,0.0,106222,07.03.2012 13:45:00,7699,-0.05895933601504963,-48.45,IS,0.17,0.0,Phase3-EA-T1v2-EURJPY-M15-322,EURJPYMT4,1178,29m 58s,Buy
97512.71,106261,07.03.2012 16:59:58,sl 106.261,0.0,-159.0100000000093,0.0,0.0,106031,07.03.2012 15:00:00,7700,-0.08472773628334042,-48.36,IS,0.17,0.0,Phase3-EA-T1v2-EURJPY-M15-322,EURJPYMT4,1180,1h 59m,Sell
97464.32,106231,07.03.2012 19:14:58,sl 106.231,0.0,-207.40000000002328,0.0,0.0,106001,07.03.2012 18:30:00,7701,-0.11051212191161403,-48.39,IS,0.17,0.0,Phase3-EA-T1v2-EURJPY-M15-322,EURJPYMT4,1182,44m 58s,Sell
97550.95,81345,08.03.2012 03:00:00,,0.0,-120.77000000001863,0.0,0.0,81084,08.03.2012 01:00:00,7702,-0.06435173077756116,86.63,IS,0.27,0.0,Phase3-EA-S1v2-USDJPY-M15-0,USDJPYMT4,2258,2h 0m,Buy
97558.55,1.20516,08.03.2012 04:25:00,,-6.71,-113.1700000000128,0.0,0.0,1.20548,07.03.2012 20:05:00,7703,-0.060302106252349906,7.6,IS,0.41,0.0,Phase3-EA-SA2v2-EURCHF-M5-43,EURCHFMT4,4154,8h 20m,Sell
97477.2,107.04,08.03.2012 06:59:58,sl 107.040,-1.55,-194.52000000001863,0.0,0.0,106.32,06.03.2012 14:00:00,7704,-0.10364907403204825,-81.35,IS,0.09,0.0,Phase3-EA-TR1v1-EURJPY-M30-91,EURJPYMT4,1242,1d 16h 59m,Sell
97400.49,128134,08.03.2012 08:59:58,sl 128.134,-2.58,-271.2300000000105,0.0,0.0,127464,06.03.2012 18:00:00,7705,-0.1445236394700331,-76.71,IS,0.09,0.0,Phase3-EA-B1v1-GBPJPY-M30-1,GBPJPYMT4,752,1d 14h 59m,Sell
97751.99,108.13,08.03.2012 14:59:58,tp 108.130,-3.08,-0.0,0.0,0.0,106.43,07.03.2012 19:15:00,7706,-0.0,351.5,IS,0.17,0.0,Phase3-EA-T1v2-EURJPY-M15-322,EURJPYMT4,1184,19h 44m,Buy
97791.67,81649,08.03.2012 22:00:00,,0.0,-0.0,0.0,0.0,81529,08.03.2012 17:15:00,7707,-0.0,39.68,IS,0.27,0.0,Phase3-EA-S1v2-USDJPY-M15-0,USDJPYMT4,2260,4h 45m,Buy
97820.44,81.64,09.03.2012 05:00:00,,0.0,-0.0,0.0,0.0,81553,09.03.2012 01:30:00,7708,-0.0,28.77,IS,0.27,0.0,Phase3-EA-S1v2-USDJPY-M15-0,USDJPYMT4,2262,3h 30m,Buy
97958.8,108461,09.03.2012 05:29:57,tp 108.461,-0.54,-0.0,0.0,0.0,107201,08.03.2012 09:30:00,7709,-0.0,138.36,IS,0.09,0.0,Phase3-EA-TR1v1-EURJPY-M30-91,EURJPYMT4,1244,19h 59m,Buy
97955.68,1.2057,12.03.2012 04:25:00,,-2.23,-3.1199999999953434,0.0,0.0,1.20568,09.03.2012 20:05:00,7710,-0.001659938241782422,-3.12,IS,0.41,0.0,Phase3-EA-SA2v2-EURCHF-M5-43,EURCHFMT4,4156,2d 8h 20m,Sell
97986.98,128907,12.03.2012 09:15:00,,0.0,-0.0,0.0,0.0,128795,12.03.2012 03:50:00,7711,-0.0,31.3,IS,0.23,0.0,Phase3-EA-S4v1-GBPJPY-M5-194,GBPJPYMT4,1838,5h 25m,Buy
98006.94,1.20539,12.03.2012 11:45:00,,0.0,-0.0,0.0,0.0,1.20593,12.03.2012 03:00:00,7712,-0.0,19.96,IS,0.34,0.0,Phase3-EA-S4v1-EURCHF-M15-221,EURCHFMT4,1966,8h 45m,Sell
97982.04,82311,12.03.2012 12:30:00,,-0.95,-24.89999999999418,0.0,0.0,82384,09.03.2012 23:30:00,7713,-0.013244191943124092,-24.9,IS,0.27,0.0,Phase3-EA-S1v2-USDJPY-M15-0,USDJPYMT4,2264,2d 13h 0m,Buy
97934.47,108145,12.03.2012 19:14:58,sl 108.145,0.0,-72.47000000000116,0.0,0.0,107915,12.03.2012 03:30:00,7714,-0.0385464494023471,-47.57,IS,0.17,0.0,Phase3-EA-T1v2-EURJPY-M15-322,EURJPYMT4,1186,15h 44m,Sell
97961.59,128755,13.03.2012 08:10:00,,0.0,-45.35000000000582,0.0,0.0,128852,13.03.2012 02:45:00,7715,-0.0241214499847749,27.12,IS,0.23,0.0,Phase3-EA-S4v1-GBPJPY-M5-194,GBPJPYMT4,1840,5h 25m,Sell
97964.93,1.20557,13.03.2012 11:15:00,,0.0,-42.01000000000931,0.0,0.0,1.20548,13.03.2012 02:30:00,7716,-0.022344919820517933,3.34,IS,0.34,0.0,Phase3-EA-S4v1-EURCHF-M15-221,EURCHFMT4,1968,8h 45m,Buy
97917.65,108252,13.03.2012 15:14:58,sl 108.252,0.0,-89.29000000000815,0.0,0.0,108482,13.03.2012 11:30:00,7717,-0.04749292765469616,-47.28,IS,0.17,0.0,Phase3-EA-T1v2-EURJPY-M15-322,EURJPYMT4,1188,3h 44m,Buy
97980.49,0.92291,13.03.2012 23:59:58,tp 0.92291,0.0,-26.45000000001164,0.0,0.0,0.92391,13.03.2012 22:45:00,7718,-0.014068629594211578,62.84,IS,0.58,0.0,Phase3-EA-SA2v2-USDCHF-M15-107,USDCHFMT4,1512,1h 14m,Sell
98179.25,130538,14.03.2012 03:59:58,tp 130.538,-1.57,-0.0,0.0,0.0,128688,08.03.2012 14:00:00,7719,-0.0,198.76,IS,0.09,0.0,Phase3-EA-B1v1-GBPJPY-M30-1,GBPJPYMT4,754,5d 13h 59m,Buy
98115.78,1.20726,14.03.2012 04:35:00,,-2.22,-63.470000000001164,0.0,0.0,1.20588,13.03.2012 20:15:00,7720,-0.03372847962780226,-63.47,IS,0.41,0.0,Phase3-EA-SA2v2-EURCHF-M5-43,EURCHFMT4,4158,8h 20m,Sell
98098.35,130377,14.03.2012 07:25:00,,0.0,-80.89999999999418,0.0,0.0,130314,14.03.2012 02:00:00,7721,-0.042990924876145524,-17.43,IS,0.23,0.0,Phase3-EA-S4v1-GBPJPY-M5-194,GBPJPYMT4,1842,5h 25m,Sell
98078.16,1.20843,14.03.2012 10:45:00,,0.0,-101.08999999999651,0.0,0.0,1.20788,14.03.2012 02:00:00,7722,-0.05372005680753663,-20.19,IS,0.34,0.0,Phase3-EA-S4v1-EURCHF-M15-221,EURCHFMT4,1970,8h 45m,Sell
97992.94,108821,14.03.2012 11:59:58,sl 108.821,-1.14,-186.30999999999767,0.0,0.0,108041,09.03.2012 09:30:00,7723,-0.09900666518757908,-85.22,IS,0.09,0.0,Phase3-EA-TR1v1-EURJPY-M30-91,EURJPYMT4,1246,5d 2h 29m,Sell
98088.5,108911,14.03.2012 21:30:00,,-1.0,-90.75,0.0,0.0,108436,13.03.2012 19:15:00,7724,-0.048225295828312566,95.56,IS,0.17,0.0,Phase3-EA-T1v2-EURJPY-M15-322,EURJPYMT4,1190,1d 2h 15m,Buy
98107.2,83765,14.03.2012 22:45:00,,0.0,-72.04999999998836,0.0,0.0,83707,14.03.2012 20:15:00,7725,-0.03828796214247228,18.7,IS,0.27,0.0,Phase3-EA-S1v2-USDJPY-M15-0,USDJPYMT4,2266,2h 30m,Buy
98155.67,1.21229,14.03.2012 23:09:57,tp 1.21229,0.0,-23.579999999987194,0.0,0.0,1.21119,14.03.2012 21:30:00,7726,-0.012530605792077055,48.47,IS,0.41,0.0,Phase3-EA-SA2v2-EURCHF-M5-43,EURCHFMT4,4160,1h 39m,Buy
98114.27,1213,15.03.2012 07:35:00,,-6.61,-64.97999999998137,0.0,0.0,1.21221,14.03.2012 23:15:00,7727,-0.034530906037717385,-41.4,IS,0.41,0.0,Phase3-EA-SA2v2-EURCHF-M5-43,EURCHFMT4,4162,8h 20m,Sell
98260.75,1.2088,15.03.2012 11:44:57,tp 1.20880,0.0,-0.0,0.0,0.0,1.2128,15.03.2012 03:15:00,7728,-0.0,146.48,IS,0.34,0.0,Phase3-EA-S4v1-EURCHF-M15-221,EURCHFMT4,1972,8h 29m,Sell
98187.14,130375,15.03.2012 16:59:58,sl 130.375,-1.16,-73.60999999998603,0.0,0.0,131045,14.03.2012 11:30:00,7729,-0.0391000248325718,-73.61,IS,0.09,0.0,Phase3-EA-B1v1-GBPJPY-M30-1,GBPJPYMT4,756,1d 5h 29m,Buy
98220.22,83256,15.03.2012 20:30:00,,0.0,-40.529999999998836,0.0,0.0,83358,15.03.2012 19:30:00,7730,-0.021528651086325096,33.08,IS,0.27,0.0,Phase3-EA-S1v2-USDJPY-M15-0,USDJPYMT4,2268,1h 0m,Sell
98283.09,0.92256,16.03.2012 05:44:57,tp 0.92256,0.0,-0.0,0.0,0.0,0.92356,16.03.2012 02:00:00,7731,-0.0,62.87,IS,0.58,0.0,Phase3-EA-SA2v2-USDCHF-M15-107,USDCHFMT4,1514,3h 44m,Sell
98309.54,131127,16.03.2012 08:45:00,,0.0,-0.0,0.0,0.0,131031,16.03.2012 03:20:00,7732,-0.0,26.45,IS,0.23,0.0,Phase3-EA-S4v1-GBPJPY-M5-194,GBPJPYMT4,1844,5h 25m,Buy
98327.75,1.20685,16.03.2012 10:00:00,,0.0,-0.0,0.0,0.0,1.20726,16.03.2012 01:40:00,7733,-0.0,18.21,IS,0.41,0.0,Phase3-EA-SA2v2-EURCHF-M5-43,EURCHFMT4,4164,8h 20m,Sell
98321.13,1.20761,16.03.2012 11:30:00,,0.0,-6.619999999995343,0.0,0.0,1.20743,16.03.2012 02:45:00,7734,-0.0035151484579385318,-6.62,IS,0.34,0.0,Phase3-EA-S4v1-EURCHF-M15-221,EURCHFMT4,1974,8h 45m,Sell
98454.42,109997,19.03.2012 02:00:00,tp 109.997,-2.64,-0.0,0.0,0.0,108737,14.03.2012 08:30:00,7735,-0.0,133.29,IS,0.09,0.0,Phase3-EA-TR1v1-EURJPY-M30-91,EURJPYMT4,1247,4d 17h 30m,Buy
98451.06,0.91602,19.03.2012 03:30:00,,-3.36,-3.35999999998603,0.0,0.0,0.91602,16.03.2012 23:15:00,7736,-0.001782924486454616,-3.36,IS,0.58,0.0,Phase3-EA-SA2v2-USDCHF-M15-107,USDCHFMT4,1516,2d 4h 15m,Sell
98471.02,1.20659,19.03.2012 06:10:00,,-1.07,-0.0,0.0,0.0,1.20612,16.03.2012 21:50:00,7737,-0.0,19.96,IS,0.41,0.0,Phase3-EA-SA2v2-EURCHF-M5-43,EURCHFMT4,4166,2d 8h 20m,Buy
98458.55,83384,19.03.2012 06:15:00,,-1.46,-12.470000000001164,0.0,0.0,83.35,16.03.2012 22:15:00,7738,-0.006616401821352239,-12.47,IS,0.27,0.0,Phase3-EA-S1v2-USDJPY-M15-0,USDJPYMT4,2270,2d 8h 0m,Sell
98568.42,109832,19.03.2012 08:30:00,,-1.0,-0.0,0.0,0.0,109288,16.03.2012 08:30:00,7739,-0.0,109.87,IS,0.17,0.0,Phase3-EA-T1v2-EURJPY-M15-322,EURJPYMT4,1192,3d 0h 0m,Buy
98495.8,131565,19.03.2012 11:29:58,sl 131.565,0.0,-72.61999999999534,0.0,0.0,132235,19.03.2012 03:30:00,7740,-0.03851122048962134,-72.62,IS,0.09,0.0,Phase3-EA-B1v1-GBPJPY-M30-1,GBPJPYMT4,758,7h 59m,Buy
98511.37,1.20609,19.03.2012 11:45:00,,0.0,-57.04999999998836,0.0,0.0,1.20651,19.03.2012 03:00:00,7741,-0.03025427057191669,15.57,IS,0.34,0.0,Phase3-EA-S4v1-EURCHF-M15-221,EURCHFMT4,1976,8h 45m,Sell
98533.1,83355,20.03.2012 03:45:00,,-0.94,-35.31999999997788,0.0,0.0,83285,19.03.2012 20:30:00,7742,-0.01873060186853017,21.73,IS,0.27,0.0,Phase3-EA-S1v2-USDJPY-M15-0,USDJPYMT4,2272,7h 15m,Buy
98517.2,0.91168,20.03.2012 06:45:00,,0.0,-51.21999999997206,0.0,0.0,0.91143,20.03.2012 02:30:00,7743,-0.02716255457831803,-15.9,IS,0.58,0.0,Phase3-EA-SA2v2-USDCHF-M15-107,USDCHFMT4,1518,4h 15m,Sell
98432.9,110714,20.03.2012 11:59:59,sl 110.714,-0.38,-135.51999999996042,0.0,0.0,109934,19.03.2012 05:00:00,7744,-0.07186781328493934,-84.3,IS,0.09,0.0,Phase3-EA-TR1v1-EURJPY-M30-91,EURJPYMT4,1250,1d 6h 59m,Sell
98443.69,1.20611,20.03.2012 13:15:00,,0.0,-124.72999999995227,0.0,0.0,1.2064,20.03.2012 04:30:00,7745,-0.06614575229508317,10.79,IS,0.34,0.0,Phase3-EA-S4v1-EURCHF-M15-221,EURCHFMT4,1978,8h 45m,Sell
98493.68,83718,20.03.2012 22:30:00,,0.0,-74.73999999996158,0.0,0.0,83563,20.03.2012 17:00:00,7746,-0.03963548085090889,49.99,IS,0.27,0.0,Phase3-EA-S1v2-USDJPY-M15-0,USDJPYMT4,2274,5h 30m,Buy
98553.99,0.91084,21.03.2012 03:14:58,tp 0.91084,-3.37,-14.429999999963911,0.0,0.0,0.91184,20.03.2012 23:00:00,7747,-0.007652394817734533,60.31,IS,0.58,0.0,Phase3-EA-SA2v2-USDCHF-M15-107,USDCHFMT4,1520,4h 14m,Sell
98555.16,1.20569,21.03.2012 04:25:00,,-1.08,-13.259999999951106,0.0,0.0,1.20564,20.03.2012 20:05:00,7748,-0.007031930373045011,1.17,IS,0.41,0.0,Phase3-EA-SA2v2-EURCHF-M5-43,EURCHFMT4,4168,8h 20m,Buy
98559.27,1.20587,21.03.2012 12:45:00,,0.0,-9.149999999965075,0.0,0.0,1.20598,21.03.2012 04:00:00,7749,-0.0048523501442951375,4.11,IS,0.34,0.0,Phase3-EA-S4v1-EURCHF-M15-221,EURCHFMT4,1980,8h 45m,Sell
98597.99,110718,21.03.2012 18:00:00,,-1.0,-0.0,0.0,0.0,110522,20.03.2012 19:15:00,7750,-0.0,38.72,IS,0.17,0.0,Phase3-EA-T1v2-EURJPY-M15-322,EURJPYMT4,1194,22h 45m,Buy
98589.8,1.20527,22.03.2012 06:30:00,,-3.24,-8.190000000002328,0.0,0.0,1.20538,21.03.2012 22:10:00,7751,-0.0043425701408600975,-8.19,IS,0.41,0.0,Phase3-EA-SA2v2-EURCHF-M5-43,EURCHFMT4,4170,8h 20m,Buy
98542.84,110288,22.03.2012 08:29:58,sl 110.288,0.0,-55.14999999999418,0.0,0.0,110058,22.03.2012 06:30:00,7752,-0.029242093195157637,-46.96,IS,0.17,0.0,Phase3-EA-T1v2-EURJPY-M15-322,EURJPYMT4,1196,1h 59m,Sell
98462.37,109771,22.03.2012 11:29:58,sl 109.771,-2.65,-135.61999999999534,0.0,0.0,110491,19.03.2012 20:00:00,7753,-0.07190956807121597,-80.47,IS,0.09,0.0,Phase3-EA-TR1v1-EURJPY-M30-91,EURJPYMT4,1251,2d 15h 29m,Buy
98189.52,82992,22.03.2012 11:44:58,sl 82.992,-2.82,-408.47000000000116,0.0,0.0,83822,21.03.2012 17:15:00,7754,-0.21658237184818377,-272.85,IS,0.27,0.0,Phase3-EA-S1v2-USDJPY-M15-0,USDJPYMT4,2276,18h 29m,Buy
98187.29,1.20526,22.03.2012 15:30:00,,0.0,-410.70000000001164,0.0,0.0,1.20532,22.03.2012 06:45:00,7755,-0.21776478105626199,-2.23,IS,0.34,0.0,Phase3-EA-S4v1-EURCHF-M15-221,EURCHFMT4,1982,8h 45m,Buy
98307.84,82644,22.03.2012 17:30:00,,0.0,-290.1500000000233,0.0,0.0,83013,22.03.2012 17:00:00,7756,-0.1538457541355678,120.55,IS,0.27,0.0,Phase3-EA-S1v2-USDJPY-M15-0,USDJPYMT4,2278,30m 0s,Sell
98277.16,82736,22.03.2012 17:45:00,,0.0,-320.8300000000163,0.0,0.0,82642,22.03.2012 17:30:00,7757,-0.17011315974259095,-30.68,IS,0.27,0.0,Phase3-EA-S1v2-USDJPY-M15-0,USDJPYMT4,2280,15m 0s,Sell
98385.5,130923,23.03.2012 04:59:58,tp 130.923,0.0,-212.4900000000198,0.0,0.0,130533,23.03.2012 02:30:00,7758,-0.1126682209073487,108.34,IS,0.23,0.0,Phase3-EA-S4v1-GBPJPY-M5-194,GBPJPYMT4,1846,2h 29m,Buy
98387.56,1.20529,23.03.2012 06:50:00,,-1.08,-210.43000000002212,0.0,0.0,1.20522,22.03.2012 22:30:00,7759,-0.11157595051782987,2.06,IS,0.41,0.0,Phase3-EA-SA2v2-EURCHF-M5-43,EURCHFMT4,4172,8h 20m,Buy
98306.17,82775,23.03.2012 10:15:00,,-1.47,-291.8200000000361,0.0,0.0,82.53,22.03.2012 23:15:00,7760,-0.15473123547076803,-81.39,IS,0.27,0.0,Phase3-EA-S1v2-USDJPY-M15-0,USDJPYMT4,2282,11h 0m,Sell
98310.51,1.2052,26.03.2012 05:25:00,,-1.08,-287.4800000000396,0.0,0.0,1.20508,23.03.2012 21:05:00,7761,-0.1524300444559558,4.34,IS,0.41,0.0,Phase3-EA-SA2v2-EURCHF-M5-43,EURCHFMT4,4174,2d 8h 20m,Buy
98237.12,82601,26.03.2012 10:00:00,,-1.48,-360.87000000005355,0.0,0.0,82381,23.03.2012 19:30:00,7762,-0.19134350265347627,-73.39,IS,0.27,0.0,Phase3-EA-S1v2-USDJPY-M15-0,USDJPYMT4,2284,2d 14h 30m,Sell
98188.55,110037,26.03.2012 15:29:57,sl 110.037,-1.44,-409.44000000006054,0.0,0.0,109807,22.03.2012 11:15:00,7763,-0.21709669334230963,-48.57,IS,0.17,0.0,Phase3-EA-T1v2-EURJPY-M15-322,EURJPYMT4,1198,4d 4h 14m,Sell
98103.68,110328,26.03.2012 18:29:58,sl 110.328,0.0,-494.3100000000559,0.0,0.0,109548,26.03.2012 11:00:00,7764,-0.2620971729338446,-84.87,IS,0.09,0.0,Phase3-EA-TR1v1-EURJPY-M30-91,EURJPYMT4,1254,7h 29m,Sell
98056.94,1.20649,27.03.2012 07:20:00,,-2.27,-541.0500000000466,0.0,0.0,1.20551,26.03.2012 23:00:00,7765,-0.28688004575236753,-46.74,IS,0.41,0.0,Phase3-EA-SA2v2-EURCHF-M5-43,EURCHFMT4,4176,8h 20m,Sell
98094.96,132268,27.03.2012 09:15:00,,0.0,-503.03000000005704,0.0,0.0,132405,27.03.2012 03:50:00,7766,-0.26672076409725054,38.02,IS,0.23,0.0,Phase3-EA-S4v1-GBPJPY-M5-194,GBPJPYMT4,1848,5h 25m,Sell
98084.04,1.20618,27.03.2012 10:00:00,,0.0,-513.9500000000698,0.0,0.0,1.20589,27.03.2012 01:15:00,7767,-0.27251085761840244,-10.92,IS,0.34,0.0,Phase3-EA-S4v1-EURCHF-M15-221,EURCHFMT4,1984,8h 45m,Sell
98036.9,110458,27.03.2012 16:29:58,sl 110.458,0.0,-561.0900000000838,0.0,0.0,110688,27.03.2012 15:30:00,7768,-0.29750582177470863,-47.14,IS,0.17,0.0,Phase3-EA-T1v2-EURJPY-M15-322,EURJPYMT4,1200,59m 58s,Buy
98056.74,83146,28.03.2012 00:45:00,,-0.94,-541.2500000000873,0.0,0.0,83082,27.03.2012 20:45:00,7769,-0.28698609142127457,19.84,IS,0.27,0.0,Phase3-EA-S1v2-USDJPY-M15-0,USDJPYMT4,2286,4h 0m,Buy
98042.44,0.90442,28.03.2012 04:00:00,,-3.4,-555.5500000000757,0.0,0.0,0.90425,27.03.2012 23:45:00,7770,-0.29456835674657755,-14.3,IS,0.58,0.0,Phase3-EA-SA2v2-USDCHF-M15-107,USDCHFMT4,1522,4h 15m,Sell
98069.42,83063,28.03.2012 04:00:00,,0.0,-528.5700000000652,0.0,0.0,83146,28.03.2012 00:45:00,7771,-0.28026279601392584,26.98,IS,0.27,0.0,Phase3-EA-S1v2-USDJPY-M15-0,USDJPYMT4,2288,3h 15m,Sell
98079.21,1.20549,28.03.2012 04:35:00,,-1.09,-518.780000000057,0.0,0.0,1.20525,27.03.2012 20:15:00,7772,-0.27507186052197913,9.79,IS,0.41,0.0,Phase3-EA-SA2v2-EURCHF-M5-43,EURCHFMT4,4178,8h 20m,Buy
98005.87,131648,28.03.2012 11:29:59,sl 131.648,-0.39,-592.1200000000536,0.0,0.0,132318,27.03.2012 03:30:00,7773,-0.31395880730226894,-73.34,IS,0.09,0.0,Phase3-EA-B1v1-GBPJPY-M30-1,GBPJPYMT4,760,1d 7h 59m,Buy
98051.35,83112,28.03.2012 18:15:00,,0.0,-546.6400000000431,0.0,0.0,82972,28.03.2012 18:00:00,7774,-0.2898440221977138,45.48,IS,0.27,0.0,Phase3-EA-S1v2-USDJPY-M15-0,USDJPYMT4,2290,15m 0s,Buy
98035.1,83064,28.03.2012 18:30:00,,0.0,-562.8900000000431,0.0,0.0,83114,28.03.2012 18:15:00,7775,-0.298460232794656,-16.25,IS,0.27,0.0,Phase3-EA-S1v2-USDJPY-M15-0,USDJPYMT4,2292,15m 0s,Buy
98039.75,82888,29.03.2012 01:00:00,,-2.84,-558.2400000000489,0.0,0.0,82865,28.03.2012 18:45:00,7776,-0.29599467099307253,4.65,IS,0.27,0.0,Phase3-EA-S1v2-USDJPY-M15-0,USDJPYMT4,2294,6h 15m,Buy
98030.6,1.20511,29.03.2012 05:50:00,,-3.26,-567.3900000000431,0.0,0.0,1.20524,28.03.2012 21:30:00,7777,-0.30084626034457845,-9.15,IS,0.41,0.0,Phase3-EA-SA2v2-EURCHF-M5-43,EURCHFMT4,4180,8h 20m,Buy
98139.08,131344,29.03.2012 05:54:57,tp 131.344,0.0,-458.9100000000326,0.0,0.0,131734,29.03.2012 02:40:00,7778,-0.243327089541109,108.48,IS,0.23,0.0,Phase3-EA-S4v1-GBPJPY-M5-194,GBPJPYMT4,1850,3h 14m,Sell
98057.77,109.69,29.03.2012 11:29:58,sl 109.690,-2.66,-540.2200000000303,0.0,0.0,110.41,26.03.2012 20:30:00,7779,-0.2864399562264843,-81.31,IS,0.09,0.0,Phase3-EA-TR1v1-EURJPY-M30-91,EURJPYMT4,1256,2d 14h 59m,Buy
98070.13,1.2051,29.03.2012 15:15:00,,0.0,-527.8600000000442,0.0,0.0,1.20543,29.03.2012 06:30:00,7780,-0.2798863338893714,12.36,IS,0.34,0.0,Phase3-EA-S4v1-EURCHF-M15-221,EURCHFMT4,1986,8h 45m,Sell
98419.97,108775,29.03.2012 17:29:58,tp 108.775,-2.16,-178.02000000004773,0.0,0.0,110475,28.03.2012 18:00:00,7781,-0.09439124987495752,349.84,IS,0.17,0.0,Phase3-EA-T1v2-EURJPY-M15-322,EURJPYMT4,1202,23h 29m,Sell
98353.27,0.90611,30.03.2012 03:00:00,,-0.77,-244.72000000005937,0.0,0.0,0.90714,29.03.2012 22:45:00,7782,-0.12975748044825872,-66.7,IS,0.58,0.0,Phase3-EA-SA2v2-USDCHF-M15-107,USDCHFMT4,1524,4h 15m,Buy
98308.52,1.59763,30.03.2012 04:59:58,sl 1.59763,-2.75,-289.4700000000594,0.0,0.0,1.59463,28.03.2012 02:00:00,7783,-0.15348519886137643,-44.75,IS,0.14,0.0,Phase3-EA-B1v1-GBPUSD-M30-14,GBPUSDMT4,514,2d 2h 59m,Sell
98298.54,1.20527,30.03.2012 05:05:00,,-2.26,-299.45000000006985,0.0,0.0,1.2051,29.03.2012 20:45:00,7784,-0.15877687773876556,-9.98,IS,0.41,0.0,Phase3-EA-SA2v2-EURCHF-M5-43,EURCHFMT4,4182,8h 20m,Sell
98219.28,109866,30.03.2012 05:29:58,sl 109.866,-0.38,-378.71000000007916,0.0,0.0,109146,29.03.2012 15:30:00,7785,-0.2008027763180713,-79.26,IS,0.09,0.0,Phase3-EA-TR1v1-EURJPY-M30-91,EURJPYMT4,1258,13h 59m,Sell
98171.68,109609,30.03.2012 11:44:58,sl 109.609,0.0,-426.310000000085,0.0,0.0,109839,30.03.2012 11:00:00,7786,-0.22604164551280967,-47.6,IS,0.17,0.0,Phase3-EA-T1v2-EURJPY-M15-322,EURJPYMT4,1204,44m 58s,Buy
98155.48,1.20471,30.03.2012 14:15:00,,0.0,-442.5100000000966,0.0,0.0,1.20514,30.03.2012 05:30:00,7787,-0.23463134469253666,-16.2,IS,0.34,0.0,Phase3-EA-S4v1-EURCHF-M15-221,EURCHFMT4,1988,8h 45m,Buy
98107.99,109503,30.03.2012 18:59:58,sl 109.503,0.0,-490.0000000000873,0.0,0.0,109733,30.03.2012 17:15:00,7788,-0.25981188876938,-47.49,IS,0.17,0.0,Phase3-EA-T1v2-EURJPY-M15-322,EURJPYMT4,1206,1h 44m,Buy
98172.33,0.90142,02.04.2012 03:14:59,tp 0.90142,0.0,-425.6600000000908,0.0,0.0,0.90042,02.04.2012 02:00:00,7789,-0.22569699708893506,64.34,IS,0.58,0.0,Phase3-EA-SA2v2-USDCHF-M15-107,USDCHFMT4,1526,1h 14m,Buy
98178.24,1.20421,02.04.2012 09:40:00,,0.0,-419.7500000000873,0.0,0.0,1.20434,02.04.2012 01:20:00,7790,-0.22256334757336838,5.91,IS,0.41,0.0,Phase3-EA-SA2v2-EURCHF-M5-43,EURCHFMT4,4184,8h 20m,Sell
98174.09,1.20433,02.04.2012 10:30:00,,0.0,-423.9000000000815,0.0,0.0,1.20422,02.04.2012 01:45:00,7791,-0.22476379520273823,-4.15,IS,0.34,0.0,Phase3-EA-S4v1-EURCHF-M15-221,EURCHFMT4,1990,8h 45m,Sell
98095.7,110079,02.04.2012 14:59:58,sl 110.079,0.0,-502.29000000009546,0.0,0.0,110799,02.04.2012 02:00:00,7792,-0.26632839512239476,-78.39,IS,0.09,0.0,Phase3-EA-TR1v1-EURJPY-M30-91,EURJPYMT4,1260,12h 59m,Buy
98139.14,82047,02.04.2012 22:45:00,,0.0,-458.85000000009313,0.0,0.0,82179,02.04.2012 22:15:00,7793,-0.24329527584047544,43.44,IS,0.27,0.0,Phase3-EA-S1v2-USDJPY-M15-0,USDJPYMT4,2296,30m 0s,Sell
98162.78,1.20356,03.04.2012 06:30:00,,-2.27,-435.21000000007916,0.0,0.0,1.20413,02.04.2012 22:10:00,7794,-0.23076067777820874,23.64,IS,0.41,0.0,Phase3-EA-SA2v2-EURCHF-M5-43,EURCHFMT4,4186,8h 20m,Sell
98272.21,131.49,03.04.2012 08:24:58,tp 131.490,0.0,-325.78000000008615,0.0,0.0,131.1,03.04.2012 03:05:00,7795,-0.1727377900475427,109.43,IS,0.23,0.0,Phase3-EA-S4v1-GBPJPY-M5-194,GBPJPYMT4,1852,5h 19m,Buy
98266.18,1.20357,03.04.2012 12:00:00,,0.0,-331.810000000085,0.0,0.0,1.20373,03.04.2012 03:15:00,7796,-0.17593506696443814,-6.03,IS,0.34,0.0,Phase3-EA-S4v1-EURCHF-M15-221,EURCHFMT4,1992,8h 45m,Buy
98218.58,109527,03.04.2012 16:14:58,sl 109.527,0.0,-379.4100000000908,0.0,0.0,109297,03.04.2012 15:00:00,7797,-0.2011739361591765,-47.6,IS,0.17,0.0,Phase3-EA-T1v2-EURJPY-M15-322,EURJPYMT4,1208,1h 14m,Sell
98282.32,0.90994,03.04.2012 22:59:57,tp 0.90994,0.0,-315.6700000001001,0.0,0.0,0.91094,03.04.2012 22:15:00,7798,-0.167377181485391,63.74,IS,0.58,0.0,Phase3-EA-SA2v2-USDCHF-M15-107,USDCHFMT4,1528,44m 57s,Sell
98346.04,0.9102,04.04.2012 02:44:57,tp 0.91020,0.0,-251.95000000009895,0.0,0.0,0.9112,04.04.2012 01:45:00,7799,-0.13359103137848843,63.72,IS,0.58,0.0,Phase3-EA-SA2v2-USDCHF-M15-107,USDCHFMT4,1530,59m 57s,Sell
98298.84,109417,04.04.2012 04:44:58,sl 109.417,0.0,-299.1500000001106,0.0,0.0,109647,04.04.2012 03:45:00,7800,-0.158617809235459,-47.2,IS,0.17,0.0,Phase3-EA-T1v2-EURJPY-M15-322,EURJPYMT4,1210,59m 58s,Buy
98308.73,1.20407,04.04.2012 06:25:00,,-2.25,-289.2600000000966,0.0,0.0,1.20434,03.04.2012 22:05:00,7801,-0.15337385090906647,9.89,IS,0.41,0.0,Phase3-EA-SA2v2-EURCHF-M5-43,EURCHFMT4,4188,8h 20m,Sell
98329.23,1.20386,04.04.2012 10:45:00,,0.0,-268.7600000000966,0.0,0.0,1.20441,04.04.2012 02:00:00,7802,-0.14250416984830863,20.5,IS,0.34,0.0,Phase3-EA-S4v1-EURCHF-M15-221,EURCHFMT4,1994,8h 45m,Sell
98465.7,108336,04.04.2012 12:29:58,tp 108.336,-0.76,-132.29000000009546,0.0,0.0,109596,02.04.2012 16:00:00,7803,-0.07014390768432645,136.47,IS,0.09,0.0,Phase3-EA-TR1v1-EURJPY-M30-91,EURJPYMT4,1262,1d 20h 29m,Sell
98392.65,131299,04.04.2012 18:59:58,sl 131.299,0.0,-205.34000000008382,0.0,0.0,130629,04.04.2012 12:30:00,7804,-0.10887708824472808,-73.05,IS,0.09,0.0,Phase3-EA-B1v1-GBPJPY-M30-1,GBPJPYMT4,762,6h 29m,Sell
98378.24,82445,04.04.2012 23:45:00,,0.0,-219.7500000000873,0.0,0.0,82401,04.04.2012 17:00:00,7805,-0.11651767868792605,-14.41,IS,0.27,0.0,Phase3-EA-S1v2-USDJPY-M15-0,USDJPYMT4,2298,6h 45m,Sell
98395.72,1.20317,05.04.2012 04:20:00,,-6.72,-202.27000000007683,0.0,0.0,1.20371,04.04.2012 20:00:00,7806,-0.10724928722733283,17.48,IS,0.41,0.0,Phase3-EA-SA2v2-EURCHF-M5-43,EURCHFMT4,4190,8h 20m,Sell
98356.65,130784,05.04.2012 04:40:00,,-3.01,-241.34000000008382,0.0,0.0,130913,04.04.2012 23:15:00,7807,-0.1279653086441077,-39.07,IS,0.23,0.0,Phase3-EA-S4v1-GBPJPY-M5-194,GBPJPYMT4,1854,5h 25m,Buy
98331.94,0.91558,05.04.2012 04:45:00,,0.0,-266.05000000007567,0.0,0.0,0.91597,05.04.2012 00:30:00,7808,-0.14106725103489978,-24.71,IS,0.58,0.0,Phase3-EA-SA2v2-USDCHF-M15-107,USDCHFMT4,1532,4h 15m,Buy
98468.99,106901,05.04.2012 13:29:58,tp 106.901,-1.15,-129.0000000000873,0.0,0.0,108161,04.04.2012 15:30:00,7809,-0.0683994564311566,137.05,IS,0.09,0.0,Phase3-EA-TR1v1-EURJPY-M30-91,EURJPYMT4,1264,21h 59m,Sell
98399.85,1.20126,05.04.2012 13:30:00,,0.0,-198.14000000010128,0.0,0.0,1.20313,05.04.2012 04:45:00,7810,-0.10505944416486142,-69.14,IS,0.34,0.0,Phase3-EA-S4v1-EURCHF-M15-221,EURCHFMT4,1996,8h 45m,Buy
98449.06,0.9194,06.04.2012 06:45:00,,0.0,-148.93000000010943,0.0,0.0,0.92018,06.04.2012 02:30:00,7811,-0.07896690733560266,49.21,IS,0.58,0.0,Phase3-EA-SA2v2-USDCHF-M15-107,USDCHFMT4,1534,4h 15m,Sell
98434.17,1.20134,06.04.2012 07:30:00,,-1.07,-163.8200000001234,0.0,0.0,1.20165,05.04.2012 23:10:00,7812,-0.08686200738413125,-14.89,IS,0.41,0.0,Phase3-EA-SA2v2-EURCHF-M5-43,EURCHFMT4,4192,8h 20m,Buy
98543.26,130529,06.04.2012 08:14:58,tp 130.529,0.0,-54.73000000012689,0.0,0.0,130139,06.04.2012 03:10:00,7813,-0.029019397290568575,109.09,IS,0.23,0.0,Phase3-EA-S4v1-GBPJPY-M5-194,GBPJPYMT4,1856,5h 4m,Buy
98565.08,1.20145,06.04.2012 13:30:00,,0.0,-32.91000000011991,0.0,0.0,1.20204,06.04.2012 04:45:00,7814,-0.017449814815163115,21.82,IS,0.34,0.0,Phase3-EA-S4v1-EURCHF-M15-221,EURCHFMT4,1998,8h 45m,Sell
98919.75,106594,06.04.2012 15:44:58,tp 106.594,-0.72,-0.0,0.0,0.0,108294,05.04.2012 00:30:00,7815,-0.0,354.67,IS,0.17,0.0,Phase3-EA-T1v2-EURJPY-M15-322,EURJPYMT4,1212,1d 15h 14m,Sell
98832.89,106649,06.04.2012 15:59:58,sl 106.649,-0.54,-86.85999999998603,0.0,0.0,107429,05.04.2012 17:00:00,7816,-0.04597719402020484,-86.86,IS,0.09,0.0,Phase3-EA-TR1v1-EURJPY-M30-91,EURJPYMT4,1266,22h 59m,Buy
98834.21,81565,06.04.2012 23:15:00,,0.0,-85.53999999997905,0.0,0.0,81569,06.04.2012 21:45:00,7817,-0.0452784846475707,1.32,IS,0.27,0.0,Phase3-EA-S1v2-USDJPY-M15-0,USDJPYMT4,2300,1h 30m,Sell
98897.4,0.9179,09.04.2012 03:14:57,tp 0.91790,0.0,-22.349999999976717,0.0,0.0,0.9189,09.04.2012 02:15:00,7818,-0.011830420059298559,63.19,IS,0.58,0.0,Phase3-EA-SA2v2-USDCHF-M15-107,USDCHFMT4,1536,59m 57s,Sell
98806.9,129097,09.04.2012 04:30:00,,-1.01,-112.84999999997672,0.0,0.0,129414,06.04.2012 23:05:00,7819,-0.05973435810706746,-90.5,IS,0.23,0.0,Phase3-EA-S4v1-GBPJPY-M5-194,GBPJPYMT4,1858,2d 5h 25m,Buy
98796.19,1.20117,09.04.2012 06:55:00,,-2.24,-123.55999999996857,0.0,0.0,1.20098,06.04.2012 22:35:00,7820,-0.06540343188045104,-10.71,IS,0.41,0.0,Phase3-EA-SA2v2-EURCHF-M5-43,EURCHFMT4,4194,2d 8h 20m,Sell
98788.79,1.2014,09.04.2012 11:15:00,,0.0,-130.95999999996275,0.0,0.0,1.2012,09.04.2012 02:30:00,7821,-0.0693204389694368,-7.4,IS,0.34,0.0,Phase3-EA-S4v1-EURCHF-M15-221,EURCHFMT4,2000,8h 45m,Sell
98740.71,106437,09.04.2012 18:59:58,sl 106.437,0.0,-179.03999999994994,0.0,0.0,106207,09.04.2012 16:15:00,7822,-0.09477039854221156,-48.08,IS,0.17,0.0,Phase3-EA-T1v2-EURJPY-M15-322,EURJPYMT4,1214,2h 44m,Sell
98779.08,81634,10.04.2012 03:00:00,,0.0,-140.6699999999546,0.0,0.0,81518,10.04.2012 00:15:00,7823,-0.0744601874605246,38.37,IS,0.27,0.0,Phase3-EA-S1v2-USDJPY-M15-0,USDJPYMT4,2302,2h 45m,Buy
98888.97,129907,10.04.2012 03:04:58,tp 129.907,0.0,-30.779999999940628,0.0,0.0,129517,10.04.2012 00:05:00,7824,-0.016292632189032957,109.89,IS,0.23,0.0,Phase3-EA-S4v1-GBPJPY-M5-194,GBPJPYMT4,1860,2h 59m,Buy
98862.85,0.91707,10.04.2012 03:45:00,,-3.35,-56.89999999993597,0.0,0.0,0.91671,09.04.2012 23:30:00,7825,-0.030118608562596502,-26.12,IS,0.58,0.0,Phase3-EA-SA2v2-USDCHF-M15-107,USDCHFMT4,1538,4h 15m,Sell
98854.79,1.20198,10.04.2012 04:35:00,,-2.24,-64.95999999993364,0.0,0.0,1.20185,09.04.2012 20:15:00,7826,-0.03438497033789933,-8.06,IS,0.41,0.0,Phase3-EA-SA2v2-EURCHF-M5-43,EURCHFMT4,4196,8h 20m,Sell
98964.95,129543,10.04.2012 08:09:58,tp 129.543,0.0,-0.0,0.0,0.0,129933,10.04.2012 03:15:00,7827,-0.0,110.16,IS,0.23,0.0,Phase3-EA-S4v1-GBPJPY-M5-194,GBPJPYMT4,1862,4h 54m,Sell
98877.59,105541,10.04.2012 19:59:58,sl 105.541,-0.54,-87.35999999998603,0.0,0.0,106321,09.04.2012 11:00:00,7828,-0.046230795711049,-87.36,IS,0.09,0.0,Phase3-EA-TR1v1-EURJPY-M30-91,EURJPYMT4,1268,1d 8h 59m,Buy
98872.05,1.20134,11.04.2012 05:50:00,,-1.07,-92.89999999999418,0.0,0.0,1.20144,10.04.2012 21:30:00,7829,-0.049162556336502634,-5.54,IS,0.41,0.0,Phase3-EA-SA2v2-EURCHF-M5-43,EURCHFMT4,4198,8h 20m,Buy
98913.25,80601,11.04.2012 11:00:00,,0.0,-51.69999999998254,0.0,0.0,80724,11.04.2012 01:00:00,7830,-0.02735957117972537,41.2,IS,0.27,0.0,Phase3-EA-S1v2-USDJPY-M15-0,USDJPYMT4,2304,10h 0m,Sell
98921.04,1.20147,11.04.2012 12:00:00,,0.0,-43.90999999997439,0.0,0.0,1.20126,11.04.2012 03:15:00,7831,-0.02323711354935099,7.79,IS,0.34,0.0,Phase3-EA-S4v1-EURCHF-M15-221,EURCHFMT4,2002,8h 45m,Buy
98845.83,128.78,11.04.2012 13:29:58,sl 128.780,-0.65,-119.11999999996624,0.0,0.0,128.11,10.04.2012 18:00:00,7832,-0.06303814543383102,-75.21,IS,0.09,0.0,Phase3-EA-B1v1-GBPJPY-M30-1,GBPJPYMT4,764,19h 29m,Sell
98811.18,106022,11.04.2012 21:30:00,,0.0,-153.76999999996042,0.0,0.0,106187,11.04.2012 20:15:00,7833,-0.08137487930960752,-34.65,IS,0.17,0.0,Phase3-EA-T1v2-EURJPY-M15-322,EURJPYMT4,1216,1h 15m,Buy
98872.94,80994,12.04.2012 03:00:00,,-2.91,-92.0099999999511,0.0,0.0,80.8,11.04.2012 18:15:00,7834,-0.04869156952120007,61.76,IS,0.27,0.0,Phase3-EA-S1v2-USDJPY-M15-0,USDJPYMT4,2306,8h 45m,Buy
98797.85,1.20275,12.04.2012 05:25:00,,-6.7,-167.0999999999476,0.0,0.0,1.20122,11.04.2012 21:05:00,7835,-0.08842909756542013,-75.09,IS,0.41,0.0,Phase3-EA-SA2v2-EURCHF-M5-43,EURCHFMT4,4200,8h 20m,Sell
98797.0,128766,12.04.2012 07:15:00,,0.0,-167.94999999995343,0.0,0.0,128763,12.04.2012 01:50:00,7836,-0.08887891643394882,-0.85,IS,0.23,0.0,Phase3-EA-S4v1-GBPJPY-M5-194,GBPJPYMT4,1864,5h 25m,Sell
98818.55,1.20217,12.04.2012 10:15:00,,0.0,-146.39999999996508,0.0,0.0,1.20275,12.04.2012 01:30:00,7837,-0.07747468512015844,21.55,IS,0.34,0.0,Phase3-EA-S4v1-EURCHF-M15-221,EURCHFMT4,2004,8h 45m,Sell
98826.02,1.2016,13.04.2012 04:45:00,,-1.08,-138.9299999999639,0.0,0.0,1.20141,12.04.2012 20:25:00,7838,-0.07352157106382093,7.47,IS,0.41,0.0,Phase3-EA-SA2v2-EURCHF-M5-43,EURCHFMT4,4202,8h 20m,Buy
98967.2,107028,13.04.2012 04:59:58,tp 107.028,-2.19,-0.0,0.0,0.0,105738,11.04.2012 05:30:00,7839,-0.0,141.18,IS,0.09,0.0,Phase3-EA-TR1v1-EURJPY-M30-91,EURJPYMT4,1270,1d 23h 29m,Buy
99043.84,106617,13.04.2012 09:45:00,,-1.03,-0.0,0.0,0.0,106247,12.04.2012 02:45:00,7840,-0.0,76.64,IS,0.17,0.0,Phase3-EA-T1v2-EURJPY-M15-322,EURJPYMT4,1218,1d 7h 0m,Buy
98963.95,106.27,13.04.2012 16:59:58,sl 106.270,0.0,-79.89000000001397,0.0,0.0,106.99,13.04.2012 05:00:00,7841,-0.042260038729648015,-79.89,IS,0.09,0.0,Phase3-EA-TR1v1-EURJPY-M30-91,EURJPYMT4,1272,11h 59m,Buy
98914.3,128.02,16.04.2012 04:55:00,,-1.02,-129.54000000000815,0.0,0.0,128191,13.04.2012 23:30:00,7842,-0.06852378792136676,-49.65,IS,0.23,0.0,Phase3-EA-S4v1-GBPJPY-M5-194,GBPJPYMT4,1866,2d 5h 25m,Buy
98944.95,1.20203,16.04.2012 05:25:00,,-2.23,-98.89000000001397,0.0,0.0,1.20277,13.04.2012 21:05:00,7843,-0.05231061747371075,30.65,IS,0.41,0.0,Phase3-EA-SA2v2-EURCHF-M5-43,EURCHFMT4,4204,2d 8h 20m,Sell
98949.37,1.20226,16.04.2012 14:30:00,,0.0,-94.47000000000116,0.0,0.0,1.20214,16.04.2012 05:45:00,7844,-0.0499725354711378,4.42,IS,0.34,0.0,Phase3-EA-S4v1-EURCHF-M15-221,EURCHFMT4,2006,8h 45m,Buy
98975.22,80415,16.04.2012 23:30:00,,0.0,-68.61999999999534,0.0,0.0,80492,16.04.2012 21:45:00,7845,-0.03629845860092305,25.85,IS,0.27,0.0,Phase3-EA-S1v2-USDJPY-M15-0,USDJPYMT4,2308,1h 45m,Sell
98991.35,80365,16.04.2012 23:45:00,,0.0,-52.48999999999069,0.0,0.0,80413,16.04.2012 23:30:00,7846,-0.027766046225039965,16.13,IS,0.27,0.0,Phase3-EA-S1v2-USDJPY-M15-0,USDJPYMT4,2310,15m 0s,Sell
98996.09,1.20177,17.04.2012 06:35:00,,-1.08,-47.75,0.0,0.0,1.20164,16.04.2012 22:15:00,7847,-0.025258691317315556,4.74,IS,0.41,0.0,Phase3-EA-SA2v2-EURCHF-M5-43,EURCHFMT4,4206,8h 20m,Buy
98915.26,105.95,17.04.2012 11:59:58,sl 105.950,-0.39,-128.5799999999872,0.0,0.0,105.23,16.04.2012 07:30:00,7848,-0.0680159692058662,-80.83,IS,0.09,0.0,Phase3-EA-TR1v1-EURJPY-M30-91,EURJPYMT4,1274,1d 4h 29m,Sell
98978.63,0.91522,17.04.2012 23:14:58,tp 0.91522,0.0,-65.20999999999185,0.0,0.0,0.91422,17.04.2012 22:15:00,7849,-0.034494644205276266,63.37,IS,0.58,0.0,Phase3-EA-SA2v2-USDCHF-M15-107,USDCHFMT4,1540,59m 58s,Buy
99089.34,129112,18.04.2012 02:29:57,tp 129.112,0.0,-0.0,0.0,0.0,128722,18.04.2012 00:10:00,7850,-0.0,110.71,IS,0.23,0.0,Phase3-EA-S4v1-GBPJPY-M5-194,GBPJPYMT4,1868,2h 19m,Buy
99002.44,106638,18.04.2012 04:29:57,sl 106.638,-0.39,-86.89999999999418,0.0,0.0,105858,17.04.2012 17:00:00,7851,-0.04595711212487918,-86.9,IS,0.09,0.0,Phase3-EA-TR1v1-EURJPY-M30-91,EURJPYMT4,1276,11h 29m,Sell
98993.57,0.91537,18.04.2012 06:30:00,,0.0,-95.76999999998952,0.0,0.0,0.91523,18.04.2012 02:15:00,7852,-0.0506480164349769,-8.87,IS,0.58,0.0,Phase3-EA-SA2v2-USDCHF-M15-107,USDCHFMT4,1542,4h 15m,Sell
98996.97,1.20152,18.04.2012 06:55:00,,-1.08,-92.36999999999534,0.0,0.0,1.20142,17.04.2012 22:35:00,7853,-0.04884992459119862,3.4,IS,0.41,0.0,Phase3-EA-SA2v2-EURCHF-M5-43,EURCHFMT4,4208,8h 20m,Buy
98857.63,129592,18.04.2012 08:00:00,,0.0,-231.70999999999185,0.0,0.0,129099,18.04.2012 02:35:00,7854,-0.12253995915369498,-139.34,IS,0.23,0.0,Phase3-EA-S4v1-GBPJPY-M5-194,GBPJPYMT4,1870,5h 25m,Sell
98878.75,1.20184,18.04.2012 10:15:00,,0.0,-210.5899999999965,0.0,0.0,1.20127,18.04.2012 01:30:00,7855,-0.1113706357005615,21.12,IS,0.34,0.0,Phase3-EA-S4v1-EURCHF-M15-221,EURCHFMT4,2008,8h 45m,Buy
99035.32,106608,18.04.2012 12:45:00,,-1.03,-54.01999999998952,0.0,0.0,105853,17.04.2012 10:45:00,7856,-0.028568506294426445,156.57,IS,0.17,0.0,Phase3-EA-T1v2-EURJPY-M15-322,EURJPYMT4,1220,1d 2h 0m,Buy
99045.08,1.20219,19.04.2012 06:25:00,,-3.22,-44.25999999998021,0.0,0.0,1.2019,18.04.2012 22:05:00,7857,-0.023406925001684457,9.76,IS,0.41,0.0,Phase3-EA-SA2v2-EURCHF-M5-43,EURCHFMT4,4210,8h 20m,Buy
99058.45,1.20162,19.04.2012 13:15:00,,0.0,-30.889999999984866,0.0,0.0,1.20198,19.04.2012 04:30:00,7858,-0.01633619325128789,13.37,IS,0.34,0.0,Phase3-EA-S4v1-EURCHF-M15-221,EURCHFMT4,2010,8h 45m,Sell
99010.5,106962,19.04.2012 19:29:58,sl 106.962,0.0,-78.83999999999651,0.0,0.0,107192,19.04.2012 17:45:00,7859,-0.04169457675403403,-47.95,IS,0.17,0.0,Phase3-EA-T1v2-EURJPY-M15-322,EURJPYMT4,1222,1h 44m,Buy
99031.38,81453,19.04.2012 21:45:00,,0.0,-57.95999999999185,0.0,0.0,81516,19.04.2012 21:30:00,7860,-0.030652177431044893,20.88,IS,0.27,0.0,Phase3-EA-S1v2-USDJPY-M15-0,USDJPYMT4,2312,15m 0s,Sell
99031.71,81.45,19.04.2012 22:00:00,,0.0,-57.63000000000466,0.0,0.0,81451,19.04.2012 21:45:00,7861,-0.030477656752096415,0.33,IS,0.27,0.0,Phase3-EA-S1v2-USDJPY-M15-0,USDJPYMT4,2314,15m 0s,Sell
99015.22,0.91436,20.04.2012 06:15:00,,0.0,-74.11999999999534,0.0,0.0,0.91462,20.04.2012 02:00:00,7862,-0.039198402194431055,-16.49,IS,0.58,0.0,Phase3-EA-SA2v2-USDCHF-M15-107,USDCHFMT4,1544,4h 15m,Buy
99007.42,1.20187,20.04.2012 07:10:00,,-1.08,-81.9199999999837,0.0,0.0,1.20202,19.04.2012 22:50:00,7863,-0.043323436424276246,-7.8,IS,0.41,0.0,Phase3-EA-SA2v2-EURCHF-M5-43,EURCHFMT4,4212,8h 20m,Buy
99086.15,130855,20.04.2012 07:15:00,,0.0,-3.1899999999732245,0.0,0.0,131134,20.04.2012 01:50:00,7864,-0.0016870332298865808,78.73,IS,0.23,0.0,Phase3-EA-S4v1-GBPJPY-M5-194,GBPJPYMT4,1872,5h 25m,Sell
99092.64,107132,20.04.2012 08:00:00,,-1.02,-0.0,0.0,0.0,107096,19.04.2012 22:15:00,7865,-0.0,6.49,IS,0.17,0.0,Phase3-EA-T1v2-EURJPY-M15-322,EURJPYMT4,1224,9h 45m,Buy
99354.58,1.60994,20.04.2012 11:59:58,tp 1.60994,-2.66,-0.0,0.0,0.0,1.59104,17.04.2012 10:30:00,7866,-0.0,261.94,IS,0.14,0.0,Phase3-EA-B1v1-GBPUSD-M30-14,GBPUSDMT4,516,3d 1h 29m,Buy
99491.19,107714,20.04.2012 13:29:58,tp 107.714,-2.17,-0.0,0.0,0.0,106454,18.04.2012 03:30:00,7867,-0.0,136.61,IS,0.09,0.0,Phase3-EA-TR1v1-EURJPY-M30-91,EURJPYMT4,1277,2d 9h 59m,Buy
99577.77,107.72,20.04.2012 23:30:00,,0.0,-0.0,0.0,0.0,107305,20.04.2012 09:30:00,7868,-0.0,86.58,IS,0.17,0.0,Phase3-EA-T1v2-EURJPY-M15-322,EURJPYMT4,1226,14h 0m,Buy
99584.34,1.20151,23.04.2012 06:35:00,,-1.08,-0.0,0.0,0.0,1.20134,20.04.2012 22:15:00,7869,-0.0,6.57,IS,0.41,0.0,Phase3-EA-SA2v2-EURCHF-M5-43,EURCHFMT4,4214,2d 8h 20m,Buy
99542.34,1.61006,23.04.2012 09:59:58,sl 1.61006,0.0,-42.0,0.0,0.0,1.61306,23.04.2012 03:00:00,7870,-0.02215372851998215,-42.0,IS,0.14,0.0,Phase3-EA-B1v1-GBPUSD-M30-14,GBPUSDMT4,518,6h 59m,Buy
99685.09,106.43,23.04.2012 10:59:58,tp 106.430,-0.39,-0.0,0.0,0.0,107.72,20.04.2012 23:30:00,7871,-0.0,142.75,IS,0.09,0.0,Phase3-EA-TR1v1-EURJPY-M30-91,EURJPYMT4,1280,2d 11h 29m,Sell
99576.51,130429,24.04.2012 07:25:00,,0.0,-108.5799999999872,0.0,0.0,130811,24.04.2012 02:00:00,7872,-0.05724224291956052,-108.58,IS,0.23,0.0,Phase3-EA-S4v1-GBPJPY-M5-194,GBPJPYMT4,1874,5h 25m,Buy
99581.45,1.20172,24.04.2012 08:50:00,,0.0,-103.63999999998487,0.0,0.0,1.20161,24.04.2012 00:30:00,7873,-0.054637926470649155,4.94,IS,0.41,0.0,Phase3-EA-SA2v2-EURCHF-M5-43,EURCHFMT4,4216,8h 20m,Buy
99582.57,1.20173,24.04.2012 09:45:00,,0.0,-102.51999999998952,0.0,0.0,1.2017,24.04.2012 01:00:00,7874,-0.0540474741583481,1.12,IS,0.34,0.0,Phase3-EA-S4v1-EURCHF-M15-221,EURCHFMT4,2012,8h 45m,Buy
99648.7,81.25,24.04.2012 22:00:00,,0.0,-36.389999999984866,0.0,0.0,81051,24.04.2012 17:00:00,7875,-0.019184428254210597,66.13,IS,0.27,0.0,Phase3-EA-S1v2-USDJPY-M15-0,USDJPYMT4,2316,5h 0m,Buy
99709.05,0.91003,25.04.2012 03:14:58,tp 0.91003,-3.38,-0.0,0.0,0.0,0.91103,24.04.2012 23:00:00,7876,-0.0,60.35,IS,0.58,0.0,Phase3-EA-SA2v2-USDCHF-M15-107,USDCHFMT4,1546,4h 14m,Sell
99705.89,1.20156,25.04.2012 10:15:00,,0.0,-3.1600000000034925,0.0,0.0,1.20149,25.04.2012 01:55:00,7877,-0.001665708620650141,-3.16,IS,0.41,0.0,Phase3-EA-SA2v2-EURCHF-M5-43,EURCHFMT4,4218,8h 20m,Sell
99672.61,107343,25.04.2012 11:15:00,,0.0,-36.44000000000233,0.0,0.0,107502,25.04.2012 10:30:00,7878,-0.01920836143557846,-33.28,IS,0.17,0.0,Phase3-EA-T1v2-EURJPY-M15-322,EURJPYMT4,1228,45m 0s,Buy
99629.55,1.60944,25.04.2012 11:59:58,sl 1.60944,-1.06,-79.5,0.0,0.0,1.61244,23.04.2012 21:30:00,7879,-0.04190627700681641,-43.06,IS,0.14,0.0,Phase3-EA-B1v1-GBPUSD-M30-14,GBPUSDMT4,520,1d 14h 29m,Buy
99581.46,107542,25.04.2012 19:44:58,sl 107.542,0.0,-127.58999999999651,0.0,0.0,107312,25.04.2012 18:15:00,7880,-0.06725562117357936,-48.09,IS,0.17,0.0,Phase3-EA-T1v2-EURJPY-M15-322,EURJPYMT4,1230,1h 29m,Sell
99575.95,1.20149,26.04.2012 05:10:00,,-3.25,-133.10000000000582,0.0,0.0,1.20154,25.04.2012 20:50:00,7881,-0.07016006880009444,-5.51,IS,0.41,0.0,Phase3-EA-SA2v2-EURCHF-M5-43,EURCHFMT4,4220,8h 20m,Buy
99527.75,107342,26.04.2012 12:14:57,sl 107.342,0.0,-181.30000000001746,0.0,0.0,107572,26.04.2012 10:45:00,7882,-0.09556739649479933,-48.2,IS,0.17,0.0,Phase3-EA-T1v2-EURJPY-M15-322,EURJPYMT4,1232,1h 29m,Buy
99507.35,0.90991,27.04.2012 04:30:00,,0.0,-201.70000000001164,0.0,0.0,0.90959,27.04.2012 00:15:00,7883,-0.10632070531163972,-20.4,IS,0.58,0.0,Phase3-EA-SA2v2-USDCHF-M15-107,USDCHFMT4,1548,4h 15m,Sell
99515.0,1.20147,27.04.2012 04:40:00,,-2.26,-194.05000000001746,0.0,0.0,1.20169,26.04.2012 20:20:00,7884,-0.10228821450532649,7.65,IS,0.41,0.0,Phase3-EA-SA2v2-EURCHF-M5-43,EURCHFMT4,4222,8h 20m,Sell
99489.14,80916,27.04.2012 05:30:00,,-1.5,-219.9100000000035,0.0,0.0,80843,26.04.2012 19:15:00,7885,-0.11591961479961187,-25.86,IS,0.27,0.0,Phase3-EA-S1v2-USDJPY-M15-0,USDJPYMT4,2318,10h 15m,Sell
99440.56,106995,27.04.2012 06:59:58,sl 106.995,0.0,-268.4899999999907,0.0,0.0,106765,27.04.2012 05:30:00,7886,-0.14152724922716664,-48.58,IS,0.17,0.0,Phase3-EA-T1v2-EURJPY-M15-322,EURJPYMT4,1234,1h 29m,Sell
99392.24,106958,27.04.2012 07:59:58,sl 106.958,0.0,-316.8099999999977,0.0,0.0,107188,27.04.2012 07:30:00,7887,-0.1669978316796152,-48.32,IS,0.17,0.0,Phase3-EA-T1v2-EURJPY-M15-322,EURJPYMT4,1236,29m 58s,Buy
99395.97,1.20155,27.04.2012 10:30:00,,0.0,-313.0799999999872,0.0,0.0,1.20145,27.04.2012 01:45:00,7888,-0.16503166295966723,3.73,IS,0.34,0.0,Phase3-EA-S4v1-EURCHF-M15-221,EURCHFMT4,2014,8h 45m,Buy
99367.66,0.90767,30.04.2012 03:15:00,,-3.39,-341.38999999998487,0.0,0.0,0.90728,27.04.2012 23:00:00,7889,-0.1799545145579424,-28.31,IS,0.58,0.0,Phase3-EA-SA2v2-USDCHF-M15-107,USDCHFMT4,1550,2d 4h 15m,Sell
99379.23,1.20135,30.04.2012 07:45:00,,-1.09,-329.8199999999779,0.0,0.0,1.20107,27.04.2012 23:25:00,7890,-0.17385570166524858,11.57,IS,0.41,0.0,Phase3-EA-SA2v2-EURCHF-M5-43,EURCHFMT4,4224,2d 8h 20m,Buy
99522.16,106017,30.04.2012 11:29:57,tp 106.017,-1.94,-186.88999999998487,0.0,0.0,107307,25.04.2012 09:00:00,7891,-0.09851401395978975,142.93,IS,0.09,0.0,Phase3-EA-TR1v1-EURJPY-M30-91,EURJPYMT4,1282,5d 2h 29m,Sell
99441.87,129566,30.04.2012 18:29:58,sl 129.566,-4.8,-267.179999999993,0.0,0.0,130236,18.04.2012 12:00:00,7892,-0.14083671812177254,-80.29,IS,0.09,0.0,Phase3-EA-B1v1-GBPJPY-M30-1,GBPJPYMT4,766,12d 6h 29m,Buy
99449.15,79781,01.05.2012 00:15:00,,-1.52,-259.8999999999942,0.0,0.0,79807,30.04.2012 22:45:00,7893,-0.13699926281850744,7.28,IS,0.27,0.0,Phase3-EA-S1v2-USDJPY-M15-0,USDJPYMT4,2320,1h 30m,Sell
99468.45,129559,01.05.2012 06:45:00,,0.0,-240.60000000000582,0.0,0.0,129626,01.05.2012 01:20:00,7894,-0.1268257892810097,19.3,IS,0.23,0.0,Phase3-EA-S4v1-GBPJPY-M5-194,GBPJPYMT4,1876,5h 25m,Sell
99481.56,1.20101,01.05.2012 07:20:00,,-2.26,-227.4900000000198,0.0,0.0,1.20135,30.04.2012 23:00:00,7895,-0.1199152069972515,13.11,IS,0.41,0.0,Phase3-EA-SA2v2-EURCHF-M5-43,EURCHFMT4,4226,8h 20m,Sell
99432.52,105816,01.05.2012 11:14:58,sl 105.816,0.0,-276.53000000002794,0.0,0.0,105586,01.05.2012 08:30:00,7896,-0.1457653179961775,-49.04,IS,0.17,0.0,Phase3-EA-T1v2-EURJPY-M15-322,EURJPYMT4,1238,2h 44m,Sell
99436.65,1.20128,01.05.2012 13:00:00,,0.0,-272.4000000000233,0.0,0.0,1.20117,01.05.2012 04:15:00,7897,-0.14358830008374548,4.13,IS,0.34,0.0,Phase3-EA-S4v1-EURCHF-M15-221,EURCHFMT4,2016,8h 45m,Buy
99424.38,0.90775,02.05.2012 02:30:00,,-0.77,-284.6700000000128,0.0,0.0,0.90793,01.05.2012 22:15:00,7898,-0.15005609906328257,-12.27,IS,0.58,0.0,Phase3-EA-SA2v2-USDCHF-M15-107,USDCHFMT4,1552,4h 15m,Buy
99437.87,80.21,02.05.2012 03:15:00,,-0.98,-271.1800000000221,0.0,0.0,80167,01.05.2012 22:45:00,7899,-0.14294521004665914,13.49,IS,0.27,0.0,Phase3-EA-S1v2-USDJPY-M15-0,USDJPYMT4,2322,4h 30m,Buy
99449.14,1.20146,02.05.2012 04:45:00,,-2.26,-259.9100000000326,0.0,0.0,1.20176,01.05.2012 20:25:00,7900,-0.13700453404833987,11.27,IS,0.41,0.0,Phase3-EA-SA2v2-EURCHF-M5-43,EURCHFMT4,4228,8h 20m,Sell
99410.12,130093,02.05.2012 06:55:00,,0.0,-298.9300000000221,0.0,0.0,129957,02.05.2012 01:30:00,7901,-0.15757287277545354,-39.02,IS,0.23,0.0,Phase3-EA-S4v1-GBPJPY-M5-194,GBPJPYMT4,1878,5h 25m,Sell
99417.23,1.20163,02.05.2012 10:30:00,,0.0,-291.8200000000361,0.0,0.0,1.20144,02.05.2012 01:45:00,7902,-0.15382502837900222,7.11,IS,0.34,0.0,Phase3-EA-S4v1-EURCHF-M15-221,EURCHFMT4,2018,8h 45m,Buy
99368.52,105937,02.05.2012 10:59:58,sl 105.937,0.0,-340.53000000002794,0.0,0.0,106167,02.05.2012 07:30:00,7903,-0.17950118879411778,-48.71,IS,0.17,0.0,Phase3-EA-T1v2-EURJPY-M15-322,EURJPYMT4,1240,3h 29m,Buy
99380.31,80131,02.05.2012 22:15:00,,0.0,-328.7400000000198,0.0,0.0,80166,02.05.2012 21:30:00,7904,-0.17328640884555543,11.79,IS,0.27,0.0,Phase3-EA-S1v2-USDJPY-M15-0,USDJPYMT4,2324,45m 0s,Sell
99360.0,0.91404,03.05.2012 07:00:00,,0.0,-349.05000000001746,0.0,0.0,0.91372,03.05.2012 02:45:00,7905,-0.18399227659408804,-20.31,IS,0.58,0.0,Phase3-EA-SA2v2-USDCHF-M15-107,USDCHFMT4,1554,4h 15m,Sell
99362.6,1.20155,03.05.2012 08:15:00,,-3.23,-346.45000000001164,0.0,0.0,1.20142,02.05.2012 23:55:00,7906,-0.18262175684291865,2.6,IS,0.41,0.0,Phase3-EA-SA2v2-EURCHF-M5-43,EURCHFMT4,4230,8h 20m,Buy
99366.69,1.20148,03.05.2012 09:45:00,,0.0,-342.36000000001513,0.0,0.0,1.20137,03.05.2012 01:00:00,7907,-0.18046582384973964,4.09,IS,0.34,0.0,Phase3-EA-S4v1-EURCHF-M15-221,EURCHFMT4,2020,8h 45m,Buy
99315.87,105968,03.05.2012 15:59:58,sl 105.968,-2.23,-393.1800000000221,0.0,0.0,105738,02.05.2012 11:30:00,7908,-0.20725421375523273,-50.82,IS,0.17,0.0,Phase3-EA-T1v2-EURJPY-M15-322,EURJPYMT4,1242,1d 4h 29m,Sell
99323.16,129748,04.05.2012 04:30:00,,-1.03,-385.89000000001397,0.0,0.0,129719,03.05.2012 23:05:00,7909,-0.20341148722215058,7.29,IS,0.23,0.0,Phase3-EA-S4v1-GBPJPY-M5-194,GBPJPYMT4,1880,5h 25m,Buy
99329.85,1.20127,04.05.2012 11:30:00,,0.0,-379.20000000001164,0.0,0.0,1.20145,04.05.2012 02:45:00,7910,-0.19988503447780215,6.69,IS,0.34,0.0,Phase3-EA-S4v1-EURCHF-M15-221,EURCHFMT4,2022,8h 45m,Sell
99283.6,1.61519,04.05.2012 17:59:57,sl 1.61519,-4.25,-425.45000000001164,0.0,0.0,1.61819,26.04.2012 09:30:00,7911,-0.22426447235912617,-46.25,IS,0.14,0.0,Phase3-EA-B1v1-GBPUSD-M30-14,GBPUSDMT4,522,8d 8h 29m,Buy
99423.31,104847,04.05.2012 17:59:58,tp 104.847,-2.35,-285.7400000000198,0.0,0.0,106107,30.04.2012 06:30:00,7912,-0.1506201206531893,139.71,IS,0.09,0.0,Phase3-EA-TR1v1-EURJPY-M30-91,EURJPYMT4,1283,4d 11h 29m,Sell
99433.79,79834,04.05.2012 22:45:00,,0.0,-275.2600000000093,0.0,0.0,79865,04.05.2012 22:00:00,7913,-0.14509587181002107,10.48,IS,0.27,0.0,Phase3-EA-S1v2-USDJPY-M15-0,USDJPYMT4,2326,45m 0s,Sell
99575.67,103231,07.05.2012 01:59:57,tp 103.231,-0.39,-133.38000000000466,0.0,0.0,104491,04.05.2012 20:30:00,7914,-0.07030766323483481,141.88,IS,0.09,0.0,Phase3-EA-TR1v1-EURJPY-M30-91,EURJPYMT4,1286,2d 5h 29m,Sell
99638.38,0.92496,07.05.2012 01:59:58,tp 0.92496,0.0,-70.6700000000128,0.0,0.0,0.92596,07.05.2012 01:45:00,7915,-0.03725178108266984,62.71,IS,0.58,0.0,Phase3-EA-SA2v2-USDCHF-M15-107,USDCHFMT4,1556,14m 58s,Sell
99651.21,1.20098,07.05.2012 04:30:00,,-2.23,-57.84000000002561,0.0,0.0,1.20132,04.05.2012 20:10:00,7916,-0.030488793233652004,12.83,IS,0.41,0.0,Phase3-EA-SA2v2-EURCHF-M5-43,EURCHFMT4,4232,2d 8h 20m,Sell
99673.12,128621,07.05.2012 07:00:00,,0.0,-35.93000000002212,0.0,0.0,128545,07.05.2012 01:35:00,7917,-0.018939528715167804,21.91,IS,0.23,0.0,Phase3-EA-S4v1-GBPJPY-M5-194,GBPJPYMT4,1882,5h 25m,Buy
99679.76,1.20112,07.05.2012 14:15:00,,0.0,-29.29000000000815,0.0,0.0,1.20094,07.05.2012 05:30:00,7918,-0.01543943211987414,6.64,IS,0.34,0.0,Phase3-EA-S4v1-EURCHF-M15-221,EURCHFMT4,2024,8h 45m,Buy
99598.72,104325,07.05.2012 16:29:58,sl 104.325,0.0,-110.3300000000163,0.0,0.0,103605,07.05.2012 02:00:00,7919,-0.058157478517770284,-81.04,IS,0.09,0.0,Phase3-EA-TR1v1-EURJPY-M30-91,EURJPYMT4,1288,14h 29m,Sell
99598.35,1.20115,08.05.2012 14:30:00,,0.0,-110.70000000001164,0.0,0.0,1.20116,08.05.2012 05:45:00,7920,-0.05835251402081842,-0.37,IS,0.34,0.0,Phase3-EA-S4v1-EURCHF-M15-221,EURCHFMT4,2026,8h 45m,Buy
99599.67,1.20103,09.05.2012 04:20:00,,-2.22,-109.38000000000466,0.0,0.0,1.20111,08.05.2012 20:00:00,7921,-0.05765671168560722,1.32,IS,0.41,0.0,Phase3-EA-SA2v2-EURCHF-M5-43,EURCHFMT4,4234,8h 20m,Sell
99478.7,0.92538,09.05.2012 04:30:00,,0.0,-230.35000000000582,0.0,0.0,0.92345,09.05.2012 00:15:00,7922,-0.1214227787235271,-120.97,IS,0.58,0.0,Phase3-EA-SA2v2-USDCHF-M15-107,USDCHFMT4,1558,4h 15m,Sell
99409.2,128685,09.05.2012 07:45:00,,0.0,-299.8500000000058,0.0,0.0,128926,09.05.2012 02:20:00,7923,-0.15805782591816533,-69.5,IS,0.23,0.0,Phase3-EA-S4v1-GBPJPY-M5-194,GBPJPYMT4,1884,5h 25m,Buy
99614.28,128017,09.05.2012 14:59:58,tp 128.017,-4.55,-94.77000000001863,0.0,0.0,129867,02.05.2012 14:00:00,7924,-0.04995544493002228,205.08,IS,0.09,0.0,Phase3-EA-B1v1-GBPJPY-M30-1,GBPJPYMT4,768,7d 0h 59m,Sell
99615.38,1.20095,09.05.2012 15:15:00,,0.0,-93.6700000000128,0.0,0.0,1.20092,09.05.2012 06:30:00,7925,-0.04937560965067962,1.1,IS,0.34,0.0,Phase3-EA-S4v1-EURCHF-M15-221,EURCHFMT4,2028,8h 45m,Buy
99761.05,102946,09.05.2012 15:29:58,tp 102.946,-0.39,-0.0,0.0,0.0,104236,08.05.2012 06:00:00,7926,-0.0,145.67,IS,0.09,0.0,Phase3-EA-TR1v1-EURJPY-M30-91,EURJPYMT4,1290,1d 9h 29m,Sell
99804.81,0.92788,10.05.2012 04:30:00,,0.0,-0.0,0.0,0.0,0.92858,10.05.2012 00:15:00,7927,-0.0,43.76,IS,0.58,0.0,Phase3-EA-SA2v2-USDCHF-M15-107,USDCHFMT4,1560,4h 15m,Sell
99801.73,1201,10.05.2012 04:30:00,,-6.62,-3.0799999999871943,0.0,0.0,1.20108,09.05.2012 20:10:00,7928,-0.0016227196771183977,-3.08,IS,0.41,0.0,Phase3-EA-SA2v2-EURCHF-M5-43,EURCHFMT4,4236,8h 20m,Sell
99795.79,79603,10.05.2012 07:00:00,,-4.58,-9.019999999989523,0.0,0.0,79599,09.05.2012 17:15:00,7929,-0.004752250483003831,-5.94,IS,0.27,0.0,Phase3-EA-S1v2-USDJPY-M15-0,USDJPYMT4,2328,13h 45m,Sell
99796.08,128471,10.05.2012 07:40:00,,0.0,-8.729999999981374,0.0,0.0,128472,10.05.2012 02:15:00,7930,-0.004599461941971521,0.29,IS,0.23,0.0,Phase3-EA-S4v1-GBPJPY-M5-194,GBPJPYMT4,1886,5h 25m,Sell
99752.48,1.61174,10.05.2012 10:59:58,sl 1.61174,-1.6,-52.329999999987194,0.0,0.0,1.61474,09.05.2012 21:00:00,7931,-0.02757042879997988,-43.6,IS,0.14,0.0,Phase3-EA-B1v1-GBPUSD-M30-14,GBPUSDMT4,524,13h 59m,Buy
99750.65,1.20107,10.05.2012 13:45:00,,0.0,-54.15999999997439,0.0,0.0,1.20102,10.05.2012 05:00:00,7932,-0.02853457717956372,-1.83,IS,0.34,0.0,Phase3-EA-S4v1-EURCHF-M15-221,EURCHFMT4,2030,8h 45m,Sell
99781.71,79981,10.05.2012 22:30:00,,0.0,-23.099999999976717,0.0,0.0,79889,10.05.2012 21:00:00,7933,-0.012170397578426317,31.06,IS,0.27,0.0,Phase3-EA-S1v2-USDJPY-M15-0,USDJPYMT4,2330,1h 30m,Buy
99725.56,0.92959,11.05.2012 05:15:00,,0.0,-79.2499999999709,0.0,0.0,0.92869,11.05.2012 01:00:00,7934,-0.04175342026367548,-56.15,IS,0.58,0.0,Phase3-EA-SA2v2-USDCHF-M15-107,USDCHFMT4,1562,4h 15m,Sell
99720.97,1.20101,11.05.2012 05:50:00,,-1.06,-83.8399999999674,0.0,0.0,1.20109,10.05.2012 21:30:00,7935,-0.044171694068220524,-4.59,IS,0.41,0.0,Phase3-EA-SA2v2-EURCHF-M5-43,EURCHFMT4,4238,8h 20m,Buy
99719.53,128814,11.05.2012 06:15:00,,0.0,-85.27999999996973,0.0,0.0,128819,11.05.2012 00:50:00,7936,-0.04493036820298156,-1.44,IS,0.23,0.0,Phase3-EA-S4v1-GBPJPY-M5-194,GBPJPYMT4,1888,5h 25m,Buy
99727.22,1.2012,11.05.2012 13:45:00,,0.0,-77.5899999999674,0.0,0.0,1.20099,11.05.2012 05:00:00,7937,-0.04087883758054774,7.69,IS,0.34,0.0,Phase3-EA-S4v1-EURCHF-M15-221,EURCHFMT4,2032,8h 45m,Buy
99730.3,1.20111,14.05.2012 10:15:00,,0.0,-74.50999999998021,0.0,0.0,1.20118,14.05.2012 01:55:00,7938,-0.039256117903429345,3.08,IS,0.41,0.0,Phase3-EA-SA2v2-EURCHF-M5-43,EURCHFMT4,4240,8h 20m,Sell
99736.13,1.20104,14.05.2012 11:30:00,,0.0,-68.67999999999302,0.0,0.0,1.2012,14.05.2012 02:45:00,7939,-0.03618454137173493,5.83,IS,0.34,0.0,Phase3-EA-S4v1-EURCHF-M15-221,EURCHFMT4,2034,8h 45m,Sell
99716.74,0.93584,15.05.2012 03:15:00,,-3.28,-88.07000000000698,0.0,0.0,0.93558,14.05.2012 23:00:00,7940,-0.04640029933909831,-19.39,IS,0.58,0.0,Phase3-EA-SA2v2-USDCHF-M15-107,USDCHFMT4,1564,4h 15m,Sell
99703.72,79.86,15.05.2012 04:30:00,,-1.52,-101.08999999999651,0.0,0.0,79826,14.05.2012 19:00:00,7941,-0.05325997797421272,-13.02,IS,0.27,0.0,Phase3-EA-S1v2-USDJPY-M15-0,USDJPYMT4,2332,9h 30m,Sell
99705.18,1.20111,15.05.2012 11:15:00,,0.0,-99.63000000000466,0.0,0.0,1.20115,15.05.2012 02:30:00,7942,-0.05249076669869665,1.46,IS,0.34,0.0,Phase3-EA-S4v1-EURCHF-M15-221,EURCHFMT4,2036,8h 45m,Sell
99844.48,102208,15.05.2012 16:29:58,tp 102.208,-2.36,-0.0,0.0,0.0,103468,09.05.2012 08:30:00,7943,-0.0,139.3,IS,0.09,0.0,Phase3-EA-TR1v1-EURJPY-M30-91,EURJPYMT4,1291,6d 7h 59m,Sell
100200.5,102057,15.05.2012 23:59:58,tp 102.057,-4.47,-0.0,0.0,0.0,103757,09.05.2012 02:00:00,7944,-0.0,356.02,IS,0.17,0.0,Phase3-EA-T1v2-EURJPY-M15-322,EURJPYMT4,1244,6d 21h 59m,Sell
100196.16,1.20095,16.05.2012 04:35:00,,-2.17,-4.3399999999965075,0.0,0.0,1.2009,15.05.2012 20:15:00,7945,-0.0022818026240711774,-4.34,IS,0.41,0.0,Phase3-EA-SA2v2-EURCHF-M5-43,EURCHFMT4,4242,8h 20m,Sell
100247.87,0.94352,17.05.2012 02:45:00,tp 0.94352,-9.76,-0.0,0.0,0.0,0.94452,16.05.2012 23:45:00,7946,-0.0,51.71,IS,0.58,0.0,Phase3-EA-SA2v2-USDCHF-M15-107,USDCHFMT4,1566,3h 0m,Sell
100292.29,127736,17.05.2012 07:25:00,,0.0,-0.0,0.0,0.0,127891,17.05.2012 02:00:00,7947,-0.0,44.42,IS,0.23,0.0,Phase3-EA-S4v1-GBPJPY-M5-194,GBPJPYMT4,1890,5h 25m,Sell
100297.51,1.20101,17.05.2012 08:40:00,,0.0,-0.0,0.0,0.0,1.20089,17.05.2012 00:20:00,7948,-0.0,5.22,IS,0.41,0.0,Phase3-EA-SA2v2-EURCHF-M5-43,EURCHFMT4,4244,8h 20m,Buy
100208.3,101483,17.05.2012 17:29:58,sl 101.483,-1.65,-89.20999999999185,0.0,0.0,102263,16.05.2012 04:00:00,7949,-0.046879226112833364,-89.21,IS,0.09,0.0,Phase3-EA-TR1v1-EURJPY-M30-91,EURJPYMT4,1294,1d 13h 29m,Buy
100209.01,79322,18.05.2012 01:00:00,,-0.99,-88.5,0.0,0.0,79317,17.05.2012 23:30:00,7950,-0.046506126117992735,0.71,IS,0.27,0.0,Phase3-EA-S1v2-USDJPY-M15-0,USDJPYMT4,2334,1h 30m,Buy
100203.31,0.94531,18.05.2012 03:15:00,,-3.25,-94.20000000001164,0.0,0.0,0.94527,17.05.2012 23:00:00,7951,-0.049501435935767876,-5.7,IS,0.58,0.0,Phase3-EA-SA2v2-USDCHF-M15-107,USDCHFMT4,1568,4h 15m,Sell
100566.85,100472,18.05.2012 07:59:58,tp 100.472,-0.75,-0.0,0.0,0.0,102172,17.05.2012 10:30:00,7952,-0.0,363.54,IS,0.17,0.0,Phase3-EA-T1v2-EURJPY-M15-322,EURJPYMT4,1246,21h 29m,Sell
100553.92,79.36,18.05.2012 08:00:00,,0.0,-12.929999999993015,0.0,0.0,79322,18.05.2012 01:00:00,7953,-0.006785020584636305,-12.93,IS,0.27,0.0,Phase3-EA-S1v2-USDJPY-M15-0,USDJPYMT4,2336,7h 0m,Sell
100696.36,100439,18.05.2012 08:29:58,tp 100.439,-0.4,-0.0,0.0,0.0,101699,17.05.2012 15:00:00,7954,-0.0,142.44,IS,0.09,0.0,Phase3-EA-TR1v1-EURJPY-M30-91,EURJPYMT4,1295,17h 29m,Sell
100686.41,1.20111,18.05.2012 08:55:00,,0.0,-9.950000000011642,0.0,0.0,1.20088,18.05.2012 00:35:00,7955,-0.00521771889091728,-9.95,IS,0.41,0.0,Phase3-EA-SA2v2-EURCHF-M5-43,EURCHFMT4,4246,8h 20m,Sell
100748.08,0.94047,21.05.2012 02:59:57,tp 0.94047,0.0,-0.0,0.0,0.0,0.94147,21.05.2012 02:15:00,7956,-0.0,61.67,IS,0.58,0.0,Phase3-EA-SA2v2-USDCHF-M15-107,USDCHFMT4,1570,44m 57s,Sell
100751.84,1.20102,21.05.2012 05:30:00,,-1.05,-0.0,0.0,0.0,1.20091,18.05.2012 21:10:00,7957,-0.0,3.76,IS,0.41,0.0,Phase3-EA-SA2v2-EURCHF-M5-43,EURCHFMT4,4248,2d 8h 20m,Buy
100748.22,1.20114,21.05.2012 11:00:00,,0.0,-3.6199999999953434,0.0,0.0,1.20104,21.05.2012 02:15:00,7958,-0.001897753646830005,-3.62,IS,0.34,0.0,Phase3-EA-S4v1-EURCHF-M15-221,EURCHFMT4,2038,8h 45m,Sell
100777.78,0.93782,22.05.2012 03:15:00,,-0.74,-0.0,0.0,0.0,0.93733,21.05.2012 23:00:00,7959,-0.0,29.56,IS,0.58,0.0,Phase3-EA-SA2v2-USDCHF-M15-107,USDCHFMT4,1572,4h 15m,Buy
100781.71,1.20098,22.05.2012 04:40:00,,-2.19,-0.0,0.0,0.0,1.20112,21.05.2012 20:20:00,7960,-0.0,3.93,IS,0.41,0.0,Phase3-EA-SA2v2-EURCHF-M5-43,EURCHFMT4,4250,8h 20m,Sell
100810.39,125523,22.05.2012 08:10:00,,0.0,-0.0,0.0,0.0,125622,22.05.2012 02:45:00,7961,-0.0,28.68,IS,0.23,0.0,Phase3-EA-S4v1-GBPJPY-M5-194,GBPJPYMT4,1892,5h 25m,Sell
100732.55,125887,22.05.2012 10:29:58,sl 125.887,-1.98,-77.83999999999651,0.0,0.0,125217,17.05.2012 23:00:00,7962,-0.040794424244925215,-77.84,IS,0.09,0.0,Phase3-EA-B1v1-GBPJPY-M30-1,GBPJPYMT4,770,4d 11h 29m,Sell
100876.81,102.03,22.05.2012 16:59:58,tp 102.030,-1.12,-0.0,0.0,0.0,100.74,18.05.2012 11:30:00,7963,-0.0,144.26,IS,0.09,0.0,Phase3-EA-TR1v1-EURJPY-M30-91,EURJPYMT4,1298,4d 5h 29m,Buy
100827.98,101423,22.05.2012 22:44:59,sl 101.423,0.0,-48.829999999987194,0.0,0.0,101653,22.05.2012 09:15:00,7964,-0.02558194471082532,-48.83,IS,0.17,0.0,Phase3-EA-T1v2-EURJPY-M15-322,EURJPYMT4,1248,13h 29m,Buy
100723.24,0.94867,23.05.2012 03:15:00,,-3.25,-153.56999999997788,0.0,0.0,0.94701,22.05.2012 23:00:00,7965,-0.08045503275121664,-104.74,IS,0.58,0.0,Phase3-EA-SA2v2-USDCHF-M15-107,USDCHFMT4,1574,4h 15m,Sell
100868.87,100576,23.05.2012 11:29:58,tp 100.576,-0.39,-7.9399999999732245,0.0,0.0,101866,22.05.2012 20:00:00,7966,-0.004159750993309878,145.63,IS,0.09,0.0,Phase3-EA-TR1v1-EURJPY-M30-91,EURJPYMT4,1300,15h 29m,Sell
100870.3,1.20089,23.05.2012 13:45:00,,0.0,-6.509999999980209,0.0,0.0,1.20085,23.05.2012 05:00:00,7967,-0.003410576696027242,1.43,IS,0.34,0.0,Phase3-EA-S4v1-EURCHF-M15-221,EURCHFMT4,2040,8h 45m,Buy
101013.21,100055,23.05.2012 17:29:58,tp 100.055,0.0,-0.0,0.0,0.0,101315,23.05.2012 02:30:00,7968,-0.0,142.91,IS,0.09,0.0,Phase3-EA-TR1v1-EURJPY-M30-91,EURJPYMT4,1301,14h 59m,Sell
100997.23,79406,23.05.2012 17:30:00,,0.0,-15.980000000010477,0.0,0.0,79359,23.05.2012 17:15:00,7969,-0.008365913540749587,-15.98,IS,0.27,0.0,Phase3-EA-S1v2-USDJPY-M15-0,USDJPYMT4,2338,15m 0s,Sell
101057.99,0.95452,24.05.2012 02:29:58,tp 0.95452,0.0,-0.0,0.0,0.0,0.95352,24.05.2012 02:00:00,7970,-0.0,60.76,IS,0.58,0.0,Phase3-EA-SA2v2-USDCHF-M15-107,USDCHFMT4,1576,29m 58s,Buy
101090.69,124648,24.05.2012 07:15:00,,0.0,-0.0,0.0,0.0,124761,24.05.2012 01:50:00,7971,-0.0,32.7,IS,0.23,0.0,Phase3-EA-S4v1-GBPJPY-M5-194,GBPJPYMT4,1894,5h 25m,Sell
101041.46,100163,24.05.2012 16:14:57,sl 100.163,0.0,-49.23000000001048,0.0,0.0,99933,24.05.2012 08:00:00,7972,-0.025762636578480286,-49.23,IS,0.17,0.0,Phase3-EA-T1v2-EURJPY-M15-322,EURJPYMT4,1250,8h 14m,Sell
101087.49,1.20299,25.05.2012 04:24:59,tp 1.20299,-1.03,-3.2000000000116415,0.0,0.0,1.20189,24.05.2012 20:05:00,7973,-0.0016745975431935668,46.03,IS,0.41,0.0,Phase3-EA-SA2v2-EURCHF-M5-43,EURCHFMT4,4252,8h 19m,Buy
101199.92,124942,25.05.2012 07:24:58,tp 124.942,0.0,-0.0,0.0,0.0,124552,25.05.2012 02:20:00,7974,-0.0,112.43,IS,0.23,0.0,Phase3-EA-S4v1-GBPJPY-M5-194,GBPJPYMT4,1896,5h 4m,Buy
101262.53,1.20141,25.05.2012 14:45:00,,0.0,-0.0,0.0,0.0,1.20317,25.05.2012 06:00:00,7975,-0.0,62.61,IS,0.34,0.0,Phase3-EA-S4v1-EURCHF-M15-221,EURCHFMT4,2042,8h 45m,Sell
101261.67,1202,28.05.2012 09:20:00,,0.0,-0.8599999999860302,0.0,0.0,1.20202,28.05.2012 01:00:00,7976,-4.496437435947483E-4,-0.86,IS,0.41,0.0,Phase3-EA-SA2v2-EURCHF-M5-43,EURCHFMT4,4254,8h 20m,Buy
101229.62,0.95916,29.05.2012 06:30:00,,0.0,-32.90999999997439,0.0,0.0,0.95863,29.05.2012 02:15:00,7977,-0.01720671581620003,-32.05,IS,0.58,0.0,Phase3-EA-SA2v2-USDCHF-M15-107,USDCHFMT4,1578,4h 15m,Sell
101230.47,1.20178,29.05.2012 07:40:00,,-2.14,-32.05999999996857,0.0,0.0,1.20185,28.05.2012 23:20:00,7978,-0.016762300488218213,0.85,IS,0.41,0.0,Phase3-EA-SA2v2-EURCHF-M5-43,EURCHFMT4,4256,8h 20m,Sell
101138.86,99146,29.05.2012 18:59:58,sl 99.146,-3.31,-123.6699999999546,0.0,0.0,99926,23.05.2012 22:30:00,7979,-0.06465981601307604,-91.61,IS,0.09,0.0,Phase3-EA-TR1v1-EURJPY-M30-91,EURJPYMT4,1304,5d 20h 29m,Buy
101170.69,0.9622,30.05.2012 02:30:00,,-0.72,-91.8399999999674,0.0,0.0,0.96166,29.05.2012 22:15:00,7980,-0.048017769084183516,31.83,IS,0.58,0.0,Phase3-EA-SA2v2-USDCHF-M15-107,USDCHFMT4,1580,4h 15m,Buy
101112.2,124016,30.05.2012 07:25:00,,0.0,-150.3299999999581,0.0,0.0,124218,30.05.2012 02:00:00,7981,-0.07859877206474147,-58.49,IS,0.23,0.0,Phase3-EA-S4v1-GBPJPY-M5-194,GBPJPYMT4,1898,5h 25m,Buy
101121.4,1.20108,30.05.2012 08:10:00,,-1.02,-141.12999999994645,0.0,0.0,1.20084,29.05.2012 23:50:00,7982,-0.0737886296913181,9.2,IS,0.41,0.0,Phase3-EA-SA2v2-EURCHF-M5-43,EURCHFMT4,4258,8h 20m,Buy
101116.12,1.20116,30.05.2012 11:30:00,,0.0,-146.40999999994528,0.0,0.0,1.20101,30.05.2012 02:45:00,7983,-0.07654923314040915,-5.28,IS,0.34,0.0,Phase3-EA-S4v1-EURCHF-M15-221,EURCHFMT4,2044,8h 45m,Sell
101321.41,123245,30.05.2012 12:29:58,tp 123.245,-4.61,-0.0,0.0,0.0,125095,23.05.2012 11:00:00,7984,-0.0,205.29,IS,0.09,0.0,Phase3-EA-B1v1-GBPJPY-M30-1,GBPJPYMT4,772,7d 1h 29m,Sell
101323.02,1.20094,31.05.2012 06:05:00,,-3.04,-0.0,0.0,0.0,1.20083,30.05.2012 21:45:00,7985,-0.0,1.61,IS,0.41,0.0,Phase3-EA-SA2v2-EURCHF-M5-43,EURCHFMT4,4260,8h 20m,Buy
101352.3,0.97063,31.05.2012 06:15:00,,0.0,-0.0,0.0,0.0,0.97112,31.05.2012 02:00:00,7986,-0.0,29.28,IS,0.58,0.0,Phase3-EA-SA2v2-USDCHF-M15-107,USDCHFMT4,1582,4h 15m,Sell
101323.39,121932,31.05.2012 08:50:00,,0.0,-28.910000000003492,0.0,0.0,122031,31.05.2012 03:25:00,7987,-0.015108258432223406,-28.91,IS,0.23,0.0,Phase3-EA-S4v1-GBPJPY-M5-194,GBPJPYMT4,1900,5h 25m,Buy
101320.58,1.20111,31.05.2012 10:30:00,,0.0,-31.720000000001164,0.0,0.0,1.20103,31.05.2012 01:45:00,7988,-0.016576753976827608,-2.81,IS,0.34,0.0,Phase3-EA-S4v1-EURCHF-M15-221,EURCHFMT4,2046,8h 45m,Sell
101530.59,121002,31.05.2012 17:59:57,tp 121.002,-1.98,-0.0,0.0,0.0,122852,30.05.2012 17:00:00,7989,-0.0,210.01,IS,0.09,0.0,Phase3-EA-B1v1-GBPJPY-M30-1,GBPJPYMT4,774,1d 0h 59m,Sell
101793.13,1.54177,31.05.2012 17:59:58,tp 1.54177,-2.06,-0.0,0.0,0.0,1.56067,30.05.2012 10:00:00,7990,-0.0,262.54,IS,0.14,0.0,Phase3-EA-B1v1-GBPUSD-M30-14,GBPUSDMT4,526,1d 7h 59m,Sell
101936.52,96944,31.05.2012 18:29:58,tp 96.944,-1.2,-0.0,0.0,0.0,98204,30.05.2012 16:30:00,7991,-0.0,143.39,IS,0.09,0.0,Phase3-EA-TR1v1-EURJPY-M30-91,EURJPYMT4,1306,1d 1h 59m,Sell
101833.24,0.97326,01.06.2012 04:00:00,,-3.16,-103.27999999999884,0.0,0.0,0.97158,31.05.2012 23:45:00,7992,-0.053809457418524935,-103.28,IS,0.58,0.0,Phase3-EA-SA2v2-USDCHF-M15-107,USDCHFMT4,1584,4h 15m,Sell
101888.35,120658,01.06.2012 08:30:00,,0.0,-48.170000000012806,0.0,0.0,120846,01.06.2012 03:05:00,7993,-0.025096839309169873,55.11,IS,0.23,0.0,Phase3-EA-S4v1-GBPJPY-M5-194,GBPJPYMT4,1902,5h 25m,Sell
101887.51,1.20102,01.06.2012 08:35:00,,0.0,-49.01000000000931,0.0,0.0,1201,01.06.2012 00:15:00,7994,-0.025534484005445758,-0.84,IS,0.41,0.0,Phase3-EA-SA2v2-EURCHF-M5-43,EURCHFMT4,4262,8h 20m,Sell
101885.62,78372,01.06.2012 11:30:00,,-1.55,-50.90000000002328,0.0,0.0,78371,31.05.2012 22:30:00,7995,-0.026519184572077876,-1.89,IS,0.27,0.0,Phase3-EA-S1v2-USDJPY-M15-0,USDJPYMT4,2340,13h 0m,Sell
102255.03,95697,01.06.2012 15:44:58,tp 95.697,-0.76,-0.0,0.0,0.0,97397,31.05.2012 15:45:00,7996,-0.0,369.41,IS,0.17,0.0,Phase3-EA-T1v2-EURJPY-M15-322,EURJPYMT4,1252,23h 59m,Sell
102213.03,1.53529,01.06.2012 17:59:58,sl 1.53529,0.0,-42.0,0.0,0.0,1.53829,01.06.2012 16:30:00,7997,-0.021845982391201887,-42.0,IS,0.14,0.0,Phase3-EA-B1v1-GBPUSD-M30-14,GBPUSDMT4,528,1h 29m,Buy
102231.35,78097,01.06.2012 22:00:00,,0.0,-23.679999999993015,0.0,0.0,78.15,01.06.2012 17:00:00,7998,-0.012316972929131144,18.32,IS,0.27,0.0,Phase3-EA-S1v2-USDJPY-M15-0,USDJPYMT4,2342,5h 0m,Sell
102345.06,120175,04.06.2012 01:29:58,tp 120.175,-1.06,-0.0,0.0,0.0,119785,01.06.2012 23:40:00,7999,-0.0,113.71,IS,0.23,0.0,Phase3-EA-S4v1-GBPJPY-M5-194,GBPJPYMT4,1904,2d 1h 49m,Buy
102350.14,1.2009,04.06.2012 05:55:00,,-2.12,-0.0,0.0,0.0,1.20107,01.06.2012 21:35:00,8000,-0.0,5.08,IS,0.41,0.0,Phase3-EA-SA2v2-EURCHF-M5-43,EURCHFMT4,4264,2d 8h 20m,Sell
102348.03,1.20084,04.06.2012 15:15:00,,0.0,-2.10999999998603,0.0,0.0,1.2009,04.06.2012 06:30:00,8001,-0.0010969578706758547,-2.11,IS,0.34,0.0,Phase3-EA-S4v1-EURCHF-M15-221,EURCHFMT4,2048,8h 45m,Buy
102264.26,97496,04.06.2012 16:29:58,sl 97.496,-0.8,-85.87999999997555,0.0,0.0,96776,31.05.2012 19:00:00,8002,-0.04464774499253048,-83.77,IS,0.09,0.0,Phase3-EA-TR1v1-EURJPY-M30-91,EURJPYMT4,1308,3d 21h 29m,Sell
102273.07,1.20112,05.06.2012 08:15:00,,-1.02,-77.06999999997788,0.0,0.0,1.20089,04.06.2012 23:55:00,8003,-0.040067555968494595,8.81,IS,0.41,0.0,Phase3-EA-SA2v2-EURCHF-M5-43,EURCHFMT4,4266,8h 20m,Buy
102196.18,120.07,05.06.2012 10:29:57,sl 120.070,0.0,-153.95999999999185,0.0,0.0,120.74,05.06.2012 09:00:00,8004,-0.08004153259258949,-76.89,IS,0.09,0.0,Phase3-EA-B1v1-GBPJPY-M30-1,GBPJPYMT4,776,1h 29m,Buy
102202.16,1.20092,05.06.2012 13:00:00,,0.0,-147.97999999998137,0.0,0.0,1.20109,05.06.2012 04:15:00,8005,-0.07693261881690393,5.98,IS,0.34,0.0,Phase3-EA-S4v1-EURCHF-M15-221,EURCHFMT4,2050,8h 45m,Sell
102165.94,0.96405,06.06.2012 03:30:00,,-0.72,-184.19999999998254,0.0,0.0,0.96464,05.06.2012 23:15:00,8006,-0.09576286245488677,-36.22,IS,0.58,0.0,Phase3-EA-SA2v2-USDCHF-M15-107,USDCHFMT4,1586,4h 15m,Buy
102308.3,98994,06.06.2012 10:59:57,tp 98.994,-1.12,-41.83999999999651,0.0,0.0,97734,04.06.2012 19:30:00,8007,-0.021751998724823602,142.36,IS,0.09,0.0,Phase3-EA-TR1v1-EURJPY-M30-91,EURJPYMT4,1310,1d 15h 29m,Buy
102314.32,1.2008,06.06.2012 14:15:00,,0.0,-35.820000000006985,0.0,0.0,1.20097,06.06.2012 05:30:00,8008,-0.018622289539278167,6.02,IS,0.34,0.0,Phase3-EA-S4v1-EURCHF-M15-221,EURCHFMT4,2052,8h 45m,Sell
102225.63,99691,06.06.2012 22:59:58,sl 99.691,0.0,-124.51000000000931,0.0,0.0,98911,06.06.2012 15:00:00,8009,-0.06473091207524416,-88.69,IS,0.09,0.0,Phase3-EA-TR1v1-EURJPY-M30-91,EURJPYMT4,1312,7h 59m,Sell
102238.27,122694,07.06.2012 04:30:00,,-5.05,-111.86999999999534,0.0,0.0,122755,06.06.2012 23:05:00,8010,-0.058159562556073574,12.64,IS,0.23,0.0,Phase3-EA-S4v1-GBPJPY-M5-194,GBPJPYMT4,1906,5h 25m,Sell
102299.04,0.95443,07.06.2012 04:44:58,tp 0.95443,0.0,-51.10000000000582,0.0,0.0,0.95543,07.06.2012 02:45:00,8011,-0.026566136109911702,60.77,IS,0.58,0.0,Phase3-EA-SA2v2-USDCHF-M15-107,USDCHFMT4,1588,1h 59m,Sell
102306.67,1.20084,07.06.2012 07:40:00,,-3.09,-43.470000000001164,0.0,0.0,1.20059,06.06.2012 23:20:00,8012,-0.0225994116770599,7.63,IS,0.41,0.0,Phase3-EA-SA2v2-EURCHF-M5-43,EURCHFMT4,4268,8h 20m,Buy
102301.33,1.20108,07.06.2012 12:15:00,,0.0,-48.80999999999767,0.0,0.0,1.20093,07.06.2012 03:30:00,8013,-0.02537559889480588,-5.34,IS,0.34,0.0,Phase3-EA-S4v1-EURCHF-M15-221,EURCHFMT4,2054,8h 45m,Sell
102509.68,123136,07.06.2012 12:29:58,tp 123.136,-1.23,-0.0,0.0,0.0,121286,06.06.2012 05:00:00,8014,-0.0,208.35,IS,0.09,0.0,Phase3-EA-B1v1-GBPJPY-M30-1,GBPJPYMT4,778,1d 7h 29m,Buy
102460.42,99.7,07.06.2012 14:14:58,sl 99.700,0.0,-49.26000000000931,0.0,0.0,99.93,07.06.2012 12:30:00,8015,-0.025588323662482426,-49.26,IS,0.17,0.0,Phase3-EA-T1v2-EURJPY-M15-322,EURJPYMT4,1254,1h 44m,Buy
102372.2,100.39,07.06.2012 15:59:58,sl 100.390,0.0,-137.48000000001048,0.0,0.0,99.61,07.06.2012 06:30:00,8016,-0.07141459068448411,-88.22,IS,0.09,0.0,Phase3-EA-TR1v1-EURJPY-M30-91,EURJPYMT4,1314,9h 29m,Sell
102396.6,79676,07.06.2012 22:15:00,,0.0,-113.0800000000163,0.0,0.0,79604,07.06.2012 20:30:00,8017,-0.0587399033648677,24.4,IS,0.27,0.0,Phase3-EA-S1v2-USDJPY-M15-0,USDJPYMT4,2344,1h 45m,Buy
102454.11,0.95512,08.06.2012 02:44:58,tp 0.95512,-3.22,-55.570000000006985,0.0,0.0,0.95612,07.06.2012 23:45:00,8018,-0.02886608091603854,57.51,IS,0.58,0.0,Phase3-EA-SA2v2-USDCHF-M15-107,USDCHFMT4,1590,2h 59m,Sell
102514.76,0.95625,08.06.2012 03:14:58,tp 0.95625,0.0,-0.0,0.0,0.0,0.95525,08.06.2012 02:45:00,8019,-0.0,60.65,IS,0.58,0.0,Phase3-EA-SA2v2-USDCHF-M15-107,USDCHFMT4,1592,29m 58s,Buy
102398.89,123186,08.06.2012 04:25:00,,-1.04,-115.86999999999534,0.0,0.0,123583,07.06.2012 23:00:00,8020,-0.060187592888979055,-115.87,IS,0.23,0.0,Phase3-EA-S4v1-GBPJPY-M5-194,GBPJPYMT4,1908,5h 25m,Buy
102413.86,1.20081,08.06.2012 04:30:00,,-2.14,-100.89999999999418,0.0,0.0,1.20121,07.06.2012 20:10:00,8021,-0.05241156574176129,14.97,IS,0.41,0.0,Phase3-EA-SA2v2-EURCHF-M5-43,EURCHFMT4,4270,8h 20m,Sell
102371.33,1.54701,08.06.2012 09:29:58,sl 1.54701,-0.53,-143.42999999999302,0.0,0.0,1.55001,07.06.2012 12:30:00,8022,-0.07450337833836362,-42.53,IS,0.14,0.0,Phase3-EA-B1v1-GBPUSD-M30-14,GBPUSDMT4,530,20h 59m,Buy
102517.69,98672,08.06.2012 11:29:58,tp 98.672,-0.4,-0.0,0.0,0.0,99962,07.06.2012 18:00:00,8023,-0.0,146.36,IS,0.09,0.0,Phase3-EA-TR1v1-EURJPY-M30-91,EURJPYMT4,1316,17h 29m,Sell
102435.76,99678,11.06.2012 01:00:00,sl 99.678,-0.4,-81.92999999999302,0.0,0.0,98958,08.06.2012 11:00:00,8024,-0.04255712812676739,-81.93,IS,0.09,0.0,Phase3-EA-TR1v1-EURJPY-M30-91,EURJPYMT4,1317,2d 14h 0m,Sell
102198.49,0.95628,11.06.2012 01:00:00,sl 0.95628,-0.73,-319.19999999998254,0.0,0.0,0.96018,08.06.2012 22:00:00,8025,-0.16580294517349645,-237.27,IS,0.58,0.0,Phase3-EA-SA2v2-USDCHF-M15-107,USDCHFMT4,1594,2d 3h 0m,Buy
102123.65,123766,11.06.2012 06:45:00,,0.0,-394.03999999997905,0.0,0.0,123507,11.06.2012 01:20:00,8026,-0.20467729485013986,-74.84,IS,0.23,0.0,Phase3-EA-S4v1-GBPJPY-M5-194,GBPJPYMT4,1910,5h 25m,Sell
102150.21,1.20148,11.06.2012 06:55:00,,-1.03,-367.4799999999814,0.0,0.0,1.20084,08.06.2012 22:35:00,8027,-0.1908811600637742,26.56,IS,0.41,0.0,Phase3-EA-SA2v2-EURCHF-M5-43,EURCHFMT4,4272,2d 8h 20m,Buy
102135.55,1.20137,11.06.2012 10:00:00,,0.0,-382.13999999998487,0.0,0.0,1.20096,11.06.2012 01:15:00,8028,-0.1984960447011306,-14.66,IS,0.34,0.0,Phase3-EA-S4v1-EURCHF-M15-221,EURCHFMT4,2056,8h 45m,Sell
102281.4,98.9,12.06.2012 01:29:58,tp 98.900,-0.4,-236.28999999997905,0.0,0.0,100.19,11.06.2012 12:00:00,8029,-0.12273677291680497,145.85,IS,0.09,0.0,Phase3-EA-TR1v1-EURJPY-M30-91,EURJPYMT4,1320,13h 29m,Sell
102394.35,123017,12.06.2012 06:29:57,tp 123.017,0.0,-123.3399999999674,0.0,0.0,122627,12.06.2012 01:20:00,8030,-0.0640668397797455,112.95,IS,0.23,0.0,Phase3-EA-S4v1-GBPJPY-M5-194,GBPJPYMT4,1912,5h 9m,Buy
102318.51,123287,12.06.2012 07:29:58,sl 123.287,0.0,-199.1799999999639,0.0,0.0,122617,12.06.2012 04:00:00,8031,-0.1034606222420202,-75.84,IS,0.09,0.0,Phase3-EA-B1v1-GBPJPY-M30-1,GBPJPYMT4,780,3h 29m,Sell
102317.23,1.20097,12.06.2012 10:25:00,,0.0,-200.45999999996275,0.0,0.0,1.20094,12.06.2012 02:05:00,8032,-0.10412549620762764,-1.28,IS,0.41,0.0,Phase3-EA-SA2v2-EURCHF-M5-43,EURCHFMT4,4274,8h 20m,Sell
102316.81,1.20094,13.06.2012 04:40:00,,-2.13,-200.87999999997555,0.0,0.0,1.20098,12.06.2012 20:20:00,8033,-0.10434365797759942,-0.42,IS,0.41,0.0,Phase3-EA-SA2v2-EURCHF-M5-43,EURCHFMT4,4276,8h 20m,Sell
102334.12,99.46,13.06.2012 07:00:00,,-1.05,-183.56999999997788,0.0,0.0,99374,12.06.2012 22:45:00,8034,-0.09535227645832313,17.31,IS,0.17,0.0,Phase3-EA-T1v2-EURJPY-M15-322,EURJPYMT4,1256,8h 15m,Buy
102381.78,123841,13.06.2012 07:20:00,,0.0,-135.9099999999744,0.0,0.0,124006,13.06.2012 01:55:00,8035,-0.07059610989513436,47.66,IS,0.23,0.0,Phase3-EA-S4v1-GBPJPY-M5-194,GBPJPYMT4,1914,5h 25m,Sell
102299.53,99905,13.06.2012 12:29:58,sl 99.905,-0.8,-218.1599999999744,0.0,0.0,99185,11.06.2012 23:00:00,8036,-0.1133194565133074,-82.25,IS,0.09,0.0,Phase3-EA-TR1v1-EURJPY-M30-91,EURJPYMT4,1321,1d 13h 29m,Sell
102301.3,1.20093,13.06.2012 14:15:00,,0.0,-216.38999999998487,0.0,0.0,1.20088,13.06.2012 05:30:00,8037,-0.11240006048274546,1.77,IS,0.34,0.0,Phase3-EA-S4v1-EURCHF-M15-221,EURCHFMT4,2058,8h 45m,Buy
102252.01,99703,13.06.2012 22:29:58,sl 99.703,0.0,-265.679999999993,0.0,0.0,99933,13.06.2012 18:30:00,8038,-0.13800290248651564,-49.29,IS,0.17,0.0,Phase3-EA-T1v2-EURJPY-M15-322,EURJPYMT4,1258,3h 59m,Buy
102221.12,1.20143,14.06.2012 06:15:00,,-6.43,-296.570000000007,0.0,0.0,1.20086,13.06.2012 21:55:00,8039,-0.15404818123467323,-30.89,IS,0.41,0.0,Phase3-EA-SA2v2-EURCHF-M5-43,EURCHFMT4,4278,8h 20m,Sell
102171.87,99.62,14.06.2012 11:59:58,sl 99.620,0.0,-345.820000000007,0.0,0.0,99.85,14.06.2012 07:00:00,8040,-0.1796302459270139,-49.25,IS,0.17,0.0,Phase3-EA-T1v2-EURJPY-M15-322,EURJPYMT4,1260,4h 59m,Buy
102177.56,1.20082,14.06.2012 12:45:00,,0.0,-340.13000000000466,0.0,0.0,1.20098,14.06.2012 04:00:00,8041,-0.1766746733767707,5.69,IS,0.34,0.0,Phase3-EA-S4v1-EURCHF-M15-221,EURCHFMT4,2060,8h 45m,Sell
102176.26,1.20093,15.06.2012 04:40:00,,-2.16,-341.429999999993,0.0,0.0,1.20095,14.06.2012 20:20:00,8042,-0.17734993599808532,-1.3,IS,0.41,0.0,Phase3-EA-SA2v2-EURCHF-M5-43,EURCHFMT4,4280,8h 20m,Sell
102153.48,99.81,15.06.2012 06:30:00,,-1.05,-364.20999999999185,0.0,0.0,99911,14.06.2012 17:30:00,8043,-0.18918261485476534,-22.78,IS,0.17,0.0,Phase3-EA-T1v2-EURJPY-M15-322,EURJPYMT4,1262,13h 0m,Buy
102176.13,78.69,15.06.2012 18:45:00,,0.0,-341.5599999999977,0.0,0.0,78756,15.06.2012 17:30:00,8044,-0.17741746226021982,22.65,IS,0.27,0.0,Phase3-EA-S1v2-USDJPY-M15-0,USDJPYMT4,2346,1h 15m,Sell
102186.54,1.20098,18.06.2012 10:15:00,,0.0,-331.1499999999942,0.0,0.0,1.20122,18.06.2012 01:55:00,8045,-0.17201016696179633,10.41,IS,0.41,0.0,Phase3-EA-SA2v2-EURCHF-M5-43,EURCHFMT4,4282,8h 20m,Sell
102195.14,1.20096,18.06.2012 11:15:00,,0.0,-322.54999999998836,0.0,0.0,1.2012,18.06.2012 02:30:00,8046,-0.16754304500536427,8.6,IS,0.34,0.0,Phase3-EA-S4v1-EURCHF-M15-221,EURCHFMT4,2062,8h 45m,Sell
102119.09,123697,18.06.2012 11:29:58,sl 123.697,0.0,-398.5999999999767,0.0,0.0,124367,18.06.2012 01:30:00,8047,-0.2070459083526173,-76.05,IS,0.09,0.0,Phase3-EA-B1v1-GBPJPY-M30-1,GBPJPYMT4,782,9h 59m,Buy
102121.93,1.20091,19.06.2012 06:40:00,,-1.03,-395.7599999999802,0.0,0.0,1.20082,18.06.2012 22:20:00,8048,-0.20557071924142628,2.84,IS,0.41,0.0,Phase3-EA-SA2v2-EURCHF-M5-43,EURCHFMT4,4284,8h 20m,Buy
102092.54,79005,19.06.2012 09:30:00,,0.0,-425.1499999999942,0.0,0.0,79091,19.06.2012 01:00:00,8049,-0.22083684881113694,-29.39,IS,0.27,0.0,Phase3-EA-S1v2-USDJPY-M15-0,USDJPYMT4,2348,8h 30m,Buy
102042.96,99936,20.06.2012 10:59:58,sl 99.936,0.0,-474.7299999999814,0.0,0.0,100166,20.06.2012 10:00:00,8050,-0.2465903263227293,-49.58,IS,0.17,0.0,Phase3-EA-T1v2-EURJPY-M15-322,EURJPYMT4,1264,59m 58s,Buy
101953.24,100848,20.06.2012 17:29:58,sl 100.848,-1.2,-564.4499999999825,0.0,0.0,100068,15.06.2012 05:30:00,8051,-0.2931938358495686,-89.72,IS,0.09,0.0,Phase3-EA-TR1v1-EURJPY-M30-91,EURJPYMT4,1324,5d 11h 59m,Sell
102014.54,0.94621,21.06.2012 01:14:58,tp 0.94621,0.0,-503.1499999999942,0.0,0.0,0.94521,21.06.2012 00:15:00,8052,-0.261352606090377,61.3,IS,0.58,0.0,Phase3-EA-SA2v2-USDCHF-M15-107,USDCHFMT4,1596,59m 58s,Buy
102002.41,1.20107,21.06.2012 04:35:00,,-6.51,-515.2799999999988,0.0,0.0,1.20094,20.06.2012 20:15:00,8053,-0.2676533257800869,-12.13,IS,0.41,0.0,Phase3-EA-SA2v2-EURCHF-M5-43,EURCHFMT4,4286,8h 20m,Sell
102050.35,79583,21.06.2012 04:45:00,,-2.95,-467.3399999999965,0.0,0.0,79433,20.06.2012 22:15:00,8054,-0.24275171803692197,47.94,IS,0.27,0.0,Phase3-EA-S1v2-USDJPY-M15-0,USDJPYMT4,2350,6h 30m,Buy
102111.55,124918,21.06.2012 08:45:00,,0.0,-406.13999999998487,0.0,0.0,124706,21.06.2012 03:20:00,8055,-0.21096243155628142,61.2,IS,0.23,0.0,Phase3-EA-S4v1-GBPJPY-M5-194,GBPJPYMT4,1916,5h 25m,Buy
102115.85,1.20093,21.06.2012 12:00:00,,0.0,-401.8399999999965,0.0,0.0,1.20105,21.06.2012 03:15:00,8056,-0.20872887057807293,4.3,IS,0.34,0.0,Phase3-EA-S4v1-EURCHF-M15-221,EURCHFMT4,2064,8h 45m,Sell
102027.97,101346,21.06.2012 12:59:57,sl 101.346,0.0,-489.72000000000116,0.0,0.0,100566,21.06.2012 03:30:00,8057,-0.2543766237793525,-87.88,IS,0.09,0.0,Phase3-EA-TR1v1-EURJPY-M30-91,EURJPYMT4,1326,9h 29m,Sell
102093.91,80256,21.06.2012 21:45:00,,0.0,-423.77999999999884,0.0,0.0,80.06,21.06.2012 19:30:00,8058,-0.2201252258948245,65.94,IS,0.27,0.0,Phase3-EA-S1v2-USDJPY-M15-0,USDJPYMT4,2352,2h 15m,Buy
102205.71,125.29,22.06.2012 06:09:58,tp 125.290,0.0,-311.9800000000105,0.0,0.0,124.9,22.06.2012 03:05:00,8059,-0.16205264046125312,111.8,IS,0.23,0.0,Phase3-EA-S4v1-GBPJPY-M5-194,GBPJPYMT4,1918,3h 4m,Buy
102157.07,100852,22.06.2012 16:44:58,sl 100.852,0.0,-360.62000000002445,0.0,0.0,101082,22.06.2012 16:30:00,8060,-0.18731785115436597,-48.64,IS,0.17,0.0,Phase3-EA-T1v2-EURJPY-M15-322,EURJPYMT4,1266,14m 58s,Buy
102162.89,1.20085,25.06.2012 05:30:00,,-1.03,-354.80000000001746,0.0,0.0,1.20069,22.06.2012 21:10:00,8061,-0.18429475234198828,5.82,IS,0.41,0.0,Phase3-EA-SA2v2-EURCHF-M5-43,EURCHFMT4,4288,2d 8h 20m,Buy
102148.36,958,25.06.2012 06:15:00,,0.0,-369.3300000000163,0.0,0.0,0.95776,25.06.2012 02:00:00,8062,-0.19184211071721022,-14.53,IS,0.58,0.0,Phase3-EA-SA2v2-USDCHF-M15-107,USDCHFMT4,1598,4h 15m,Sell
102149.42,1.20092,25.06.2012 11:00:00,,0.0,-368.2700000000186,0.0,0.0,1.20095,25.06.2012 02:15:00,8063,-0.19129151196444225,1.06,IS,0.34,0.0,Phase3-EA-S4v1-EURCHF-M15-221,EURCHFMT4,2066,8h 45m,Sell
102294.9,99586,25.06.2012 14:29:58,tp 99.586,0.0,-222.79000000000815,0.0,0.0,100876,25.06.2012 03:30:00,8064,-0.11572443031079777,145.48,IS,0.09,0.0,Phase3-EA-TR1v1-EURJPY-M30-91,EURJPYMT4,1328,10h 59m,Sell
102291.06,1.20087,26.06.2012 04:20:00,,-2.13,-226.63000000000466,0.0,0.0,1.20083,25.06.2012 20:00:00,8065,-0.11771905220762008,-3.84,IS,0.41,0.0,Phase3-EA-SA2v2-EURCHF-M5-43,EURCHFMT4,4290,8h 20m,Sell
102302.77,79559,26.06.2012 06:30:00,,-1.53,-214.9200000000128,0.0,0.0,79598,25.06.2012 21:00:00,8066,-0.11163649428788198,11.71,IS,0.27,0.0,Phase3-EA-S1v2-USDJPY-M15-0,USDJPYMT4,2354,9h 30m,Sell
102303.35,123897,26.06.2012 06:50:00,,0.0,-214.3400000000256,0.0,0.0,123895,26.06.2012 01:25:00,8067,-0.11133522327222249,0.58,IS,0.23,0.0,Phase3-EA-S4v1-GBPJPY-M5-194,GBPJPYMT4,1920,5h 25m,Buy
102254.22,99656,26.06.2012 09:14:57,sl 99.656,0.0,-263.47000000003027,0.0,0.0,99426,26.06.2012 07:15:00,8068,-0.13685495603028985,-49.13,IS,0.17,0.0,Phase3-EA-T1v2-EURJPY-M15-322,EURJPYMT4,1268,1h 59m,Sell
102250.68,1.20092,26.06.2012 10:30:00,,0.0,-267.0100000000384,0.0,0.0,1.20082,26.06.2012 01:45:00,8069,-0.13869374809142881,-3.54,IS,0.34,0.0,Phase3-EA-S4v1-EURCHF-M15-221,EURCHFMT4,2068,8h 45m,Sell
102393.23,98771,26.06.2012 15:29:58,tp 98.771,-0.4,-124.46000000005006,0.0,0.0,100031,25.06.2012 11:00:00,8070,-0.06464860449969548,142.55,IS,0.09,0.0,Phase3-EA-TR1v1-EURJPY-M30-91,EURJPYMT4,1329,1d 4h 29m,Sell
102418.23,79392,27.06.2012 03:15:00,,-1.53,-99.46000000005006,0.0,0.0,79.47,26.06.2012 17:00:00,8071,-0.05166278485891341,25.0,IS,0.27,0.0,Phase3-EA-S1v2-USDJPY-M15-0,USDJPYMT4,2356,10h 15m,Sell
102478.61,0.96064,27.06.2012 05:59:57,tp 0.96064,0.0,-39.0800000000454,0.0,0.0,0.96164,27.06.2012 02:30:00,8072,-0.020299433262494122,60.38,IS,0.58,0.0,Phase3-EA-SA2v2-USDCHF-M15-107,USDCHFMT4,1600,3h 29m,Sell
102429.37,99.34,27.06.2012 05:59:58,sl 99.340,0.0,-88.32000000003609,0.0,0.0,99.11,27.06.2012 03:15:00,8073,-0.04587630362697366,-49.24,IS,0.17,0.0,Phase3-EA-T1v2-EURJPY-M15-322,EURJPYMT4,1270,2h 44m,Sell
102466.72,124186,27.06.2012 08:40:00,,0.0,-50.97000000003027,0.0,0.0,124057,27.06.2012 03:15:00,8074,-0.026475489083642216,37.35,IS,0.23,0.0,Phase3-EA-S4v1-GBPJPY-M5-194,GBPJPYMT4,1922,5h 25m,Buy
102473.32,99484,27.06.2012 19:15:00,,0.0,-44.37000000002445,0.0,0.0,99453,27.06.2012 18:45:00,8075,-0.023047232698472725,6.6,IS,0.17,0.0,Phase3-EA-T1v2-EURJPY-M15-322,EURJPYMT4,1272,30m 0s,Buy
102456.04,99344,28.06.2012 03:00:00,,0.0,-61.65000000002328,0.0,0.0,99425,28.06.2012 01:45:00,8076,-0.03202303123418069,-17.28,IS,0.17,0.0,Phase3-EA-T1v2-EURJPY-M15-322,EURJPYMT4,1274,1h 15m,Buy
102456.82,1.20097,28.06.2012 07:05:00,,-3.07,-60.87000000002445,0.0,0.0,1.20088,27.06.2012 22:45:00,8077,-0.03161787366138889,0.78,IS,0.41,0.0,Phase3-EA-SA2v2-EURCHF-M5-43,EURCHFMT4,4292,8h 20m,Buy
102337.89,79384,28.06.2012 15:45:00,,-2.95,-179.80000000001746,0.0,0.0,79725,27.06.2012 20:30:00,8078,-0.09339401485651375,-118.93,IS,0.27,0.0,Phase3-EA-S1v2-USDJPY-M15-0,USDJPYMT4,2358,19h 15m,Buy
102398.04,0.96431,29.06.2012 05:14:57,tp 0.96431,0.0,-119.65000000002328,0.0,0.0,0.96531,29.06.2012 01:30:00,8079,-0.0621501328007951,60.15,IS,0.58,0.0,Phase3-EA-SA2v2-USDCHF-M15-107,USDCHFMT4,1602,3h 44m,Sell
102394.47,1.2009,29.06.2012 05:35:00,,-1.02,-123.22000000003027,0.0,0.0,1.20096,28.06.2012 21:15:00,8080,-0.0640045078455024,-3.57,IS,0.41,0.0,Phase3-EA-SA2v2-EURCHF-M5-43,EURCHFMT4,4294,8h 20m,Buy
102344.47,99554,29.06.2012 06:14:58,sl 99.554,-0.75,-173.22000000003027,0.0,0.0,99324,28.06.2012 03:15:00,8081,-0.08997614712706656,-50.0,IS,0.17,0.0,Phase3-EA-T1v2-EURJPY-M15-322,EURJPYMT4,1276,1d 2h 59m,Sell
102490.14,100153,29.06.2012 06:29:58,tp 100.153,-0.56,-27.550000000017462,0.0,0.0,98863,28.06.2012 23:30:00,8082,-0.014310373244150916,145.67,IS,0.09,0.0,Phase3-EA-TR1v1-EURJPY-M30-91,EURJPYMT4,1332,6h 59m,Buy
102410.42,124631,29.06.2012 10:29:58,sl 124.631,-3.94,-107.27000000001863,0.0,0.0,123961,25.06.2012 15:30:00,8083,-0.0557195549146774,-79.72,IS,0.09,0.0,Phase3-EA-B1v1-GBPJPY-M30-1,GBPJPYMT4,784,3d 18h 59m,Sell
102353.84,1.20257,29.06.2012 15:00:00,,0.0,-163.85000000000582,0.0,0.0,1.20098,29.06.2012 06:15:00,8084,-0.08510906192568873,-56.58,IS,0.34,0.0,Phase3-EA-S4v1-EURCHF-M15-221,EURCHFMT4,2070,8h 45m,Sell
102338.29,79861,02.07.2012 01:30:00,,0.0,-179.39999999999418,0.0,0.0,79907,02.07.2012 01:00:00,8085,-0.09318624174224914,-15.55,IS,0.27,0.0,Phase3-EA-S1v2-USDJPY-M15-0,USDJPYMT4,2360,30m 0s,Buy
102399.35,0.94984,02.07.2012 02:59:57,tp 0.94984,0.0,-118.33999999999651,0.0,0.0,0.94884,02.07.2012 01:15:00,8086,-0.06146967585160421,61.06,IS,0.58,0.0,Phase3-EA-SA2v2-USDCHF-M15-107,USDCHFMT4,1604,1h 44m,Buy
102409.52,1.20137,02.07.2012 04:30:00,,-1.04,-108.1699999999837,0.0,0.0,1.20111,29.06.2012 20:10:00,8087,-0.056187044421727415,10.17,IS,0.41,0.0,Phase3-EA-SA2v2-EURCHF-M5-43,EURCHFMT4,4296,2d 8h 20m,Buy
102333.39,124647,02.07.2012 08:59:58,sl 124.647,-0.41,-184.29999999998836,0.0,0.0,125317,29.06.2012 20:30:00,8088,-0.09573146239183941,-76.13,IS,0.09,0.0,Phase3-EA-B1v1-GBPJPY-M30-1,GBPJPYMT4,786,2d 12h 29m,Buy
102342.33,1.20116,02.07.2012 10:30:00,,0.0,-175.35999999998603,0.0,0.0,1.20141,02.07.2012 01:45:00,8089,-0.09108773328829453,8.94,IS,0.34,0.0,Phase3-EA-S4v1-EURCHF-M15-221,EURCHFMT4,2072,8h 45m,Sell
102488.43,99776,02.07.2012 17:59:57,tp 99.776,0.0,-29.25999999998021,0.0,0.0,101066,02.07.2012 01:30:00,8090,-0.01519860330756106,146.1,IS,0.09,0.0,Phase3-EA-TR1v1-EURJPY-M30-91,EURJPYMT4,1334,16h 29m,Sell
102507.3,79414,03.07.2012 02:45:00,,-1.53,-10.389999999984866,0.0,0.0,79474,02.07.2012 22:00:00,8091,-0.005396906642701169,18.87,IS,0.27,0.0,Phase3-EA-S1v2-USDJPY-M15-0,USDJPYMT4,2362,4h 45m,Sell
102506.69,0.95462,03.07.2012 04:30:00,,0.0,-10.999999999970896,0.0,0.0,0.95461,03.07.2012 00:15:00,8092,-0.005713760641928995,-0.61,IS,0.58,0.0,Phase3-EA-SA2v2-USDCHF-M15-107,USDCHFMT4,1606,4h 15m,Sell
102508.48,124854,03.07.2012 04:30:00,,-1.68,-9.209999999962747,0.0,0.0,124866,02.07.2012 23:05:00,8093,-0.004783975955644766,1.79,IS,0.23,0.0,Phase3-EA-S4v1-GBPJPY-M5-194,GBPJPYMT4,1924,5h 25m,Sell
102507.41,1.2012,03.07.2012 14:15:00,,0.0,-10.279999999969732,0.0,0.0,1.20117,03.07.2012 05:30:00,8094,-0.005339769036273867,-1.07,IS,0.34,0.0,Phase3-EA-S4v1-EURCHF-M15-221,EURCHFMT4,2074,8h 45m,Sell
102506.37,100633,04.07.2012 02:45:00,,-1.04,-11.319999999977881,0.0,0.0,100633,03.07.2012 17:45:00,8095,-0.005879979133334634,-1.04,IS,0.17,0.0,Phase3-EA-T1v2-EURJPY-M15-322,EURJPYMT4,1278,9h 0m,Buy
102446.17,0.95376,04.07.2012 06:00:00,,0.0,-71.51999999998952,0.0,0.0,0.95277,04.07.2012 01:45:00,8096,-0.037149832828343915,-60.2,IS,0.58,0.0,Phase3-EA-SA2v2-USDCHF-M15-107,USDCHFMT4,1608,4h 15m,Sell
102355.33,99272,05.07.2012 14:59:58,sl 99.272,-2.76,-162.35999999998603,0.0,0.0,100052,02.07.2012 23:30:00,8097,-0.08433510707508785,-90.84,IS,0.09,0.0,Phase3-EA-TR1v1-EURJPY-M30-91,EURJPYMT4,1336,2d 15h 29m,Buy
102360.77,79.91,06.07.2012 02:15:00,,-0.98,-156.9199999999837,0.0,0.0,79891,05.07.2012 20:30:00,8098,-0.08150939272125246,5.44,IS,0.27,0.0,Phase3-EA-S1v2-USDJPY-M15-0,USDJPYMT4,2364,5h 45m,Buy
102347.25,1.2012,06.07.2012 05:25:00,,-2.11,-170.43999999997322,0.0,0.0,1.20093,05.07.2012 21:05:00,8099,-0.08853212398298196,-13.52,IS,0.41,0.0,Phase3-EA-SA2v2-EURCHF-M5-43,EURCHFMT4,4298,8h 20m,Sell
102328.71,0.97005,06.07.2012 06:00:00,,0.0,-188.97999999998137,0.0,0.0,0.96974,06.07.2012 01:45:00,8100,-0.09816240782859018,-18.54,IS,0.58,0.0,Phase3-EA-SA2v2-USDCHF-M15-107,USDCHFMT4,1610,4h 15m,Sell
102331.52,1.20104,06.07.2012 11:15:00,,0.0,-186.1699999999837,0.0,0.0,1.20112,06.07.2012 02:30:00,8101,-0.09670280170096748,2.81,IS,0.34,0.0,Phase3-EA-S4v1-EURCHF-M15-221,EURCHFMT4,2076,8h 45m,Sell
102693.72,98.31,06.07.2012 15:59:57,tp 98.310,-0.74,-0.0,0.0,0.0,100.01,05.07.2012 07:00:00,8102,-0.0,362.2,IS,0.17,0.0,Phase3-EA-T1v2-EURJPY-M15-322,EURJPYMT4,1280,1d 8h 59m,Sell
102834.12,98677,06.07.2012 15:59:58,tp 98.677,-1.57,-0.0,0.0,0.0,99937,04.07.2012 18:30:00,8103,-0.0,140.4,IS,0.09,0.0,Phase3-EA-TR1v1-EURJPY-M30-91,EURJPYMT4,1337,1d 21h 29m,Sell
102892.71,0.97802,09.07.2012 01:00:00,tp 0.97802,-0.71,-0.0,0.0,0.0,0.97702,06.07.2012 23:45:00,8104,-0.0,58.59,IS,0.58,0.0,Phase3-EA-SA2v2-USDCHF-M15-107,USDCHFMT4,1612,2d 1h 15m,Buy
102895.25,79636,09.07.2012 02:30:00,,-1.53,-0.0,0.0,0.0,79648,06.07.2012 20:15:00,8105,-0.0,2.54,IS,0.27,0.0,Phase3-EA-S1v2-USDJPY-M15-0,USDJPYMT4,2366,2d 6h 15m,Sell
102900.11,1.20093,09.07.2012 05:35:00,,-1.01,-0.0,0.0,0.0,1.20079,06.07.2012 21:15:00,8106,-0.0,4.86,IS,0.41,0.0,Phase3-EA-SA2v2-EURCHF-M5-43,EURCHFMT4,4300,2d 8h 20m,Buy
103012.74,123415,09.07.2012 05:54:58,tp 123.415,0.0,-0.0,0.0,0.0,123025,09.07.2012 02:50:00,8107,-0.0,112.63,IS,0.23,0.0,Phase3-EA-S4v1-GBPJPY-M5-194,GBPJPYMT4,1926,3h 4m,Buy
102963.61,97924,09.07.2012 13:29:58,sl 97.924,0.0,-49.13000000000466,0.0,0.0,97694,09.07.2012 12:30:00,8108,-0.025454278303082247,-49.13,IS,0.17,0.0,Phase3-EA-T1v2-EURJPY-M15-322,EURJPYMT4,1282,59m 58s,Sell
103022.32,0.97612,10.07.2012 03:44:57,tp 0.97612,-0.71,-0.0,0.0,0.0,0.97512,09.07.2012 23:45:00,8109,-0.0,58.71,IS,0.58,0.0,Phase3-EA-SA2v2-USDCHF-M15-107,USDCHFMT4,1614,3h 59m,Buy
103029.03,1.2009,10.07.2012 08:35:00,,0.0,-0.0,0.0,0.0,1.20074,10.07.2012 00:15:00,8110,-0.0,6.71,IS,0.41,0.0,Phase3-EA-SA2v2-EURCHF-M5-43,EURCHFMT4,4302,8h 20m,Buy
102984.18,123.24,10.07.2012 08:55:00,,0.0,-44.85000000000582,0.0,0.0,123395,10.07.2012 03:30:00,8111,-0.02323484711082355,-44.85,IS,0.23,0.0,Phase3-EA-S4v1-GBPJPY-M5-194,GBPJPYMT4,1928,5h 25m,Buy
102981.74,1.20092,10.07.2012 11:15:00,,0.0,-47.29000000000815,0.0,0.0,1.20085,10.07.2012 02:30:00,8112,-0.024498905682740078,-2.44,IS,0.34,0.0,Phase3-EA-S4v1-EURCHF-M15-221,EURCHFMT4,2078,8h 45m,Sell
102986.18,1.20091,11.07.2012 07:55:00,,-1.0,-42.85000000000582,0.0,0.0,1.20078,10.07.2012 23:35:00,8113,-0.022198733527286404,4.44,IS,0.41,0.0,Phase3-EA-SA2v2-EURCHF-M5-43,EURCHFMT4,4304,8h 20m,Buy
102982.36,1.20094,11.07.2012 09:45:00,,0.0,-46.670000000012806,0.0,0.0,1.20083,11.07.2012 01:00:00,8114,-0.024177710471845977,-3.82,IS,0.34,0.0,Phase3-EA-S4v1-EURCHF-M15-221,EURCHFMT4,2080,8h 45m,Sell
102933.0,97357,11.07.2012 16:59:58,sl 97.357,0.0,-96.02999999999884,0.0,0.0,97127,11.07.2012 15:15:00,8115,-0.04974899371353554,-49.36,IS,0.17,0.0,Phase3-EA-T1v2-EURJPY-M15-322,EURJPYMT4,1284,1h 44m,Sell
102883.88,97378,11.07.2012 21:14:58,sl 97.378,0.0,-145.14999999999418,0.0,0.0,97608,11.07.2012 17:15:00,8116,-0.07519594332520547,-49.12,IS,0.17,0.0,Phase3-EA-T1v2-EURJPY-M15-322,EURJPYMT4,1286,3h 59m,Buy
102905.55,79754,11.07.2012 23:45:00,,0.0,-123.47999999998137,0.0,0.0,79.69,11.07.2012 23:15:00,8117,-0.06396965264757384,21.67,IS,0.27,0.0,Phase3-EA-S1v2-USDJPY-M15-0,USDJPYMT4,2368,30m 0s,Buy
102928.79,79606,12.07.2012 02:45:00,,-4.57,-100.23999999999069,0.0,0.0,79688,11.07.2012 23:15:00,8118,-0.051930012806877014,23.24,IS,0.27,0.0,Phase3-EA-S1v2-USDJPY-M15-0,USDJPYMT4,2369,3h 30m,Sell
103000.67,123345,12.07.2012 05:20:00,,-5.02,-28.35999999998603,0.0,0.0,123611,11.07.2012 23:55:00,8119,-0.014692090614549517,71.88,IS,0.23,0.0,Phase3-EA-S4v1-GBPJPY-M5-194,GBPJPYMT4,1930,5h 25m,Sell
102994.41,1.20088,12.07.2012 10:40:00,,0.0,-34.61999999999534,0.0,0.0,1.20073,12.07.2012 02:20:00,8120,-0.017935126131025613,-6.26,IS,0.41,0.0,Phase3-EA-SA2v2-EURCHF-M5-43,EURCHFMT4,4306,8h 20m,Sell
102992.68,1.20084,12.07.2012 11:45:00,,0.0,-36.35000000000582,0.0,0.0,1.20079,12.07.2012 03:00:00,8121,-0.018831364380790673,-1.73,IS,0.34,0.0,Phase3-EA-S4v1-EURCHF-M15-221,EURCHFMT4,2082,8h 45m,Sell
103133.17,96499,12.07.2012 15:59:58,tp 96.499,-2.39,-0.0,0.0,0.0,97759,06.07.2012 19:30:00,8122,-0.0,140.49,IS,0.09,0.0,Phase3-EA-TR1v1-EURJPY-M30-91,EURJPYMT4,1340,5d 20h 29m,Sell
103083.14,96886,13.07.2012 04:44:57,sl 96.886,-0.75,-50.029999999998836,0.0,0.0,96656,12.07.2012 21:30:00,8123,-0.025904405752776045,-50.03,IS,0.17,0.0,Phase3-EA-T1v2-EURJPY-M15-322,EURJPYMT4,1288,7h 14m,Sell
103142.07,0.9842,13.07.2012 04:44:57,tp 0.98420,0.0,-0.0,0.0,0.0,0.9852,13.07.2012 02:45:00,8124,-0.0,58.93,IS,0.58,0.0,Phase3-EA-SA2v2-USDCHF-M15-107,USDCHFMT4,1616,1h 59m,Sell
103136.24,1.20085,13.07.2012 09:30:00,,0.0,-5.829999999987194,0.0,0.0,1.20071,13.07.2012 01:10:00,8125,-0.0030185034259947526,-5.83,IS,0.41,0.0,Phase3-EA-SA2v2-EURCHF-M5-43,EURCHFMT4,4308,8h 20m,Sell
103129.68,1.2009,13.07.2012 10:15:00,,0.0,-12.389999999984866,0.0,0.0,1.20071,13.07.2012 01:30:00,8126,-0.006414966972231809,-6.56,IS,0.34,0.0,Phase3-EA-S4v1-EURCHF-M15-221,EURCHFMT4,2084,8h 45m,Sell
103052.97,122861,13.07.2012 14:59:58,sl 122.861,-0.66,-89.09999999997672,0.0,0.0,122191,12.07.2012 17:30:00,8127,-0.04613184481246191,-76.71,IS,0.09,0.0,Phase3-EA-B1v1-GBPJPY-M30-1,GBPJPYMT4,788,21h 29m,Sell
103112.08,0.98118,16.07.2012 03:14:58,tp 0.98118,0.0,-29.989999999990687,0.0,0.0,0.98018,16.07.2012 01:15:00,8128,-0.015527430145069186,59.11,IS,0.58,0.0,Phase3-EA-SA2v2-USDCHF-M15-107,USDCHFMT4,1618,1h 59m,Buy
103061.6,96769,16.07.2012 07:44:58,sl 96.769,-1.05,-80.47000000000116,0.0,0.0,96999,13.07.2012 17:15:00,8129,-0.041663631336249535,-50.48,IS,0.17,0.0,Phase3-EA-T1v2-EURJPY-M15-322,EURJPYMT4,1290,2d 14h 29m,Buy
102984.95,122687,16.07.2012 12:29:58,sl 122.687,-0.41,-157.11999999999534,0.0,0.0,123357,13.07.2012 22:00:00,8130,-0.0813494439611189,-76.65,IS,0.09,0.0,Phase3-EA-B1v1-GBPJPY-M30-1,GBPJPYMT4,790,2d 14h 29m,Buy
103249.02,1.56292,16.07.2012 18:29:58,tp 1.56292,-0.53,-0.0,0.0,0.0,1.54402,13.07.2012 08:30:00,8131,-0.0,264.07,IS,0.14,0.0,Phase3-EA-B1v1-GBPUSD-M30-14,GBPUSDMT4,532,3d 9h 59m,Buy
103248.85,78806,17.07.2012 02:00:00,,-1.54,-0.17000000001280569,0.0,0.0,78.81,16.07.2012 21:30:00,8132,-8.796939824730046E-5,-0.17,IS,0.27,0.0,Phase3-EA-S1v2-USDJPY-M15-0,USDJPYMT4,2372,4h 30m,Sell
103308.16,0.97791,17.07.2012 03:44:57,tp 0.97791,0.0,-0.0,0.0,0.0,0.97891,17.07.2012 02:00:00,8133,-0.0,59.31,IS,0.58,0.0,Phase3-EA-SA2v2-USDCHF-M15-107,USDCHFMT4,1620,1h 44m,Sell
103421.87,123522,17.07.2012 04:24:58,tp 123.522,0.0,-0.0,0.0,0.0,123132,17.07.2012 02:05:00,8134,-0.0,113.71,IS,0.23,0.0,Phase3-EA-S4v1-GBPJPY-M5-194,GBPJPYMT4,1932,2h 19m,Buy
103422.96,1.2009,17.07.2012 06:00:00,,-1.01,-0.0,0.0,0.0,1.20085,16.07.2012 21:40:00,8135,-0.0,1.09,IS,0.41,0.0,Phase3-EA-SA2v2-EURCHF-M5-43,EURCHFMT4,4310,8h 20m,Buy
103339.71,97257,17.07.2012 11:59:58,sl 97.257,-1.2,-83.25,0.0,0.0,96537,12.07.2012 16:00:00,8136,-0.04304039189556392,-83.25,IS,0.09,0.0,Phase3-EA-TR1v1-EURJPY-M30-91,EURJPYMT4,1342,4d 19h 59m,Sell
103308.14,0.97729,18.07.2012 02:30:00,,-0.71,-114.82000000000698,0.0,0.0,0.97781,17.07.2012 22:15:00,8137,-0.05936213570509249,-31.57,IS,0.58,0.0,Phase3-EA-SA2v2-USDCHF-M15-107,USDCHFMT4,1622,4h 15m,Buy
103315.28,1201,18.07.2012 04:55:00,,-2.1,-107.67999999999302,0.0,0.0,1.20122,17.07.2012 20:35:00,8138,-0.05567074353530357,7.14,IS,0.41,0.0,Phase3-EA-SA2v2-EURCHF-M5-43,EURCHFMT4,4312,8h 20m,Sell
103272.75,1.56214,18.07.2012 11:59:58,sl 1.56214,-0.53,-150.20999999999185,0.0,0.0,1.56514,17.07.2012 23:30:00,8139,-0.07765882602561328,-42.53,IS,0.14,0.0,Phase3-EA-B1v1-GBPUSD-M30-14,GBPUSDMT4,534,12h 29m,Buy
103279.61,78773,19.07.2012 02:15:00,,0.0,-143.35000000000582,0.0,0.0,78793,19.07.2012 00:15:00,8140,-0.07411219433308515,6.86,IS,0.27,0.0,Phase3-EA-S1v2-USDJPY-M15-0,USDJPYMT4,2374,2h 0m,Sell
103283.44,1.20088,19.07.2012 14:45:00,,0.0,-139.52000000001863,0.0,0.0,1.20099,19.07.2012 06:00:00,8141,-0.0721320778050436,3.83,IS,0.34,0.0,Phase3-EA-S4v1-EURCHF-M15-221,EURCHFMT4,2086,8h 45m,Sell
103429.16,95851,20.07.2012 14:59:58,tp 95.851,-2.0,-0.0,0.0,0.0,97141,17.07.2012 15:30:00,8142,-0.0,145.72,IS,0.09,0.0,Phase3-EA-TR1v1-EURJPY-M30-91,EURJPYMT4,1344,2d 23h 29m,Sell
103541.84,122203,23.07.2012 03:54:59,tp 122.203,-1.7,-0.0,0.0,0.0,122593,20.07.2012 23:25:00,8143,-0.0,112.68,IS,0.23,0.0,Phase3-EA-S4v1-GBPJPY-M5-194,GBPJPYMT4,1934,2d 4h 29m,Sell
103909.63,94914,23.07.2012 05:14:58,tp 94.914,-1.52,-0.0,0.0,0.0,96614,19.07.2012 04:30:00,8144,-0.0,367.79,IS,0.17,0.0,Phase3-EA-T1v2-EURJPY-M15-322,EURJPYMT4,1292,4d 0h 44m,Sell
103904.24,1.20094,23.07.2012 07:10:00,,-2.08,-5.39000000001397,0.0,0.0,1.20086,20.07.2012 22:50:00,8145,-0.002779645343046635,-5.39,IS,0.41,0.0,Phase3-EA-SA2v2-EURCHF-M5-43,EURCHFMT4,4314,2d 8h 20m,Sell
103907.66,1.20082,23.07.2012 09:45:00,,0.0,-1.9700000000011642,0.0,0.0,1.20092,23.07.2012 01:00:00,8146,-0.0010159371661949746,3.42,IS,0.34,0.0,Phase3-EA-S4v1-EURCHF-M15-221,EURCHFMT4,2088,8h 45m,Sell
104052.5,94315,23.07.2012 09:59:58,tp 94.315,-0.4,-0.0,0.0,0.0,95575,20.07.2012 18:30:00,8147,-0.0,144.84,IS,0.09,0.0,Phase3-EA-TR1v1-EURJPY-M30-91,EURJPYMT4,1346,2d 15h 29m,Sell
104111.08,0.99011,24.07.2012 03:14:58,tp 0.99011,0.0,-0.0,0.0,0.0,0.99111,24.07.2012 01:00:00,8148,-0.0,58.58,IS,0.58,0.0,Phase3-EA-SA2v2-USDCHF-M15-107,USDCHFMT4,1624,2h 14m,Sell
104079.92,121443,24.07.2012 05:35:00,,0.0,-31.160000000003492,0.0,0.0,121549,24.07.2012 00:10:00,8149,-0.016052664278619972,-31.16,IS,0.23,0.0,Phase3-EA-S4v1-GBPJPY-M5-194,GBPJPYMT4,1936,5h 25m,Buy
104048.23,78.3,24.07.2012 08:30:00,,-1.0,-62.85000000000582,0.0,0.0,78389,23.07.2012 23:00:00,8150,-0.03237836809728003,-31.69,IS,0.27,0.0,Phase3-EA-S1v2-USDJPY-M15-0,USDJPYMT4,2376,9h 30m,Buy
104041.61,1.20095,24.07.2012 08:30:00,,0.0,-69.47000000000116,0.0,0.0,1.20079,24.07.2012 00:10:00,8151,-0.035788786503068784,-6.62,IS,0.41,0.0,Phase3-EA-SA2v2-EURCHF-M5-43,EURCHFMT4,4316,8h 20m,Sell
104036.81,1.20098,24.07.2012 10:15:00,,0.0,-74.26999999998952,0.0,0.0,1.20084,24.07.2012 01:30:00,8152,-0.03826159743173311,-4.8,IS,0.34,0.0,Phase3-EA-S4v1-EURCHF-M15-221,EURCHFMT4,2090,8h 45m,Sell
103994.81,1.55024,24.07.2012 10:29:58,sl 1.55024,0.0,-116.26999999998952,0.0,0.0,1.55324,24.07.2012 07:30:00,8153,-0.05989869305759842,-42.0,IS,0.14,0.0,Phase3-EA-B1v1-GBPUSD-M30-14,GBPUSDMT4,536,2h 59m,Buy
103992.34,1.20093,25.07.2012 09:10:00,,0.0,-118.73999999999069,0.0,0.0,1.20087,25.07.2012 00:50:00,8154,-0.061171160347977295,-2.47,IS,0.41,0.0,Phase3-EA-SA2v2-EURCHF-M5-43,EURCHFMT4,4318,8h 20m,Sell
103942.34,94527,25.07.2012 10:14:58,sl 94.527,0.0,-168.7399999999907,0.0,0.0,94297,25.07.2012 09:45:00,8155,-0.08692960752162648,-50.0,IS,0.17,0.0,Phase3-EA-T1v2-EURJPY-M15-322,EURJPYMT4,1294,29m 58s,Sell
103943.71,1.20089,25.07.2012 15:15:00,,0.0,-167.36999999999534,0.0,0.0,1.20085,25.07.2012 06:30:00,8156,-0.08622382606907089,1.37,IS,0.34,0.0,Phase3-EA-S4v1-EURCHF-M15-221,EURCHFMT4,2092,8h 45m,Buy
103969.01,121005,26.07.2012 08:05:00,,0.0,-142.07000000000698,0.0,0.0,120919,26.07.2012 02:40:00,8157,-0.0731900517992104,25.3,IS,0.23,0.0,Phase3-EA-S4v1-GBPJPY-M5-194,GBPJPYMT4,1938,5h 25m,Buy
103918.98,94697,26.07.2012 11:59:58,sl 94.697,0.0,-192.10000000000582,0.0,0.0,94927,26.07.2012 08:45:00,8158,-0.09896395404116318,-50.03,IS,0.17,0.0,Phase3-EA-T1v2-EURJPY-M15-322,EURJPYMT4,1296,3h 14m,Buy
104064.51,95771,26.07.2012 14:29:58,tp 95.771,-2.81,-46.570000000006985,0.0,0.0,94481,23.07.2012 12:00:00,8159,-0.023991417697540453,145.53,IS,0.09,0.0,Phase3-EA-TR1v1-EURJPY-M30-91,EURJPYMT4,1348,3d 2h 29m,Buy
104066.59,1.20088,26.07.2012 14:30:00,,0.0,-44.49000000001979,0.0,0.0,1.20094,26.07.2012 05:45:00,8160,-0.022919866295123242,2.08,IS,0.34,0.0,Phase3-EA-S4v1-EURCHF-M15-221,EURCHFMT4,2094,8h 45m,Sell
104253.57,96039,27.07.2012 00:45:00,,-1.06,-0.0,0.0,0.0,95174,26.07.2012 13:30:00,8161,-0.0,186.98,IS,0.17,0.0,Phase3-EA-T1v2-EURJPY-M15-322,EURJPYMT4,1298,11h 15m,Buy
104255.49,1.20088,27.07.2012 05:30:00,,-1.01,-0.0,0.0,0.0,1.20081,26.07.2012 21:10:00,8162,-0.0,1.92,IS,0.41,0.0,Phase3-EA-SA2v2-EURCHF-M5-43,EURCHFMT4,4320,8h 20m,Buy
104173.81,123209,27.07.2012 16:29:58,sl 123.209,-4.68,-81.67999999999302,0.0,0.0,122539,20.07.2012 20:30:00,8163,-0.042047717673252306,-81.68,IS,0.09,0.0,Phase3-EA-B1v1-GBPJPY-M30-1,GBPJPYMT4,792,6d 19h 59m,Sell
104096.47,123008,30.07.2012 10:29:57,sl 123.008,-0.41,-159.01999999998952,0.0,0.0,123678,27.07.2012 20:30:00,8164,-0.08186126425564047,-77.34,IS,0.09,0.0,Phase3-EA-B1v1-GBPJPY-M30-1,GBPJPYMT4,794,2d 13h 59m,Buy
104010.24,78249,30.07.2012 17:30:00,,-1.0,-245.25,0.0,0.0,78496,27.07.2012 22:45:00,8165,-0.12625125807255155,-86.23,IS,0.27,0.0,Phase3-EA-S1v2-USDJPY-M15-0,USDJPYMT4,2378,2d 18h 45m,Buy
104015.11,1.20114,31.07.2012 07:20:00,,-1.0,-240.38000000000466,0.0,0.0,1201,30.07.2012 23:00:00,8166,-0.12374425041990021,4.87,IS,0.41,0.0,Phase3-EA-SA2v2-EURCHF-M5-43,EURCHFMT4,4322,8h 20m,Buy
103973.11,1.5681,31.07.2012 12:29:58,sl 1.56810,0.0,-282.38000000000466,0.0,0.0,1.5711,31.07.2012 03:00:00,8167,-0.14536526097666747,-42.0,IS,0.14,0.0,Phase3-EA-B1v1-GBPUSD-M30-14,GBPUSDMT4,538,9h 29m,Buy
103958.86,1.20147,31.07.2012 15:00:00,,0.0,-296.63000000000466,0.0,0.0,1.20106,31.07.2012 06:15:00,8168,-0.1527009609869992,-14.25,IS,0.34,0.0,Phase3-EA-S4v1-EURCHF-M15-221,EURCHFMT4,2096,8h 45m,Sell
103955.4,96054,01.08.2012 00:45:00,,-1.07,-300.0899999999965,0.0,0.0,96065,31.07.2012 15:30:00,8169,-0.1544821204281001,-3.46,IS,0.17,0.0,Phase3-EA-T1v2-EURJPY-M15-322,EURJPYMT4,1300,9h 15m,Buy
103952.71,1.20095,01.08.2012 05:45:00,,-1.01,-302.77999999999884,0.0,0.0,1.20099,31.07.2012 21:25:00,8170,-0.1558668946756657,-2.69,IS,0.41,0.0,Phase3-EA-SA2v2-EURCHF-M5-43,EURCHFMT4,4324,8h 20m,Buy
103875.5,121823,01.08.2012 21:29:57,sl 121.823,0.0,-379.9899999999907,0.0,0.0,122493,01.08.2012 09:00:00,8171,-0.1956135190825186,-77.21,IS,0.09,0.0,Phase3-EA-B1v1-GBPJPY-M30-1,GBPJPYMT4,796,12h 29m,Buy
103894.6,121896,02.08.2012 04:55:00,,-3.17,-360.88999999998487,0.0,0.0,121.82,01.08.2012 23:30:00,8172,-0.18578110713884288,19.1,IS,0.23,0.0,Phase3-EA-S4v1-GBPJPY-M5-194,GBPJPYMT4,1940,5h 25m,Buy
103899.2,1.20126,02.08.2012 05:05:00,,-6.26,-356.28999999997905,0.0,0.0,1.20152,01.08.2012 20:45:00,8173,-0.18341309169690823,4.6,IS,0.41,0.0,Phase3-EA-SA2v2-EURCHF-M5-43,EURCHFMT4,4326,8h 20m,Sell
103923.87,1.20186,02.08.2012 12:45:00,,0.0,-331.61999999996624,0.0,0.0,1.20115,02.08.2012 04:00:00,8174,-0.17071332192462907,24.67,IS,0.34,0.0,Phase3-EA-S4v1-EURCHF-M15-221,EURCHFMT4,2098,8h 45m,Buy
103873.94,96377,02.08.2012 15:44:58,sl 96.377,0.0,-381.54999999995925,0.0,0.0,96607,02.08.2012 15:15:00,8175,-0.19641658518889663,-49.93,IS,0.17,0.0,Phase3-EA-T1v2-EURJPY-M15-322,EURJPYMT4,1302,29m 58s,Buy
103787.26,95509,02.08.2012 15:59:58,sl 95.509,-3.93,-468.22999999995227,0.0,0.0,96229,26.07.2012 18:00:00,8176,-0.2410382326903355,-86.68,IS,0.09,0.0,Phase3-EA-TR1v1-EURJPY-M30-91,EURJPYMT4,1350,6d 21h 59m,Buy
103793.13,78.21,02.08.2012 18:15:00,,0.0,-462.3599999999569,0.0,0.0,78227,02.08.2012 17:45:00,8177,-0.23801643907204686,5.87,IS,0.27,0.0,Phase3-EA-S1v2-USDJPY-M15-0,USDJPYMT4,2380,30m 0s,Sell
103799.0,78191,02.08.2012 18:45:00,,0.0,-456.4899999999616,0.0,0.0,78208,02.08.2012 18:15:00,8178,-0.23499464545375823,5.87,IS,0.27,0.0,Phase3-EA-S1v2-USDJPY-M15-0,USDJPYMT4,2382,30m 0s,Sell
103798.31,78191,02.08.2012 23:15:00,,0.0,-457.1799999999639,0.0,0.0,78189,02.08.2012 18:45:00,8179,-0.23534984777004916,-0.69,IS,0.27,0.0,Phase3-EA-S1v2-USDJPY-M15-0,USDJPYMT4,2384,4h 30m,Sell
103856.36,0.98715,03.08.2012 03:29:58,tp 0.98715,-0.71,-399.12999999997555,0.0,0.0,0.98615,02.08.2012 23:30:00,8180,-0.205466522464809,58.05,IS,0.58,0.0,Phase3-EA-SA2v2-USDCHF-M15-107,USDCHFMT4,1626,3h 59m,Buy
103867.0,1.20131,03.08.2012 06:55:00,,-1.0,-388.4899999999616,0.0,0.0,1.20103,02.08.2012 22:35:00,8181,-0.1999891997904208,10.64,IS,0.41,0.0,Phase3-EA-SA2v2-EURCHF-M5-43,EURCHFMT4,4328,8h 20m,Buy
103816.98,95275,03.08.2012 08:29:58,sl 95.275,0.0,-438.5099999999511,0.0,0.0,95045,03.08.2012 03:30:00,8182,-0.2257387937915939,-50.02,IS,0.17,0.0,Phase3-EA-T1v2-EURJPY-M15-322,EURJPYMT4,1304,4h 59m,Sell
103884.32,121329,03.08.2012 09:10:00,,0.0,-371.1699999999546,0.0,0.0,121.1,03.08.2012 03:45:00,8183,-0.1910731068655789,67.34,IS,0.23,0.0,Phase3-EA-S4v1-GBPJPY-M5-194,GBPJPYMT4,1942,5h 25m,Buy
103841.63,1.55469,03.08.2012 12:29:58,sl 1.55469,-0.69,-413.8599999999569,0.0,0.0,1.55169,02.08.2012 18:00:00,8184,-0.21304931973863708,-42.69,IS,0.14,0.0,Phase3-EA-B1v1-GBPUSD-M30-14,GBPUSDMT4,540,18h 29m,Sell
103989.02,96572,03.08.2012 16:29:58,tp 96.572,0.0,-266.46999999994296,0.0,0.0,95282,03.08.2012 08:30:00,8185,-0.137175016263346,147.39,IS,0.09,0.0,Phase3-EA-TR1v1-EURJPY-M30-91,EURJPYMT4,1352,7h 59m,Buy
104133.1,96949,03.08.2012 17:29:59,tp 96.949,0.0,-122.38999999995576,0.0,0.0,95689,03.08.2012 12:30:00,8186,-0.06300465433432823,144.08,IS,0.09,0.0,Phase3-EA-TR1v1-EURJPY-M30-91,EURJPYMT4,1353,4h 59m,Buy
104247.32,122596,06.08.2012 04:24:58,tp 122.596,0.0,-8.169999999954598,0.0,0.0,122986,06.08.2012 02:50:00,8187,-0.004205801339233492,114.22,IS,0.23,0.0,Phase3-EA-S4v1-GBPJPY-M5-194,GBPJPYMT4,1944,1h 34m,Sell
104283.52,1.20203,06.08.2012 05:35:00,,-1.01,-0.0,0.0,0.0,1.20115,03.08.2012 21:15:00,8188,-0.0,36.2,IS,0.41,0.0,Phase3-EA-SA2v2-EURCHF-M5-43,EURCHFMT4,4330,2d 8h 20m,Buy
104315.71,1.20108,06.08.2012 14:15:00,,0.0,-0.0,0.0,0.0,1202,06.08.2012 05:30:00,8189,-0.0,32.19,IS,0.34,0.0,Phase3-EA-S4v1-EURCHF-M15-221,EURCHFMT4,2100,8h 45m,Sell
104178.03,78207,07.08.2012 00:15:00,,-2.0,-137.67999999999302,0.0,0.0,78.6,03.08.2012 21:15:00,8190,-0.07085376679013382,-137.68,IS,0.27,0.0,Phase3-EA-S1v2-USDJPY-M15-0,USDJPYMT4,2386,3d 3h 0m,Buy
104170.66,1.20115,07.08.2012 07:50:00,,-1.02,-145.04999999998836,0.0,0.0,1.2013,06.08.2012 23:30:00,8191,-0.07464656357429261,-7.37,IS,0.41,0.0,Phase3-EA-SA2v2-EURCHF-M5-43,EURCHFMT4,4332,8h 20m,Buy
104190.35,121965,07.08.2012 08:00:00,,0.0,-125.35999999998603,0.0,0.0,121898,07.08.2012 02:35:00,8192,-0.06451356918078614,19.69,IS,0.23,0.0,Phase3-EA-S4v1-GBPJPY-M5-194,GBPJPYMT4,1946,5h 25m,Buy
104140.39,97102,07.08.2012 10:29:58,sl 97.102,0.0,-175.31999999997788,0.0,0.0,96872,07.08.2012 09:15:00,8193,-0.09022430559010258,-49.96,IS,0.17,0.0,Phase3-EA-T1v2-EURJPY-M15-322,EURJPYMT4,1306,1h 14m,Sell
104097.04,122588,08.08.2012 05:45:00,,0.0,-218.6699999999837,0.0,0.0,122736,08.08.2012 00:20:00,8194,-0.11253336130155572,-43.35,IS,0.23,0.0,Phase3-EA-S4v1-GBPJPY-M5-194,GBPJPYMT4,1948,5h 25m,Buy
104085.02,1.20103,08.08.2012 06:25:00,,-1.02,-230.68999999997322,0.0,0.0,1.20129,07.08.2012 22:05:00,8195,-0.11871917098209545,-12.02,IS,0.41,0.0,Phase3-EA-SA2v2-EURCHF-M5-43,EURCHFMT4,4334,8h 20m,Buy
104092.37,1.20109,08.08.2012 13:45:00,,0.0,-223.3399999999674,0.0,0.0,1.2013,08.08.2012 05:00:00,8196,-0.11493666672651787,7.35,IS,0.34,0.0,Phase3-EA-S4v1-EURCHF-M15-221,EURCHFMT4,2102,8h 45m,Sell
104022.86,78429,08.08.2012 15:00:00,,-1.0,-292.8499999999767,0.0,0.0,78628,07.08.2012 22:00:00,8197,-0.1507083498292424,-69.51,IS,0.27,0.0,Phase3-EA-S1v2-USDJPY-M15-0,USDJPYMT4,2388,17h 0m,Buy
104019.06,1.20125,09.08.2012 09:20:00,,0.0,-296.6499999999651,0.0,0.0,1.20116,09.08.2012 01:00:00,8198,-0.15266393026068992,-3.8,IS,0.41,0.0,Phase3-EA-SA2v2-EURCHF-M5-43,EURCHFMT4,4336,8h 20m,Sell
104012.76,1.20126,09.08.2012 10:00:00,,0.0,-302.94999999995343,0.0,0.0,1.20108,09.08.2012 01:15:00,8199,-0.15590607676546214,-6.3,IS,0.34,0.0,Phase3-EA-S4v1-EURCHF-M15-221,EURCHFMT4,2104,8h 45m,Sell
103969.16,1.56215,09.08.2012 15:59:57,sl 1.56215,-1.6,-346.54999999995925,0.0,0.0,1.56515,08.08.2012 13:30:00,8200,-0.17834378908424778,-43.6,IS,0.14,0.0,Phase3-EA-B1v1-GBPUSD-M30-14,GBPUSDMT4,542,1d 2h 29m,Buy
103981.56,78596,10.08.2012 02:15:00,,-1.0,-334.1499999999651,0.0,0.0,78557,09.08.2012 20:30:00,8201,-0.17196242136056028,12.4,IS,0.27,0.0,Phase3-EA-S1v2-USDJPY-M15-0,USDJPYMT4,2390,5h 45m,Buy
103967.78,0.9766,10.08.2012 02:30:00,,-0.71,-347.9299999999639,0.0,0.0,0.97682,09.08.2012 22:15:00,8202,-0.1790539735567254,-13.78,IS,0.58,0.0,Phase3-EA-SA2v2-USDCHF-M15-107,USDCHFMT4,1628,4h 15m,Buy
103967.43,1.20092,10.08.2012 10:15:00,,0.0,-348.27999999996973,0.0,0.0,1.20091,10.08.2012 01:30:00,8203,-0.17923409280699384,-0.35,IS,0.34,0.0,Phase3-EA-S4v1-EURCHF-M15-221,EURCHFMT4,2106,8h 45m,Sell
103880.89,96251,10.08.2012 10:29:58,sl 96.251,-3.93,-434.8199999999779,0.0,0.0,96971,03.08.2012 18:00:00,8204,-0.22376986400120555,-86.54,IS,0.09,0.0,Phase3-EA-TR1v1-EURJPY-M30-91,EURJPYMT4,1356,6d 16h 29m,Buy
103887.44,1.20089,13.08.2012 06:30:00,,-1.01,-428.2699999999895,0.0,0.0,1.20071,10.08.2012 22:10:00,8205,-0.22039906088910086,6.55,IS,0.41,0.0,Phase3-EA-SA2v2-EURCHF-M5-43,EURCHFMT4,4338,2d 8h 20m,Buy
103884.66,1.2009,13.08.2012 10:15:00,,0.0,-431.04999999998836,0.0,0.0,1.20082,13.08.2012 01:30:00,8206,-0.22182972236263732,-2.78,IS,0.34,0.0,Phase3-EA-S4v1-EURCHF-M15-221,EURCHFMT4,2108,8h 45m,Sell
103801.49,96806,13.08.2012 15:59:58,sl 96.806,-0.4,-514.2200000000012,0.0,0.0,96086,10.08.2012 15:30:00,8207,-0.26463120249000976,-83.17,IS,0.09,0.0,Phase3-EA-TR1v1-EURJPY-M30-91,EURJPYMT4,1358,3d 0h 29m,Sell
103750.81,96837,13.08.2012 16:59:58,sl 96.837,-0.76,-564.8999999999942,0.0,0.0,96607,10.08.2012 07:45:00,8208,-0.2907124699284443,-50.68,IS,0.17,0.0,Phase3-EA-T1v2-EURJPY-M15-322,EURJPYMT4,1308,3d 9h 14m,Sell
103744.06,1.20107,14.08.2012 09:05:00,,0.0,-571.6499999999942,0.0,0.0,1.20091,14.08.2012 00:45:00,8209,-0.29418619832642096,-6.75,IS,0.41,0.0,Phase3-EA-SA2v2-EURCHF-M5-43,EURCHFMT4,4340,8h 20m,Sell
103665.21,123174,14.08.2012 09:10:00,,0.0,-650.5,0.0,0.0,122905,14.08.2012 03:45:00,8210,-0.3347644922790847,-78.85,IS,0.23,0.0,Phase3-EA-S4v1-GBPJPY-M5-194,GBPJPYMT4,1950,5h 25m,Sell
103575.54,97436,14.08.2012 15:59:58,sl 97.436,-0.4,-740.1700000000128,0.0,0.0,96656,13.08.2012 21:30:00,8211,-0.38091104419710137,-89.67,IS,0.09,0.0,Phase3-EA-TR1v1-EURJPY-M30-91,EURJPYMT4,1360,18h 29m,Sell
103578.32,78759,15.08.2012 01:45:00,,-0.99,-737.390000000014,0.0,0.0,78748,14.08.2012 20:00:00,8212,-0.3794803827235649,2.78,IS,0.27,0.0,Phase3-EA-S1v2-USDJPY-M15-0,USDJPYMT4,2392,5h 45m,Buy
103576.05,1.20089,15.08.2012 06:25:00,,-1.01,-739.6600000000035,0.0,0.0,1.20092,14.08.2012 22:05:00,8213,-0.38064858471813834,-2.27,IS,0.41,0.0,Phase3-EA-SA2v2-EURCHF-M5-43,EURCHFMT4,4342,8h 20m,Buy
103579.19,1.20097,15.08.2012 11:00:00,,0.0,-736.5199999999895,0.0,0.0,1.20106,15.08.2012 02:15:00,8214,-0.3790326577300353,3.14,IS,0.34,0.0,Phase3-EA-S4v1-EURCHF-M15-221,EURCHFMT4,2110,8h 45m,Sell
103529.63,96972,15.08.2012 13:29:58,sl 96.972,0.0,-786.0799999999872,0.0,0.0,97202,15.08.2012 03:15:00,8215,-0.4045375435676228,-49.56,IS,0.17,0.0,Phase3-EA-T1v2-EURJPY-M15-322,EURJPYMT4,1310,10h 14m,Buy
103555.73,78952,16.08.2012 00:15:00,,-2.97,-759.9799999999814,0.0,0.0,78867,15.08.2012 23:00:00,8216,-0.39110579376211,26.1,IS,0.27,0.0,Phase3-EA-S1v2-USDJPY-M15-0,USDJPYMT4,2394,1h 15m,Buy
103615.12,0.97665,16.08.2012 03:29:59,tp 0.97665,0.0,-700.5899999999674,0.0,0.0,0.97765,16.08.2012 01:15:00,8217,-0.36054213012420144,59.39,IS,0.58,0.0,Phase3-EA-SA2v2-USDCHF-M15-107,USDCHFMT4,1630,2h 14m,Sell
103529.42,124109,16.08.2012 05:30:00,,0.0,-786.289999999979,0.0,0.0,123814,16.08.2012 00:05:00,8218,-0.40464561511777786,-85.7,IS,0.23,0.0,Phase3-EA-S4v1-GBPJPY-M5-194,GBPJPYMT4,1952,5h 25m,Sell
103734.4,124176,16.08.2012 06:59:58,tp 124.176,-5.34,-581.3099999999686,0.0,0.0,122326,03.08.2012 16:00:00,8219,-0.2991574896337344,204.98,IS,0.09,0.0,Phase3-EA-B1v1-GBPJPY-M30-1,GBPJPYMT4,798,12d 14h 59m,Buy
103732.32,1.20097,16.08.2012 09:45:00,,0.0,-583.3899999999558,0.0,0.0,1.20091,16.08.2012 01:00:00,8220,-0.3002279126067339,-2.08,IS,0.34,0.0,Phase3-EA-S4v1-EURCHF-M15-221,EURCHFMT4,2112,8h 45m,Sell
103719.61,0.97207,17.08.2012 03:15:00,,-3.16,-596.0999999999476,0.0,0.0,0.97191,16.08.2012 23:00:00,8221,-0.30676881452351246,-12.71,IS,0.58,0.0,Phase3-EA-SA2v2-USDCHF-M15-107,USDCHFMT4,1632,4h 15m,Sell
103733.29,124812,17.08.2012 04:50:00,,-1.68,-582.4199999999546,0.0,0.0,124865,16.08.2012 23:25:00,8222,-0.29972872497028336,13.68,IS,0.23,0.0,Phase3-EA-S4v1-GBPJPY-M5-194,GBPJPYMT4,1954,5h 25m,Sell
103731.89,1.20097,17.08.2012 10:15:00,,0.0,-583.8199999999488,0.0,0.0,1.20093,17.08.2012 01:30:00,8223,-0.3004492019713422,-1.4,IS,0.34,0.0,Phase3-EA-S4v1-EURCHF-M15-221,EURCHFMT4,2114,8h 45m,Sell
103682.65,97896,17.08.2012 15:14:58,sl 97.896,0.0,-633.0599999999395,0.0,0.0,98126,17.08.2012 09:30:00,8224,-0.32578940735154055,-49.24,IS,0.17,0.0,Phase3-EA-T1v2-EURJPY-M15-322,EURJPYMT4,1312,5h 44m,Buy
103687.96,1.20103,20.08.2012 06:25:00,,-1.01,-627.7499999999418,0.0,0.0,1.20088,17.08.2012 22:05:00,8225,-0.3230567410118001,5.31,IS,0.41,0.0,Phase3-EA-SA2v2-EURCHF-M5-43,EURCHFMT4,4344,2d 8h 20m,Buy
103720.05,124792,20.08.2012 07:05:00,,0.0,-595.6599999999453,0.0,0.0,124681,20.08.2012 01:40:00,8226,-0.3065423788946061,32.09,IS,0.23,0.0,Phase3-EA-S4v1-GBPJPY-M5-194,GBPJPYMT4,1956,5h 25m,Buy
103705.73,98059,20.08.2012 09:30:00,,-1.05,-609.9799999999523,0.0,0.0,98121,17.08.2012 23:00:00,8227,-0.3139118293626136,-14.32,IS,0.17,0.0,Phase3-EA-T1v2-EURJPY-M15-322,EURJPYMT4,1314,2d 10h 30m,Buy
103707.13,1.20098,20.08.2012 12:15:00,,0.0,-608.5799999999581,0.0,0.0,1.20102,20.08.2012 03:30:00,8228,-0.3131913523615547,1.4,IS,0.34,0.0,Phase3-EA-S4v1-EURCHF-M15-221,EURCHFMT4,2116,8h 45m,Sell
103711.18,1.20096,21.08.2012 05:35:00,,-1.01,-604.5299999999697,0.0,0.0,1.20084,20.08.2012 21:15:00,8229,-0.31110711532277474,4.05,IS,0.41,0.0,Phase3-EA-SA2v2-EURCHF-M5-43,EURCHFMT4,4346,8h 20m,Buy
103732.64,124691,21.08.2012 08:25:00,,0.0,-583.0699999999779,0.0,0.0,124617,21.08.2012 03:00:00,8230,-0.30006323214935976,21.46,IS,0.23,0.0,Phase3-EA-S4v1-GBPJPY-M5-194,GBPJPYMT4,1958,5h 25m,Buy
103871.67,98476,21.08.2012 10:59:58,tp 98.476,-3.91,-444.03999999997905,0.0,0.0,97216,14.08.2012 11:00:00,8231,-0.2285147196796276,139.03,IS,0.09,0.0,Phase3-EA-TR1v1-EURJPY-M30-91,EURJPYMT4,1361,6d 23h 59m,Buy
104021.16,98833,21.08.2012 23:45:00,,0.0,-294.54999999998836,0.0,0.0,98136,21.08.2012 09:45:00,8232,-0.15158321475910916,149.49,IS,0.17,0.0,Phase3-EA-T1v2-EURJPY-M15-322,EURJPYMT4,1316,14h 0m,Buy
104037.24,0.96319,22.08.2012 02:45:00,,-3.19,-278.47000000000116,0.0,0.0,0.96351,21.08.2012 22:30:00,8233,-0.14330802177549135,16.08,IS,0.58,0.0,Phase3-EA-SA2v2-USDCHF-M15-107,USDCHFMT4,1634,4h 15m,Sell
104036.22,1.20087,22.08.2012 05:30:00,,-1.02,-279.4899999999907,0.0,0.0,1.20087,21.08.2012 21:10:00,8234,-0.14383294073340241,-1.02,IS,0.41,0.0,Phase3-EA-SA2v2-EURCHF-M5-43,EURCHFMT4,4348,8h 20m,Buy
103986.88,98606,22.08.2012 14:29:58,sl 98.606,0.0,-328.8299999999872,0.0,0.0,98836,22.08.2012 08:00:00,8235,-0.16922460875653672,-49.34,IS,0.17,0.0,Phase3-EA-T1v2-EURJPY-M15-322,EURJPYMT4,1318,6h 29m,Buy
103991.93,1.20099,23.08.2012 05:35:00,,-3.08,-323.77999999999884,0.0,0.0,1.2008,22.08.2012 21:15:00,8236,-0.16662574528842686,5.05,IS,0.41,0.0,Phase3-EA-SA2v2-EURCHF-M5-43,EURCHFMT4,4350,8h 20m,Buy
103942.13,98558,23.08.2012 09:59:58,sl 98.558,0.0,-373.5799999999872,0.0,0.0,98328,23.08.2012 09:30:00,8237,-0.1922541414690487,-49.8,IS,0.17,0.0,Phase3-EA-T1v2-EURJPY-M15-322,EURJPYMT4,1320,29m 58s,Sell
103944.62,1.20088,23.08.2012 14:00:00,,0.0,-371.0899999999965,0.0,0.0,1.20095,23.08.2012 05:15:00,8238,-0.1909727216600221,2.49,IS,0.34,0.0,Phase3-EA-S4v1-EURCHF-M15-221,EURCHFMT4,2118,8h 45m,Sell
103894.76,98606,23.08.2012 17:44:58,sl 98.606,0.0,-420.94999999998254,0.0,0.0,98376,23.08.2012 17:15:00,8239,-0.21663199542640257,-49.86,IS,0.17,0.0,Phase3-EA-T1v2-EURJPY-M15-322,EURJPYMT4,1322,29m 58s,Sell
103888.26,98.7,23.08.2012 20:00:00,,0.0,-427.44999999998254,0.0,0.0,98.73,23.08.2012 19:00:00,8240,-0.21997706721704677,-6.5,IS,0.17,0.0,Phase3-EA-T1v2-EURJPY-M15-322,EURJPYMT4,1324,1h 0m,Buy
103901.61,0.95588,24.08.2012 06:30:00,,0.0,-414.0999999999767,0.0,0.0,0.9561,24.08.2012 02:15:00,8241,-0.21310680438548993,13.35,IS,0.58,0.0,Phase3-EA-SA2v2-USDCHF-M15-107,USDCHFMT4,1636,4h 15m,Sell
103878.91,98569,24.08.2012 10:30:00,,0.0,-436.79999999998836,0.0,0.0,98674,24.08.2012 01:00:00,8242,-0.2247888243312841,-22.7,IS,0.17,0.0,Phase3-EA-T1v2-EURJPY-M15-322,EURJPYMT4,1326,9h 30m,Buy
103838.87,78569,24.08.2012 12:00:00,,-1.55,-476.8399999999965,0.0,0.0,78457,23.08.2012 22:45:00,8243,-0.24539446656165656,-40.04,IS,0.27,0.0,Phase3-EA-S1v2-USDJPY-M15-0,USDJPYMT4,2396,13h 15m,Sell
103753.57,98069,24.08.2012 15:59:58,sl 98.069,-2.8,-562.1399999999849,0.0,0.0,98789,21.08.2012 15:30:00,8244,-0.28929210098348906,-85.3,IS,0.09,0.0,Phase3-EA-TR1v1-EURJPY-M30-91,EURJPYMT4,1364,3d 0h 29m,Buy
103810.86,0.9589,27.08.2012 02:14:57,tp 0.95890,-3.2,-504.8499999999767,0.0,0.0,0.9599,24.08.2012 23:30:00,8245,-0.2598091528471762,57.29,IS,0.58,0.0,Phase3-EA-SA2v2-USDCHF-M15-107,USDCHFMT4,1638,2d 2h 44m,Sell
103806.17,1.20092,27.08.2012 09:40:00,,0.0,-509.53999999997905,0.0,0.0,1.20081,27.08.2012 01:20:00,8246,-0.26222275080073454,-4.69,IS,0.41,0.0,Phase3-EA-SA2v2-EURCHF-M5-43,EURCHFMT4,4352,8h 20m,Sell
103808.65,1.20095,27.08.2012 09:45:00,,0.0,-507.05999999996857,0.0,0.0,1.20088,27.08.2012 01:00:00,8247,-0.26094647725599107,2.48,IS,0.34,0.0,Phase3-EA-S4v1-EURCHF-M15-221,EURCHFMT4,2120,8h 45m,Buy
103786.83,98456,27.08.2012 19:30:00,,0.0,-528.8799999999756,0.0,0.0,98557,27.08.2012 11:45:00,8248,-0.27217562594397254,-21.82,IS,0.17,0.0,Phase3-EA-T1v2-EURJPY-M15-322,EURJPYMT4,1328,7h 45m,Buy
103758.29,0.96142,28.08.2012 03:45:00,,-3.2,-557.4199999999837,0.0,0.0,961,27.08.2012 23:30:00,8249,-0.28686306423705143,-28.54,IS,0.58,0.0,Phase3-EA-SA2v2-USDCHF-M15-107,USDCHFMT4,1640,4h 15m,Sell
103755.31,1.20098,28.08.2012 05:15:00,,-2.13,-560.3999999999942,0.0,0.0,1.20096,27.08.2012 20:55:00,8250,-0.28839665099645984,-2.98,IS,0.41,0.0,Phase3-EA-SA2v2-EURCHF-M5-43,EURCHFMT4,4354,8h 20m,Sell
103681.82,124006,28.08.2012 08:55:00,,0.0,-633.8899999999849,0.0,0.0,124257,28.08.2012 03:30:00,8251,-0.32621654728790767,-73.49,IS,0.23,0.0,Phase3-EA-S4v1-GBPJPY-M5-194,GBPJPYMT4,1960,5h 25m,Buy
103682.89,1.20093,28.08.2012 13:00:00,,0.0,-632.8199999999779,0.0,0.0,1.20096,28.08.2012 04:15:00,8252,-0.3256658970085211,1.07,IS,0.34,0.0,Phase3-EA-S4v1-EURCHF-M15-221,EURCHFMT4,2122,8h 45m,Sell
103678.46,0.95575,29.08.2012 02:30:00,,-3.22,-637.2499999999709,0.0,0.0,0.95573,28.08.2012 22:15:00,8253,-0.3279456920904489,-4.43,IS,0.58,0.0,Phase3-EA-SA2v2-USDCHF-M15-107,USDCHFMT4,1642,4h 15m,Sell
103679.63,124279,29.08.2012 07:40:00,,0.0,-636.0799999999581,0.0,0.0,124283,29.08.2012 02:15:00,8254,-0.32734357916812634,1.17,IS,0.23,0.0,Phase3-EA-S4v1-GBPJPY-M5-194,GBPJPYMT4,1962,5h 25m,Sell
103678.35,1.20088,29.08.2012 11:10:00,,0.0,-637.3599999999569,0.0,0.0,1.20085,29.08.2012 02:50:00,8255,-0.328002300997668,-1.28,IS,0.41,0.0,Phase3-EA-SA2v2-EURCHF-M5-43,EURCHFMT4,4356,8h 20m,Sell
103675.86,1.20095,29.08.2012 12:45:00,,0.0,-639.8499999999476,0.0,0.0,1.20088,29.08.2012 04:00:00,8256,-0.3292837208066946,-2.49,IS,0.34,0.0,Phase3-EA-S4v1-EURCHF-M15-221,EURCHFMT4,2124,8h 45m,Sell
103626.14,98811,29.08.2012 15:59:57,sl 98.811,0.0,-689.5699999999488,0.0,0.0,98581,29.08.2012 14:45:00,8257,-0.35487094687297666,-49.72,IS,0.17,0.0,Phase3-EA-T1v2-EURJPY-M15-322,EURJPYMT4,1330,1h 14m,Sell
103687.28,124414,30.08.2012 07:30:00,,0.0,-628.4299999999348,0.0,0.0,124623,30.08.2012 02:05:00,8258,-0.3234066869837408,61.14,IS,0.23,0.0,Phase3-EA-S4v1-GBPJPY-M5-194,GBPJPYMT4,1964,5h 25m,Sell
103682.14,1.20098,30.08.2012 08:45:00,,0.0,-633.5699999999488,0.0,0.0,1.20086,30.08.2012 00:25:00,8259,-0.3260518668305036,-5.14,IS,0.41,0.0,Phase3-EA-SA2v2-EURCHF-M5-43,EURCHFMT4,4358,8h 20m,Sell
103682.5,1.20087,30.08.2012 12:15:00,,0.0,-633.2099999999627,0.0,0.0,1.20088,30.08.2012 03:30:00,8260,-0.32586660131595196,0.36,IS,0.34,0.0,Phase3-EA-S4v1-EURCHF-M15-221,EURCHFMT4,2126,8h 45m,Sell
103638.9,1.58017,30.08.2012 17:59:58,sl 1.58017,-1.6,-676.8099999999686,0.0,0.0,1.58317,29.08.2012 14:30:00,8261,-0.34830431363473763,-43.6,IS,0.14,0.0,Phase3-EA-B1v1-GBPUSD-M30-14,GBPUSDMT4,544,1d 3h 29m,Buy
103644.29,1.20088,31.08.2012 07:55:00,,-1.02,-671.4199999999546,0.0,0.0,1.20073,30.08.2012 23:35:00,8262,-0.3455304771806424,5.39,IS,0.41,0.0,Phase3-EA-SA2v2-EURCHF-M5-43,EURCHFMT4,4360,8h 20m,Buy
103594.5,98474,31.08.2012 11:59:59,sl 98.474,0.0,-721.2099999999627,0.0,0.0,98244,31.08.2012 05:45:00,8263,-0.37115372709698113,-49.79,IS,0.17,0.0,Phase3-EA-T1v2-EURJPY-M15-322,EURJPYMT4,1332,6h 14m,Sell
103613.47,78273,31.08.2012 23:15:00,,0.0,-702.2399999999616,0.0,0.0,78328,31.08.2012 22:00:00,8264,-0.3613912637325928,18.97,IS,0.27,0.0,Phase3-EA-S1v2-USDJPY-M15-0,USDJPYMT4,2398,1h 15m,Sell
103673.46,0.95525,03.09.2012 02:44:58,tp 0.95525,-0.73,-642.2499999999709,0.0,0.0,0.95425,31.08.2012 23:30:00,8265,-0.3305188242370983,59.99,IS,0.58,0.0,Phase3-EA-SA2v2-USDCHF-M15-107,USDCHFMT4,1644,2d 3h 14m,Buy
103672.86,1.20075,03.09.2012 05:00:00,,-1.03,-642.8499999999767,0.0,0.0,1.20074,31.08.2012 20:40:00,8266,-0.3308276000946992,-0.6,IS,0.41,0.0,Phase3-EA-SA2v2-EURCHF-M5-43,EURCHFMT4,4362,2d 8h 20m,Buy
103738.6,124522,04.09.2012 05:35:00,,0.0,-577.109999999986,0.0,0.0,124298,04.09.2012 00:10:00,8267,-0.2969960586305579,65.74,IS,0.23,0.0,Phase3-EA-S4v1-GBPJPY-M5-194,GBPJPYMT4,1966,5h 25m,Buy
103735.59,1.20078,04.09.2012 06:20:00,,-2.15,-580.1199999999953,0.0,0.0,1.20076,03.09.2012 22:00:00,8268,-0.2985450841828456,-3.01,IS,0.41,0.0,Phase3-EA-SA2v2-EURCHF-M5-43,EURCHFMT4,4364,8h 20m,Sell
103757.95,98681,04.09.2012 14:15:00,,-1.06,-557.7600000000093,0.0,0.0,98573,03.09.2012 18:15:00,8269,-0.2870380372230368,22.36,IS,0.17,0.0,Phase3-EA-T1v2-EURJPY-M15-322,EURJPYMT4,1334,20h 0m,Buy
103715.95,1.58653,04.09.2012 16:29:57,sl 1.58653,0.0,-599.7600000000093,0.0,0.0,1.58953,04.09.2012 05:00:00,8270,-0.3086523472548916,-42.0,IS,0.14,0.0,Phase3-EA-B1v1-GBPUSD-M30-14,GBPUSDMT4,546,11h 29m,Buy
103724.34,1.20122,05.09.2012 07:40:00,,-1.03,-591.3699999999953,0.0,0.0,1201,04.09.2012 23:20:00,8271,-0.3043346315128067,8.39,IS,0.41,0.0,Phase3-EA-SA2v2-EURCHF-M5-43,EURCHFMT4,4366,8h 20m,Buy
103640.01,98168,05.09.2012 09:29:58,sl 98.168,-1.68,-675.6999999999825,0.0,0.0,98296,28.08.2012 11:30:00,8272,-0.3477330782981886,-84.33,IS,0.09,0.0,Phase3-EA-TR1v1-EURJPY-M30-91,EURJPYMT4,1366,7d 21h 59m,Buy
103651.35,1.20124,05.09.2012 10:30:00,,0.0,-664.359999999986,0.0,0.0,1.20092,05.09.2012 01:45:00,8273,-0.3418972145895896,11.34,IS,0.34,0.0,Phase3-EA-S4v1-EURCHF-M15-221,EURCHFMT4,2128,8h 45m,Buy
103600.69,98737,05.09.2012 15:14:58,sl 98.737,-0.76,-715.0199999999895,0.0,0.0,98507,04.09.2012 23:15:00,8274,-0.367968189499443,-50.66,IS,0.17,0.0,Phase3-EA-T1v2-EURJPY-M15-322,EURJPYMT4,1336,15h 59m,Sell
103593.39,1.20428,06.09.2012 04:50:00,,-6.44,-722.3199999999779,0.0,0.0,1.20426,05.09.2012 20:30:00,8275,-0.3717249624335451,-7.3,IS,0.41,0.0,Phase3-EA-SA2v2-EURCHF-M5-43,EURCHFMT4,4368,8h 20m,Sell
103654.13,0.95483,06.09.2012 04:59:58,tp 0.95483,0.0,-661.5799999999872,0.0,0.0,0.95583,06.09.2012 01:45:00,8276,-0.34046655311605317,60.74,IS,0.58,0.0,Phase3-EA-SA2v2-USDCHF-M15-107,USDCHFMT4,1646,3h 14m,Sell
103795.47,99586,06.09.2012 15:59:57,tp 99.586,-6.17,-520.2399999999907,0.0,0.0,98888,31.08.2012 15:00:00,8277,-0.2677292535945702,141.34,IS,0.09,0.0,Phase3-EA-TR1v1-EURJPY-M30-91,EURJPYMT4,1367,6d 0h 59m,Buy
103804.72,78851,06.09.2012 22:00:00,,0.0,-510.9899999999907,0.0,0.0,78.88,06.09.2012 21:30:00,8278,-0.26296895912326884,9.25,IS,0.27,0.0,Phase3-EA-S1v2-USDJPY-M15-0,USDJPYMT4,2400,30m 0s,Buy
103811.26,78902,07.09.2012 02:00:00,,-0.99,-504.44999999998254,0.0,0.0,78878,06.09.2012 21:30:00,8279,-0.25960330227544726,6.54,IS,0.27,0.0,Phase3-EA-S1v2-USDJPY-M15-0,USDJPYMT4,2401,4h 30m,Sell
103826.34,0.95375,07.09.2012 02:30:00,,-0.73,-489.36999999999534,0.0,0.0,0.95349,06.09.2012 22:15:00,8280,-0.25184273572115934,15.08,IS,0.58,0.0,Phase3-EA-SA2v2-USDCHF-M15-107,USDCHFMT4,1648,4h 15m,Buy
103867.85,1.20539,07.09.2012 08:10:00,,-1.03,-447.85999999998603,0.0,0.0,1.2044,06.09.2012 23:50:00,8281,-0.23048059263967136,41.51,IS,0.41,0.0,Phase3-EA-SA2v2-EURCHF-M5-43,EURCHFMT4,4370,8h 20m,Buy
104069.65,125978,07.09.2012 10:29:58,tp 125.978,-9.05,-246.05999999999767,0.0,0.0,124128,16.08.2012 07:00:00,8282,-0.12662897920090824,201.8,IS,0.09,0.0,Phase3-EA-B1v1-GBPJPY-M30-1,GBPJPYMT4,800,22d 3h 29m,Buy
103993.17,125236,07.09.2012 15:59:57,sl 125.236,0.0,-322.54000000000815,0.0,0.0,125906,07.09.2012 10:30:00,8283,-0.1659876085160626,-76.48,IS,0.09,0.0,Phase3-EA-B1v1-GBPJPY-M30-1,GBPJPYMT4,802,5h 29m,Buy
104032.12,99902,07.09.2012 18:45:00,,0.0,-283.5899999999965,0.0,0.0,99723,07.09.2012 06:45:00,8284,-0.1459429090936579,38.95,IS,0.17,0.0,Phase3-EA-T1v2-EURJPY-M15-322,EURJPYMT4,1338,12h 0m,Buy
104079.82,1.20936,07.09.2012 20:44:59,tp 1.20936,0.0,-235.88999999998487,0.0,0.0,1.21046,07.09.2012 20:15:00,8285,-0.12139522841461681,47.7,IS,0.41,0.0,Phase3-EA-SA2v2-EURCHF-M5-43,EURCHFMT4,4372,29m 59s,Sell
104077.78,78237,10.09.2012 01:15:00,,-1.0,-237.92999999999302,0.0,0.0,78.24,07.09.2012 21:30:00,8286,-0.12244506633045395,-2.04,IS,0.27,0.0,Phase3-EA-S1v2-USDJPY-M15-0,USDJPYMT4,2404,2d 3h 45m,Buy
104125.48,1.21027,10.09.2012 02:19:57,tp 1.21027,0.0,-190.22999999998137,0.0,0.0,1.20917,10.09.2012 01:20:00,8287,-0.09789738565141284,47.7,IS,0.41,0.0,Phase3-EA-SA2v2-EURCHF-M5-43,EURCHFMT4,4374,59m 57s,Buy
104138.09,78197,10.09.2012 03:15:00,,-1.55,-177.61999999999534,0.0,0.0,78238,07.09.2012 21:30:00,8288,-0.09140794637757028,12.61,IS,0.27,0.0,Phase3-EA-S1v2-USDJPY-M15-0,USDJPYMT4,2405,2d 5h 45m,Sell
104199.48,0.94472,10.09.2012 05:44:57,tp 0.94472,0.0,-116.22999999998137,0.0,0.0,0.94572,10.09.2012 02:30:00,8289,-0.05981502988100197,61.39,IS,0.58,0.0,Phase3-EA-SA2v2-USDCHF-M15-107,USDCHFMT4,1650,3h 14m,Sell
104182.55,100052,10.09.2012 05:45:00,,-1.06,-133.1599999999744,0.0,0.0,100125,07.09.2012 21:45:00,8290,-0.06852765532955318,-16.93,IS,0.17,0.0,Phase3-EA-T1v2-EURJPY-M15-322,EURJPYMT4,1340,2d 8h 0m,Buy
104186.5,1.20862,10.09.2012 15:15:00,,0.0,-129.20999999996275,0.0,0.0,1.20851,10.09.2012 06:30:00,8291,-0.06649488093369418,3.95,IS,0.34,0.0,Phase3-EA-S4v1-EURCHF-M15-221,EURCHFMT4,2130,8h 45m,Buy
104136.53,99951,10.09.2012 21:44:58,sl 99.951,0.0,-179.1799999999639,0.0,0.0,100181,10.09.2012 10:30:00,8292,-0.09221076360730872,-49.97,IS,0.17,0.0,Phase3-EA-T1v2-EURJPY-M15-322,EURJPYMT4,1342,11h 14m,Buy
104184.22,1.20747,10.09.2012 22:29:58,tp 1.20747,0.0,-131.48999999996158,0.0,0.0,1.20857,10.09.2012 22:00:00,8293,-0.06766822919256571,47.69,IS,0.41,0.0,Phase3-EA-SA2v2-EURCHF-M5-43,EURCHFMT4,4376,29m 58s,Sell
104229.42,0.94572,11.09.2012 02:15:00,,-3.25,-86.28999999994994,0.0,0.0,0.94651,10.09.2012 22:00:00,8294,-0.04440711458684929,45.2,IS,0.58,0.0,Phase3-EA-SA2v2-USDCHF-M15-107,USDCHFMT4,1652,4h 15m,Sell
104252.23,1.20804,11.09.2012 07:00:00,,-1.04,-63.47999999995227,0.0,0.0,1.20749,10.09.2012 22:40:00,8295,-0.032668485733836,22.81,IS,0.41,0.0,Phase3-EA-SA2v2-EURCHF-M5-43,EURCHFMT4,4378,8h 20m,Buy
104313.46,1.20878,11.09.2012 10:15:00,,0.0,-2.2499999999417923,0.0,0.0,1.20708,11.09.2012 01:30:00,8296,-0.0011579094659622672,61.23,IS,0.34,0.0,Phase3-EA-S4v1-EURCHF-M15-221,EURCHFMT4,2132,8h 45m,Buy
104574.87,1.6069,11.09.2012 17:59:58,tp 1.60690,-3.19,-0.0,0.0,0.0,1588,05.09.2012 13:00:00,8297,-0.0,261.41,IS,0.14,0.0,Phase3-EA-B1v1-GBPUSD-M30-14,GBPUSDMT4,548,6d 4h 59m,Buy
104524.62,100053,11.09.2012 18:29:58,sl 100.053,0.0,-50.25,0.0,0.0,99823,11.09.2012 13:15:00,8298,-0.025825534407397974,-50.25,IS,0.17,0.0,Phase3-EA-T1v2-EURJPY-M15-322,EURJPYMT4,1344,5h 14m,Sell
104539.73,1.20748,12.09.2012 07:05:00,,-1.05,-35.14000000001397,0.0,0.0,1.20711,11.09.2012 22:45:00,8299,-0.01805988615077265,15.11,IS,0.41,0.0,Phase3-EA-SA2v2-EURCHF-M5-43,EURCHFMT4,4380,8h 20m,Buy
104523.49,125159,12.09.2012 09:20:00,,0.0,-51.38000000000466,0.0,0.0,125104,12.09.2012 03:55:00,8300,-0.0264062877184523,-16.24,IS,0.23,0.0,Phase3-EA-S4v1-GBPJPY-M5-194,GBPJPYMT4,1968,5h 25m,Sell
104473.27,99839,12.09.2012 11:14:58,sl 99.839,0.0,-101.60000000000582,0.0,0.0,100069,12.09.2012 03:45:00,8301,-0.05221640389635392,-50.22,IS,0.17,0.0,Phase3-EA-T1v2-EURJPY-M15-322,EURJPYMT4,1346,7h 29m,Buy
104538.74,1.20841,12.09.2012 13:30:00,,0.0,-36.13000000000466,0.0,0.0,1.20661,12.09.2012 04:45:00,8302,-0.018568687724167345,65.47,IS,0.34,0.0,Phase3-EA-S4v1-EURCHF-M15-221,EURCHFMT4,2134,8h 45m,Buy
104504.39,125139,13.09.2012 08:40:00,,0.0,-70.48000000001048,0.0,0.0,125255,13.09.2012 03:15:00,8303,-0.036222560498182683,-34.35,IS,0.23,0.0,Phase3-EA-S4v1-GBPJPY-M5-194,GBPJPYMT4,1970,5h 25m,Buy
104446.15,1.21021,13.09.2012 08:55:00,,0.0,-128.72000000000116,0.0,0.0,1.20888,13.09.2012 00:35:00,8304,-0.06615448336159796,-58.24,IS,0.41,0.0,Phase3-EA-SA2v2-EURCHF-M5-43,EURCHFMT4,4382,8h 20m,Sell
104395.82,100232,13.09.2012 10:59:58,sl 100.232,0.0,-179.04999999998836,0.0,0.0,100462,13.09.2012 02:00:00,8305,-0.09202113304764789,-50.33,IS,0.17,0.0,Phase3-EA-T1v2-EURJPY-M15-322,EURJPYMT4,1348,8h 59m,Buy
104342.55,1.21085,13.09.2012 13:30:00,,0.0,-232.31999999997788,0.0,0.0,1.20938,13.09.2012 04:45:00,8306,-0.11939876922440053,-53.27,IS,0.34,0.0,Phase3-EA-S4v1-EURCHF-M15-221,EURCHFMT4,2136,8h 45m,Sell
104390.72,1.21316,13.09.2012 20:39:58,tp 1.21316,0.0,-184.14999999996508,0.0,0.0,1.21426,13.09.2012 20:35:00,8307,-0.09464223206211811,48.17,IS,0.41,0.0,Phase3-EA-SA2v2-EURCHF-M5-43,EURCHFMT4,4384,4m 58s,Sell
104438.94,1.2142,13.09.2012 21:59:59,tp 1.21420,0.0,-135.9299999999639,0.0,0.0,1.2153,13.09.2012 21:20:00,8308,-0.06985999785068009,48.22,IS,0.41,0.0,Phase3-EA-SA2v2-EURCHF-M5-43,EURCHFMT4,4386,39m 59s,Sell
104429.52,0.93498,14.09.2012 02:30:00,,-0.74,-145.34999999997672,0.0,0.0,0.93512,13.09.2012 22:15:00,8309,-0.07470132191273024,-9.42,IS,0.58,0.0,Phase3-EA-SA2v2-USDCHF-M15-107,USDCHFMT4,1654,4h 15m,Buy
104280.24,125794,14.09.2012 07:30:00,,0.0,-294.62999999997555,0.0,0.0,125.29,14.09.2012 02:05:00,8310,-0.15142243188957283,-149.28,IS,0.23,0.0,Phase3-EA-S4v1-GBPJPY-M5-194,GBPJPYMT4,1972,5h 25m,Sell
104227.5,77564,14.09.2012 09:00:00,,-1.57,-347.36999999996624,0.0,0.0,77417,13.09.2012 21:30:00,8311,-0.17852767934521319,-52.74,IS,0.27,0.0,Phase3-EA-S1v2-USDJPY-M15-0,USDJPYMT4,2408,11h 30m,Sell
104369.77,101.26,14.09.2012 09:59:57,tp 101.260,-3.96,-205.09999999997672,0.0,0.0,100.0,07.09.2012 11:00:00,8312,-0.10540929566083032,142.27,IS,0.09,0.0,Phase3-EA-TR1v1-EURJPY-M30-91,EURJPYMT4,1370,6d 22h 59m,Buy
104298.45,1.21715,14.09.2012 13:45:00,,0.0,-276.4199999999837,0.0,0.0,1.2152,14.09.2012 05:00:00,8313,-0.14206356658492592,-71.32,IS,0.34,0.0,Phase3-EA-S4v1-EURCHF-M15-221,EURCHFMT4,2138,8h 45m,Sell
104443.52,102504,14.09.2012 16:59:57,tp 102.504,0.0,-131.34999999997672,0.0,0.0,101244,14.09.2012 10:00:00,8314,-0.06750614814748503,145.07,IS,0.09,0.0,Phase3-EA-TR1v1-EURJPY-M30-91,EURJPYMT4,1372,6h 59m,Buy
104492.15,1.21675,14.09.2012 23:19:57,tp 1.21675,0.0,-82.71999999997206,0.0,0.0,1.21565,14.09.2012 20:40:00,8315,-0.04251319813292018,48.63,IS,0.41,0.0,Phase3-EA-SA2v2-EURCHF-M5-43,EURCHFMT4,4388,2h 39m,Buy
104538.63,1.21579,17.09.2012 01:00:00,tp 1.21579,-2.21,-36.23999999996158,0.0,0.0,1.21689,14.09.2012 23:20:00,8316,-0.018625221232300707,46.48,IS,0.41,0.0,Phase3-EA-SA2v2-EURCHF-M5-43,EURCHFMT4,4390,2d 1h 40m,Sell
104504.16,0.92554,17.09.2012 07:00:00,,0.0,-70.70999999996275,0.0,0.0,0.92609,17.09.2012 02:45:00,8317,-0.036340766924301465,-34.47,IS,0.58,0.0,Phase3-EA-SA2v2-USDCHF-M15-107,USDCHFMT4,1656,4h 15m,Buy
104552.89,1216,17.09.2012 08:19:58,tp 1.21600,0.0,-21.97999999995227,0.0,0.0,1.2149,17.09.2012 02:15:00,8318,-0.011296422811410444,48.73,IS,0.41,0.0,Phase3-EA-SA2v2-EURCHF-M5-43,EURCHFMT4,4392,6h 4m,Buy
104627.53,1.2168,17.09.2012 11:45:00,,0.0,-0.0,0.0,0.0,1.21476,17.09.2012 03:00:00,8319,-0.0,74.64,IS,0.34,0.0,Phase3-EA-S4v1-EURCHF-M15-221,EURCHFMT4,2140,8h 45m,Buy
104577.67,102.63,17.09.2012 15:14:58,sl 102.630,0.0,-49.85999999998603,0.0,0.0,102.86,17.09.2012 13:15:00,8320,-0.025618164090139714,-49.86,IS,0.17,0.0,Phase3-EA-T1v2-EURJPY-M15-322,EURJPYMT4,1350,1h 59m,Buy
104839.61,1.62571,17.09.2012 16:59:58,tp 1.62571,-2.66,-0.0,0.0,0.0,1.60681,12.09.2012 05:00:00,8321,-0.0,261.94,IS,0.14,0.0,Phase3-EA-B1v1-GBPUSD-M30-14,GBPUSDMT4,550,5d 11h 59m,Buy
104749.61,1.21383,18.09.2012 06:50:00,,-1.06,-90.0,0.0,0.0,1.21584,17.09.2012 22:30:00,8322,-0.046191839534065866,-90.0,IS,0.41,0.0,Phase3-EA-SA2v2-EURCHF-M5-43,EURCHFMT4,4394,8h 20m,Buy
104718.76,78.68,18.09.2012 08:45:00,,-0.99,-120.85000000000582,0.0,0.0,78767,17.09.2012 21:30:00,8323,-0.06202537564102365,-30.85,IS,0.27,0.0,Phase3-EA-S1v2-USDJPY-M15-0,USDJPYMT4,2410,11h 15m,Buy
104743.02,127771,18.09.2012 08:50:00,,0.0,-96.58999999999651,0.0,0.0,127688,18.09.2012 03:25:00,8324,-0.04957410867328067,24.26,IS,0.23,0.0,Phase3-EA-S4v1-GBPJPY-M5-194,GBPJPYMT4,1974,5h 25m,Buy
104600.03,1.21134,18.09.2012 10:59:59,sl 1.21134,0.0,-239.5799999999872,0.0,0.0,1.21524,18.09.2012 03:45:00,8325,-0.12296267683967677,-142.99,IS,0.34,0.0,Phase3-EA-S4v1-EURCHF-M15-221,EURCHFMT4,2142,7h 14m,Buy
104569.82,1.21076,19.09.2012 05:55:00,,-1.06,-269.78999999997905,0.0,0.0,1.21142,18.09.2012 21:35:00,8326,-0.13846773764327402,-30.21,IS,0.41,0.0,Phase3-EA-SA2v2-EURCHF-M5-43,EURCHFMT4,4396,8h 20m,Buy
104520.13,102815,19.09.2012 06:44:57,sl 102.815,0.0,-319.4799999999814,0.0,0.0,102585,19.09.2012 04:00:00,8327,-0.1639707654926945,-49.69,IS,0.17,0.0,Phase3-EA-T1v2-EURJPY-M15-322,EURJPYMT4,1352,2h 44m,Sell
104729.87,128608,19.09.2012 07:29:57,tp 128.608,-1.23,-109.73999999999069,0.0,0.0,126758,14.09.2012 16:30:00,8328,-0.0563232496718662,209.74,IS,0.09,0.0,Phase3-EA-B1v1-GBPJPY-M30-1,GBPJPYMT4,804,4d 14h 59m,Buy
104753.34,1.2115,19.09.2012 10:45:00,,0.0,-86.26999999998952,0.0,0.0,1.21086,19.09.2012 02:00:00,8329,-0.044277444406704204,23.47,IS,0.34,0.0,Phase3-EA-S4v1-EURCHF-M15-221,EURCHFMT4,2144,8h 45m,Buy
104669.16,102117,19.09.2012 16:59:57,sl 102.117,-1.68,-170.44999999998254,0.0,0.0,102837,14.09.2012 17:00:00,8330,-0.0874822116508969,-84.18,IS,0.09,0.0,Phase3-EA-TR1v1-EURJPY-M30-91,EURJPYMT4,1374,4d 23h 59m,Buy
104717.77,1.2106,19.09.2012 21:14:58,tp 1.21060,0.0,-121.83999999999651,0.0,0.0,1.2117,19.09.2012 20:35:00,8331,-0.0625334858758936,48.61,IS,0.41,0.0,Phase3-EA-SA2v2-EURCHF-M5-43,EURCHFMT4,4398,39m 58s,Sell
104723.12,78312,20.09.2012 06:00:00,,-4.65,-116.48999999999069,0.0,0.0,78341,19.09.2012 23:30:00,8332,-0.05978763763692114,5.35,IS,0.27,0.0,Phase3-EA-S1v2-USDJPY-M15-0,USDJPYMT4,2412,6h 30m,Sell
104672.75,1.20946,20.09.2012 07:30:00,,-3.18,-166.85999999998603,0.0,0.0,1.21053,19.09.2012 23:10:00,8333,-0.08563967049615094,-50.37,IS,0.41,0.0,Phase3-EA-SA2v2-EURCHF-M5-43,EURCHFMT4,4400,8h 20m,Buy
104610.28,1.20857,20.09.2012 09:45:00,,0.0,-229.3299999999872,0.0,0.0,1.21028,20.09.2012 01:00:00,8334,-0.11770193955940815,-62.47,IS,0.34,0.0,Phase3-EA-S4v1-EURCHF-M15-221,EURCHFMT4,2146,8h 45m,Buy
104754.18,100932,20.09.2012 16:59:57,tp 100.932,-1.21,-85.42999999999302,0.0,0.0,102192,19.09.2012 17:00:00,8335,-0.04384632057105471,143.9,IS,0.09,0.0,Phase3-EA-TR1v1-EURJPY-M30-91,EURJPYMT4,1376,23h 59m,Sell
104740.55,1.20994,21.09.2012 05:10:00,,-2.2,-99.05999999999767,0.0,0.0,1.20968,20.09.2012 20:50:00,8336,-0.05084181804716063,-13.63,IS,0.41,0.0,Phase3-EA-SA2v2-EURCHF-M5-43,EURCHFMT4,4402,8h 20m,Sell
104766.05,0.9326,21.09.2012 07:00:00,,0.0,-73.55999999999767,0.0,0.0,0.93219,21.09.2012 02:45:00,8337,-0.0377541301791753,25.5,IS,0.58,0.0,Phase3-EA-SA2v2-USDCHF-M15-107,USDCHFMT4,1658,4h 15m,Buy
104721.3,1.62643,21.09.2012 08:59:57,sl 1.62643,-2.75,-118.30999999999767,0.0,0.0,1.62343,19.09.2012 12:00:00,8338,-0.06072173928083584,-44.75,IS,0.14,0.0,Phase3-EA-B1v1-GBPUSD-M30-14,GBPUSDMT4,552,1d 20h 59m,Sell
104786.02,1.21123,21.09.2012 11:45:00,,0.0,-53.58999999999651,0.0,0.0,1.20946,21.09.2012 03:00:00,8339,-0.027504674229226984,64.72,IS,0.34,0.0,Phase3-EA-S4v1-EURCHF-M15-221,EURCHFMT4,2148,8h 45m,Buy
104832.16,1.21066,24.09.2012 01:04:57,tp 1.21066,-2.2,-7.449999999982538,0.0,0.0,1.21176,21.09.2012 21:20:00,8340,-0.003823657828088712,46.14,IS,0.41,0.0,Phase3-EA-SA2v2-EURCHF-M5-43,EURCHFMT4,4404,2d 3h 44m,Sell
104708.78,126414,24.09.2012 05:00:00,,-1.06,-130.8299999999872,0.0,0.0,126829,21.09.2012 23:35:00,8341,-0.06714753740268051,-123.38,IS,0.23,0.0,Phase3-EA-S4v1-GBPJPY-M5-194,GBPJPYMT4,1976,2d 5h 25m,Buy
104756.98,1.21122,24.09.2012 09:39:58,tp 1.21122,0.0,-82.62999999997555,0.0,0.0,1.21012,24.09.2012 02:30:00,8342,-0.04240924111887481,48.2,IS,0.41,0.0,Phase3-EA-SA2v2-EURCHF-M5-43,EURCHFMT4,4406,7h 9m,Buy
105125.88,100.57,24.09.2012 17:14:58,tp 100.570,-1.52,-0.0,0.0,0.0,102.27,20.09.2012 04:30:00,8343,-0.0,368.9,IS,0.17,0.0,Phase3-EA-T1v2-EURJPY-M15-322,EURJPYMT4,1354,4d 12h 44m,Sell
105034.78,100549,24.09.2012 17:29:58,sl 100.549,-1.12,-91.10000000000582,0.0,0.0,101329,20.09.2012 18:00:00,8344,-0.04668780994094969,-91.1,IS,0.09,0.0,Phase3-EA-TR1v1-EURJPY-M30-91,EURJPYMT4,1378,3d 23h 29m,Buy
104991.25,0.93525,25.09.2012 02:30:00,,-0.74,-134.63000000000466,0.0,0.0,0.93594,24.09.2012 22:15:00,8345,-0.0689964857557615,-43.53,IS,0.58,0.0,Phase3-EA-SA2v2-USDCHF-M15-107,USDCHFMT4,1660,4h 15m,Buy
105003.09,1.20973,25.09.2012 04:35:00,,-2.19,-122.79000000000815,0.0,0.0,1.21005,24.09.2012 20:15:00,8346,-0.06292860793248328,11.84,IS,0.41,0.0,Phase3-EA-SA2v2-EURCHF-M5-43,EURCHFMT4,4408,8h 20m,Sell
105048.05,126197,25.09.2012 08:40:00,,0.0,-77.8300000000163,0.0,0.0,126349,25.09.2012 03:15:00,8347,-0.03988707187381606,44.96,IS,0.23,0.0,Phase3-EA-S4v1-GBPJPY-M5-194,GBPJPYMT4,1978,5h 25m,Sell
105048.41,1.20952,25.09.2012 11:30:00,,0.0,-77.47000000003027,0.0,0.0,1.20951,25.09.2012 02:45:00,8348,-0.03970257558865592,0.36,IS,0.34,0.0,Phase3-EA-S4v1-EURCHF-M15-221,EURCHFMT4,2150,8h 45m,Buy
104998.23,100837,25.09.2012 17:14:58,sl 100.837,0.0,-127.65000000002328,0.0,0.0,100607,25.09.2012 07:45:00,8349,-0.06541930778224955,-50.18,IS,0.17,0.0,Phase3-EA-T1v2-EURJPY-M15-322,EURJPYMT4,1356,9h 29m,Sell
105037.67,0.9369,26.09.2012 04:00:00,,-3.28,-88.21000000002095,0.0,0.0,0.93759,25.09.2012 23:45:00,8350,-0.04520671476280886,39.44,IS,0.58,0.0,Phase3-EA-SA2v2-USDCHF-M15-107,USDCHFMT4,1662,4h 15m,Sell
105033.12,1.20962,26.09.2012 06:35:00,,-1.05,-92.76000000000931,0.0,0.0,1.2097,25.09.2012 22:15:00,8351,-0.04753854281144513,-4.55,IS,0.41,0.0,Phase3-EA-SA2v2-EURCHF-M5-43,EURCHFMT4,4410,8h 20m,Buy
104941.63,99874,26.09.2012 11:29:57,sl 99.874,-1.14,-184.25,0.0,0.0,100654,24.09.2012 22:30:00,8352,-0.09442622372798497,-91.49,IS,0.09,0.0,Phase3-EA-TR1v1-EURJPY-M30-91,EURJPYMT4,1380,1d 12h 59m,Buy
104889.03,100094,27.09.2012 01:14:57,sl 100.094,-2.3,-236.85000000000582,0.0,0.0,99864,26.09.2012 17:30:00,8353,-0.12138318094965422,-52.6,IS,0.17,0.0,Phase3-EA-T1v2-EURJPY-M15-322,EURJPYMT4,1358,7h 44m,Sell
104908.23,0.93923,27.09.2012 02:15:00,,-9.82,-217.64999999999418,0.0,0.0,0.9397,26.09.2012 22:00:00,8354,-0.11154337907405905,19.2,IS,0.58,0.0,Phase3-EA-SA2v2-USDCHF-M15-107,USDCHFMT4,1664,4h 15m,Sell
104900.37,1.20896,27.09.2012 04:35:00,,-6.55,-225.5099999999802,0.0,0.0,1.20893,26.09.2012 20:15:00,8355,-0.11557154796687122,-7.86,IS,0.41,0.0,Phase3-EA-SA2v2-EURCHF-M5-43,EURCHFMT4,4412,8h 20m,Sell
104868.27,125716,27.09.2012 04:55:00,,-5.15,-257.60999999998603,0.0,0.0,125625,26.09.2012 23:30:00,8356,-0.1320224667276249,-32.1,IS,0.23,0.0,Phase3-EA-S4v1-GBPJPY-M5-194,GBPJPYMT4,1980,5h 25m,Sell
104881.31,1.20887,27.09.2012 12:00:00,,0.0,-244.56999999997788,0.0,0.0,1.20923,27.09.2012 03:15:00,8357,-0.12533960128711638,13.04,IS,0.34,0.0,Phase3-EA-S4v1-EURCHF-M15-221,EURCHFMT4,2152,8h 45m,Sell
104830.96,99818,27.09.2012 12:29:58,sl 99.818,0.0,-294.9199999999837,0.0,0.0,100048,27.09.2012 05:30:00,8358,-0.15114345672649004,-50.35,IS,0.17,0.0,Phase3-EA-T1v2-EURJPY-M15-322,EURJPYMT4,1360,6h 59m,Buy
104876.92,1.20953,28.09.2012 04:45:00,tp 1.20953,-2.19,-248.95999999999185,0.0,0.0,1.21063,27.09.2012 21:15:00,8359,-0.12758943098680253,45.96,IS,0.41,0.0,Phase3-EA-SA2v2-EURCHF-M5-43,EURCHFMT4,4414,7h 30m,Sell
104885.5,100171,28.09.2012 10:30:00,,-1.07,-240.38000000000466,0.0,0.0,100127,27.09.2012 19:45:00,8360,-0.12319226952365518,8.58,IS,0.17,0.0,Phase3-EA-T1v2-EURJPY-M15-322,EURJPYMT4,1362,14h 45m,Buy
104870.95,1.2095,28.09.2012 13:45:00,,0.0,-254.92999999999302,0.0,0.0,1.2099,28.09.2012 05:00:00,8361,-0.13064899438249417,-14.55,IS,0.34,0.0,Phase3-EA-S4v1-EURCHF-M15-221,EURCHFMT4,2154,8h 45m,Buy
104828.42,1.61579,28.09.2012 16:59:58,sl 1.61579,-0.53,-297.45999999999185,0.0,0.0,1.61879,27.09.2012 04:30:00,8362,-0.1524451805162857,-42.53,IS,0.14,0.0,Phase3-EA-B1v1-GBPUSD-M30-14,GBPUSDMT4,554,1d 12h 29m,Buy
104778.2,100086,28.09.2012 17:29:58,sl 100.086,0.0,-347.679999999993,0.0,0.0,100316,28.09.2012 10:45:00,8363,-0.1781824122971243,-50.22,IS,0.17,0.0,Phase3-EA-T1v2-EURJPY-M15-322,EURJPYMT4,1364,6h 44m,Buy
104728.08,100174,28.09.2012 21:59:58,sl 100.174,0.0,-397.79999999998836,0.0,0.0,100404,28.09.2012 20:45:00,8364,-0.2038683951098579,-50.12,IS,0.17,0.0,Phase3-EA-T1v2-EURJPY-M15-322,EURJPYMT4,1366,1h 14m,Buy
104691.75,125571,01.10.2012 07:50:00,,0.0,-434.12999999997555,0.0,0.0,125694,01.10.2012 02:25:00,8365,-0.22248714522131782,-36.33,IS,0.23,0.0,Phase3-EA-S4v1-GBPJPY-M5-194,GBPJPYMT4,1982,5h 25m,Buy
104676.89,1.20898,01.10.2012 14:15:00,,0.0,-448.9899999999616,0.0,0.0,1.20857,01.10.2012 05:30:00,8366,-0.2301027418812719,-14.86,IS,0.34,0.0,Phase3-EA-S4v1-EURCHF-M15-221,EURCHFMT4,2156,8h 45m,Sell
104660.63,0.93828,02.10.2012 03:00:00,,-3.28,-465.2499999999709,0.0,0.0,0.93807,01.10.2012 22:45:00,8367,-0.23843582409466627,-16.26,IS,0.58,0.0,Phase3-EA-SA2v2-USDCHF-M15-107,USDCHFMT4,1666,4h 15m,Sell
104701.55,1.20998,02.10.2012 05:35:00,,-1.05,-424.3299999999581,0.0,0.0,1.20902,01.10.2012 21:15:00,8368,-0.2174647463473102,40.92,IS,0.41,0.0,Phase3-EA-SA2v2-EURCHF-M5-43,EURCHFMT4,4416,8h 20m,Buy
104697.56,1.20996,02.10.2012 14:45:00,,0.0,-428.3199999999488,0.0,0.0,1.20985,02.10.2012 06:00:00,8369,-0.2195095801745763,-3.99,IS,0.34,0.0,Phase3-EA-S4v1-EURCHF-M15-221,EURCHFMT4,2158,8h 45m,Sell
104724.09,100982,02.10.2012 23:45:00,,0.0,-401.78999999994994,0.0,0.0,100.86,02.10.2012 12:00:00,8370,-0.20591322893710912,26.53,IS,0.17,0.0,Phase3-EA-T1v2-EURJPY-M15-322,EURJPYMT4,1368,11h 45m,Buy
104657.05,0.93702,03.10.2012 02:30:00,,-3.28,-468.8299999999581,0.0,0.0,0.93599,02.10.2012 22:15:00,8371,-0.24027053715271227,-67.04,IS,0.58,0.0,Phase3-EA-SA2v2-USDCHF-M15-107,USDCHFMT4,1668,4h 15m,Sell
104674.81,1.20976,03.10.2012 05:30:00,,-1.05,-451.0699999999488,0.0,0.0,1.20933,02.10.2012 21:10:00,8372,-0.2311687204177875,17.76,IS,0.41,0.0,Phase3-EA-SA2v2-EURCHF-M5-43,EURCHFMT4,4418,8h 20m,Buy
104636.3,100849,03.10.2012 05:45:00,,0.0,-489.5799999999581,0.0,0.0,101026,03.10.2012 02:00:00,8373,-0.2509046980338829,-38.51,IS,0.17,0.0,Phase3-EA-T1v2-EURJPY-M15-322,EURJPYMT4,1370,3h 45m,Buy
104656.01,126071,03.10.2012 07:25:00,,0.0,-469.86999999996624,0.0,0.0,126138,03.10.2012 02:00:00,8374,-0.24080352642097752,19.71,IS,0.23,0.0,Phase3-EA-S4v1-GBPJPY-M5-194,GBPJPYMT4,1984,5h 25m,Sell
104637.13,1.21022,03.10.2012 13:15:00,,0.0,-488.7499999999709,0.0,0.0,1.2097,03.10.2012 04:30:00,8375,-0.25047933159864266,-18.88,IS,0.34,0.0,Phase3-EA-S4v1-EURCHF-M15-221,EURCHFMT4,2160,8h 45m,Sell
104781.0,101341,03.10.2012 17:29:58,tp 101.341,-3.97,-344.87999999997555,0.0,0.0,100051,26.09.2012 15:30:00,8376,-0.1767474411902586,143.87,IS,0.09,0.0,Phase3-EA-TR1v1-EURJPY-M30-91,EURJPYMT4,1382,7d 1h 59m,Buy
104833.01,0.93785,04.10.2012 01:59:58,tp 0.93785,-9.83,-292.86999999996624,0.0,0.0,0.93885,03.10.2012 22:15:00,8377,-0.15009285288038954,52.01,IS,0.58,0.0,Phase3-EA-SA2v2-USDCHF-M15-107,USDCHFMT4,1670,3h 44m,Sell
104815.97,1.2113,04.10.2012 04:50:00,,-6.55,-309.9099999999744,0.0,0.0,1.21106,03.10.2012 20:30:00,8378,-0.15882567704497913,-17.04,IS,0.41,0.0,Phase3-EA-SA2v2-EURCHF-M5-43,EURCHFMT4,4420,8h 20m,Sell
104834.29,78572,04.10.2012 05:30:00,,-2.99,-291.5899999999674,0.0,0.0,78.51,03.10.2012 22:15:00,8379,-0.14943686608868417,18.32,IS,0.27,0.0,Phase3-EA-S1v2-USDJPY-M15-0,USDJPYMT4,2414,7h 15m,Buy
104818.82,0.93738,04.10.2012 06:30:00,,0.0,-307.05999999996857,0.0,0.0,0.93763,04.10.2012 02:15:00,8380,-0.15736508145406836,-15.47,IS,0.58,0.0,Phase3-EA-SA2v2-USDCHF-M15-107,USDCHFMT4,1672,4h 15m,Buy
104764.74,1.21298,04.10.2012 11:00:00,,0.0,-361.13999999995576,0.0,0.0,1.21149,04.10.2012 02:15:00,8381,-0.18508052340363806,-54.08,IS,0.34,0.0,Phase3-EA-S4v1-EURCHF-M15-221,EURCHFMT4,2162,8h 45m,Sell
104906.22,101848,04.10.2012 14:59:58,tp 101.848,-2.82,-219.65999999994528,0.0,0.0,100588,01.10.2012 13:00:00,8382,-0.11257348333288474,141.48,IS,0.09,0.0,Phase3-EA-TR1v1-EURJPY-M30-91,EURJPYMT4,1383,3d 1h 59m,Buy
105069.6,101887,05.10.2012 06:45:00,,-4.24,-56.27999999994063,0.0,0.0,101115,03.10.2012 11:15:00,8383,-0.028842919247790436,163.38,IS,0.17,0.0,Phase3-EA-T1v2-EURJPY-M15-322,EURJPYMT4,1372,1d 19h 30m,Buy
105088.09,1.21163,05.10.2012 09:15:00,,0.0,-37.78999999994994,0.0,0.0,1.21121,05.10.2012 00:55:00,8384,-0.019366985045730395,18.49,IS,0.41,0.0,Phase3-EA-SA2v2-EURCHF-M5-43,EURCHFMT4,4422,8h 20m,Buy
105001.22,127636,05.10.2012 15:59:57,sl 127.636,-10.04,-124.65999999994528,0.0,0.0,126966,20.09.2012 06:00:00,8385,-0.06388696363595897,-86.87,IS,0.09,0.0,Phase3-EA-B1v1-GBPJPY-M30-1,GBPJPYMT4,806,15d 9h 59m,Sell
104988.89,78658,08.10.2012 01:00:00,,-1.0,-136.98999999993248,0.0,0.0,78691,05.10.2012 20:30:00,8386,-0.07020596140293235,-12.33,IS,0.27,0.0,Phase3-EA-S1v2-USDJPY-M15-0,USDJPYMT4,2416,2d 4h 30m,Buy
105051.21,0.93073,08.10.2012 01:44:57,tp 0.93073,0.0,-74.6699999999255,0.0,0.0,0.92973,08.10.2012 01:15:00,8387,-0.03826760448174547,62.32,IS,0.58,0.0,Phase3-EA-SA2v2-USDCHF-M15-107,USDCHFMT4,1674,29m 57s,Buy
105054.55,1.21144,08.10.2012 04:25:00,,-1.06,-71.32999999992899,0.0,0.0,1.21134,05.10.2012 20:05:00,8388,-0.03655588894713955,3.34,IS,0.41,0.0,Phase3-EA-SA2v2-EURCHF-M5-43,EURCHFMT4,4424,2d 8h 20m,Buy
104962.45,0.93201,08.10.2012 06:00:00,,0.0,-163.4299999999348,0.0,0.0,0.93053,08.10.2012 01:45:00,8389,-0.08375618856910952,-92.1,IS,0.58,0.0,Phase3-EA-SA2v2-USDCHF-M15-107,USDCHFMT4,1676,4h 15m,Sell
104997.0,1.21062,08.10.2012 14:00:00,,0.0,-128.87999999994645,0.0,0.0,1.21157,08.10.2012 05:15:00,8390,-0.0660496700898651,34.55,IS,0.34,0.0,Phase3-EA-S4v1-EURCHF-M15-221,EURCHFMT4,2164,8h 45m,Sell
105026.03,78132,08.10.2012 18:15:00,,0.0,-99.84999999994761,0.0,0.0,78216,08.10.2012 17:00:00,8391,-0.05117209464984723,29.03,IS,0.27,0.0,Phase3-EA-S1v2-USDJPY-M15-0,USDJPYMT4,2418,1h 15m,Sell
105073.32,1.21119,09.10.2012 03:34:58,tp 1.21119,-1.05,-52.559999999939464,0.0,0.0,1.21009,08.10.2012 20:35:00,8392,-0.02693645763439443,47.29,IS,0.41,0.0,Phase3-EA-SA2v2-EURCHF-M5-43,EURCHFMT4,4426,6h 59m,Buy
105051.01,125.72,09.10.2012 08:45:00,,0.0,-74.86999999993714,0.0,0.0,125644,09.10.2012 03:20:00,8393,-0.038370102417955486,-22.31,IS,0.23,0.0,Phase3-EA-S4v1-GBPJPY-M5-194,GBPJPYMT4,1986,5h 25m,Sell
105149.93,1.21086,09.10.2012 15:00:00,,0.0,-0.0,0.0,0.0,1.21358,09.10.2012 06:15:00,8394,-0.0,98.92,IS,0.34,0.0,Phase3-EA-S4v1-EURCHF-M15-221,EURCHFMT4,2166,8h 45m,Sell
105297.43,100831,09.10.2012 17:59:57,tp 100.831,-0.8,-0.0,0.0,0.0,102121,05.10.2012 05:30:00,8395,-0.0,147.5,IS,0.09,0.0,Phase3-EA-TR1v1-EURJPY-M30-91,EURJPYMT4,1386,4d 12h 29m,Sell
105509.64,124942,09.10.2012 18:59:57,tp 124.942,-0.67,-0.0,0.0,0.0,126792,08.10.2012 03:30:00,8396,-0.0,212.21,IS,0.09,0.0,Phase3-EA-B1v1-GBPJPY-M30-1,GBPJPYMT4,808,1d 15h 29m,Sell
105654.29,100721,09.10.2012 18:59:58,tp 100.721,-0.4,-0.0,0.0,0.0,101981,08.10.2012 07:30:00,8397,-0.0,144.65,IS,0.09,0.0,Phase3-EA-TR1v1-EURJPY-M30-91,EURJPYMT4,1387,1d 11h 29m,Sell
105715.9,0.94138,10.10.2012 02:29:57,tp 0.94138,0.0,-0.0,0.0,0.0,0.94038,10.10.2012 00:15:00,8398,-0.0,61.61,IS,0.58,0.0,Phase3-EA-SA2v2-USDCHF-M15-107,USDCHFMT4,1678,2h 14m,Buy
105760.57,125044,10.10.2012 05:40:00,,0.0,-0.0,0.0,0.0,125196,10.10.2012 00:15:00,8399,-0.0,44.67,IS,0.23,0.0,Phase3-EA-S4v1-GBPJPY-M5-194,GBPJPYMT4,1988,5h 25m,Sell
105773.6,1.21081,10.10.2012 15:30:00,,0.0,-0.0,0.0,0.0,1.21045,10.10.2012 06:45:00,8400,-0.0,13.03,IS,0.34,0.0,Phase3-EA-S4v1-EURCHF-M15-221,EURCHFMT4,2168,8h 45m,Buy
105679.36,1.20801,11.10.2012 05:20:00,,-3.14,-94.23999999999069,0.0,0.0,1.2101,10.10.2012 21:00:00,8401,-0.04813723607268313,-94.24,IS,0.41,0.0,Phase3-EA-SA2v2-EURCHF-M5-43,EURCHFMT4,4428,8h 20m,Buy
105706.16,1.20833,11.10.2012 10:45:00,,0.0,-67.44000000000233,0.0,0.0,1.20759,11.10.2012 02:00:00,8402,-0.03444795416746799,26.8,IS,0.34,0.0,Phase3-EA-S4v1-EURCHF-M15-221,EURCHFMT4,2170,8h 45m,Buy
105623.29,100932,11.10.2012 13:59:57,sl 100.932,0.0,-150.30999999999767,0.0,0.0,100673,10.10.2012 10:00:00,8403,-0.07677746131245336,-82.87,IS,0.09,0.0,Phase3-EA-TR1v1-EURJPY-M30-91,EURJPYMT4,1390,1d 3h 59m,Buy
105570.35,101542,11.10.2012 15:44:57,sl 101.542,-3.04,-203.25,0.0,0.0,101312,09.10.2012 10:30:00,8404,-0.10381890101627561,-52.94,IS,0.17,0.0,Phase3-EA-T1v2-EURJPY-M15-322,EURJPYMT4,1374,2d 5h 14m,Sell
105561.08,78378,12.10.2012 01:45:00,,-1.0,-212.51999999998952,0.0,0.0,78402,11.10.2012 19:15:00,8405,-0.10855396233199412,-9.27,IS,0.27,0.0,Phase3-EA-S1v2-USDJPY-M15-0,USDJPYMT4,2420,6h 30m,Buy
105588.98,1.20942,12.10.2012 04:30:00,,-1.05,-184.61999999999534,0.0,0.0,1.20876,11.10.2012 20:10:00,8406,-0.0943028069157408,27.9,IS,0.41,0.0,Phase3-EA-SA2v2-EURCHF-M5-43,EURCHFMT4,4430,8h 20m,Buy
105565.33,101328,12.10.2012 09:00:00,,0.0,-208.26999999998952,0.0,0.0,101437,12.10.2012 03:15:00,8407,-0.10638308740299451,-23.65,IS,0.17,0.0,Phase3-EA-T1v2-EURJPY-M15-322,EURJPYMT4,1376,5h 45m,Buy
105606.4,125737,12.10.2012 09:15:00,,0.0,-167.19999999998254,0.0,0.0,125877,12.10.2012 03:50:00,8408,-0.08540477367734056,41.07,IS,0.23,0.0,Phase3-EA-S4v1-GBPJPY-M5-194,GBPJPYMT4,1990,5h 25m,Sell
105616.98,1.20914,12.10.2012 13:45:00,,0.0,-156.61999999999534,0.0,0.0,1.20943,12.10.2012 05:00:00,8409,-0.08000057208939042,10.58,IS,0.34,0.0,Phase3-EA-S4v1-EURCHF-M15-221,EURCHFMT4,2172,8h 45m,Sell
105569.43,101308,12.10.2012 18:45:00,,0.0,-204.1699999999837,0.0,0.0,101527,12.10.2012 09:45:00,8410,-0.10428883158913309,-47.55,IS,0.17,0.0,Phase3-EA-T1v2-EURJPY-M15-322,EURJPYMT4,1378,9h 0m,Buy
105615.46,1.20796,15.10.2012 03:39:57,tp 1.20796,-2.2,-158.13999999998487,0.0,0.0,1.20906,12.10.2012 22:45:00,8411,-0.08077697912281552,46.03,IS,0.41,0.0,Phase3-EA-SA2v2-EURCHF-M5-43,EURCHFMT4,4432,2d 4h 54m,Sell
105760.47,101963,15.10.2012 12:29:58,tp 101.963,-2.81,-13.129999999975553,0.0,0.0,100212,11.10.2012 05:00:00,8412,-0.006706726545343964,145.01,IS,0.09,0.0,Phase3-EA-TR1v1-EURJPY-M30-91,EURJPYMT4,1391,4d 7h 29m,Sell
105800.2,1.20917,15.10.2012 12:45:00,,0.0,-0.0,0.0,0.0,1.20808,15.10.2012 04:00:00,8413,-0.0,39.73,IS,0.34,0.0,Phase3-EA-S4v1-EURCHF-M15-221,EURCHFMT4,2174,8h 45m,Buy
105772.21,126764,16.10.2012 08:15:00,,0.0,-27.989999999990687,0.0,0.0,126668,16.10.2012 02:50:00,8414,-0.014295184581011967,-27.99,IS,0.23,0.0,Phase3-EA-S4v1-GBPJPY-M5-194,GBPJPYMT4,1992,5h 25m,Sell
105750.61,1.20906,16.10.2012 10:30:00,,0.0,-49.58999999999651,0.0,0.0,1.20857,16.10.2012 02:10:00,8415,-0.025326838276976398,-21.6,IS,0.41,0.0,Phase3-EA-SA2v2-EURCHF-M5-43,EURCHFMT4,4434,8h 20m,Sell
105729.76,1.20903,16.10.2012 11:45:00,,0.0,-70.44000000000233,0.0,0.0,1.20846,16.10.2012 03:00:00,8416,-0.03597544844183106,-20.85,IS,0.34,0.0,Phase3-EA-S4v1-EURCHF-M15-221,EURCHFMT4,2176,8h 45m,Sell
105871.92,102707,16.10.2012 14:59:58,tp 102.707,-1.68,-0.0,0.0,0.0,101447,11.10.2012 16:00:00,8417,-0.0,142.16,IS,0.09,0.0,Phase3-EA-TR1v1-EURJPY-M30-91,EURJPYMT4,1393,4d 22h 59m,Buy
105919.73,1.2096,17.10.2012 03:04:58,tp 1.20960,-1.06,-0.0,0.0,0.0,1.2085,16.10.2012 21:40:00,8418,-0.0,47.81,IS,0.41,0.0,Phase3-EA-SA2v2-EURCHF-M5-43,EURCHFMT4,4436,5h 24m,Buy
106136.02,102981,17.10.2012 07:45:00,,-1.06,-0.0,0.0,0.0,101975,16.10.2012 02:15:00,8419,-0.0,216.29,IS,0.17,0.0,Phase3-EA-T1v2-EURJPY-M15-322,EURJPYMT4,1380,1d 5h 30m,Buy
106074.97,1.21086,17.10.2012 10:45:00,,0.0,-61.04999999998836,0.0,0.0,1.2092,17.10.2012 02:00:00,8420,-0.03112635812635953,-61.05,IS,0.34,0.0,Phase3-EA-S4v1-EURCHF-M15-221,EURCHFMT4,2178,8h 45m,Sell
106044.22,1.20967,18.10.2012 04:35:00,,-3.2,-91.79999999998836,0.0,0.0,1.21029,17.10.2012 20:15:00,8421,-0.04680425349713329,-30.75,IS,0.41,0.0,Phase3-EA-SA2v2-EURCHF-M5-43,EURCHFMT4,4438,8h 20m,Buy
106019.24,127668,18.10.2012 06:40:00,,0.0,-116.77999999999884,0.0,0.0,127582,18.10.2012 01:15:00,8422,-0.05954031289102248,-24.98,IS,0.23,0.0,Phase3-EA-S4v1-GBPJPY-M5-194,GBPJPYMT4,1994,5h 25m,Sell
106025.87,1.20999,18.10.2012 09:45:00,,0.0,-110.14999999999418,0.0,0.0,1.20981,18.10.2012 01:00:00,8423,-0.0561600056940045,6.63,IS,0.34,0.0,Phase3-EA-S4v1-EURCHF-M15-221,EURCHFMT4,2180,8h 45m,Buy
105976.46,103534,18.10.2012 10:29:58,sl 103.534,0.0,-159.55999999999767,0.0,0.0,103764,18.10.2012 09:15:00,8424,-0.08135170684099592,-49.41,IS,0.17,0.0,Phase3-EA-T1v2-EURJPY-M15-322,EURJPYMT4,1382,1h 14m,Buy
105927.12,103.75,18.10.2012 17:29:58,sl 103.750,0.0,-208.89999999999418,0.0,0.0,103.98,18.10.2012 12:30:00,8425,-0.10650771847006657,-49.34,IS,0.17,0.0,Phase3-EA-T1v2-EURJPY-M15-322,EURJPYMT4,1384,4h 59m,Buy
105956.76,79344,19.10.2012 02:15:00,,-0.99,-179.2599999999802,0.0,0.0,79254,18.10.2012 17:30:00,8426,-0.09139575688340143,29.64,IS,0.27,0.0,Phase3-EA-S1v2-USDJPY-M15-0,USDJPYMT4,2422,8h 45m,Buy
105942.39,1.20837,19.10.2012 05:40:00,,-1.06,-193.62999999997555,0.0,0.0,1.20867,18.10.2012 21:20:00,8427,-0.09872230506154601,-14.37,IS,0.41,0.0,Phase3-EA-SA2v2-EURCHF-M5-43,EURCHFMT4,4440,8h 20m,Buy
105917.17,127343,19.10.2012 06:50:00,,0.0,-218.84999999997672,0.0,0.0,127256,19.10.2012 01:25:00,8428,-0.11158072851686089,-25.22,IS,0.23,0.0,Phase3-EA-S4v1-GBPJPY-M5-194,GBPJPYMT4,1996,5h 25m,Sell
105890.01,1.20919,19.10.2012 12:45:00,,0.0,-246.0099999999802,0.0,0.0,1.20845,19.10.2012 04:00:00,8429,-0.1254282614687396,-27.16,IS,0.34,0.0,Phase3-EA-S4v1-EURCHF-M15-221,EURCHFMT4,2182,8h 45m,Sell
105952.53,0.92768,22.10.2012 03:14:57,tp 0.92768,0.0,-183.4899999999907,0.0,0.0,0.92868,22.10.2012 02:45:00,8430,-0.09355242346611808,62.52,IS,0.58,0.0,Phase3-EA-SA2v2-USDCHF-M15-107,USDCHFMT4,1680,29m 57s,Sell
105954.3,1.20905,22.10.2012 07:15:00,,-2.21,-181.72000000000116,0.0,0.0,1.20914,19.10.2012 22:55:00,8431,-0.09264998851307402,1.77,IS,0.41,0.0,Phase3-EA-SA2v2-EURCHF-M5-43,EURCHFMT4,4442,2d 8h 20m,Sell
106093.08,104228,22.10.2012 13:29:58,tp 104.228,-3.36,-42.94000000000233,0.0,0.0,102968,16.10.2012 15:00:00,8432,-0.021892969990928837,138.78,IS,0.09,0.0,Phase3-EA-TR1v1-EURJPY-M30-91,EURJPYMT4,1396,5d 22h 29m,Buy
106063.71,1.20991,22.10.2012 14:15:00,,0.0,-72.30999999999767,0.0,0.0,1.20911,22.10.2012 05:30:00,8433,-0.036867272008475255,-29.37,IS,0.34,0.0,Phase3-EA-S4v1-EURCHF-M15-221,EURCHFMT4,2184,8h 45m,Sell
106066.42,79851,22.10.2012 18:45:00,,0.0,-69.60000000000582,0.0,0.0,79843,22.10.2012 18:00:00,8434,-0.03548557781482748,2.71,IS,0.27,0.0,Phase3-EA-S1v2-USDJPY-M15-0,USDJPYMT4,2424,45m 0s,Buy
106037.25,1.21082,23.10.2012 08:15:00,,-2.21,-98.77000000001863,0.0,0.0,1.21021,22.10.2012 23:55:00,8435,-0.05035790978119077,-29.17,IS,0.41,0.0,Phase3-EA-SA2v2-EURCHF-M5-43,EURCHFMT4,4444,8h 20m,Sell
106078.98,127968,23.10.2012 09:20:00,,0.0,-57.04000000000815,0.0,0.0,128113,23.10.2012 03:55:00,8436,-0.029081858599969528,41.73,IS,0.23,0.0,Phase3-EA-S4v1-GBPJPY-M5-194,GBPJPYMT4,1998,5h 25m,Sell
106063.22,1.21067,23.10.2012 09:45:00,,0.0,-72.80000000001746,0.0,0.0,1.21024,23.10.2012 01:00:00,8437,-0.037117098633905804,-15.76,IS,0.34,0.0,Phase3-EA-S4v1-EURCHF-M15-221,EURCHFMT4,2186,8h 45m,Sell
105981.43,103504,23.10.2012 16:59:58,sl 103.504,-0.55,-154.5900000000256,0.0,0.0,104224,22.10.2012 13:30:00,8438,-0.07881775106888836,-81.79,IS,0.09,0.0,Phase3-EA-TR1v1-EURJPY-M30-91,EURJPYMT4,1398,1d 3h 29m,Buy
105980.11,1.21041,24.10.2012 05:20:00,,-2.2,-155.9100000000326,0.0,0.0,1.21043,23.10.2012 21:00:00,8439,-0.07949075340675928,-1.32,IS,0.41,0.0,Phase3-EA-SA2v2-EURCHF-M5-43,EURCHFMT4,4446,8h 20m,Sell
105976.37,127305,24.10.2012 08:45:00,,0.0,-159.65000000002328,0.0,0.0,127318,24.10.2012 03:20:00,8440,-0.0813975933640454,-3.74,IS,0.23,0.0,Phase3-EA-S4v1-GBPJPY-M5-194,GBPJPYMT4,2000,5h 25m,Buy
105994.98,1.21029,24.10.2012 10:30:00,,0.0,-141.04000000003725,0.0,0.0,1.2108,24.10.2012 01:45:00,8441,-0.07190928010063463,18.61,IS,0.34,0.0,Phase3-EA-S4v1-EURCHF-M15-221,EURCHFMT4,2188,8h 45m,Sell
105943.82,103817,25.10.2012 06:14:58,sl 103.817,-2.24,-192.20000000004075,0.0,0.0,103587,24.10.2012 09:30:00,8442,-0.09799321919555627,-51.16,IS,0.17,0.0,Phase3-EA-T1v2-EURJPY-M15-322,EURJPYMT4,1386,20h 44m,Sell
106147.12,128831,25.10.2012 10:59:57,tp 128.831,-4.5,-0.0,0.0,0.0,126981,16.10.2012 12:00:00,8443,-0.0,203.3,IS,0.09,0.0,Phase3-EA-B1v1-GBPJPY-M30-1,GBPJPYMT4,810,8d 22h 59m,Buy
106147.12,1.20975,26.10.2012 05:05:00,,-2.19,-0.0,0.0,0.0,1.2098,25.10.2012 20:45:00,8444,-0.0,0.0,IS,0.41,0.0,Phase3-EA-SA2v2-EURCHF-M5-43,EURCHFMT4,4448,8h 20m,Sell
106071.32,128687,26.10.2012 10:59:57,sl 128.687,-0.4,-75.79999999998836,0.0,0.0,129357,25.10.2012 16:30:00,8445,-0.0386444623810883,-75.8,IS,0.09,0.0,Phase3-EA-B1v1-GBPJPY-M30-1,GBPJPYMT4,812,18h 29m,Buy
105989.69,103125,26.10.2012 14:29:58,sl 103.125,-0.55,-157.42999999999302,0.0,0.0,103634,23.10.2012 23:30:00,8446,-0.08026118354426642,-81.63,IS,0.09,0.0,Phase3-EA-TR1v1-EURJPY-M30-91,EURJPYMT4,1400,2d 14h 59m,Buy
105899.06,102854,26.10.2012 14:59:57,sl 102.854,-2.76,-248.05999999999767,0.0,0.0,103845,25.10.2012 06:30:00,8447,-0.1264662973384452,-90.63,IS,0.09,0.0,Phase3-EA-TR1v1-EURJPY-M30-91,EURJPYMT4,1401,1d 8h 29m,Buy
105920.09,1.20941,26.10.2012 15:15:00,,0.0,-227.02999999999884,0.0,0.0,1.20999,26.10.2012 06:30:00,8448,-0.11574475322400764,21.03,IS,0.34,0.0,Phase3-EA-S4v1-EURCHF-M15-221,EURCHFMT4,2190,8h 45m,Sell
105900.95,79705,29.10.2012 02:00:00,,-1.53,-246.1700000000128,0.0,0.0,79653,26.10.2012 23:00:00,8449,-0.12550273488594277,-19.14,IS,0.27,0.0,Phase3-EA-S1v2-USDJPY-M15-0,USDJPYMT4,2426,2d 3h 0m,Sell
105884.03,128111,29.10.2012 04:50:00,,-1.04,-263.0900000000256,0.0,0.0,128166,26.10.2012 23:25:00,8450,-0.13412891303223048,-16.92,IS,0.23,0.0,Phase3-EA-S4v1-GBPJPY-M5-194,GBPJPYMT4,2002,2d 5h 25m,Buy
105891.48,1.20927,29.10.2012 06:25:00,,-2.19,-255.64000000001397,0.0,0.0,1.20949,26.10.2012 22:05:00,8451,-0.13033074357656294,7.45,IS,0.41,0.0,Phase3-EA-SA2v2-EURCHF-M5-43,EURCHFMT4,4450,2d 8h 20m,Sell
105883.86,1.20894,29.10.2012 13:30:00,,0.0,-263.2600000000093,0.0,0.0,1.20915,29.10.2012 04:45:00,8452,-0.13421558267080777,-7.62,IS,0.34,0.0,Phase3-EA-S4v1-EURCHF-M15-221,EURCHFMT4,2192,8h 45m,Buy
105879.74,1.20838,30.10.2012 06:25:00,,-1.05,-267.38000000000466,0.0,0.0,1.20845,29.10.2012 22:05:00,8453,-0.13631604685299678,-4.12,IS,0.41,0.0,Phase3-EA-SA2v2-EURCHF-M5-43,EURCHFMT4,4452,8h 20m,Buy
105803.65,128282,30.10.2012 08:59:57,sl 128.282,-0.65,-343.47000000000116,0.0,0.0,127612,29.10.2012 16:00:00,8454,-0.17510835744108816,-76.09,IS,0.09,0.0,Phase3-EA-B1v1-GBPJPY-M30-1,GBPJPYMT4,814,16h 59m,Sell
105714.19,102288,30.10.2012 09:29:57,sl 102.288,-1.1,-432.929999999993,0.0,0.0,103068,26.10.2012 21:30:00,8455,-0.2207169801932303,-89.46,IS,0.09,0.0,Phase3-EA-TR1v1-EURJPY-M30-91,EURJPYMT4,1404,3d 11h 59m,Buy
105734.53,0.93214,31.10.2012 03:45:00,,-3.3,-412.5899999999965,0.0,0.0,0.93252,30.10.2012 23:30:00,8456,-0.21034721284717064,20.34,IS,0.58,0.0,Phase3-EA-SA2v2-USDCHF-M15-107,USDCHFMT4,1682,4h 15m,Sell
105759.17,1.20792,31.10.2012 05:35:00,,-2.2,-387.94999999998254,0.0,0.0,1.20853,30.10.2012 21:15:00,8457,-0.1977852134662907,24.64,IS,0.41,0.0,Phase3-EA-SA2v2-EURCHF-M5-43,EURCHFMT4,4454,8h 20m,Sell
105735.74,1.20726,31.10.2012 13:00:00,,0.0,-411.37999999997555,0.0,0.0,1.2079,31.10.2012 04:15:00,8458,-0.2097303289489921,-23.43,IS,0.34,0.0,Phase3-EA-S4v1-EURCHF-M15-221,EURCHFMT4,2194,8h 45m,Buy
105647.77,103863,31.10.2012 13:59:58,sl 103.863,0.0,-499.3499999999767,0.0,0.0,103083,31.10.2012 05:30:00,8459,-0.2545793178100067,-87.97,IS,0.09,0.0,Phase3-EA-TR1v1-EURJPY-M30-91,EURJPYMT4,1406,8h 29m,Sell
105712.26,103556,31.10.2012 20:15:00,,0.0,-434.85999999998603,0.0,0.0,103253,31.10.2012 02:30:00,8460,-0.22170093550187464,64.49,IS,0.17,0.0,Phase3-EA-T1v2-EURJPY-M15-322,EURJPYMT4,1388,17h 45m,Buy
105634.65,129052,01.11.2012 08:35:00,,0.0,-512.4699999999721,0.0,0.0,128782,01.11.2012 03:10:00,8461,-0.26126817462319635,-77.61,IS,0.23,0.0,Phase3-EA-S4v1-GBPJPY-M5-194,GBPJPYMT4,2004,5h 25m,Sell
105627.62,1.20754,01.11.2012 11:15:00,,0.0,-519.4999999999709,0.0,0.0,1.20738,01.11.2012 02:55:00,8462,-0.2648522190894107,-7.03,IS,0.41,0.0,Phase3-EA-SA2v2-EURCHF-M5-43,EURCHFMT4,4456,8h 20m,Sell
105634.19,103756,01.11.2012 22:15:00,,0.0,-512.9299999999639,0.0,0.0,103725,01.11.2012 15:00:00,8463,-0.26150269246877667,6.57,IS,0.17,0.0,Phase3-EA-T1v2-EURJPY-M15-322,EURJPYMT4,1390,7h 15m,Buy
105660.38,1.20616,02.11.2012 05:05:00,,-1.06,-486.7399999999616,0.0,0.0,1.20554,01.11.2012 20:45:00,8464,-0.24815046991256362,26.19,IS,0.41,0.0,Phase3-EA-SA2v2-EURCHF-M5-43,EURCHFMT4,4458,8h 20m,Buy
105690.47,129238,02.11.2012 08:30:00,,0.0,-456.6499999999651,0.0,0.0,129343,02.11.2012 03:05:00,8465,-0.23280994388291995,30.09,IS,0.23,0.0,Phase3-EA-S4v1-GBPJPY-M5-194,GBPJPYMT4,2006,5h 25m,Sell
105641.76,103553,02.11.2012 08:59:57,sl 103.553,0.0,-505.3599999999569,0.0,0.0,103783,02.11.2012 02:00:00,8466,-0.2576433444446981,-48.71,IS,0.17,0.0,Phase3-EA-T1v2-EURJPY-M15-322,EURJPYMT4,1392,6h 59m,Buy
105558.99,103087,02.11.2012 21:59:58,sl 103.087,-2.21,-588.1299999999464,0.0,0.0,103807,31.10.2012 15:00:00,8467,-0.29984126200779526,-82.77,IS,0.09,0.0,Phase3-EA-TR1v1-EURJPY-M30-91,EURJPYMT4,1408,2d 6h 59m,Buy
105582.5,80504,05.11.2012 03:00:00,,-0.97,-564.6199999999371,0.0,0.0,80431,02.11.2012 21:00:00,8468,-0.28785536081281,23.51,IS,0.27,0.0,Phase3-EA-S1v2-USDJPY-M15-0,USDJPYMT4,2428,2d 6h 0m,Buy
105599.05,1.20653,05.11.2012 06:10:00,,-2.18,-548.0699999999488,0.0,0.0,1.20696,02.11.2012 21:50:00,8469,-0.2794178165858092,16.55,IS,0.41,0.0,Phase3-EA-SA2v2-EURCHF-M5-43,EURCHFMT4,4460,2d 8h 20m,Sell
105521.93,128173,05.11.2012 12:59:58,sl 128.173,-2.02,-625.1899999999441,0.0,0.0,128843,31.10.2012 20:00:00,8470,-0.3187352432194478,-77.12,IS,0.09,0.0,Phase3-EA-B1v1-GBPJPY-M30-1,GBPJPYMT4,816,4d 16h 59m,Buy
105434.45,102536,05.11.2012 15:59:57,sl 102.536,0.0,-712.6699999999546,0.0,0.0,103316,05.11.2012 05:30:00,8471,-0.36333441959277935,-87.48,IS,0.09,0.0,Phase3-EA-TR1v1-EURJPY-M30-91,EURJPYMT4,1410,10h 29m,Buy
105414.91,1.20731,06.11.2012 06:05:00,,-2.17,-732.2099999999627,0.0,0.0,1.20691,05.11.2012 21:45:00,8472,-0.3732963298160893,-19.54,IS,0.41,0.0,Phase3-EA-SA2v2-EURCHF-M5-43,EURCHFMT4,4462,8h 20m,Sell
105414.91,1.20698,06.11.2012 10:00:00,,0.0,-732.2099999999627,0.0,0.0,1.20698,06.11.2012 01:15:00,8473,-0.3732963298160893,0.0,IS,0.34,0.0,Phase3-EA-S4v1-EURCHF-M15-221,EURCHFMT4,2196,8h 45m,Sell
105366.17,102.77,06.11.2012 13:14:58,sl 102.770,0.0,-780.9499999999534,0.0,0.0,102.54,06.11.2012 04:15:00,8474,-0.39814502501997023,-48.74,IS,0.17,0.0,Phase3-EA-T1v2-EURJPY-M15-322,EURJPYMT4,1394,8h 59m,Sell
105290.52,128678,06.11.2012 22:59:57,sl 128.678,-0.65,-856.5999999999476,0.0,0.0,128008,05.11.2012 18:30:00,8475,-0.4367130141905448,-75.65,IS,0.09,0.0,Phase3-EA-B1v1-GBPJPY-M30-1,GBPJPYMT4,818,1d 4h 29m,Sell
105247.92,0.94349,07.11.2012 03:30:00,,-3.26,-899.1999999999534,0.0,0.0,0.94285,06.11.2012 23:15:00,8476,-0.4584314059772841,-42.6,IS,0.58,0.0,Phase3-EA-SA2v2-USDCHF-M15-107,USDCHFMT4,1684,4h 15m,Sell
105246.18,1.20807,07.11.2012 05:00:00,,-2.17,-900.9399999999441,0.0,0.0,1.20808,06.11.2012 20:40:00,8477,-0.4593184952192728,-1.74,IS,0.41,0.0,Phase3-EA-SA2v2-EURCHF-M5-43,EURCHFMT4,4464,8h 20m,Sell
105248.77,128293,07.11.2012 08:35:00,,0.0,-898.3499999999476,0.0,0.0,128284,07.11.2012 03:10:00,8478,-0.4579980577843533,2.59,IS,0.23,0.0,Phase3-EA-S4v1-GBPJPY-M5-194,GBPJPYMT4,2008,5h 25m,Buy
105167.08,103283,07.11.2012 10:29:58,sl 103.283,-0.78,-980.0399999999499,0.0,0.0,102563,05.11.2012 13:30:00,8479,-0.49964536823173694,-81.69,IS,0.09,0.0,Phase3-EA-TR1v1-EURJPY-M30-91,EURJPYMT4,1411,1d 20h 59m,Sell
105228.41,0.94569,08.11.2012 03:14:58,tp 0.94569,0.0,-918.7099999999627,0.0,0.0,0.94469,08.11.2012 01:30:00,8480,-0.46837802155849134,61.33,IS,0.58,0.0,Phase3-EA-SA2v2-USDCHF-M15-107,USDCHFMT4,1686,1h 44m,Buy
105221.82,79917,08.11.2012 03:15:00,,-4.56,-925.2999999999593,0.0,0.0,79911,07.11.2012 21:15:00,8481,-0.4717377446071889,-6.59,IS,0.27,0.0,Phase3-EA-S1v2-USDJPY-M15-0,USDJPYMT4,2430,6h 0m,Sell
105242.69,1.20596,08.11.2012 10:45:00,,0.0,-904.4299999999639,0.0,0.0,1.20654,08.11.2012 02:00:00,8482,-0.4610977719173043,20.87,IS,0.34,0.0,Phase3-EA-S4v1-EURCHF-M15-221,EURCHFMT4,2198,8h 45m,Sell
105234.88,1206,08.11.2012 10:50:00,,0.0,-912.2399999999616,0.0,0.0,1.20618,08.11.2012 02:30:00,8483,-0.46507947707820474,-7.81,IS,0.41,0.0,Phase3-EA-SA2v2-EURCHF-M5-43,EURCHFMT4,4466,8h 20m,Buy
105494.66,1.5932,08.11.2012 13:29:58,tp 1.59320,-4.82,-652.4599999999627,0.0,0.0,1.6121,01.11.2012 20:30:00,8484,-0.33263807289138925,259.78,IS,0.14,0.0,Phase3-EA-B1v1-GBPUSD-M30-14,GBPUSDMT4,556,6d 16h 59m,Sell
105406.53,101207,08.11.2012 21:29:58,sl 101.207,0.0,-740.5899999999674,0.0,0.0,101987,08.11.2012 10:00:00,8485,-0.3775686331769567,-88.13,IS,0.09,0.0,Phase3-EA-TR1v1-EURJPY-M30-91,EURJPYMT4,1414,11h 29m,Buy
105416.98,1.20576,09.11.2012 09:45:00,,0.0,-730.1399999999558,0.0,0.0,1.20547,09.11.2012 01:00:00,8486,-0.3722409995109556,10.45,IS,0.34,0.0,Phase3-EA-S4v1-EURCHF-M15-221,EURCHFMT4,2200,8h 45m,Buy
105419.02,79468,09.11.2012 11:00:00,,0.0,-728.0999999999476,0.0,0.0,79474,09.11.2012 01:45:00,8487,-0.3712009638479246,2.04,IS,0.27,0.0,Phase3-EA-S1v2-USDJPY-M15-0,USDJPYMT4,2432,9h 15m,Sell
105781.25,100616,09.11.2012 15:44:58,tp 100.616,-2.98,-365.86999999993714,0.0,0.0,102316,07.11.2012 15:15:00,8488,-0.18652835687821265,362.23,IS,0.17,0.0,Phase3-EA-T1v2-EURJPY-M15-322,EURJPYMT4,1396,2d 0h 29m,Sell
105747.42,79412,12.11.2012 02:30:00,,-1.53,-399.69999999992433,0.0,0.0,79317,09.11.2012 17:15:00,8489,-0.20377561495673405,-33.83,IS,0.27,0.0,Phase3-EA-S1v2-USDJPY-M15-0,USDJPYMT4,2434,2d 9h 15m,Sell
105808.58,0.94831,12.11.2012 05:14:57,tp 0.94831,0.0,-338.53999999992084,0.0,0.0,0.94731,12.11.2012 02:30:00,8490,-0.17259493792206573,61.16,IS,0.58,0.0,Phase3-EA-SA2v2-USDCHF-M15-107,USDCHFMT4,1688,2h 44m,Buy
105834.75,1.20531,12.11.2012 13:45:00,,0.0,-312.36999999990803,0.0,0.0,1.20604,12.11.2012 05:00:00,8491,-0.15925291179391626,26.17,IS,0.34,0.0,Phase3-EA-S4v1-EURCHF-M15-221,EURCHFMT4,2202,8h 45m,Sell
105947.73,125947,13.11.2012 05:09:59,tp 125.947,0.0,-199.38999999989755,0.0,0.0,126337,13.11.2012 03:00:00,8492,-0.10165328963274961,112.98,IS,0.23,0.0,Phase3-EA-S4v1-GBPJPY-M5-194,GBPJPYMT4,2010,2h 9m,Sell
105905.73,1.58935,13.11.2012 12:59:57,sl 1.58935,0.0,-241.38999999989755,0.0,0.0,1.58635,13.11.2012 05:00:00,8493,-0.12306578857741923,-42.0,IS,0.14,0.0,Phase3-EA-B1v1-GBPUSD-M30-14,GBPUSDMT4,558,7h 59m,Sell
105892.86,1.20454,13.11.2012 13:30:00,,0.0,-254.2599999998929,0.0,0.0,1.2049,13.11.2012 04:45:00,8494,-0.12962719003974776,-12.87,IS,0.34,0.0,Phase3-EA-S4v1-EURCHF-M15-221,EURCHFMT4,2204,8h 45m,Buy
105843.67,100992,13.11.2012 14:44:58,sl 100.992,0.0,-303.4499999998952,0.0,0.0,100762,13.11.2012 05:00:00,8495,-0.15470530487518466,-49.19,IS,0.17,0.0,Phase3-EA-T1v2-EURJPY-M15-322,EURJPYMT4,1398,9h 44m,Sell
105837.24,79427,14.11.2012 01:30:00,,-0.99,-309.87999999988824,0.0,0.0,79443,13.11.2012 19:00:00,8496,-0.15798345649932932,-6.43,IS,0.27,0.0,Phase3-EA-S1v2-USDJPY-M15-0,USDJPYMT4,2436,6h 30m,Buy
105840.97,1.20352,14.11.2012 07:00:00,,-1.04,-306.14999999987776,0.0,0.0,1.20341,13.11.2012 22:40:00,8497,-0.15608182266447593,3.73,IS,0.41,0.0,Phase3-EA-SA2v2-EURCHF-M5-43,EURCHFMT4,4468,8h 20m,Buy
105793.24,126.28,14.11.2012 08:20:00,,0.0,-353.87999999988824,0.0,0.0,126115,14.11.2012 02:55:00,8498,-0.180415598250888,-47.73,IS,0.23,0.0,Phase3-EA-S4v1-GBPJPY-M5-194,GBPJPYMT4,2012,5h 25m,Sell
105805.45,1.20383,14.11.2012 10:30:00,,0.0,-341.6699999998964,0.0,0.0,1.20349,14.11.2012 01:45:00,8499,-0.1741906789148346,12.21,IS,0.34,0.0,Phase3-EA-S4v1-EURCHF-M15-221,EURCHFMT4,2206,8h 45m,Buy
105722.82,101943,14.11.2012 12:59:58,sl 101.943,-1.6,-424.29999999990105,0.0,0.0,101223,08.11.2012 23:30:00,8500,-0.21631722148145724,-82.63,IS,0.09,0.0,Phase3-EA-TR1v1-EURJPY-M30-91,EURJPYMT4,1416,5d 13h 29m,Sell
105740.08,80225,15.11.2012 00:30:00,,-2.93,-407.03999999989173,0.0,0.0,80165,14.11.2012 20:15:00,8501,-0.20751770405800019,17.26,IS,0.27,0.0,Phase3-EA-S1v2-USDJPY-M15-0,USDJPYMT4,2438,4h 15m,Buy
105974.05,102073,15.11.2012 02:00:00,,-3.11,-173.06999999989057,0.0,0.0,100955,14.11.2012 02:30:00,8502,-0.08823479029408642,233.97,IS,0.17,0.0,Phase3-EA-T1v2-EURJPY-M15-322,EURJPYMT4,1400,23h 30m,Buy
106014.58,0.94442,15.11.2012 05:45:00,,0.0,-132.53999999989173,0.0,0.0,0.94508,15.11.2012 01:30:00,8503,-0.06757172881248082,40.53,IS,0.58,0.0,Phase3-EA-SA2v2-USDCHF-M15-107,USDCHFMT4,1690,4h 15m,Sell
106001.04,1.20335,15.11.2012 06:40:00,,-3.12,-146.07999999989988,0.0,0.0,1.20359,14.11.2012 22:20:00,8504,-0.0744747106151237,-13.54,IS,0.41,0.0,Phase3-EA-SA2v2-EURCHF-M5-43,EURCHFMT4,4470,8h 20m,Buy
106112.82,127396,15.11.2012 07:04:58,tp 127.396,0.0,-34.29999999990105,0.0,0.0,127006,15.11.2012 02:05:00,8505,-0.017486874138096416,111.78,IS,0.23,0.0,Phase3-EA-S4v1-GBPJPY-M5-194,GBPJPYMT4,2014,4h 59m,Buy
106251.4,103215,15.11.2012 12:59:58,tp 103.215,-1.65,-0.0,0.0,0.0,101955,14.11.2012 14:00:00,8506,-0.0,138.58,IS,0.09,0.0,Phase3-EA-TR1v1-EURJPY-M30-91,EURJPYMT4,1418,22h 59m,Buy
106273.7,81253,16.11.2012 03:30:00,,-0.96,-0.0,0.0,0.0,81183,15.11.2012 18:15:00,8507,-0.0,22.3,IS,0.27,0.0,Phase3-EA-S1v2-USDJPY-M15-0,USDJPYMT4,2440,9h 15m,Buy
106225.56,103643,16.11.2012 03:59:58,sl 103.643,0.0,-48.14000000001397,0.0,0.0,103873,16.11.2012 03:30:00,8508,-0.0245269743220889,-48.14,IS,0.17,0.0,Phase3-EA-T1v2-EURJPY-M15-322,EURJPYMT4,1402,29m 58s,Buy
106211.65,1.20435,16.11.2012 08:40:00,,0.0,-62.05000000001746,0.0,0.0,1.20403,16.11.2012 00:20:00,8509,-0.0316140165493478,-13.91,IS,0.41,0.0,Phase3-EA-SA2v2-EURCHF-M5-43,EURCHFMT4,4472,8h 20m,Sell
106209.85,1.20406,16.11.2012 10:15:00,,0.0,-63.85000000000582,0.0,0.0,1.20401,16.11.2012 01:30:00,8510,-0.03253110325020907,-1.8,IS,0.34,0.0,Phase3-EA-S4v1-EURCHF-M15-221,EURCHFMT4,2208,8h 45m,Sell
106412.69,129196,16.11.2012 20:59:58,tp 129.196,-1.61,-0.0,0.0,0.0,127346,14.11.2012 17:00:00,8511,-0.0,202.84,IS,0.09,0.0,Phase3-EA-B1v1-GBPJPY-M30-1,GBPJPYMT4,820,2d 3h 59m,Buy
106374.03,1.20537,19.11.2012 05:35:00,,-2.17,-38.66000000000349,0.0,0.0,1.20453,16.11.2012 21:15:00,8512,-0.01968304593761399,-38.66,IS,0.41,0.0,Phase3-EA-SA2v2-EURCHF-M5-43,EURCHFMT4,4474,2d 8h 20m,Sell
106350.69,0.94417,19.11.2012 07:00:00,,0.0,-62.0,0.0,0.0,0.94455,19.11.2012 02:45:00,8513,-0.03156618851867452,-23.34,IS,0.58,0.0,Phase3-EA-SA2v2-USDCHF-M15-107,USDCHFMT4,1692,4h 15m,Buy
106422.37,129221,19.11.2012 08:15:00,,0.0,-0.0,0.0,0.0,129474,19.11.2012 02:50:00,8514,-0.0,71.68,IS,0.23,0.0,Phase3-EA-S4v1-GBPJPY-M5-194,GBPJPYMT4,2016,5h 25m,Sell
106429.27,103748,19.11.2012 10:00:00,,0.0,-0.0,0.0,0.0,103715,19.11.2012 09:45:00,8515,-0.0,6.9,IS,0.17,0.0,Phase3-EA-T1v2-EURJPY-M15-322,EURJPYMT4,1404,15m 0s,Buy
106431.43,1.20501,19.11.2012 13:30:00,,0.0,-0.0,0.0,0.0,1.20507,19.11.2012 04:45:00,8516,-0.0,2.16,IS,0.34,0.0,Phase3-EA-S4v1-EURCHF-M15-221,EURCHFMT4,2210,8h 45m,Sell
106470.55,103942,20.11.2012 04:30:00,,-1.02,-0.0,0.0,0.0,103.75,19.11.2012 17:45:00,8517,-0.0,39.12,IS,0.17,0.0,Phase3-EA-T1v2-EURJPY-M15-322,EURJPYMT4,1406,10h 45m,Buy
106466.65,129349,20.11.2012 04:40:00,,-1.64,-3.8999999999941792,0.0,0.0,129341,19.11.2012 23:15:00,8518,-0.0019850303264250884,-3.9,IS,0.23,0.0,Phase3-EA-S4v1-GBPJPY-M5-194,GBPJPYMT4,2018,5h 25m,Sell
106476.5,1.20425,20.11.2012 06:45:00,,-1.05,-0.0,0.0,0.0,1204,19.11.2012 22:25:00,8519,-0.0,9.85,IS,0.41,0.0,Phase3-EA-SA2v2-EURCHF-M5-43,EURCHFMT4,4476,8h 20m,Buy
106490.58,1.20425,20.11.2012 11:00:00,,0.0,-0.0,0.0,0.0,1.20386,20.11.2012 02:15:00,8520,-0.0,14.08,IS,0.34,0.0,Phase3-EA-S4v1-EURCHF-M15-221,EURCHFMT4,2212,8h 45m,Buy
106627.81,104581,20.11.2012 16:59:58,tp 104.581,-1.62,-0.0,0.0,0.0,103321,15.11.2012 13:00:00,8521,-0.0,137.23,IS,0.09,0.0,Phase3-EA-TR1v1-EURJPY-M30-91,EURJPYMT4,1420,5d 3h 59m,Buy
106646.01,81719,21.11.2012 01:30:00,,-0.96,-0.0,0.0,0.0,81661,20.11.2012 21:30:00,8522,-0.0,18.2,IS,0.27,0.0,Phase3-EA-S1v2-USDJPY-M15-0,USDJPYMT4,2442,4h 0m,Buy
106653.29,0.9401,21.11.2012 03:45:00,,-0.74,-0.0,0.0,0.0,0.93997,20.11.2012 23:30:00,8523,-0.0,7.28,IS,0.58,0.0,Phase3-EA-SA2v2-USDCHF-M15-107,USDCHFMT4,1694,4h 15m,Buy
106658.78,1.20466,21.11.2012 04:45:00,,-1.05,-0.0,0.0,0.0,1.20451,20.11.2012 20:25:00,8524,-0.0,5.49,IS,0.41,0.0,Phase3-EA-SA2v2-EURCHF-M5-43,EURCHFMT4,4478,8h 20m,Buy
106724.27,104296,21.11.2012 08:15:00,,-1.02,-0.0,0.0,0.0,103976,20.11.2012 12:45:00,8525,-0.0,65.49,IS,0.17,0.0,Phase3-EA-T1v2-EURJPY-M15-322,EURJPYMT4,1408,19h 30m,Buy
106737.19,130231,21.11.2012 08:50:00,,0.0,-0.0,0.0,0.0,130277,21.11.2012 03:25:00,8526,-0.0,12.92,IS,0.23,0.0,Phase3-EA-S4v1-GBPJPY-M5-194,GBPJPYMT4,2020,5h 25m,Sell
106651.87,105295,21.11.2012 14:29:58,sl 105.295,0.0,-85.32000000000698,0.0,0.0,104515,21.11.2012 07:00:00,8527,-0.04336749955613715,-85.32,IS,0.09,0.0,Phase3-EA-TR1v1-EURJPY-M30-91,EURJPYMT4,1422,7h 29m,Sell
106682.97,82472,21.11.2012 22:00:00,,0.0,-54.220000000001164,0.0,0.0,82377,21.11.2012 17:45:00,8528,-0.02755960883654025,31.1,IS,0.27,0.0,Phase3-EA-S1v2-USDJPY-M15-0,USDJPYMT4,2444,4h 15m,Buy
106656.32,1.20446,22.11.2012 07:40:00,,-6.55,-80.86999999999534,0.0,0.0,1204,21.11.2012 23:20:00,8529,-0.041105598794002836,-26.65,IS,0.41,0.0,Phase3-EA-SA2v2-EURCHF-M5-43,EURCHFMT4,4480,8h 20m,Sell
106709.63,131493,22.11.2012 07:45:00,,0.0,-27.55999999999767,0.0,0.0,131684,22.11.2012 02:20:00,8530,-0.014008535956011967,53.31,IS,0.23,0.0,Phase3-EA-S4v1-GBPJPY-M5-194,GBPJPYMT4,2022,5h 25m,Sell
106910.78,105866,22.11.2012 08:30:00,,-3.03,-0.0,0.0,0.0,104876,21.11.2012 12:00:00,8531,-0.0,201.15,IS,0.17,0.0,Phase3-EA-T1v2-EURJPY-M15-322,EURJPYMT4,1410,20h 30m,Buy
106903.89,1.20459,22.11.2012 11:30:00,,0.0,-6.89000000001397,0.0,0.0,1.2044,22.11.2012 02:45:00,8532,-0.0034990466240669743,-6.89,IS,0.34,0.0,Phase3-EA-S4v1-EURCHF-M15-221,EURCHFMT4,2214,8h 45m,Sell
107104.12,132166,22.11.2012 11:59:58,tp 132.166,-1.18,-0.0,0.0,0.0,130316,21.11.2012 03:30:00,8533,-0.0,200.23,IS,0.09,0.0,Phase3-EA-B1v1-GBPJPY-M30-1,GBPJPYMT4,822,1d 8h 29m,Buy
107150.69,106179,22.11.2012 20:15:00,,0.0,-0.0,0.0,0.0,105953,22.11.2012 10:00:00,8534,-0.0,46.57,IS,0.17,0.0,Phase3-EA-T1v2-EURJPY-M15-322,EURJPYMT4,1412,10h 15m,Buy
107187.77,0.93558,23.11.2012 03:15:00,,-0.74,-0.0,0.0,0.0,0.93497,22.11.2012 23:00:00,8535,-0.0,37.08,IS,0.58,0.0,Phase3-EA-SA2v2-USDCHF-M15-107,USDCHFMT4,1696,4h 15m,Buy
107179.38,131149,23.11.2012 08:50:00,,0.0,-8.39000000001397,0.0,0.0,131179,23.11.2012 03:25:00,8536,-0.004254827771526572,-8.39,IS,0.23,0.0,Phase3-EA-S4v1-GBPJPY-M5-194,GBPJPYMT4,2024,5h 25m,Buy
107131.76,106063,23.11.2012 12:14:58,sl 106.063,0.0,-56.01000000000931,0.0,0.0,105833,23.11.2012 11:45:00,8537,-0.028404398508086542,-47.62,IS,0.17,0.0,Phase3-EA-T1v2-EURJPY-M15-322,EURJPYMT4,1414,29m 58s,Sell
107163.07,1.20509,23.11.2012 12:45:00,,0.0,-24.70000000001164,0.0,0.0,1.20423,23.11.2012 04:00:00,8538,-0.012526131818424418,31.31,IS,0.34,0.0,Phase3-EA-S4v1-EURCHF-M15-221,EURCHFMT4,2216,8h 45m,Buy
107298.76,106821,23.11.2012 20:29:58,tp 106.821,-2.14,-0.0,0.0,0.0,105561,21.11.2012 17:30:00,8539,-0.0,135.69,IS,0.09,0.0,Phase3-EA-TR1v1-EURJPY-M30-91,EURJPYMT4,1424,2d 2h 59m,Buy
107400.15,106658,26.11.2012 06:00:00,,-1.01,-0.0,0.0,0.0,106162,23.11.2012 13:15:00,8540,-0.0,101.39,IS,0.17,0.0,Phase3-EA-T1v2-EURJPY-M15-322,EURJPYMT4,1416,2d 16h 45m,Buy
107424.31,1.20442,26.11.2012 14:00:00,,0.0,-0.0,0.0,0.0,1.20376,26.11.2012 05:15:00,8541,-0.0,24.16,IS,0.34,0.0,Phase3-EA-S4v1-EURCHF-M15-221,EURCHFMT4,2218,8h 45m,Buy
107376.65,106412,27.11.2012 02:29:58,sl 106.412,0.0,-47.66000000000349,0.0,0.0,106642,27.11.2012 01:30:00,8542,-0.024140897339341508,-47.66,IS,0.17,0.0,Phase3-EA-T1v2-EURJPY-M15-322,EURJPYMT4,1418,59m 58s,Buy
107439.19,0.92734,27.11.2012 02:29:58,tp 0.92734,0.0,-0.0,0.0,0.0,0.92634,27.11.2012 01:45:00,8543,-0.0,62.54,IS,0.58,0.0,Phase3-EA-SA2v2-USDCHF-M15-107,USDCHFMT4,1698,44m 58s,Buy
107391.45,106564,27.11.2012 03:29:58,sl 106.564,0.0,-47.73999999999069,0.0,0.0,106334,27.11.2012 03:00:00,8544,-0.024179596765966538,-47.74,IS,0.17,0.0,Phase3-EA-T1v2-EURJPY-M15-322,EURJPYMT4,1420,29m 58s,Sell
107385.39,131454,27.11.2012 05:05:00,,-1.01,-53.79999999998836,0.0,0.0,131472,26.11.2012 23:40:00,8545,-0.02724889622976481,-6.06,IS,0.23,0.0,Phase3-EA-S4v1-GBPJPY-M5-194,GBPJPYMT4,2026,5h 25m,Buy
107364.04,106449,27.11.2012 06:00:00,,0.0,-75.14999999999418,0.0,0.0,106552,27.11.2012 04:30:00,8546,-0.03806235226147044,-21.35,IS,0.17,0.0,Phase3-EA-T1v2-EURJPY-M15-322,EURJPYMT4,1422,1h 30m,Buy
107402.91,1.20442,27.11.2012 10:00:00,,0.0,-36.279999999998836,0.0,0.0,1.20336,27.11.2012 01:15:00,8547,-0.018375277977993484,38.87,IS,0.34,0.0,Phase3-EA-S4v1-EURCHF-M15-221,EURCHFMT4,2220,8h 45m,Buy
107437.27,1.20374,28.11.2012 04:25:00,,-2.2,-1.9200000000128057,0.0,0.0,1.20457,27.11.2012 20:05:00,8548,-9.724513152696784E-4,34.36,IS,0.41,0.0,Phase3-EA-SA2v2-EURCHF-M5-43,EURCHFMT4,4482,8h 20m,Sell
107432.52,1.2036,28.11.2012 13:45:00,,0.0,-6.670000000012806,0.0,0.0,1.20373,28.11.2012 05:00:00,8549,-0.003378255350426014,-4.75,IS,0.34,0.0,Phase3-EA-S4v1-EURCHF-M15-221,EURCHFMT4,2222,8h 45m,Buy
107573.67,105302,28.11.2012 18:29:57,tp 105.302,-0.76,-0.0,0.0,0.0,106592,26.11.2012 05:30:00,8550,-0.0,141.15,IS,0.09,0.0,Phase3-EA-TR1v1-EURJPY-M30-91,EURJPYMT4,1426,2d 12h 59m,Sell
107529.96,131413,29.11.2012 05:30:00,,0.0,-43.70999999999185,0.0,0.0,131257,29.11.2012 00:05:00,8551,-0.022123393263885672,-43.71,IS,0.23,0.0,Phase3-EA-S4v1-GBPJPY-M5-194,GBPJPYMT4,2028,5h 25m,Sell
107521.89,1.20393,29.11.2012 14:15:00,,0.0,-51.779999999998836,0.0,0.0,1.20371,29.11.2012 05:30:00,8552,-0.026207945623522945,-8.07,IS,0.34,0.0,Phase3-EA-S4v1-EURCHF-M15-221,EURCHFMT4,2224,8h 45m,Sell
107661.09,107055,30.11.2012 04:59:58,tp 107.055,-2.15,-0.0,0.0,0.0,105765,28.11.2012 20:00:00,8553,-0.0,139.2,IS,0.09,0.0,Phase3-EA-TR1v1-EURJPY-M30-91,EURJPYMT4,1428,1d 8h 59m,Buy
107696.93,132097,03.12.2012 04:35:00,,-1.0,-0.0,0.0,0.0,131965,30.11.2012 23:10:00,8554,-0.0,35.84,IS,0.23,0.0,Phase3-EA-S4v1-GBPJPY-M5-194,GBPJPYMT4,2030,2d 5h 25m,Buy
107650.83,1.20602,03.12.2012 07:20:00,,-2.21,-46.10000000000582,0.0,0.0,1.20503,30.11.2012 23:00:00,8555,-0.02331852092999404,-46.1,IS,0.41,0.0,Phase3-EA-SA2v2-EURCHF-M5-43,EURCHFMT4,4484,2d 8h 20m,Sell
107603.3,107175,03.12.2012 08:59:58,sl 107.175,0.0,-93.63000000000466,0.0,0.0,107405,03.12.2012 05:15:00,8556,-0.04736037125108839,-47.53,IS,0.17,0.0,Phase3-EA-T1v2-EURJPY-M15-322,EURJPYMT4,1424,3h 44m,Buy
107593.38,1.20579,03.12.2012 14:15:00,,0.0,-103.55000000001746,0.0,0.0,1.20552,03.12.2012 05:30:00,8557,-0.052378152761409655,-9.92,IS,0.34,0.0,Phase3-EA-S4v1-EURCHF-M15-221,EURCHFMT4,2226,8h 45m,Sell
107850.54,1.60837,03.12.2012 15:59:58,tp 1.60837,-7.44,-0.0,0.0,0.0,1.58947,19.11.2012 02:30:00,8558,-0.0,257.16,IS,0.14,0.0,Phase3-EA-B1v1-GBPUSD-M30-14,GBPUSDMT4,560,14d 13h 29m,Buy
107729.15,82272,03.12.2012 17:00:00,,-0.95,-121.39000000001397,0.0,0.0,82639,30.11.2012 17:00:00,8559,-0.061354394079497374,-121.39,IS,0.27,0.0,Phase3-EA-S1v2-USDJPY-M15-0,USDJPYMT4,2446,3d 0h 0m,Buy
107730.17,82.23,04.12.2012 01:15:00,,-0.95,-120.37000000002445,0.0,0.0,82224,03.12.2012 20:30:00,8560,-0.06083885340925734,1.02,IS,0.27,0.0,Phase3-EA-S1v2-USDJPY-M15-0,USDJPYMT4,2448,4h 45m,Buy
107741.95,1.20846,04.12.2012 06:00:00,,-1.06,-108.59000000002561,0.0,0.0,1.20817,03.12.2012 21:40:00,8561,-0.054884864099954064,11.78,IS,0.41,0.0,Phase3-EA-SA2v2-EURCHF-M5-43,EURCHFMT4,4486,8h 20m,Buy
107775.76,1.20901,04.12.2012 10:00:00,,0.0,-74.78000000002794,0.0,0.0,1.20809,04.12.2012 01:15:00,8562,-0.037796207177411646,33.81,IS,0.34,0.0,Phase3-EA-S4v1-EURCHF-M15-221,EURCHFMT4,2228,8h 45m,Buy
107696.5,107853,05.12.2012 06:29:58,sl 107.853,-0.38,-154.04000000003725,0.0,0.0,107338,30.11.2012 17:30:00,8563,-0.07785674984765609,-79.26,IS,0.09,0.0,Phase3-EA-TR1v1-EURJPY-M30-91,EURJPYMT4,1430,4d 12h 59m,Sell
107644.74,1.21481,05.12.2012 06:35:00,,-2.21,-205.80000000004657,0.0,0.0,1.21369,04.12.2012 22:15:00,8564,-0.10401791170246283,-51.76,IS,0.41,0.0,Phase3-EA-SA2v2-EURCHF-M5-43,EURCHFMT4,4488,8h 20m,Sell
107481.72,132471,05.12.2012 06:45:00,,0.0,-368.8200000000361,0.0,0.0,131888,05.12.2012 01:20:00,8565,-0.18641344117637226,-163.02,IS,0.23,0.0,Phase3-EA-S4v1-GBPJPY-M5-194,GBPJPYMT4,2032,5h 25m,Sell
107438.04,1.21465,05.12.2012 11:45:00,,0.0,-412.5000000000291,0.0,0.0,1.21346,05.12.2012 03:00:00,8566,-0.20849071223158036,-43.68,IS,0.34,0.0,Phase3-EA-S4v1-EURCHF-M15-221,EURCHFMT4,2230,8h 45m,Sell
107387.54,107555,06.12.2012 03:59:58,sl 107.555,-3.03,-463.0000000000291,0.0,0.0,107785,05.12.2012 20:15:00,8567,-0.2340150297290205,-50.5,IS,0.17,0.0,Phase3-EA-T1v2-EURJPY-M15-322,EURJPYMT4,1426,7h 44m,Buy
107392.91,132523,06.12.2012 04:25:00,,-3.01,-457.63000000003376,0.0,0.0,132493,05.12.2012 23:00:00,8568,-0.23130085972979011,5.37,IS,0.23,0.0,Phase3-EA-S4v1-GBPJPY-M5-194,GBPJPYMT4,2034,5h 25m,Buy
107345.49,1.21001,06.12.2012 07:55:00,,-3.19,-505.05000000004657,0.0,0.0,1.21101,05.12.2012 23:35:00,8569,-0.25526844657590775,-47.42,IS,0.41,0.0,Phase3-EA-SA2v2-EURCHF-M5-43,EURCHFMT4,4490,8h 20m,Buy
107417.71,1.21221,06.12.2012 13:30:00,,0.0,-432.8300000000454,0.0,0.0,1.21024,06.12.2012 04:45:00,8570,-0.21876614539441944,72.22,IS,0.34,0.0,Phase3-EA-S4v1-EURCHF-M15-221,EURCHFMT4,2232,8h 45m,Buy
107370.25,107589,06.12.2012 14:59:58,sl 107.589,0.0,-480.29000000003725,0.0,0.0,107819,06.12.2012 12:15:00,8571,-0.24275394952171256,-47.46,IS,0.17,0.0,Phase3-EA-T1v2-EURJPY-M15-322,EURJPYMT4,1428,2h 44m,Buy
107319.73,0.93237,07.12.2012 03:30:00,,-0.75,-530.8100000000268,0.0,0.0,0.93317,06.12.2012 23:15:00,8572,-0.26828837565974045,-50.52,IS,0.58,0.0,Phase3-EA-SA2v2-USDCHF-M15-107,USDCHFMT4,1700,4h 15m,Buy
107312.48,132366,07.12.2012 08:35:00,,0.0,-538.0600000000268,0.0,0.0,132.34,07.12.2012 03:10:00,8573,-0.2719527578747195,-7.25,IS,0.23,0.0,Phase3-EA-S4v1-GBPJPY-M5-194,GBPJPYMT4,2036,5h 25m,Sell
107286.11,1.20857,07.12.2012 09:15:00,,0.0,-564.4300000000221,0.0,0.0,1.20917,07.12.2012 00:55:00,8574,-0.2852810004966478,-26.37,IS,0.41,0.0,Phase3-EA-SA2v2-EURCHF-M5-43,EURCHFMT4,4492,8h 20m,Buy
107277.74,1.20894,07.12.2012 11:15:00,,0.0,-572.8000000000175,0.0,0.0,1.20917,07.12.2012 02:30:00,8575,-0.289511466584835,-8.37,IS,0.34,0.0,Phase3-EA-S4v1-EURCHF-M15-221,EURCHFMT4,2234,8h 45m,Buy
107181.48,0.93574,10.12.2012 02:45:00,,-3.29,-669.0600000000268,0.0,0.0,0.93424,07.12.2012 22:30:00,8576,-0.3381643537591682,-96.26,IS,0.58,0.0,Phase3-EA-SA2v2-USDCHF-M15-107,USDCHFMT4,1702,2d 4h 15m,Sell
107319.55,106048,10.12.2012 13:29:58,tp 106.048,-3.05,-530.9900000000198,0.0,0.0,107133,04.12.2012 05:30:00,8577,-0.26837935342507435,138.07,IS,0.09,0.0,Phase3-EA-TR1v1-EURJPY-M30-91,EURJPYMT4,1431,6d 7h 59m,Sell
107455.48,106034,10.12.2012 13:29:58,tp 106.034,-1.91,-395.0600000000268,0.0,0.0,107294,05.12.2012 17:30:00,8578,-0.1996759776344434,135.93,IS,0.09,0.0,Phase3-EA-TR1v1-EURJPY-M30-91,EURJPYMT4,1433,4d 19h 59m,Sell
107419.11,1.20631,10.12.2012 13:30:00,,0.0,-431.4300000000221,0.0,0.0,1.20731,10.12.2012 04:45:00,8579,-0.21805854055289448,-36.37,IS,0.34,0.0,Phase3-EA-S4v1-EURCHF-M15-221,EURCHFMT4,2236,8h 45m,Buy
107403.3,1.20758,11.12.2012 05:00:00,,-2.2,-447.2400000000198,0.0,0.0,1.20727,10.12.2012 20:40:00,8580,-0.22604942094169586,-15.81,IS,0.41,0.0,Phase3-EA-SA2v2-EURCHF-M5-43,EURCHFMT4,4494,8h 20m,Sell
107371.99,1.20876,11.12.2012 10:45:00,,0.0,-478.55000000001746,0.0,0.0,1.2079,11.12.2012 02:00:00,8581,-0.24187449779010758,-31.31,IS,0.34,0.0,Phase3-EA-S4v1-EURCHF-M15-221,EURCHFMT4,2238,8h 45m,Sell
107323.13,107007,11.12.2012 13:14:58,sl 107.007,-1.44,-527.4100000000035,0.0,0.0,106777,07.12.2012 09:15:00,8582,-0.26656990675891096,-48.86,IS,0.17,0.0,Phase3-EA-T1v2-EURJPY-M15-322,EURJPYMT4,1430,4d 3h 59m,Sell
107343.81,1.21221,12.12.2012 05:40:00,,-2.2,-506.7300000000105,0.0,0.0,1.21273,11.12.2012 21:20:00,8583,-0.2561175723857053,20.68,IS,0.41,0.0,Phase3-EA-SA2v2-EURCHF-M5-43,EURCHFMT4,4496,8h 20m,Sell
107330.16,133026,12.12.2012 06:15:00,,0.0,-520.3800000000047,0.0,0.0,132977,12.12.2012 00:50:00,8584,-0.26301671959045597,-13.65,IS,0.23,0.0,Phase3-EA-S4v1-GBPJPY-M5-194,GBPJPYMT4,2038,5h 25m,Sell
107469.46,107629,12.12.2012 10:29:57,tp 107.629,-1.07,-381.0800000000163,0.0,0.0,106339,10.12.2012 17:00:00,8585,-0.19261003785989922,139.3,IS,0.09,0.0,Phase3-EA-TR1v1-EURJPY-M30-91,EURJPYMT4,1436,1d 17h 29m,Buy
107453.04,1.21174,12.12.2012 11:15:00,,0.0,-397.5000000000291,0.0,0.0,1.21219,12.12.2012 02:30:00,8586,-0.20090923178679615,-16.42,IS,0.34,0.0,Phase3-EA-S4v1-EURCHF-M15-221,EURCHFMT4,2240,8h 45m,Buy
107649.9,133435,12.12.2012 11:29:58,tp 133.435,-4.31,-200.64000000004307,0.0,0.0,131585,29.11.2012 09:00:00,8587,-0.1014098824294553,196.86,IS,0.09,0.0,Phase3-EA-B1v1-GBPJPY-M30-1,GBPJPYMT4,824,13d 2h 29m,Buy
107785.73,107849,12.12.2012 11:59:58,tp 107.849,-1.07,-64.81000000005588,0.0,0.0,106589,10.12.2012 21:00:00,8588,-0.032757049841792535,135.83,IS,0.09,0.0,Phase3-EA-TR1v1-EURJPY-M30-91,EURJPYMT4,1437,1d 14h 59m,Buy
107838.56,83.31,13.12.2012 03:30:00,,0.0,-11.980000000068685,0.0,0.0,83147,13.12.2012 01:30:00,8589,-0.006055075715269034,52.83,IS,0.27,0.0,Phase3-EA-S1v2-USDJPY-M15-0,USDJPYMT4,2450,2h 0m,Buy
107880.57,1.21036,13.12.2012 04:49:59,tp 1.21036,-6.64,-0.0,0.0,0.0,1.21146,12.12.2012 21:30:00,8590,-0.0,42.01,IS,0.41,0.0,Phase3-EA-SA2v2-EURCHF-M5-43,EURCHFMT4,4498,7h 19m,Sell
108014.68,109049,13.12.2012 06:29:58,tp 109.049,-1.59,-0.0,0.0,0.0,107789,12.12.2012 13:00:00,8591,-0.0,134.11,IS,0.09,0.0,Phase3-EA-TR1v1-EURJPY-M30-91,EURJPYMT4,1440,17h 29m,Buy
107874.43,134983,13.12.2012 09:15:00,,0.0,-140.25,0.0,0.0,134473,13.12.2012 03:50:00,8592,-0.07082808203916982,-140.25,IS,0.23,0.0,Phase3-EA-S4v1-GBPJPY-M5-194,GBPJPYMT4,2040,5h 25m,Sell
107843.24,1.20963,13.12.2012 14:00:00,,0.0,-171.44000000000233,0.0,0.0,1.21048,13.12.2012 05:15:00,8593,-0.0865794394637821,-31.19,IS,0.34,0.0,Phase3-EA-S4v1-EURCHF-M15-221,EURCHFMT4,2242,8h 45m,Buy
107891.0,1.20887,14.12.2012 05:19:57,tp 1.20887,-1.07,-123.67999999999302,0.0,0.0,1.20777,13.12.2012 23:05:00,8594,-0.06246001559075957,47.76,IS,0.41,0.0,Phase3-EA-SA2v2-EURCHF-M5-43,EURCHFMT4,4500,6h 14m,Buy
107783.75,135154,14.12.2012 08:15:00,,0.0,-230.92999999999302,0.0,0.0,134763,14.12.2012 02:50:00,8595,-0.11662266656188942,-107.25,IS,0.23,0.0,Phase3-EA-S4v1-GBPJPY-M5-194,GBPJPYMT4,2042,5h 25m,Sell
107803.3,1.20822,14.12.2012 10:00:00,,0.0,-211.38000000000466,0.0,0.0,1.20769,14.12.2012 01:15:00,8596,-0.1067496611867383,19.55,IS,0.34,0.0,Phase3-EA-S4v1-EURCHF-M15-221,EURCHFMT4,2244,8h 45m,Buy
108000.75,136035,17.12.2012 02:00:00,tp 136.035,-1.95,-13.929999999993015,0.0,0.0,134185,12.12.2012 19:30:00,8597,-0.007034831962960006,197.45,IS,0.09,0.0,Phase3-EA-B1v1-GBPJPY-M30-1,GBPJPYMT4,826,4d 6h 30m,Buy
108135.5,110569,17.12.2012 02:00:00,tp 110.569,-1.06,-0.0,0.0,0.0,109309,13.12.2012 07:00:00,8598,-0.0,134.75,IS,0.09,0.0,Phase3-EA-TR1v1-EURJPY-M30-91,EURJPYMT4,1442,3d 19h 0m,Buy
108198.68,0.91804,17.12.2012 02:44:58,tp 0.91804,0.0,-0.0,0.0,0.0,0.91704,17.12.2012 02:15:00,8599,-0.0,63.18,IS,0.58,0.0,Phase3-EA-SA2v2-USDCHF-M15-107,USDCHFMT4,1704,29m 58s,Buy
108157.63,1.20861,17.12.2012 07:10:00,,-2.23,-41.04999999998836,0.0,0.0,1.20774,14.12.2012 22:50:00,8600,-0.020711540561212737,-41.05,IS,0.41,0.0,Phase3-EA-SA2v2-EURCHF-M5-43,EURCHFMT4,4502,2d 8h 20m,Sell
108148.05,135857,17.12.2012 07:45:00,,0.0,-50.62999999997555,0.0,0.0,135822,17.12.2012 02:20:00,8601,-0.025545074265870694,-9.58,IS,0.23,0.0,Phase3-EA-S4v1-GBPJPY-M5-194,GBPJPYMT4,2044,5h 25m,Sell
107990.94,83954,17.12.2012 10:15:00,,-1.45,-207.73999999996158,0.0,0.0,83.47,14.12.2012 23:15:00,8602,-0.10481401793390399,-157.11,IS,0.27,0.0,Phase3-EA-S1v2-USDJPY-M15-0,USDJPYMT4,2452,2d 11h 0m,Sell
108030.95,1.20774,17.12.2012 11:45:00,,0.0,-167.72999999995227,0.0,0.0,1.20882,17.12.2012 03:00:00,8603,-0.08462720336984675,40.01,IS,0.34,0.0,Phase3-EA-S4v1-EURCHF-M15-221,EURCHFMT4,2246,8h 45m,Sell
108145.38,110265,17.12.2012 12:15:00,,-1.0,-53.299999999959255,0.0,0.0,109696,14.12.2012 20:00:00,8604,-0.02689220735474076,114.43,IS,0.17,0.0,Phase3-EA-T1v2-EURJPY-M15-322,EURJPYMT4,1432,2d 16h 15m,Buy
108167.0,83659,17.12.2012 18:30:00,,0.0,-31.67999999996391,0.0,0.0,83726,17.12.2012 18:15:00,8605,-0.01598396114442529,21.62,IS,0.27,0.0,Phase3-EA-S1v2-USDJPY-M15-0,USDJPYMT4,2454,15m 0s,Sell
108101.83,136166,18.12.2012 08:35:00,,0.0,-96.84999999997672,0.0,0.0,135928,18.12.2012 03:10:00,8606,-0.04886510848607894,-65.17,IS,0.23,0.0,Phase3-EA-S4v1-GBPJPY-M5-194,GBPJPYMT4,2046,5h 25m,Sell
108080.39,1.20843,18.12.2012 10:55:00,,0.0,-118.28999999997905,0.0,0.0,1.20795,18.12.2012 02:35:00,8607,-0.05968253673534995,-21.44,IS,0.41,0.0,Phase3-EA-SA2v2-EURCHF-M5-43,EURCHFMT4,4504,8h 20m,Sell
108085.58,1.2078,18.12.2012 12:15:00,,0.0,-113.09999999997672,0.0,0.0,1.20794,18.12.2012 03:30:00,8608,-0.05706395219179885,5.19,IS,0.34,0.0,Phase3-EA-S4v1-EURCHF-M15-221,EURCHFMT4,2248,8h 45m,Sell
108001.56,111152,18.12.2012 19:29:58,sl 111.152,-0.38,-197.11999999996624,0.0,0.0,110372,17.12.2012 12:00:00,8609,-0.09945575823207585,-84.02,IS,0.09,0.0,Phase3-EA-TR1v1-EURJPY-M30-91,EURJPYMT4,1444,1d 7h 29m,Sell
108015.04,1.20758,19.12.2012 04:35:00,,-2.24,-183.63999999995576,0.0,0.0,1.20793,18.12.2012 20:15:00,8610,-0.09265450203803337,13.48,IS,0.41,0.0,Phase3-EA-SA2v2-EURCHF-M5-43,EURCHFMT4,4506,8h 20m,Sell
108011.22,136998,19.12.2012 07:55:00,,0.0,-187.45999999996275,0.0,0.0,136984,19.12.2012 02:30:00,8611,-0.09458186098916613,-3.82,IS,0.23,0.0,Phase3-EA-S4v1-GBPJPY-M5-194,GBPJPYMT4,2048,5h 25m,Sell
108145.13,111885,19.12.2012 12:59:58,tp 111.885,-0.52,-53.549999999959255,0.0,0.0,110625,18.12.2012 06:30:00,8612,-0.027018343411751834,133.91,IS,0.09,0.0,Phase3-EA-TR1v1-EURJPY-M30-91,EURJPYMT4,1445,1d 6h 29m,Buy
108486.25,112311,19.12.2012 15:59:57,tp 112.311,-0.99,-0.0,0.0,0.0,110611,18.12.2012 13:30:00,8613,-0.0,341.12,IS,0.17,0.0,Phase3-EA-T1v2-EURJPY-M15-322,EURJPYMT4,1434,1d 2h 29m,Buy
108409.35,111.68,19.12.2012 18:59:57,sl 111.680,0.0,-76.89999999999418,0.0,0.0,112.4,19.12.2012 16:30:00,8614,-0.038743237881714195,-76.9,IS,0.09,0.0,Phase3-EA-TR1v1-EURJPY-M30-91,EURJPYMT4,1448,2h 29m,Buy
108350.9,1.20723,20.12.2012 05:30:00,,-3.24,-135.35000000000582,0.0,0.0,1.20846,19.12.2012 21:10:00,8615,-0.06819112155124368,-58.45,IS,0.41,0.0,Phase3-EA-SA2v2-EURCHF-M5-43,EURCHFMT4,4508,8h 20m,Buy
108405.79,136914,20.12.2012 06:50:00,,0.0,-80.45999999999185,0.0,0.0,136713,20.12.2012 01:25:00,8616,-0.040536813003415405,54.89,IS,0.23,0.0,Phase3-EA-S4v1-GBPJPY-M5-194,GBPJPYMT4,2050,5h 25m,Buy
108411.74,1.20813,20.12.2012 09:45:00,,0.0,-74.50999999998021,0.0,0.0,1.20797,20.12.2012 01:00:00,8617,-0.03753912424663168,5.95,IS,0.34,0.0,Phase3-EA-S4v1-EURCHF-M15-221,EURCHFMT4,2250,8h 45m,Buy
108456.52,84419,20.12.2012 22:00:00,,0.0,-29.729999999981374,0.0,0.0,84279,20.12.2012 20:30:00,8618,-0.014978367519151216,44.78,IS,0.27,0.0,Phase3-EA-S1v2-USDJPY-M15-0,USDJPYMT4,2456,1h 30m,Buy
108520.07,0.9126,21.12.2012 03:14:58,tp 0.91260,0.0,-0.0,0.0,0.0,0.9116,21.12.2012 00:45:00,8619,-0.0,63.55,IS,0.58,0.0,Phase3-EA-SA2v2-USDCHF-M15-107,USDCHFMT4,1706,2h 29m,Buy
108550.21,1.20775,21.12.2012 13:30:00,,0.0,-0.0,0.0,0.0,1.20694,21.12.2012 04:45:00,8620,-0.0,30.14,IS,0.34,0.0,Phase3-EA-S4v1-EURCHF-M15-221,EURCHFMT4,2252,8h 45m,Buy
108552.0,1.20791,24.12.2012 05:10:00,,-2.24,-0.0,0.0,0.0,1208,21.12.2012 20:50:00,8621,-0.0,1.79,IS,0.41,0.0,Phase3-EA-SA2v2-EURCHF-M5-43,EURCHFMT4,4510,2d 8h 20m,Sell
108474.8,111512,24.12.2012 11:29:58,sl 111.512,-0.37,-77.20000000001164,0.0,0.0,110792,21.12.2012 07:00:00,8622,-0.038881502075028905,-77.2,IS,0.09,0.0,Phase3-EA-TR1v1-EURJPY-M30-91,EURJPYMT4,1450,3d 4h 29m,Sell
108607.26,112881,26.12.2012 14:29:58,tp 112.881,-0.52,-0.0,0.0,0.0,111621,24.12.2012 14:00:00,8623,-0.0,132.46,IS,0.09,0.0,Phase3-EA-TR1v1-EURJPY-M30-91,EURJPYMT4,1452,2d 0h 29m,Buy
108636.96,85442,26.12.2012 18:45:00,,0.0,-0.0,0.0,0.0,85348,26.12.2012 17:00:00,8624,-0.0,29.7,IS,0.27,0.0,Phase3-EA-S1v2-USDJPY-M15-0,USDJPYMT4,2458,1h 45m,Buy
108829.38,138063,26.12.2012 18:59:58,tp 138.063,-2.67,-0.0,0.0,0.0,136213,18.12.2012 08:00:00,8625,-0.0,192.42,IS,0.09,0.0,Phase3-EA-B1v1-GBPJPY-M30-1,GBPJPYMT4,828,8d 10h 59m,Buy
108850.3,85.68,27.12.2012 03:00:00,,-3.66,-0.0,0.0,0.0,85602,26.12.2012 23:45:00,8626,-0.0,20.92,IS,0.27,0.0,Phase3-EA-S1v2-USDJPY-M15-0,USDJPYMT4,2460,3h 15m,Buy
108766.9,113444,27.12.2012 03:29:57,sl 113.444,-1.47,-83.39999999999418,0.0,0.0,112664,26.12.2012 16:30:00,8627,-0.041941098404173344,-83.4,IS,0.09,0.0,Phase3-EA-TR1v1-EURJPY-M30-91,EURJPYMT4,1454,10h 59m,Sell
108708.89,138286,27.12.2012 04:45:00,,-6.23,-141.4100000000035,0.0,0.0,138093,26.12.2012 23:20:00,8628,-0.07111379766588385,-58.01,IS,0.23,0.0,Phase3-EA-S4v1-GBPJPY-M5-194,GBPJPYMT4,2052,5h 25m,Sell
108758.3,1.20855,27.12.2012 08:09:58,tp 1.20855,0.0,-92.0,0.0,0.0,1.20745,27.12.2012 01:35:00,8629,-0.04626595987031435,49.41,IS,0.41,0.0,Phase3-EA-SA2v2-EURCHF-M5-43,EURCHFMT4,4512,6h 34m,Buy
108762.35,1.20856,28.12.2012 04:20:00,,-2.24,-87.95000000001164,0.0,0.0,1.2087,27.12.2012 20:00:00,8630,-0.04422925185429006,4.05,IS,0.41,0.0,Phase3-EA-SA2v2-EURCHF-M5-43,EURCHFMT4,4514,8h 20m,Sell
108673.42,139177,28.12.2012 07:10:00,,0.0,-176.88000000000466,0.0,0.0,138843,28.12.2012 01:45:00,8631,-0.08895133675936323,-88.93,IS,0.23,0.0,Phase3-EA-S4v1-GBPJPY-M5-194,GBPJPYMT4,2054,5h 25m,Sell
108638.3,113873,28.12.2012 11:30:00,,-0.97,-212.0,0.0,0.0,114046,27.12.2012 23:45:00,8632,-0.10661286404898525,-35.12,IS,0.17,0.0,Phase3-EA-T1v2-EURJPY-M15-322,EURJPYMT4,1436,11h 45m,Buy
108648.18,1.20703,31.12.2012 06:55:00,,-2.24,-202.11999999999534,0.0,0.0,1.2073,28.12.2012 22:35:00,8633,-0.10164430227160566,9.88,IS,0.41,0.0,Phase3-EA-SA2v2-EURCHF-M5-43,EURCHFMT4,4516,2d 8h 20m,Sell
108706.22,138969,31.12.2012 07:30:00,,0.0,-144.0799999999872,0.0,0.0,138752,31.12.2012 02:05:00,8634,-0.07245651628385108,58.04,IS,0.23,0.0,Phase3-EA-S4v1-GBPJPY-M5-194,GBPJPYMT4,2056,5h 25m,Buy
108896.63,139941,31.12.2012 17:29:58,tp 139.941,-2.27,-0.0,0.0,0.0,138091,26.12.2012 19:00:00,8635,-0.0,190.41,IS,0.09,0.0,Phase3-EA-B1v1-GBPJPY-M30-1,GBPJPYMT4,830,4d 22h 29m,Buy
108864.82,1.20786,02.01.2013 01:00:00,,-2.24,-31.80999999999767,0.0,0.0,1.2072,31.12.2012 20:35:00,8636,-0.01599323226341118,-31.81,IS,0.41,0.0,Phase3-EA-SA2v2-EURCHF-M5-43,EURCHFMT4,4518,1d 4h 25m,Sell
108994.0,114813,02.01.2013 04:29:57,tp 114.813,-1.53,-0.0,0.0,0.0,113553,27.12.2012 07:30:00,8637,-0.0,129.18,IS,0.09,0.0,Phase3-EA-TR1v1-EURJPY-M30-91,EURJPYMT4,1456,5d 20h 59m,Buy
109043.61,1207,02.01.2013 04:54:58,tp 1.20700,0.0,-0.0,0.0,0.0,1.2081,02.01.2013 01:15:00,8638,-0.0,49.61,IS,0.41,0.0,Phase3-EA-SA2v2-EURCHF-M5-43,EURCHFMT4,4520,3h 39m,Sell
109099.79,0.91879,03.01.2013 04:30:00,,0.0,-0.0,0.0,0.0,0.9179,03.01.2013 00:15:00,8639,-0.0,56.18,IS,0.58,0.0,Phase3-EA-SA2v2-USDCHF-M15-107,USDCHFMT4,1708,4h 15m,Buy
109087.29,1.20982,03.01.2013 04:50:00,,-8.93,-12.5,0.0,0.0,1.20974,02.01.2013 20:30:00,8640,-0.006278258756576267,-12.5,IS,0.41,0.0,Phase3-EA-SA2v2-EURCHF-M5-43,EURCHFMT4,4522,8h 20m,Sell
109118.37,141545,03.01.2013 05:15:00,,-6.12,-0.0,0.0,0.0,141686,02.01.2013 23:50:00,8641,-0.0,31.08,IS,0.23,0.0,Phase3-EA-S4v1-GBPJPY-M5-194,GBPJPYMT4,2058,5h 25m,Sell
109088.13,1.20883,03.01.2013 13:30:00,,0.0,-30.239999999990687,0.0,0.0,1.20965,03.01.2013 04:45:00,8642,-0.015186946337492914,-30.24,IS,0.34,0.0,Phase3-EA-S4v1-EURCHF-M15-221,EURCHFMT4,2254,8h 45m,Buy
109017.39,140.73,03.01.2013 13:59:58,sl 140.730,-1.49,-100.97999999998137,0.0,0.0,141.4,02.01.2013 04:30:00,8643,-0.0507135529484201,-70.74,IS,0.09,0.0,Phase3-EA-B1v1-GBPJPY-M30-1,GBPJPYMT4,832,1d 9h 29m,Buy
109149.29,113938,03.01.2013 13:59:58,tp 113.938,-1.44,-0.0,0.0,0.0,115228,02.01.2013 13:30:00,8644,-0.0,131.9,IS,0.09,0.0,Phase3-EA-TR1v1-EURJPY-M30-91,EURJPYMT4,1458,1d 0h 29m,Sell
108892.26,87663,04.01.2013 02:59:58,sl 87.663,-1.39,-257.02999999999884,0.0,0.0,86833,03.01.2013 19:00:00,8645,-0.12906398009252154,-257.03,IS,0.27,0.0,Phase3-EA-S1v2-USDJPY-M15-0,USDJPYMT4,2462,7h 59m,Sell
108892.26,1.2091,04.01.2013 06:10:00,,-2.21,-257.02999999999884,0.0,0.0,1.20915,03.01.2013 21:50:00,8646,-0.12906398009252154,0.0,IS,0.41,0.0,Phase3-EA-SA2v2-EURCHF-M5-43,EURCHFMT4,4524,8h 20m,Sell
108805.49,140.98,04.01.2013 07:00:00,,0.0,-343.79999999998836,0.0,0.0,140649,04.01.2013 01:35:00,8647,-0.1726343086636097,-86.77,IS,0.23,0.0,Phase3-EA-S4v1-GBPJPY-M5-194,GBPJPYMT4,2060,5h 25m,Sell
108816.11,1.20906,04.01.2013 11:45:00,,0.0,-333.179999999993,0.0,0.0,1.20877,04.01.2013 03:00:00,8648,-0.16730162583054747,10.62,IS,0.34,0.0,Phase3-EA-S4v1-EURCHF-M15-221,EURCHFMT4,2256,8h 45m,Buy
108771.13,115052,04.01.2013 15:44:57,sl 115.052,-0.68,-378.1600000000035,0.0,0.0,114822,03.01.2013 04:15:00,8649,-0.18988769681277912,-44.98,IS,0.17,0.0,Phase3-EA-T1v2-EURJPY-M15-322,EURJPYMT4,1438,1d 11h 29m,Sell
108902.23,115333,04.01.2013 23:29:58,tp 115.333,-0.51,-247.05999999999767,0.0,0.0,114043,03.01.2013 20:30:00,8650,-0.1240576855684481,131.1,IS,0.09,0.0,Phase3-EA-TR1v1-EURJPY-M30-91,EURJPYMT4,1460,1d 2h 59m,Buy
108964.22,0.92446,07.01.2013 02:14:58,tp 0.92446,-0.75,-185.07000000000698,0.0,0.0,0.92346,04.01.2013 23:45:00,8651,-0.09293028360784333,61.99,IS,0.58,0.0,Phase3-EA-SA2v2-USDCHF-M15-107,USDCHFMT4,1710,2d 2h 29m,Buy
109066.01,141649,07.01.2013 04:14:58,tp 141.649,0.0,-83.27999999999884,0.0,0.0,141259,07.01.2013 03:30:00,8652,-0.041817874419737354,101.79,IS,0.23,0.0,Phase3-EA-S4v1-GBPJPY-M5-194,GBPJPYMT4,2062,44m 58s,Buy
109066.44,1.20869,07.01.2013 07:25:00,,-2.22,-82.85000000000582,0.0,0.0,1.20875,04.01.2013 23:05:00,8653,-0.041601955999946344,0.43,IS,0.41,0.0,Phase3-EA-SA2v2-EURCHF-M5-43,EURCHFMT4,4526,2d 8h 20m,Sell
109067.91,1.20863,07.01.2013 15:30:00,,0.0,-81.38000000000466,0.0,0.0,1.20867,07.01.2013 06:45:00,8654,-0.04086381628576451,1.47,IS,0.34,0.0,Phase3-EA-S4v1-EURCHF-M15-221,EURCHFMT4,2258,8h 45m,Sell
109168.78,141022,08.01.2013 01:44:58,tp 141.022,-1.52,-0.0,0.0,0.0,141412,07.01.2013 23:10:00,8655,-0.0,100.87,IS,0.23,0.0,Phase3-EA-S4v1-GBPJPY-M5-194,GBPJPYMT4,2064,2h 34m,Sell
109271.4,141417,08.01.2013 05:29:58,tp 141.417,0.0,-0.0,0.0,0.0,141027,08.01.2013 02:00:00,8656,-0.0,102.62,IS,0.23,0.0,Phase3-EA-S4v1-GBPJPY-M5-194,GBPJPYMT4,2066,3h 29m,Buy
109294.82,1.20892,08.01.2013 06:40:00,,-1.07,-0.0,0.0,0.0,1.20837,07.01.2013 22:20:00,8657,-0.0,23.42,IS,0.41,0.0,Phase3-EA-SA2v2-EURCHF-M5-43,EURCHFMT4,4528,8h 20m,Buy
109250.17,114.81,08.01.2013 07:44:58,sl 114.810,0.0,-44.64999999999418,0.0,0.0,115.04,08.01.2013 06:30:00,8658,-0.022403994243299467,-44.65,IS,0.17,0.0,Phase3-EA-T1v2-EURJPY-M15-322,EURJPYMT4,1440,1h 14m,Buy
109207.64,1.60458,08.01.2013 18:29:58,sl 1.60458,-0.53,-87.17999999999302,0.0,0.0,1.60758,07.01.2013 18:30:00,8659,-0.04374423780808389,-42.53,IS,0.14,0.0,Phase3-EA-B1v1-GBPUSD-M30-14,GBPUSDMT4,562,23h 59m,Buy
109340.29,113608,09.01.2013 01:59:58,tp 113.608,-0.72,-0.0,0.0,0.0,114898,07.01.2013 03:30:00,8660,-0.0,132.65,IS,0.09,0.0,Phase3-EA-TR1v1-EURJPY-M30-91,EURJPYMT4,1462,1d 22h 29m,Sell
109443.08,140203,09.01.2013 04:44:59,tp 140.203,0.0,-0.0,0.0,0.0,139813,09.01.2013 00:05:00,8661,-0.0,102.79,IS,0.23,0.0,Phase3-EA-S4v1-GBPJPY-M5-194,GBPJPYMT4,2068,4h 39m,Buy
109373.93,140305,09.01.2013 04:59:57,sl 140.305,0.0,-69.14999999999418,0.0,0.0,139635,09.01.2013 00:30:00,8662,-0.03467154638806919,-69.15,IS,0.09,0.0,Phase3-EA-B1v1-GBPJPY-M30-1,GBPJPYMT4,834,4h 29m,Sell
109373.48,1.2087,09.01.2013 07:15:00,,-2.22,-69.60000000000582,0.0,0.0,1.20874,08.01.2013 22:55:00,8663,-0.03489717467259611,-0.45,IS,0.41,0.0,Phase3-EA-SA2v2-EURCHF-M5-43,EURCHFMT4,4530,8h 20m,Sell
109367.24,1.20894,09.01.2013 14:30:00,,0.0,-75.83999999999651,0.0,0.0,1.20877,09.01.2013 05:45:00,8664,-0.038025886884617034,-6.24,IS,0.34,0.0,Phase3-EA-S4v1-EURCHF-M15-221,EURCHFMT4,2260,8h 45m,Sell
109446.75,88041,10.01.2013 01:45:00,,-2.68,-0.0,0.0,0.0,87773,09.01.2013 22:15:00,8665,-0.0,79.51,IS,0.27,0.0,Phase3-EA-S1v2-USDJPY-M15-0,USDJPYMT4,2464,3h 30m,Buy
109509.38,0.9261,10.01.2013 03:44:57,tp 0.92610,0.0,-0.0,0.0,0.0,0.9251,10.01.2013 00:30:00,8666,-0.0,62.63,IS,0.58,0.0,Phase3-EA-SA2v2-USDCHF-M15-107,USDCHFMT4,1712,3h 14m,Buy
109506.77,141005,10.01.2013 07:15:00,,0.0,-2.60999999998603,0.0,0.0,140995,10.01.2013 01:50:00,8667,-0.001308209167902793,-2.61,IS,0.23,0.0,Phase3-EA-S4v1-GBPJPY-M5-194,GBPJPYMT4,2070,5h 25m,Sell
109522.62,1.20893,10.01.2013 14:15:00,,0.0,-0.0,0.0,0.0,1.2085,10.01.2013 05:30:00,8668,-0.0,15.85,IS,0.34,0.0,Phase3-EA-S4v1-EURCHF-M15-221,EURCHFMT4,2262,8h 45m,Buy
109652.84,115613,10.01.2013 15:59:58,tp 115.613,-1.51,-0.0,0.0,0.0,114323,09.01.2013 05:00:00,8669,-0.0,130.22,IS,0.09,0.0,Phase3-EA-TR1v1-EURJPY-M30-91,EURJPYMT4,1464,1d 10h 59m,Buy
109977.59,116336,10.01.2013 16:59:58,tp 116.336,-2.85,-0.0,0.0,0.0,114636,09.01.2013 18:15:00,8670,-0.0,324.75,IS,0.17,0.0,Phase3-EA-T1v2-EURJPY-M15-322,EURJPYMT4,1442,22h 44m,Buy
110105.15,117804,11.01.2013 00:59:58,tp 117.804,-0.5,-0.0,0.0,0.0,116544,10.01.2013 20:00:00,8671,-0.0,127.56,IS,0.09,0.0,Phase3-EA-TR1v1-EURJPY-M30-91,EURJPYMT4,1466,4h 59m,Buy
109898.23,143805,11.01.2013 01:39:58,sl 143.805,0.0,-206.9200000000128,0.0,0.0,143005,11.01.2013 00:20:00,8672,-0.10340563448767415,-206.92,IS,0.23,0.0,Phase3-EA-S4v1-GBPJPY-M5-194,GBPJPYMT4,2072,1h 19m,Sell
110085.18,143973,11.01.2013 01:59:57,tp 143.973,-0.37,-19.970000000001164,0.0,0.0,142123,10.01.2013 18:30:00,8673,-0.009979753144784676,186.95,IS,0.09,0.0,Phase3-EA-B1v1-GBPJPY-M30-1,GBPJPYMT4,836,7h 29m,Buy
110185.9,143728,11.01.2013 04:24:59,tp 143.728,0.0,-0.0,0.0,0.0,144118,11.01.2013 03:05:00,8674,-0.0,100.72,IS,0.23,0.0,Phase3-EA-S4v1-GBPJPY-M5-194,GBPJPYMT4,2074,1h 19m,Sell
110099.46,1.21376,11.01.2013 07:25:00,,-2.24,-86.44000000000233,0.0,0.0,1.21188,10.01.2013 23:05:00,8675,-0.04317986431611918,-86.44,IS,0.41,0.0,Phase3-EA-SA2v2-EURCHF-M5-43,EURCHFMT4,4532,8h 20m,Sell
110059.74,1.21385,11.01.2013 10:00:00,,0.0,-126.16000000000349,0.0,0.0,1.21278,11.01.2013 01:15:00,8676,-0.06302142158863488,-39.72,IS,0.34,0.0,Phase3-EA-S4v1-EURCHF-M15-221,EURCHFMT4,2264,8h 45m,Sell
110187.17,119078,11.01.2013 17:29:58,tp 119.078,0.0,-0.0,0.0,0.0,117818,11.01.2013 01:00:00,8677,-0.0,127.43,IS,0.09,0.0,Phase3-EA-TR1v1-EURJPY-M30-91,EURJPYMT4,1468,16h 29m,Buy
110307.0,89467,14.01.2013 02:00:00,tp 89.467,-0.88,-0.0,0.0,0.0,89067,11.01.2013 21:15:00,8678,-0.0,119.83,IS,0.27,0.0,Phase3-EA-S1v2-USDJPY-M15-0,USDJPYMT4,2466,2d 4h 45m,Buy
110141.39,1222,14.01.2013 05:15:00,,-2.24,-165.60999999998603,0.0,0.0,1.21836,11.01.2013 20:55:00,8679,-0.08267808913317332,-165.61,IS,0.41,0.0,Phase3-EA-SA2v2-EURCHF-M5-43,EURCHFMT4,4534,2d 8h 20m,Sell
110101.33,144557,14.01.2013 07:50:00,,0.0,-205.6699999999837,0.0,0.0,144401,14.01.2013 02:25:00,8680,-0.10267739020602526,-40.06,IS,0.23,0.0,Phase3-EA-S4v1-GBPJPY-M5-194,GBPJPYMT4,2076,5h 25m,Sell
110038.9,1.22214,14.01.2013 12:00:00,,0.0,-268.0999999999767,0.0,0.0,1.22046,14.01.2013 03:15:00,8681,-0.1338445486178595,-62.43,IS,0.34,0.0,Phase3-EA-S4v1-EURCHF-M15-221,EURCHFMT4,2266,8h 45m,Sell
110207.07,119376,14.01.2013 12:15:00,,-0.93,-99.92999999996391,0.0,0.0,118487,11.01.2013 16:30:00,8682,-0.04988842127332723,168.17,IS,0.17,0.0,Phase3-EA-T1v2-EURJPY-M15-322,EURJPYMT4,1444,2d 19h 45m,Buy
110062.21,0.92212,15.01.2013 02:15:00,,-3.34,-244.78999999994994,0.0,0.0,0.91987,14.01.2013 22:00:00,8683,-0.12220741162313305,-144.86,IS,0.58,0.0,Phase3-EA-SA2v2-USDCHF-M15-107,USDCHFMT4,1714,4h 15m,Sell
109842.14,1.23421,15.01.2013 02:59:58,sl 1.23421,-2.23,-464.8599999999569,0.0,0.0,1.22931,14.01.2013 21:55:00,8684,-0.23207376676798883,-220.07,IS,0.41,0.0,Phase3-EA-SA2v2-EURCHF-M5-43,EURCHFMT4,4536,5h 4m,Sell
109698.57,1.23736,15.01.2013 04:44:58,sl 1.23736,0.0,-608.4299999999639,0.0,0.0,1.23346,15.01.2013 01:30:00,8685,-0.30374874567536925,-143.57,IS,0.34,0.0,Phase3-EA-S4v1-EURCHF-M15-221,EURCHFMT4,2268,3h 14m,Sell
109828.73,118511,15.01.2013 09:59:58,tp 118.511,-0.35,-478.2699999999604,0.0,0.0,119801,14.01.2013 10:30:00,8686,-0.23876849036726566,130.16,IS,0.09,0.0,Phase3-EA-TR1v1-EURJPY-M30-91,EURJPYMT4,1470,23h 29m,Sell
109975.91,1.23222,15.01.2013 10:29:57,tp 1.23222,0.0,-331.0899999999674,0.0,0.0,1.23622,15.01.2013 06:00:00,8687,-0.1652912778884244,147.18,IS,0.34,0.0,Phase3-EA-S4v1-EURCHF-M15-221,EURCHFMT4,2270,4h 29m,Sell
109987.5,88.78,16.01.2013 01:45:00,,-0.88,-319.4999999999709,0.0,0.0,88739,15.01.2013 22:00:00,8688,-0.15950515958002956,11.59,IS,0.27,0.0,Phase3-EA-S1v2-USDJPY-M15-0,USDJPYMT4,2468,3h 45m,Buy
110035.95,1.23844,16.01.2013 04:09:58,tp 1.23844,0.0,-271.04999999995925,0.0,0.0,1.23954,16.01.2013 02:05:00,8689,-0.13531728796295603,48.45,IS,0.41,0.0,Phase3-EA-SA2v2-EURCHF-M5-43,EURCHFMT4,4538,2h 4m,Sell
110362.03,117256,16.01.2013 04:29:58,tp 117.256,-0.67,-0.0,0.0,0.0,118956,15.01.2013 06:15:00,8690,-0.0,326.08,IS,0.17,0.0,Phase3-EA-T1v2-EURJPY-M15-322,EURJPYMT4,1446,22h 14m,Sell
110282.23,117487,16.01.2013 04:29:58,sl 117.487,-0.5,-79.79999999998836,0.0,0.0,118267,15.01.2013 20:00:00,8691,-0.03982790551682277,-79.8,IS,0.09,0.0,Phase3-EA-TR1v1-EURJPY-M30-91,EURJPYMT4,1472,8h 29m,Buy
110214.07,141874,16.01.2013 19:29:58,sl 141.874,0.0,-147.95999999999185,0.0,0.0,141204,16.01.2013 11:00:00,8692,-0.07384632707104802,-68.16,IS,0.09,0.0,Phase3-EA-B1v1-GBPJPY-M30-1,GBPJPYMT4,838,8h 29m,Sell
110140.82,117905,16.01.2013 19:29:58,sl 117.905,0.0,-221.20999999999185,0.0,0.0,117185,16.01.2013 09:00:00,8693,-0.11040515011751033,-73.25,IS,0.09,0.0,Phase3-EA-TR1v1-EURJPY-M30-91,EURJPYMT4,1474,10h 29m,Sell
110189.19,1.23787,16.01.2013 20:54:58,tp 1.23787,0.0,-172.8399999999965,0.0,0.0,1.23897,16.01.2013 20:25:00,8694,-0.0862638494928385,48.37,IS,0.41,0.0,Phase3-EA-SA2v2-EURCHF-M5-43,EURCHFMT4,4540,29m 58s,Sell
110210.0,88.57,17.01.2013 02:15:00,,-2.66,-152.02999999999884,0.0,0.0,88493,16.01.2013 23:00:00,8695,-0.07587765007172183,20.81,IS,0.27,0.0,Phase3-EA-S1v2-USDJPY-M15-0,USDJPYMT4,2470,3h 15m,Buy
110272.25,0.93167,17.01.2013 03:14:58,tp 0.93167,0.0,-89.77999999999884,0.0,0.0,0.93067,17.01.2013 00:30:00,8696,-0.04480888918923338,62.25,IS,0.58,0.0,Phase3-EA-SA2v2-USDCHF-M15-107,USDCHFMT4,1716,2h 44m,Buy
110373.72,141276,17.01.2013 06:19:57,tp 141.276,0.0,-0.0,0.0,0.0,141666,17.01.2013 02:05:00,8697,-0.0,101.47,IS,0.23,0.0,Phase3-EA-S4v1-GBPJPY-M5-194,GBPJPYMT4,2078,4h 14m,Sell
110231.6,1.24232,17.01.2013 10:59:58,sl 1.24232,0.0,-142.11999999999534,0.0,0.0,1.23842,17.01.2013 04:45:00,8698,-0.07092746493901238,-142.12,IS,0.34,0.0,Phase3-EA-S4v1-EURCHF-M15-221,EURCHFMT4,2272,6h 14m,Sell
110555.18,119492,17.01.2013 14:44:58,tp 119.492,0.0,-0.0,0.0,0.0,117792,17.01.2013 09:45:00,8699,-0.0,323.58,IS,0.17,0.0,Phase3-EA-T1v2-EURJPY-M15-322,EURJPYMT4,1448,4h 59m,Buy
110564.24,89421,17.01.2013 19:15:00,,0.0,-0.0,0.0,0.0,89391,17.01.2013 18:00:00,8700,-0.0,9.06,IS,0.27,0.0,Phase3-EA-S1v2-USDJPY-M15-0,USDJPYMT4,2472,1h 15m,Buy
110612.57,1.24706,17.01.2013 23:54:58,tp 1.24706,0.0,-0.0,0.0,0.0,1.24816,17.01.2013 20:35:00,8701,-0.0,48.33,IS,0.41,0.0,Phase3-EA-SA2v2-EURCHF-M5-43,EURCHFMT4,4542,3h 19m,Sell
110710.8,143515,18.01.2013 02:39:58,tp 143.515,-1.48,-0.0,0.0,0.0,143905,17.01.2013 23:05:00,8702,-0.0,98.23,IS,0.23,0.0,Phase3-EA-S4v1-GBPJPY-M5-194,GBPJPYMT4,2080,3h 34m,Sell
110496.16,1.25313,18.01.2013 06:19:58,sl 1.25313,0.0,-214.64000000001397,0.0,0.0,1.24823,18.01.2013 02:20:00,8703,-0.10693993546934856,-214.64,IS,0.41,0.0,Phase3-EA-SA2v2-EURCHF-M5-43,EURCHFMT4,4544,3h 59m,Sell
110354.58,1.25451,18.01.2013 06:44:58,sl 1.25451,0.0,-356.22000000000116,0.0,0.0,1.25061,18.01.2013 04:45:00,8704,-0.17747923878535682,-141.58,IS,0.34,0.0,Phase3-EA-S4v1-EURCHF-M15-221,EURCHFMT4,2274,1h 59m,Sell
110311.08,120194,18.01.2013 07:29:57,sl 120.194,0.0,-399.72000000000116,0.0,0.0,120424,18.01.2013 07:00:00,8705,-0.19915221303487396,-43.5,IS,0.17,0.0,Phase3-EA-T1v2-EURJPY-M15-322,EURJPYMT4,1450,29m 57s,Buy
110571.55,1.59212,18.01.2013 15:59:58,tp 1.59212,-4.13,-139.25,0.0,0.0,1.61102,14.01.2013 14:00:00,8706,-0.06937842906310947,260.47,IS,0.14,0.0,Phase3-EA-B1v1-GBPUSD-M30-14,GBPUSDMT4,564,4d 1h 59m,Sell
110504.02,142715,18.01.2013 18:29:58,sl 142.715,-0.36,-206.77999999999884,0.0,0.0,143385,17.01.2013 20:30:00,8707,-0.10302385322563516,-67.53,IS,0.09,0.0,Phase3-EA-B1v1-GBPJPY-M30-1,GBPJPYMT4,840,21h 59m,Buy
110550.1,1.24353,21.01.2013 03:24:58,tp 1.24353,-2.19,-160.70000000001164,0.0,0.0,1.24463,18.01.2013 22:05:00,8708,-0.08006544739994614,46.08,IS,0.41,0.0,Phase3-EA-SA2v2-EURCHF-M5-43,EURCHFMT4,4546,2d 5h 19m,Sell
110469.23,142176,21.01.2013 08:55:00,,0.0,-241.57000000000698,0.0,0.0,142491,21.01.2013 03:30:00,8709,-0.12035725033232202,-80.87,IS,0.23,0.0,Phase3-EA-S4v1-GBPJPY-M5-194,GBPJPYMT4,2082,5h 25m,Buy
110568.24,142217,22.01.2013 01:54:58,tp 142.217,-0.92,-142.55999999999767,0.0,0.0,141827,21.01.2013 23:45:00,8710,-0.07102756802324399,99.01,IS,0.23,0.0,Phase3-EA-S4v1-GBPJPY-M5-194,GBPJPYMT4,2084,2h 9m,Buy
110592.02,89814,22.01.2013 02:00:00,,-0.87,-118.77999999999884,0.0,0.0,89732,21.01.2013 23:00:00,8711,-0.05917967543350853,23.78,IS,0.27,0.0,Phase3-EA-S1v2-USDJPY-M15-0,USDJPYMT4,2474,3h 0m,Buy
110692.24,141824,22.01.2013 03:04:58,tp 141.824,0.0,-18.55999999999767,0.0,0.0,142214,22.01.2013 02:00:00,8712,-0.009247135679792821,100.22,IS,0.23,0.0,Phase3-EA-S4v1-GBPJPY-M5-194,GBPJPYMT4,2086,1h 4m,Sell
110792.47,142254,22.01.2013 06:39:57,tp 142.254,0.0,-0.0,0.0,0.0,141864,22.01.2013 03:15:00,8713,-0.0,100.23,IS,0.23,0.0,Phase3-EA-S4v1-GBPJPY-M5-194,GBPJPYMT4,2088,3h 24m,Buy
110748.16,119.77,22.01.2013 06:59:58,sl 119.770,-0.66,-44.30999999999767,0.0,0.0,119.54,21.01.2013 04:00:00,8714,-0.022067560601250393,-44.31,IS,0.17,0.0,Phase3-EA-T1v2-EURJPY-M15-322,EURJPYMT4,1452,1d 2h 59m,Sell
110796.68,1.24089,22.01.2013 07:34:58,tp 1.24089,0.0,-0.0,0.0,0.0,1.24199,22.01.2013 02:40:00,8715,-0.0,48.52,IS,0.41,0.0,Phase3-EA-SA2v2-EURCHF-M5-43,EURCHFMT4,4548,4h 54m,Sell
110722.57,118732,22.01.2013 07:59:58,sl 118.732,-1.47,-74.10999999998603,0.0,0.0,119452,17.01.2013 15:30:00,8716,-0.036907980749475426,-74.11,IS,0.09,0.0,Phase3-EA-TR1v1-EURJPY-M30-91,EURJPYMT4,1476,4d 16h 29m,Buy
110868.69,1.23886,22.01.2013 12:14:58,tp 1.23886,0.0,-0.0,0.0,0.0,1.24286,22.01.2013 04:00:00,8717,-0.0,146.12,IS,0.34,0.0,Phase3-EA-S4v1-EURCHF-M15-221,EURCHFMT4,2276,8h 14m,Sell
110925.04,88638,22.01.2013 18:45:00,,0.0,-0.0,0.0,0.0,88823,22.01.2013 17:00:00,8718,-0.0,56.35,IS,0.27,0.0,Phase3-EA-S1v2-USDJPY-M15-0,USDJPYMT4,2476,1h 45m,Sell
110927.02,88684,23.01.2013 02:30:00,,-1.37,-0.0,0.0,0.0,88695,22.01.2013 23:45:00,8719,-0.0,1.98,IS,0.27,0.0,Phase3-EA-S1v2-USDJPY-M15-0,USDJPYMT4,2478,2h 45m,Sell
111028.18,140508,23.01.2013 04:04:58,tp 140.508,0.0,-0.0,0.0,0.0,140118,23.01.2013 02:55:00,8720,-0.0,101.16,IS,0.23,0.0,Phase3-EA-S4v1-GBPJPY-M5-194,GBPJPYMT4,2090,1h 9m,Buy
110984.13,118175,23.01.2013 04:14:58,sl 118.175,0.0,-44.04999999998836,0.0,0.0,117945,23.01.2013 03:15:00,8721,-0.021912350795788033,-44.05,IS,0.17,0.0,Phase3-EA-T1v2-EURJPY-M15-322,EURJPYMT4,1454,59m 58s,Sell
110912.26,1.23844,23.01.2013 05:45:00,,-2.21,-115.9199999999837,0.0,0.0,1.23686,22.01.2013 21:25:00,8722,-0.05766355741766318,-71.87,IS,0.41,0.0,Phase3-EA-SA2v2-EURCHF-M5-43,EURCHFMT4,4550,8h 20m,Sell
110937.89,1.2376,23.01.2013 13:45:00,,0.0,-90.28999999997905,0.0,0.0,1.2383,23.01.2013 05:00:00,8723,-0.044914101097656416,25.63,IS,0.34,0.0,Phase3-EA-S4v1-EURCHF-M15-221,EURCHFMT4,2278,8h 45m,Sell
110893.7,118275,23.01.2013 15:29:58,sl 118.275,0.0,-134.47999999998137,0.0,0.0,118045,23.01.2013 06:15:00,8724,-0.06689609387100898,-44.19,IS,0.17,0.0,Phase3-EA-T1v2-EURJPY-M15-322,EURJPYMT4,1456,9h 14m,Sell
110849.49,117825,23.01.2013 20:14:57,sl 117.825,0.0,-178.68999999997322,0.0,0.0,117595,23.01.2013 19:45:00,8725,-0.08888803549829312,-44.21,IS,0.17,0.0,Phase3-EA-T1v2-EURJPY-M15-322,EURJPYMT4,1458,29m 57s,Sell
110855.59,88563,23.01.2013 21:30:00,,0.0,-172.5899999999674,0.0,0.0,88543,23.01.2013 20:45:00,8726,-0.08585363504756735,6.1,IS,0.27,0.0,Phase3-EA-S1v2-USDJPY-M15-0,USDJPYMT4,2480,45m 0s,Buy
110897.48,1.23629,24.01.2013 04:24:59,tp 1.23629,-6.62,-130.69999999995343,0.0,0.0,1.23739,23.01.2013 21:40:00,8727,-0.06501576047694058,41.89,IS,0.41,0.0,Phase3-EA-SA2v2-EURCHF-M5-43,EURCHFMT4,4552,6h 44m,Sell
110998.6,140497,24.01.2013 05:44:58,tp 140.497,0.0,-29.57999999995809,0.0,0.0,140107,24.01.2013 02:15:00,8728,-0.014714354972500862,101.12,IS,0.23,0.0,Phase3-EA-S4v1-GBPJPY-M5-194,GBPJPYMT4,2092,3h 29m,Buy
111144.88,1.24048,24.01.2013 09:44:58,tp 1.24048,0.0,-0.0,0.0,0.0,1.23648,24.01.2013 04:45:00,8729,-0.0,146.28,IS,0.34,0.0,Phase3-EA-S4v1-EURCHF-M15-221,EURCHFMT4,2280,4h 59m,Buy
111273.45,119159,24.01.2013 09:59:58,tp 119.159,-1.49,-0.0,0.0,0.0,117869,23.01.2013 13:30:00,8730,-0.0,128.57,IS,0.09,0.0,Phase3-EA-TR1v1-EURJPY-M30-91,EURJPYMT4,1478,20h 29m,Buy
111362.94,90207,24.01.2013 23:30:00,,0.0,-0.0,0.0,0.0,89908,24.01.2013 21:30:00,8731,-0.0,89.49,IS,0.27,0.0,Phase3-EA-S1v2-USDJPY-M15-0,USDJPYMT4,2482,2h 0m,Buy
111424.62,0.92909,25.01.2013 00:59:57,tp 0.92909,-0.75,-0.0,0.0,0.0,0.92809,24.01.2013 23:15:00,8732,-0.0,61.68,IS,0.58,0.0,Phase3-EA-SA2v2-USDCHF-M15-107,USDCHFMT4,1718,1h 44m,Buy
111472.06,1.24322,25.01.2013 02:39:58,tp 1.24322,-1.06,-0.0,0.0,0.0,1.24212,24.01.2013 21:05:00,8733,-0.0,47.44,IS,0.41,0.0,Phase3-EA-SA2v2-EURCHF-M5-43,EURCHFMT4,4554,5h 34m,Buy
111403.91,142579,25.01.2013 05:00:00,,-1.48,-68.14999999999418,0.0,0.0,142317,24.01.2013 23:35:00,8734,-0.03382603026940506,-68.15,IS,0.23,0.0,Phase3-EA-S4v1-GBPJPY-M5-194,GBPJPYMT4,2094,5h 25m,Sell
111332.78,1.24437,25.01.2013 11:05:00,,0.0,-139.27999999999884,0.0,0.0,1.24276,25.01.2013 02:45:00,8735,-0.06913117382132208,-71.13,IS,0.41,0.0,Phase3-EA-SA2v2-EURCHF-M5-43,EURCHFMT4,4556,8h 20m,Sell
111457.49,121571,25.01.2013 11:59:58,tp 121.571,-0.49,-14.570000000006985,0.0,0.0,120311,24.01.2013 19:30:00,8736,-0.007231771988635511,124.71,IS,0.09,0.0,Phase3-EA-TR1v1-EURJPY-M30-91,EURJPYMT4,1480,16h 29m,Buy
111415.49,1.57725,25.01.2013 12:59:57,sl 1.57725,0.0,-56.570000000006985,0.0,0.0,1.58025,25.01.2013 11:30:00,8737,-0.028078335030677092,-42.0,IS,0.14,0.0,Phase3-EA-B1v1-GBPUSD-M30-14,GBPUSDMT4,566,1h 29m,Buy
111471.24,91055,25.01.2013 20:30:00,,0.0,-0.8200000000069849,0.0,0.0,90867,25.01.2013 18:15:00,8738,-4.07004326062374E-4,55.75,IS,0.27,0.0,Phase3-EA-S1v2-USDJPY-M15-0,USDJPYMT4,2484,2h 15m,Buy
111519.93,1.24721,25.01.2013 22:44:57,tp 1.24721,0.0,-0.0,0.0,0.0,1.24831,25.01.2013 20:30:00,8739,-0.0,48.69,IS,0.41,0.0,Phase3-EA-SA2v2-EURCHF-M5-43,EURCHFMT4,4558,2h 14m,Sell
111568.54,1.24856,28.01.2013 02:54:59,tp 1.24856,0.0,-0.0,0.0,0.0,1.24966,28.01.2013 02:25:00,8740,-0.0,48.61,IS,0.41,0.0,Phase3-EA-SA2v2-EURCHF-M5-43,EURCHFMT4,4560,29m 59s,Sell
111525.66,122635,28.01.2013 03:14:57,sl 122.635,0.0,-42.88000000000466,0.0,0.0,122865,28.01.2013 02:30:00,8741,-0.021273160980381414,-42.88,IS,0.17,0.0,Phase3-EA-T1v2-EURJPY-M15-322,EURJPYMT4,1460,44m 57s,Buy
111458.76,142272,28.01.2013 19:29:58,sl 142.272,-0.36,-109.77999999999884,0.0,0.0,142942,25.01.2013 11:00:00,8742,-0.05446286409575544,-66.9,IS,0.09,0.0,Phase3-EA-B1v1-GBPJPY-M30-1,GBPJPYMT4,842,3d 8h 29m,Buy
111469.03,90708,29.01.2013 01:15:00,,-1.34,-99.51000000000931,0.0,0.0,90747,28.01.2013 23:15:00,8743,-0.04936782297476032,10.27,IS,0.27,0.0,Phase3-EA-S1v2-USDJPY-M15-0,USDJPYMT4,2486,2h 0m,Sell
111455.76,0.9262,29.01.2013 03:30:00,,-0.75,-112.77999999999884,0.0,0.0,0.9264,28.01.2013 23:15:00,8744,-0.05595119158971853,-13.27,IS,0.58,0.0,Phase3-EA-SA2v2-USDCHF-M15-107,USDCHFMT4,1720,4h 15m,Buy
111431.24,1.24594,29.01.2013 05:45:00,,-1.06,-137.29999999998836,0.0,0.0,1.24647,28.01.2013 21:25:00,8745,-0.06811578830703832,-24.52,IS,0.41,0.0,Phase3-EA-SA2v2-EURCHF-M5-43,EURCHFMT4,4562,8h 20m,Buy
111387.53,122293,29.01.2013 06:29:58,sl 122.293,-0.66,-181.0099999999802,0.0,0.0,122063,28.01.2013 22:45:00,8746,-0.0898007198940765,-43.71,IS,0.17,0.0,Phase3-EA-T1v2-EURJPY-M15-322,EURJPYMT4,1462,7h 44m,Sell
111534.7,1.24234,29.01.2013 13:44:58,tp 1.24234,0.0,-33.839999999967404,0.0,0.0,1.24634,29.01.2013 06:30:00,8747,-0.016788334131887486,147.17,IS,0.34,0.0,Phase3-EA-S4v1-EURCHF-M15-221,EURCHFMT4,2282,7h 14m,Sell
111491.58,122057,29.01.2013 17:29:58,sl 122.057,0.0,-76.95999999996275,0.0,0.0,121827,29.01.2013 10:30:00,8748,-0.038180561311781325,-43.12,IS,0.17,0.0,Phase3-EA-T1v2-EURJPY-M15-322,EURJPYMT4,1464,6h 59m,Sell
111534.56,90466,29.01.2013 20:30:00,,0.0,-33.97999999995227,0.0,0.0,90.61,29.01.2013 17:00:00,8749,-0.01685778941493159,42.98,IS,0.27,0.0,Phase3-EA-S1v2-USDJPY-M15-0,USDJPYMT4,2488,3h 30m,Sell
111581.29,1.24248,30.01.2013 01:14:58,tp 1.24248,-2.22,-0.0,0.0,0.0,1.24358,29.01.2013 23:30:00,8750,-0.0,46.73,IS,0.41,0.0,Phase3-EA-SA2v2-EURCHF-M5-43,EURCHFMT4,4564,1h 44m,Sell
111644.18,0.92221,30.01.2013 02:59:58,tp 0.92221,0.0,-0.0,0.0,0.0,0.92121,30.01.2013 01:15:00,8751,-0.0,62.89,IS,0.58,0.0,Phase3-EA-SA2v2-USDCHF-M15-107,USDCHFMT4,1722,1h 44m,Buy
111573.69,143319,30.01.2013 04:55:00,,-1.47,-70.48999999999069,0.0,0.0,143046,29.01.2013 23:30:00,8752,-0.03495761692700003,-70.49,IS,0.23,0.0,Phase3-EA-S4v1-GBPJPY-M5-194,GBPJPYMT4,2096,5h 25m,Sell
111696.94,122946,30.01.2013 10:59:58,tp 122.946,-1.47,-0.0,0.0,0.0,121686,25.01.2013 12:00:00,8753,-0.0,123.25,IS,0.09,0.0,Phase3-EA-TR1v1-EURJPY-M30-91,EURJPYMT4,1482,4d 22h 59m,Buy
111680.94,91136,30.01.2013 22:15:00,,0.0,-16.0,0.0,0.0,91.19,30.01.2013 17:00:00,8754,-0.007932693475666976,-16.0,IS,0.27,0.0,Phase3-EA-S1v2-USDJPY-M15-0,USDJPYMT4,2490,5h 15m,Buy
111693.26,91003,31.01.2013 03:00:00,,-4.0,-3.679999999993015,0.0,0.0,91058,30.01.2013 22:30:00,8755,-0.0018245194993999415,12.32,IS,0.27,0.0,Phase3-EA-S1v2-USDJPY-M15-0,USDJPYMT4,2492,4h 30m,Sell
111682.24,123548,31.01.2013 03:15:00,,0.0,-14.699999999982538,0.0,0.0,123607,31.01.2013 02:30:00,8756,-0.007288162130760376,-11.02,IS,0.17,0.0,Phase3-EA-T1v2-EURJPY-M15-322,EURJPYMT4,1466,45m 0s,Buy
111691.94,1.23505,31.01.2013 13:45:00,,0.0,-4.999999999970896,0.0,0.0,1.23479,31.01.2013 05:00:00,8757,-0.0024789667111315005,9.7,IS,0.34,0.0,Phase3-EA-S4v1-EURCHF-M15-221,EURCHFMT4,2284,8h 45m,Buy
111741.55,1.2351,31.01.2013 20:39:58,tp 1.23510,0.0,-0.0,0.0,0.0,1234,31.01.2013 20:15:00,8758,-0.0,49.61,IS,0.41,0.0,Phase3-EA-SA2v2-EURCHF-M5-43,EURCHFMT4,4566,24m 58s,Buy
111863.14,124855,01.02.2013 02:59:58,tp 124.855,-1.93,-0.0,0.0,0.0,123595,30.01.2013 13:00:00,8759,-0.0,121.59,IS,0.09,0.0,Phase3-EA-TR1v1-EURJPY-M30-91,EURJPYMT4,1484,1d 13h 59m,Buy
112043.29,145616,01.02.2013 04:29:58,tp 145.616,-1.42,-0.0,0.0,0.0,143766,30.01.2013 12:30:00,8760,-0.0,180.15,IS,0.09,0.0,Phase3-EA-B1v1-GBPJPY-M30-1,GBPJPYMT4,844,1d 15h 59m,Buy
111822.65,1.24058,01.02.2013 07:44:58,sl 1.24058,0.0,-220.64000000001397,0.0,0.0,1.23568,01.02.2013 00:10:00,8761,-0.10920431952974685,-220.64,IS,0.41,0.0,Phase3-EA-SA2v2-EURCHF-M5-43,EURCHFMT4,4568,7h 34m,Sell
111945.63,126094,01.02.2013 13:29:57,tp 126.094,0.0,-97.66000000000349,0.0,0.0,124834,01.02.2013 03:00:00,8762,-0.048336175875973456,122.98,IS,0.09,0.0,Phase3-EA-TR1v1-EURJPY-M30-91,EURJPYMT4,1486,10h 29m,Buy
112020.04,1.23616,01.02.2013 14:00:00,,0.0,-23.25,0.0,0.0,1.23814,01.02.2013 05:15:00,8763,-0.011507434867052455,74.41,IS,0.34,0.0,Phase3-EA-S4v1-EURCHF-M15-221,EURCHFMT4,2286,8h 45m,Sell
111954.68,145418,01.02.2013 16:59:58,sl 145.418,0.0,-88.60999999998603,0.0,0.0,146088,01.02.2013 07:30:00,8764,-0.043856937787929345,-65.36,IS,0.09,0.0,Phase3-EA-B1v1-GBPJPY-M30-1,GBPJPYMT4,846,9h 29m,Buy
111910.55,1.57536,01.02.2013 18:29:58,sl 1.57536,-2.13,-132.7399999999907,0.0,0.0,1.57836,30.01.2013 18:30:00,8765,-0.06569879158074993,-44.13,IS,0.14,0.0,Phase3-EA-B1v1-GBPUSD-M30-14,GBPUSDMT4,568,1d 23h 59m,Buy
111834.5,126389,01.02.2013 18:59:58,sl 126.389,0.0,-208.78999999997905,0.0,0.0,125609,01.02.2013 15:00:00,8766,-0.10333923982329639,-76.05,IS,0.09,0.0,Phase3-EA-TR1v1-EURJPY-M30-91,EURJPYMT4,1488,3h 59m,Sell
111792.23,126581,01.02.2013 19:44:57,sl 126.581,0.0,-251.05999999996857,0.0,0.0,126811,01.02.2013 19:00:00,8767,-0.12426049882674527,-42.27,IS,0.17,0.0,Phase3-EA-T1v2-EURJPY-M15-322,EURJPYMT4,1468,44m 57s,Buy
111673.25,0.90819,04.02.2013 02:30:00,,-3.39,-370.03999999997905,0.0,0.0,0.90638,01.02.2013 22:15:00,8768,-0.1831488687399505,-118.98,IS,0.58,0.0,Phase3-EA-SA2v2-USDCHF-M15-107,USDCHFMT4,1724,2d 4h 15m,Sell
111693.11,1.23724,04.02.2013 06:00:00,,-2.26,-350.179999999993,0.0,0.0,1.23773,01.02.2013 21:40:00,8769,-0.17331929211803648,19.86,IS,0.41,0.0,Phase3-EA-SA2v2-EURCHF-M5-43,EURCHFMT4,4570,2d 8h 20m,Sell
111627.53,145951,04.02.2013 11:59:58,sl 145.951,-0.56,-415.7599999999802,0.0,0.0,145281,01.02.2013 17:30:00,8770,-0.2057776825946452,-65.58,IS,0.09,0.0,Phase3-EA-B1v1-GBPJPY-M30-1,GBPJPYMT4,848,2d 18h 29m,Sell
111569.68,1.23613,04.02.2013 14:30:00,,0.0,-473.60999999998603,0.0,0.0,1.23768,04.02.2013 05:45:00,8771,-0.23441016031761516,-57.85,IS,0.34,0.0,Phase3-EA-S4v1-EURCHF-M15-221,EURCHFMT4,2288,8h 45m,Buy
111695.1,125124,04.02.2013 20:29:57,tp 125.124,0.0,-348.1899999999732,0.0,0.0,126414,04.02.2013 04:00:00,8772,-0.17233435468209402,125.42,IS,0.09,0.0,Phase3-EA-TR1v1-EURJPY-M30-91,EURJPYMT4,1490,16h 29m,Sell
111743.64,1.22856,05.02.2013 03:09:57,tp 1.22856,-1.08,-299.6499999999651,0.0,0.0,1.22746,04.02.2013 21:55:00,8773,-0.1483098003402953,48.54,IS,0.41,0.0,Phase3-EA-SA2v2-EURCHF-M5-43,EURCHFMT4,4572,5h 14m,Buy
111840.87,145428,05.02.2013 03:39:58,tp 145.428,0.0,-202.4199999999546,0.0,0.0,145038,05.02.2013 02:00:00,8774,-0.10018645014142948,97.23,IS,0.23,0.0,Phase3-EA-S4v1-GBPJPY-M5-194,GBPJPYMT4,2098,1h 39m,Buy
111965.9,125934,05.02.2013 12:59:57,tp 125.934,0.0,-77.38999999995576,0.0,0.0,124644,05.02.2013 05:30:00,8775,-0.03830367244562066,125.03,IS,0.09,0.0,Phase3-EA-TR1v1-EURJPY-M30-91,EURJPYMT4,1492,7h 29m,Buy
111927.38,1.22947,05.02.2013 13:15:00,,0.0,-115.90999999994528,0.0,0.0,1.22844,05.02.2013 04:30:00,8776,-0.0573688935672869,-38.52,IS,0.34,0.0,Phase3-EA-S4v1-EURCHF-M15-221,EURCHFMT4,2290,8h 45m,Sell
111885.38,1.57261,05.02.2013 16:59:58,sl 1.57261,0.0,-157.90999999994528,0.0,0.0,1.57561,05.02.2013 02:30:00,8777,-0.07815651784325263,-42.0,IS,0.14,0.0,Phase3-EA-B1v1-GBPUSD-M30-14,GBPUSDMT4,570,14h 29m,Buy
111932.8,93384,05.02.2013 19:00:00,,0.0,-110.48999999993248,0.0,0.0,93.22,05.02.2013 18:30:00,8778,-0.0546863001488107,47.42,IS,0.27,0.0,Phase3-EA-S1v2-USDJPY-M15-0,USDJPYMT4,2494,30m 0s,Buy
111974.43,93393,05.02.2013 22:15:00,,0.0,-68.85999999992782,0.0,0.0,93249,05.02.2013 20:30:00,8779,-0.034081804943845224,41.63,IS,0.27,0.0,Phase3-EA-S1v2-USDJPY-M15-0,USDJPYMT4,2496,1h 45m,Buy
112021.87,1.23206,06.02.2013 04:04:58,tp 1.23206,-2.26,-21.419999999925494,0.0,0.0,1.23316,05.02.2013 22:00:00,8780,-0.010601688380705644,47.44,IS,0.41,0.0,Phase3-EA-SA2v2-EURCHF-M5-43,EURCHFMT4,4574,6h 4m,Sell
111891.73,146922,06.02.2013 04:55:00,,-1.43,-151.55999999993946,0.0,0.0,146397,05.02.2013 23:30:00,8781,-0.07501362703009778,-130.14,IS,0.23,0.0,Phase3-EA-S4v1-GBPJPY-M5-194,GBPJPYMT4,2100,5h 25m,Sell
112040.54,1.23676,06.02.2013 11:29:57,tp 1.23676,0.0,-2.7499999999417923,0.0,0.0,1.23276,06.02.2013 03:30:00,8782,-0.0013610944466118035,148.81,IS,0.34,0.0,Phase3-EA-S4v1-EURCHF-M15-221,EURCHFMT4,2292,7h 59m,Buy
111971.47,126558,06.02.2013 11:29:58,sl 126.558,0.0,-71.81999999994878,0.0,0.0,127278,06.02.2013 02:00:00,8783,-0.03554683751187604,-69.07,IS,0.09,0.0,Phase3-EA-TR1v1-EURJPY-M30-91,EURJPYMT4,1494,9h 29m,Buy
111954.25,1.22993,07.02.2013 05:25:00,,-3.25,-89.03999999994994,0.0,0.0,1.23024,06.02.2013 21:05:00,8784,-0.04406976346502256,-17.22,IS,0.41,0.0,Phase3-EA-SA2v2-EURCHF-M5-43,EURCHFMT4,4576,8h 20m,Buy
111912.45,126592,07.02.2013 09:14:58,sl 126.592,0.0,-130.8399999999383,0.0,0.0,126362,07.02.2013 03:30:00,8785,-0.06475839905395411,-41.8,IS,0.17,0.0,Phase3-EA-T1v2-EURJPY-M15-322,EURJPYMT4,1470,5h 44m,Sell
111882.56,93.51,08.02.2013 04:45:00,,-1.3,-160.72999999995227,0.0,0.0,93411,07.02.2013 21:15:00,8786,-0.07955225833035663,-29.89,IS,0.27,0.0,Phase3-EA-S1v2-USDJPY-M15-0,USDJPYMT4,2498,7h 30m,Sell
111821.83,1.23063,08.02.2013 05:20:00,,-2.23,-221.45999999996275,0.0,0.0,1.22932,07.02.2013 21:00:00,8787,-0.10961017314653798,-60.73,IS,0.41,0.0,Phase3-EA-SA2v2-EURCHF-M5-43,EURCHFMT4,4578,8h 20m,Sell
111943.5,123805,08.02.2013 11:29:58,tp 123.805,-0.34,-99.78999999994994,0.0,0.0,125065,07.02.2013 19:30:00,8788,-0.0493904053927995,121.67,IS,0.09,0.0,Phase3-EA-TR1v1-EURJPY-M30-91,EURJPYMT4,1496,15h 59m,Sell
111873.34,124.54,08.02.2013 11:59:58,sl 124.540,0.0,-169.94999999995343,0.0,0.0,123.82,08.02.2013 11:30:00,8789,-0.08411563680236683,-70.16,IS,0.09,0.0,Phase3-EA-TR1v1-EURJPY-M30-91,EURJPYMT4,1498,29m 58s,Sell
111905.0,92529,11.02.2013 02:15:00,,-1.31,-138.28999999994994,0.0,0.0,92642,08.02.2013 17:00:00,8790,-0.06844572764576808,31.66,IS,0.27,0.0,Phase3-EA-S1v2-USDJPY-M15-0,USDJPYMT4,2500,2d 9h 15m,Sell
111891.59,0.91701,11.02.2013 03:30:00,,-0.76,-151.69999999995343,0.0,0.0,0.91721,08.02.2013 23:15:00,8791,-0.07508291911102458,-13.41,IS,0.58,0.0,Phase3-EA-SA2v2-USDCHF-M15-107,USDCHFMT4,1726,2d 4h 15m,Buy
111939.69,1.2269,11.02.2013 03:44:57,tp 1.22690,-1.07,-103.59999999994761,0.0,0.0,1.2258,08.02.2013 22:05:00,8792,-0.05127613988068953,48.1,IS,0.41,0.0,Phase3-EA-SA2v2-EURCHF-M5-43,EURCHFMT4,4580,2d 5h 39m,Buy
111915.94,1.22755,11.02.2013 13:15:00,,0.0,-127.34999999994761,0.0,0.0,1.22691,11.02.2013 04:30:00,8793,-0.063031046465313,-23.75,IS,0.34,0.0,Phase3-EA-S4v1-EURCHF-M15-221,EURCHFMT4,2294,8h 45m,Sell
111846.16,125.26,11.02.2013 15:29:58,sl 125.260,-0.34,-197.12999999994645,0.0,0.0,124.54,08.02.2013 12:00:00,8794,-0.09756819936952404,-69.78,IS,0.09,0.0,Phase3-EA-TR1v1-EURJPY-M30-91,EURJPYMT4,1500,3d 3h 29m,Sell
111892.39,93451,11.02.2013 20:30:00,,0.0,-150.89999999993597,0.0,0.0,93291,11.02.2013 17:45:00,8795,-0.0746869643629023,46.23,IS,0.27,0.0,Phase3-EA-S1v2-USDJPY-M15-0,USDJPYMT4,2502,2h 45m,Buy
111653.0,94119,12.02.2013 00:29:58,sl 94.119,-1.29,-390.28999999994994,0.0,0.0,93289,11.02.2013 17:45:00,8796,-0.19317147330156242,-239.39,IS,0.27,0.0,Phase3-EA-S1v2-USDJPY-M15-0,USDJPYMT4,2503,6h 44m,Sell
111701.01,1.23219,12.02.2013 00:39:57,tp 1.23219,-1.07,-342.2799999999406,0.0,0.0,1.23109,11.02.2013 22:25:00,8797,-0.16940923898038843,48.01,IS,0.41,0.0,Phase3-EA-SA2v2-EURCHF-M5-43,EURCHFMT4,4582,2h 14m,Buy
111750.01,1.23233,12.02.2013 06:39:58,tp 1.23233,0.0,-293.2799999999406,0.0,0.0,1.23343,12.02.2013 00:50:00,8798,-0.14515701065842843,49.0,IS,0.41,0.0,Phase3-EA-SA2v2-EURCHF-M5-43,EURCHFMT4,4584,5h 49m,Sell
111829.8,1.2316,12.02.2013 11:15:00,,0.0,-213.48999999993248,0.0,0.0,1.23376,12.02.2013 02:30:00,8799,-0.10566547396844093,79.79,IS,0.34,0.0,Phase3-EA-S4v1-EURCHF-M15-221,EURCHFMT4,2296,8h 45m,Sell
111786.21,1.5637,12.02.2013 11:59:58,sl 1.56370,-1.59,-257.079999999929,0.0,0.0,1.5667,07.02.2013 10:00:00,8800,-0.12724005830628077,-43.59,IS,0.14,0.0,Phase3-EA-B1v1-GBPUSD-M30-14,GBPUSDMT4,572,5d 1h 59m,Buy
111711.76,126893,12.02.2013 14:29:57,sl 126.893,0.0,-331.5299999999406,0.0,0.0,126113,12.02.2013 08:00:00,8801,-0.1640885970526115,-74.45,IS,0.09,0.0,Phase3-EA-TR1v1-EURJPY-M30-91,EURJPYMT4,1502,6h 29m,Sell
111670.3,126.13,12.02.2013 16:59:58,sl 126.130,0.0,-372.9899999999325,0.0,0.0,126.36,12.02.2013 13:30:00,8802,-0.18460895187359647,-41.46,IS,0.17,0.0,Phase3-EA-T1v2-EURJPY-M15-322,EURJPYMT4,1472,3h 29m,Buy
111719.54,1.23275,12.02.2013 21:39:57,tp 1.23275,0.0,-323.7499999999418,0.0,0.0,1.23385,12.02.2013 20:30:00,8803,-0.160237937127207,49.24,IS,0.41,0.0,Phase3-EA-SA2v2-EURCHF-M5-43,EURCHFMT4,4586,1h 9m,Sell
111810.63,93224,13.02.2013 02:00:00,,-1.3,-232.65999999994528,0.0,0.0,93543,12.02.2013 21:15:00,8804,-0.11515353962012019,91.09,IS,0.27,0.0,Phase3-EA-S1v2-USDJPY-M15-0,USDJPYMT4,2506,4h 45m,Sell
111906.77,145331,14.02.2013 04:09:58,tp 145.331,0.0,-136.51999999993131,0.0,0.0,144941,14.02.2013 01:25:00,8805,-0.06756967776555745,96.14,IS,0.23,0.0,Phase3-EA-S4v1-GBPJPY-M5-194,GBPJPYMT4,2102,2h 44m,Buy
111912.63,93499,14.02.2013 04:15:00,,-2.51,-130.65999999994528,0.0,0.0,93.47,13.02.2013 17:00:00,8806,-0.06466930923563201,5.86,IS,0.27,0.0,Phase3-EA-S1v2-USDJPY-M15-0,USDJPYMT4,2508,11h 15m,Buy
111904.41,0.91689,14.02.2013 05:30:00,,0.0,-138.87999999994645,0.0,0.0,0.91702,14.02.2013 01:15:00,8807,-0.06873774427250016,-8.22,IS,0.58,0.0,Phase3-EA-SA2v2-USDCHF-M15-107,USDCHFMT4,1728,4h 15m,Buy
111851.57,1.23264,14.02.2013 07:50:00,,-3.22,-191.71999999994296,0.0,0.0,1.23375,13.02.2013 23:30:00,8808,-0.09489055538540388,-52.84,IS,0.41,0.0,Phase3-EA-SA2v2-EURCHF-M5-43,EURCHFMT4,4588,8h 20m,Buy
111809.8,125479,14.02.2013 11:59:58,sl 125.479,0.0,-233.48999999993248,0.0,0.0,125249,14.02.2013 10:30:00,8809,-0.11556434267128175,-41.77,IS,0.17,0.0,Phase3-EA-T1v2-EURJPY-M15-322,EURJPYMT4,1474,1h 29m,Sell
111932.49,124713,14.02.2013 13:29:58,tp 124.713,-1.35,-110.79999999993015,0.0,0.0,126003,12.02.2013 17:30:00,8810,-0.054839732613703576,122.69,IS,0.09,0.0,Phase3-EA-TR1v1-EURJPY-M30-91,EURJPYMT4,1504,1d 19h 59m,Sell
112028.01,144.14,15.02.2013 03:14:58,tp 144.140,-0.89,-15.279999999940628,0.0,0.0,143.75,14.02.2013 23:45:00,8811,-0.007562735688941002,95.52,IS,0.23,0.0,Phase3-EA-S4v1-GBPJPY-M5-194,GBPJPYMT4,2104,3h 29m,Buy
112045.36,1.23049,15.02.2013 04:20:00,,-2.22,-0.0,0.0,0.0,1.23093,14.02.2013 20:00:00,8812,-0.0,17.35,IS,0.41,0.0,Phase3-EA-SA2v2-EURCHF-M5-43,EURCHFMT4,4590,8h 20m,Sell
112057.32,0.92175,15.02.2013 04:45:00,,0.0,-0.0,0.0,0.0,0.92156,15.02.2013 00:30:00,8813,-0.0,11.96,IS,0.58,0.0,Phase3-EA-SA2v2-USDCHF-M15-107,USDCHFMT4,1730,4h 15m,Buy
112015.15,124079,15.02.2013 05:29:58,sl 124.079,0.0,-42.170000000012806,0.0,0.0,123849,15.02.2013 04:15:00,8814,-0.020870315413474068,-42.17,IS,0.17,0.0,Phase3-EA-T1v2-EURJPY-M15-322,EURJPYMT4,1476,1h 14m,Sell
111939.38,123453,15.02.2013 06:59:58,sl 123.453,0.0,-117.94000000000233,0.0,0.0,124233,15.02.2013 03:30:00,8815,-0.05836957552441149,-75.77,IS,0.09,0.0,Phase3-EA-TR1v1-EURJPY-M30-91,EURJPYMT4,1506,3h 29m,Buy
111897.38,1.5491,15.02.2013 12:59:57,sl 1.54910,0.0,-159.94000000000233,0.0,0.0,1.5521,15.02.2013 10:00:00,8816,-0.07915575639625509,-42.0,IS,0.14,0.0,Phase3-EA-B1v1-GBPUSD-M30-14,GBPUSDMT4,574,2h 59m,Buy
111956.7,1.2299,15.02.2013 14:45:00,,0.0,-100.61999999999534,0.0,0.0,1.23151,15.02.2013 06:00:00,8817,-0.049797750460114434,59.32,IS,0.34,0.0,Phase3-EA-S4v1-EURCHF-M15-221,EURCHFMT4,2298,8h 45m,Sell
111891.48,144.63,15.02.2013 16:59:58,sl 144.630,-0.56,-165.8399999999965,0.0,0.0,143.96,14.02.2013 23:30:00,8818,-0.08207571989967787,-65.22,IS,0.09,0.0,Phase3-EA-B1v1-GBPJPY-M30-1,GBPJPYMT4,850,17h 29m,Sell
112015.98,124947,15.02.2013 16:59:58,tp 124.947,0.0,-41.33999999999651,0.0,0.0,123657,15.02.2013 09:00:00,8819,-0.020459540886712903,124.5,IS,0.09,0.0,Phase3-EA-TR1v1-EURJPY-M30-91,EURJPYMT4,1508,7h 59m,Buy
112006.73,93399,15.02.2013 22:30:00,,0.0,-50.58999999999651,0.0,0.0,93369,15.02.2013 22:15:00,8820,-0.025037449769202268,-9.25,IS,0.27,0.0,Phase3-EA-S1v2-USDJPY-M15-0,USDJPYMT4,2510,15m 0s,Buy
112121.07,93769,18.02.2013 02:00:00,tp 93.769,-0.84,-0.0,0.0,0.0,93367,15.02.2013 22:15:00,8821,-0.0,114.34,IS,0.27,0.0,Phase3-EA-S1v2-USDJPY-M15-0,USDJPYMT4,2511,2d 3h 45m,Sell
112183.18,0.92254,18.02.2013 02:14:58,tp 0.92254,-0.76,-0.0,0.0,0.0,0.92154,15.02.2013 22:15:00,8822,-0.0,62.11,IS,0.58,0.0,Phase3-EA-SA2v2-USDCHF-M15-107,USDCHFMT4,1732,2d 3h 59m,Buy
112230.94,1.23237,18.02.2013 04:19:57,tp 1.23237,-1.07,-0.0,0.0,0.0,1.23127,15.02.2013 22:20:00,8823,-0.0,47.76,IS,0.41,0.0,Phase3-EA-SA2v2-EURCHF-M5-43,EURCHFMT4,4592,2d 5h 59m,Buy
112051.1,0.92558,18.02.2013 07:00:00,,0.0,-179.8399999999965,0.0,0.0,0.92271,18.02.2013 02:45:00,8824,-0.08892803445407302,-179.84,IS,0.58,0.0,Phase3-EA-SA2v2-USDCHF-M15-107,USDCHFMT4,1734,4h 15m,Sell
112083.07,1.23216,19.02.2013 04:45:00,,-2.22,-147.86999999999534,0.0,0.0,1.23293,18.02.2013 20:25:00,8825,-0.07311937530429058,31.97,IS,0.41,0.0,Phase3-EA-SA2v2-EURCHF-M5-43,EURCHFMT4,4594,8h 20m,Sell
112076.93,144918,19.02.2013 08:30:00,,0.0,-154.0100000000093,0.0,0.0,144943,19.02.2013 03:05:00,8826,-0.07615550815320773,-6.14,IS,0.23,0.0,Phase3-EA-S4v1-GBPJPY-M5-194,GBPJPYMT4,2106,5h 25m,Buy
112085.03,1.23269,19.02.2013 12:15:00,,0.0,-145.9100000000035,0.0,0.0,1.23247,19.02.2013 03:30:00,8827,-0.07215018631669459,8.1,IS,0.34,0.0,Phase3-EA-S4v1-EURCHF-M15-221,EURCHFMT4,2300,8h 45m,Buy
112043.03,1.54563,19.02.2013 15:59:59,sl 1.54563,0.0,-187.9100000000035,0.0,0.0,1.54863,19.02.2013 09:30:00,8828,-0.09291852176526633,-42.0,IS,0.14,0.0,Phase3-EA-B1v1-GBPUSD-M30-14,GBPUSDMT4,576,6h 29m,Buy
112138.89,144191,20.02.2013 05:29:57,tp 144.191,0.0,-92.05000000001746,0.0,0.0,144581,20.02.2013 02:35:00,8829,-0.045517268524795,95.86,IS,0.23,0.0,Phase3-EA-S4v1-GBPJPY-M5-194,GBPJPYMT4,2108,2h 54m,Sell
112154.48,1.23502,20.02.2013 06:45:00,,-2.22,-76.46000000002095,0.0,0.0,1.23542,19.02.2013 22:25:00,8830,-0.037808260199957845,15.59,IS,0.41,0.0,Phase3-EA-SA2v2-EURCHF-M5-43,EURCHFMT4,4596,8h 20m,Sell
112085.16,124979,20.02.2013 08:29:58,sl 124.979,0.0,-145.78000000002794,0.0,0.0,125434,18.02.2013 11:00:00,8831,-0.07208590337365159,-69.32,IS,0.09,0.0,Phase3-EA-TR1v1-EURJPY-M30-91,EURJPYMT4,1510,1d 21h 29m,Sell
112148.41,1.23408,20.02.2013 12:45:00,,0.0,-82.53000000002794,0.0,0.0,1.23579,20.02.2013 04:00:00,8832,-0.04080977915645726,63.25,IS,0.34,0.0,Phase3-EA-S4v1-EURCHF-M15-221,EURCHFMT4,2302,8h 45m,Sell
112263.35,93959,20.02.2013 22:14:58,tp 93.959,0.0,-0.0,0.0,0.0,93559,20.02.2013 19:45:00,8833,-0.0,114.94,IS,0.27,0.0,Phase3-EA-S1v2-USDJPY-M15-0,USDJPYMT4,2514,2h 29m,Buy
112385.73,124144,21.02.2013 06:59:57,tp 124.144,-1.69,-0.0,0.0,0.0,125699,20.02.2013 05:00:00,8834,-0.0,122.38,IS,0.09,0.0,Phase3-EA-TR1v1-EURJPY-M30-91,EURJPYMT4,1511,1d 1h 59m,Buy
112391.81,1.23202,21.02.2013 07:30:00,,-3.18,-0.0,0.0,0.0,1.23181,20.02.2013 23:10:00,8835,-0.0,6.08,IS,0.41,0.0,Phase3-EA-SA2v2-EURCHF-M5-43,EURCHFMT4,4598,8h 20m,Buy
112394.74,1.23171,21.02.2013 10:00:00,,0.0,-0.0,0.0,0.0,1.23163,21.02.2013 01:15:00,8836,-0.0,2.93,IS,0.34,0.0,Phase3-EA-S4v1-EURCHF-M15-221,EURCHFMT4,2304,8h 45m,Buy
112325.14,123127,21.02.2013 17:29:58,sl 123.127,0.0,-69.60000000000582,0.0,0.0,122407,21.02.2013 15:00:00,8837,-0.0343882454652752,-69.6,IS,0.09,0.0,Phase3-EA-TR1v1-EURJPY-M30-91,EURJPYMT4,1514,2h 29m,Sell
112423.98,92875,21.02.2013 19:00:00,,0.0,-0.0,0.0,0.0,93215,21.02.2013 17:15:00,8838,-0.0,98.84,IS,0.27,0.0,Phase3-EA-S1v2-USDJPY-M15-0,USDJPYMT4,2516,1h 45m,Sell
112472.42,1.22888,21.02.2013 20:39:58,tp 1.22888,0.0,-0.0,0.0,0.0,1.22998,21.02.2013 20:05:00,8839,-0.0,48.44,IS,0.41,0.0,Phase3-EA-SA2v2-EURCHF-M5-43,EURCHFMT4,4600,34m 58s,Sell
112568.77,141873,22.02.2013 04:39:58,tp 141.873,0.0,-0.0,0.0,0.0,142263,22.02.2013 03:20:00,8840,-0.0,96.35,IS,0.23,0.0,Phase3-EA-S4v1-GBPJPY-M5-194,GBPJPYMT4,2110,1h 19m,Sell
112514.33,1.22696,22.02.2013 06:30:00,,-1.06,-54.44000000000233,0.0,0.0,1.22817,21.02.2013 22:10:00,8841,-0.02687482379440923,-54.44,IS,0.41,0.0,Phase3-EA-SA2v2-EURCHF-M5-43,EURCHFMT4,4602,8h 20m,Buy
112449.09,142799,22.02.2013 07:29:58,sl 142.799,-0.56,-119.67999999999302,0.0,0.0,142129,21.02.2013 07:00:00,8842,-0.05908117031070116,-65.24,IS,0.09,0.0,Phase3-EA-B1v1-GBPJPY-M30-1,GBPJPYMT4,852,1d 0h 29m,Sell
112572.91,123988,25.02.2013 02:00:00,tp 123.988,-0.47,-0.0,0.0,0.0,122698,22.02.2013 00:30:00,8843,-0.0,123.82,IS,0.09,0.0,Phase3-EA-TR1v1-EURJPY-M30-91,EURJPYMT4,1516,3d 1h 30m,Buy
112532.98,1.22821,25.02.2013 11:30:00,,0.0,-39.929999999993015,0.0,0.0,1.22712,25.02.2013 02:45:00,8844,-0.019711421433395437,-39.93,IS,0.34,0.0,Phase3-EA-S4v1-EURCHF-M15-221,EURCHFMT4,2306,8h 45m,Sell
112584.51,93797,25.02.2013 19:00:00,,0.0,-0.0,0.0,0.0,93976,25.02.2013 17:00:00,8845,-0.0,51.53,IS,0.27,0.0,Phase3-EA-S1v2-USDJPY-M15-0,USDJPYMT4,2518,2h 0m,Sell
112368.44,1.22197,25.02.2013 21:54:58,sl 1.22197,0.0,-216.07000000000698,0.0,0.0,1.22687,25.02.2013 20:10:00,8846,-0.10665672316210457,-216.07,IS,0.41,0.0,Phase3-EA-SA2v2-EURCHF-M5-43,EURCHFMT4,4604,1h 44m,Buy
112493.3,122646,25.02.2013 21:59:59,tp 122.646,0.0,-91.21000000002095,0.0,0.0,123936,25.02.2013 19:00:00,8847,-0.045023185632514826,124.86,IS,0.09,0.0,Phase3-EA-TR1v1-EURJPY-M30-91,EURJPYMT4,1518,2h 59m,Sell
112541.74,1.22075,25.02.2013 22:14:57,tp 1.22075,0.0,-42.77000000001863,0.0,0.0,1.21965,25.02.2013 22:05:00,8848,-0.021112176839195872,48.44,IS,0.41,0.0,Phase3-EA-SA2v2-EURCHF-M5-43,EURCHFMT4,4606,9m 57s,Buy
112590.2,1.21874,25.02.2013 23:44:58,tp 1.21874,0.0,-0.0,0.0,0.0,1.21764,25.02.2013 23:40:00,8849,-0.0,48.46,IS,0.41,0.0,Phase3-EA-SA2v2-EURCHF-M5-43,EURCHFMT4,4608,4m 58s,Buy
112519.85,120578,26.02.2013 02:29:58,sl 120.578,0.0,-70.35000000000582,0.0,0.0,119858,26.02.2013 00:30:00,8850,-0.034725272989515554,-70.35,IS,0.09,0.0,Phase3-EA-TR1v1-EURJPY-M30-91,EURJPYMT4,1520,1h 59m,Sell
112377.47,1.2139,26.02.2013 06:59:58,sl 1.21390,0.0,-212.73000000001048,0.0,0.0,1.2178,26.02.2013 01:15:00,8851,-0.10500507921903904,-142.38,IS,0.34,0.0,Phase3-EA-S4v1-EURCHF-M15-221,EURCHFMT4,2308,5h 44m,Buy
112474.92,139813,26.02.2013 07:44:58,tp 139.813,0.0,-115.27999999999884,0.0,0.0,140203,26.02.2013 02:35:00,8852,-0.05690304861735581,97.45,IS,0.23,0.0,Phase3-EA-S4v1-GBPJPY-M5-194,GBPJPYMT4,2112,5h 9m,Sell
112432.39,120504,26.02.2013 15:29:58,sl 120.504,0.0,-157.80999999999767,0.0,0.0,120274,26.02.2013 15:15:00,8853,-0.07789616674449061,-42.53,IS,0.17,0.0,Phase3-EA-T1v2-EURJPY-M15-322,EURJPYMT4,1478,14m 58s,Sell
112445.29,92058,26.02.2013 18:15:00,,0.0,-144.9100000000035,0.0,0.0,92014,26.02.2013 17:00:00,8854,-0.07152863267818627,12.9,IS,0.27,0.0,Phase3-EA-S1v2-USDJPY-M15-0,USDJPYMT4,2520,1h 15m,Buy
112402.63,120043,26.02.2013 18:59:58,sl 120.043,0.0,-187.57000000000698,0.0,0.0,119813,26.02.2013 18:45:00,8855,-0.0925859197532784,-42.66,IS,0.17,0.0,Phase3-EA-T1v2-EURJPY-M15-322,EURJPYMT4,1480,14m 58s,Sell
112451.01,1.21724,26.02.2013 20:24:58,tp 1.21724,0.0,-139.19000000000233,0.0,0.0,1.21614,26.02.2013 20:10:00,8856,-0.06870519896816418,48.38,IS,0.41,0.0,Phase3-EA-SA2v2-EURCHF-M5-43,EURCHFMT4,4610,14m 58s,Buy
112499.38,1.21728,26.02.2013 22:09:58,tp 1.21728,0.0,-90.82000000000698,0.0,0.0,1.21618,26.02.2013 21:20:00,8857,-0.044829414255974184,48.37,IS,0.41,0.0,Phase3-EA-SA2v2-EURCHF-M5-43,EURCHFMT4,4612,49m 58s,Buy
112456.82,120109,26.02.2013 22:44:57,sl 120.109,0.0,-133.38000000000466,0.0,0.0,119879,26.02.2013 19:00:00,8858,-0.06583734060186727,-42.56,IS,0.17,0.0,Phase3-EA-T1v2-EURJPY-M15-322,EURJPYMT4,1482,3h 44m,Sell
112390.74,139376,27.02.2013 02:59:58,sl 139.376,-0.57,-199.45999999999185,0.0,0.0,138706,26.02.2013 19:00:00,8859,-0.09845491045469675,-66.08,IS,0.09,0.0,Phase3-EA-B1v1-GBPJPY-M30-1,GBPJPYMT4,854,7h 59m,Sell
112406.19,91777,27.02.2013 04:15:00,,-1.32,-184.0099999999802,0.0,0.0,91834,26.02.2013 22:00:00,8860,-0.09082867779388118,15.45,IS,0.27,0.0,Phase3-EA-S1v2-USDJPY-M15-0,USDJPYMT4,2522,6h 15m,Sell
112363.58,119903,27.02.2013 05:59:58,sl 119.903,0.0,-226.61999999996624,0.0,0.0,119673,27.02.2013 05:15:00,8861,-0.11186128450436661,-42.61,IS,0.17,0.0,Phase3-EA-T1v2-EURJPY-M15-322,EURJPYMT4,1484,44m 58s,Sell
112320.95,120049,27.02.2013 09:29:57,sl 120.049,0.0,-269.2499999999709,0.0,0.0,119819,27.02.2013 08:15:00,8862,-0.13290376336070048,-42.63,IS,0.17,0.0,Phase3-EA-T1v2-EURJPY-M15-322,EURJPYMT4,1486,1h 14m,Sell
112278.29,120093,27.02.2013 13:14:58,sl 120.093,0.0,-311.9099999999744,0.0,0.0,119863,27.02.2013 12:45:00,8863,-0.1539610504357926,-42.66,IS,0.17,0.0,Phase3-EA-T1v2-EURJPY-M15-322,EURJPYMT4,1488,29m 58s,Sell
112362.32,1.21902,27.02.2013 13:15:00,,0.0,-227.87999999997555,0.0,0.0,1.21672,27.02.2013 04:30:00,8864,-0.11248322969224307,84.03,IS,0.34,0.0,Phase3-EA-S4v1-EURCHF-M15-221,EURCHFMT4,2310,8h 45m,Buy
112319.66,119847,27.02.2013 18:14:58,sl 119.847,0.0,-270.53999999997905,0.0,0.0,119617,27.02.2013 16:45:00,8865,-0.13354051676733522,-42.66,IS,0.17,0.0,Phase3-EA-T1v2-EURJPY-M15-322,EURJPYMT4,1490,1h 29m,Sell
112253.9,1.22114,28.02.2013 04:25:00,,-6.61,-336.29999999998836,0.0,0.0,1.2198,27.02.2013 20:05:00,8866,-0.16600013228674781,-65.76,IS,0.41,0.0,Phase3-EA-SA2v2-EURCHF-M5-43,EURCHFMT4,4614,8h 20m,Sell
112206.44,0.92875,28.02.2013 04:30:00,,0.0,-383.7599999999802,0.0,0.0,0.92951,28.02.2013 00:15:00,8867,-0.18942673436325086,-47.46,IS,0.58,0.0,Phase3-EA-SA2v2-USDCHF-M15-107,USDCHFMT4,1736,4h 15m,Buy
112265.14,0.93581,01.03.2013 00:44:58,tp 0.93581,-3.28,-325.05999999996857,0.0,0.0,0.93681,28.02.2013 23:15:00,8868,-0.16045198632508742,58.7,IS,0.58,0.0,Phase3-EA-SA2v2-USDCHF-M15-107,USDCHFMT4,1738,1h 29m,Sell
112301.56,92678,01.03.2013 05:30:00,,0.0,-288.63999999995576,0.0,0.0,92553,01.03.2013 01:00:00,8869,-0.14247480875183233,36.42,IS,0.27,0.0,Phase3-EA-S1v2-USDJPY-M15-0,USDJPYMT4,2524,4h 30m,Buy
112228.87,1.22404,01.03.2013 05:55:00,,-2.19,-361.3299999999581,0.0,0.0,1.22243,28.02.2013 21:35:00,8870,-0.17835512280453675,-72.69,IS,0.41,0.0,Phase3-EA-SA2v2-EURCHF-M5-43,EURCHFMT4,4616,8h 20m,Sell
112488.65,1.50586,01.03.2013 12:59:58,tp 1.50586,-4.82,-101.54999999995925,0.0,0.0,1.52476,22.02.2013 20:30:00,8871,-0.05012582049870075,259.78,IS,0.14,0.0,Phase3-EA-B1v1-GBPUSD-M30-14,GBPUSDMT4,578,6d 16h 29m,Sell
112448.51,1.22508,01.03.2013 14:00:00,,0.0,-141.68999999997322,0.0,0.0,1.22397,01.03.2013 05:15:00,8872,-0.06993921719805432,-40.14,IS,0.34,0.0,Phase3-EA-S4v1-EURCHF-M15-221,EURCHFMT4,2312,8h 45m,Sell
112564.42,93177,01.03.2013 18:14:58,tp 93.177,0.0,-25.779999999969732,0.0,0.0,92777,01.03.2013 17:00:00,8873,-0.012725195986760281,115.91,IS,0.27,0.0,Phase3-EA-S1v2-USDJPY-M15-0,USDJPYMT4,2526,1h 14m,Buy
112488.85,121599,01.03.2013 20:29:58,sl 121.599,-0.34,-101.34999999997672,0.0,0.0,120819,28.02.2013 12:30:00,8874,-0.050027099040317005,-75.57,IS,0.09,0.0,Phase3-EA-TR1v1-EURJPY-M30-91,EURJPYMT4,1522,1d 7h 59m,Sell
112794.23,121999,01.03.2013 20:59:58,tp 121.999,-3.61,-0.0,0.0,0.0,120299,27.02.2013 19:15:00,8875,-0.0,305.38,IS,0.17,0.0,Phase3-EA-T1v2-EURJPY-M15-322,EURJPYMT4,1492,2d 1h 44m,Buy
112855.75,0.94279,04.03.2013 03:44:59,tp 0.94279,0.0,-0.0,0.0,0.0,0.94179,04.03.2013 02:30:00,8876,-0.0,61.52,IS,0.58,0.0,Phase3-EA-SA2v2-USDCHF-M15-107,USDCHFMT4,1740,1h 14m,Buy
112857.93,1.22692,04.03.2013 04:35:00,,-2.17,-0.0,0.0,0.0,1.22702,01.03.2013 20:15:00,8877,-0.0,2.18,IS,0.41,0.0,Phase3-EA-SA2v2-EURCHF-M5-43,EURCHFMT4,4618,2d 8h 20m,Sell
112850.0,1.22668,04.03.2013 11:30:00,,0.0,-7.929999999993015,0.0,0.0,1.2269,04.03.2013 02:45:00,8878,-0.003909139761010567,-7.93,IS,0.34,0.0,Phase3-EA-S4v1-EURCHF-M15-221,EURCHFMT4,2314,8h 45m,Buy
112808.21,121556,04.03.2013 12:44:57,sl 121.556,0.0,-49.720000000001164,0.0,0.0,121786,04.03.2013 12:15:00,8879,-0.024509764050141377,-41.79,IS,0.17,0.0,Phase3-EA-T1v2-EURJPY-M15-322,EURJPYMT4,1494,29m 57s,Buy
112766.39,121447,04.03.2013 17:44:57,sl 121.447,0.0,-91.54000000000815,0.0,0.0,121677,04.03.2013 16:15:00,8880,-0.04512517701428176,-41.82,IS,0.17,0.0,Phase3-EA-T1v2-EURJPY-M15-322,EURJPYMT4,1496,1h 29m,Buy
112814.3,1.22503,04.03.2013 21:24:58,tp 1.22503,0.0,-43.63000000000466,0.0,0.0,1.22393,04.03.2013 20:45:00,8881,-0.02150766302308442,47.91,IS,0.41,0.0,Phase3-EA-SA2v2-EURCHF-M5-43,EURCHFMT4,4620,39m 58s,Buy
112772.42,121647,04.03.2013 22:59:57,sl 121.647,0.0,-85.51000000000931,0.0,0.0,121417,04.03.2013 18:15:00,8882,-0.04215265333724393,-41.88,IS,0.17,0.0,Phase3-EA-T1v2-EURJPY-M15-322,EURJPYMT4,1498,4h 44m,Sell
112740.34,93423,04.03.2013 23:45:00,,0.0,-117.58999999999651,0.0,0.0,93534,04.03.2013 17:00:00,8883,-0.057966676481415354,-32.08,IS,0.27,0.0,Phase3-EA-S1v2-USDJPY-M15-0,USDJPYMT4,2528,6h 45m,Buy
112713.31,1.22567,05.03.2013 07:05:00,,-2.18,-144.61999999999534,0.0,0.0,1.2251,04.03.2013 22:45:00,8884,-0.07129127266555207,-27.03,IS,0.41,0.0,Phase3-EA-SA2v2-EURCHF-M5-43,EURCHFMT4,4622,8h 20m,Sell
112671.34,121635,05.03.2013 18:14:57,sl 121.635,0.0,-186.5899999999965,0.0,0.0,121405,05.03.2013 14:00:00,8885,-0.09198062900474029,-41.97,IS,0.17,0.0,Phase3-EA-T1v2-EURJPY-M15-322,EURJPYMT4,1500,4h 14m,Sell
112629.34,1.51151,05.03.2013 18:59:57,sl 1.51151,0.0,-228.5899999999965,0.0,0.0,1.51451,05.03.2013 11:30:00,8886,-0.11268477401893807,-42.0,IS,0.14,0.0,Phase3-EA-B1v1-GBPUSD-M30-14,GBPUSDMT4,580,7h 29m,Buy
112588.8,1.22876,06.03.2013 04:25:00,,-2.18,-269.13000000000466,0.0,0.0,1.22788,05.03.2013 20:05:00,8887,-0.13266920351597966,-40.54,IS,0.41,0.0,Phase3-EA-SA2v2-EURCHF-M5-43,EURCHFMT4,4624,8h 20m,Sell
112618.93,141003,06.03.2013 06:05:00,,0.0,-239.0,0.0,0.0,141125,06.03.2013 00:40:00,8888,-0.11781644424745881,30.13,IS,0.23,0.0,Phase3-EA-S4v1-GBPJPY-M5-194,GBPJPYMT4,2114,5h 25m,Sell
112587.09,93202,06.03.2013 09:45:00,,-0.84,-270.8399999999965,0.0,0.0,93309,05.03.2013 23:30:00,8889,-0.1335121579915537,-31.84,IS,0.27,0.0,Phase3-EA-S1v2-USDJPY-M15-0,USDJPYMT4,2530,10h 15m,Buy
112462.95,1.2318,06.03.2013 14:15:00,,0.0,-394.9800000000105,0.0,0.0,1.22835,06.03.2013 05:30:00,8890,-0.19470769518352518,-124.14,IS,0.34,0.0,Phase3-EA-S4v1-EURCHF-M15-221,EURCHFMT4,2316,8h 45m,Sell
112489.93,94068,07.03.2013 03:45:00,,0.0,-368.0,0.0,0.0,93974,07.03.2013 01:30:00,8891,-0.18140774679106628,26.98,IS,0.27,0.0,Phase3-EA-S1v2-USDJPY-M15-0,USDJPYMT4,2532,2h 15m,Buy
112534.5,122019,07.03.2013 06:15:00,,-2.66,-323.429999999993,0.0,0.0,121758,06.03.2013 07:15:00,8892,-0.15943670528432963,44.57,IS,0.17,0.0,Phase3-EA-T1v2-EURJPY-M15-322,EURJPYMT4,1502,23h 0m,Buy
112494.72,1.23176,07.03.2013 06:15:00,,-6.49,-363.20999999999185,0.0,0.0,1.23099,06.03.2013 21:55:00,8893,-0.17904648834777637,-39.78,IS,0.41,0.0,Phase3-EA-SA2v2-EURCHF-M5-43,EURCHFMT4,4626,8h 20m,Sell
112500.6,140848,07.03.2013 07:10:00,,0.0,-357.3299999999872,0.0,0.0,140824,07.03.2013 01:45:00,8894,-0.1761479080457864,5.88,IS,0.23,0.0,Phase3-EA-S4v1-GBPJPY-M5-194,GBPJPYMT4,2116,5h 25m,Buy
112494.14,1.23205,07.03.2013 14:45:00,,0.0,-363.78999999997905,0.0,0.0,1.23187,07.03.2013 06:00:00,8895,-0.17933240273129947,-6.46,IS,0.34,0.0,Phase3-EA-S4v1-EURCHF-M15-221,EURCHFMT4,2318,8h 45m,Sell
112799.71,123743,07.03.2013 16:59:57,tp 123.743,0.0,-58.21999999997206,0.0,0.0,122043,07.03.2013 10:00:00,8896,-0.028699888636333725,305.57,IS,0.17,0.0,Phase3-EA-T1v2-EURJPY-M15-322,EURJPYMT4,1504,6h 59m,Buy
112816.49,94919,08.03.2013 02:00:00,,0.0,-41.439999999973224,0.0,0.0,94.86,08.03.2013 00:30:00,8897,-0.020428089747328612,16.78,IS,0.27,0.0,Phase3-EA-S1v2-USDJPY-M15-0,USDJPYMT4,2534,1h 30m,Buy
112836.21,142529,08.03.2013 04:30:00,,-0.87,-21.71999999997206,0.0,0.0,142444,07.03.2013 23:05:00,8898,-0.01070700070732851,19.72,IS,0.23,0.0,Phase3-EA-S4v1-GBPJPY-M5-194,GBPJPYMT4,2118,5h 25m,Buy
112840.12,1.2354,08.03.2013 04:45:00,,-2.17,-17.809999999968568,0.0,0.0,1.23554,07.03.2013 20:25:00,8899,-0.008779543397671709,3.91,IS,0.41,0.0,Phase3-EA-SA2v2-EURCHF-M5-43,EURCHFMT4,4628,8h 20m,Sell
112958.39,125462,08.03.2013 13:59:58,tp 125.462,-0.46,-0.0,0.0,0.0,124202,07.03.2013 19:30:00,8900,-0.0,118.27,IS,0.09,0.0,Phase3-EA-TR1v1-EURJPY-M30-91,EURJPYMT4,1524,18h 29m,Buy
113005.75,1.23765,08.03.2013 20:14:58,tp 1.23765,0.0,-0.0,0.0,0.0,1.23875,08.03.2013 20:00:00,8901,-0.0,47.36,IS,0.41,0.0,Phase3-EA-SA2v2-EURCHF-M5-43,EURCHFMT4,4630,14m 58s,Sell
113050.4,96199,11.03.2013 02:15:00,,-0.82,-0.0,0.0,0.0,96037,08.03.2013 18:30:00,8902,-0.0,44.65,IS,0.27,0.0,Phase3-EA-S1v2-USDJPY-M15-0,USDJPYMT4,2536,2d 7h 45m,Buy
113054.97,1.2366,11.03.2013 05:10:00,,-1.03,-0.0,0.0,0.0,1.23647,08.03.2013 20:50:00,8903,-0.0,4.57,IS,0.41,0.0,Phase3-EA-SA2v2-EURCHF-M5-43,EURCHFMT4,4632,2d 8h 20m,Buy
113037.98,124.92,11.03.2013 13:45:00,,0.0,-16.989999999990687,0.0,0.0,125016,11.03.2013 12:45:00,8904,-0.008367192391297103,-16.99,IS,0.17,0.0,Phase3-EA-T1v2-EURJPY-M15-322,EURJPYMT4,1506,1h 0m,Buy
113102.04,1.23533,11.03.2013 15:30:00,,0.0,-0.0,0.0,0.0,1.23712,11.03.2013 06:45:00,8905,-0.0,64.06,IS,0.34,0.0,Phase3-EA-S4v1-EURCHF-M15-221,EURCHFMT4,2320,8h 45m,Sell
113147.51,1.23505,12.03.2013 00:39:58,tp 1.23505,-2.16,-0.0,0.0,0.0,1.23615,11.03.2013 20:55:00,8906,-0.0,45.47,IS,0.41,0.0,Phase3-EA-SA2v2-EURCHF-M5-43,EURCHFMT4,4634,3h 44m,Sell
113073.96,125849,12.03.2013 01:29:58,sl 125.849,-0.66,-73.54999999998836,0.0,0.0,125069,08.03.2013 17:00:00,8907,-0.03620521856260411,-73.55,IS,0.09,0.0,Phase3-EA-TR1v1-EURJPY-M30-91,EURJPYMT4,1526,3d 8h 29m,Sell
113065.89,0.9479,12.03.2013 02:30:00,,-0.73,-81.61999999999534,0.0,0.0,0.94802,11.03.2013 22:15:00,8908,-0.040177701415092415,-8.07,IS,0.58,0.0,Phase3-EA-SA2v2-USDCHF-M15-107,USDCHFMT4,1742,4h 15m,Buy
113023.36,1.49016,12.03.2013 02:59:58,sl 1.49016,-0.53,-124.14999999999418,0.0,0.0,1.49316,11.03.2013 21:30:00,8909,-0.06111322752614278,-42.53,IS,0.14,0.0,Phase3-EA-B1v1-GBPUSD-M30-14,GBPUSDMT4,582,5h 29m,Buy
113070.92,1.23631,12.03.2013 04:24:58,tp 1.23631,0.0,-76.58999999999651,0.0,0.0,1.23521,12.03.2013 00:40:00,8910,-0.03770166811298656,47.56,IS,0.41,0.0,Phase3-EA-SA2v2-EURCHF-M5-43,EURCHFMT4,4636,3h 44m,Buy
113106.17,143794,12.03.2013 07:05:00,,0.0,-41.33999999999651,0.0,0.0,143942,12.03.2013 01:40:00,8911,-0.020349744872578717,35.25,IS,0.23,0.0,Phase3-EA-S4v1-GBPJPY-M5-194,GBPJPYMT4,2120,5h 25m,Sell
113109.04,1.23529,12.03.2013 10:00:00,,0.0,-38.470000000001164,0.0,0.0,1.23521,12.03.2013 01:15:00,8912,-0.018936978356269788,2.87,IS,0.34,0.0,Phase3-EA-S4v1-EURCHF-M15-221,EURCHFMT4,2322,8h 45m,Buy
113041.57,125143,12.03.2013 11:29:58,sl 125.143,0.0,-105.94000000000233,0.0,0.0,125863,12.03.2013 01:30:00,8913,-0.05214929781812334,-67.47,IS,0.09,0.0,Phase3-EA-TR1v1-EURJPY-M30-91,EURJPYMT4,1528,9h 59m,Buy
112974.1,125468,12.03.2013 16:29:58,sl 125.468,0.0,-173.4100000000035,0.0,0.0,124748,12.03.2013 14:30:00,8914,-0.08536161727997688,-67.47,IS,0.09,0.0,Phase3-EA-TR1v1-EURJPY-M30-91,EURJPYMT4,1530,1h 59m,Sell
113041.16,95829,12.03.2013 18:30:00,,0.0,-106.35000000000582,0.0,0.0,96067,12.03.2013 17:00:00,8915,-0.05235112160616951,67.06,IS,0.27,0.0,Phase3-EA-S1v2-USDJPY-M15-0,USDJPYMT4,2538,1h 30m,Sell
113000.43,125205,12.03.2013 22:29:57,sl 125.205,0.0,-147.0800000000163,0.0,0.0,124975,12.03.2013 19:00:00,8916,-0.07240059206239628,-40.73,IS,0.17,0.0,Phase3-EA-T1v2-EURJPY-M15-322,EURJPYMT4,1508,3h 29m,Sell
112995.24,1.23396,13.03.2013 06:40:00,,-2.16,-152.27000000001863,0.0,0.0,1.23389,12.03.2013 22:20:00,8917,-0.07495538586715535,-5.19,IS,0.41,0.0,Phase3-EA-SA2v2-EURCHF-M5-43,EURCHFMT4,4638,8h 20m,Sell
112924.92,1.23183,13.03.2013 14:15:00,,0.0,-222.5900000000256,0.0,0.0,1.23379,13.03.2013 05:30:00,8918,-0.10957062678249153,-70.32,IS,0.34,0.0,Phase3-EA-S4v1-EURCHF-M15-221,EURCHFMT4,2324,8h 45m,Buy
112958.33,96166,13.03.2013 23:30:00,,0.0,-189.18000000002212,0.0,0.0,96047,13.03.2013 20:45:00,8919,-0.09312444932257419,33.41,IS,0.27,0.0,Phase3-EA-S1v2-USDJPY-M15-0,USDJPYMT4,2540,2h 45m,Buy
113009.58,0.9519,14.03.2013 03:44:58,tp 0.95190,-9.68,-137.93000000002212,0.0,0.0,0.9529,13.03.2013 23:30:00,8920,-0.06789647581701667,51.25,IS,0.58,0.0,Phase3-EA-SA2v2-USDCHF-M15-107,USDCHFMT4,1744,4h 14m,Sell
113000.53,1.23414,14.03.2013 04:25:00,,-6.46,-146.98000000001048,0.0,0.0,1.23408,13.03.2013 20:05:00,8921,-0.07235136674823622,-9.05,IS,0.41,0.0,Phase3-EA-SA2v2-EURCHF-M5-43,EURCHFMT4,4640,8h 20m,Sell
113047.13,1.23226,15.03.2013 02:09:59,tp 1.23226,-1.04,-100.38000000000466,0.0,0.0,1.23116,14.03.2013 21:00:00,8922,-0.049412370350984974,46.6,IS,0.41,0.0,Phase3-EA-SA2v2-EURCHF-M5-43,EURCHFMT4,4642,5h 9m,Buy
112980.02,96106,15.03.2013 03:45:00,,-0.81,-167.4899999999907,0.0,0.0,96342,14.03.2013 17:00:00,8923,-0.08244747868186521,-67.11,IS,0.27,0.0,Phase3-EA-S1v2-USDJPY-M15-0,USDJPYMT4,2542,10h 45m,Buy
112932.82,0.94613,15.03.2013 06:30:00,,0.0,-214.69000000000233,0.0,0.0,0.9469,15.03.2013 02:15:00,8924,-0.10568182696406243,-47.2,IS,0.58,0.0,Phase3-EA-SA2v2-USDCHF-M15-107,USDCHFMT4,1746,4h 15m,Buy
112889.67,125259,15.03.2013 07:14:58,sl 125.259,-2.48,-257.8399999999965,0.0,0.0,125029,13.03.2013 01:15:00,8925,-0.12692255002288505,-43.15,IS,0.17,0.0,Phase3-EA-T1v2-EURJPY-M15-322,EURJPYMT4,1510,2d 5h 59m,Sell
112871.46,1.23263,15.03.2013 10:35:00,,0.0,-276.04999999998836,0.0,0.0,1.23221,15.03.2013 02:15:00,8926,-0.1358864797309045,-18.21,IS,0.41,0.0,Phase3-EA-SA2v2-EURCHF-M5-43,EURCHFMT4,4644,8h 20m,Sell
112895.89,1.23152,15.03.2013 11:45:00,,0.0,-251.61999999999534,0.0,0.0,1.2322,15.03.2013 03:00:00,8927,-0.12386073548230755,24.43,IS,0.34,0.0,Phase3-EA-S4v1-EURCHF-M15-221,EURCHFMT4,2326,8h 45m,Sell
112832.14,144265,15.03.2013 18:59:58,sl 144.265,-0.34,-315.36999999999534,0.0,0.0,144935,14.03.2013 22:30:00,8928,-0.15524187325751324,-63.75,IS,0.09,0.0,Phase3-EA-B1v1-GBPJPY-M30-1,GBPJPYMT4,856,20h 29m,Buy
112880.14,1.2273,15.03.2013 21:19:57,tp 1.22730,0.0,-267.36999999999534,0.0,0.0,1.2262,15.03.2013 20:05:00,8929,-0.13161372246206426,48.0,IS,0.41,0.0,Phase3-EA-SA2v2-EURCHF-M5-43,EURCHFMT4,4646,1h 14m,Buy
112951.86,95241,15.03.2013 23:30:00,,0.0,-195.64999999999418,0.0,0.0,95494,15.03.2013 21:30:00,8930,-0.09630932714853033,71.72,IS,0.27,0.0,Phase3-EA-S1v2-USDJPY-M15-0,USDJPYMT4,2544,2h 0m,Sell
112875.88,123804,18.03.2013 02:00:00,sl 123.804,-2.3,-271.63000000000466,0.0,0.0,124584,13.03.2013 21:00:00,8931,-0.13371072084516494,-75.98,IS,0.09,0.0,Phase3-EA-TR1v1-EURJPY-M30-91,EURJPYMT4,1532,4d 5h 0m,Buy
112921.75,1.22613,18.03.2013 02:00:00,tp 1.22613,-2.18,-225.7600000000093,0.0,0.0,1.22723,15.03.2013 22:10:00,8932,-0.1111310692412663,45.87,IS,0.41,0.0,Phase3-EA-SA2v2-EURCHF-M5-43,EURCHFMT4,4648,2d 3h 50m,Sell
112983.1,0.94536,18.03.2013 02:59:58,tp 0.94536,0.0,-164.4100000000035,0.0,0.0,0.94436,18.03.2013 02:00:00,8933,-0.0809313390058302,61.35,IS,0.58,0.0,Phase3-EA-SA2v2-USDCHF-M15-107,USDCHFMT4,1748,59m 58s,Buy
112884.54,142636,18.03.2013 08:45:00,,0.0,-262.97000000000116,0.0,0.0,143041,18.03.2013 03:20:00,8934,-0.12944780863915095,-98.56,IS,0.23,0.0,Phase3-EA-S4v1-GBPJPY-M5-194,GBPJPYMT4,2122,5h 25m,Buy
112845.48,1.21884,18.03.2013 10:35:00,,0.0,-302.02999999999884,0.0,0.0,1.21974,18.03.2013 02:15:00,8935,-0.14867521634894643,-39.06,IS,0.41,0.0,Phase3-EA-SA2v2-EURCHF-M5-43,EURCHFMT4,4650,8h 20m,Buy
112777.08,122845,18.03.2013 11:29:57,sl 122.845,0.0,-370.429999999993,0.0,0.0,122125,18.03.2013 05:30:00,8936,-0.18234533123245836,-68.4,IS,0.09,0.0,Phase3-EA-TR1v1-EURJPY-M30-91,EURJPYMT4,1534,5h 59m,Sell
112713.59,143412,18.03.2013 11:29:58,sl 143.412,0.0,-433.9199999999837,0.0,0.0,142742,18.03.2013 08:30:00,8937,-0.21359848319085076,-63.49,IS,0.09,0.0,Phase3-EA-B1v1-GBPJPY-M30-1,GBPJPYMT4,858,2h 59m,Sell
112857.79,1.22175,18.03.2013 11:59:58,tp 1.22175,0.0,-289.71999999997206,0.0,0.0,1.21775,18.03.2013 06:15:00,8938,-0.14261558017618373,144.2,IS,0.34,0.0,Phase3-EA-S4v1-EURCHF-M15-221,EURCHFMT4,2328,5h 44m,Buy
112876.82,95.05,18.03.2013 18:00:00,,0.0,-270.6899999999732,0.0,0.0,94983,18.03.2013 17:00:00,8939,-0.13324800289207192,19.03,IS,0.27,0.0,Phase3-EA-S1v2-USDJPY-M15-0,USDJPYMT4,2546,1h 0m,Buy
112914.55,95185,18.03.2013 19:45:00,,0.0,-232.95999999996275,0.0,0.0,95052,18.03.2013 18:00:00,8940,-0.11467529186056072,37.73,IS,0.27,0.0,Phase3-EA-S1v2-USDJPY-M15-0,USDJPYMT4,2548,1h 45m,Buy
112962.27,1.22417,18.03.2013 21:59:58,tp 1.22417,0.0,-185.23999999996158,0.0,0.0,1.22527,18.03.2013 20:05:00,8941,-0.09118497194475128,47.72,IS,0.41,0.0,Phase3-EA-SA2v2-EURCHF-M5-43,EURCHFMT4,4652,1h 54m,Sell
113014.31,95463,19.03.2013 03:15:00,,0.0,-133.19999999995343,0.0,0.0,95279,19.03.2013 01:00:00,8942,-0.065568118457348,52.04,IS,0.27,0.0,Phase3-EA-S1v2-USDJPY-M15-0,USDJPYMT4,2550,2h 15m,Buy
113029.73,1.22628,19.03.2013 07:25:00,,-1.04,-117.77999999994063,0.0,0.0,1.2259,18.03.2013 23:05:00,8943,-0.057977575014303714,15.42,IS,0.41,0.0,Phase3-EA-SA2v2-EURCHF-M5-43,EURCHFMT4,4654,8h 20m,Buy
113074.31,144079,19.03.2013 09:15:00,,0.0,-73.19999999995343,0.0,0.0,144264,19.03.2013 03:50:00,8944,-0.036032929963036774,44.58,IS,0.23,0.0,Phase3-EA-S4v1-GBPJPY-M5-194,GBPJPYMT4,2124,5h 25m,Sell
113000.1,122437,19.03.2013 18:59:58,sl 122.437,-0.46,-147.40999999994528,0.0,0.0,123217,18.03.2013 12:00:00,8945,-0.07256303559908003,-74.21,IS,0.09,0.0,Phase3-EA-TR1v1-EURJPY-M30-91,EURJPYMT4,1536,1d 6h 59m,Buy
113045.58,1.21891,20.03.2013 00:04:58,tp 1.21891,-2.17,-101.92999999993481,0.0,0.0,1.22001,19.03.2013 21:30:00,8946,-0.050175362720386966,45.48,IS,0.41,0.0,Phase3-EA-SA2v2-EURCHF-M5-43,EURCHFMT4,4656,2h 34m,Sell
113068.76,94937,20.03.2013 03:45:00,,-1.28,-78.74999999994179,0.0,0.0,95023,19.03.2013 21:45:00,8947,-0.03876493489875483,23.18,IS,0.27,0.0,Phase3-EA-S1v2-USDJPY-M15-0,USDJPYMT4,2552,6h 0m,Sell
113116.36,1.21989,20.03.2013 05:59:58,tp 1.21989,0.0,-31.14999999993597,0.0,0.0,1.21879,20.03.2013 00:10:00,8948,-0.015333685359931726,47.6,IS,0.41,0.0,Phase3-EA-SA2v2-EURCHF-M5-43,EURCHFMT4,4658,5h 49m,Buy
113135.95,0.94741,20.03.2013 06:00:00,,0.0,-11.559999999939464,0.0,0.0,0.94773,20.03.2013 01:45:00,8949,-0.005690446316540831,19.59,IS,0.58,0.0,Phase3-EA-SA2v2-USDCHF-M15-107,USDCHFMT4,1750,4h 15m,Sell
113171.85,1.22003,20.03.2013 09:45:00,,0.0,-0.0,0.0,0.0,1.21903,20.03.2013 01:00:00,8950,-0.0,35.9,IS,0.34,0.0,Phase3-EA-S4v1-EURCHF-M15-221,EURCHFMT4,2330,8h 45m,Buy
113293.62,123633,20.03.2013 15:29:58,tp 123.633,0.0,-0.0,0.0,0.0,122343,20.03.2013 08:00:00,8951,-0.0,121.77,IS,0.09,0.0,Phase3-EA-TR1v1-EURJPY-M30-91,EURJPYMT4,1538,7h 29m,Buy
113412.51,124474,20.03.2013 21:29:58,tp 124.474,0.0,-0.0,0.0,0.0,123214,20.03.2013 14:00:00,8952,-0.0,118.89,IS,0.09,0.0,Phase3-EA-TR1v1-EURJPY-M30-91,EURJPYMT4,1539,7h 29m,Buy
113460.27,1222,20.03.2013 22:49:57,tp 1.22200,0.0,-0.0,0.0,0.0,1.2209,20.03.2013 21:05:00,8953,-0.0,47.76,IS,0.41,0.0,Phase3-EA-SA2v2-EURCHF-M5-43,EURCHFMT4,4660,1h 44m,Buy
113493.44,0.94426,21.03.2013 04:30:00,,0.0,-0.0,0.0,0.0,0.9448,21.03.2013 00:15:00,8954,-0.0,33.17,IS,0.58,0.0,Phase3-EA-SA2v2-USDCHF-M15-107,USDCHFMT4,1752,4h 15m,Sell
113483.46,1.22262,21.03.2013 09:35:00,,0.0,-9.980000000010477,0.0,0.0,1.22239,21.03.2013 01:15:00,8955,-0.004904334999698483,-9.98,IS,0.41,0.0,Phase3-EA-SA2v2-EURCHF-M5-43,EURCHFMT4,4662,8h 20m,Sell
113414.51,123589,21.03.2013 11:29:58,sl 123.589,-1.38,-78.93000000002212,0.0,0.0,124309,20.03.2013 23:00:00,8956,-0.03878749113486005,-68.95,IS,0.09,0.0,Phase3-EA-TR1v1-EURJPY-M30-91,EURJPYMT4,1542,12h 29m,Buy
113468.48,95059,21.03.2013 19:00:00,,0.0,-24.960000000020955,0.0,0.0,95249,21.03.2013 18:30:00,8957,-0.012265751662569978,53.97,IS,0.27,0.0,Phase3-EA-S1v2-USDJPY-M15-0,USDJPYMT4,2554,30m 0s,Sell
113477.29,95026,21.03.2013 19:15:00,,0.0,-16.150000000023283,0.0,0.0,95057,21.03.2013 19:00:00,8958,-0.007936373772060273,8.81,IS,0.27,0.0,Phase3-EA-S1v2-USDJPY-M15-0,USDJPYMT4,2556,15m 0s,Sell
113524.94,1.22254,21.03.2013 21:14:58,tp 1.22254,0.0,-0.0,0.0,0.0,1.22144,21.03.2013 20:30:00,8959,-0.0,47.65,IS,0.41,0.0,Phase3-EA-SA2v2-EURCHF-M5-43,EURCHFMT4,4664,44m 58s,Buy
113571.57,1.2219,22.03.2013 05:24:57,tp 1.22190,-1.04,-0.0,0.0,0.0,1.2208,21.03.2013 23:45:00,8960,-0.0,46.63,IS,0.41,0.0,Phase3-EA-SA2v2-EURCHF-M5-43,EURCHFMT4,4666,5h 39m,Buy
113568.42,144055,22.03.2013 08:15:00,,0.0,-3.1499999999941792,0.0,0.0,144068,22.03.2013 02:50:00,8961,-0.0015473673460366618,-3.15,IS,0.23,0.0,Phase3-EA-S4v1-GBPJPY-M5-194,GBPJPYMT4,2126,5h 25m,Buy
113615.11,94837,22.03.2013 08:15:00,,0.0,-0.0,0.0,0.0,95001,22.03.2013 00:45:00,8962,-0.0,46.69,IS,0.27,0.0,Phase3-EA-S1v2-USDJPY-M15-0,USDJPYMT4,2558,7h 30m,Sell
113540.96,121839,22.03.2013 11:29:58,sl 121.839,0.0,-74.14999999999418,0.0,0.0,122619,22.03.2013 04:00:00,8963,-0.03641674726398932,-74.15,IS,0.09,0.0,Phase3-EA-TR1v1-EURJPY-M30-91,EURJPYMT4,1544,7h 29m,Buy
113499.62,122452,22.03.2013 14:14:58,sl 122.452,0.0,-115.48999999999069,0.0,0.0,122222,22.03.2013 08:30:00,8964,-0.056719759157358295,-41.34,IS,0.17,0.0,Phase3-EA-T1v2-EURJPY-M15-322,EURJPYMT4,1512,5h 44m,Sell
113492.05,1.22203,22.03.2013 14:30:00,,0.0,-123.05999999999767,0.0,0.0,1.22182,22.03.2013 05:45:00,8965,-0.060437557900293905,-7.57,IS,0.34,0.0,Phase3-EA-S4v1-EURCHF-M15-221,EURCHFMT4,2332,8h 45m,Sell
113614.44,123414,22.03.2013 17:29:58,tp 123.414,0.0,-0.6699999999837019,0.0,0.0,122124,22.03.2013 13:00:00,8966,-3.290522004892951E-4,122.39,IS,0.09,0.0,Phase3-EA-TR1v1-EURJPY-M30-91,EURJPYMT4,1546,4h 29m,Buy
113611.33,94709,25.03.2013 02:15:00,,-0.83,-3.779999999969732,0.0,0.0,94717,22.03.2013 18:15:00,8967,-0.0018564437580146753,-3.11,IS,0.27,0.0,Phase3-EA-S1v2-USDJPY-M15-0,USDJPYMT4,2560,2d 8h 0m,Buy
113658.32,1.22314,25.03.2013 02:44:57,tp 1.22314,-1.05,-0.0,0.0,0.0,1.22204,22.03.2013 22:05:00,8968,-0.0,46.99,IS,0.41,0.0,Phase3-EA-SA2v2-EURCHF-M5-43,EURCHFMT4,4668,2d 4h 39m,Buy
113656.86,144554,25.03.2013 08:25:00,,0.0,-1.459999999991851,0.0,0.0,144548,25.03.2013 03:00:00,8969,-7.16886989930902E-4,-1.46,IS,0.23,0.0,Phase3-EA-S4v1-GBPJPY-M5-194,GBPJPYMT4,2128,5h 25m,Sell
113608.48,1222,25.03.2013 11:05:00,,0.0,-49.83999999999651,0.0,0.0,1.22089,25.03.2013 02:45:00,8970,-0.024472361355036356,-48.38,IS,0.41,0.0,Phase3-EA-SA2v2-EURCHF-M5-43,EURCHFMT4,4670,8h 20m,Sell
113622.49,123095,25.03.2013 11:30:00,,0.0,-35.829999999987194,0.0,0.0,123017,25.03.2013 02:30:00,8971,-0.017593192362574252,14.01,IS,0.17,0.0,Phase3-EA-T1v2-EURJPY-M15-322,EURJPYMT4,1514,9h 0m,Buy
113716.56,1.22186,25.03.2013 13:45:00,,0.0,-0.0,0.0,0.0,1.22446,25.03.2013 05:00:00,8972,-0.0,94.07,IS,0.34,0.0,Phase3-EA-S4v1-EURCHF-M15-221,EURCHFMT4,2334,8h 45m,Sell
113674.03,1.51638,25.03.2013 17:59:58,sl 1.51638,-0.53,-42.529999999998836,0.0,0.0,1.51938,22.03.2013 09:30:00,8973,-0.020877046029050675,-42.53,IS,0.14,0.0,Phase3-EA-B1v1-GBPUSD-M30-14,GBPUSDMT4,584,3d 8h 29m,Buy
113794.5,120594,25.03.2013 19:59:58,tp 120.594,0.0,-0.0,0.0,0.0,121854,25.03.2013 18:00:00,8974,-0.0,120.47,IS,0.09,0.0,Phase3-EA-TR1v1-EURJPY-M30-91,EURJPYMT4,1548,1h 59m,Sell
113842.08,1.22018,25.03.2013 20:54:57,tp 1.22018,0.0,-0.0,0.0,0.0,1.21908,25.03.2013 20:30:00,8975,-0.0,47.58,IS,0.41,0.0,Phase3-EA-SA2v2-EURCHF-M5-43,EURCHFMT4,4672,24m 57s,Buy
113910.34,93942,26.03.2013 03:00:00,,-1.29,-0.0,0.0,0.0,94184,25.03.2013 23:15:00,8976,-0.0,68.26,IS,0.27,0.0,Phase3-EA-S1v2-USDJPY-M15-0,USDJPYMT4,2562,3h 45m,Sell
113957.9,1.22025,26.03.2013 04:09:58,tp 1.22025,0.0,-0.0,0.0,0.0,1.21915,26.03.2013 02:30:00,8977,-0.0,47.56,IS,0.41,0.0,Phase3-EA-SA2v2-EURCHF-M5-43,EURCHFMT4,4674,1h 39m,Buy
113888.69,121319,26.03.2013 04:29:57,sl 121.319,-0.33,-69.20999999999185,0.0,0.0,120599,25.03.2013 20:00:00,8978,-0.03393347352565972,-69.21,IS,0.09,0.0,Phase3-EA-TR1v1-EURJPY-M30-91,EURJPYMT4,1550,8h 29m,Sell
113847.1,121163,26.03.2013 11:59:58,sl 121.163,0.0,-110.79999999998836,0.0,0.0,120933,26.03.2013 11:45:00,8979,-0.054324936665845175,-41.59,IS,0.17,0.0,Phase3-EA-T1v2-EURJPY-M15-322,EURJPYMT4,1516,14m 58s,Sell
113805.1,1.51694,26.03.2013 13:59:58,sl 1.51694,0.0,-152.79999999998836,0.0,0.0,1.51994,26.03.2013 12:00:00,8980,-0.07491742168358649,-42.0,IS,0.14,0.0,Phase3-EA-B1v1-GBPUSD-M30-14,GBPUSDMT4,586,1h 59m,Buy
113797.93,1.22088,26.03.2013 14:30:00,,0.0,-159.97000000000116,0.0,0.0,1.22068,26.03.2013 05:45:00,8981,-0.0784328530544786,-7.17,IS,0.34,0.0,Phase3-EA-S4v1-EURCHF-M15-221,EURCHFMT4,2336,8h 45m,Sell
113833.88,94627,27.03.2013 02:00:00,,0.0,-124.01999999998952,0.0,0.0,94501,27.03.2013 01:30:00,8982,-0.06080666647381099,35.95,IS,0.27,0.0,Phase3-EA-S1v2-USDJPY-M15-0,USDJPYMT4,2564,30m 0s,Buy
113848.83,1.21945,27.03.2013 06:20:00,,-1.04,-109.06999999997788,0.0,0.0,1.21908,26.03.2013 22:00:00,8983,-0.05347672240201403,14.95,IS,0.41,0.0,Phase3-EA-SA2v2-EURCHF-M5-43,EURCHFMT4,4676,8h 20m,Buy
113759.77,143664,27.03.2013 06:45:00,,0.0,-198.12999999997555,0.0,0.0,143297,27.03.2013 01:20:00,8984,-0.09714259658487101,-89.06,IS,0.23,0.0,Phase3-EA-S4v1-GBPJPY-M5-194,GBPJPYMT4,2130,5h 25m,Sell
113729.78,121308,27.03.2013 11:15:00,,-0.88,-228.11999999996624,0.0,0.0,121.47,26.03.2013 20:15:00,8985,-0.11184661148205839,-29.99,IS,0.17,0.0,Phase3-EA-T1v2-EURJPY-M15-322,EURJPYMT4,1518,15h 0m,Buy
113654.94,120494,27.03.2013 14:29:58,sl 120.494,-0.47,-302.95999999996275,0.0,0.0,121274,26.03.2013 06:00:00,8986,-0.1485404585946224,-74.84,IS,0.09,0.0,Phase3-EA-TR1v1-EURJPY-M30-91,EURJPYMT4,1552,1d 8h 29m,Buy
113746.27,1.21699,27.03.2013 15:00:00,,0.0,-211.62999999997555,0.0,0.0,1.21955,27.03.2013 06:15:00,8987,-0.10376160962628786,91.33,IS,0.34,0.0,Phase3-EA-S4v1-EURCHF-M15-221,EURCHFMT4,2338,8h 45m,Sell
113748.71,94.31,28.03.2013 02:30:00,,-3.86,-209.18999999997322,0.0,0.0,94332,27.03.2013 18:15:00,8988,-0.10256528430620841,2.44,IS,0.27,0.0,Phase3-EA-S1v2-USDJPY-M15-0,USDJPYMT4,2566,8h 15m,Sell
113754.73,1.21872,28.03.2013 06:45:00,,-6.45,-203.1699999999837,0.0,0.0,1.21901,27.03.2013 22:25:00,8989,-0.09961369478700396,6.02,IS,0.41,0.0,Phase3-EA-SA2v2-EURCHF-M5-43,EURCHFMT4,4678,8h 20m,Sell
113713.2,120716,28.03.2013 10:14:58,sl 120.716,0.0,-244.69999999998254,0.0,0.0,120486,28.03.2013 03:00:00,8990,-0.11997574009145093,-41.53,IS,0.17,0.0,Phase3-EA-T1v2-EURJPY-M15-322,EURJPYMT4,1520,7h 14m,Sell
113671.63,120302,28.03.2013 13:29:58,sl 120.302,0.0,-286.2699999999895,0.0,0.0,120072,28.03.2013 12:00:00,8991,-0.14035739728639499,-41.57,IS,0.17,0.0,Phase3-EA-T1v2-EURJPY-M15-322,EURJPYMT4,1522,1h 29m,Sell
113676.08,94102,29.03.2013 03:45:00,,-1.29,-281.8199999999779,0.0,0.0,94122,28.03.2013 22:30:00,8992,-0.13817557446903334,4.45,IS,0.27,0.0,Phase3-EA-S1v2-USDJPY-M15-0,USDJPYMT4,2568,5h 15m,Sell
113676.51,1.21704,29.03.2013 07:05:00,,-2.16,-281.38999999998487,0.0,0.0,1.2171,28.03.2013 22:45:00,8993,-0.1379647466462361,0.43,IS,0.41,0.0,Phase3-EA-SA2v2-EURCHF-M5-43,EURCHFMT4,4680,8h 20m,Sell
113634.93,120553,29.03.2013 08:59:58,sl 120.553,0.0,-322.96999999997206,0.0,0.0,120783,29.03.2013 01:15:00,8994,-0.1583513068137937,-41.58,IS,0.17,0.0,Phase3-EA-T1v2-EURJPY-M15-322,EURJPYMT4,1524,7h 44m,Buy
113629.58,1.21636,01.04.2013 06:55:00,,-1.04,-328.3199999999779,0.0,0.0,1.21646,29.03.2013 22:35:00,8995,-0.16097439716724693,-5.35,IS,0.41,0.0,Phase3-EA-SA2v2-EURCHF-M5-43,EURCHFMT4,4682,2d 8h 20m,Buy
113553.84,119716,01.04.2013 10:29:58,sl 119.716,-0.94,-404.05999999996857,0.0,0.0,120496,28.03.2013 09:30:00,8996,-0.19810951181590253,-75.74,IS,0.09,0.0,Phase3-EA-TR1v1-EURJPY-M30-91,EURJPYMT4,1554,4d 0h 59m,Buy
113559.21,1.21661,01.04.2013 12:30:00,,0.0,-398.6899999999732,0.0,0.0,1.21676,01.04.2013 03:45:00,8997,-0.1954766155172079,5.37,IS,0.34,0.0,Phase3-EA-S4v1-EURCHF-M15-221,EURCHFMT4,2340,8h 45m,Sell
113517.29,120046,01.04.2013 18:44:57,sl 120.046,0.0,-440.60999999998603,0.0,0.0,119816,01.04.2013 18:00:00,8998,-0.2160298767539693,-41.92,IS,0.17,0.0,Phase3-EA-T1v2-EURJPY-M15-322,EURJPYMT4,1526,44m 57s,Sell
113541.02,93286,01.04.2013 23:45:00,,0.0,-416.87999999997555,0.0,0.0,93368,01.04.2013 22:15:00,8999,-0.20439512271894034,23.73,IS,0.27,0.0,Phase3-EA-S1v2-USDJPY-M15-0,USDJPYMT4,2570,1h 30m,Sell
113543.28,0.94679,02.04.2013 02:30:00,,-3.25,-414.61999999996624,0.0,0.0,0.94688,01.04.2013 22:15:00,9000,-0.20328705090607635,2.26,IS,0.58,0.0,Phase3-EA-SA2v2-USDCHF-M15-107,USDCHFMT4,1754,4h 15m,Sell
113518.8,141744,02.04.2013 06:20:00,,0.0,-439.0999999999767,0.0,0.0,141843,02.04.2013 00:55:00,9001,-0.21528952788785072,-24.48,IS,0.23,0.0,Phase3-EA-S4v1-GBPJPY-M5-194,GBPJPYMT4,2132,5h 25m,Buy
113525.13,1.21639,02.04.2013 08:05:00,,-1.04,-432.7699999999895,0.0,0.0,1.21622,01.04.2013 23:45:00,9002,-0.21218594621732598,6.33,IS,0.41,0.0,Phase3-EA-SA2v2-EURCHF-M5-43,EURCHFMT4,4684,8h 20m,Buy
113455.72,119951,02.04.2013 17:59:58,sl 119.951,0.0,-502.179999999993,0.0,0.0,119231,02.04.2013 09:00:00,9003,-0.24621747919545683,-69.41,IS,0.09,0.0,Phase3-EA-TR1v1-EURJPY-M30-91,EURJPYMT4,1556,8h 59m,Sell
113480.3,93452,03.04.2013 03:30:00,,-0.84,-477.6000000000058,0.0,0.0,93364,02.04.2013 22:00:00,9004,-0.23416597248746118,24.58,IS,0.27,0.0,Phase3-EA-S1v2-USDJPY-M15-0,USDJPYMT4,2572,5h 30m,Buy
113460.27,1.21628,03.04.2013 04:55:00,,-1.04,-497.63000000000466,0.0,0.0,1.21672,02.04.2013 20:35:00,9005,-0.2439866266518739,-20.03,IS,0.41,0.0,Phase3-EA-SA2v2-EURCHF-M5-43,EURCHFMT4,4686,8h 20m,Buy
113500.36,1.21724,03.04.2013 11:30:00,,0.0,-457.54000000000815,0.0,0.0,1.21612,03.04.2013 02:45:00,9006,-0.2243306094051792,40.09,IS,0.34,0.0,Phase3-EA-S4v1-EURCHF-M15-221,EURCHFMT4,2342,8h 45m,Buy
113457.27,120167,03.04.2013 12:14:58,sl 120.167,-1.28,-500.63000000000466,0.0,0.0,119937,01.04.2013 21:00:00,9007,-0.24545751843885544,-43.09,IS,0.17,0.0,Phase3-EA-T1v2-EURJPY-M15-322,EURJPYMT4,1528,1d 15h 14m,Sell
113415.49,119857,03.04.2013 13:29:58,sl 119.857,0.0,-542.4100000000035,0.0,0.0,120087,03.04.2013 12:15:00,9008,-0.26594213805888417,-41.78,IS,0.17,0.0,Phase3-EA-T1v2-EURJPY-M15-322,EURJPYMT4,1530,1h 14m,Buy
113439.79,92.82,04.04.2013 03:15:00,,-3.92,-518.1100000000151,0.0,0.0,92917,03.04.2013 23:00:00,9009,-0.2540279145843396,24.3,IS,0.27,0.0,Phase3-EA-S1v2-USDJPY-M15-0,USDJPYMT4,2574,4h 15m,Sell
113457.49,1.21395,04.04.2013 06:30:00,,-3.12,-500.4100000000035,0.0,0.0,1.21347,03.04.2013 22:10:00,9010,-0.2453496530411429,17.7,IS,0.41,0.0,Phase3-EA-SA2v2-EURCHF-M5-43,EURCHFMT4,4688,8h 20m,Buy
113415.39,119.54,04.04.2013 07:44:58,sl 119.540,0.0,-542.5100000000093,0.0,0.0,119.31,04.04.2013 07:00:00,9011,-0.2659911677851198,-42.1,IS,0.17,0.0,Phase3-EA-T1v2-EURJPY-M15-322,EURJPYMT4,1532,44m 58s,Sell
113348.22,141974,04.04.2013 07:59:58,sl 141.974,-2.24,-609.6800000000221,0.0,0.0,141304,02.04.2013 08:30:00,9012,-0.2989244348956423,-67.17,IS,0.09,0.0,Phase3-EA-B1v1-GBPJPY-M30-1,GBPJPYMT4,860,1d 23h 29m,Sell
113473.22,120795,04.04.2013 07:59:58,tp 120.795,0.0,-484.6800000000221,0.0,0.0,119505,04.04.2013 00:30:00,9013,-0.23763727710474558,125.0,IS,0.09,0.0,Phase3-EA-TR1v1-EURJPY-M30-91,EURJPYMT4,1558,7h 29m,Buy
113645.96,146102,04.04.2013 17:59:59,tp 146.102,0.0,-311.94000000003143,0.0,0.0,144252,04.04.2013 15:00:00,9014,-0.1529433280103541,172.74,IS,0.09,0.0,Phase3-EA-B1v1-GBPJPY-M30-1,GBPJPYMT4,862,2h 59m,Buy
113454.75,147527,05.04.2013 03:34:57,sl 147.527,-1.38,-503.1500000000233,0.0,0.0,146727,04.04.2013 23:55:00,9015,-0.24669306753992903,-191.21,IS,0.23,0.0,Phase3-EA-S4v1-GBPJPY-M5-194,GBPJPYMT4,2134,3h 39m,Sell
113222.45,96998,05.04.2013 03:44:57,sl 96.998,-1.26,-735.4500000000116,0.0,0.0,96168,04.04.2013 22:45:00,9016,-0.36058912157852585,-232.3,IS,0.27,0.0,Phase3-EA-S1v2-USDJPY-M15-0,USDJPYMT4,2576,4h 59m,Sell
113284.19,0.93935,05.04.2013 04:29:57,tp 0.93935,0.0,-673.710000000021,0.0,0.0,0.94035,05.04.2013 02:30:00,9017,-0.3303181686024507,61.74,IS,0.58,0.0,Phase3-EA-SA2v2-USDCHF-M15-107,USDCHFMT4,1756,1h 59m,Sell
113376.92,147152,05.04.2013 07:14:58,tp 147.152,0.0,-580.9800000000105,0.0,0.0,147542,05.04.2013 03:40:00,9018,-0.2848529034668467,92.73,IS,0.23,0.0,Phase3-EA-S4v1-GBPJPY-M5-194,GBPJPYMT4,2136,3h 34m,Sell
113640.99,1.53155,05.04.2013 15:59:57,tp 1.53155,-0.53,-316.9100000000035,0.0,0.0,1.51265,04.04.2013 15:30:00,9019,-0.15538010540410643,264.07,IS,0.14,0.0,Phase3-EA-B1v1-GBPUSD-M30-14,GBPUSDMT4,588,1d 0h 29m,Buy
113600.53,125219,05.04.2013 15:59:58,sl 125.219,0.0,-357.36999999999534,0.0,0.0,125449,05.04.2013 15:45:00,9020,-0.1752175326378599,-40.46,IS,0.17,0.0,Phase3-EA-T1v2-EURJPY-M15-322,EURJPYMT4,1534,14m 58s,Buy
113717.92,125.6,05.04.2013 16:29:58,tp 125.600,-0.46,-239.97999999998137,0.0,0.0,124.34,04.04.2013 22:30:00,9021,-0.1176615370132661,117.39,IS,0.09,0.0,Phase3-EA-TR1v1-EURJPY-M30-91,EURJPYMT4,1560,17h 59m,Buy
113889.81,148443,05.04.2013 17:29:58,tp 148.443,-0.34,-68.0899999999674,0.0,0.0,146593,04.04.2013 23:00:00,9022,-0.0333843405918413,171.89,IS,0.09,0.0,Phase3-EA-B1v1-GBPJPY-M30-1,GBPJPYMT4,864,18h 29m,Buy
113938.1,1.21508,05.04.2013 23:29:57,tp 1.21508,0.0,-19.799999999959255,0.0,0.0,1.21398,05.04.2013 22:00:00,9023,-0.009707885794058069,48.29,IS,0.41,0.0,Phase3-EA-SA2v2-EURCHF-M5-43,EURCHFMT4,4690,1h 29m,Buy
114107.54,151052,08.04.2013 01:29:58,tp 151.052,-0.33,-0.0,0.0,0.0,149202,05.04.2013 21:00:00,9024,-0.0,169.44,IS,0.09,0.0,Phase3-EA-B1v1-GBPJPY-M30-1,GBPJPYMT4,866,2d 4h 29m,Buy
113921.19,151564,08.04.2013 02:59:58,sl 151.564,0.0,-186.35000000000582,0.0,0.0,150764,08.04.2013 01:10:00,9025,-0.09129990984164765,-186.35,IS,0.23,0.0,Phase3-EA-S4v1-GBPJPY-M5-194,GBPJPYMT4,2138,1h 49m,Sell
113969.46,1.21416,08.04.2013 05:04:57,tp 1.21416,0.0,-138.0800000000163,0.0,0.0,1.21306,08.04.2013 01:15:00,9026,-0.06765061202541348,48.27,IS,0.41,0.0,Phase3-EA-SA2v2-EURCHF-M5-43,EURCHFMT4,4692,3h 49m,Buy
113898.62,129225,08.04.2013 21:29:58,sl 129.225,0.0,-208.9200000000128,0.0,0.0,128445,08.04.2013 15:00:00,9027,-0.10235780608595439,-70.84,IS,0.09,0.0,Phase3-EA-TR1v1-EURJPY-M30-91,EURJPYMT4,1562,6h 29m,Sell
113957.38,0.93478,09.04.2013 00:14:57,tp 0.93478,-3.29,-150.1600000000035,0.0,0.0,0.93578,08.04.2013 22:30:00,9028,-0.07356906070202147,58.76,IS,0.58,0.0,Phase3-EA-SA2v2-USDCHF-M15-107,USDCHFMT4,1758,1h 44m,Sell
114004.57,1.21697,09.04.2013 00:49:57,tp 1.21697,-1.05,-102.97000000000116,0.0,0.0,1.21587,08.04.2013 20:05:00,9029,-0.05044889571448495,47.19,IS,0.41,0.0,Phase3-EA-SA2v2-EURCHF-M5-43,EURCHFMT4,4694,4h 44m,Buy
114094.95,151374,09.04.2013 04:04:57,tp 151.374,0.0,-12.589999999996508,0.0,0.0,151764,09.04.2013 00:55:00,9030,-0.006168316956833856,90.38,IS,0.23,0.0,Phase3-EA-S4v1-GBPJPY-M5-194,GBPJPYMT4,2140,3h 9m,Sell
114029.61,128845,09.04.2013 09:29:58,sl 128.845,0.0,-77.92999999999302,0.0,0.0,129565,09.04.2013 01:30:00,9031,-0.03818085309341959,-65.34,IS,0.09,0.0,Phase3-EA-TR1v1-EURJPY-M30-91,EURJPYMT4,1564,7h 59m,Buy
113988.49,1.21789,09.04.2013 10:00:00,,0.0,-119.04999999998836,0.0,0.0,1.21676,09.04.2013 01:15:00,9032,-0.058327095608514894,-41.12,IS,0.34,0.0,Phase3-EA-S4v1-EURCHF-M15-221,EURCHFMT4,2344,8h 45m,Sell
113935.06,1.21822,09.04.2013 10:25:00,,0.0,-172.47999999998137,0.0,0.0,1217,09.04.2013 02:05:00,9033,-0.08450447249522508,-53.43,IS,0.41,0.0,Phase3-EA-SA2v2-EURCHF-M5-43,EURCHFMT4,4696,8h 20m,Sell
113946.49,1.21974,10.04.2013 05:00:00,,-2.2,-161.04999999998836,0.0,0.0,1.22005,09.04.2013 20:40:00,9034,-0.0789044833914453,11.43,IS,0.41,0.0,Phase3-EA-SA2v2-EURCHF-M5-43,EURCHFMT4,4698,8h 20m,Sell
114008.75,0.93164,10.04.2013 05:44:58,tp 0.93164,0.0,-98.78999999997905,0.0,0.0,0.93264,10.04.2013 01:30:00,9035,-0.04840095569226818,62.26,IS,0.58,0.0,Phase3-EA-SA2v2-USDCHF-M15-107,USDCHFMT4,1760,4h 14m,Sell
114049.35,151861,10.04.2013 08:30:00,,0.0,-58.189999999973224,0.0,0.0,151686,10.04.2013 03:05:00,9036,-0.028509480835432605,40.6,IS,0.23,0.0,Phase3-EA-S4v1-GBPJPY-M5-194,GBPJPYMT4,2142,5h 25m,Buy
114047.89,1.21959,10.04.2013 11:30:00,,0.0,-59.649999999965075,0.0,0.0,1.21963,10.04.2013 02:45:00,9037,-0.029224790029787624,-1.46,IS,0.34,0.0,Phase3-EA-S4v1-EURCHF-M15-221,EURCHFMT4,2346,8h 45m,Buy
114046.04,1.21821,11.04.2013 05:40:00,,-3.17,-61.499999999970896,0.0,0.0,1.21818,10.04.2013 21:20:00,9038,-0.030131174967848125,-1.85,IS,0.41,0.0,Phase3-EA-SA2v2-EURCHF-M5-43,EURCHFMT4,4700,8h 20m,Buy
114049.77,0.93284,11.04.2013 06:45:00,,0.0,-57.76999999996042,0.0,0.0,0.9329,11.04.2013 02:30:00,9039,-0.028303706957597027,3.73,IS,0.58,0.0,Phase3-EA-SA2v2-USDCHF-M15-107,USDCHFMT4,1762,4h 15m,Sell
114027.84,152685,11.04.2013 08:20:00,,0.0,-79.69999999995343,0.0,0.0,152.78,11.04.2013 02:55:00,9040,-0.039048043007109415,-21.93,IS,0.23,0.0,Phase3-EA-S4v1-GBPJPY-M5-194,GBPJPYMT4,2144,5h 25m,Buy
114193.18,153058,11.04.2013 10:59:58,tp 153.058,-1.63,-0.0,0.0,0.0,151208,08.04.2013 01:30:00,9041,-0.0,165.34,IS,0.09,0.0,Phase3-EA-B1v1-GBPJPY-M30-1,GBPJPYMT4,868,3d 9h 29m,Buy
114153.81,130069,11.04.2013 15:59:57,sl 130.069,0.0,-39.36999999999534,0.0,0.0,130299,11.04.2013 09:15:00,9042,-0.019280761482824815,-39.37,IS,0.17,0.0,Phase3-EA-T1v2-EURJPY-M15-322,EURJPYMT4,1536,6h 44m,Buy
114200.07,1.21915,12.04.2013 00:04:57,tp 1.21915,-2.2,-0.0,0.0,0.0,1.22025,11.04.2013 20:45:00,9043,-0.0,46.26,IS,0.41,0.0,Phase3-EA-SA2v2-EURCHF-M5-43,EURCHFMT4,4702,3h 19m,Sell
114196.77,0.9304,12.04.2013 02:15:00,,-3.3,-3.2999999999883585,0.0,0.0,0.9304,11.04.2013 22:00:00,9044,-0.00161606212964978,-3.3,IS,0.58,0.0,Phase3-EA-SA2v2-USDCHF-M15-107,USDCHFMT4,1764,4h 15m,Sell
114190.64,130624,12.04.2013 03:15:00,,-0.84,-9.429999999993015,0.0,0.0,130655,11.04.2013 18:15:00,9045,-0.004618019964436333,-6.13,IS,0.17,0.0,Phase3-EA-T1v2-EURJPY-M15-322,EURJPYMT4,1538,9h 0m,Buy
114135.51,153351,12.04.2013 04:40:00,,-0.83,-64.55999999999767,0.0,0.0,153586,11.04.2013 23:15:00,9046,-0.03161605184562245,-55.13,IS,0.23,0.0,Phase3-EA-S4v1-GBPJPY-M5-194,GBPJPYMT4,2146,5h 25m,Buy
114068.08,129322,12.04.2013 11:59:58,sl 129.322,-2.22,-131.9899999999907,0.0,0.0,130042,09.04.2013 22:00:00,9047,-0.06463758802824603,-67.43,IS,0.09,0.0,Phase3-EA-TR1v1-EURJPY-M30-91,EURJPYMT4,1566,2d 13h 59m,Buy
113840.73,98914,12.04.2013 12:29:58,sl 98.914,-0.79,-359.3399999999965,0.0,0.0,99744,11.04.2013 23:45:00,9048,-0.1759744744455742,-227.35,IS,0.27,0.0,Phase3-EA-S1v2-USDJPY-M15-0,USDJPYMT4,2578,12h 44m,Buy
113744.47,1.21681,12.04.2013 13:15:00,,0.0,-455.6000000000058,0.0,0.0,1.21945,12.04.2013 04:30:00,9049,-0.2231145170518323,-96.26,IS,0.34,0.0,Phase3-EA-S4v1-EURCHF-M15-221,EURCHFMT4,2348,8h 45m,Buy
113737.39,99097,12.04.2013 17:15:00,,0.0,-462.679999999993,0.0,0.0,99071,12.04.2013 17:00:00,9050,-0.22658170489363233,-7.08,IS,0.27,0.0,Phase3-EA-S1v2-USDJPY-M15-0,USDJPYMT4,2580,15m 0s,Sell
113757.6,98884,12.04.2013 22:00:00,,0.0,-442.47000000000116,0.0,0.0,98958,12.04.2013 21:15:00,9051,-0.21668454863898864,20.21,IS,0.27,0.0,Phase3-EA-S1v2-USDJPY-M15-0,USDJPYMT4,2582,45m 0s,Sell
113819.35,0.92803,15.04.2013 01:15:00,tp 0.92803,-0.75,-380.72000000000116,0.0,0.0,0.92703,12.04.2013 23:45:00,9052,-0.18644459818255654,61.75,IS,0.58,0.0,Phase3-EA-SA2v2-USDCHF-M15-107,USDCHFMT4,1766,2d 1h 30m,Buy
113910.44,151202,15.04.2013 05:04:57,tp 151.202,0.0,-289.63000000000466,0.0,0.0,151592,15.04.2013 03:40:00,9053,-0.14183638624609834,91.09,IS,0.23,0.0,Phase3-EA-S4v1-GBPJPY-M5-194,GBPJPYMT4,2148,1h 24m,Sell
113907.18,1.21636,15.04.2013 06:25:00,,-1.06,-292.89000000001397,0.0,0.0,1.21641,12.04.2013 22:05:00,9054,-0.14343285974388376,-3.26,IS,0.41,0.0,Phase3-EA-SA2v2-EURCHF-M5-43,EURCHFMT4,4704,2d 8h 20m,Buy
114076.43,149704,15.04.2013 06:59:58,tp 149.704,-0.53,-123.64000000001397,0.0,0.0,151554,12.04.2013 22:30:00,9055,-0.0605484611244322,169.25,IS,0.09,0.0,Phase3-EA-B1v1-GBPJPY-M30-1,GBPJPYMT4,870,2d 8h 29m,Sell
114370.84,127633,15.04.2013 06:59:58,tp 127.633,-0.61,-0.0,0.0,0.0,129333,12.04.2013 22:00:00,9056,-0.0,294.41,IS,0.17,0.0,Phase3-EA-T1v2-EURJPY-M15-322,EURJPYMT4,1540,2d 8h 59m,Sell
114486.47,127633,15.04.2013 06:59:58,tp 127.633,0.0,-0.0,0.0,0.0,128893,15.04.2013 02:30:00,9057,-0.0,115.63,IS,0.09,0.0,Phase3-EA-TR1v1-EURJPY-M30-91,EURJPYMT4,1568,4h 29m,Sell
114508.76,1.21666,15.04.2013 10:00:00,,0.0,-0.0,0.0,0.0,1.21605,15.04.2013 01:15:00,9058,-0.0,22.29,IS,0.34,0.0,Phase3-EA-S4v1-EURCHF-M15-221,EURCHFMT4,2350,8h 45m,Buy
114581.44,97702,15.04.2013 21:00:00,,0.0,-0.0,0.0,0.0,97965,15.04.2013 17:30:00,9059,-0.0,72.68,IS,0.27,0.0,Phase3-EA-S1v2-USDJPY-M15-0,USDJPYMT4,2584,3h 30m,Sell
114509.6,127331,15.04.2013 21:29:58,sl 127.331,0.0,-71.83999999999651,0.0,0.0,128111,15.04.2013 10:00:00,9060,-0.035115599929297664,-71.84,IS,0.09,0.0,Phase3-EA-TR1v1-EURJPY-M30-91,EURJPYMT4,1570,11h 29m,Buy
114807.0,126183,15.04.2013 22:59:58,tp 126.183,0.0,-0.0,0.0,0.0,127883,15.04.2013 20:45:00,9061,-0.0,297.4,IS,0.17,0.0,Phase3-EA-T1v2-EURJPY-M15-322,EURJPYMT4,1542,2h 14m,Sell
114616.06,147309,15.04.2013 23:24:59,sl 147.309,0.0,-190.94000000000233,0.0,0.0,148109,15.04.2013 23:05:00,9062,-0.09322923532887124,-190.94,IS,0.23,0.0,Phase3-EA-S4v1-GBPJPY-M5-194,GBPJPYMT4,2150,19m 59s,Buy
114708.85,147851,15.04.2013 23:59:58,tp 147.851,0.0,-98.14999999999418,0.0,0.0,147461,15.04.2013 23:30:00,9063,-0.04792316668863548,92.79,IS,0.23,0.0,Phase3-EA-S4v1-GBPJPY-M5-194,GBPJPYMT4,2152,29m 58s,Buy
114641.71,126263,16.04.2013 01:29:58,sl 126.263,0.0,-165.29000000000815,0.0,0.0,125543,16.04.2013 00:30:00,9064,-0.08070524933230178,-67.14,IS,0.09,0.0,Phase3-EA-TR1v1-EURJPY-M30-91,EURJPYMT4,1572,59m 58s,Sell
114590.03,1.21452,16.04.2013 05:40:00,,-1.06,-216.97000000000116,0.0,0.0,1.21567,15.04.2013 21:20:00,9065,-0.10593876185872556,-51.68,IS,0.41,0.0,Phase3-EA-SA2v2-EURCHF-M5-43,EURCHFMT4,4706,8h 20m,Buy
114709.08,127852,16.04.2013 10:29:58,tp 127.852,0.0,-97.9200000000128,0.0,0.0,126562,16.04.2013 02:30:00,9066,-0.047810865839552505,119.05,IS,0.09,0.0,Phase3-EA-TR1v1-EURJPY-M30-91,EURJPYMT4,1574,7h 59m,Buy
114754.35,1.21532,16.04.2013 11:00:00,,0.0,-52.65000000002328,0.0,0.0,1.21408,16.04.2013 02:15:00,9067,-0.025707129150870336,45.27,IS,0.34,0.0,Phase3-EA-S4v1-EURCHF-M15-221,EURCHFMT4,2352,8h 45m,Buy
114755.76,97747,17.04.2013 00:45:00,,-0.8,-51.24000000001979,0.0,0.0,97739,16.04.2013 18:00:00,9068,-0.025018676119478105,1.41,IS,0.27,0.0,Phase3-EA-S1v2-USDJPY-M15-0,USDJPYMT4,2586,6h 45m,Buy
114745.51,0.92235,17.04.2013 04:00:00,,-3.33,-61.49000000001979,0.0,0.0,0.92224,16.04.2013 23:45:00,9069,-0.030023387872494336,-10.25,IS,0.58,0.0,Phase3-EA-SA2v2-USDCHF-M15-107,USDCHFMT4,1768,4h 15m,Sell
114747.55,1.21568,17.04.2013 04:25:00,,-1.07,-59.45000000001164,0.0,0.0,1.21561,16.04.2013 20:05:00,9070,-0.029027328167499807,2.04,IS,0.41,0.0,Phase3-EA-SA2v2-EURCHF-M5-43,EURCHFMT4,4708,8h 20m,Buy
114560.3,151078,17.04.2013 07:54:57,sl 151.078,0.0,-246.70000000001164,0.0,0.0,150278,17.04.2013 03:30:00,9071,-0.12045486726528408,-187.25,IS,0.23,0.0,Phase3-EA-S4v1-GBPJPY-M5-194,GBPJPYMT4,2154,4h 24m,Sell
114459.85,98112,17.04.2013 11:00:00,,0.0,-347.1500000000233,0.0,0.0,97747,17.04.2013 00:45:00,9072,-0.1695010424448488,-100.45,IS,0.27,0.0,Phase3-EA-S1v2-USDJPY-M15-0,USDJPYMT4,2588,10h 15m,Sell
114481.57,1.21515,17.04.2013 13:15:00,,0.0,-325.4300000000221,0.0,0.0,1.21574,17.04.2013 04:30:00,9073,-0.15889593617406653,21.72,IS,0.34,0.0,Phase3-EA-S4v1-EURCHF-M15-221,EURCHFMT4,2354,8h 45m,Sell
114414.96,128061,17.04.2013 17:29:57,sl 128.061,-0.45,-392.04000000000815,0.0,0.0,128781,16.04.2013 16:30:00,9074,-0.19141923860024615,-66.61,IS,0.09,0.0,Phase3-EA-TR1v1-EURJPY-M30-91,EURJPYMT4,1576,1d 0h 59m,Buy
114468.27,97742,17.04.2013 17:30:00,,0.0,-338.7300000000105,0.0,0.0,97935,17.04.2013 17:00:00,9075,-0.1653898548389502,53.31,IS,0.27,0.0,Phase3-EA-S1v2-USDJPY-M15-0,USDJPYMT4,2590,30m 0s,Sell
114579.07,97475,17.04.2013 19:29:58,tp 97.475,0.0,-227.93000000002212,0.0,0.0,97875,17.04.2013 18:45:00,9076,-0.11129014145025362,110.8,IS,0.27,0.0,Phase3-EA-S1v2-USDJPY-M15-0,USDJPYMT4,2592,44m 58s,Sell
114598.26,97825,18.04.2013 03:15:00,,-3.72,-208.7400000000198,0.0,0.0,97908,17.04.2013 22:15:00,9077,-0.10192034451948356,19.19,IS,0.27,0.0,Phase3-EA-S1v2-USDJPY-M15-0,USDJPYMT4,2594,5h 0m,Sell
114558.35,127756,18.04.2013 05:14:58,sl 127.756,0.0,-248.65000000002328,0.0,0.0,127526,18.04.2013 04:30:00,9078,-0.12140698315976602,-39.91,IS,0.17,0.0,Phase3-EA-T1v2-EURJPY-M15-322,EURJPYMT4,1544,44m 58s,Sell
114583.09,98212,18.04.2013 23:00:00,,0.0,-223.9100000000326,0.0,0.0,98122,18.04.2013 17:00:00,9079,-0.10932731791395384,24.74,IS,0.27,0.0,Phase3-EA-S1v2-USDJPY-M15-0,USDJPYMT4,2596,6h 0m,Buy
114597.21,0.93228,19.04.2013 03:30:00,,-3.3,-209.79000000003725,0.0,0.0,0.93256,18.04.2013 23:15:00,9080,-0.10243302230882546,14.12,IS,0.58,0.0,Phase3-EA-SA2v2-USDCHF-M15-107,USDCHFMT4,1770,4h 15m,Sell
114688.58,149918,19.04.2013 04:04:57,tp 149.918,0.0,-118.42000000004191,0.0,0.0,150308,19.04.2013 01:50:00,9081,-0.05782028934559917,91.37,IS,0.23,0.0,Phase3-EA-S4v1-GBPJPY-M5-194,GBPJPYMT4,2156,2h 14m,Sell
114648.75,128108,19.04.2013 04:14:57,sl 128.108,0.0,-158.2500000000291,0.0,0.0,128338,19.04.2013 01:45:00,9082,-0.07726786682097207,-39.83,IS,0.17,0.0,Phase3-EA-T1v2-EURJPY-M15-322,EURJPYMT4,1546,2h 29m,Buy
114662.84,1.21684,19.04.2013 07:55:00,,-2.2,-144.1600000000326,0.0,0.0,1.21721,18.04.2013 23:35:00,9083,-0.07038821915268123,14.09,IS,0.41,0.0,Phase3-EA-SA2v2-EURCHF-M5-43,EURCHFMT4,4710,8h 20m,Sell
114623.61,129992,19.04.2013 21:44:58,sl 129.992,0.0,-183.39000000004307,0.0,0.0,130222,19.04.2013 21:30:00,9084,-0.08954283789130359,-39.23,IS,0.17,0.0,Phase3-EA-T1v2-EURJPY-M15-322,EURJPYMT4,1548,14m 58s,Buy
114650.72,130081,22.04.2013 10:45:00,,-0.84,-156.28000000005704,0.0,0.0,129917,19.04.2013 21:45:00,9085,-0.07630598563528407,27.11,IS,0.17,0.0,Phase3-EA-T1v2-EURJPY-M15-322,EURJPYMT4,1550,2d 13h 0m,Buy
114585.16,128976,22.04.2013 17:29:58,sl 128.976,-0.44,-221.84000000005472,0.0,0.0,129696,19.04.2013 12:30:00,9086,-0.10831661027213599,-65.56,IS,0.09,0.0,Phase3-EA-TR1v1-EURJPY-M30-91,EURJPYMT4,1578,3d 4h 59m,Buy
114519.95,129923,22.04.2013 21:59:58,sl 129.923,0.0,-287.05000000004657,0.0,0.0,129203,22.04.2013 17:30:00,9087,-0.14015634231254062,-65.21,IS,0.09,0.0,Phase3-EA-TR1v1-EURJPY-M30-91,EURJPYMT4,1580,4h 29m,Sell
114591.3,99139,22.04.2013 23:45:00,,0.0,-215.70000000004075,0.0,0.0,99401,22.04.2013 21:30:00,9088,-0.10531866586593214,71.35,IS,0.27,0.0,Phase3-EA-S1v2-USDJPY-M15-0,USDJPYMT4,2598,2h 15m,Sell
114591.3,1.22034,23.04.2013 06:15:00,,-2.19,-215.70000000004075,0.0,0.0,1.22039,22.04.2013 21:55:00,9089,-0.10531866586593214,0.0,IS,0.41,0.0,Phase3-EA-SA2v2-EURCHF-M5-43,EURCHFMT4,4712,8h 20m,Sell
114883.6,127893,23.04.2013 13:44:58,tp 127.893,-0.6,-0.0,0.0,0.0,129593,22.04.2013 23:30:00,9090,-0.0,292.3,IS,0.17,0.0,Phase3-EA-T1v2-EURJPY-M15-322,EURJPYMT4,1552,14h 14m,Sell
114822.49,150839,23.04.2013 14:59:58,sl 150.839,0.0,-61.10999999998603,0.0,0.0,150169,23.04.2013 11:00:00,9091,-0.029826691838676075,-61.11,IS,0.09,0.0,Phase3-EA-B1v1-GBPJPY-M30-1,GBPJPYMT4,872,3h 59m,Sell
114870.33,1.22559,23.04.2013 20:14:57,tp 1.22559,0.0,-13.269999999989523,0.0,0.0,1.22669,23.04.2013 20:05:00,9092,-0.006476848317771388,47.84,IS,0.41,0.0,Phase3-EA-SA2v2-EURCHF-M5-43,EURCHFMT4,4714,9m 57s,Sell
114925.98,99467,23.04.2013 22:45:00,,0.0,-0.0,0.0,0.0,99262,23.04.2013 20:15:00,9093,-0.0,55.65,IS,0.27,0.0,Phase3-EA-S1v2-USDJPY-M15-0,USDJPYMT4,2600,2h 30m,Buy
114846.64,1.22876,24.04.2013 06:10:00,,-2.17,-79.33999999999651,0.0,0.0,1.22698,23.04.2013 21:50:00,9094,-0.03871641848436988,-79.34,IS,0.41,0.0,Phase3-EA-SA2v2-EURCHF-M5-43,EURCHFMT4,4716,8h 20m,Sell
114807.36,129.2,24.04.2013 10:59:57,sl 129.200,0.0,-118.61999999999534,0.0,0.0,129.43,24.04.2013 09:15:00,9095,-0.05788431510733523,-39.28,IS,0.17,0.0,Phase3-EA-T1v2-EURJPY-M15-322,EURJPYMT4,1554,1h 44m,Buy
114800.44,99429,25.04.2013 03:00:00,,-3.66,-125.54000000000815,0.0,0.0,99417,24.04.2013 20:30:00,9096,-0.06126114414580696,-6.92,IS,0.27,0.0,Phase3-EA-S1v2-USDJPY-M15-0,USDJPYMT4,2602,6h 30m,Sell
114765.31,1.23339,25.04.2013 06:10:00,,-6.5,-160.6700000000128,0.0,0.0,1.23273,24.04.2013 21:50:00,9097,-0.07840391930784571,-35.13,IS,0.41,0.0,Phase3-EA-SA2v2-EURCHF-M5-43,EURCHFMT4,4718,8h 20m,Sell
114782.96,1.23313,25.04.2013 13:45:00,,0.0,-143.02000000001863,0.0,0.0,1.23362,25.04.2013 05:00:00,9098,-0.06979105333546187,17.65,IS,0.34,0.0,Phase3-EA-S4v1-EURCHF-M15-221,EURCHFMT4,2356,8h 45m,Sell
114743.65,129462,25.04.2013 21:29:58,sl 129.462,0.0,-182.3300000000163,0.0,0.0,129232,25.04.2013 17:15:00,9099,-0.08897358939067435,-39.31,IS,0.17,0.0,Phase3-EA-T1v2-EURJPY-M15-322,EURJPYMT4,1556,4h 14m,Sell
114791.36,1.22882,25.04.2013 22:14:58,tp 1.22882,0.0,-134.62000000002445,0.0,0.0,1.22992,25.04.2013 22:05:00,9100,-0.06569201230611356,47.71,IS,0.41,0.0,Phase3-EA-SA2v2-EURCHF-M5-43,EURCHFMT4,4720,9m 58s,Sell
114788.94,99354,26.04.2013 02:30:00,,-0.79,-137.04000000003725,0.0,0.0,99.36,25.04.2013 21:00:00,9101,-0.06687292650743287,-2.42,IS,0.27,0.0,Phase3-EA-S1v2-USDJPY-M15-0,USDJPYMT4,2604,5h 30m,Buy
114850.37,0.94421,26.04.2013 04:29:58,tp 0.94421,0.0,-75.61000000004424,0.0,0.0,0.94521,26.04.2013 02:15:00,9102,-0.03689624907493129,61.43,IS,0.58,0.0,Phase3-EA-SA2v2-USDCHF-M15-107,USDCHFMT4,1772,2h 14m,Sell
114844.98,1.22884,26.04.2013 06:35:00,,-1.04,-81.00000000005821,0.0,0.0,1.22894,25.04.2013 22:15:00,9103,-0.03952646706877177,-5.39,IS,0.41,0.0,Phase3-EA-SA2v2-EURCHF-M5-43,EURCHFMT4,4722,8h 20m,Buy
114771.76,128147,26.04.2013 08:29:58,sl 128.147,-2.21,-154.22000000005937,0.0,0.0,128927,23.04.2013 16:30:00,9104,-0.07525644137461665,-73.22,IS,0.09,0.0,Phase3-EA-TR1v1-EURJPY-M30-91,EURJPYMT4,1582,2d 15h 59m,Buy
114844.15,1.22769,26.04.2013 14:00:00,,0.0,-81.8300000000454,0.0,0.0,1.2297,26.04.2013 05:15:00,9105,-0.03993149136095141,72.39,IS,0.34,0.0,Phase3-EA-S4v1-EURCHF-M15-221,EURCHFMT4,2358,8h 45m,Sell
114772.68,127675,26.04.2013 16:59:57,sl 127.675,0.0,-153.30000000004657,0.0,0.0,128455,26.04.2013 12:30:00,9106,-0.07480749878568146,-71.47,IS,0.09,0.0,Phase3-EA-TR1v1-EURJPY-M30-91,EURJPYMT4,1584,4h 29m,Buy
114732.17,127905,29.04.2013 01:00:00,sl 127.905,-0.61,-193.81000000005588,0.0,0.0,127675,26.04.2013 23:30:00,9107,-0.09457561213080691,-40.51,IS,0.17,0.0,Phase3-EA-T1v2-EURJPY-M15-322,EURJPYMT4,1558,2d 1h 30m,Sell
114841.42,97742,29.04.2013 01:14:58,tp 97.742,-1.24,-84.56000000005588,0.0,0.0,98142,26.04.2013 20:45:00,9108,-0.04126367969549565,109.25,IS,0.27,0.0,Phase3-EA-S1v2-USDJPY-M15-0,USDJPYMT4,2606,2d 4h 29m,Sell
114780.9,1.22863,29.04.2013 04:25:00,,-2.18,-145.0800000000454,0.0,0.0,1.22729,26.04.2013 20:05:00,9109,-0.07079629434981582,-60.52,IS,0.41,0.0,Phase3-EA-SA2v2-EURCHF-M5-43,EURCHFMT4,4724,2d 8h 20m,Sell
114694.42,151466,29.04.2013 04:35:00,,-0.84,-231.56000000005588,0.0,0.0,151.83,26.04.2013 23:10:00,9110,-0.11299689770914101,-86.48,IS,0.23,0.0,Phase3-EA-S4v1-GBPJPY-M5-194,GBPJPYMT4,2158,2d 5h 25m,Buy
114632.87,151857,29.04.2013 10:29:58,sl 151.857,0.0,-293.11000000004424,0.0,0.0,151187,29.04.2013 05:30:00,9111,-0.14303213287063107,-61.55,IS,0.09,0.0,Phase3-EA-B1v1-GBPJPY-M30-1,GBPJPYMT4,874,4h 59m,Sell
114681.01,1.22648,29.04.2013 23:59:58,tp 1.22648,0.0,-244.97000000003027,0.0,0.0,1.22758,29.04.2013 22:45:00,9112,-0.1195407239238427,48.14,IS,0.41,0.0,Phase3-EA-SA2v2-EURCHF-M5-43,EURCHFMT4,4726,1h 14m,Sell
114708.28,98102,30.04.2013 04:15:00,,-0.8,-217.70000000004075,0.0,0.0,98.0,29.04.2013 22:00:00,9113,-0.1062334800107042,27.27,IS,0.27,0.0,Phase3-EA-S1v2-USDJPY-M15-0,USDJPYMT4,2608,6h 15m,Buy
114668.33,128143,30.04.2013 05:59:58,sl 128.143,0.0,-257.6500000000524,0.0,0.0,128373,30.04.2013 04:30:00,9114,-0.12572832395387407,-39.95,IS,0.17,0.0,Phase3-EA-T1v2-EURJPY-M15-322,EURJPYMT4,1560,1h 29m,Buy
114813.66,1.22347,30.04.2013 14:14:57,tp 1.22347,0.0,-112.32000000006519,0.0,0.0,1.22747,30.04.2013 06:00:00,9115,-0.054810034335355945,145.33,IS,0.34,0.0,Phase3-EA-S4v1-EURCHF-M15-221,EURCHFMT4,2360,8h 14m,Sell
114808.25,97439,01.05.2013 00:15:00,,-1.25,-117.73000000006869,0.0,0.0,97424,30.04.2013 23:15:00,9116,-0.057450011950689765,-5.41,IS,0.27,0.0,Phase3-EA-S1v2-USDJPY-M15-0,USDJPYMT4,2610,1h 0m,Sell
114821.74,1.22397,01.05.2013 06:25:00,,-1.06,-104.240000000078,0.0,0.0,1.22364,30.04.2013 22:05:00,9117,-0.05086714724998631,13.49,IS,0.41,0.0,Phase3-EA-SA2v2-EURCHF-M5-43,EURCHFMT4,4728,8h 20m,Buy
114816.78,151137,01.05.2013 08:15:00,,0.0,-109.20000000006985,0.0,0.0,151158,01.05.2013 02:50:00,9118,-0.053287533381599216,-4.96,IS,0.23,0.0,Phase3-EA-S4v1-GBPJPY-M5-194,GBPJPYMT4,2160,5h 25m,Buy
114749.48,128801,01.05.2013 11:59:58,sl 128.801,-0.96,-176.5000000000582,0.0,0.0,128081,26.04.2013 15:30:00,9119,-0.08612865972389512,-67.3,IS,0.09,0.0,Phase3-EA-TR1v1-EURJPY-M30-91,EURJPYMT4,1585,4d 20h 29m,Sell
114774.98,128418,01.05.2013 18:30:00,,0.0,-151.0000000000582,0.0,0.0,128272,01.05.2013 09:30:00,9120,-0.0736851423133648,25.5,IS,0.17,0.0,Phase3-EA-T1v2-EURJPY-M15-322,EURJPYMT4,1562,9h 0m,Buy
114778.86,97304,01.05.2013 21:15:00,,0.0,-147.12000000005355,0.0,0.0,97318,01.05.2013 18:30:00,9121,-0.07179177574266223,3.88,IS,0.27,0.0,Phase3-EA-S1v2-USDJPY-M15-0,USDJPYMT4,2612,2h 45m,Sell
114799.84,97213,02.05.2013 02:45:00,,-3.74,-126.14000000004307,0.0,0.0,97302,01.05.2013 21:15:00,9122,-0.06155393279077766,20.98,IS,0.27,0.0,Phase3-EA-S1v2-USDJPY-M15-0,USDJPYMT4,2614,5h 30m,Sell
114768.8,1.22192,02.05.2013 04:35:00,,-3.18,-157.18000000005122,0.0,0.0,1.22255,01.05.2013 20:15:00,9123,-0.07670086535638403,-31.04,IS,0.41,0.0,Phase3-EA-SA2v2-EURCHF-M5-43,EURCHFMT4,4730,8h 20m,Buy
114799.55,1.2226,02.05.2013 11:00:00,,0.0,-126.43000000005122,0.0,0.0,1.22176,02.05.2013 02:15:00,9124,-0.06169544730250923,30.75,IS,0.34,0.0,Phase3-EA-S4v1-EURCHF-M15-221,EURCHFMT4,2362,8h 45m,Buy
114726.49,129127,02.05.2013 15:29:57,sl 129.127,-0.97,-199.4900000000489,0.0,0.0,128347,01.05.2013 17:00:00,9125,-0.09734734463636477,-73.06,IS,0.09,0.0,Phase3-EA-TR1v1-EURJPY-M30-91,EURJPYMT4,1588,22h 29m,Sell
114739.19,98011,03.05.2013 03:15:00,,-0.8,-186.79000000003725,0.0,0.0,97962,02.05.2013 22:00:00,9126,-0.09114998498484006,12.7,IS,0.27,0.0,Phase3-EA-S1v2-USDJPY-M15-0,USDJPYMT4,2616,5h 15m,Buy
114746.65,1.2215,03.05.2013 04:45:00,,-2.19,-179.3300000000454,0.0,0.0,1.22172,02.05.2013 20:25:00,9127,-0.08750964616592027,7.46,IS,0.41,0.0,Phase3-EA-SA2v2-EURCHF-M5-43,EURCHFMT4,4732,8h 20m,Sell
114709.4,0.93429,03.05.2013 06:00:00,,0.0,-216.5800000000454,0.0,0.0,0.93489,03.05.2013 01:45:00,9128,-0.10568694120679299,-37.25,IS,0.58,0.0,Phase3-EA-SA2v2-USDCHF-M15-107,USDCHFMT4,1774,4h 15m,Buy
114655.46,1.22307,03.05.2013 14:15:00,,0.0,-270.52000000004773,0.0,0.0,1.22159,03.05.2013 05:30:00,9129,-0.13200864038812768,-53.94,IS,0.34,0.0,Phase3-EA-S4v1-EURCHF-M15-221,EURCHFMT4,2364,8h 45m,Sell
114772.42,129405,03.05.2013 15:59:58,tp 129.405,0.0,-153.56000000005588,0.0,0.0,128115,03.05.2013 05:30:00,9130,-0.07493437386516592,116.96,IS,0.09,0.0,Phase3-EA-TR1v1-EURJPY-M30-91,EURJPYMT4,1590,10h 29m,Buy
114886.82,130.05,03.05.2013 16:59:57,tp 130.050,0.0,-39.1600000000617,0.0,0.0,128.79,03.05.2013 13:00:00,9131,-0.019109338894005297,114.4,IS,0.09,0.0,Phase3-EA-TR1v1-EURJPY-M30-91,EURJPYMT4,1591,3h 59m,Buy
114876.33,99145,06.05.2013 01:00:00,,-1.23,-49.65000000005239,0.0,0.0,99111,03.05.2013 21:45:00,9132,-0.02422826036994048,-10.49,IS,0.27,0.0,Phase3-EA-S1v2-USDJPY-M15-0,USDJPYMT4,2618,2d 3h 15m,Sell
114917.08,0.9351,06.05.2013 02:30:00,,-3.29,-8.900000000052387,0.0,0.0,0.93581,03.05.2013 22:15:00,9133,-0.004343031566838107,40.75,IS,0.58,0.0,Phase3-EA-SA2v2-USDCHF-M15-107,USDCHFMT4,1776,2d 4h 15m,Sell
114867.09,1.22716,06.05.2013 04:50:00,,-2.19,-58.890000000043074,0.0,0.0,1.22607,03.05.2013 20:30:00,9134,-0.028737205502222214,-49.99,IS,0.41,0.0,Phase3-EA-SA2v2-EURCHF-M5-43,EURCHFMT4,4734,2d 8h 20m,Sell
114805.07,1.22882,06.05.2013 12:00:00,,0.0,-120.9100000000326,0.0,0.0,1.22711,06.05.2013 03:15:00,9135,-0.059001791768926524,-62.02,IS,0.34,0.0,Phase3-EA-S4v1-EURCHF-M15-221,EURCHFMT4,2366,8h 45m,Sell
114743.95,153699,07.05.2013 04:29:58,sl 153.699,-0.33,-182.03000000002794,0.0,0.0,154369,06.05.2013 02:30:00,9136,-0.08882719506820319,-61.12,IS,0.09,0.0,Phase3-EA-B1v1-GBPJPY-M30-1,GBPJPYMT4,876,1d 1h 59m,Buy
114602.96,1.23105,07.05.2013 12:14:58,sl 1.23105,0.0,-323.0200000000186,0.0,0.0,1.22715,07.05.2013 05:15:00,9137,-0.15762764682155825,-140.99,IS,0.34,0.0,Phase3-EA-S4v1-EURCHF-M15-221,EURCHFMT4,2368,6h 59m,Sell
114563.52,130045,07.05.2013 13:14:57,sl 130.045,0.0,-362.46000000002095,0.0,0.0,129815,07.05.2013 03:15:00,9138,-0.17687362041651294,-39.44,IS,0.17,0.0,Phase3-EA-T1v2-EURJPY-M15-322,EURJPYMT4,1564,9h 59m,Sell
114516.74,1.54527,07.05.2013 17:59:58,sl 1.54527,-4.78,-409.2400000000198,0.0,0.0,1.54827,26.04.2013 20:30:00,9139,-0.19970137510139896,-46.78,IS,0.14,0.0,Phase3-EA-B1v1-GBPUSD-M30-14,GBPUSDMT4,590,10d 21h 29m,Buy
114537.88,98953,08.05.2013 00:45:00,,-1.23,-388.1000000000058,0.0,0.0,99035,07.05.2013 22:30:00,9140,-0.18938545517752506,21.14,IS,0.27,0.0,Phase3-EA-S1v2-USDJPY-M15-0,USDJPYMT4,2620,2h 15m,Sell
114536.39,1.23035,08.05.2013 04:25:00,,-1.05,-389.5899999999965,0.0,0.0,1.23036,07.05.2013 20:05:00,9141,-0.19011254697915542,-1.49,IS,0.41,0.0,Phase3-EA-SA2v2-EURCHF-M5-43,EURCHFMT4,4736,8h 20m,Buy
114555.44,153.28,08.05.2013 06:10:00,,0.0,-370.54000000000815,0.0,0.0,153198,08.05.2013 00:45:00,9142,-0.18081650750188258,19.05,IS,0.23,0.0,Phase3-EA-S4v1-GBPJPY-M5-194,GBPJPYMT4,2162,5h 25m,Buy
114486.0,1.23212,08.05.2013 12:45:00,,0.0,-439.9800000000105,0.0,0.0,1.2302,08.05.2013 04:00:00,9143,-0.21470191334452,-69.44,IS,0.34,0.0,Phase3-EA-S4v1-EURCHF-M15-221,EURCHFMT4,2370,8h 45m,Sell
114473.19,1.23044,09.05.2013 04:25:00,,-3.16,-452.79000000000815,0.0,0.0,1.23066,08.05.2013 20:05:00,9144,-0.22095295091427938,-12.81,IS,0.41,0.0,Phase3-EA-SA2v2-EURCHF-M5-43,EURCHFMT4,4738,8h 20m,Buy
114401.22,130893,09.05.2013 20:59:58,sl 130.893,-1.59,-524.7600000000093,0.0,0.0,130113,06.05.2013 09:30:00,9145,-0.2560729488764708,-71.97,IS,0.09,0.0,Phase3-EA-TR1v1-EURJPY-M30-91,EURJPYMT4,1594,3d 11h 29m,Sell
114188.93,1.23931,09.05.2013 21:09:58,sl 1.23931,0.0,-737.0500000000175,0.0,0.0,1.23441,09.05.2013 20:15:00,9146,-0.359666451271827,-212.29,IS,0.41,0.0,Phase3-EA-SA2v2-EURCHF-M5-43,EURCHFMT4,4740,54m 58s,Sell
114236.5,1.23822,09.05.2013 21:19:58,tp 1.23822,0.0,-689.4800000000105,0.0,0.0,1.23932,09.05.2013 21:10:00,9147,-0.336453191537748,47.57,IS,0.41,0.0,Phase3-EA-SA2v2-EURCHF-M5-43,EURCHFMT4,4742,9m 58s,Sell
114210.29,155907,10.05.2013 08:40:00,,0.0,-715.6900000000023,0.0,0.0,155792,10.05.2013 03:15:00,9148,-0.3492431755114695,-26.21,IS,0.23,0.0,Phase3-EA-S4v1-GBPJPY-M5-194,GBPJPYMT4,2164,5h 25m,Sell
114117.11,1.2388,10.05.2013 09:25:00,,0.0,-808.8699999999953,0.0,0.0,1.23664,10.05.2013 01:05:00,9149,-0.39471325207276864,-93.18,IS,0.41,0.0,Phase3-EA-SA2v2-EURCHF-M5-43,EURCHFMT4,4744,8h 20m,Sell
113977.84,1.24112,10.05.2013 10:29:58,sl 1.24112,0.0,-948.1399999999849,0.0,0.0,1.23722,10.05.2013 03:15:00,9150,-0.462674376377256,-139.27,IS,0.34,0.0,Phase3-EA-S4v1-EURCHF-M15-221,EURCHFMT4,2372,7h 14m,Sell
113918.34,155758,10.05.2013 12:59:58,sl 155.758,0.0,-1007.6399999999849,0.0,0.0,156428,10.05.2013 11:00:00,9151,-0.49170925033516005,-59.5,IS,0.09,0.0,Phase3-EA-B1v1-GBPJPY-M30-1,GBPJPYMT4,878,1h 59m,Buy
113977.47,101869,13.05.2013 01:15:00,,-0.77,-948.5099999999802,0.0,0.0,101643,10.05.2013 19:30:00,9152,-0.46285492937497513,59.13,IS,0.27,0.0,Phase3-EA-S1v2-USDJPY-M15-0,USDJPYMT4,2622,2d 5h 45m,Buy
113937.33,0.95804,13.05.2013 03:15:00,,-3.21,-988.6499999999942,0.0,0.0,0.95743,10.05.2013 23:00:00,9153,-0.48244248972238146,-40.14,IS,0.58,0.0,Phase3-EA-SA2v2-USDCHF-M15-107,USDCHFMT4,1778,2d 4h 15m,Sell
113885.43,156372,13.05.2013 04:50:00,,-1.31,-1040.5499999999884,0.0,0.0,156148,10.05.2013 23:25:00,9154,-0.5077687075108697,-51.9,IS,0.23,0.0,Phase3-EA-S4v1-GBPJPY-M5-194,GBPJPYMT4,2166,2d 5h 25m,Sell
113814.44,1.24381,13.05.2013 06:25:00,,-2.14,-1111.539999999979,0.0,0.0,1.2422,10.05.2013 22:05:00,9155,-0.5424104840196318,-70.99,IS,0.41,0.0,Phase3-EA-SA2v2-EURCHF-M5-43,EURCHFMT4,4746,2d 8h 20m,Sell
113775.99,131871,13.05.2013 08:29:57,sl 131.871,0.0,-1149.9899999999907,0.0,0.0,132101,13.05.2013 01:00:00,9156,-0.5611733563504174,-38.45,IS,0.17,0.0,Phase3-EA-T1v2-EURJPY-M15-322,EURJPYMT4,1566,7h 29m,Buy
113918.31,1.23996,13.05.2013 14:14:58,tp 1.23996,0.0,-1007.6699999999837,0.0,0.0,1.24396,13.05.2013 05:45:00,9157,-0.49172388976740716,142.32,IS,0.34,0.0,Phase3-EA-S4v1-EURCHF-M15-221,EURCHFMT4,2374,8h 29m,Sell
114181.53,1.53134,13.05.2013 18:29:58,tp 1.53134,-1.38,-744.4499999999825,0.0,0.0,1.55024,09.05.2013 16:30:00,9158,-0.36327751122623836,263.22,IS,0.14,0.0,Phase3-EA-B1v1-GBPUSD-M30-14,GBPUSDMT4,592,4d 1h 59m,Sell
114227.68,1.24328,14.05.2013 03:29:58,tp 1.24328,-1.03,-698.2999999999884,0.0,0.0,1.24218,13.05.2013 23:05:00,9159,-0.3407571846185559,46.15,IS,0.41,0.0,Phase3-EA-SA2v2-EURCHF-M5-43,EURCHFMT4,4748,4h 24m,Buy
113990.18,0.95243,14.05.2013 03:59:57,sl 0.95243,0.0,-935.7999999999884,0.0,0.0,0.95633,14.05.2013 02:45:00,9160,-0.45665268991271085,-237.5,IS,0.58,0.0,Phase3-EA-SA2v2-USDCHF-M15-107,USDCHFMT4,1780,1h 14m,Buy
113951.65,131917,14.05.2013 08:29:58,sl 131.917,0.0,-974.3299999999872,0.0,0.0,132147,14.05.2013 05:00:00,9161,-0.47545460072948414,-38.53,IS,0.17,0.0,Phase3-EA-T1v2-EURJPY-M15-322,EURJPYMT4,1568,3h 29m,Buy
113966.92,1.24064,14.05.2013 14:00:00,,0.0,-959.0599999999977,0.0,0.0,1.24021,14.05.2013 05:15:00,9162,-0.46800312971541874,15.27,IS,0.34,0.0,Phase3-EA-S4v1-EURCHF-M15-221,EURCHFMT4,2376,8h 45m,Buy
113897.38,132477,14.05.2013 18:29:58,sl 132.477,-0.62,-1028.6000000000058,0.0,0.0,131697,10.05.2013 13:00:00,9163,-0.5019373336655513,-69.54,IS,0.09,0.0,Phase3-EA-TR1v1-EURJPY-M30-91,EURJPYMT4,1596,4d 5h 29m,Sell
113906.74,1.24753,15.05.2013 04:20:00,,-2.12,-1019.2400000000198,0.0,0.0,1.2478,14.05.2013 20:00:00,9164,-0.4973698308042811,9.36,IS,0.41,0.0,Phase3-EA-SA2v2-EURCHF-M5-43,EURCHFMT4,4750,8h 20m,Sell
113888.25,102217,15.05.2013 09:00:00,,0.0,-1037.7300000000105,0.0,0.0,102287,15.05.2013 00:45:00,9165,-0.5063926008795984,-18.49,IS,0.27,0.0,Phase3-EA-S1v2-USDJPY-M15-0,USDJPYMT4,2624,8h 15m,Buy
113946.38,102185,15.05.2013 21:30:00,,0.0,-979.6000000000058,0.0,0.0,102405,15.05.2013 20:45:00,9166,-0.47802626099433615,58.13,IS,0.27,0.0,Phase3-EA-S1v2-USDJPY-M15-0,USDJPYMT4,2626,45m 0s,Sell
113996.19,102164,16.05.2013 02:45:00,,-3.57,-929.7900000000081,0.0,0.0,102366,15.05.2013 22:15:00,9167,-0.45371992365243474,49.81,IS,0.27,0.0,Phase3-EA-S1v2-USDJPY-M15-0,USDJPYMT4,2628,4h 30m,Sell
114043.03,1.24082,16.05.2013 22:24:57,tp 1.24082,0.0,-882.9500000000116,0.0,0.0,1.24192,16.05.2013 22:15:00,9168,-0.4308628901030545,46.84,IS,0.41,0.0,Phase3-EA-SA2v2-EURCHF-M5-43,EURCHFMT4,4752,9m 57s,Sell
114001.04,1.24381,17.05.2013 08:00:00,,-2.13,-924.9400000000023,0.0,0.0,1.24287,16.05.2013 23:40:00,9169,-0.45135321543905654,-41.99,IS,0.41,0.0,Phase3-EA-SA2v2-EURCHF-M5-43,EURCHFMT4,4754,8h 20m,Sell
113998.12,156003,17.05.2013 08:05:00,,0.0,-927.8600000000151,0.0,0.0,156016,17.05.2013 02:40:00,9170,-0.45277812017783725,-2.92,IS,0.23,0.0,Phase3-EA-S4v1-GBPJPY-M5-194,GBPJPYMT4,2168,5h 25m,Buy
114017.5,1.24251,17.05.2013 12:45:00,,0.0,-908.4800000000105,0.0,0.0,1.24306,17.05.2013 04:00:00,9171,-0.4433210469458319,19.38,IS,0.34,0.0,Phase3-EA-S4v1-EURCHF-M15-221,EURCHFMT4,2378,8h 45m,Sell
113977.22,132347,17.05.2013 21:14:58,sl 132.347,-2.33,-948.7600000000093,0.0,0.0,132117,15.05.2013 11:45:00,9172,-0.46297692464372003,-40.28,IS,0.17,0.0,Phase3-EA-T1v2-EURJPY-M15-322,EURJPYMT4,1570,2d 9h 29m,Sell
114023.57,1.24791,17.05.2013 22:44:58,tp 1.24791,0.0,-902.4100000000035,0.0,0.0,1.24901,17.05.2013 20:50:00,9173,-0.44035900182104737,46.35,IS,0.41,0.0,Phase3-EA-SA2v2-EURCHF-M5-43,EURCHFMT4,4756,1h 54m,Sell
114034.99,156062,20.05.2013 06:40:00,,0.0,-890.9899999999907,0.0,0.0,156011,20.05.2013 01:15:00,9174,-0.43478625794542325,11.42,IS,0.23,0.0,Phase3-EA-S4v1-GBPJPY-M5-194,GBPJPYMT4,2170,5h 25m,Buy
113903.7,1.2445,20.05.2013 07:35:00,,-1.01,-1022.2799999999988,0.0,0.0,1.24758,17.05.2013 23:15:00,9175,-0.49885329327203604,-131.29,IS,0.41,0.0,Phase3-EA-SA2v2-EURCHF-M5-43,EURCHFMT4,4758,2d 8h 20m,Buy
113871.78,1.24573,20.05.2013 10:15:00,,0.0,-1054.2000000000116,0.0,0.0,1.24664,20.05.2013 01:30:00,9176,-0.5144296491835767,-31.92,IS,0.34,0.0,Phase3-EA-S4v1-EURCHF-M15-221,EURCHFMT4,2380,8h 45m,Buy
113931.77,0.96678,21.05.2013 02:59:59,tp 0.96678,0.0,-994.210000000021,0.0,0.0,0.96578,21.05.2013 02:00:00,9177,-0.485155664498965,59.99,IS,0.58,0.0,Phase3-EA-SA2v2-USDCHF-M15-107,USDCHFMT4,1782,59m 59s,Buy
113893.05,131999,21.05.2013 04:14:58,sl 131.999,-0.58,-1032.9300000000221,0.0,0.0,131769,20.05.2013 21:00:00,9178,-0.5040502917199747,-38.72,IS,0.17,0.0,Phase3-EA-T1v2-EURJPY-M15-322,EURJPYMT4,1572,7h 14m,Sell
113844.72,1.24686,21.05.2013 06:25:00,,-2.12,-1081.2600000000093,0.0,0.0,1.24577,20.05.2013 22:05:00,9179,-0.5276344170709854,-48.33,IS,0.41,0.0,Phase3-EA-SA2v2-EURCHF-M5-43,EURCHFMT4,4760,8h 20m,Sell
113802.19,1.5181,21.05.2013 11:59:57,sl 1.51810,-0.53,-1123.7900000000081,0.0,0.0,1.5211,20.05.2013 17:30:00,9180,-0.5483882521874497,-42.53,IS,0.14,0.0,Phase3-EA-B1v1-GBPUSD-M30-14,GBPUSDMT4,594,18h 29m,Buy
113811.31,1.24641,21.05.2013 13:30:00,,0.0,-1114.6700000000128,0.0,0.0,1.24667,21.05.2013 04:45:00,9181,-0.5439378647841564,9.12,IS,0.34,0.0,Phase3-EA-S4v1-EURCHF-M15-221,EURCHFMT4,2382,8h 45m,Sell
113773.28,132091,21.05.2013 17:29:58,sl 132.091,0.0,-1152.7000000000116,0.0,0.0,132321,21.05.2013 15:15:00,9182,-0.5624957850634683,-38.03,IS,0.17,0.0,Phase3-EA-T1v2-EURJPY-M15-322,EURJPYMT4,1574,2h 14m,Buy
113802.67,102434,22.05.2013 01:15:00,,-1.19,-1123.3099999999977,0.0,0.0,102.55,21.05.2013 21:30:00,9183,-0.5481540212714817,29.39,IS,0.27,0.0,Phase3-EA-S1v2-USDJPY-M15-0,USDJPYMT4,2630,3h 45m,Sell
113746.42,1.2527,22.05.2013 05:15:00,,-2.11,-1179.5599999999977,0.0,0.0,1.25142,21.05.2013 20:55:00,9184,-0.5756029567358868,-56.25,IS,0.41,0.0,Phase3-EA-SA2v2-EURCHF-M5-43,EURCHFMT4,4762,8h 20m,Sell
113783.64,155321,22.05.2013 08:40:00,,0.0,-1142.3399999999965,0.0,0.0,155487,22.05.2013 03:15:00,9185,-0.5574403011272612,37.22,IS,0.23,0.0,Phase3-EA-S4v1-GBPJPY-M5-194,GBPJPYMT4,2172,5h 25m,Sell
113715.08,132904,22.05.2013 10:59:58,sl 132.904,-0.31,-1210.8999999999942,0.0,0.0,132124,21.05.2013 18:30:00,9186,-0.5908962836239643,-68.56,IS,0.09,0.0,Phase3-EA-TR1v1-EURJPY-M30-91,EURJPYMT4,1598,16h 29m,Sell
113802.98,103213,22.05.2013 17:30:00,,0.0,-1123.0,0.0,0.0,102877,22.05.2013 17:15:00,9187,-0.5480027471382568,87.9,IS,0.27,0.0,Phase3-EA-S1v2-USDJPY-M15-0,USDJPYMT4,2632,15m 0s,Buy
113744.78,155881,22.05.2013 17:59:58,sl 155.881,0.0,-1181.2000000000116,0.0,0.0,155211,22.05.2013 01:30:00,9188,-0.5764032456987669,-58.2,IS,0.09,0.0,Phase3-EA-B1v1-GBPJPY-M30-1,GBPJPYMT4,880,16h 29m,Sell
113790.74,1.26196,22.05.2013 21:04:57,tp 1.26196,0.0,-1135.2400000000198,0.0,0.0,1.26086,22.05.2013 20:55:00,9189,-0.5539756354953209,45.96,IS,0.41,0.0,Phase3-EA-SA2v2-EURCHF-M5-43,EURCHFMT4,4764,9m 57s,Buy
113788.46,103434,23.05.2013 03:15:00,,-2.28,-1137.5200000000186,0.0,0.0,103434,22.05.2013 21:00:00,9190,-0.5550882323461442,-2.28,IS,0.27,0.0,Phase3-EA-S1v2-USDJPY-M15-0,USDJPYMT4,2634,6h 15m,Buy
113875.38,154986,23.05.2013 05:24:58,tp 154.986,0.0,-1050.6000000000058,0.0,0.0,155376,23.05.2013 03:30:00,9191,-0.512672917313852,86.92,IS,0.23,0.0,Phase3-EA-S4v1-GBPJPY-M5-194,GBPJPYMT4,2174,1h 54m,Sell
113934.68,0.97809,23.05.2013 05:29:58,tp 0.97809,0.0,-991.3000000000175,0.0,0.0,0.97909,23.05.2013 01:30:00,9192,-0.4837356395709381,59.3,IS,0.58,0.0,Phase3-EA-SA2v2-USDCHF-M15-107,USDCHFMT4,1784,3h 59m,Sell
113808.13,1.25746,23.05.2013 05:40:00,,-3.02,-1117.8500000000058,0.0,0.0,1.26041,22.05.2013 21:20:00,9193,-0.5454896446024075,-126.55,IS,0.41,0.0,Phase3-EA-SA2v2-EURCHF-M5-43,EURCHFMT4,4766,8h 20m,Buy
113920.06,131862,23.05.2013 07:29:58,tp 131.862,-0.92,-1005.9200000000128,0.0,0.0,133152,22.05.2013 18:30:00,9194,-0.49086992288630654,111.93,IS,0.09,0.0,Phase3-EA-TR1v1-EURJPY-M30-91,EURJPYMT4,1600,12h 59m,Sell
114203.03,130708,23.05.2013 09:14:58,tp 130.708,0.0,-722.9500000000116,0.0,0.0,132408,23.05.2013 05:30:00,9195,-0.35278591811541327,282.97,IS,0.17,0.0,Phase3-EA-T1v2-EURJPY-M15-322,EURJPYMT4,1576,3h 44m,Sell
114143.4,152879,23.05.2013 12:29:58,sl 152.879,0.0,-782.5800000000163,0.0,0.0,152209,23.05.2013 11:30:00,9196,-0.38188422961305957,-59.63,IS,0.09,0.0,Phase3-EA-B1v1-GBPJPY-M30-1,GBPJPYMT4,882,59m 58s,Sell
114079.59,131597,23.05.2013 18:59:58,sl 131.597,0.0,-846.390000000014,0.0,0.0,130877,23.05.2013 10:00:00,9197,-0.4130223020038796,-63.81,IS,0.09,0.0,Phase3-EA-TR1v1-EURJPY-M30-91,EURJPYMT4,1602,8h 59m,Sell
114139.51,0.96802,23.05.2013 23:44:57,tp 0.96802,0.0,-786.4700000000012,0.0,0.0,0.96902,23.05.2013 22:15:00,9198,-0.3837824759945017,59.92,IS,0.58,0.0,Phase3-EA-SA2v2-USDCHF-M15-107,USDCHFMT4,1786,1h 29m,Sell
113919.59,102454,24.05.2013 02:59:58,sl 102.454,-1.19,-1006.390000000014,0.0,0.0,101624,23.05.2013 17:00:00,9199,-0.4910992739915208,-219.92,IS,0.27,0.0,Phase3-EA-S1v2-USDJPY-M15-0,USDJPYMT4,2636,9h 59m,Sell
113876.18,154237,24.05.2013 05:30:00,,0.0,-1049.8000000000175,0.0,0.0,154044,24.05.2013 00:05:00,9200,-0.5122825324539194,-43.41,IS,0.23,0.0,Phase3-EA-S4v1-GBPJPY-M5-194,GBPJPYMT4,2176,5h 25m,Sell
113829.71,1.2538,24.05.2013 06:25:00,,-2.12,-1096.2700000000186,0.0,0.0,1.25275,23.05.2013 22:05:00,9201,-0.5349590130055806,-46.47,IS,0.41,0.0,Phase3-EA-SA2v2-EURCHF-M5-43,EURCHFMT4,4768,8h 20m,Sell
113766.37,131626,24.05.2013 06:59:58,sl 131.626,0.0,-1159.6100000000151,0.0,0.0,132346,24.05.2013 04:30:00,9202,-0.5658677342911863,-63.34,IS,0.09,0.0,Phase3-EA-TR1v1-EURJPY-M30-91,EURJPYMT4,1604,2h 29m,Buy
113906.76,1.24919,24.05.2013 07:29:58,tp 1.24919,0.0,-1019.2200000000012,0.0,0.0,1.25319,24.05.2013 02:00:00,9203,-0.49736007118277353,140.39,IS,0.34,0.0,Phase3-EA-S4v1-EURCHF-M15-221,EURCHFMT4,2384,5h 29m,Sell
113868.35,131876,24.05.2013 12:29:58,sl 131.876,0.0,-1057.6300000000047,0.0,0.0,132106,24.05.2013 12:00:00,9204,-0.5161034242705583,-38.41,IS,0.17,0.0,Phase3-EA-T1v2-EURJPY-M15-322,EURJPYMT4,1578,29m 58s,Buy
113826.35,1.50848,24.05.2013 15:59:57,sl 1.50848,0.0,-1099.6300000000047,0.0,0.0,1.51148,24.05.2013 11:30:00,9205,-0.5365986294173142,-42.0,IS,0.14,0.0,Phase3-EA-B1v1-GBPUSD-M30-14,GBPUSDMT4,596,4h 29m,Buy
113900.03,100778,24.05.2013 21:15:00,,0.0,-1025.9500000000116,0.0,0.0,101053,24.05.2013 20:30:00,9206,-0.5006441838170088,73.68,IS,0.27,0.0,Phase3-EA-S1v2-USDJPY-M15-0,USDJPYMT4,2638,45m 0s,Sell
113946.96,1.24317,24.05.2013 22:49:58,tp 1.24317,0.0,-979.0200000000186,0.0,0.0,1.24207,24.05.2013 21:20:00,9207,-0.4777432319708872,46.93,IS,0.41,0.0,Phase3-EA-SA2v2-EURCHF-M5-43,EURCHFMT4,4770,1h 29m,Buy
113993.86,1.24192,24.05.2013 23:54:57,tp 1.24192,0.0,-932.1200000000244,0.0,0.0,1.24302,24.05.2013 22:55:00,9208,-0.45485691955701274,46.9,IS,0.41,0.0,Phase3-EA-SA2v2-EURCHF-M5-43,EURCHFMT4,4772,59m 57s,Sell
114040.77,1.24406,27.05.2013 01:29:57,tp 1.24406,0.0,-885.210000000021,0.0,0.0,1.24516,27.05.2013 01:20:00,9209,-0.4319657273323845,46.91,IS,0.41,0.0,Phase3-EA-SA2v2-EURCHF-M5-43,EURCHFMT4,4774,9m 57s,Sell
114038.78,0.96148,27.05.2013 03:45:00,,-3.2,-887.2000000000116,0.0,0.0,0.9615,24.05.2013 23:30:00,9210,-0.4329368096714762,-1.99,IS,0.58,0.0,Phase3-EA-SA2v2-USDCHF-M15-107,USDCHFMT4,1788,2d 4h 15m,Sell
114071.55,100933,27.05.2013 03:45:00,,-1.2,-854.4300000000221,0.0,0.0,101.06,24.05.2013 22:15:00,9211,-0.4169456698462625,32.77,IS,0.27,0.0,Phase3-EA-S1v2-USDJPY-M15-0,USDJPYMT4,2640,2d 5h 30m,Sell
114032.81,130554,27.05.2013 04:29:58,sl 130.554,0.0,-893.1700000000128,0.0,0.0,130324,27.05.2013 04:00:00,9212,-0.43585005668876564,-38.74,IS,0.17,0.0,Phase3-EA-T1v2-EURJPY-M15-322,EURJPYMT4,1580,29m 58s,Sell
114063.59,1.24339,27.05.2013 10:15:00,,0.0,-862.390000000014,0.0,0.0,1.24426,27.05.2013 01:30:00,9213,-0.42082999920264375,30.78,IS,0.34,0.0,Phase3-EA-S4v1-EURCHF-M15-221,EURCHFMT4,2386,8h 45m,Sell
114151.48,152.82,28.05.2013 02:09:57,tp 152.820,-0.82,-774.5,0.0,0.0,152.43,27.05.2013 23:55:00,9214,-0.37794134252767575,87.89,IS,0.23,0.0,Phase3-EA-S4v1-GBPJPY-M5-194,GBPJPYMT4,2178,2h 14m,Buy
114112.22,130834,28.05.2013 02:14:58,sl 130.834,-0.59,-813.7600000000093,0.0,0.0,130604,27.05.2013 23:45:00,9215,-0.39709947952914776,-39.26,IS,0.17,0.0,Phase3-EA-T1v2-EURJPY-M15-322,EURJPYMT4,1582,2h 29m,Sell
114252.95,1.24905,28.05.2013 07:59:58,tp 1.24905,0.0,-673.0299999999988,0.0,0.0,1.24505,28.05.2013 01:30:00,9216,-0.32842590285526296,140.73,IS,0.34,0.0,Phase3-EA-S4v1-EURCHF-M15-221,EURCHFMT4,2388,6h 29m,Buy
114113.05,153997,28.05.2013 08:55:00,,0.0,-812.929999999993,0.0,0.0,153377,28.05.2013 03:30:00,9217,-0.3966944552369539,-139.9,IS,0.23,0.0,Phase3-EA-S4v1-GBPJPY-M5-194,GBPJPYMT4,2180,5h 25m,Sell
114226.3,131984,28.05.2013 10:59:58,tp 131.984,-0.44,-699.679999999993,0.0,0.0,130694,27.05.2013 02:30:00,9218,-0.3414305985019516,113.25,IS,0.09,0.0,Phase3-EA-TR1v1-EURJPY-M30-91,EURJPYMT4,1606,1d 8h 29m,Buy
114272.53,1.25415,28.05.2013 20:39:58,tp 1.25415,0.0,-653.4499999999825,0.0,0.0,1.25525,28.05.2013 20:25:00,9219,-0.3188712334082674,46.23,IS,0.41,0.0,Phase3-EA-SA2v2-EURCHF-M5-43,EURCHFMT4,4776,14m 58s,Sell
114213.53,153605,28.05.2013 20:59:58,sl 153.605,0.0,-712.4499999999825,0.0,0.0,154275,28.05.2013 10:30:00,9220,-0.3476621168287101,-59.0,IS,0.09,0.0,Phase3-EA-B1v1-GBPJPY-M30-1,GBPJPYMT4,884,10h 29m,Buy
114257.61,1.25511,29.05.2013 00:24:57,tp 1.25511,-2.1,-668.3699999999953,0.0,0.0,1.25621,28.05.2013 23:55:00,9221,-0.32615191104612123,44.08,IS,0.41,0.0,Phase3-EA-SA2v2-EURCHF-M5-43,EURCHFMT4,4778,29m 57s,Sell
114345.25,153515,29.05.2013 03:39:58,tp 153.515,0.0,-580.7299999999814,0.0,0.0,153905,29.05.2013 03:05:00,9222,-0.28338524963988393,87.64,IS,0.23,0.0,Phase3-EA-S4v1-GBPJPY-M5-194,GBPJPYMT4,2182,34m 58s,Sell
114306.99,131513,29.05.2013 07:14:58,sl 131.513,0.0,-618.9899999999907,0.0,0.0,131283,29.05.2013 04:30:00,9223,-0.3020554055664332,-38.26,IS,0.17,0.0,Phase3-EA-T1v2-EURJPY-M15-322,EURJPYMT4,1584,2h 44m,Sell
114446.2,1.25678,29.05.2013 08:29:58,tp 1.25678,0.0,-479.77999999999884,0.0,0.0,1.25278,29.05.2013 05:00:00,9224,-0.23412356012644006,139.21,IS,0.34,0.0,Phase3-EA-S4v1-EURCHF-M15-221,EURCHFMT4,2390,3h 29m,Buy
114438.77,153518,29.05.2013 09:10:00,,0.0,-487.20999999999185,0.0,0.0,153551,29.05.2013 03:45:00,9225,-0.23774925951311274,-7.43,IS,0.23,0.0,Phase3-EA-S4v1-GBPJPY-M5-194,GBPJPYMT4,2184,5h 25m,Buy
114374.91,131.07,29.05.2013 10:29:58,sl 131.070,-0.43,-551.0699999999779,0.0,0.0,131.79,28.05.2013 09:30:00,9226,-0.26891173095767323,-63.86,IS,0.09,0.0,Phase3-EA-TR1v1-EURJPY-M30-91,EURJPYMT4,1607,1d 0h 59m,Buy
114398.05,100966,30.05.2013 02:30:00,,-3.6,-527.9299999999639,0.0,0.0,101066,29.05.2013 20:45:00,9227,-0.2576198488839538,23.14,IS,0.27,0.0,Phase3-EA-S1v2-USDJPY-M15-0,USDJPYMT4,2642,5h 45m,Sell
114486.78,153023,30.05.2013 03:54:58,tp 153.023,0.0,-439.19999999995343,0.0,0.0,152633,30.05.2013 02:55:00,9228,-0.21432128810605242,88.73,IS,0.23,0.0,Phase3-EA-S4v1-GBPJPY-M5-194,GBPJPYMT4,2186,59m 58s,Buy
114530.56,1.2464,30.05.2013 03:54:58,tp 1.24640,-3.07,-395.4199999999546,0.0,0.0,1.2453,29.05.2013 22:10:00,9229,-0.19295747664593466,43.78,IS,0.41,0.0,Phase3-EA-SA2v2-EURCHF-M5-43,EURCHFMT4,4780,5h 44m,Buy
114490.19,131454,30.05.2013 04:14:57,sl 131.454,-1.76,-435.78999999994994,0.0,0.0,131224,29.05.2013 09:30:00,9230,-0.2126572726405641,-40.37,IS,0.17,0.0,Phase3-EA-T1v2-EURJPY-M15-322,EURJPYMT4,1586,18h 44m,Sell
114631.94,1.24287,30.05.2013 08:44:58,tp 1.24287,0.0,-294.03999999994994,0.0,0.0,1.24687,30.05.2013 04:30:00,9231,-0.1434859552702632,141.75,IS,0.34,0.0,Phase3-EA-S4v1-EURCHF-M15-221,EURCHFMT4,2392,4h 14m,Sell
114588.93,101027,31.05.2013 02:00:00,,-0.78,-337.04999999995925,0.0,0.0,101185,30.05.2013 17:00:00,9232,-0.16447402130269556,-43.01,IS,0.27,0.0,Phase3-EA-S1v2-USDJPY-M15-0,USDJPYMT4,2644,9h 0m,Buy
114579.68,0.95334,31.05.2013 03:15:00,,-0.73,-346.29999999995925,0.0,0.0,0.95348,30.05.2013 23:00:00,9233,-0.16898784624573107,-9.25,IS,0.58,0.0,Phase3-EA-SA2v2-USDCHF-M15-107,USDCHFMT4,1790,4h 15m,Buy
114566.19,1.24391,31.05.2013 05:40:00,,-1.03,-359.78999999994994,0.0,0.0,1.2442,30.05.2013 21:20:00,9234,-0.17557071094643453,-13.49,IS,0.41,0.0,Phase3-EA-SA2v2-EURCHF-M5-43,EURCHFMT4,4782,8h 20m,Buy
114527.47,131509,31.05.2013 06:59:58,sl 131.509,0.0,-398.5099999999511,0.0,0.0,131739,31.05.2013 02:15:00,9235,-0.19446533816744427,-38.72,IS,0.17,0.0,Phase3-EA-T1v2-EURJPY-M15-322,EURJPYMT4,1588,4h 44m,Buy
114579.9,153597,31.05.2013 07:30:00,,0.0,-346.0799999999581,0.0,0.0,153827,31.05.2013 02:05:00,9236,-0.1688804904092475,52.43,IS,0.23,0.0,Phase3-EA-S4v1-GBPJPY-M5-194,GBPJPYMT4,2188,5h 25m,Sell
114722.57,1.24023,31.05.2013 11:29:57,tp 1.24023,0.0,-203.40999999994528,0.0,0.0,1.24423,31.05.2013 04:15:00,9237,-0.09926023045001142,142.67,IS,0.34,0.0,Phase3-EA-S4v1-EURCHF-M15-221,EURCHFMT4,2394,7h 14m,Sell
114769.58,1.24427,31.05.2013 21:49:58,tp 1.24427,0.0,-156.39999999993597,0.0,0.0,1.24537,31.05.2013 21:15:00,9238,-0.07632024011788804,47.01,IS,0.41,0.0,Phase3-EA-SA2v2-EURCHF-M5-43,EURCHFMT4,4784,34m 58s,Sell
114816.78,1.24216,31.05.2013 23:49:58,tp 1.24216,0.0,-109.19999999992433,0.0,0.0,1.24106,31.05.2013 23:15:00,9239,-0.0532875333815282,47.2,IS,0.41,0.0,Phase3-EA-SA2v2-EURCHF-M5-43,EURCHFMT4,4786,34m 58s,Buy
114876.69,0.95654,03.06.2013 01:00:00,tp 0.95654,-0.73,-49.28999999992084,0.0,0.0,0.95554,31.05.2013 23:45:00,9240,-0.02405258718290409,59.91,IS,0.58,0.0,Phase3-EA-SA2v2-USDCHF-M15-107,USDCHFMT4,1792,2d 1h 15m,Buy
114837.28,130783,03.06.2013 04:14:58,sl 130.783,-0.59,-88.69999999992433,0.0,0.0,130553,31.05.2013 23:00:00,9241,-0.043283921345611674,-39.41,IS,0.17,0.0,Phase3-EA-T1v2-EURJPY-M15-322,EURJPYMT4,1590,2d 5h 14m,Sell
114787.97,100693,03.06.2013 05:15:00,,-0.78,-138.009999999922,0.0,0.0,100874,31.05.2013 21:45:00,9242,-0.06734626815005171,-49.31,IS,0.27,0.0,Phase3-EA-S1v2-USDJPY-M15-0,USDJPYMT4,2646,2d 7h 30m,Buy
114835.11,1.24493,03.06.2013 05:54:57,tp 1.24493,0.0,-90.86999999990803,0.0,0.0,1.24383,03.06.2013 01:05:00,9243,-0.0443428402781861,47.14,IS,0.41,0.0,Phase3-EA-SA2v2-EURCHF-M5-43,EURCHFMT4,4788,4h 49m,Buy
114813.09,1.24544,03.06.2013 15:15:00,,0.0,-112.88999999989755,0.0,0.0,1.24482,03.06.2013 06:30:00,9244,-0.05508818354798011,-22.02,IS,0.34,0.0,Phase3-EA-S4v1-EURCHF-M15-221,EURCHFMT4,2396,8h 45m,Sell
114740.96,130056,03.06.2013 16:29:58,sl 130.056,-2.19,-185.0199999999022,0.0,0.0,130836,29.05.2013 22:30:00,9245,-0.09028625848216089,-72.13,IS,0.09,0.0,Phase3-EA-TR1v1-EURJPY-M30-91,EURJPYMT4,1610,4d 17h 59m,Buy
114757.94,99374,04.06.2013 04:00:00,,-1.22,-168.03999999989173,0.0,0.0,99441,03.06.2013 22:15:00,9246,-0.08200033982996735,16.98,IS,0.27,0.0,Phase3-EA-S1v2-USDJPY-M15-0,USDJPYMT4,2648,5h 45m,Sell
114712.11,1.23882,04.06.2013 06:20:00,,-2.16,-213.86999999987893,0.0,0.0,1.23781,03.06.2013 22:00:00,9247,-0.10436451249367108,-45.83,IS,0.41,0.0,Phase3-EA-SA2v2-EURCHF-M5-43,EURCHFMT4,4790,8h 20m,Sell
114643.63,152879,04.06.2013 07:40:00,,0.0,-282.3499999998894,0.0,0.0,152582,04.06.2013 02:15:00,9248,-0.13778145650438664,-68.48,IS,0.23,0.0,Phase3-EA-S4v1-GBPJPY-M5-194,GBPJPYMT4,2190,5h 25m,Sell
114578.48,130.53,04.06.2013 08:59:58,sl 130.530,-0.32,-347.4999999998836,0.0,0.0,129.81,03.06.2013 19:30:00,9249,-0.16957342353560145,-65.15,IS,0.09,0.0,Phase3-EA-TR1v1-EURJPY-M30-91,EURJPYMT4,1612,13h 29m,Sell
114538.75,130878,04.06.2013 09:29:58,sl 130.878,-0.6,-387.22999999989406,0.0,0.0,130648,03.06.2013 09:15:00,9250,-0.18896091164228773,-39.73,IS,0.17,0.0,Phase3-EA-T1v2-EURJPY-M15-322,EURJPYMT4,1592,1d 0h 14m,Sell
114399.13,1.24269,04.06.2013 10:29:57,sl 1.24269,0.0,-526.8499999998894,0.0,0.0,1.23879,04.06.2013 03:15:00,9251,-0.25709282932300087,-139.62,IS,0.34,0.0,Phase3-EA-S4v1-EURCHF-M15-221,EURCHFMT4,2398,7h 14m,Sell
114446.73,1.23962,05.06.2013 01:54:58,tp 1.23962,0.0,-479.2499999998836,0.0,0.0,1.23852,05.06.2013 00:05:00,9252,-0.23386493015667476,47.6,IS,0.41,0.0,Phase3-EA-SA2v2-EURCHF-M5-43,EURCHFMT4,4792,1h 49m,Buy
114433.88,0.94798,05.06.2013 06:45:00,,0.0,-492.0999999998894,0.0,0.0,0.94777,05.06.2013 02:30:00,9253,-0.24013548696943504,-12.85,IS,0.58,0.0,Phase3-EA-SA2v2-USDCHF-M15-107,USDCHFMT4,1794,4h 15m,Sell
114394.81,130783,05.06.2013 07:14:58,sl 130.783,0.0,-531.1699999998964,0.0,0.0,131013,05.06.2013 01:45:00,9254,-0.2592009075666706,-39.07,IS,0.17,0.0,Phase3-EA-T1v2-EURJPY-M15-322,EURJPYMT4,1594,5h 29m,Buy
114442.44,1.23857,05.06.2013 07:19:58,tp 1.23857,0.0,-483.53999999989173,0.0,0.0,1.23967,05.06.2013 02:20:00,9255,-0.23595836896809735,47.63,IS,0.41,0.0,Phase3-EA-SA2v2-EURCHF-M5-43,EURCHFMT4,4794,4h 59m,Sell
114377.05,130311,05.06.2013 08:29:58,sl 130.311,-0.44,-548.9299999999057,0.0,0.0,131031,04.06.2013 11:00:00,9256,-0.2678674514573033,-65.39,IS,0.09,0.0,Phase3-EA-TR1v1-EURJPY-M30-91,EURJPYMT4,1614,21h 29m,Buy
114408.28,1.23869,05.06.2013 11:15:00,,0.0,-517.6999999998952,0.0,0.0,1.23956,05.06.2013 02:30:00,9257,-0.2526278024874605,31.23,IS,0.34,0.0,Phase3-EA-S4v1-EURCHF-M15-221,EURCHFMT4,2400,8h 45m,Sell
114458.98,99.05,05.06.2013 23:45:00,,0.0,-466.9999999998836,0.0,0.0,99236,05.06.2013 22:45:00,9258,-0.227887161988871,50.7,IS,0.27,0.0,Phase3-EA-S1v2-USDJPY-M15-0,USDJPYMT4,2650,1h 0m,Sell
114720.92,1.54086,06.06.2013 03:29:58,tp 1.54086,-2.66,-205.05999999988126,0.0,0.0,1.52196,03.06.2013 05:30:00,9259,-0.10006539922360272,261.94,IS,0.14,0.0,Phase3-EA-B1v1-GBPUSD-M30-14,GBPUSDMT4,598,2d 21h 59m,Buy
114811.18,152884,06.06.2013 04:49:57,tp 152.884,0.0,-114.79999999987194,0.0,0.0,152494,06.06.2013 03:30:00,9260,-0.05602022740107008,90.26,IS,0.23,0.0,Phase3-EA-S4v1-GBPJPY-M5-194,GBPJPYMT4,2192,1h 19m,Buy
114858.97,1.23411,06.06.2013 04:49:57,tp 1.23411,0.0,-67.0099999998638,0.0,0.0,1.23301,06.06.2013 02:20:00,9261,-0.03269961183050752,47.79,IS,0.41,0.0,Phase3-EA-SA2v2-EURCHF-M5-43,EURCHFMT4,4796,2h 29m,Buy
114838.02,1.23463,06.06.2013 14:15:00,,0.0,-87.95999999987544,0.0,0.0,1.23405,06.06.2013 05:30:00,9262,-0.04292281535014497,-20.95,IS,0.34,0.0,Phase3-EA-S4v1-EURCHF-M15-221,EURCHFMT4,2402,8h 45m,Sell
114771.58,130353,06.06.2013 16:59:58,sl 130.353,-0.95,-154.39999999987776,0.0,0.0,129633,05.06.2013 20:00:00,9263,-0.07534427796801411,-66.44,IS,0.09,0.0,Phase3-EA-TR1v1-EURJPY-M30-91,EURJPYMT4,1616,20h 59m,Sell
114820.33,1.2304,06.06.2013 20:34:58,tp 1.23040,0.0,-105.64999999987776,0.0,0.0,1.2293,06.06.2013 20:30:00,9264,-0.05155520056552969,48.75,IS,0.41,0.0,Phase3-EA-SA2v2-EURCHF-M5-43,EURCHFMT4,4798,4m 58s,Buy
114882.67,0.93045,07.06.2013 01:59:58,tp 0.93045,0.0,-43.309999999881256,0.0,0.0,0.92945,07.06.2013 01:15:00,9265,-0.021134460354846688,62.34,IS,0.58,0.0,Phase3-EA-SA2v2-USDCHF-M15-107,USDCHFMT4,1796,44m 58s,Buy
114949.48,97396,07.06.2013 02:15:00,,0.0,-0.0,0.0,0.0,97155,07.06.2013 01:30:00,9266,-0.0,66.81,IS,0.27,0.0,Phase3-EA-S1v2-USDJPY-M15-0,USDJPYMT4,2652,45m 0s,Buy
115011.91,0.92902,07.06.2013 03:29:58,tp 0.92902,0.0,-0.0,0.0,0.0,0.93002,07.06.2013 02:15:00,9267,-0.0,62.43,IS,0.58,0.0,Phase3-EA-SA2v2-USDCHF-M15-107,USDCHFMT4,1798,1h 14m,Sell
115104.22,151412,07.06.2013 05:09:58,tp 151.412,0.0,-0.0,0.0,0.0,151802,07.06.2013 01:55:00,9268,-0.0,92.31,IS,0.23,0.0,Phase3-EA-S4v1-GBPJPY-M5-194,GBPJPYMT4,2194,3h 14m,Sell
115200.44,96808,07.06.2013 05:15:00,,0.0,-0.0,0.0,0.0,97153,07.06.2013 01:30:00,9269,-0.0,96.22,IS,0.27,0.0,Phase3-EA-S1v2-USDJPY-M15-0,USDJPYMT4,2653,3h 45m,Sell
115249.0,1.22986,07.06.2013 05:24:57,tp 1.22986,0.0,-0.0,0.0,0.0,1.23096,07.06.2013 02:05:00,9270,-0.0,48.56,IS,0.41,0.0,Phase3-EA-SA2v2-EURCHF-M5-43,EURCHFMT4,4800,3h 19m,Sell
115018.81,97354,07.06.2013 18:29:58,sl 97.354,0.0,-230.19000000000233,0.0,0.0,96524,07.06.2013 17:00:00,9271,-0.11215158173730497,-230.19,IS,0.27,0.0,Phase3-EA-S1v2-USDJPY-M15-0,USDJPYMT4,2656,1h 29m,Sell
115067.03,1.23672,07.06.2013 23:14:58,tp 1.23672,0.0,-181.97000000000116,0.0,0.0,1.23562,07.06.2013 22:05:00,9272,-0.08865816642224818,48.22,IS,0.41,0.0,Phase3-EA-SA2v2-EURCHF-M5-43,EURCHFMT4,4802,1h 9m,Buy
115176.75,97724,10.06.2013 01:00:00,tp 97.724,-0.8,-72.25,0.0,0.0,97324,07.06.2013 23:15:00,9273,-0.03520114592519311,109.72,IS,0.27,0.0,Phase3-EA-S1v2-USDJPY-M15-0,USDJPYMT4,2658,2d 1h 45m,Buy
115222.78,1.23636,10.06.2013 01:00:00,tp 1.23636,-2.19,-26.220000000001164,0.0,0.0,1.23746,07.06.2013 23:35:00,9274,-0.012774727282472033,46.03,IS,0.41,0.0,Phase3-EA-SA2v2-EURCHF-M5-43,EURCHFMT4,4804,2d 1h 25m,Sell
115341.09,129389,10.06.2013 02:29:58,tp 129.389,-0.45,-0.0,0.0,0.0,128099,07.06.2013 17:30:00,9275,-0.0,118.31,IS,0.09,0.0,Phase3-EA-TR1v1-EURJPY-M30-91,EURJPYMT4,1618,2d 8h 59m,Buy
115111.52,98152,10.06.2013 02:44:57,sl 98.152,-1.25,-229.57000000000698,0.0,0.0,97322,07.06.2013 23:15:00,9276,-0.1117993480993043,-229.57,IS,0.27,0.0,Phase3-EA-S1v2-USDJPY-M15-0,USDJPYMT4,2659,2d 3h 29m,Sell
115173.51,0.93563,10.06.2013 04:29:58,tp 0.93563,0.0,-167.5800000000163,0.0,0.0,0.93663,10.06.2013 02:00:00,9277,-0.08161055344549666,61.99,IS,0.58,0.0,Phase3-EA-SA2v2-USDCHF-M15-107,USDCHFMT4,1800,2h 29m,Sell
115265.02,152215,10.06.2013 04:49:57,tp 152.215,0.0,-76.07000000000698,0.0,0.0,152605,10.06.2013 02:55:00,9278,-0.03704567848549288,91.51,IS,0.23,0.0,Phase3-EA-S4v1-GBPJPY-M5-194,GBPJPYMT4,2196,1h 54m,Sell
115213.57,1.23886,10.06.2013 12:15:00,,0.0,-127.52000000001863,0.0,0.0,1.23744,10.06.2013 03:30:00,9279,-0.06210155015735912,-51.45,IS,0.34,0.0,Phase3-EA-S4v1-EURCHF-M15-221,EURCHFMT4,2404,8h 45m,Sell
115279.28,99033,10.06.2013 17:15:00,,0.0,-61.810000000026776,0.0,0.0,98792,10.06.2013 17:00:00,9280,-0.030101135627567985,65.71,IS,0.27,0.0,Phase3-EA-S1v2-USDJPY-M15-0,USDJPYMT4,2662,15m 0s,Buy
115326.54,1.23789,11.06.2013 01:19:58,tp 1.23789,-1.05,-14.550000000017462,0.0,0.0,1.23679,10.06.2013 22:00:00,9281,-0.007085771289135254,47.26,IS,0.41,0.0,Phase3-EA-SA2v2-EURCHF-M5-43,EURCHFMT4,4806,3h 19m,Buy
115417.39,153733,11.06.2013 03:29:58,tp 153.733,0.0,-0.0,0.0,0.0,154123,11.06.2013 02:00:00,9282,-0.0,90.85,IS,0.23,0.0,Phase3-EA-S4v1-GBPJPY-M5-194,GBPJPYMT4,2198,1h 29m,Sell
115470.78,98612,11.06.2013 04:15:00,,0.0,-0.0,0.0,0.0,98807,11.06.2013 01:15:00,9283,-0.0,53.39,IS,0.27,0.0,Phase3-EA-S1v2-USDJPY-M15-0,USDJPYMT4,2664,3h 0m,Sell
115409.42,153032,11.06.2013 06:59:58,sl 153.032,-0.33,-61.35999999998603,0.0,0.0,153702,10.06.2013 17:30:00,9284,-0.02986312701007204,-61.36,IS,0.09,0.0,Phase3-EA-B1v1-GBPJPY-M30-1,GBPJPYMT4,886,13h 29m,Buy
115369.82,130789,11.06.2013 06:59:58,sl 130.789,0.0,-100.95999999999185,0.0,0.0,131019,11.06.2013 06:00:00,9285,-0.049135940399891075,-39.6,IS,0.17,0.0,Phase3-EA-T1v2-EURJPY-M15-322,EURJPYMT4,1596,59m 58s,Buy
115489.04,129489,11.06.2013 13:29:58,tp 129.489,-0.32,-0.0,0.0,0.0,130779,10.06.2013 21:30:00,9286,-0.0,119.22,IS,0.09,0.0,Phase3-EA-TR1v1-EURJPY-M30-91,EURJPYMT4,1620,15h 59m,Sell
115635.28,1.23423,11.06.2013 13:29:58,tp 1.23423,0.0,-0.0,0.0,0.0,1.23823,11.06.2013 06:15:00,9287,-0.0,146.24,IS,0.34,0.0,Phase3-EA-S4v1-EURCHF-M15-221,EURCHFMT4,2406,7h 14m,Sell
115663.98,96908,11.06.2013 19:45:00,,0.0,-0.0,0.0,0.0,96805,11.06.2013 19:15:00,9288,-0.0,28.7,IS,0.27,0.0,Phase3-EA-S1v2-USDJPY-M15-0,USDJPYMT4,2666,30m 0s,Buy
115719.54,96709,11.06.2013 21:30:00,,0.0,-0.0,0.0,0.0,96908,11.06.2013 19:45:00,9289,-0.0,55.56,IS,0.27,0.0,Phase3-EA-S1v2-USDJPY-M15-0,USDJPYMT4,2668,1h 45m,Sell
115836.8,127582,11.06.2013 21:59:57,tp 127.582,0.0,-0.0,0.0,0.0,128842,11.06.2013 15:30:00,9290,-0.0,117.26,IS,0.09,0.0,Phase3-EA-TR1v1-EURJPY-M30-91,EURJPYMT4,1622,6h 29m,Sell
115773.91,150279,11.06.2013 22:59:58,sl 150.279,0.0,-62.89000000001397,0.0,0.0,149609,11.06.2013 22:00:00,9291,-0.030553331571426305,-62.89,IS,0.09,0.0,Phase3-EA-B1v1-GBPJPY-M30-1,GBPJPYMT4,888,59m 58s,Sell
115820.49,1.22974,12.06.2013 07:39:58,tp 1.22974,-2.22,-16.310000000026776,0.0,0.0,1.23084,11.06.2013 23:30:00,9292,-0.007923753187003823,46.58,IS,0.41,0.0,Phase3-EA-SA2v2-EURCHF-M5-43,EURCHFMT4,4808,8h 9m,Sell
115940.41,129203,12.06.2013 11:59:57,tp 129.203,0.0,-0.0,0.0,0.0,127913,12.06.2013 01:30:00,9293,-0.0,119.92,IS,0.09,0.0,Phase3-EA-TR1v1-EURJPY-M30-91,EURJPYMT4,1624,10h 29m,Buy
115989.46,1.22728,12.06.2013 20:24:57,tp 1.22728,0.0,-0.0,0.0,0.0,1.22618,12.06.2013 20:00:00,9294,-0.0,49.05,IS,0.41,0.0,Phase3-EA-SA2v2-EURCHF-M5-43,EURCHFMT4,4810,24m 57s,Buy
116038.45,1.22768,12.06.2013 23:29:59,tp 1.22768,0.0,-0.0,0.0,0.0,1.22878,12.06.2013 22:55:00,9295,-0.0,48.99,IS,0.41,0.0,Phase3-EA-SA2v2-EURCHF-M5-43,EURCHFMT4,4812,34m 59s,Sell
116084.2,1.22847,13.06.2013 01:19:58,tp 1.22847,-3.21,-0.0,0.0,0.0,1.22737,12.06.2013 23:50:00,9296,-0.0,45.75,IS,0.41,0.0,Phase3-EA-SA2v2-EURCHF-M5-43,EURCHFMT4,4814,1h 29m,Buy
116110.3,95715,13.06.2013 03:45:00,,-3.8,-0.0,0.0,0.0,95821,12.06.2013 23:45:00,9297,-0.0,26.1,IS,0.27,0.0,Phase3-EA-S1v2-USDJPY-M15-0,USDJPYMT4,2670,4h 0m,Sell
115952.37,0.91811,13.06.2013 05:15:00,,0.0,-157.92999999999302,0.0,0.0,0.92061,13.06.2013 01:00:00,9298,-0.07662402121582093,-157.93,IS,0.58,0.0,Phase3-EA-SA2v2-USDCHF-M15-107,USDCHFMT4,1802,4h 15m,Buy
116258.62,125715,13.06.2013 10:14:58,tp 125.715,0.0,-0.0,0.0,0.0,127415,13.06.2013 04:00:00,9299,-0.0,306.25,IS,0.17,0.0,Phase3-EA-T1v2-EURJPY-M15-322,EURJPYMT4,1598,6h 14m,Sell
116378.97,125397,13.06.2013 12:29:58,tp 125.397,0.0,-0.0,0.0,0.0,126657,13.06.2013 08:30:00,9300,-0.0,120.35,IS,0.09,0.0,Phase3-EA-TR1v1-EURJPY-M30-91,EURJPYMT4,1626,3h 59m,Sell
116440.6,1.22776,13.06.2013 15:30:00,,0.0,-0.0,0.0,0.0,1.22609,13.06.2013 06:45:00,9301,-0.0,61.63,IS,0.34,0.0,Phase3-EA-S4v1-EURCHF-M15-221,EURCHFMT4,2408,8h 45m,Buy
116376.77,148.64,13.06.2013 21:29:58,sl 148.640,0.0,-63.829999999987194,0.0,0.0,147.97,13.06.2013 09:30:00,9302,-0.030919305601701818,-63.83,IS,0.09,0.0,Phase3-EA-B1v1-GBPJPY-M30-1,GBPJPYMT4,890,11h 59m,Sell
116308.18,126293,13.06.2013 21:29:58,sl 126.293,0.0,-132.4199999999837,0.0,0.0,125573,13.06.2013 12:30:00,9303,-0.06414435920065287,-68.59,IS,0.09,0.0,Phase3-EA-TR1v1-EURJPY-M30-91,EURJPYMT4,1628,8h 59m,Sell
116402.26,149525,14.06.2013 03:19:58,tp 149.525,0.0,-38.33999999999651,0.0,0.0,149915,14.06.2013 00:40:00,9304,-0.018571928196292928,94.08,IS,0.23,0.0,Phase3-EA-S4v1-GBPJPY-M5-194,GBPJPYMT4,2200,2h 39m,Sell
116334.46,127146,14.06.2013 03:29:57,sl 127.146,0.0,-106.13999999998487,0.0,0.0,127866,14.06.2013 01:00:00,9305,-0.05141430513183176,-67.8,IS,0.09,0.0,Phase3-EA-TR1v1-EURJPY-M30-91,EURJPYMT4,1630,2h 29m,Buy
116397.36,0.9221,14.06.2013 03:59:57,tp 0.92210,0.0,-43.23999999999069,0.0,0.0,0.9231,14.06.2013 02:30:00,9306,-0.020945492311100846,62.9,IS,0.58,0.0,Phase3-EA-SA2v2-USDCHF-M15-107,USDCHFMT4,1804,1h 29m,Sell
116252.08,1.23281,14.06.2013 05:00:00,,-2.22,-188.51999999998952,0.0,0.0,1.22959,13.06.2013 20:40:00,9307,-0.09131924631103983,-145.28,IS,0.41,0.0,Phase3-EA-SA2v2-EURCHF-M5-43,EURCHFMT4,4816,8h 20m,Sell
116306.17,1.23167,14.06.2013 12:00:00,,0.0,-134.42999999999302,0.0,0.0,1.23314,14.06.2013 03:15:00,9308,-0.06511800488856953,54.09,IS,0.34,0.0,Phase3-EA-S4v1-EURCHF-M15-221,EURCHFMT4,2410,8h 45m,Sell
116264.82,126.45,14.06.2013 18:29:58,sl 126.450,0.0,-175.77999999999884,0.0,0.0,126.22,14.06.2013 18:15:00,9309,-0.08514797961253642,-41.35,IS,0.17,0.0,Phase3-EA-T1v2-EURJPY-M15-322,EURJPYMT4,1600,14m 58s,Sell
116313.77,1.22909,14.06.2013 23:44:57,tp 1.22909,0.0,-126.8299999999872,0.0,0.0,1.23019,14.06.2013 22:05:00,9310,-0.06143655850641129,48.95,IS,0.41,0.0,Phase3-EA-SA2v2-EURCHF-M5-43,EURCHFMT4,4818,1h 39m,Sell
116375.54,94194,17.06.2013 01:00:00,,-1.29,-65.05999999999767,0.0,0.0,94414,14.06.2013 22:30:00,9311,-0.03151511863460837,61.77,IS,0.27,0.0,Phase3-EA-S1v2-USDJPY-M15-0,USDJPYMT4,2672,2d 2h 30m,Sell
116438.38,0.92291,17.06.2013 03:59:58,tp 0.92291,0.0,-2.220000000001164,0.0,0.0,0.92191,17.06.2013 01:15:00,9312,-0.0010753698642617547,62.84,IS,0.58,0.0,Phase3-EA-SA2v2-USDCHF-M15-107,USDCHFMT4,1806,2h 44m,Buy
116396.39,1.23189,17.06.2013 12:30:00,,0.0,-44.20999999999185,0.0,0.0,1.23075,17.06.2013 03:45:00,9313,-0.021415361125665982,-41.99,IS,0.34,0.0,Phase3-EA-S4v1-EURCHF-M15-221,EURCHFMT4,2412,8h 45m,Sell
116263.74,94849,17.06.2013 14:00:00,,0.0,-176.85999999998603,0.0,0.0,94383,17.06.2013 01:15:00,9314,-0.0856711325194681,-132.65,IS,0.27,0.0,Phase3-EA-S1v2-USDJPY-M15-0,USDJPYMT4,2674,12h 45m,Sell
116358.3,149041,18.06.2013 04:09:58,tp 149.041,0.0,-82.29999999998836,0.0,0.0,148651,18.06.2013 02:30:00,9315,-0.039866189112019584,94.56,IS,0.23,0.0,Phase3-EA-S4v1-GBPJPY-M5-194,GBPJPYMT4,2202,1h 39m,Buy
116317.06,126443,18.06.2013 09:29:58,sl 126.443,0.0,-123.53999999997905,0.0,0.0,126673,18.06.2013 04:00:00,9316,-0.059842879743605845,-41.24,IS,0.17,0.0,Phase3-EA-T1v2-EURJPY-M15-322,EURJPYMT4,1602,5h 29m,Buy
116318.9,1.23274,18.06.2013 11:00:00,,0.0,-121.69999999998254,0.0,0.0,1.23269,18.06.2013 02:15:00,9317,-0.05895158219845412,1.84,IS,0.34,0.0,Phase3-EA-S4v1-EURCHF-M15-221,EURCHFMT4,2414,8h 45m,Buy
116440.62,127.23,18.06.2013 11:29:58,tp 127.230,-0.47,-0.0,0.0,0.0,125.94,17.06.2013 02:30:00,9318,-0.0,121.72,IS,0.09,0.0,Phase3-EA-TR1v1-EURJPY-M30-91,EURJPYMT4,1632,1d 8h 59m,Buy
116418.29,95.39,19.06.2013 00:30:00,,-0.82,-22.329999999987194,0.0,0.0,95466,18.06.2013 18:30:00,9319,-0.010816669703853376,-22.33,IS,0.27,0.0,Phase3-EA-S1v2-USDJPY-M15-0,USDJPYMT4,2676,6h 0m,Buy
116512.29,148963,19.06.2013 05:39:57,tp 148.963,0.0,-0.0,0.0,0.0,149353,19.06.2013 01:50:00,9320,-0.0,94.0,IS,0.23,0.0,Phase3-EA-S4v1-GBPJPY-M5-194,GBPJPYMT4,2204,3h 49m,Sell
116470.43,127588,19.06.2013 05:59:58,sl 127.588,-0.87,-41.85999999998603,0.0,0.0,127818,18.06.2013 23:15:00,9321,-0.02026998005783859,-41.86,IS,0.17,0.0,Phase3-EA-T1v2-EURJPY-M15-322,EURJPYMT4,1604,6h 44m,Buy
116507.84,95258,19.06.2013 06:00:00,,0.0,-4.449999999982538,0.0,0.0,95.39,19.06.2013 00:30:00,9322,-0.002154835433756758,37.41,IS,0.27,0.0,Phase3-EA-S1v2-USDJPY-M15-0,USDJPYMT4,2678,5h 30m,Sell
116551.08,1.23151,19.06.2013 06:10:00,,-2.23,-0.0,0.0,0.0,1.23253,18.06.2013 21:50:00,9323,-0.0,43.24,IS,0.41,0.0,Phase3-EA-SA2v2-EURCHF-M5-43,EURCHFMT4,4820,8h 20m,Sell
116547.76,1.23262,19.06.2013 12:30:00,,0.0,-3.320000000006985,0.0,0.0,1.23253,19.06.2013 03:45:00,9324,-0.0016073505885357592,-3.32,IS,0.34,0.0,Phase3-EA-S4v1-EURCHF-M15-221,EURCHFMT4,2416,8h 45m,Sell
116596.88,1.2326,19.06.2013 21:04:58,tp 1.23260,0.0,-0.0,0.0,0.0,1.2315,19.06.2013 20:20:00,9325,-0.0,49.12,IS,0.41,0.0,Phase3-EA-SA2v2-EURCHF-M5-43,EURCHFMT4,4822,44m 58s,Buy
116645.76,1.23411,19.06.2013 21:09:58,tp 1.23411,0.0,-0.0,0.0,0.0,1.23301,19.06.2013 21:05:00,9326,-0.0,48.88,IS,0.41,0.0,Phase3-EA-SA2v2-EURCHF-M5-43,EURCHFMT4,4824,4m 58s,Buy
116599.51,1.55646,19.06.2013 21:29:57,sl 1.55646,-4.25,-46.25,0.0,0.0,1.55946,11.06.2013 18:00:00,9327,-0.02238129637888517,-46.25,IS,0.14,0.0,Phase3-EA-B1v1-GBPUSD-M30-14,GBPUSDMT4,600,8d 3h 29m,Buy
116525.48,128423,19.06.2013 21:29:58,sl 128.423,-0.33,-120.27999999999884,0.0,0.0,127643,18.06.2013 21:00:00,9328,-0.058205888182752054,-74.03,IS,0.09,0.0,Phase3-EA-TR1v1-EURJPY-M30-91,EURJPYMT4,1634,1d 0h 29m,Sell
116587.9,0.92918,19.06.2013 22:29:58,tp 0.92918,0.0,-57.85999999998603,0.0,0.0,0.93018,19.06.2013 22:00:00,9329,-0.02799960666988072,62.42,IS,0.58,0.0,Phase3-EA-SA2v2-USDCHF-M15-107,USDCHFMT4,1808,29m 58s,Sell
116629.91,1.23241,20.06.2013 03:39:57,tp 1.23241,-6.63,-15.849999999976717,0.0,0.0,1.23351,19.06.2013 21:20:00,9330,-0.007670130759022894,42.01,IS,0.41,0.0,Phase3-EA-SA2v2-EURCHF-M5-43,EURCHFMT4,4826,6h 19m,Sell
116617.88,1.23094,20.06.2013 14:15:00,,0.0,-27.879999999975553,0.0,0.0,1.23127,20.06.2013 05:30:00,9331,-0.013491687417141003,-12.03,IS,0.34,0.0,Phase3-EA-S4v1-EURCHF-M15-221,EURCHFMT4,2418,8h 45m,Buy
116556.37,151186,20.06.2013 21:29:58,sl 151.186,0.0,-89.38999999998487,0.0,0.0,151856,20.06.2013 19:00:00,9332,-0.043257601801258524,-61.51,IS,0.09,0.0,Phase3-EA-B1v1-GBPJPY-M30-1,GBPJPYMT4,892,2h 29m,Buy
116516.32,129178,20.06.2013 21:29:59,sl 129.178,0.0,-129.43999999997322,0.0,0.0,129408,20.06.2013 18:30:00,9333,-0.06263859466556318,-40.05,IS,0.17,0.0,Phase3-EA-T1v2-EURJPY-M15-322,EURJPYMT4,1606,2h 59m,Buy
116465.61,1.22498,21.06.2013 06:05:00,,-1.06,-180.14999999996508,0.0,0.0,1.2261,20.06.2013 21:45:00,9334,-0.0871781738952515,-50.71,IS,0.41,0.0,Phase3-EA-SA2v2-EURCHF-M5-43,EURCHFMT4,4828,8h 20m,Buy
116557.77,151043,21.06.2013 06:49:57,tp 151.043,0.0,-87.98999999996158,0.0,0.0,150653,21.06.2013 02:10:00,9335,-0.042580113910859384,92.16,IS,0.23,0.0,Phase3-EA-S4v1-GBPJPY-M5-194,GBPJPYMT4,2206,4h 39m,Buy
116515.77,1.54863,21.06.2013 10:29:58,sl 1.54863,0.0,-129.98999999996158,0.0,0.0,1.55163,21.06.2013 05:00:00,9336,-0.06290475062249565,-42.0,IS,0.14,0.0,Phase3-EA-B1v1-GBPUSD-M30-14,GBPUSDMT4,602,5h 29m,Buy
116567.81,1.22671,21.06.2013 11:45:00,,0.0,-77.94999999995343,0.0,0.0,1.22529,21.06.2013 03:00:00,9337,-0.03772155789693096,52.04,IS,0.34,0.0,Phase3-EA-S4v1-EURCHF-M15-221,EURCHFMT4,2420,8h 45m,Buy
116569.75,97475,21.06.2013 18:00:00,,0.0,-76.0099999999511,0.0,0.0,97482,21.06.2013 17:45:00,9338,-0.03678275324882092,1.94,IS,0.27,0.0,Phase3-EA-S1v2-USDJPY-M15-0,USDJPYMT4,2680,15m 0s,Sell
116618.03,1.22648,21.06.2013 22:49:57,tp 1.22648,0.0,-27.72999999995227,0.0,0.0,1.22758,21.06.2013 22:25:00,9339,-0.013419099428873893,48.28,IS,0.41,0.0,Phase3-EA-SA2v2-EURCHF-M5-43,EURCHFMT4,4830,24m 57s,Sell
116665.13,1.22725,24.06.2013 01:59:58,tp 1.22725,-1.05,-0.0,0.0,0.0,1.22615,21.06.2013 23:20:00,9340,-0.0,47.1,IS,0.41,0.0,Phase3-EA-SA2v2-EURCHF-M5-43,EURCHFMT4,4832,2d 2h 39m,Buy
116557.15,0.9363,24.06.2013 04:00:00,,-3.29,-107.98000000001048,0.0,0.0,0.93461,21.06.2013 23:45:00,9341,-0.05224877559170715,-107.98,IS,0.58,0.0,Phase3-EA-SA2v2-USDCHF-M15-107,USDCHFMT4,1810,2d 4h 15m,Sell
116574.2,151286,24.06.2013 07:35:00,,0.0,-90.93000000002212,0.0,0.0,151359,24.06.2013 02:10:00,9342,-0.04399871424851478,17.05,IS,0.23,0.0,Phase3-EA-S4v1-GBPJPY-M5-194,GBPJPYMT4,2208,5h 25m,Sell
116622.4,1.22611,24.06.2013 07:59:57,tp 1.22611,0.0,-42.73000000001048,0.0,0.0,1.22721,24.06.2013 02:45:00,9343,-0.020675960187386346,48.2,IS,0.41,0.0,Phase3-EA-SA2v2-EURCHF-M5-43,EURCHFMT4,4834,5h 14m,Sell
116635.11,1.2264,24.06.2013 10:00:00,,0.0,-30.020000000018626,0.0,0.0,1.22605,24.06.2013 01:15:00,9344,-0.014525914458824502,12.71,IS,0.34,0.0,Phase3-EA-S4v1-EURCHF-M15-221,EURCHFMT4,2422,8h 45m,Buy
116752.77,127756,24.06.2013 15:59:58,tp 127.756,-0.64,-0.0,0.0,0.0,129046,20.06.2013 14:00:00,9345,-0.0,117.66,IS,0.09,0.0,Phase3-EA-TR1v1-EURJPY-M30-91,EURJPYMT4,1636,4d 1h 59m,Sell
116790.57,97518,25.06.2013 02:00:00,,-1.24,-0.0,0.0,0.0,97659,24.06.2013 20:45:00,9346,-0.0,37.8,IS,0.27,0.0,Phase3-EA-S1v2-USDJPY-M15-0,USDJPYMT4,2682,5h 15m,Sell
116709.8,1.22581,25.06.2013 05:35:00,,-2.2,-80.76999999998952,0.0,0.0,1.22402,24.06.2013 21:15:00,9347,-0.03905884102935113,-80.77,IS,0.41,0.0,Phase3-EA-SA2v2-EURCHF-M5-43,EURCHFMT4,4836,8h 20m,Sell
116667.97,1.22656,25.06.2013 13:30:00,,0.0,-122.59999999997672,0.0,0.0,1.22541,25.06.2013 04:45:00,9348,-0.05928703615449004,-41.83,IS,0.34,0.0,Phase3-EA-S4v1-EURCHF-M15-221,EURCHFMT4,2424,8h 45m,Sell
116704.14,97868,26.06.2013 00:15:00,,-0.8,-86.42999999996391,0.0,0.0,97734,25.06.2013 20:45:00,9349,-0.04179590974577004,36.17,IS,0.27,0.0,Phase3-EA-S1v2-USDJPY-M15-0,USDJPYMT4,2684,3h 30m,Buy
116795.93,150709,26.06.2013 05:14:58,tp 150.709,0.0,-0.0,0.0,0.0,151099,26.06.2013 00:55:00,9350,-0.0,91.79,IS,0.23,0.0,Phase3-EA-S4v1-GBPJPY-M5-194,GBPJPYMT4,2210,4h 19m,Sell
116729.76,1.22603,26.06.2013 06:40:00,,-1.05,-66.1700000000128,0.0,0.0,1.22752,25.06.2013 22:20:00,9351,-0.03199772838856761,-66.17,IS,0.41,0.0,Phase3-EA-SA2v2-EURCHF-M5-43,EURCHFMT4,4838,8h 20m,Buy
116735.56,97819,27.06.2013 10:00:00,,0.0,-60.37000000002445,0.0,0.0,97798,27.06.2013 01:15:00,9352,-0.029193031023397844,5.8,IS,0.27,0.0,Phase3-EA-S1v2-USDJPY-M15-0,USDJPYMT4,2686,8h 45m,Buy
116783.41,1.22755,27.06.2013 10:14:58,tp 1.22755,0.0,-12.520000000018626,0.0,0.0,1.22645,27.06.2013 02:05:00,9353,-0.006054277760697975,47.85,IS,0.41,0.0,Phase3-EA-SA2v2-EURCHF-M5-43,EURCHFMT4,4840,8h 9m,Buy
116769.67,98272,27.06.2013 17:15:00,,0.0,-26.260000000009313,0.0,0.0,98322,27.06.2013 17:00:00,9354,-0.012698509105091748,-13.74,IS,0.27,0.0,Phase3-EA-S1v2-USDJPY-M15-0,USDJPYMT4,2688,15m 0s,Buy
116817.36,1.23281,27.06.2013 21:19:57,tp 1.23281,0.0,-0.0,0.0,0.0,1.23171,27.06.2013 20:10:00,9355,-0.0,47.69,IS,0.41,0.0,Phase3-EA-SA2v2-EURCHF-M5-43,EURCHFMT4,4842,1h 9m,Buy
116865.08,1.23234,27.06.2013 23:34:57,tp 1.23234,0.0,-0.0,0.0,0.0,1.23344,27.06.2013 22:00:00,9356,-0.0,47.72,IS,0.41,0.0,Phase3-EA-SA2v2-EURCHF-M5-43,EURCHFMT4,4844,1h 34m,Sell
116981.18,128396,28.06.2013 03:29:58,tp 128.396,-1.8,-0.0,0.0,0.0,127106,26.06.2013 21:30:00,9357,-0.0,116.1,IS,0.09,0.0,Phase3-EA-TR1v1-EURJPY-M30-91,EURJPYMT4,1638,1d 5h 59m,Buy
117028.97,1.23287,28.06.2013 06:09:58,tp 1.23287,0.0,-0.0,0.0,0.0,1.23177,28.06.2013 02:45:00,9358,-0.0,47.79,IS,0.41,0.0,Phase3-EA-SA2v2-EURCHF-M5-43,EURCHFMT4,4846,3h 24m,Buy
117032.94,1.23264,28.06.2013 15:30:00,,0.0,-0.0,0.0,0.0,1.23275,28.06.2013 06:45:00,9359,-0.0,3.97,IS,0.34,0.0,Phase3-EA-S4v1-EURCHF-M15-221,EURCHFMT4,2426,8h 45m,Sell
117023.12,98993,28.06.2013 17:15:00,,0.0,-9.820000000006985,0.0,0.0,99029,28.06.2013 17:00:00,9360,-0.004743206564137536,-9.82,IS,0.27,0.0,Phase3-EA-S1v2-USDJPY-M15-0,USDJPYMT4,2690,15m 0s,Buy
117042.74,99065,28.06.2013 18:00:00,,0.0,-0.0,0.0,0.0,98993,28.06.2013 17:30:00,9361,-0.0,19.62,IS,0.27,0.0,Phase3-EA-S1v2-USDJPY-M15-0,USDJPYMT4,2692,30m 0s,Buy
117104.14,0.94468,28.06.2013 23:14:57,tp 0.94468,0.0,-0.0,0.0,0.0,0.94368,28.06.2013 23:00:00,9362,-0.0,61.4,IS,0.58,0.0,Phase3-EA-SA2v2-USDCHF-M15-107,USDCHFMT4,1812,14m 57s,Buy
117157.96,99371,01.07.2013 01:30:00,,-0.79,-0.0,0.0,0.0,99.17,28.06.2013 23:00:00,9363,-0.0,53.82,IS,0.27,0.0,Phase3-EA-S1v2-USDJPY-M15-0,USDJPYMT4,2694,2d 2h 30m,Buy
117204.64,1.2308,01.07.2013 05:29:58,tp 1.23080,-1.04,-0.0,0.0,0.0,1.2297,28.06.2013 22:55:00,9364,-0.0,46.68,IS,0.41,0.0,Phase3-EA-SA2v2-EURCHF-M5-43,EURCHFMT4,4848,2d 6h 34m,Buy
117092.46,1.23363,01.07.2013 14:45:00,,0.0,-112.17999999999302,0.0,0.0,1.23051,01.07.2013 06:00:00,9365,-0.05413971424577768,-112.18,IS,0.34,0.0,Phase3-EA-S4v1-EURCHF-M15-221,EURCHFMT4,2428,8h 45m,Sell
117140.13,1.23486,01.07.2013 21:29:57,tp 1.23486,0.0,-64.50999999998021,0.0,0.0,1.23596,01.07.2013 20:55:00,9366,-0.031133472686702305,47.67,IS,0.41,0.0,Phase3-EA-SA2v2-EURCHF-M5-43,EURCHFMT4,4850,34m 57s,Sell
117167.12,0.94558,02.07.2013 04:45:00,,0.0,-37.51999999998952,0.0,0.0,0.94514,02.07.2013 00:30:00,9367,-0.018107702607426796,26.99,IS,0.58,0.0,Phase3-EA-SA2v2-USDCHF-M15-107,USDCHFMT4,1814,4h 15m,Buy
117150.9,1.23468,02.07.2013 06:05:00,,-1.04,-53.73999999999069,0.0,0.0,1.23503,01.07.2013 21:45:00,9368,-0.02593571263654635,-16.22,IS,0.41,0.0,Phase3-EA-SA2v2-EURCHF-M5-43,EURCHFMT4,4852,8h 20m,Buy
117263.65,130583,02.07.2013 09:59:58,tp 130.583,-0.88,-0.0,0.0,0.0,129323,28.06.2013 06:30:00,9369,-0.0,112.75,IS,0.09,0.0,Phase3-EA-TR1v1-EURJPY-M30-91,EURJPYMT4,1640,4d 3h 29m,Buy
117224.41,129924,02.07.2013 11:44:58,sl 129.924,0.0,-39.23999999999069,0.0,0.0,130154,02.07.2013 08:15:00,9370,-0.018932408070585677,-39.24,IS,0.17,0.0,Phase3-EA-T1v2-EURJPY-M15-322,EURJPYMT4,1608,3h 29m,Buy
117262.77,130628,03.07.2013 01:00:00,,-0.83,-0.8800000000046566,0.0,0.0,130396,02.07.2013 15:45:00,9371,-4.245799975078367E-4,38.36,IS,0.17,0.0,Phase3-EA-T1v2-EURJPY-M15-322,EURJPYMT4,1610,9h 15m,Buy
117332.47,100754,03.07.2013 02:00:00,,-0.78,-0.0,0.0,0.0,100491,02.07.2013 21:30:00,9372,-0.0,69.7,IS,0.27,0.0,Phase3-EA-S1v2-USDJPY-M15-0,USDJPYMT4,2696,4h 30m,Buy
117293.65,130609,03.07.2013 03:29:58,sl 130.609,0.0,-38.820000000006985,0.0,0.0,130839,03.07.2013 02:15:00,9373,-0.01872355063343757,-38.82,IS,0.17,0.0,Phase3-EA-T1v2-EURJPY-M15-322,EURJPYMT4,1612,1h 14m,Buy
117382.91,152242,03.07.2013 04:54:57,tp 152.242,0.0,-0.0,0.0,0.0,152632,03.07.2013 01:55:00,9374,-0.0,89.26,IS,0.23,0.0,Phase3-EA-S4v1-GBPJPY-M5-194,GBPJPYMT4,2212,2h 59m,Sell
117321.1,1.23399,03.07.2013 05:00:00,,-1.04,-61.80999999999767,0.0,0.0,1.2354,02.07.2013 20:40:00,9375,-0.029804770315932642,-61.81,IS,0.41,0.0,Phase3-EA-SA2v2-EURCHF-M5-43,EURCHFMT4,4854,8h 20m,Buy
117282.31,130417,03.07.2013 10:14:58,sl 130.417,0.0,-100.60000000000582,0.0,0.0,130647,03.07.2013 07:30:00,9376,-0.04850930098338635,-38.79,IS,0.17,0.0,Phase3-EA-T1v2-EURJPY-M15-322,EURJPYMT4,1614,2h 44m,Buy
117238.24,1.52618,03.07.2013 14:29:58,sl 1.52618,-2.07,-144.6700000000128,0.0,0.0,1.52318,28.06.2013 14:30:00,9377,-0.06975984665275067,-44.07,IS,0.14,0.0,Phase3-EA-B1v1-GBPUSD-M30-14,GBPUSDMT4,604,4d 23h 59m,Sell
117528.92,128648,03.07.2013 14:44:58,tp 128.648,0.0,-0.0,0.0,0.0,130348,03.07.2013 10:15:00,9378,-0.0,290.68,IS,0.17,0.0,Phase3-EA-T1v2-EURJPY-M15-322,EURJPYMT4,1616,4h 29m,Sell
117598.15,99445,03.07.2013 17:15:00,,0.0,-0.0,0.0,0.0,99702,03.07.2013 17:00:00,9379,-0.0,69.23,IS,0.27,0.0,Phase3-EA-S1v2-USDJPY-M15-0,USDJPYMT4,2698,15m 0s,Buy
117654.9,99912,03.07.2013 19:15:00,,0.0,-0.0,0.0,0.0,99.7,03.07.2013 17:00:00,9380,-0.0,56.75,IS,0.27,0.0,Phase3-EA-S1v2-USDJPY-M15-0,USDJPYMT4,2699,2h 15m,Sell
117700.58,100053,04.07.2013 01:30:00,,-2.35,-0.0,0.0,0.0,99875,03.07.2013 21:30:00,9381,-0.0,45.68,IS,0.27,0.0,Phase3-EA-S1v2-USDJPY-M15-0,USDJPYMT4,2702,4h 0m,Buy
117656.52,1.23318,04.07.2013 10:55:00,,0.0,-44.05999999999767,0.0,0.0,1.23216,04.07.2013 02:35:00,9382,-0.021213229159012175,-44.06,IS,0.41,0.0,Phase3-EA-SA2v2-EURCHF-M5-43,EURCHFMT4,4856,8h 20m,Sell
117594.41,150999,04.07.2013 14:29:58,sl 150.999,-1.62,-106.1699999999837,0.0,0.0,151669,01.07.2013 12:00:00,9383,-0.05111685292356096,-62.11,IS,0.09,0.0,Phase3-EA-B1v1-GBPJPY-M30-1,GBPJPYMT4,894,3d 2h 29m,Buy
117641.57,1.23597,04.07.2013 21:34:59,tp 1.23597,0.0,-59.00999999998021,0.0,0.0,1.23707,04.07.2013 20:50:00,9384,-0.0284110906189958,47.16,IS,0.41,0.0,Phase3-EA-SA2v2-EURCHF-M5-43,EURCHFMT4,4858,44m 59s,Sell
117654.82,100082,05.07.2013 00:15:00,,-0.78,-45.75999999998021,0.0,0.0,100.03,04.07.2013 20:45:00,9385,-0.02203171507753129,13.25,IS,0.27,0.0,Phase3-EA-S1v2-USDJPY-M15-0,USDJPYMT4,2704,3h 30m,Buy
117652.25,1.23502,05.07.2013 09:50:00,,0.0,-48.329999999987194,0.0,0.0,1.23508,05.07.2013 01:30:00,9386,-0.02326907320142626,-2.57,IS,0.41,0.0,Phase3-EA-SA2v2-EURCHF-M5-43,EURCHFMT4,4860,8h 20m,Buy
117677.09,1.2355,05.07.2013 10:00:00,,0.0,-23.489999999990687,0.0,0.0,1.2348,05.07.2013 01:15:00,9387,-0.011309549544825801,24.84,IS,0.34,0.0,Phase3-EA-S4v1-EURCHF-M15-221,EURCHFMT4,2430,8h 45m,Buy
117637.82,129823,05.07.2013 21:59:58,sl 129.823,-0.59,-62.75999999998021,0.0,0.0,129593,04.07.2013 15:30:00,9388,-0.03021657426280651,-39.27,IS,0.17,0.0,Phase3-EA-T1v2-EURJPY-M15-322,EURJPYMT4,1618,1d 6h 29m,Sell
117624.07,101136,08.07.2013 05:00:00,,-1.2,-76.50999999998021,0.0,0.0,101089,05.07.2013 21:45:00,9389,-0.03683668095677911,-13.75,IS,0.27,0.0,Phase3-EA-S1v2-USDJPY-M15-0,USDJPYMT4,2706,2d 7h 15m,Sell
117508.53,1.23775,08.07.2013 05:05:00,,-2.13,-192.04999999998836,0.0,0.0,1.23508,05.07.2013 20:45:00,9390,-0.09246483567835354,-115.54,IS,0.41,0.0,Phase3-EA-SA2v2-EURCHF-M5-43,EURCHFMT4,4862,2d 8h 20m,Sell
117513.46,1.23781,08.07.2013 09:45:00,,0.0,-187.11999999999534,0.0,0.0,1.23795,08.07.2013 01:00:00,9391,-0.09009122651462709,4.93,IS,0.34,0.0,Phase3-EA-S4v1-EURCHF-M15-221,EURCHFMT4,2432,8h 45m,Sell
117532.17,100993,08.07.2013 19:30:00,,0.0,-168.4100000000035,0.0,0.0,101063,08.07.2013 19:00:00,9392,-0.08108306678777812,18.71,IS,0.27,0.0,Phase3-EA-S1v2-USDJPY-M15-0,USDJPYMT4,2708,30m 0s,Sell
117493.45,129831,08.07.2013 19:59:58,sl 129.831,0.0,-207.13000000000466,0.0,0.0,130061,08.07.2013 11:45:00,9393,-0.09972528723800551,-38.72,IS,0.17,0.0,Phase3-EA-T1v2-EURJPY-M15-322,EURJPYMT4,1620,8h 14m,Buy
117453.89,129866,09.07.2013 00:14:57,sl 129.866,-0.83,-246.69000000000233,0.0,0.0,130096,08.07.2013 23:00:00,9394,-0.11877193602444484,-39.56,IS,0.17,0.0,Phase3-EA-T1v2-EURJPY-M15-322,EURJPYMT4,1622,1h 14m,Buy
117415.24,129885,09.07.2013 05:29:58,sl 129.885,0.0,-285.3399999999965,0.0,0.0,130115,09.07.2013 05:00:00,9395,-0.13738045411331776,-38.65,IS,0.17,0.0,Phase3-EA-T1v2-EURJPY-M15-322,EURJPYMT4,1624,29m 58s,Buy
117409.28,1.24034,09.07.2013 06:40:00,,-2.13,-291.29999999998836,0.0,0.0,1.24025,08.07.2013 22:20:00,9396,-0.14024996945121032,-5.96,IS,0.41,0.0,Phase3-EA-SA2v2-EURCHF-M5-43,EURCHFMT4,4864,8h 20m,Sell
117344.35,129108,09.07.2013 18:59:57,sl 129.108,-0.88,-356.2299999999814,0.0,0.0,129828,05.07.2013 22:00:00,9397,-0.17151131691590812,-64.93,IS,0.09,0.0,Phase3-EA-TR1v1-EURJPY-M30-91,EURJPYMT4,1642,3d 20h 59m,Buy
117389.68,1.24407,10.07.2013 02:14:57,tp 1.24407,-1.01,-310.8999999999942,0.0,0.0,1.24297,09.07.2013 20:40:00,9398,-0.14968663062953044,45.33,IS,0.41,0.0,Phase3-EA-SA2v2-EURCHF-M5-43,EURCHFMT4,4866,5h 34m,Buy
117475.63,1.24199,10.07.2013 12:45:00,,0.0,-224.94999999998254,0.0,0.0,1.24444,10.07.2013 04:00:00,9399,-0.10830494551338336,85.95,IS,0.34,0.0,Phase3-EA-S4v1-EURCHF-M15-221,EURCHFMT4,2434,8h 45m,Sell
117531.33,100348,10.07.2013 21:00:00,,0.0,-169.2499999999709,0.0,0.0,100141,10.07.2013 18:30:00,9400,-0.08148749512397602,55.7,IS,0.27,0.0,Phase3-EA-S1v2-USDJPY-M15-0,USDJPYMT4,2710,2h 30m,Buy
117578.21,1.24311,10.07.2013 21:29:58,tp 1.24311,0.0,-122.36999999996624,0.0,0.0,1.24201,10.07.2013 20:10:00,9401,-0.058916542264814825,46.88,IS,0.41,0.0,Phase3-EA-SA2v2-EURCHF-M5-43,EURCHFMT4,4868,1h 19m,Buy
117625.1,1.24293,10.07.2013 23:54:58,tp 1.24293,0.0,-75.47999999995227,0.0,0.0,1.24403,10.07.2013 21:40:00,9402,-0.036340774782598985,46.89,IS,0.41,0.0,Phase3-EA-SA2v2-EURCHF-M5-43,EURCHFMT4,4870,2h 14m,Sell
117388.03,0.95415,11.07.2013 00:44:58,sl 0.95415,0.0,-312.54999999995925,0.0,0.0,0.95805,11.07.2013 00:15:00,9403,-0.15048104343279034,-237.07,IS,0.58,0.0,Phase3-EA-SA2v2-USDCHF-M15-107,USDCHFMT4,1816,29m 58s,Buy
117321.82,129663,11.07.2013 00:59:57,sl 129.663,-1.26,-378.7599999999511,0.0,0.0,128943,09.07.2013 21:00:00,9404,-0.1823586626479083,-66.21,IS,0.09,0.0,Phase3-EA-TR1v1-EURJPY-M30-91,EURJPYMT4,1644,1d 3h 59m,Sell
117083.89,0.95069,11.07.2013 01:59:58,sl 0.95069,0.0,-616.6899999999441,0.0,0.0,0.95459,11.07.2013 01:15:00,9405,-0.29691298888040685,-237.93,IS,0.58,0.0,Phase3-EA-SA2v2-USDCHF-M15-107,USDCHFMT4,1818,44m 58s,Buy
117131.4,1.24385,11.07.2013 03:09:58,tp 1.24385,0.0,-569.1799999999348,0.0,0.0,1.24275,11.07.2013 02:00:00,9406,-0.2740387147690832,47.51,IS,0.41,0.0,Phase3-EA-SA2v2-EURCHF-M5-43,EURCHFMT4,4872,1h 9m,Buy
116990.82,1.23696,11.07.2013 07:44:58,sl 1.23696,0.0,-709.759999999922,0.0,0.0,1.24086,11.07.2013 06:45:00,9407,-0.3417226856082529,-140.58,IS,0.34,0.0,Phase3-EA-S4v1-EURCHF-M15-221,EURCHFMT4,2436,59m 58s,Buy
116951.44,129387,11.07.2013 16:29:58,sl 129.387,0.0,-749.1399999999267,0.0,0.0,129157,11.07.2013 16:00:00,9408,-0.3606826711797927,-39.38,IS,0.17,0.0,Phase3-EA-T1v2-EURJPY-M15-322,EURJPYMT4,1626,29m 58s,Sell
116999.01,1.23887,11.07.2013 21:54:57,tp 1.23887,0.0,-701.5699999999197,0.0,0.0,1.23777,11.07.2013 20:10:00,9409,-0.3377795093301692,47.57,IS,0.41,0.0,Phase3-EA-SA2v2-EURCHF-M5-43,EURCHFMT4,4874,1h 44m,Buy
117065.43,98.78,11.07.2013 22:30:00,,0.0,-635.1499999999069,0.0,0.0,99023,11.07.2013 21:30:00,9410,-0.30580078303098773,66.42,IS,0.27,0.0,Phase3-EA-S1v2-USDJPY-M15-0,USDJPYMT4,2712,1h 0m,Sell
117126.66,0.94723,11.07.2013 23:59:58,tp 0.94723,0.0,-573.9199999998964,0.0,0.0,0.94623,11.07.2013 22:00:00,9411,-0.2763208460948414,61.23,IS,0.58,0.0,Phase3-EA-SA2v2-USDCHF-M15-107,USDCHFMT4,1820,1h 59m,Buy
117217.26,150341,12.07.2013 03:59:59,tp 150.341,0.0,-483.31999999989057,0.0,0.0,149951,12.07.2013 03:10:00,9412,-0.23270036126037189,90.6,IS,0.23,0.0,Phase3-EA-S4v1-GBPJPY-M5-194,GBPJPYMT4,2214,49m 59s,Buy
117265.18,99167,12.07.2013 04:00:00,,0.0,-435.39999999987776,0.0,0.0,98991,12.07.2013 01:00:00,9413,-0.20962868760398995,47.92,IS,0.27,0.0,Phase3-EA-S1v2-USDJPY-M15-0,USDJPYMT4,2714,3h 0m,Buy
117287.69,1.23923,12.07.2013 07:55:00,,-2.16,-412.88999999986845,0.0,0.0,1.2398,11.07.2013 23:35:00,9414,-0.19879097111807104,22.51,IS,0.41,0.0,Phase3-EA-SA2v2-EURCHF-M5-43,EURCHFMT4,4876,8h 20m,Sell
117337.78,1.23898,12.07.2013 11:15:00,,0.0,-362.79999999987194,0.0,0.0,1.24038,12.07.2013 02:30:00,9415,-0.1746745242598118,50.09,IS,0.34,0.0,Phase3-EA-S4v1-EURCHF-M15-221,EURCHFMT4,2438,8h 45m,Sell
117298.32,129222,12.07.2013 17:29:58,sl 129.222,0.0,-402.2599999998638,0.0,0.0,128992,12.07.2013 17:00:00,9416,-0.1936730268157467,-39.46,IS,0.17,0.0,Phase3-EA-T1v2-EURJPY-M15-322,EURJPYMT4,1628,29m 58s,Sell
117287.72,129.65,15.07.2013 03:45:00,,-0.84,-412.8599999998696,0.0,0.0,129707,12.07.2013 18:30:00,9417,-0.19877652724892111,-10.6,IS,0.17,0.0,Phase3-EA-T1v2-EURJPY-M15-322,EURJPYMT4,1630,2d 9h 15m,Buy
117259.98,1.23676,15.07.2013 05:55:00,,-2.17,-440.5999999998603,0.0,0.0,1.23617,12.07.2013 21:35:00,9418,-0.21213229159006572,-27.74,IS,0.41,0.0,Phase3-EA-SA2v2-EURCHF-M5-43,EURCHFMT4,4878,2d 8h 20m,Sell
117244.24,99321,15.07.2013 09:45:00,,-0.79,-456.339999999851,0.0,0.0,99376,12.07.2013 18:45:00,9419,-0.21971050827101604,-15.74,IS,0.27,0.0,Phase3-EA-S1v2-USDJPY-M15-0,USDJPYMT4,2716,2d 15h 0m,Buy
117271.55,99968,16.07.2013 02:15:00,,-0.78,-429.0299999998533,0.0,0.0,99864,15.07.2013 17:00:00,9420,-0.20656177272102505,27.31,IS,0.27,0.0,Phase3-EA-S1v2-USDJPY-M15-0,USDJPYMT4,2718,9h 15m,Buy
117286.95,1.23911,16.07.2013 06:25:00,,-1.04,-413.62999999985914,0.0,0.0,1.23873,15.07.2013 22:05:00,9421,-0.19914725322377852,15.4,IS,0.41,0.0,Phase3-EA-SA2v2-EURCHF-M5-43,EURCHFMT4,4880,8h 20m,Buy
117389.77,130343,16.07.2013 06:45:00,,-0.83,-310.80999999985215,0.0,0.0,129735,15.07.2013 06:15:00,9422,-0.1496432990220106,102.82,IS,0.17,0.0,Phase3-EA-T1v2-EURJPY-M15-322,EURJPYMT4,1632,1d 0h 30m,Buy
117350.6,130357,16.07.2013 10:44:58,sl 130.357,0.0,-349.97999999986496,0.0,0.0,130587,16.07.2013 09:00:00,9423,-0.1685021775095009,-39.17,IS,0.17,0.0,Phase3-EA-T1v2-EURJPY-M15-322,EURJPYMT4,1634,1h 44m,Buy
117311.32,130495,16.07.2013 13:29:58,sl 130.495,0.0,-389.2599999998638,0.0,0.0,130265,16.07.2013 11:30:00,9424,-0.18741401685053624,-39.28,IS,0.17,0.0,Phase3-EA-T1v2-EURJPY-M15-322,EURJPYMT4,1636,1h 59m,Sell
117357.28,99279,16.07.2013 18:00:00,,0.0,-343.29999999987194,0.0,0.0,99448,16.07.2013 17:00:00,9425,-0.1652860093119961,45.96,IS,0.27,0.0,Phase3-EA-S1v2-USDJPY-M15-0,USDJPYMT4,2720,1h 0m,Sell
117393.77,99163,16.07.2013 19:45:00,,0.0,-306.80999999988126,0.0,0.0,99297,16.07.2013 19:30:00,9426,-0.14771744980195986,36.49,IS,0.27,0.0,Phase3-EA-S1v2-USDJPY-M15-0,USDJPYMT4,2722,15m 0s,Sell
117354.35,130294,16.07.2013 22:44:58,sl 130.294,0.0,-346.22999999989406,0.0,0.0,130524,16.07.2013 22:00:00,9427,-0.16669669386570418,-39.42,IS,0.17,0.0,Phase3-EA-T1v2-EURJPY-M15-322,EURJPYMT4,1638,44m 58s,Buy
117402.44,1.23586,16.07.2013 22:44:58,tp 1.23586,0.0,-298.13999999989755,0.0,0.0,1.23696,16.07.2013 20:05:00,9428,-0.14354317161747734,48.09,IS,0.41,0.0,Phase3-EA-SA2v2-EURCHF-M5-43,EURCHFMT4,4882,2h 39m,Sell
117331.33,131014,17.07.2013 10:59:58,sl 131.014,-0.64,-369.2499999998836,0.0,0.0,130234,15.07.2013 17:30:00,9429,-0.17777995612717182,-71.11,IS,0.09,0.0,Phase3-EA-TR1v1-EURJPY-M30-91,EURJPYMT4,1646,1d 17h 29m,Sell
117246.91,99466,17.07.2013 15:45:00,,0.0,-453.6699999998964,0.0,0.0,99155,17.07.2013 01:00:00,9430,-0.21842500391664468,-84.42,IS,0.27,0.0,Phase3-EA-S1v2-USDJPY-M15-0,USDJPYMT4,2724,14h 45m,Sell
117207.5,130325,17.07.2013 16:44:58,sl 130.325,0.0,-493.0799999998999,0.0,0.0,130555,17.07.2013 04:45:00,9431,-0.23739943335733438,-39.41,IS,0.17,0.0,Phase3-EA-T1v2-EURJPY-M15-322,EURJPYMT4,1640,11h 59m,Buy
117197.06,99509,18.07.2013 03:15:00,,-3.66,-503.5199999999022,0.0,0.0,99484,17.07.2013 21:45:00,9432,-0.2424258998217045,-10.44,IS,0.27,0.0,Phase3-EA-S1v2-USDJPY-M15-0,USDJPYMT4,2726,5h 30m,Sell
117217.76,100577,19.07.2013 01:45:00,,-0.78,-482.81999999989057,0.0,0.0,100497,18.07.2013 22:00:00,9433,-0.2324596301078638,20.7,IS,0.27,0.0,Phase3-EA-S1v2-USDJPY-M15-0,USDJPYMT4,2728,3h 45m,Buy
117217.44,131418,19.07.2013 06:30:00,,-0.83,-483.13999999989755,0.0,0.0,131415,18.07.2013 17:15:00,9434,-0.23261369804547236,-0.32,IS,0.17,0.0,Phase3-EA-T1v2-EURJPY-M15-322,EURJPYMT4,1642,13h 15m,Buy
117173.45,1.23631,19.07.2013 14:00:00,,0.0,-527.1299999998882,0.0,0.0,1.23753,19.07.2013 05:15:00,9435,-0.25379322484313005,-43.99,IS,0.34,0.0,Phase3-EA-S4v1-EURCHF-M15-221,EURCHFMT4,2440,8h 45m,Buy
117134.43,131757,19.07.2013 17:44:58,sl 131.757,0.0,-566.1499999998778,0.0,0.0,131527,19.07.2013 17:15:00,9436,-0.27257988398485666,-39.02,IS,0.17,0.0,Phase3-EA-T1v2-EURJPY-M15-322,EURJPYMT4,1644,29m 58s,Sell
117036.13,0.93929,22.07.2013 02:45:00,,-0.74,-664.4499999998661,0.0,0.0,0.94087,19.07.2013 22:30:00,9437,-0.31990762856794247,-98.3,IS,0.58,0.0,Phase3-EA-SA2v2-USDCHF-M15-107,USDCHFMT4,1822,2d 4h 15m,Buy
117125.49,152818,22.07.2013 03:04:57,tp 152.818,0.0,-575.0899999998801,0.0,0.0,153208,22.07.2013 01:00:00,9438,-0.27688415699170255,89.36,IS,0.23,0.0,Phase3-EA-S4v1-GBPJPY-M5-194,GBPJPYMT4,2216,2h 4m,Sell
117215.25,153089,22.07.2013 04:04:57,tp 153.089,0.0,-485.3299999998708,0.0,0.0,152699,22.07.2013 03:25:00,9439,-0.2336681004934449,89.76,IS,0.23,0.0,Phase3-EA-S4v1-GBPJPY-M5-194,GBPJPYMT4,2218,39m 57s,Buy
117235.33,1.23568,22.07.2013 04:20:00,,-2.18,-465.2499999998836,0.0,0.0,1.23619,19.07.2013 20:00:00,9440,-0.224000337408726,20.08,IS,0.41,0.0,Phase3-EA-SA2v2-EURCHF-M5-43,EURCHFMT4,4884,2d 8h 20m,Sell
117264.32,1.2366,22.07.2013 13:00:00,,0.0,-436.2599999998929,0.0,0.0,1.2358,22.07.2013 04:15:00,9441,-0.21004274518631114,28.99,IS,0.34,0.0,Phase3-EA-S4v1-EURCHF-M15-221,EURCHFMT4,2442,8h 45m,Buy
117354.48,152.61,23.07.2013 02:14:58,tp 152.610,0.0,-346.0999999998894,0.0,0.0,153.0,23.07.2013 00:15:00,9442,-0.16663410376604984,90.16,IS,0.23,0.0,Phase3-EA-S4v1-GBPJPY-M5-194,GBPJPYMT4,2220,1h 59m,Sell
117430.76,99293,23.07.2013 02:15:00,,-1.22,-269.81999999989057,0.0,0.0,99578,22.07.2013 22:00:00,9443,-0.1299081591394155,76.28,IS,0.27,0.0,Phase3-EA-S1v2-USDJPY-M15-0,USDJPYMT4,2730,4h 15m,Sell
117520.86,152992,23.07.2013 04:54:57,tp 152.992,0.0,-179.71999999988475,0.0,0.0,152602,23.07.2013 02:20:00,9444,-0.08652840545745404,90.1,IS,0.23,0.0,Phase3-EA-S4v1-GBPJPY-M5-194,GBPJPYMT4,2222,2h 34m,Buy
117556.77,1.2352,23.07.2013 08:45:00,,0.0,-143.80999999988126,0.0,0.0,1.23438,23.07.2013 00:25:00,9445,-0.06923909408432101,35.91,IS,0.41,0.0,Phase3-EA-SA2v2-EURCHF-M5-43,EURCHFMT4,4886,8h 20m,Buy
117467.03,1.23719,23.07.2013 12:45:00,,0.0,-233.54999999987194,0.0,0.0,1.23471,23.07.2013 04:00:00,9446,-0.11244552133646935,-89.74,IS,0.34,0.0,Phase3-EA-S4v1-EURCHF-M15-221,EURCHFMT4,2444,8h 45m,Sell
117427.3,131.8,23.07.2013 14:29:58,sl 131.800,-0.6,-273.2799999998824,0.0,0.0,131.57,22.07.2013 16:00:00,9447,-0.1315740187147676,-39.73,IS,0.17,0.0,Phase3-EA-T1v2-EURJPY-M15-322,EURJPYMT4,1646,22h 29m,Sell
117321.24,99512,24.07.2013 03:00:00,,-0.79,-379.3399999998801,0.0,0.0,99.9,23.07.2013 17:15:00,9448,-0.1826379107847835,-106.06,IS,0.27,0.0,Phase3-EA-S1v2-USDJPY-M15-0,USDJPYMT4,2732,9h 45m,Buy
117268.88,1.23575,24.07.2013 04:35:00,,-1.05,-431.6999999998661,0.0,0.0,1.23692,23.07.2013 20:15:00,9449,-0.20784727707542444,-52.36,IS,0.41,0.0,Phase3-EA-SA2v2-EURCHF-M5-43,EURCHFMT4,4888,8h 20m,Buy
117330.86,0.93577,24.07.2013 04:59:58,tp 0.93577,0.0,-369.71999999985565,0.0,0.0,0.93477,24.07.2013 02:45:00,9450,-0.178006243410516,61.98,IS,0.58,0.0,Phase3-EA-SA2v2-USDCHF-M15-107,USDCHFMT4,1824,2h 14m,Buy
117342.84,1.23641,24.07.2013 09:45:00,,0.0,-357.73999999984517,0.0,0.0,1.23608,24.07.2013 01:00:00,9451,-0.172238324996417,11.98,IS,0.34,0.0,Phase3-EA-S4v1-EURCHF-M15-221,EURCHFMT4,2446,8h 45m,Buy
117271.53,132375,24.07.2013 10:59:58,sl 132.375,-0.95,-429.04999999984284,0.0,0.0,131595,19.07.2013 05:00:00,9452,-0.20657140196712032,-71.31,IS,0.09,0.0,Phase3-EA-TR1v1-EURJPY-M30-91,EURJPYMT4,1648,5d 5h 59m,Sell
117436.82,153686,24.07.2013 11:59:58,tp 153.686,-1.3,-263.7599999998347,0.0,0.0,151836,18.07.2013 07:00:00,9453,-0.12699049757099048,165.29,IS,0.09,0.0,Phase3-EA-B1v1-GBPJPY-M30-1,GBPJPYMT4,896,6d 4h 59m,Buy
117486.9,100276,24.07.2013 20:00:00,,0.0,-213.6799999998475,0.0,0.0,100.09,24.07.2013 17:30:00,9454,-0.10287886533578589,50.08,IS,0.27,0.0,Phase3-EA-S1v2-USDJPY-M15-0,USDJPYMT4,2734,2h 30m,Buy
117500.71,100324,25.07.2013 01:30:00,,-2.34,-199.86999999984982,0.0,0.0,100264,24.07.2013 21:30:00,9455,-0.09622987090351344,13.81,IS,0.27,0.0,Phase3-EA-S1v2-USDJPY-M15-0,USDJPYMT4,2736,4h 0m,Buy
117494.94,1.23714,25.07.2013 04:40:00,,-3.15,-205.63999999983935,0.0,0.0,1.2372,24.07.2013 20:20:00,9456,-0.0990079084034518,-5.77,IS,0.41,0.0,Phase3-EA-SA2v2-EURCHF-M5-43,EURCHFMT4,4890,8h 20m,Buy
117584.55,153297,25.07.2013 04:44:57,tp 153.297,0.0,-116.02999999985332,0.0,0.0,153687,25.07.2013 01:25:00,9457,-0.05586407125095781,89.61,IS,0.23,0.0,Phase3-EA-S4v1-GBPJPY-M5-194,GBPJPYMT4,2224,3h 19m,Sell
117518.44,131745,25.07.2013 12:29:57,sl 131.745,-1.32,-182.13999999983935,0.0,0.0,132465,24.07.2013 13:00:00,9458,-0.08769354423557135,-66.11,IS,0.09,0.0,Phase3-EA-TR1v1-EURJPY-M30-91,EURJPYMT4,1650,23h 29m,Buy
117478.45,131879,26.07.2013 00:29:58,sl 131.879,-0.6,-222.12999999983003,0.0,0.0,131649,25.07.2013 23:15:00,9459,-0.10694722181316428,-39.99,IS,0.17,0.0,Phase3-EA-T1v2-EURJPY-M15-322,EURJPYMT4,1648,1h 14m,Sell
117540.05,0.93028,26.07.2013 03:29:58,tp 0.93028,-0.75,-160.5299999998242,0.0,0.0,0.92928,25.07.2013 23:30:00,9460,-0.07728914382416423,61.6,IS,0.58,0.0,Phase3-EA-SA2v2-USDCHF-M15-107,USDCHFMT4,1826,3h 59m,Buy
117524.86,1.23383,26.07.2013 05:55:00,,-1.06,-175.71999999982654,0.0,0.0,1.23415,25.07.2013 21:35:00,9461,-0.08460255623736126,-15.19,IS,0.41,0.0,Phase3-EA-SA2v2-EURCHF-M5-43,EURCHFMT4,4892,8h 20m,Buy
117453.45,131097,26.07.2013 06:59:58,sl 131.097,-0.44,-247.12999999983003,0.0,0.0,131877,25.07.2013 16:30:00,9462,-0.11898377943856901,-71.41,IS,0.09,0.0,Phase3-EA-TR1v1-EURJPY-M30-91,EURJPYMT4,1652,14h 29m,Buy
117500.97,1.23328,29.07.2013 01:04:57,tp 1.23328,-1.06,-199.6099999998405,0.0,0.0,1.23218,26.07.2013 21:05:00,9463,-0.09610469070420474,47.52,IS,0.41,0.0,Phase3-EA-SA2v2-EURCHF-M5-43,EURCHFMT4,4894,2d 3h 59m,Buy
117538.28,98048,29.07.2013 01:45:00,,-1.24,-162.29999999984284,0.0,0.0,98188,26.07.2013 22:00:00,9464,-0.07814133210405184,37.31,IS,0.27,0.0,Phase3-EA-S1v2-USDJPY-M15-0,USDJPYMT4,2738,2d 3h 45m,Sell
117629.72,151077,29.07.2013 03:34:58,tp 151.077,0.0,-70.85999999984051,0.0,0.0,150687,29.07.2013 02:35:00,9465,-0.034116418933370384,91.44,IS,0.23,0.0,Phase3-EA-S4v1-GBPJPY-M5-194,GBPJPYMT4,2226,59m 58s,Buy
117616.79,97917,30.07.2013 01:00:00,,-0.8,-83.78999999983353,0.0,0.0,97961,29.07.2013 20:15:00,9466,-0.04034172653722635,-12.93,IS,0.27,0.0,Phase3-EA-S1v2-USDJPY-M15-0,USDJPYMT4,2740,4h 45m,Buy
117576.3,130143,30.07.2013 03:14:58,sl 130.143,-0.61,-124.27999999982421,0.0,0.0,129913,29.07.2013 13:15:00,9467,-0.05983613526732736,-40.49,IS,0.17,0.0,Phase3-EA-T1v2-EURJPY-M15-322,EURJPYMT4,1650,13h 59m,Sell
117623.62,1.23528,30.07.2013 06:34:58,tp 1.23528,-1.06,-76.95999999981723,0.0,0.0,1.23418,29.07.2013 22:20:00,9468,-0.03705333899395793,47.32,IS,0.41,0.0,Phase3-EA-SA2v2-EURCHF-M5-43,EURCHFMT4,4896,8h 14m,Buy
117648.48,1.2341,30.07.2013 12:30:00,,0.0,-52.0999999998312,0.0,0.0,1.23478,30.07.2013 03:45:00,9469,-0.025084186091262187,24.86,IS,0.34,0.0,Phase3-EA-S4v1-EURCHF-M15-221,EURCHFMT4,2448,8h 45m,Sell
117817.31,149873,30.07.2013 14:29:57,tp 149.873,-1.06,-0.0,0.0,0.0,151723,26.07.2013 11:30:00,9470,-0.0,168.83,IS,0.09,0.0,Phase3-EA-B1v1-GBPJPY-M30-1,GBPJPYMT4,898,4d 2h 59m,Sell
117821.74,98068,31.07.2013 00:30:00,,-0.8,-0.0,0.0,0.0,98049,30.07.2013 21:45:00,9471,-0.0,4.43,IS,0.27,0.0,Phase3-EA-S1v2-USDJPY-M15-0,USDJPYMT4,2742,2h 45m,Buy
117808.33,1.23243,31.07.2013 05:00:00,,-1.06,-13.410000000003492,0.0,0.0,1.23271,30.07.2013 20:40:00,9472,-0.006452645425836298,-13.41,IS,0.41,0.0,Phase3-EA-SA2v2-EURCHF-M5-43,EURCHFMT4,4898,8h 20m,Buy
117870.76,0.92907,31.07.2013 05:14:58,tp 0.92907,0.0,-0.0,0.0,0.0,0.93007,31.07.2013 02:30:00,9473,-0.0,62.43,IS,0.58,0.0,Phase3-EA-SA2v2-USDCHF-M15-107,USDCHFMT4,1828,2h 44m,Sell
117830.89,130088,31.07.2013 06:29:58,sl 130.088,0.0,-39.86999999999534,0.0,0.0,129858,31.07.2013 03:15:00,9474,-0.019180186766044,-39.87,IS,0.17,0.0,Phase3-EA-T1v2-EURJPY-M15-322,EURJPYMT4,1652,3h 14m,Sell
117945.98,129502,31.07.2013 13:29:58,tp 129.502,-0.96,-0.0,0.0,0.0,130762,26.07.2013 14:00:00,9475,-0.0,115.09,IS,0.09,0.0,Phase3-EA-TR1v1-EURJPY-M30-91,EURJPYMT4,1654,4d 23h 29m,Sell
117896.2,1.23114,31.07.2013 14:15:00,,0.0,-49.779999999998836,0.0,0.0,1.2325,31.07.2013 05:30:00,9476,-0.02393890951871179,-49.78,IS,0.34,0.0,Phase3-EA-S4v1-EURCHF-M15-221,EURCHFMT4,2450,8h 45m,Buy
117946.42,98381,31.07.2013 21:15:00,,0.0,-0.0,0.0,0.0,98198,31.07.2013 21:00:00,9477,-0.0,50.22,IS,0.27,0.0,Phase3-EA-S1v2-USDJPY-M15-0,USDJPYMT4,2744,15m 0s,Buy
117854.72,98.05,31.07.2013 21:30:00,,0.0,-91.70000000001164,0.0,0.0,98383,31.07.2013 21:15:00,9478,-0.0440978979104382,-91.7,IS,0.27,0.0,Phase3-EA-S1v2-USDJPY-M15-0,USDJPYMT4,2746,15m 0s,Buy
117945.31,98052,31.07.2013 21:30:00,,0.0,-1.110000000015134,0.0,0.0,98381,31.07.2013 21:15:00,9479,-5.337913487595154E-4,90.59,IS,0.27,0.0,Phase3-EA-S1v2-USDJPY-M15-0,USDJPYMT4,2747,15m 0s,Sell
117983.09,97913,31.07.2013 21:45:00,,0.0,-0.0,0.0,0.0,98052,31.07.2013 21:30:00,9480,-0.0,37.78,IS,0.27,0.0,Phase3-EA-S1v2-USDJPY-M15-0,USDJPYMT4,2750,15m 0s,Buy
118045.72,0.92612,31.07.2013 22:44:58,tp 0.92612,0.0,-0.0,0.0,0.0,0.92512,31.07.2013 22:15:00,9481,-0.0,62.63,IS,0.58,0.0,Phase3-EA-SA2v2-USDCHF-M15-107,USDCHFMT4,1830,29m 58s,Buy
117994.22,97874,01.08.2013 04:15:00,,-2.4,-51.5,0.0,0.0,98.05,31.07.2013 21:30:00,9482,-0.02475417422670347,-51.5,IS,0.27,0.0,Phase3-EA-S1v2-USDJPY-M15-0,USDJPYMT4,2751,6h 45m,Sell
117937.46,1.23169,01.08.2013 04:35:00,,-3.19,-108.26000000000931,0.0,0.0,1.2329,31.07.2013 20:15:00,9483,-0.05203663886957569,-56.76,IS,0.41,0.0,Phase3-EA-SA2v2-EURCHF-M5-43,EURCHFMT4,4900,8h 20m,Buy
118007.23,148982,01.08.2013 06:00:00,,0.0,-38.49000000001979,0.0,0.0,148684,01.08.2013 00:35:00,9484,-0.018500741087112745,69.77,IS,0.23,0.0,Phase3-EA-S4v1-GBPJPY-M5-194,GBPJPYMT4,2228,5h 25m,Buy
117944.52,149753,01.08.2013 11:29:58,sl 149.753,-1.6,-101.20000000001164,0.0,0.0,149083,31.07.2013 09:00:00,9485,-0.04864315401442096,-62.71,IS,0.09,0.0,Phase3-EA-B1v1-GBPJPY-M30-1,GBPJPYMT4,900,1d 2h 29m,Sell
117889.43,1.23786,02.08.2013 04:35:00,,-2.19,-156.29000000000815,0.0,0.0,1.23665,01.08.2013 20:15:00,9486,-0.07512291048333374,-55.09,IS,0.41,0.0,Phase3-EA-SA2v2-EURCHF-M5-43,EURCHFMT4,4902,8h 20m,Sell
117873.83,1.23823,02.08.2013 13:30:00,,0.0,-171.89000000001397,0.0,0.0,1.2378,02.08.2013 04:45:00,9487,-0.0826212622879302,-15.6,IS,0.34,0.0,Phase3-EA-S4v1-EURCHF-M15-221,EURCHFMT4,2452,8h 45m,Sell
117834.3,131244,02.08.2013 15:44:58,sl 131.244,0.0,-211.4200000000128,0.0,0.0,131474,02.08.2013 08:30:00,9488,-0.10162189349533912,-39.53,IS,0.17,0.0,Phase3-EA-T1v2-EURJPY-M15-322,EURJPYMT4,1654,7h 14m,Buy
117882.84,1.23396,02.08.2013 22:04:58,tp 1.23396,0.0,-162.88000000000466,0.0,0.0,1.23286,02.08.2013 20:30:00,9489,-0.07829048345719566,48.54,IS,0.41,0.0,Phase3-EA-SA2v2-EURCHF-M5-43,EURCHFMT4,4904,1h 34m,Buy
117882.7,98933,05.08.2013 03:15:00,,-1.23,-163.02000000001863,0.0,0.0,98937,02.08.2013 23:45:00,9490,-0.07835777635801283,-0.14,IS,0.27,0.0,Phase3-EA-S1v2-USDJPY-M15-0,USDJPYMT4,2754,2d 3h 30m,Sell
117920.64,151279,05.08.2013 04:25:00,,-0.84,-125.0800000000163,0.0,0.0,151112,02.08.2013 23:00:00,9491,-0.06012140023837813,37.94,IS,0.23,0.0,Phase3-EA-S4v1-GBPJPY-M5-194,GBPJPYMT4,2230,2d 5h 25m,Buy
117910.05,1.23419,05.08.2013 06:30:00,,-2.21,-135.6700000000128,0.0,0.0,1234,02.08.2013 22:10:00,9492,-0.06521162752111023,-10.59,IS,0.41,0.0,Phase3-EA-SA2v2-EURCHF-M5-43,EURCHFMT4,4906,2d 8h 20m,Sell
117957.12,98669,05.08.2013 20:00:00,,0.0,-88.60000000000582,0.0,0.0,98497,05.08.2013 19:30:00,9493,-0.04258679294147712,47.07,IS,0.27,0.0,Phase3-EA-S1v2-USDJPY-M15-0,USDJPYMT4,2756,30m 0s,Buy
118019.7,0.92684,06.08.2013 03:14:58,tp 0.92684,0.0,-26.020000000018626,0.0,0.0,0.92784,06.08.2013 02:45:00,9494,-0.012506866279209425,62.58,IS,0.58,0.0,Phase3-EA-SA2v2-USDCHF-M15-107,USDCHFMT4,1832,29m 58s,Sell
118137.19,130108,06.08.2013 03:29:58,tp 130.108,-0.64,-0.0,0.0,0.0,131398,02.08.2013 04:00:00,9495,-0.0,117.49,IS,0.09,0.0,Phase3-EA-TR1v1-EURJPY-M30-91,EURJPYMT4,1656,3d 23h 29m,Sell
117918.91,1.22693,06.08.2013 03:49:57,sl 1.22693,-1.06,-218.27999999999884,0.0,0.0,1.23183,05.08.2013 20:00:00,9496,-0.10487313679981816,-218.28,IS,0.41,0.0,Phase3-EA-SA2v2-EURCHF-M5-43,EURCHFMT4,4908,7h 49m,Buy
117980.16,150856,06.08.2013 08:50:00,,0.0,-157.02999999999884,0.0,0.0,150594,06.08.2013 03:25:00,9497,-0.07544543096791008,61.25,IS,0.23,0.0,Phase3-EA-S4v1-GBPJPY-M5-194,GBPJPYMT4,2232,5h 25m,Buy
118047.62,1.23125,06.08.2013 12:15:00,,0.0,-89.57000000000698,0.0,0.0,1.22941,06.08.2013 03:30:00,9498,-0.04303411610390551,67.46,IS,0.34,0.0,Phase3-EA-S4v1-EURCHF-M15-221,EURCHFMT4,2454,8h 45m,Buy
118108.54,97951,06.08.2013 17:15:00,,0.0,-28.64999999999418,0.0,0.0,98172,06.08.2013 17:00:00,9499,-0.013764959544228494,60.92,IS,0.27,0.0,Phase3-EA-S1v2-USDJPY-M15-0,USDJPYMT4,2758,15m 0s,Sell
118144.7,97818,06.08.2013 17:30:00,,0.0,-0.0,0.0,0.0,97949,06.08.2013 17:15:00,9500,-0.0,36.16,IS,0.27,0.0,Phase3-EA-S1v2-USDJPY-M15-0,USDJPYMT4,2760,15m 0s,Sell
118439.21,129624,07.08.2013 02:14:58,tp 129.624,-1.22,-0.0,0.0,0.0,131324,05.08.2013 05:15:00,9501,-0.0,294.51,IS,0.17,0.0,Phase3-EA-T1v2-EURJPY-M15-322,EURJPYMT4,1656,1d 20h 59m,Sell
118548.95,97314,07.08.2013 02:14:58,tp 97.314,-1.24,-0.0,0.0,0.0,97714,06.08.2013 23:00:00,9502,-0.0,109.74,IS,0.27,0.0,Phase3-EA-S1v2-USDJPY-M15-0,USDJPYMT4,2762,3h 14m,Sell
118595.5,1.23093,07.08.2013 02:19:57,tp 1.23093,-2.21,-0.0,0.0,0.0,1.23203,06.08.2013 22:25:00,9503,-0.0,46.55,IS,0.41,0.0,Phase3-EA-SA2v2-EURCHF-M5-43,EURCHFMT4,4910,3h 54m,Sell
118532.48,149673,07.08.2013 02:29:58,sl 149.673,-1.32,-63.01999999998952,0.0,0.0,150343,01.08.2013 14:30:00,9504,-0.03021158174552621,-63.02,IS,0.09,0.0,Phase3-EA-B1v1-GBPJPY-M30-1,GBPJPYMT4,902,5d 11h 59m,Buy
118595.16,0.92533,07.08.2013 03:14:58,tp 0.92533,0.0,-0.33999999999650754,0.0,0.0,0.92433,07.08.2013 02:30:00,9505,-1.6299488723222954E-4,62.68,IS,0.58,0.0,Phase3-EA-SA2v2-USDCHF-M15-107,USDCHFMT4,1834,44m 58s,Buy
118516.66,149097,07.08.2013 08:00:00,,0.0,-78.83999999999651,0.0,0.0,149429,07.08.2013 02:35:00,9506,-0.037795637969177676,-78.5,IS,0.23,0.0,Phase3-EA-S4v1-GBPJPY-M5-194,GBPJPYMT4,2234,5h 25m,Buy
118633.06,129023,07.08.2013 09:59:58,tp 129.023,-0.32,-0.0,0.0,0.0,130283,06.08.2013 02:00:00,9507,-0.0,116.4,IS,0.09,0.0,Phase3-EA-TR1v1-EURJPY-M30-91,EURJPYMT4,1657,1d 7h 59m,Sell
118681.79,1.23212,07.08.2013 09:59:58,tp 1.23212,0.0,-0.0,0.0,0.0,1.23102,07.08.2013 02:25:00,9508,-0.0,48.73,IS,0.41,0.0,Phase3-EA-SA2v2-EURCHF-M5-43,EURCHFMT4,4912,7h 34m,Buy
118720.26,1.23218,07.08.2013 11:45:00,,0.0,-0.0,0.0,0.0,1.23113,07.08.2013 03:00:00,9509,-0.0,38.47,IS,0.34,0.0,Phase3-EA-S4v1-EURCHF-M15-221,EURCHFMT4,2456,8h 45m,Buy
118677.2,1.52782,07.08.2013 12:59:57,sl 1.52782,-1.06,-43.05999999999767,0.0,0.0,1.53082,05.08.2013 10:30:00,9510,-0.02063048407471196,-43.06,IS,0.14,0.0,Phase3-EA-B1v1-GBPUSD-M30-14,GBPUSDMT4,606,2d 2h 29m,Buy
118615.02,149446,07.08.2013 13:29:58,sl 149.446,0.0,-105.23999999999069,0.0,0.0,148776,07.08.2013 09:00:00,9511,-0.050421554668430374,-62.18,IS,0.09,0.0,Phase3-EA-B1v1-GBPJPY-M30-1,GBPJPYMT4,904,4h 29m,Sell
118542.42,128622,07.08.2013 17:29:57,sl 128.622,0.0,-177.8399999999965,0.0,0.0,129402,07.08.2013 13:30:00,9512,-0.08520495327094522,-72.6,IS,0.09,0.0,Phase3-EA-TR1v1-EURJPY-M30-91,EURJPYMT4,1660,3h 59m,Buy
118591.35,1.22957,07.08.2013 22:59:57,tp 1.22957,0.0,-128.9100000000035,0.0,0.0,1.22847,07.08.2013 20:35:00,9513,-0.06176209247727205,48.93,IS,0.41,0.0,Phase3-EA-SA2v2-EURCHF-M5-43,EURCHFMT4,4914,2h 24m,Buy
118549.11,129065,08.08.2013 03:29:58,sl 129.065,-1.85,-171.14999999999418,0.0,0.0,128835,07.08.2013 16:15:00,9514,-0.08199970620963824,-42.24,IS,0.17,0.0,Phase3-EA-T1v2-EURJPY-M15-322,EURJPYMT4,1658,11h 14m,Sell
118598.03,1.22995,08.08.2013 04:04:58,tp 1.22995,0.0,-122.22999999998137,0.0,0.0,1.22885,08.08.2013 01:10:00,9515,-0.05856163651769148,48.92,IS,0.41,0.0,Phase3-EA-SA2v2-EURCHF-M5-43,EURCHFMT4,4916,2h 54m,Buy
118690.87,149455,08.08.2013 06:04:57,tp 149.455,0.0,-29.389999999984866,0.0,0.0,149845,08.08.2013 03:30:00,9516,-0.014081048001753485,92.84,IS,0.23,0.0,Phase3-EA-S4v1-GBPJPY-M5-194,GBPJPYMT4,2236,2h 34m,Sell
118663.74,96537,08.08.2013 08:30:00,,0.0,-56.51999999998952,0.0,0.0,96.44,08.08.2013 01:45:00,9517,-0.02707930701120685,-27.13,IS,0.27,0.0,Phase3-EA-S1v2-USDJPY-M15-0,USDJPYMT4,2764,6h 45m,Sell
118623.11,128633,08.08.2013 10:29:57,sl 128.633,0.0,-97.14999999999418,0.0,0.0,128403,08.08.2013 09:00:00,9518,-0.046545553364102536,-40.63,IS,0.17,0.0,Phase3-EA-T1v2-EURJPY-M15-322,EURJPYMT4,1660,1h 29m,Sell
118608.34,1.23001,08.08.2013 12:30:00,,0.0,-111.9199999999837,0.0,0.0,1.22961,08.08.2013 03:45:00,9519,-0.053622010627997006,-14.77,IS,0.34,0.0,Phase3-EA-S4v1-EURCHF-M15-221,EURCHFMT4,2458,8h 45m,Sell
118657.23,1.22998,09.08.2013 22:04:58,tp 1.22998,0.0,-63.02999999996973,0.0,0.0,1.23108,09.08.2013 20:45:00,9520,-0.030198314241257334,48.89,IS,0.41,0.0,Phase3-EA-SA2v2-EURCHF-M5-43,EURCHFMT4,4918,1h 19m,Sell
118716.46,96186,09.08.2013 22:30:00,,0.0,-3.7999999999592546,0.0,0.0,96397,09.08.2013 19:30:00,9521,-0.0018206186596160959,59.23,IS,0.27,0.0,Phase3-EA-S1v2-USDJPY-M15-0,USDJPYMT4,2766,3h 0m,Sell
118652.22,148859,12.08.2013 02:59:58,sl 148.859,-1.69,-68.03999999994994,0.0,0.0,149529,07.08.2013 13:30:00,9522,-0.032598656210925336,-64.24,IS,0.09,0.0,Phase3-EA-B1v1-GBPJPY-M30-1,GBPJPYMT4,906,4d 13h 29m,Buy
118578.48,128005,12.08.2013 02:59:58,sl 128.005,-0.92,-141.77999999994063,0.0,0.0,128785,08.08.2013 02:30:00,9523,-0.06792824041132361,-73.74,IS,0.09,0.0,Phase3-EA-TR1v1-EURJPY-M30-91,EURJPYMT4,1662,4d 0h 29m,Buy
118584.01,0.92211,12.08.2013 03:00:00,,-0.76,-136.2499999999418,0.0,0.0,0.92201,09.08.2013 22:45:00,9524,-0.06527876115138076,5.53,IS,0.58,0.0,Phase3-EA-SA2v2-USDCHF-M15-107,USDCHFMT4,1836,2d 4h 15m,Buy
118352.64,97382,13.08.2013 03:29:58,sl 97.382,-1.25,-367.61999999993714,0.0,0.0,96552,12.08.2013 21:30:00,9525,-0.17613048201450823,-231.37,IS,0.27,0.0,Phase3-EA-S1v2-USDJPY-M15-0,USDJPYMT4,2768,5h 59m,Sell
118400.23,1.2319,13.08.2013 03:34:59,tp 1.23190,-1.06,-320.0299999999406,0.0,0.0,1.2308,12.08.2013 20:00:00,9526,-0.15332962885344173,47.59,IS,0.41,0.0,Phase3-EA-SA2v2-EURCHF-M5-43,EURCHFMT4,4920,7h 34m,Buy
118299.2,150221,13.08.2013 05:10:00,,-1.38,-421.05999999993946,0.0,0.0,149.8,12.08.2013 23:45:00,9527,-0.2017341296910692,-101.03,IS,0.23,0.0,Phase3-EA-S4v1-GBPJPY-M5-194,GBPJPYMT4,2238,5h 25m,Sell
118315.48,0.92609,13.08.2013 06:00:00,,0.0,-404.7799999999406,0.0,0.0,0.92635,13.08.2013 01:45:00,9528,-0.19393421606505187,16.28,IS,0.58,0.0,Phase3-EA-SA2v2-USDCHF-M15-107,USDCHFMT4,1838,4h 15m,Sell
118246.96,1.2333,13.08.2013 10:30:00,,0.0,-473.29999999993015,0.0,0.0,1.23143,13.08.2013 01:45:00,9529,-0.22676284515931858,-68.52,IS,0.34,0.0,Phase3-EA-S4v1-EURCHF-M15-221,EURCHFMT4,2460,8h 45m,Sell
118365.41,129944,13.08.2013 10:59:58,tp 129.944,-0.46,-354.8499999999185,0.0,0.0,128654,12.08.2013 06:00:00,9530,-0.17001224509777646,118.45,IS,0.09,0.0,Phase3-EA-TR1v1-EURJPY-M30-91,EURJPYMT4,1664,1d 4h 59m,Buy
118659.29,130395,13.08.2013 13:29:58,tp 130.395,-0.86,-60.96999999991385,0.0,0.0,128695,12.08.2013 22:15:00,9531,-0.02921134728363862,293.88,IS,0.17,0.0,Phase3-EA-T1v2-EURJPY-M15-322,EURJPYMT4,1662,15h 14m,Buy
118703.57,98176,13.08.2013 17:45:00,,0.0,-16.689999999915017,0.0,0.0,98015,13.08.2013 17:15:00,9532,-0.007996348797148351,44.28,IS,0.27,0.0,Phase3-EA-S1v2-USDJPY-M15-0,USDJPYMT4,2770,30m 0s,Buy
118707.42,98192,13.08.2013 18:00:00,,0.0,-12.839999999909196,0.0,0.0,98178,13.08.2013 17:45:00,9533,-0.006151774628830529,3.85,IS,0.27,0.0,Phase3-EA-S1v2-USDJPY-M15-0,USDJPYMT4,2772,15m 0s,Buy
118737.39,98214,13.08.2013 20:15:00,,0.0,-0.0,0.0,0.0,98105,13.08.2013 19:15:00,9534,-0.0,29.97,IS,0.27,0.0,Phase3-EA-S1v2-USDJPY-M15-0,USDJPYMT4,2774,1h 0m,Buy
118761.11,1.23711,14.08.2013 04:40:00,,-2.2,-0.0,0.0,0.0,1.2377,13.08.2013 20:20:00,9535,-0.0,23.72,IS,0.41,0.0,Phase3-EA-SA2v2-EURCHF-M5-43,EURCHFMT4,4922,8h 20m,Sell
118733.39,130061,14.08.2013 05:45:00,,-0.85,-27.720000000001164,0.0,0.0,130216,13.08.2013 20:45:00,9536,-0.013278335222494733,-27.72,IS,0.17,0.0,Phase3-EA-T1v2-EURJPY-M15-322,EURJPYMT4,1664,9h 0m,Buy
118848.42,130503,14.08.2013 08:59:57,tp 130.503,-0.45,-0.0,0.0,0.0,129243,13.08.2013 02:30:00,9537,-0.0,115.03,IS,0.09,0.0,Phase3-EA-TR1v1-EURJPY-M30-91,EURJPYMT4,1665,1d 6h 29m,Buy
118808.67,130.34,14.08.2013 10:14:58,sl 130.340,0.0,-39.75,0.0,0.0,130.57,14.08.2013 09:00:00,9538,-0.019032942648069703,-39.75,IS,0.17,0.0,Phase3-EA-T1v2-EURJPY-M15-322,EURJPYMT4,1666,1h 14m,Buy
118977.91,152.49,14.08.2013 16:29:58,tp 152.490,-0.33,-0.0,0.0,0.0,150.64,13.08.2013 08:30:00,9539,-0.0,169.24,IS,0.09,0.0,Phase3-EA-B1v1-GBPJPY-M30-1,GBPJPYMT4,908,1d 7h 59m,Buy
118938.07,130076,14.08.2013 17:14:57,sl 130.076,0.0,-39.83999999999651,0.0,0.0,130306,14.08.2013 16:30:00,9540,-0.01906421592597813,-39.84,IS,0.17,0.0,Phase3-EA-T1v2-EURJPY-M15-322,EURJPYMT4,1668,44m 57s,Buy
119029.54,152378,15.08.2013 04:44:58,tp 152.378,0.0,-0.0,0.0,0.0,151988,15.08.2013 01:05:00,9541,-0.0,91.47,IS,0.23,0.0,Phase3-EA-S4v1-GBPJPY-M5-194,GBPJPYMT4,2240,3h 39m,Buy
119074.59,1.24043,15.08.2013 04:54:58,tp 1.24043,-3.16,-0.0,0.0,0.0,1.23933,14.08.2013 22:10:00,9542,-0.0,45.05,IS,0.41,0.0,Phase3-EA-SA2v2-EURCHF-M5-43,EURCHFMT4,4924,6h 44m,Buy
119136.6,0.93527,15.08.2013 04:59:58,tp 0.93527,0.0,-0.0,0.0,0.0,0.93427,15.08.2013 02:15:00,9543,-0.0,62.01,IS,0.58,0.0,Phase3-EA-SA2v2-USDCHF-M15-107,USDCHFMT4,1840,2h 44m,Buy
119157.74,1.23962,15.08.2013 10:45:00,,0.0,-0.0,0.0,0.0,1.23904,15.08.2013 02:00:00,9544,-0.0,21.14,IS,0.34,0.0,Phase3-EA-S4v1-EURCHF-M15-221,EURCHFMT4,2462,8h 45m,Buy
119117.78,130084,15.08.2013 10:59:58,sl 130.084,0.0,-39.95999999999185,0.0,0.0,129854,15.08.2013 06:30:00,9545,-0.0191051978281997,-39.96,IS,0.17,0.0,Phase3-EA-T1v2-EURJPY-M15-322,EURJPYMT4,1670,4h 29m,Sell
118887.45,97295,15.08.2013 21:14:57,sl 97.295,0.0,-270.28999999997905,0.0,0.0,98125,15.08.2013 17:15:00,9546,-0.1292278258504692,-230.33,IS,0.27,0.0,Phase3-EA-S1v2-USDJPY-M15-0,USDJPYMT4,2776,3h 59m,Buy
118904.08,152225,16.08.2013 04:35:00,,-0.85,-253.6599999999744,0.0,0.0,152151,15.08.2013 23:10:00,9547,-0.12127688891645734,16.63,IS,0.23,0.0,Phase3-EA-S4v1-GBPJPY-M5-194,GBPJPYMT4,2242,5h 25m,Buy
118887.18,0.92654,16.08.2013 06:00:00,,0.0,-270.55999999996857,0.0,0.0,0.92627,16.08.2013 01:45:00,9548,-0.1293569150249791,-16.9,IS,0.58,0.0,Phase3-EA-SA2v2-USDCHF-M15-107,USDCHFMT4,1842,4h 15m,Sell
118930.12,1.23571,16.08.2013 14:15:00,,0.0,-227.61999999996624,0.0,0.0,1.23688,16.08.2013 05:30:00,9549,-0.10882695519657302,42.94,IS,0.34,0.0,Phase3-EA-S4v1-EURCHF-M15-221,EURCHFMT4,2464,8h 45m,Sell
118890.09,130112,16.08.2013 21:14:58,sl 130.112,0.0,-267.6499999999651,0.0,0.0,129882,16.08.2013 20:15:00,9550,-0.1279656205885392,-40.03,IS,0.17,0.0,Phase3-EA-T1v2-EURJPY-M15-322,EURJPYMT4,1672,59m 58s,Sell
118948.13,97745,19.08.2013 02:00:00,,-0.8,-209.60999999995693,0.0,0.0,97532,16.08.2013 22:45:00,9551,-0.10021622914837171,58.04,IS,0.27,0.0,Phase3-EA-S1v2-USDJPY-M15-0,USDJPYMT4,2778,2d 3h 15m,Buy
118996.85,1.2346,19.08.2013 04:54:57,tp 1.23460,0.0,-160.88999999995576,0.0,0.0,1.2357,19.08.2013 02:00:00,9552,-0.07692280476924003,48.72,IS,0.41,0.0,Phase3-EA-SA2v2-EURCHF-M5-43,EURCHFMT4,4926,2h 54m,Sell
119007.49,1.2355,19.08.2013 12:45:00,,0.0,-150.2499999999418,0.0,0.0,1.23579,19.08.2013 04:00:00,9553,-0.0718357350772392,10.64,IS,0.34,0.0,Phase3-EA-S4v1-EURCHF-M15-221,EURCHFMT4,2466,8h 45m,Sell
119030.82,130308,19.08.2013 21:45:00,,0.0,-126.9199999999546,0.0,0.0,130174,19.08.2013 09:45:00,9554,-0.060681474183051386,23.33,IS,0.17,0.0,Phase3-EA-T1v2-EURJPY-M15-322,EURJPYMT4,1674,12h 0m,Buy
119078.53,1.23301,20.08.2013 01:19:57,tp 1.23301,-1.07,-79.20999999996275,0.0,0.0,1.23191,19.08.2013 21:00:00,9555,-0.037870938938220605,47.71,IS,0.41,0.0,Phase3-EA-SA2v2-EURCHF-M5-43,EURCHFMT4,4928,4h 19m,Buy
119048.22,0.92434,20.08.2013 03:45:00,,-3.33,-109.51999999996042,0.0,0.0,0.92391,19.08.2013 23:30:00,9556,-0.052362394047650196,-30.31,IS,0.58,0.0,Phase3-EA-SA2v2-USDCHF-M15-107,USDCHFMT4,1844,4h 15m,Sell
118983.3,97693,20.08.2013 03:45:00,,-0.8,-174.43999999997322,0.0,0.0,97925,19.08.2013 18:15:00,9557,-0.08340116889768079,-64.92,IS,0.27,0.0,Phase3-EA-S1v2-USDJPY-M15-0,USDJPYMT4,2780,9h 30m,Buy
119075.38,152506,20.08.2013 08:09:59,tp 152.506,0.0,-82.35999999998603,0.0,0.0,152896,20.08.2013 03:55:00,9558,-0.039376979307572106,92.08,IS,0.23,0.0,Phase3-EA-S4v1-GBPJPY-M5-194,GBPJPYMT4,2244,4h 14m,Sell
119124.28,1.23184,20.08.2013 08:29:59,tp 1.23184,0.0,-33.45999999999185,0.0,0.0,1.23294,20.08.2013 01:40:00,9559,-0.015997495478767186,48.9,IS,0.41,0.0,Phase3-EA-SA2v2-EURCHF-M5-43,EURCHFMT4,4930,6h 49m,Sell
119093.25,1.23151,20.08.2013 15:00:00,,0.0,-64.48999999999069,0.0,0.0,1.23235,20.08.2013 06:15:00,9560,-0.030833188386903708,-31.03,IS,0.34,0.0,Phase3-EA-S4v1-EURCHF-M15-221,EURCHFMT4,2468,8h 45m,Buy
119093.75,0.91733,21.08.2013 02:30:00,,-0.76,-63.98999999999069,0.0,0.0,0.91731,20.08.2013 22:15:00,9561,-0.030594134360024283,0.5,IS,0.58,0.0,Phase3-EA-SA2v2-USDCHF-M15-107,USDCHFMT4,1846,4h 15m,Buy
119026.82,130871,21.08.2013 03:29:58,sl 130.871,-0.32,-130.9199999999837,0.0,0.0,130332,19.08.2013 21:00:00,9562,-0.0625939063981007,-66.93,IS,0.09,0.0,Phase3-EA-TR1v1-EURJPY-M30-91,EURJPYMT4,1668,1d 6h 29m,Sell
118965.79,1.23033,21.08.2013 04:55:00,,-1.07,-191.94999999998254,0.0,0.0,1.23167,20.08.2013 20:35:00,9563,-0.09177284091900267,-61.03,IS,0.41,0.0,Phase3-EA-SA2v2-EURCHF-M5-43,EURCHFMT4,4932,8h 20m,Buy
118953.4,130.75,21.08.2013 08:15:00,,0.0,-204.3399999999965,0.0,0.0,130821,21.08.2013 08:00:00,9564,-0.09769659970508149,-12.39,IS,0.17,0.0,Phase3-EA-T1v2-EURJPY-M15-322,EURJPYMT4,1676,15m 0s,Buy
118962.28,1231,21.08.2013 12:45:00,,0.0,-195.45999999999185,0.0,0.0,1.23124,21.08.2013 04:00:00,9565,-0.0934510001877007,8.88,IS,0.34,0.0,Phase3-EA-S4v1-EURCHF-M15-221,EURCHFMT4,2470,8h 45m,Sell
119011.16,1.23184,21.08.2013 21:09:57,tp 1.23184,0.0,-146.5799999999872,0.0,0.0,1.23074,21.08.2013 20:45:00,9566,-0.07008107851996594,48.88,IS,0.41,0.0,Phase3-EA-SA2v2-EURCHF-M5-43,EURCHFMT4,4934,24m 57s,Buy
119273.64,1.57102,21.08.2013 21:29:57,tp 1.57102,-2.12,-0.0,0.0,0.0,1.55212,15.08.2013 03:30:00,9567,-0.0,262.48,IS,0.14,0.0,Phase3-EA-B1v1-GBPUSD-M30-14,GBPUSDMT4,608,6d 17h 59m,Buy
119322.53,1.23163,21.08.2013 23:09:58,tp 1.23163,0.0,-0.0,0.0,0.0,1.23273,21.08.2013 21:40:00,9568,-0.0,48.89,IS,0.41,0.0,Phase3-EA-SA2v2-EURCHF-M5-43,EURCHFMT4,4936,1h 29m,Sell
119259.82,152.76,22.08.2013 01:29:58,sl 152.760,-1.0,-62.70999999999185,0.0,0.0,153.43,21.08.2013 22:00:00,9569,-0.029958552478795003,-62.71,IS,0.09,0.0,Phase3-EA-B1v1-GBPJPY-M30-1,GBPJPYMT4,910,3h 29m,Buy
119351.28,153.27,22.08.2013 04:49:57,tp 153.270,0.0,-0.0,0.0,0.0,152.88,22.08.2013 00:15:00,9570,-0.0,91.46,IS,0.23,0.0,Phase3-EA-S4v1-GBPJPY-M5-194,GBPJPYMT4,2246,4h 34m,Buy
119277.95,131112,22.08.2013 04:59:58,sl 131.112,-1.61,-73.3299999999872,0.0,0.0,130151,20.08.2013 00:30:00,9571,-0.035027251803756196,-73.33,IS,0.09,0.0,Phase3-EA-TR1v1-EURJPY-M30-91,EURJPYMT4,1669,2d 4h 29m,Sell
119200.27,1.2348,22.08.2013 14:45:00,,0.0,-151.0099999999802,0.0,0.0,1.23268,22.08.2013 06:00:00,9572,-0.07213235094620829,-77.68,IS,0.34,0.0,Phase3-EA-S4v1-EURCHF-M15-221,EURCHFMT4,2472,8h 45m,Sell
119254.96,98744,22.08.2013 17:45:00,,0.0,-96.31999999997788,0.0,0.0,98544,22.08.2013 17:00:00,9573,-0.046008794405258575,54.69,IS,0.27,0.0,Phase3-EA-S1v2-USDJPY-M15-0,USDJPYMT4,2782,45m 0s,Buy
119276.85,98684,22.08.2013 20:45:00,,0.0,-74.42999999996391,0.0,0.0,98604,22.08.2013 18:00:00,9574,-0.035552684464104256,21.89,IS,0.27,0.0,Phase3-EA-S1v2-USDJPY-M15-0,USDJPYMT4,2784,2h 45m,Buy
119324.61,1.23403,23.08.2013 04:34:59,tp 1.23403,-1.07,-26.669999999954598,0.0,0.0,1.23293,22.08.2013 23:55:00,9575,-0.012739353683414027,47.76,IS,0.41,0.0,Phase3-EA-SA2v2-EURCHF-M5-43,EURCHFMT4,4938,4h 39m,Buy
119310.91,154246,23.08.2013 08:25:00,,0.0,-40.36999999996624,0.0,0.0,154187,23.08.2013 03:00:00,9576,-0.01928337863516572,-13.7,IS,0.23,0.0,Phase3-EA-S4v1-GBPJPY-M5-194,GBPJPYMT4,2248,5h 25m,Sell
119278.92,1.23492,23.08.2013 14:00:00,,0.0,-72.35999999995693,0.0,0.0,1.23405,23.08.2013 05:15:00,9577,-0.03456391573051592,-31.99,IS,0.34,0.0,Phase3-EA-S4v1-EURCHF-M15-221,EURCHFMT4,2474,8h 45m,Sell
119218.02,153535,23.08.2013 17:29:57,sl 153.535,0.0,-133.2599999999511,0.0,0.0,154205,23.08.2013 04:30:00,9578,-0.06365377847221673,-60.9,IS,0.09,0.0,Phase3-EA-B1v1-GBPJPY-M30-1,GBPJPYMT4,912,12h 59m,Buy
119267.0,1.23225,23.08.2013 22:54:58,tp 1.23225,0.0,-84.27999999994063,0.0,0.0,1.23335,23.08.2013 22:10:00,9579,-0.04025769510458214,48.98,IS,0.41,0.0,Phase3-EA-SA2v2-EURCHF-M5-43,EURCHFMT4,4940,44m 58s,Sell
119270.42,98635,26.08.2013 04:15:00,,-1.23,-80.85999999992782,0.0,0.0,98652,23.08.2013 22:30:00,9580,-0.038624077196913846,3.42,IS,0.27,0.0,Phase3-EA-S1v2-USDJPY-M15-0,USDJPYMT4,2786,2d 5h 45m,Sell
119318.27,1.23342,26.08.2013 04:39:58,tp 1.23342,-1.07,-33.009999999922,0.0,0.0,1.23232,23.08.2013 22:55:00,9581,-0.015767756471286812,47.85,IS,0.41,0.0,Phase3-EA-SA2v2-EURCHF-M5-43,EURCHFMT4,4942,2d 5h 44m,Buy
119294.84,132049,26.08.2013 07:15:00,,0.0,-56.43999999991502,0.0,0.0,132185,26.08.2013 02:15:00,9582,-0.026959472136933973,-23.43,IS,0.17,0.0,Phase3-EA-T1v2-EURJPY-M15-322,EURJPYMT4,1678,5h 0m,Buy
119239.99,1.23492,26.08.2013 14:00:00,,0.0,-111.28999999992084,0.0,0.0,1.23343,26.08.2013 05:15:00,9583,-0.05315945524666487,-54.85,IS,0.34,0.0,Phase3-EA-S4v1-EURCHF-M15-221,EURCHFMT4,2476,8h 45m,Sell
119288.9,1.23325,26.08.2013 22:34:57,tp 1.23325,0.0,-62.379999999917345,0.0,0.0,1.23435,26.08.2013 21:50:00,9584,-0.02979680850287465,48.91,IS,0.41,0.0,Phase3-EA-SA2v2-EURCHF-M5-43,EURCHFMT4,4944,44m 57s,Sell
119351.74,0.92305,26.08.2013 23:59:58,tp 0.92305,0.0,-0.0,0.0,0.0,0.92205,26.08.2013 22:30:00,9585,-0.0,62.84,IS,0.58,0.0,Phase3-EA-SA2v2-USDCHF-M15-107,USDCHFMT4,1848,1h 29m,Buy
119284.94,131404,27.08.2013 02:59:58,sl 131.404,-0.9,-66.79999999998836,0.0,0.0,132124,23.08.2013 05:30:00,9586,-0.03190802235509859,-66.8,IS,0.09,0.0,Phase3-EA-TR1v1-EURJPY-M30-91,EURJPYMT4,1672,3d 21h 29m,Buy
119250.96,0.92164,27.08.2013 06:30:00,,0.0,-100.77999999999884,0.0,0.0,0.92218,27.08.2013 02:15:00,9587,-0.04813907923573891,-33.98,IS,0.58,0.0,Phase3-EA-SA2v2-USDCHF-M15-107,USDCHFMT4,1850,4h 15m,Buy
119232.1,1.23282,27.08.2013 07:30:00,,-1.07,-119.63999999998487,0.0,0.0,1.23322,26.08.2013 23:10:00,9588,-0.05714784123599068,-18.86,IS,0.41,0.0,Phase3-EA-SA2v2-EURCHF-M5-43,EURCHFMT4,4946,8h 20m,Buy
119160.32,130779,27.08.2013 11:29:58,sl 130.779,0.0,-191.4199999999837,0.0,0.0,131559,27.08.2013 07:00:00,9589,-0.09143463531756761,-71.78,IS,0.09,0.0,Phase3-EA-TR1v1-EURJPY-M30-91,EURJPYMT4,1674,4h 29m,Buy
119064.4,1.22982,27.08.2013 13:30:00,,0.0,-287.3399999999965,0.0,0.0,1.23242,27.08.2013 04:45:00,9590,-0.13725226262747778,-95.92,IS,0.34,0.0,Phase3-EA-S4v1-EURCHF-M15-221,EURCHFMT4,2478,8h 45m,Buy
119359.99,130.0,27.08.2013 15:29:58,tp 130.000,-0.6,-0.0,0.0,0.0,131.7,26.08.2013 22:45:00,9591,-0.0,295.59,IS,0.17,0.0,Phase3-EA-T1v2-EURJPY-M15-322,EURJPYMT4,1680,16h 44m,Sell
119452.47,150617,28.08.2013 02:59:58,tp 150.617,0.0,-0.0,0.0,0.0,151007,28.08.2013 01:35:00,9592,-0.0,92.48,IS,0.23,0.0,Phase3-EA-S4v1-GBPJPY-M5-194,GBPJPYMT4,2250,1h 24m,Sell
119529.94,96.89,28.08.2013 03:00:00,,0.0,-0.0,0.0,0.0,97168,28.08.2013 01:30:00,9593,-0.0,77.47,IS,0.27,0.0,Phase3-EA-S1v2-USDJPY-M15-0,USDJPYMT4,2788,1h 30m,Sell
119550.76,1.22906,28.08.2013 04:55:00,,-1.07,-0.0,0.0,0.0,1.22857,27.08.2013 20:35:00,9594,-0.0,20.82,IS,0.41,0.0,Phase3-EA-SA2v2-EURCHF-M5-43,EURCHFMT4,4948,8h 20m,Buy
119508.76,1.55066,28.08.2013 16:29:58,sl 1.55066,0.0,-42.0,0.0,0.0,1.55366,28.08.2013 16:00:00,9595,-0.020042876484914533,-42.0,IS,0.14,0.0,Phase3-EA-B1v1-GBPUSD-M30-14,GBPUSDMT4,610,29m 58s,Buy
119468.74,130088,28.08.2013 16:44:58,sl 130.088,0.0,-82.01999999998952,0.0,0.0,130318,28.08.2013 16:15:00,9596,-0.03914087450696381,-40.02,IS,0.17,0.0,Phase3-EA-T1v2-EURJPY-M15-322,EURJPYMT4,1682,29m 58s,Buy
119426.18,130073,29.08.2013 04:59:58,sl 130.073,-2.56,-124.5799999999872,0.0,0.0,130303,28.08.2013 21:00:00,9597,-0.059450989345009427,-42.56,IS,0.17,0.0,Phase3-EA-T1v2-EURJPY-M15-322,EURJPYMT4,1684,7h 59m,Buy
119408.4,1.23011,29.08.2013 07:25:00,,-6.67,-142.35999999998603,0.0,0.0,1.22986,28.08.2013 23:05:00,9598,-0.06793580705695602,-17.78,IS,0.41,0.0,Phase3-EA-SA2v2-EURCHF-M5-43,EURCHFMT4,4950,8h 20m,Sell
119364.8,1.55071,29.08.2013 09:59:58,sl 1.55071,-1.6,-185.95999999999185,0.0,0.0,1.55371,28.08.2013 18:00:00,9599,-0.08874222169367961,-43.6,IS,0.14,0.0,Phase3-EA-B1v1-GBPUSD-M30-14,GBPUSDMT4,612,15h 59m,Buy
119301.02,152.23,29.08.2013 09:59:58,sl 152.230,-2.14,-249.7399999999907,0.0,0.0,151.56,27.08.2013 15:00:00,9600,-0.1191787612700564,-63.78,IS,0.09,0.0,Phase3-EA-B1v1-GBPJPY-M30-1,GBPJPYMT4,914,1d 18h 59m,Sell
119291.49,1.23037,29.08.2013 11:00:00,,0.0,-259.2699999999895,0.0,0.0,1.23011,29.08.2013 02:15:00,9601,-0.12372658538675194,-9.53,IS,0.34,0.0,Phase3-EA-S4v1-EURCHF-M15-221,EURCHFMT4,2480,8h 45m,Sell
119353.85,0.93012,30.08.2013 04:29:58,tp 0.93012,0.0,-196.9100000000035,0.0,0.0,0.93112,30.08.2013 01:00:00,9602,-0.0939676859201093,62.36,IS,0.58,0.0,Phase3-EA-SA2v2-USDCHF-M15-107,USDCHFMT4,1852,3h 29m,Sell
119363.55,1.2321,30.08.2013 04:35:00,,-2.2,-187.20999999999185,0.0,0.0,1.23237,29.08.2013 20:15:00,9603,-0.08933873587477825,9.7,IS,0.41,0.0,Phase3-EA-SA2v2-EURCHF-M5-43,EURCHFMT4,4952,8h 20m,Sell
119359.17,1.23218,30.08.2013 13:00:00,,0.0,-191.5899999999965,0.0,0.0,1.2323,30.08.2013 04:15:00,9604,-0.09142892156535014,-4.38,IS,0.34,0.0,Phase3-EA-S4v1-EURCHF-M15-221,EURCHFMT4,2482,8h 45m,Buy
119373.46,98268,30.08.2013 19:15:00,,0.0,-177.29999999998836,0.0,0.0,98216,30.08.2013 17:45:00,9605,-0.08460957144702651,14.29,IS,0.27,0.0,Phase3-EA-S1v2-USDJPY-M15-0,USDJPYMT4,2790,1h 30m,Buy
119421.95,1.22958,30.08.2013 20:19:58,tp 1.22958,0.0,-128.80999999999767,0.0,0.0,1.22848,30.08.2013 20:15:00,9606,-0.06146959333385225,48.49,IS,0.41,0.0,Phase3-EA-SA2v2-EURCHF-M5-43,EURCHFMT4,4954,4m 58s,Buy
119484.16,0.9324,02.09.2013 01:59:58,tp 0.93240,0.0,-66.60000000000582,0.0,0.0,0.9314,02.09.2013 01:15:00,9607,-0.03178227556893868,62.21,IS,0.58,0.0,Phase3-EA-SA2v2-USDCHF-M15-107,USDCHFMT4,1854,44m 58s,Buy
119297.59,153474,02.09.2013 06:29:57,sl 153.474,0.0,-253.1700000000128,0.0,0.0,152674,02.09.2013 03:00:00,9608,-0.12081559618300165,-186.57,IS,0.23,0.0,Phase3-EA-S4v1-GBPJPY-M5-194,GBPJPYMT4,2252,3h 29m,Sell
119223.69,1.23118,02.09.2013 07:10:00,,-2.21,-327.070000000007,0.0,0.0,1.22955,30.08.2013 22:50:00,9609,-0.15608151456955088,-73.9,IS,0.41,0.0,Phase3-EA-SA2v2-EURCHF-M5-43,EURCHFMT4,4956,2d 8h 20m,Sell
119182.81,130363,02.09.2013 09:44:57,sl 130.363,-1.22,-367.95000000001164,0.0,0.0,130133,29.08.2013 17:15:00,9610,-0.17558991434820323,-40.88,IS,0.17,0.0,Phase3-EA-T1v2-EURJPY-M15-322,EURJPYMT4,1686,3d 16h 29m,Sell
119115.15,130.57,02.09.2013 09:59:57,sl 130.570,-1.93,-435.61000000001513,0.0,0.0,129.85,27.08.2013 15:30:00,9611,-0.20787803394271245,-67.66,IS,0.09,0.0,Phase3-EA-TR1v1-EURJPY-M30-91,EURJPYMT4,1676,5d 18h 29m,Sell
119095.81,1.23172,02.09.2013 12:45:00,,0.0,-454.95000000001164,0.0,0.0,1.23119,02.09.2013 04:00:00,9612,-0.21710730135266906,-19.34,IS,0.34,0.0,Phase3-EA-S4v1-EURCHF-M15-221,EURCHFMT4,2484,8h 45m,Sell
119105.07,99381,03.09.2013 00:45:00,,-0.79,-445.6900000000023,0.0,0.0,99344,02.09.2013 23:45:00,9613,-0.21268832429908585,9.26,IS,0.27,0.0,Phase3-EA-S1v2-USDJPY-M15-0,USDJPYMT4,2792,1h 0m,Buy
119108.58,1.23261,03.09.2013 04:45:00,,-2.19,-442.179999999993,0.0,0.0,1.23274,02.09.2013 20:25:00,9614,-0.2110133124785564,3.51,IS,0.41,0.0,Phase3-EA-SA2v2-EURCHF-M5-43,EURCHFMT4,4958,8h 20m,Sell
119116.03,0.93467,03.09.2013 07:00:00,,0.0,-434.7299999999814,0.0,0.0,0.93479,03.09.2013 02:45:00,9615,-0.2074580879592029,7.45,IS,0.58,0.0,Phase3-EA-SA2v2-USDCHF-M15-107,USDCHFMT4,1856,4h 15m,Sell
119114.64,154731,03.09.2013 07:40:00,,0.0,-436.11999999999534,0.0,0.0,154725,03.09.2013 02:15:00,9616,-0.20812141172859128,-1.39,IS,0.23,0.0,Phase3-EA-S4v1-GBPJPY-M5-194,GBPJPYMT4,2254,5h 25m,Sell
119127.8,131.21,03.09.2013 08:30:00,,-0.84,-422.95999999999185,0.0,0.0,131128,02.09.2013 22:45:00,9617,-0.20184131042998305,13.16,IS,0.17,0.0,Phase3-EA-T1v2-EURJPY-M15-322,EURJPYMT4,1688,9h 45m,Buy
119175.96,1.23368,03.09.2013 22:39:59,tp 1.23368,0.0,-374.79999999998836,0.0,0.0,1.23258,03.09.2013 20:10:00,9618,-0.17885881206061272,48.16,IS,0.41,0.0,Phase3-EA-SA2v2-EURCHF-M5-43,EURCHFMT4,4960,2h 29m,Buy
119195.22,99526,04.09.2013 03:30:00,,0.0,-355.53999999997905,0.0,0.0,99597,04.09.2013 00:30:00,9619,-0.1696677215582403,19.26,IS,0.27,0.0,Phase3-EA-S1v2-USDJPY-M15-0,USDJPYMT4,2794,3h 0m,Sell
119186.47,1.23382,04.09.2013 07:05:00,,-2.19,-364.28999999997905,0.0,0.0,1.23367,03.09.2013 22:45:00,9620,-0.17384332082593085,-8.75,IS,0.41,0.0,Phase3-EA-SA2v2-EURCHF-M5-43,EURCHFMT4,4962,8h 20m,Sell
119182.54,131146,04.09.2013 07:15:00,,0.0,-368.21999999997206,0.0,0.0,131169,04.09.2013 07:00:00,9621,-0.17571876141130166,-3.93,IS,0.17,0.0,Phase3-EA-T1v2-EURJPY-M15-322,EURJPYMT4,1690,15m 0s,Buy
119349.08,155638,04.09.2013 13:30:00,tp 155.638,-0.66,-201.6799999999639,0.0,0.0,153788,02.09.2013 10:00:00,9622,-0.09624398403516285,166.54,IS,0.09,0.0,Phase3-EA-B1v1-GBPJPY-M30-1,GBPJPYMT4,916,2d 3h 30m,Buy
119397.29,1.23544,04.09.2013 23:39:58,tp 1.23544,0.0,-153.46999999997206,0.0,0.0,1.23654,04.09.2013 20:25:00,9623,-0.07323762509855414,48.21,IS,0.41,0.0,Phase3-EA-SA2v2-EURCHF-M5-43,EURCHFMT4,4964,3h 14m,Sell
119433.08,99793,05.09.2013 02:15:00,,-2.36,-117.67999999996391,0.0,0.0,99652,04.09.2013 22:30:00,9624,-0.05615823106533379,35.79,IS,0.27,0.0,Phase3-EA-S1v2-USDJPY-M15-0,USDJPYMT4,2796,3h 45m,Buy
119477.11,131631,05.09.2013 04:30:00,,-2.51,-73.64999999996508,0.0,0.0,131358,04.09.2013 18:00:00,9625,-0.035146615550315605,44.03,IS,0.17,0.0,Phase3-EA-T1v2-EURJPY-M15-322,EURJPYMT4,1692,10h 30m,Buy
119512.87,1.23646,05.09.2013 08:00:00,,-3.16,-37.88999999995576,0.0,0.0,1.23557,04.09.2013 23:40:00,9626,-0.01808153785744107,35.76,IS,0.41,0.0,Phase3-EA-SA2v2-EURCHF-M5-43,EURCHFMT4,4966,8h 20m,Buy
119606.2,1.23789,05.09.2013 09:45:00,,0.0,-0.0,0.0,0.0,1.23531,05.09.2013 01:00:00,9627,-0.0,93.33,IS,0.34,0.0,Phase3-EA-S4v1-EURCHF-M15-221,EURCHFMT4,2486,8h 45m,Buy
119567.09,131616,05.09.2013 15:14:59,sl 131.616,0.0,-39.10999999998603,0.0,0.0,131846,05.09.2013 11:30:00,9628,-0.018658799214901912,-39.11,IS,0.17,0.0,Phase3-EA-T1v2-EURJPY-M15-322,EURJPYMT4,1694,3h 44m,Buy
119563.49,1.23878,06.09.2013 14:00:00,,0.0,-42.70999999999185,0.0,0.0,1.23888,06.09.2013 05:15:00,9629,-0.020376305662710134,-3.6,IS,0.34,0.0,Phase3-EA-S4v1-EURCHF-M15-221,EURCHFMT4,2488,8h 45m,Buy
119495.97,130539,06.09.2013 15:59:58,sl 130.539,-2.65,-110.22999999998137,0.0,0.0,131259,02.09.2013 12:30:00,9630,-0.052589093261545004,-67.52,IS,0.09,0.0,Phase3-EA-TR1v1-EURJPY-M30-91,EURJPYMT4,1678,4d 3h 29m,Buy
119455.91,131424,09.09.2013 01:00:00,sl 131.424,-0.6,-150.28999999997905,0.0,0.0,131194,06.09.2013 03:30:00,9631,-0.07170112334462335,-40.06,IS,0.17,0.0,Phase3-EA-T1v2-EURJPY-M15-322,EURJPYMT4,1696,2d 21h 30m,Sell
119230.52,99973,09.09.2013 02:44:58,sl 99.973,-1.23,-375.679999999993,0.0,0.0,99143,06.09.2013 21:00:00,9632,-0.17923133953098247,-225.39,IS,0.27,0.0,Phase3-EA-S1v2-USDJPY-M15-0,USDJPYMT4,2798,2d 5h 44m,Sell
119346.26,131741,09.09.2013 02:59:58,tp 131.741,-0.45,-259.9400000000023,0.0,0.0,130451,06.09.2013 19:30:00,9633,-0.12401350723404192,115.74,IS,0.09,0.0,Phase3-EA-TR1v1-EURJPY-M30-91,EURJPYMT4,1680,2d 7h 29m,Buy
119327.03,1.23635,09.09.2013 05:05:00,,-2.19,-279.1700000000128,0.0,0.0,1.23596,06.09.2013 20:45:00,9634,-0.13318785417607432,-19.23,IS,0.41,0.0,Phase3-EA-SA2v2-EURCHF-M5-43,EURCHFMT4,4968,2d 8h 20m,Sell
119417.07,155.58,09.09.2013 05:09:58,tp 155.580,0.0,-189.13000000000466,0.0,0.0,155.97,09.09.2013 01:15:00,9635,-0.09023110957595874,90.04,IS,0.23,0.0,Phase3-EA-S4v1-GBPJPY-M5-194,GBPJPYMT4,2256,3h 54m,Sell
119433.04,1.23614,09.09.2013 12:00:00,,0.0,-173.1600000000035,0.0,0.0,1.23658,09.09.2013 03:15:00,9636,-0.08261206013944349,15.97,IS,0.34,0.0,Phase3-EA-S4v1-EURCHF-M15-221,EURCHFMT4,2490,8h 45m,Sell
119693.92,1.5707,09.09.2013 17:29:58,tp 1.57070,-3.72,-0.0,0.0,0.0,1.5518,02.09.2013 02:00:00,9637,-0.0,260.88,IS,0.14,0.0,Phase3-EA-B1v1-GBPUSD-M30-14,GBPUSDMT4,614,7d 15h 29m,Buy
119707.74,99625,09.09.2013 23:45:00,,0.0,-0.0,0.0,0.0,99574,09.09.2013 23:00:00,9638,-0.0,13.82,IS,0.27,0.0,Phase3-EA-S1v2-USDJPY-M15-0,USDJPYMT4,2800,45m 0s,Buy
119655.94,0.93272,10.09.2013 02:30:00,,-3.3,-51.79999999998836,0.0,0.0,0.93194,09.09.2013 22:15:00,9639,-0.02470104346171866,-51.8,IS,0.58,0.0,Phase3-EA-SA2v2-USDCHF-M15-107,USDCHFMT4,1858,4h 15m,Sell
119617.7,1.23649,10.09.2013 05:30:00,,-2.2,-90.03999999997905,0.0,0.0,1.23567,09.09.2013 21:10:00,9640,-0.042935945044268925,-38.24,IS,0.41,0.0,Phase3-EA-SA2v2-EURCHF-M5-43,EURCHFMT4,4970,8h 20m,Sell
119631.79,156325,10.09.2013 06:50:00,,0.0,-75.94999999998254,0.0,0.0,156386,10.09.2013 01:25:00,9641,-0.03621707048103325,14.09,IS,0.23,0.0,Phase3-EA-S4v1-GBPJPY-M5-194,GBPJPYMT4,2258,5h 25m,Sell
119599.76,1.23704,10.09.2013 12:45:00,,0.0,-107.97999999998137,0.0,0.0,1.23616,10.09.2013 04:00:00,9642,-0.051490707972905794,-32.03,IS,0.34,0.0,Phase3-EA-S4v1-EURCHF-M15-221,EURCHFMT4,2492,8h 45m,Sell
119887.02,132.98,10.09.2013 16:14:58,tp 132.980,-0.84,-0.0,0.0,0.0,131.28,09.09.2013 14:00:00,9643,-0.0,287.26,IS,0.17,0.0,Phase3-EA-T1v2-EURJPY-M15-322,EURJPYMT4,1698,1d 2h 14m,Buy
119999.59,133237,10.09.2013 17:29:57,tp 133.237,-0.44,-0.0,0.0,0.0,131977,09.09.2013 18:00:00,9644,-0.0,112.57,IS,0.09,0.0,Phase3-EA-TR1v1-EURJPY-M30-91,EURJPYMT4,1682,23h 29m,Buy
120055.78,100427,10.09.2013 23:45:00,,0.0,-0.0,0.0,0.0,100218,10.09.2013 18:45:00,9645,-0.0,56.19,IS,0.27,0.0,Phase3-EA-S1v2-USDJPY-M15-0,USDJPYMT4,2802,5h 0m,Buy
120143.95,157596,11.09.2013 04:09:57,tp 157.596,-1.33,-0.0,0.0,0.0,157986,10.09.2013 23:40:00,9646,-0.0,88.17,IS,0.23,0.0,Phase3-EA-S4v1-GBPJPY-M5-194,GBPJPYMT4,2260,4h 29m,Sell
120082.15,1.2412,11.09.2013 06:15:00,,-2.19,-61.79999999998836,0.0,0.0,1.23984,10.09.2013 21:55:00,9647,-0.029408412661886235,-61.8,IS,0.41,0.0,Phase3-EA-SA2v2-EURCHF-M5-43,EURCHFMT4,4972,8h 20m,Sell
120075.61,1.24042,11.09.2013 09:45:00,,0.0,-68.33999999999651,0.0,0.0,1.24024,11.09.2013 01:00:00,9648,-0.03252056506979905,-6.54,IS,0.34,0.0,Phase3-EA-S4v1-EURCHF-M15-221,EURCHFMT4,2494,8h 45m,Sell
120120.92,1.23855,12.09.2013 00:24:58,tp 1.23855,-3.17,-23.029999999998836,0.0,0.0,1.23745,11.09.2013 20:40:00,9649,-0.010959154427238403,45.31,IS,0.41,0.0,Phase3-EA-SA2v2-EURCHF-M5-43,EURCHFMT4,4974,3h 44m,Buy
120210.84,157774,12.09.2013 03:29:58,tp 157.774,0.0,-0.0,0.0,0.0,158164,12.09.2013 01:05:00,9650,-0.0,89.92,IS,0.23,0.0,Phase3-EA-S4v1-GBPJPY-M5-194,GBPJPYMT4,2262,2h 24m,Sell
120144.1,132.55,12.09.2013 04:59:58,sl 132.550,-1.76,-66.73999999999069,0.0,0.0,133.27,10.09.2013 17:30:00,9651,-0.03174907630833413,-66.74,IS,0.09,0.0,Phase3-EA-TR1v1-EURJPY-M30-91,EURJPYMT4,1684,1d 11h 29m,Buy
120082.2,157.04,12.09.2013 09:29:58,sl 157.040,-1.29,-128.63999999998487,0.0,0.0,157.71,10.09.2013 16:30:00,9652,-0.06119570237195373,-61.9,IS,0.09,0.0,Phase3-EA-B1v1-GBPJPY-M30-1,GBPJPYMT4,918,1d 16h 59m,Buy
120105.58,1.23805,12.09.2013 10:15:00,,0.0,-105.25999999998021,0.0,0.0,1.23869,12.09.2013 01:30:00,9653,-0.050073535693962966,23.38,IS,0.34,0.0,Phase3-EA-S4v1-EURCHF-M15-221,EURCHFMT4,2496,8h 45m,Sell
120063.05,1.57983,13.09.2013 03:29:57,sl 1.57983,-0.53,-147.78999999997905,0.0,0.0,1.58283,12.09.2013 17:30:00,9654,-0.07030560365011523,-42.53,IS,0.14,0.0,Phase3-EA-B1v1-GBPUSD-M30-14,GBPUSDMT4,616,9h 59m,Buy
120026.97,1.23786,13.09.2013 04:20:00,,-2.2,-183.86999999996624,0.0,0.0,1.23709,12.09.2013 20:00:00,9655,-0.0874693236561753,-36.08,IS,0.41,0.0,Phase3-EA-SA2v2-EURCHF-M5-43,EURCHFMT4,4976,8h 20m,Sell
120032.45,1.23756,13.09.2013 11:30:00,,0.0,-178.38999999995576,0.0,0.0,1.23771,13.09.2013 02:45:00,9656,-0.08486241718074784,5.48,IS,0.34,0.0,Phase3-EA-S4v1-EURCHF-M15-221,EURCHFMT4,2498,8h 45m,Sell
120140.43,98901,16.09.2013 01:00:00,tp 98.901,-1.22,-70.40999999994528,0.0,0.0,99301,13.09.2013 23:30:00,9657,-0.03349494250626882,107.98,IS,0.27,0.0,Phase3-EA-S1v2-USDJPY-M15-0,USDJPYMT4,2804,2d 1h 30m,Sell
120203.12,0.92519,16.09.2013 02:59:57,tp 0.92519,0.0,-7.7199999999429565,0.0,0.0,0.92419,16.09.2013 02:00:00,9658,-0.0036725032828672853,62.69,IS,0.58,0.0,Phase3-EA-SA2v2-USDCHF-M15-107,USDCHFMT4,1860,59m 57s,Buy
120143.93,1.23515,16.09.2013 04:30:00,,-1.06,-66.90999999994528,0.0,0.0,1.23646,13.09.2013 20:10:00,9659,-0.031829947494593884,-59.19,IS,0.41,0.0,Phase3-EA-SA2v2-EURCHF-M5-43,EURCHFMT4,4978,2d 8h 20m,Buy
120142.46,1.23593,16.09.2013 10:00:00,,0.0,-68.37999999994645,0.0,0.0,1.23597,16.09.2013 01:15:00,9660,-0.03252924539949791,-1.47,IS,0.34,0.0,Phase3-EA-S4v1-EURCHF-M15-221,EURCHFMT4,2500,8h 45m,Buy
120100.46,1.59307,16.09.2013 18:29:58,sl 1.59307,0.0,-110.37999999994645,0.0,0.0,1.59607,16.09.2013 16:00:00,9661,-0.052509185539597096,-42.0,IS,0.14,0.0,Phase3-EA-B1v1-GBPUSD-M30-14,GBPUSDMT4,618,2h 29m,Buy
120118.44,99124,17.09.2013 02:30:00,,0.0,-92.39999999993597,0.0,0.0,99058,17.09.2013 00:15:00,9662,-0.04395586830818775,17.98,IS,0.27,0.0,Phase3-EA-S1v2-USDJPY-M15-0,USDJPYMT4,2806,2h 15m,Buy
120127.73,1.23632,17.09.2013 04:55:00,,-2.21,-83.10999999992782,0.0,0.0,1.23658,16.09.2013 20:35:00,9663,-0.039536495834338124,9.29,IS,0.41,0.0,Phase3-EA-SA2v2-EURCHF-M5-43,EURCHFMT4,4980,8h 20m,Sell
120177.3,1.23756,17.09.2013 12:30:00,,0.0,-33.53999999992084,0.0,0.0,1.23621,17.09.2013 03:45:00,9664,-0.015955409340412976,49.57,IS,0.34,0.0,Phase3-EA-S4v1-EURCHF-M15-221,EURCHFMT4,2502,8h 45m,Buy
120183.76,1.23704,18.09.2013 04:40:00,,-1.06,-27.079999999928987,0.0,0.0,1.23687,17.09.2013 20:20:00,9665,-0.012882304261725406,6.46,IS,0.41,0.0,Phase3-EA-SA2v2-EURCHF-M5-43,EURCHFMT4,4982,8h 20m,Buy
120182.29,1.23711,18.09.2013 15:00:00,,0.0,-28.54999999993015,0.0,0.0,1.23707,18.09.2013 06:15:00,9666,-0.01358160216662943,-1.47,IS,0.34,0.0,Phase3-EA-S4v1-EURCHF-M15-221,EURCHFMT4,2504,8h 45m,Sell
120183.93,98915,18.09.2013 20:30:00,,0.0,-26.90999999991618,0.0,0.0,98921,18.09.2013 17:15:00,9667,-0.01280143307543796,1.64,IS,0.27,0.0,Phase3-EA-S1v2-USDJPY-M15-0,USDJPYMT4,2808,3h 15m,Sell
120233.13,1.23579,18.09.2013 21:29:58,tp 1.23579,0.0,-0.0,0.0,0.0,1.23469,18.09.2013 20:25:00,9668,-0.0,49.2,IS,0.41,0.0,Phase3-EA-SA2v2-EURCHF-M5-43,EURCHFMT4,4984,1h 4m,Buy
120497.73,1.61011,18.09.2013 21:59:58,tp 1.61011,0.0,-0.0,0.0,0.0,1.59121,18.09.2013 08:30:00,9669,-0.0,264.6,IS,0.14,0.0,Phase3-EA-B1v1-GBPUSD-M30-14,GBPUSDMT4,620,13h 29m,Buy
120546.99,1.23486,18.09.2013 21:59:58,tp 1.23486,0.0,-0.0,0.0,0.0,1.23596,18.09.2013 21:50:00,9670,-0.0,49.26,IS,0.41,0.0,Phase3-EA-SA2v2-EURCHF-M5-43,EURCHFMT4,4986,9m 58s,Sell
120608.23,0.91297,19.09.2013 00:59:58,tp 0.91297,-2.29,-0.0,0.0,0.0,0.91197,18.09.2013 23:45:00,9671,-0.0,61.24,IS,0.58,0.0,Phase3-EA-SA2v2-USDCHF-M15-107,USDCHFMT4,1862,1h 14m,Buy
120657.68,1.2345,19.09.2013 02:59:57,tp 1.23450,0.0,-0.0,0.0,0.0,1.2334,19.09.2013 00:05:00,9672,-0.0,49.45,IS,0.41,0.0,Phase3-EA-SA2v2-EURCHF-M5-43,EURCHFMT4,4988,2h 54m,Buy
120611.94,133168,19.09.2013 07:14:57,sl 133.168,-6.01,-45.73999999999069,0.0,0.0,132938,11.09.2013 23:00:00,9673,-0.021712951552485676,-45.74,IS,0.17,0.0,Phase3-EA-T1v2-EURJPY-M15-322,EURJPYMT4,1700,7d 8h 14m,Sell
120726.79,133464,19.09.2013 10:29:58,tp 133.464,-3.12,-0.0,0.0,0.0,132174,12.09.2013 20:30:00,9674,-0.0,114.85,IS,0.09,0.0,Phase3-EA-TR1v1-EURJPY-M30-91,EURJPYMT4,1686,6d 13h 59m,Buy
120772.75,1.23301,19.09.2013 14:00:00,,0.0,-0.0,0.0,0.0,1.23424,19.09.2013 05:15:00,9675,-0.0,45.96,IS,0.34,0.0,Phase3-EA-S4v1-EURCHF-M15-221,EURCHFMT4,2506,8h 45m,Sell
120814.83,99449,19.09.2013 23:45:00,,0.0,-0.0,0.0,0.0,99294,19.09.2013 20:30:00,9676,-0.0,42.08,IS,0.27,0.0,Phase3-EA-S1v2-USDJPY-M15-0,USDJPYMT4,2810,3h 15m,Buy
120856.07,1.23262,20.09.2013 04:35:00,,-1.08,-0.0,0.0,0.0,1.23168,19.09.2013 20:15:00,9677,-0.0,41.24,IS,0.41,0.0,Phase3-EA-SA2v2-EURCHF-M5-43,EURCHFMT4,4990,8h 20m,Buy
120946.48,159111,20.09.2013 07:34:58,tp 159.111,0.0,-0.0,0.0,0.0,159501,20.09.2013 03:30:00,9678,-0.0,90.41,IS,0.23,0.0,Phase3-EA-S4v1-GBPJPY-M5-194,GBPJPYMT4,2264,4h 4m,Sell
120923.55,134361,20.09.2013 07:45:00,,-0.84,-22.929999999993015,0.0,0.0,134.49,19.09.2013 22:45:00,9679,-0.010870055760111677,-22.93,IS,0.17,0.0,Phase3-EA-T1v2-EURJPY-M15-322,EURJPYMT4,1702,9h 0m,Buy
120956.02,1.2317,20.09.2013 12:45:00,,0.0,-0.0,0.0,0.0,1.23257,20.09.2013 04:00:00,9680,-0.0,32.47,IS,0.34,0.0,Phase3-EA-S4v1-EURCHF-M15-221,EURCHFMT4,2508,8h 45m,Sell
120964.11,0.91015,23.09.2013 02:15:00,,-3.38,-0.0,0.0,0.0,0.91033,20.09.2013 22:00:00,9681,-0.0,8.09,IS,0.58,0.0,Phase3-EA-SA2v2-USDCHF-M15-107,USDCHFMT4,1864,2d 4h 15m,Sell
120952.74,158848,23.09.2013 06:40:00,,0.0,-11.369999999995343,0.0,0.0,158897,23.09.2013 01:15:00,9682,-0.005389542325467232,-11.37,IS,0.23,0.0,Phase3-EA-S4v1-GBPJPY-M5-194,GBPJPYMT4,2266,5h 25m,Buy
120906.84,1.2326,23.09.2013 07:20:00,,-2.25,-57.26999999998952,0.0,0.0,1.23163,20.09.2013 23:00:00,9683,-0.02714679762353371,-45.9,IS,0.41,0.0,Phase3-EA-SA2v2-EURCHF-M5-43,EURCHFMT4,4992,2d 8h 20m,Sell
120864.15,1.60541,23.09.2013 11:29:57,sl 1.60541,-0.69,-99.95999999999185,0.0,0.0,1.60241,20.09.2013 14:00:00,9684,-0.04738246709356915,-42.69,IS,0.14,0.0,Phase3-EA-B1v1-GBPUSD-M30-14,GBPUSDMT4,622,2d 21h 29m,Sell
120858.19,1.23235,23.09.2013 12:30:00,,0.0,-105.9199999999837,0.0,0.0,1.23219,23.09.2013 03:45:00,9685,-0.05020759218237776,-5.96,IS,0.34,0.0,Phase3-EA-S4v1-EURCHF-M15-221,EURCHFMT4,2510,8h 45m,Sell
120791.77,133246,23.09.2013 17:29:58,sl 133.246,-0.88,-172.3399999999965,0.0,0.0,133966,19.09.2013 12:30:00,9686,-0.08169162043723696,-66.42,IS,0.09,0.0,Phase3-EA-TR1v1-EURJPY-M30-91,EURJPYMT4,1688,4d 4h 59m,Buy
120801.14,0.91063,24.09.2013 04:00:00,,-3.37,-162.97000000000116,0.0,0.0,0.91083,23.09.2013 23:45:00,9687,-0.07725010666506252,9.37,IS,0.58,0.0,Phase3-EA-SA2v2-USDCHF-M15-107,USDCHFMT4,1866,4h 15m,Sell
120780.7,1.2288,24.09.2013 06:55:00,,-1.08,-183.4100000000035,0.0,0.0,1.22923,23.09.2013 22:35:00,9688,-0.0869389584797158,-20.44,IS,0.41,0.0,Phase3-EA-SA2v2-EURCHF-M5-43,EURCHFMT4,4994,8h 20m,Buy
120819.11,1.22972,24.09.2013 14:30:00,,0.0,-145.0,0.0,0.0,1.22869,24.09.2013 05:45:00,9689,-0.06873207011372635,38.41,IS,0.34,0.0,Phase3-EA-S4v1-EURCHF-M15-221,EURCHFMT4,2512,8h 45m,Buy
120747.57,132759,24.09.2013 17:29:58,sl 132.759,-0.45,-216.54000000000815,0.0,0.0,133539,23.09.2013 20:30:00,9690,-0.10264305146501286,-71.54,IS,0.09,0.0,Phase3-EA-TR1v1-EURJPY-M30-91,EURJPYMT4,1690,20h 59m,Buy
120693.4,0.91345,25.09.2013 03:15:00,,-3.37,-270.71000000002095,0.0,0.0,0.91265,24.09.2013 23:00:00,9691,-0.1283204048309538,-54.17,IS,0.58,0.0,Phase3-EA-SA2v2-USDCHF-M15-107,USDCHFMT4,1868,4h 15m,Sell
120724.74,98648,25.09.2013 04:00:00,,-1.23,-239.37000000002445,0.0,0.0,98767,24.09.2013 18:15:00,9692,-0.11346479740085764,31.34,IS,0.27,0.0,Phase3-EA-S1v2-USDJPY-M15-0,USDJPYMT4,2812,9h 45m,Sell
120685.67,1.23064,25.09.2013 04:25:00,,-2.25,-278.44000000003143,0.0,0.0,1.22982,24.09.2013 20:05:00,9693,-0.13198453518943537,-39.07,IS,0.41,0.0,Phase3-EA-SA2v2-EURCHF-M5-43,EURCHFMT4,4996,8h 20m,Sell
120642.32,157728,25.09.2013 08:05:00,,0.0,-321.79000000003725,0.0,0.0,157914,25.09.2013 02:40:00,9694,-0.15253305408205906,-43.35,IS,0.23,0.0,Phase3-EA-S4v1-GBPJPY-M5-194,GBPJPYMT4,2268,5h 25m,Buy
120690.05,1.22883,25.09.2013 10:30:00,,0.0,-274.0600000000268,0.0,0.0,1.23011,25.09.2013 01:45:00,9695,-0.12990835265772196,47.73,IS,0.34,0.0,Phase3-EA-S4v1-EURCHF-M15-221,EURCHFMT4,2514,8h 45m,Sell
120649.8,133263,25.09.2013 15:59:58,sl 133.263,-0.6,-314.3100000000268,0.0,0.0,133033,24.09.2013 23:00:00,9696,-0.14898742729273912,-40.25,IS,0.17,0.0,Phase3-EA-T1v2-EURJPY-M15-322,EURJPYMT4,1704,16h 59m,Sell
120740.8,158466,26.09.2013 05:09:58,tp 158.466,0.0,-223.31000000002678,0.0,0.0,158076,26.09.2013 03:55:00,9697,-0.10585212811791775,91.0,IS,0.23,0.0,Phase3-EA-S4v1-GBPJPY-M5-194,GBPJPYMT4,2270,1h 14m,Buy
120774.43,1.22929,26.09.2013 11:15:00,,0.0,-189.68000000002212,0.0,0.0,1.23019,26.09.2013 02:30:00,9698,-0.08991102799429748,33.63,IS,0.34,0.0,Phase3-EA-S4v1-EURCHF-M15-221,EURCHFMT4,2516,8h 45m,Sell
120734.92,133455,26.09.2013 11:59:58,sl 133.455,0.0,-229.19000000003143,0.0,0.0,133685,26.09.2013 05:30:00,9699,-0.10863933206460072,-39.51,IS,0.17,0.0,Phase3-EA-T1v2-EURJPY-M15-322,EURJPYMT4,1706,6h 29m,Buy
120695.41,133341,26.09.2013 18:14:58,sl 133.341,0.0,-268.70000000004075,0.0,0.0,133571,26.09.2013 17:00:00,9700,-0.12736763613490396,-39.51,IS,0.17,0.0,Phase3-EA-T1v2-EURJPY-M15-322,EURJPYMT4,1708,1h 14m,Buy
120655.9,133251,26.09.2013 21:14:57,sl 133.251,0.0,-308.21000000005006,0.0,0.0,133481,26.09.2013 19:45:00,9701,-0.14609594020520716,-39.51,IS,0.17,0.0,Phase3-EA-T1v2-EURJPY-M15-322,EURJPYMT4,1710,1h 29m,Buy
120686.74,99029,27.09.2013 02:00:00,,-0.79,-277.37000000005355,0.0,0.0,98913,26.09.2013 20:30:00,9702,-0.13147733991343422,30.84,IS,0.27,0.0,Phase3-EA-S1v2-USDJPY-M15-0,USDJPYMT4,2814,5h 30m,Buy
120776.19,158392,27.09.2013 05:19:58,tp 158.392,-1.35,-187.9200000000419,0.0,0.0,158782,26.09.2013 23:55:00,9703,-0.08907676286740922,89.45,IS,0.23,0.0,Phase3-EA-S4v1-GBPJPY-M5-194,GBPJPYMT4,2272,5h 24m,Sell
120730.93,1.22651,27.09.2013 06:15:00,,-1.08,-233.18000000005122,0.0,0.0,1.22749,26.09.2013 21:55:00,9704,-0.11053064902842918,-45.26,IS,0.41,0.0,Phase3-EA-SA2v2-EURCHF-M5-43,EURCHFMT4,4998,8h 20m,Buy
120769.69,98224,27.09.2013 20:45:00,,0.0,-194.4200000000419,0.0,0.0,98365,27.09.2013 20:00:00,9705,-0.09215785566561074,38.76,IS,0.27,0.0,Phase3-EA-S1v2-USDJPY-M15-0,USDJPYMT4,2816,45m 0s,Sell
120695.98,132372,30.09.2013 01:00:00,sl 132.372,-2.24,-268.13000000003376,0.0,0.0,133152,25.09.2013 13:00:00,9706,-0.1270974479972122,-73.71,IS,0.09,0.0,Phase3-EA-TR1v1-EURJPY-M30-91,EURJPYMT4,1692,4d 12h 0m,Buy
120805.08,97876,30.09.2013 01:00:00,tp 97.876,-1.24,-159.03000000002794,0.0,0.0,98276,27.09.2013 22:45:00,9707,-0.07538249041508843,109.1,IS,0.27,0.0,Phase3-EA-S1v2-USDJPY-M15-0,USDJPYMT4,2818,2d 2h 15m,Sell
120668.51,1.22157,30.09.2013 06:25:00,,-1.09,-295.6000000000349,0.0,0.0,1.22456,27.09.2013 22:05:00,9708,-0.14011862017668905,-136.57,IS,0.41,0.0,Phase3-EA-SA2v2-EURCHF-M5-43,EURCHFMT4,5000,2d 8h 20m,Buy
120708.96,158164,30.09.2013 06:35:00,,0.0,-255.15000000002328,0.0,0.0,157992,30.09.2013 01:10:00,9709,-0.1209447426863371,40.45,IS,0.23,0.0,Phase3-EA-S4v1-GBPJPY-M5-194,GBPJPYMT4,2274,5h 25m,Buy
120703.7,1222,30.09.2013 12:00:00,,0.0,-260.4100000000326,0.0,0.0,1.22214,30.09.2013 03:15:00,9710,-0.12343805778150152,-5.26,IS,0.34,0.0,Phase3-EA-S4v1-EURCHF-M15-221,EURCHFMT4,2518,8h 45m,Buy
120638.7,159406,30.09.2013 20:59:57,sl 159.406,-3.71,-325.4100000000326,0.0,0.0,158736,23.09.2013 06:00:00,9711,-0.15424898576351678,-65.0,IS,0.09,0.0,Phase3-EA-B1v1-GBPJPY-M30-1,GBPJPYMT4,920,7d 14h 59m,Sell
120661.51,98345,01.10.2013 02:00:00,,-0.8,-302.6000000000349,0.0,0.0,98259,30.09.2013 23:45:00,9712,-0.14343672011321376,22.81,IS,0.27,0.0,Phase3-EA-S1v2-USDJPY-M15-0,USDJPYMT4,2820,2h 15m,Buy
120710.24,1.22418,01.10.2013 02:09:57,tp 1.22418,-1.09,-253.87000000002445,0.0,0.0,1.22308,30.09.2013 21:50:00,9713,-0.12033800441223028,48.73,IS,0.41,0.0,Phase3-EA-SA2v2-EURCHF-M5-43,EURCHFMT4,5002,4h 19m,Buy
120669.32,133263,01.10.2013 05:14:58,sl 133.263,-1.22,-294.79000000003725,0.0,0.0,133033,27.09.2013 18:00:00,9714,-0.13973466861260658,-40.92,IS,0.17,0.0,Phase3-EA-T1v2-EURJPY-M15-322,EURJPYMT4,1712,3d 11h 14m,Sell
120561.95,159661,01.10.2013 07:30:00,,0.0,-402.1600000000326,0.0,0.0,159202,01.10.2013 02:05:00,9715,-0.1906295814961271,-107.37,IS,0.23,0.0,Phase3-EA-S4v1-GBPJPY-M5-194,GBPJPYMT4,2276,5h 25m,Sell
120611.86,1.22321,01.10.2013 07:44:58,tp 1.22321,0.0,-352.2500000000291,0.0,0.0,1.22431,01.10.2013 02:45:00,9716,-0.1669715289487042,49.91,IS,0.41,0.0,Phase3-EA-SA2v2-EURCHF-M5-43,EURCHFMT4,5004,4h 59m,Sell
120610.78,98034,02.10.2013 03:30:00,,-0.8,-353.3300000000163,0.0,0.0,98035,01.10.2013 20:30:00,9717,-0.16748346436747624,-1.08,IS,0.27,0.0,Phase3-EA-S1v2-USDJPY-M15-0,USDJPYMT4,2822,7h 0m,Buy
120635.44,1.22616,02.10.2013 05:05:00,,-1.09,-328.6700000000128,0.0,0.0,1.22559,01.10.2013 20:45:00,9718,-0.15579427230537463,24.66,IS,0.41,0.0,Phase3-EA-SA2v2-EURCHF-M5-43,EURCHFMT4,5006,8h 20m,Buy
120562.59,131556,02.10.2013 10:29:57,sl 131.556,-0.9,-401.5200000000186,0.0,0.0,132336,30.09.2013 07:30:00,9719,-0.1903262123590668,-72.85,IS,0.09,0.0,Phase3-EA-TR1v1-EURJPY-M30-91,EURJPYMT4,1694,2d 2h 59m,Buy
120620.45,1.22435,02.10.2013 11:45:00,,0.0,-343.6600000000326,0.0,0.0,1.22589,02.10.2013 03:00:00,9720,-0.16289974631231338,57.86,IS,0.34,0.0,Phase3-EA-S4v1-EURCHF-M15-221,EURCHFMT4,2520,8h 45m,Sell
120663.6,1.22541,03.10.2013 00:04:57,tp 1.22541,-6.81,-300.5100000000384,0.0,0.0,1.22651,02.10.2013 20:45:00,9721,-0.14244603027502448,43.15,IS,0.41,0.0,Phase3-EA-SA2v2-EURCHF-M5-43,EURCHFMT4,5008,3h 19m,Sell
120621.07,132912,03.10.2013 05:14:58,sl 132.912,-2.44,-343.04000000003725,0.0,0.0,132682,01.10.2013 19:15:00,9722,-0.1626058574607948,-42.53,IS,0.17,0.0,Phase3-EA-T1v2-EURJPY-M15-322,EURJPYMT4,1714,1d 9h 59m,Sell
120520.26,158555,03.10.2013 07:30:00,,0.0,-443.8500000000349,0.0,0.0,158127,03.10.2013 02:05:00,9723,-0.21039123668951615,-100.81,IS,0.23,0.0,Phase3-EA-S4v1-GBPJPY-M5-194,GBPJPYMT4,2278,5h 25m,Sell
120519.35,1.2257,03.10.2013 08:25:00,,0.0,-444.7600000000384,0.0,0.0,1.22572,03.10.2013 00:05:00,9724,-0.21082258968126602,-0.91,IS,0.41,0.0,Phase3-EA-SA2v2-EURCHF-M5-43,EURCHFMT4,5010,8h 20m,Buy
120636.7,133.2,03.10.2013 12:29:57,tp 133.200,-1.36,-327.4100000000326,0.0,0.0,131.91,02.10.2013 13:00:00,9725,-0.15519701431680957,117.35,IS,0.09,0.0,Phase3-EA-TR1v1-EURJPY-M30-91,EURJPYMT4,1696,23h 29m,Buy
120674.04,1.22652,03.10.2013 13:00:00,,0.0,-290.0700000000361,0.0,0.0,1.22553,03.10.2013 04:15:00,9726,-0.13749732122683506,37.34,IS,0.34,0.0,Phase3-EA-S4v1-EURCHF-M15-221,EURCHFMT4,2522,8h 45m,Buy
120698.35,97193,04.10.2013 02:15:00,,-1.25,-265.7600000000384,0.0,0.0,97285,03.10.2013 22:45:00,9727,-0.12597403416156247,24.31,IS,0.27,0.0,Phase3-EA-S1v2-USDJPY-M15-0,USDJPYMT4,2824,3h 30m,Sell
120790.7,156917,04.10.2013 04:04:58,tp 156.917,0.0,-173.4100000000326,0.0,0.0,157307,04.10.2013 03:25:00,9728,-0.0821988157132657,92.35,IS,0.23,0.0,Phase3-EA-S4v1-GBPJPY-M5-194,GBPJPYMT4,2280,39m 58s,Sell
120750.47,132597,04.10.2013 05:14:58,sl 132.597,0.0,-213.64000000004307,0.0,0.0,132367,04.10.2013 04:00:00,9729,-0.10126841006275489,-40.23,IS,0.17,0.0,Phase3-EA-T1v2-EURJPY-M15-322,EURJPYMT4,1716,1h 14m,Sell
120754.57,1.22468,04.10.2013 10:55:00,,0.0,-209.54000000003725,0.0,0.0,1.22459,04.10.2013 02:35:00,9730,-0.09932495152850193,4.1,IS,0.41,0.0,Phase3-EA-SA2v2-EURCHF-M5-43,EURCHFMT4,5012,8h 20m,Buy
120682.02,1.22726,07.10.2013 09:30:00,,0.0,-282.0900000000256,0.0,0.0,1.22886,07.10.2013 01:10:00,9731,-0.13371468729919192,-72.55,IS,0.41,0.0,Phase3-EA-SA2v2-EURCHF-M5-43,EURCHFMT4,5014,8h 20m,Buy
120800.92,131563,07.10.2013 10:29:57,tp 131.563,-0.64,-163.19000000003143,0.0,0.0,132853,03.10.2013 14:00:00,9732,-0.07735438980593906,118.9,IS,0.09,0.0,Phase3-EA-TR1v1-EURJPY-M30-91,EURJPYMT4,1698,3d 20h 29m,Sell
120679.15,1.22529,07.10.2013 11:45:00,,0.0,-284.96000000002095,0.0,0.0,1.22852,07.10.2013 03:00:00,9733,-0.13507510827316485,-121.77,IS,0.34,0.0,Phase3-EA-S4v1-EURCHF-M15-221,EURCHFMT4,2524,8h 45m,Buy
120630.2,97078,07.10.2013 17:15:00,,0.0,-333.9100000000326,0.0,0.0,97254,07.10.2013 01:15:00,9734,-0.15827810711501109,-48.95,IS,0.27,0.0,Phase3-EA-S1v2-USDJPY-M15-0,USDJPYMT4,2826,16h 0m,Buy
120616.86,1.22659,08.10.2013 04:30:00,,-1.09,-347.2500000000291,0.0,0.0,1.22686,07.10.2013 20:10:00,9735,-0.16460145756547226,-13.34,IS,0.41,0.0,Phase3-EA-SA2v2-EURCHF-M5-43,EURCHFMT4,5016,8h 20m,Buy
120600.55,155637,08.10.2013 05:00:00,,-0.86,-363.5600000000268,0.0,0.0,155702,07.10.2013 23:35:00,9736,-0.17233263041757374,-16.31,IS,0.23,0.0,Phase3-EA-S4v1-GBPJPY-M5-194,GBPJPYMT4,2282,5h 25m,Buy
120537.92,156.55,08.10.2013 15:29:58,sl 156.550,-0.54,-426.19000000003143,0.0,0.0,155.88,07.10.2013 02:00:00,9737,-0.20202014456393927,-62.63,IS,0.09,0.0,Phase3-EA-B1v1-GBPJPY-M30-1,GBPJPYMT4,922,1d 13h 29m,Sell
120562.73,96862,08.10.2013 23:30:00,,0.0,-401.38000000003376,0.0,0.0,96951,08.10.2013 22:15:00,9738,-0.19025985036034349,24.81,IS,0.27,0.0,Phase3-EA-S1v2-USDJPY-M15-0,USDJPYMT4,2828,1h 15m,Sell
120611.55,1.2278,09.10.2013 03:39:57,tp 1.22780,-1.09,-352.5600000000268,0.0,0.0,1.2267,08.10.2013 20:55:00,9739,-0.16711847337446348,48.82,IS,0.41,0.0,Phase3-EA-SA2v2-EURCHF-M5-43,EURCHFMT4,5018,6h 44m,Buy
120542.32,156367,09.10.2013 08:05:00,,0.0,-421.79000000003725,0.0,0.0,156074,09.10.2013 02:40:00,9740,-0.19993448174669792,-69.23,IS,0.23,0.0,Phase3-EA-S4v1-GBPJPY-M5-194,GBPJPYMT4,2284,5h 25m,Sell
120663.86,1.22989,09.10.2013 11:15:00,,0.0,-300.2500000000291,0.0,0.0,1.22664,09.10.2013 02:30:00,9741,-0.142322786563092,121.54,IS,0.34,0.0,Phase3-EA-S4v1-EURCHF-M15-221,EURCHFMT4,2526,8h 45m,Buy
120926.39,1.59496,09.10.2013 15:59:58,tp 1.59496,-2.07,-37.72000000003027,0.0,0.0,1.61386,04.10.2013 10:00:00,9742,-0.01787981851511613,262.53,IS,0.14,0.0,Phase3-EA-B1v1-GBPUSD-M30-14,GBPUSDMT4,624,5d 5h 59m,Sell
120859.81,131334,09.10.2013 17:59:58,sl 131.334,0.0,-104.30000000001746,0.0,0.0,131717,07.10.2013 11:30:00,9743,-0.04943968905422661,-66.58,IS,0.09,0.0,Phase3-EA-TR1v1-EURJPY-M30-91,EURJPYMT4,1700,2d 6h 29m,Buy
120807.23,1232,10.10.2013 05:40:00,,-6.76,-156.88000000000466,0.0,0.0,1.23098,09.10.2013 21:20:00,9744,-0.07436335972028765,-52.58,IS,0.41,0.0,Phase3-EA-SA2v2-EURCHF-M5-43,EURCHFMT4,5020,8h 20m,Sell
120786.75,155623,10.10.2013 07:35:00,,0.0,-177.36000000001513,0.0,0.0,155536,10.10.2013 02:10:00,9745,-0.08407117210601067,-20.48,IS,0.23,0.0,Phase3-EA-S4v1-GBPJPY-M5-194,GBPJPYMT4,2286,5h 25m,Sell
120781.15,1.2315,10.10.2013 12:45:00,,0.0,-182.96000000002095,0.0,0.0,1.23135,10.10.2013 04:00:00,9746,-0.08672565205523321,-5.6,IS,0.34,0.0,Phase3-EA-S4v1-EURCHF-M15-221,EURCHFMT4,2528,8h 45m,Sell
120737.68,132647,10.10.2013 16:44:58,sl 132.647,-3.67,-226.43000000002212,0.0,0.0,132417,04.10.2013 08:30:00,9747,-0.10733105266105226,-43.47,IS,0.17,0.0,Phase3-EA-T1v2-EURJPY-M15-322,EURJPYMT4,1718,6d 8h 14m,Sell
120829.1,156558,11.10.2013 01:19:58,tp 156.558,0.0,-135.0100000000093,0.0,0.0,156948,11.10.2013 00:55:00,9748,-0.06399666749003334,91.42,IS,0.23,0.0,Phase3-EA-S4v1-GBPJPY-M5-194,GBPJPYMT4,2288,24m 58s,Sell
120889.45,0.91018,11.10.2013 01:29:58,tp 0.91018,-3.37,-74.66000000000349,0.0,0.0,0.91118,10.10.2013 23:15:00,9749,-0.03538990589442103,60.35,IS,0.58,0.0,Phase3-EA-SA2v2-USDCHF-M15-107,USDCHFMT4,1870,2h 14m,Sell
120980.76,156995,11.10.2013 03:04:58,tp 156.995,0.0,-0.0,0.0,0.0,156605,11.10.2013 01:25:00,9750,-0.0,91.31,IS,0.23,0.0,Phase3-EA-S4v1-GBPJPY-M5-194,GBPJPYMT4,2290,1h 39m,Buy
121096.09,133007,11.10.2013 03:59:57,tp 133.007,-2.73,-0.0,0.0,0.0,132054,09.10.2013 07:30:00,9751,-0.0,115.33,IS,0.09,0.0,Phase3-EA-TR1v1-EURJPY-M30-91,EURJPYMT4,1701,1d 20h 29m,Buy
121121.58,1.23277,11.10.2013 06:10:00,,-1.08,-0.0,0.0,0.0,1.23218,10.10.2013 21:50:00,9752,-0.0,25.49,IS,0.41,0.0,Phase3-EA-SA2v2-EURCHF-M5-43,EURCHFMT4,5022,8h 20m,Buy
121120.09,1.23177,11.10.2013 10:30:00,,0.0,-1.4899999999906868,0.0,0.0,1.23181,11.10.2013 01:45:00,9753,-7.057544756867936E-4,-1.49,IS,0.34,0.0,Phase3-EA-S4v1-EURCHF-M15-221,EURCHFMT4,2530,8h 45m,Buy
121234.99,133593,11.10.2013 12:29:58,tp 133.593,-0.45,-0.0,0.0,0.0,132333,10.10.2013 15:00:00,9754,-0.0,114.9,IS,0.09,0.0,Phase3-EA-TR1v1-EURJPY-M30-91,EURJPYMT4,1703,21h 29m,Buy
121282.23,1.23369,14.10.2013 01:00:00,tp 1.23369,-2.25,-0.0,0.0,0.0,1.23479,11.10.2013 20:10:00,9755,-0.0,47.24,IS,0.41,0.0,Phase3-EA-SA2v2-EURCHF-M5-43,EURCHFMT4,5024,2d 4h 50m,Sell
121342.43,133233,14.10.2013 03:30:00,,-0.85,-0.0,0.0,0.0,132.88,11.10.2013 03:00:00,9756,-0.0,60.2,IS,0.17,0.0,Phase3-EA-T1v2-EURJPY-M15-322,EURJPYMT4,1720,3d 0h 30m,Buy
121317.56,0.90959,14.10.2013 06:30:00,,0.0,-24.869999999995343,0.0,0.0,0.90998,14.10.2013 02:15:00,9757,-0.011767632273365617,-24.87,IS,0.58,0.0,Phase3-EA-SA2v2-USDCHF-M15-107,USDCHFMT4,1872,4h 15m,Buy
121339.19,1.23392,14.10.2013 09:40:00,,0.0,-3.2399999999906868,0.0,0.0,1.23344,14.10.2013 01:20:00,9758,-0.0015330570392280717,21.63,IS,0.41,0.0,Phase3-EA-SA2v2-EURCHF-M5-43,EURCHFMT4,5026,8h 20m,Buy
121389.96,1.23509,14.10.2013 10:15:00,,0.0,-0.0,0.0,0.0,1.23373,14.10.2013 01:30:00,9759,-0.0,50.77,IS,0.34,0.0,Phase3-EA-S4v1-EURCHF-M15-221,EURCHFMT4,2532,8h 45m,Buy
121557.9,157686,15.10.2013 00:29:58,tp 157.686,-0.99,-0.0,0.0,0.0,155836,10.10.2013 09:00:00,9760,-0.0,167.94,IS,0.09,0.0,Phase3-EA-B1v1-GBPJPY-M30-1,GBPJPYMT4,924,4d 15h 29m,Buy
121462.87,0.91129,15.10.2013 02:45:00,,-3.38,-95.02999999999884,0.0,0.0,0.90985,14.10.2013 22:30:00,9761,-0.044919145066196084,-95.03,IS,0.58,0.0,Phase3-EA-SA2v2-USDCHF-M15-107,USDCHFMT4,1874,4h 15m,Sell
121428.21,1.23482,15.10.2013 04:40:00,,-2.25,-129.69000000000233,0.0,0.0,1.2341,14.10.2013 20:20:00,9762,-0.06130236686977951,-34.66,IS,0.41,0.0,Phase3-EA-SA2v2-EURCHF-M5-43,EURCHFMT4,5028,8h 20m,Sell
121404.03,1.23579,15.10.2013 12:15:00,,0.0,-153.86999999999534,0.0,0.0,1.23514,15.10.2013 03:30:00,9763,-0.07273186205761831,-24.18,IS,0.34,0.0,Phase3-EA-S4v1-EURCHF-M15-221,EURCHFMT4,2534,8h 45m,Sell
121342.92,156999,15.10.2013 13:59:58,sl 156.999,0.0,-214.97999999998137,0.0,0.0,157669,15.10.2013 00:30:00,9764,-0.10161757135988758,-61.11,IS,0.09,0.0,Phase3-EA-B1v1-GBPJPY-M30-1,GBPJPYMT4,926,13h 29m,Buy
121276.8,132961,15.10.2013 13:59:58,sl 132.961,-0.45,-281.0999999999767,0.0,0.0,133277,11.10.2013 15:30:00,9765,-0.13287142668743374,-66.12,IS,0.09,0.0,Phase3-EA-TR1v1-EURJPY-M30-91,EURJPYMT4,1706,3d 22h 29m,Sell
121325.08,1.23574,16.10.2013 03:09:57,tp 1.23574,-1.08,-232.81999999997788,0.0,0.0,1.23464,15.10.2013 21:45:00,9766,-0.11005025101874048,48.28,IS,0.41,0.0,Phase3-EA-SA2v2-EURCHF-M5-43,EURCHFMT4,5030,5h 24m,Buy
121282.55,1.59655,16.10.2013 04:59:57,sl 1.59655,-0.53,-275.3499999999767,0.0,0.0,1.59955,15.10.2013 21:30:00,9767,-0.13015349462250025,-42.53,IS,0.14,0.0,Phase3-EA-B1v1-GBPUSD-M30-14,GBPUSDMT4,626,7h 29m,Buy
121321.09,157298,16.10.2013 08:30:00,,0.0,-236.80999999996857,0.0,0.0,157463,16.10.2013 03:05:00,9768,-0.11193625952988123,38.54,IS,0.23,0.0,Phase3-EA-S4v1-GBPJPY-M5-194,GBPJPYMT4,2292,5h 25m,Sell
121365.01,1.23529,16.10.2013 09:45:00,,0.0,-192.88999999995576,0.0,0.0,1.23411,16.10.2013 01:00:00,9769,-0.09117598539215703,43.92,IS,0.34,0.0,Phase3-EA-S4v1-EURCHF-M15-221,EURCHFMT4,2536,8h 45m,Buy
121403.87,98.86,17.10.2013 01:45:00,,-2.38,-154.02999999996973,0.0,0.0,98709,16.10.2013 20:30:00,9770,-0.07280749147158695,38.86,IS,0.27,0.0,Phase3-EA-S1v2-USDJPY-M15-0,USDJPYMT4,2830,5h 15m,Buy
121467.39,0.91304,17.10.2013 03:59:58,tp 0.91304,0.0,-90.50999999998021,0.0,0.0,0.91404,17.10.2013 02:00:00,9771,-0.04278261412123086,63.52,IS,0.58,0.0,Phase3-EA-SA2v2-USDCHF-M15-107,USDCHFMT4,1876,1h 59m,Sell
121474.38,157622,17.10.2013 06:40:00,,0.0,-83.51999999998952,0.0,0.0,157652,17.10.2013 01:15:00,9772,-0.03947855409795088,6.99,IS,0.23,0.0,Phase3-EA-S4v1-GBPJPY-M5-194,GBPJPYMT4,2294,5h 25m,Sell
121430.32,1.59979,17.10.2013 09:29:57,sl 1.59979,-2.06,-127.5799999999872,0.0,0.0,1.59679,16.10.2013 17:30:00,9773,-0.0603050039729011,-44.06,IS,0.14,0.0,Phase3-EA-B1v1-GBPUSD-M30-14,GBPUSDMT4,628,15h 59m,Sell
121420.94,97826,17.10.2013 17:15:00,,0.0,-136.95999999999185,0.0,0.0,97792,17.10.2013 17:00:00,9774,-0.06473877836752526,-9.38,IS,0.27,0.0,Phase3-EA-S1v2-USDJPY-M15-0,USDJPYMT4,2832,15m 0s,Sell
121347.06,134057,18.10.2013 03:59:58,sl 134.057,-2.24,-210.8399999999965,0.0,0.0,133681,14.10.2013 22:30:00,9775,-0.0996606602731426,-73.88,IS,0.09,0.0,Phase3-EA-TR1v1-EURJPY-M30-91,EURJPYMT4,1707,3d 5h 29m,Buy
121323.94,0.90328,18.10.2013 06:15:00,,0.0,-233.95999999999185,0.0,0.0,0.90292,18.10.2013 02:00:00,9776,-0.11058911059335998,-23.12,IS,0.58,0.0,Phase3-EA-SA2v2-USDCHF-M15-107,USDCHFMT4,1878,4h 15m,Sell
121298.97,1.23411,18.10.2013 06:40:00,,-2.27,-258.929999999993,0.0,0.0,1.23361,17.10.2013 22:20:00,9777,-0.12239202601273262,-24.97,IS,0.41,0.0,Phase3-EA-SA2v2-EURCHF-M5-43,EURCHFMT4,5032,8h 20m,Sell
121296.62,158339,18.10.2013 06:55:00,,0.0,-261.27999999999884,0.0,0.0,158329,18.10.2013 01:30:00,9778,-0.12350283303057777,-2.35,IS,0.23,0.0,Phase3-EA-S4v1-GBPJPY-M5-194,GBPJPYMT4,2296,5h 25m,Sell
121276.26,1.23485,18.10.2013 12:00:00,,0.0,-281.63999999998487,0.0,0.0,1.23431,18.10.2013 03:15:00,9779,-0.13312667595962266,-20.36,IS,0.34,0.0,Phase3-EA-S4v1-EURCHF-M15-221,EURCHFMT4,2538,8h 45m,Sell
121236.27,133797,18.10.2013 12:59:59,sl 133.797,0.0,-321.62999999997555,0.0,0.0,134027,18.10.2013 08:45:00,9780,-0.15202930261643405,-39.99,IS,0.17,0.0,Phase3-EA-T1v2-EURJPY-M15-322,EURJPYMT4,1722,4h 14m,Buy
121199.2,97953,21.10.2013 01:00:00,,-1.24,-358.69999999998254,0.0,0.0,97823,18.10.2013 17:00:00,9781,-0.16955169246810428,-37.07,IS,0.27,0.0,Phase3-EA-S1v2-USDJPY-M15-0,USDJPYMT4,2834,2d 8h 0m,Sell
121214.44,0.90207,21.10.2013 02:15:00,,-3.41,-343.45999999999185,0.0,0.0,0.90236,18.10.2013 22:00:00,9782,-0.16234799078644144,15.24,IS,0.58,0.0,Phase3-EA-SA2v2-USDCHF-M15-107,USDCHFMT4,1880,2d 4h 15m,Sell
121263.29,1235,21.10.2013 03:44:58,tp 1.23500,-1.09,-294.60999999998603,0.0,0.0,1.2339,18.10.2013 20:25:00,9783,-0.13925738533043844,48.85,IS,0.41,0.0,Phase3-EA-SA2v2-EURCHF-M5-43,EURCHFMT4,5034,2d 7h 19m,Buy
121255.08,158503,21.10.2013 08:40:00,,0.0,-302.8199999999779,0.0,0.0,158468,21.10.2013 03:15:00,9784,-0.14313811963532225,-8.21,IS,0.23,0.0,Phase3-EA-S4v1-GBPJPY-M5-194,GBPJPYMT4,2298,5h 25m,Sell
121236.63,1.2354,21.10.2013 12:45:00,,0.0,-321.2699999999895,0.0,0.0,1.23491,21.10.2013 04:00:00,9785,-0.15185913643498394,-18.45,IS,0.34,0.0,Phase3-EA-S4v1-EURCHF-M15-221,EURCHFMT4,2540,8h 45m,Sell
121194.1,1.6138,21.10.2013 15:29:58,sl 1.61380,-0.53,-363.79999999998836,0.0,0.0,1.6168,18.10.2013 09:30:00,9786,-0.1719623800387437,-42.53,IS,0.14,0.0,Phase3-EA-B1v1-GBPUSD-M30-14,GBPUSDMT4,630,3d 5h 59m,Buy
121244.16,1.23351,21.10.2013 20:49:57,tp 1.23351,0.0,-313.7399999999907,0.0,0.0,1.23241,21.10.2013 20:15:00,9787,-0.14829982713951503,50.06,IS,0.41,0.0,Phase3-EA-SA2v2-EURCHF-M5-43,EURCHFMT4,5036,34m 57s,Buy
121219.54,0.90239,22.10.2013 02:45:00,,-3.41,-338.35999999998603,0.0,0.0,0.90206,21.10.2013 22:30:00,9788,-0.15993730321580202,-24.62,IS,0.58,0.0,Phase3-EA-SA2v2-USDCHF-M15-107,USDCHFMT4,1882,4h 15m,Sell
121170.97,1.23448,22.10.2013 05:15:00,,-2.27,-386.929999999993,0.0,0.0,1.23346,21.10.2013 20:55:00,9789,-0.18289555719733927,-48.57,IS,0.41,0.0,Phase3-EA-SA2v2-EURCHF-M5-43,EURCHFMT4,5038,8h 20m,Sell
121201.62,158499,22.10.2013 07:50:00,,0.0,-356.27999999999884,0.0,0.0,158368,22.10.2013 02:25:00,9790,-0.168407797581653,30.65,IS,0.23,0.0,Phase3-EA-S4v1-GBPJPY-M5-194,GBPJPYMT4,2300,5h 25m,Buy
121175.27,1.23465,22.10.2013 10:15:00,,0.0,-382.63000000000466,0.0,0.0,1.23395,22.10.2013 01:30:00,9791,-0.1808630166966119,-26.35,IS,0.34,0.0,Phase3-EA-S4v1-EURCHF-M15-221,EURCHFMT4,2542,8h 45m,Sell
121103.21,134734,22.10.2013 15:59:58,sl 134.734,-0.64,-454.6900000000023,0.0,0.0,133954,18.10.2013 07:00:00,9792,-0.21492461401819482,-72.06,IS,0.09,0.0,Phase3-EA-TR1v1-EURJPY-M30-91,EURJPYMT4,1710,4d 8h 59m,Sell
121094.54,98124,23.10.2013 03:45:00,,-1.24,-463.36000000001513,0.0,0.0,98097,22.10.2013 23:15:00,9793,-0.21902278288828322,-8.67,IS,0.27,0.0,Phase3-EA-S1v2-USDJPY-M15-0,USDJPYMT4,2836,4h 30m,Sell
121060.64,1.23251,23.10.2013 08:30:00,,0.0,-497.2600000000093,0.0,0.0,1.23325,23.10.2013 00:10:00,9794,-0.23504676497545363,-33.9,IS,0.41,0.0,Phase3-EA-SA2v2-EURCHF-M5-43,EURCHFMT4,5040,8h 20m,Buy
121179.53,133858,23.10.2013 11:29:58,tp 133.858,-0.32,-378.36999999999534,0.0,0.0,135148,22.10.2013 18:30:00,9795,-0.1788493835493698,118.89,IS,0.09,0.0,Phase3-EA-TR1v1-EURJPY-M30-91,EURJPYMT4,1712,16h 59m,Sell
121300.05,1.23017,23.10.2013 14:45:00,,0.0,-257.8500000000058,0.0,0.0,1.23334,23.10.2013 06:00:00,9796,-0.12188152746836856,120.52,IS,0.34,0.0,Phase3-EA-S4v1-EURCHF-M15-221,EURCHFMT4,2544,8h 45m,Sell
121236.48,157717,24.10.2013 05:29:58,sl 157.717,-1.61,-321.4200000000128,0.0,0.0,157047,23.10.2013 13:00:00,9797,-0.1519300390106019,-63.57,IS,0.09,0.0,Phase3-EA-B1v1-GBPJPY-M30-1,GBPJPYMT4,928,16h 29m,Sell
121237.24,1.22959,24.10.2013 12:45:00,,0.0,-320.6600000000035,0.0,0.0,1.22961,24.10.2013 04:00:00,9798,-0.1515707992941889,0.76,IS,0.34,0.0,Phase3-EA-S4v1-EURCHF-M15-221,EURCHFMT4,2546,8h 45m,Sell
121195.24,1.61451,24.10.2013 15:59:58,sl 1.61451,0.0,-362.6600000000035,0.0,0.0,1.61751,24.10.2013 04:30:00,9799,-0.17142352046413795,-42.0,IS,0.14,0.0,Phase3-EA-B1v1-GBPUSD-M30-14,GBPUSDMT4,632,11h 29m,Buy
121180.09,0.89231,25.10.2013 02:45:00,,-3.45,-377.8099999999977,0.0,0.0,0.89213,24.10.2013 22:30:00,9800,-0.17858468060043825,-15.15,IS,0.58,0.0,Phase3-EA-SA2v2-USDCHF-M15-107,USDCHFMT4,1884,4h 15m,Sell
121272.32,157.35,25.10.2013 03:44:58,tp 157.350,0.0,-285.5799999999872,0.0,0.0,157.74,25.10.2013 01:40:00,9801,-0.13498905027889993,92.23,IS,0.23,0.0,Phase3-EA-S4v1-GBPJPY-M5-194,GBPJPYMT4,2302,2h 4m,Sell
121299.89,1.23088,25.10.2013 04:25:00,,-2.3,-258.0099999999802,0.0,0.0,1.23153,24.10.2013 20:05:00,9802,-0.12195715688233721,27.57,IS,0.41,0.0,Phase3-EA-SA2v2-EURCHF-M5-43,EURCHFMT4,5042,8h 20m,Sell
121409.79,1.23375,25.10.2013 14:00:00,,0.0,-148.10999999998603,0.0,0.0,1.23086,25.10.2013 05:15:00,9803,-0.0700092031543066,109.9,IS,0.34,0.0,Phase3-EA-S4v1-EURCHF-M15-221,EURCHFMT4,2548,8h 45m,Buy
121369.68,134484,25.10.2013 19:29:58,sl 134.484,0.0,-188.21999999997206,0.0,0.0,134254,25.10.2013 03:30:00,9804,-0.08896855187160135,-40.11,IS,0.17,0.0,Phase3-EA-T1v2-EURJPY-M15-322,EURJPYMT4,1724,15h 59m,Sell
121385.8,0.89253,28.10.2013 02:30:00,,-0.78,-172.09999999997672,0.0,0.0,0.89227,25.10.2013 22:15:00,9805,-0.08134888841304215,16.12,IS,0.58,0.0,Phase3-EA-SA2v2-USDCHF-M15-107,USDCHFMT4,1886,2d 4h 15m,Buy
121317.77,134815,28.10.2013 04:29:57,sl 134.815,-1.61,-240.12999999997555,0.0,0.0,134095,23.10.2013 09:00:00,9806,-0.11350556986998526,-68.03,IS,0.09,0.0,Phase3-EA-TR1v1-EURJPY-M30-91,EURJPYMT4,1713,4d 19h 29m,Sell
121367.17,1.23324,28.10.2013 06:14:57,tp 1.23324,-1.1,-190.72999999998137,0.0,0.0,1.23214,25.10.2013 22:35:00,9807,-0.0901549883034289,49.4,IS,0.41,0.0,Phase3-EA-SA2v2-EURCHF-M5-43,EURCHFMT4,5044,2d 7h 39m,Buy
121413.99,1.23342,28.10.2013 11:00:00,,0.0,-143.9099999999744,0.0,0.0,1.23219,28.10.2013 02:15:00,9808,-0.0680239310373062,46.82,IS,0.34,0.0,Phase3-EA-S4v1-EURCHF-M15-221,EURCHFMT4,2550,8h 45m,Buy
121369.6,1.23539,29.10.2013 04:50:00,,-2.29,-188.29999999998836,0.0,0.0,1.23447,28.10.2013 20:30:00,9809,-0.08900636657859944,-44.39,IS,0.41,0.0,Phase3-EA-SA2v2-EURCHF-M5-43,EURCHFMT4,5046,8h 20m,Sell
121328.82,157145,29.10.2013 08:50:00,,0.0,-229.0799999999872,0.0,0.0,157318,29.10.2013 03:25:00,9810,-0.10828241346694466,-40.78,IS,0.23,0.0,Phase3-EA-S4v1-GBPJPY-M5-194,GBPJPYMT4,2304,5h 25m,Buy
121294.71,1.23572,29.10.2013 11:45:00,,0.0,-263.1899999999732,0.0,0.0,1.23482,29.10.2013 03:00:00,9811,-0.12440565915996096,-34.11,IS,0.34,0.0,Phase3-EA-S4v1-EURCHF-M15-221,EURCHFMT4,2552,8h 45m,Sell
121301.86,98194,30.10.2013 03:00:00,,0.0,-256.03999999997905,0.0,0.0,98168,30.10.2013 00:45:00,9812,-0.12102596972269858,7.15,IS,0.27,0.0,Phase3-EA-S1v2-USDJPY-M15-0,USDJPYMT4,2838,2h 15m,Buy
121350.88,1.23657,30.10.2013 03:14:58,tp 1.23657,-1.09,-207.01999999998952,0.0,0.0,1.23547,29.10.2013 22:05:00,9813,-0.0978550080143487,49.02,IS,0.41,0.0,Phase3-EA-SA2v2-EURCHF-M5-43,EURCHFMT4,5048,5h 9m,Buy
121385.71,1.23561,30.10.2013 12:45:00,,0.0,-172.19000000000233,0.0,0.0,1.23653,30.10.2013 04:00:00,9814,-0.08139142995841843,34.83,IS,0.34,0.0,Phase3-EA-S4v1-EURCHF-M15-221,EURCHFMT4,2554,8h 45m,Sell
121435.91,1235,30.10.2013 21:14:58,tp 1.23500,0.0,-121.98999999999069,0.0,0.0,1.2339,30.10.2013 20:00:00,9815,-0.05766270132195001,50.2,IS,0.41,0.0,Phase3-EA-SA2v2-EURCHF-M5-43,EURCHFMT4,5050,1h 14m,Buy
121471.7,135188,31.10.2013 03:45:00,,-2.54,-86.19999999998254,0.0,0.0,134966,30.10.2013 09:45:00,9816,-0.04074534678212528,35.79,IS,0.17,0.0,Phase3-EA-T1v2-EURJPY-M15-322,EURJPYMT4,1726,18h 0m,Buy
121486.74,1.23521,31.10.2013 05:50:00,,-6.84,-71.15999999997439,0.0,0.0,1.23569,30.10.2013 21:30:00,9817,-0.03363618186793015,15.04,IS,0.41,0.0,Phase3-EA-SA2v2-EURCHF-M5-43,EURCHFMT4,5052,8h 20m,Sell
121449.37,157757,31.10.2013 06:30:00,,0.0,-108.52999999996973,0.0,0.0,157917,31.10.2013 01:05:00,9818,-0.051300376870808816,-37.37,IS,0.23,0.0,Phase3-EA-S4v1-GBPJPY-M5-194,GBPJPYMT4,2306,5h 25m,Buy
121484.84,1.2344,31.10.2013 11:00:00,,0.0,-73.05999999996857,0.0,0.0,1.23534,31.10.2013 02:15:00,9819,-0.0345342811589489,35.47,IS,0.34,0.0,Phase3-EA-S4v1-EURCHF-M15-221,EURCHFMT4,2556,8h 45m,Sell
121416.63,134071,31.10.2013 14:59:58,sl 134.071,-2.24,-141.26999999996042,0.0,0.0,134791,28.10.2013 07:00:00,9820,-0.06677604570661708,-68.21,IS,0.09,0.0,Phase3-EA-TR1v1-EURJPY-M30-91,EURJPYMT4,1716,3d 7h 59m,Buy
121466.41,1.23197,31.10.2013 22:29:58,tp 1.23197,0.0,-91.48999999996158,0.0,0.0,1.23087,31.10.2013 20:10:00,9821,-0.0432458442818542,49.78,IS,0.41,0.0,Phase3-EA-SA2v2-EURCHF-M5-43,EURCHFMT4,5054,2h 19m,Buy
121438.73,0.90735,01.11.2013 03:00:00,,-3.39,-119.1699999999546,0.0,0.0,0.90697,31.10.2013 22:45:00,9822,-0.05632973290052209,-27.68,IS,0.58,0.0,Phase3-EA-SA2v2-USDCHF-M15-107,USDCHFMT4,1888,4h 15m,Sell
121486.17,1.23077,01.11.2013 03:44:57,tp 1.23077,-2.26,-71.72999999995227,0.0,0.0,1.23187,31.10.2013 22:35:00,9823,-0.033905611655226146,47.44,IS,0.41,0.0,Phase3-EA-SA2v2-EURCHF-M5-43,EURCHFMT4,5056,5h 9m,Sell
121601.31,132743,01.11.2013 06:59:57,tp 132.743,-0.32,-0.0,0.0,0.0,134003,31.10.2013 15:00:00,9824,-0.0,115.14,IS,0.09,0.0,Phase3-EA-TR1v1-EURJPY-M30-91,EURJPYMT4,1718,15h 59m,Sell
121454.54,156975,01.11.2013 09:00:00,,0.0,-146.76999999998952,0.0,0.0,157.6,01.11.2013 03:35:00,9825,-0.0693615743683195,-146.77,IS,0.23,0.0,Phase3-EA-S4v1-GBPJPY-M5-194,GBPJPYMT4,2308,5h 25m,Buy
121531.38,1.23033,01.11.2013 10:45:00,,0.0,-69.92999999999302,0.0,0.0,1.23238,01.11.2013 02:00:00,9826,-0.033047999561057737,76.84,IS,0.34,0.0,Phase3-EA-S4v1-EURCHF-M15-221,EURCHFMT4,2558,8h 45m,Sell
121488.85,1.60099,01.11.2013 10:59:58,sl 1.60099,-0.53,-112.45999999999185,0.0,0.0,1.60399,31.10.2013 15:30:00,9827,-0.05314711898522315,-42.53,IS,0.14,0.0,Phase3-EA-B1v1-GBPUSD-M30-14,GBPUSDMT4,634,19h 29m,Buy
121508.0,98835,04.11.2013 06:15:00,,-0.79,-93.30999999999767,0.0,0.0,98762,01.11.2013 23:00:00,9828,-0.04409708049538866,19.15,IS,0.27,0.0,Phase3-EA-S1v2-USDJPY-M15-0,USDJPYMT4,2840,2d 7h 15m,Buy
121495.86,1.23081,04.11.2013 10:25:00,,0.0,-105.45000000001164,0.0,0.0,1.23108,04.11.2013 02:05:00,9829,-0.04983428505239913,-12.14,IS,0.41,0.0,Phase3-EA-SA2v2-EURCHF-M5-43,EURCHFMT4,5058,8h 20m,Buy
121482.08,133175,05.11.2013 04:15:00,,-0.84,-119.23000000001048,0.0,0.0,133.25,04.11.2013 18:45:00,9830,-0.056346532070150925,-13.78,IS,0.17,0.0,Phase3-EA-T1v2-EURJPY-M15-322,EURJPYMT4,1728,9h 30m,Buy
121455.33,1.2297,05.11.2013 04:55:00,,-1.08,-145.98000000001048,0.0,0.0,1.23027,04.11.2013 20:35:00,9831,-0.06898823074394447,-26.75,IS,0.41,0.0,Phase3-EA-SA2v2-EURCHF-M5-43,EURCHFMT4,5060,8h 20m,Buy
121545.15,157118,05.11.2013 04:59:58,tp 157.118,-1.35,-56.16000000000349,0.0,0.0,157508,04.11.2013 23:50:00,9832,-0.02654047841197345,89.82,IS,0.23,0.0,Phase3-EA-S4v1-GBPJPY-M5-194,GBPJPYMT4,2310,5h 9m,Sell
121524.76,0.91037,05.11.2013 06:00:00,,0.0,-76.55000000001746,0.0,0.0,0.91005,05.11.2013 01:45:00,9833,-0.036176524616041754,-20.39,IS,0.58,0.0,Phase3-EA-SA2v2-USDCHF-M15-107,USDCHFMT4,1890,4h 15m,Sell
121466.81,1.23095,06.11.2013 06:10:00,,-2.24,-134.5000000000291,0.0,0.0,1.22971,05.11.2013 21:50:00,9834,-0.06356293351871402,-57.95,IS,0.41,0.0,Phase3-EA-SA2v2-EURCHF-M5-43,EURCHFMT4,5062,8h 20m,Sell
121427.11,132891,06.11.2013 06:14:58,sl 132.891,0.0,-174.20000000004075,0.0,0.0,132661,06.11.2013 03:00:00,9835,-0.08232463211122808,-39.7,IS,0.17,0.0,Phase3-EA-T1v2-EURJPY-M15-322,EURJPYMT4,1730,3h 14m,Sell
121470.63,98715,06.11.2013 06:45:00,,-0.79,-130.68000000005122,0.0,0.0,98553,05.11.2013 23:45:00,9836,-0.06175765168942013,43.52,IS,0.27,0.0,Phase3-EA-S1v2-USDJPY-M15-0,USDJPYMT4,2842,7h 0m,Buy
121466.15,1.23083,06.11.2013 10:00:00,,0.0,-135.1600000000617,0.0,0.0,1.23071,06.11.2013 01:15:00,9837,-0.06387484085049405,-4.48,IS,0.34,0.0,Phase3-EA-S4v1-EURCHF-M15-221,EURCHFMT4,2560,8h 45m,Sell
121399.46,133468,06.11.2013 17:59:58,sl 133.468,-0.96,-201.85000000006403,0.0,0.0,132748,01.11.2013 07:00:00,9838,-0.09539165896471166,-66.69,IS,0.09,0.0,Phase3-EA-TR1v1-EURJPY-M30-91,EURJPYMT4,1720,5d 10h 59m,Sell
121456.56,133305,07.11.2013 02:00:00,,-2.53,-144.7500000000582,0.0,0.0,132959,06.11.2013 06:30:00,9839,-0.06840694889840568,57.1,IS,0.17,0.0,Phase3-EA-T1v2-EURJPY-M15-322,EURJPYMT4,1732,19h 30m,Buy
121474.1,1.23223,07.11.2013 07:25:00,,-6.75,-127.21000000005006,0.0,0.0,1.23277,06.11.2013 23:05:00,9840,-0.06011777526332374,17.54,IS,0.41,0.0,Phase3-EA-SA2v2-EURCHF-M5-43,EURCHFMT4,5064,8h 20m,Sell
121434.48,133176,07.11.2013 15:59:57,sl 133.176,0.0,-166.8300000000454,0.0,0.0,133406,07.11.2013 08:45:00,9841,-0.07884166690652529,-39.62,IS,0.17,0.0,Phase3-EA-T1v2-EURJPY-M15-322,EURJPYMT4,1734,7h 14m,Buy
121551.21,132164,07.11.2013 15:59:58,tp 132.164,-0.96,-50.100000000034925,0.0,0.0,133454,06.11.2013 22:00:00,9842,-0.023676602002149466,116.73,IS,0.09,0.0,Phase3-EA-TR1v1-EURJPY-M30-91,EURJPYMT4,1722,17h 59m,Sell
121600.52,1.22972,07.11.2013 22:49:57,tp 1.22972,0.0,-0.7900000000372529,0.0,0.0,1.22862,07.11.2013 22:10:00,9843,-3.733436244025362E-4,49.31,IS,0.41,0.0,Phase3-EA-SA2v2-EURCHF-M5-43,EURCHFMT4,5066,39m 57s,Buy
121582.16,0.91629,08.11.2013 04:45:00,,0.0,-19.150000000023283,0.0,0.0,916,08.11.2013 00:30:00,9844,-0.009050038489848254,-18.36,IS,0.58,0.0,Phase3-EA-SA2v2-USDCHF-M15-107,USDCHFMT4,1892,4h 15m,Sell
121631.32,1.23048,08.11.2013 05:39:57,tp 1.23048,0.0,-0.0,0.0,0.0,1.22938,08.11.2013 02:05:00,9845,-0.0,49.16,IS,0.41,0.0,Phase3-EA-SA2v2-EURCHF-M5-43,EURCHFMT4,5068,3h 34m,Buy
121638.2,98106,08.11.2013 07:15:00,,0.0,-0.0,0.0,0.0,98131,08.11.2013 01:45:00,9846,-0.0,6.88,IS,0.27,0.0,Phase3-EA-S1v2-USDJPY-M15-0,USDJPYMT4,2844,5h 30m,Sell
121631.52,1.23013,08.11.2013 14:45:00,,0.0,-6.679999999993015,0.0,0.0,1.22995,08.11.2013 06:00:00,9847,-0.0031563300009133316,-6.68,IS,0.34,0.0,Phase3-EA-S4v1-EURCHF-M15-221,EURCHFMT4,2562,8h 45m,Sell
121591.11,0.92284,11.11.2013 02:45:00,,-3.33,-47.08999999999651,0.0,0.0,0.92225,08.11.2013 22:30:00,9848,-0.022250236488495986,-40.41,IS,0.58,0.0,Phase3-EA-SA2v2-USDCHF-M15-107,USDCHFMT4,1894,2d 4h 15m,Sell
121613.24,158523,11.11.2013 04:40:00,,-1.35,-24.95999999999185,0.0,0.0,158624,08.11.2013 23:15:00,9849,-0.011793712099229553,22.13,IS,0.23,0.0,Phase3-EA-S4v1-GBPJPY-M5-194,GBPJPYMT4,2312,2d 5h 25m,Sell
121602.57,1.23187,11.11.2013 05:20:00,,-2.22,-35.63000000000466,0.0,0.0,1.23168,08.11.2013 21:00:00,9850,-0.01683533501986142,-10.67,IS,0.41,0.0,Phase3-EA-SA2v2-EURCHF-M5-43,EURCHFMT4,5070,2d 8h 20m,Sell
121719.32,132.87,11.11.2013 13:29:58,tp 132.870,-0.44,-0.0,0.0,0.0,131.58,08.11.2013 07:30:00,9851,-0.0,116.75,IS,0.09,0.0,Phase3-EA-TR1v1-EURJPY-M30-91,EURJPYMT4,1724,3d 5h 59m,Buy
121711.75,1.23336,12.11.2013 05:45:00,,-2.23,-7.570000000006985,0.0,0.0,1.23324,11.11.2013 21:25:00,9852,-0.0035754885288725286,-7.57,IS,0.41,0.0,Phase3-EA-SA2v2-EURCHF-M5-43,EURCHFMT4,5072,8h 20m,Sell
121666.03,1.59409,12.11.2013 11:59:58,sl 1.59409,-3.72,-53.29000000000815,0.0,0.0,1.59709,05.11.2013 03:00:00,9853,-0.025170116737578647,-45.72,IS,0.14,0.0,Phase3-EA-B1v1-GBPUSD-M30-14,GBPUSDMT4,636,7d 8h 59m,Buy
121701.85,1.23232,12.11.2013 15:00:00,,0.0,-17.470000000001164,0.0,0.0,1.23329,12.11.2013 06:15:00,9854,-0.008251490700046183,35.82,IS,0.34,0.0,Phase3-EA-S4v1-EURCHF-M15-221,EURCHFMT4,2564,8h 45m,Sell
121815.1,133728,12.11.2013 16:29:58,tp 133.728,-0.44,-0.0,0.0,0.0,132468,11.11.2013 02:00:00,9855,-0.0,113.25,IS,0.09,0.0,Phase3-EA-TR1v1-EURJPY-M30-91,EURJPYMT4,1725,1d 14h 29m,Buy
121905.69,133857,13.11.2013 02:15:00,,-0.84,-0.0,0.0,0.0,133321,12.11.2013 04:15:00,9856,-0.0,90.59,IS,0.17,0.0,Phase3-EA-T1v2-EURJPY-M15-322,EURJPYMT4,1736,22h 0m,Buy
121877.52,133741,13.11.2013 04:15:00,,0.0,-28.170000000012806,0.0,0.0,133906,13.11.2013 02:45:00,9857,-0.013293649641976376,-28.17,IS,0.17,0.0,Phase3-EA-T1v2-EURJPY-M15-322,EURJPYMT4,1738,1h 30m,Buy
121879.32,1.23256,13.11.2013 05:25:00,,-2.23,-26.370000000024447,0.0,0.0,1.23265,12.11.2013 21:05:00,9858,-0.012444215160066833,1.8,IS,0.41,0.0,Phase3-EA-SA2v2-EURCHF-M5-43,EURCHFMT4,5074,8h 20m,Sell
121914.89,1.23191,13.11.2013 15:30:00,,0.0,-0.0,0.0,0.0,1.23287,13.11.2013 06:45:00,9859,-0.0,35.57,IS,0.34,0.0,Phase3-EA-S4v1-EURCHF-M15-221,EURCHFMT4,2566,8h 45m,Sell
121918.93,1.23202,14.11.2013 06:20:00,,-6.72,-0.0,0.0,0.0,1.23226,13.11.2013 22:00:00,9860,-0.0,4.04,IS,0.41,0.0,Phase3-EA-SA2v2-EURCHF-M5-43,EURCHFMT4,5076,8h 20m,Sell
121894.44,1.23313,14.11.2013 12:15:00,,0.0,-24.489999999990687,0.0,0.0,1.23247,14.11.2013 03:30:00,9861,-0.01155630598927169,-24.49,IS,0.34,0.0,Phase3-EA-S4v1-EURCHF-M15-221,EURCHFMT4,2568,8h 45m,Sell
121822.89,134583,14.11.2013 12:59:57,sl 134.583,-1.27,-96.03999999997905,0.0,0.0,133803,12.11.2013 20:00:00,9862,-0.0453192171175922,-71.55,IS,0.09,0.0,Phase3-EA-TR1v1-EURJPY-M30-91,EURJPYMT4,1728,1d 16h 59m,Sell
121872.8,100072,14.11.2013 17:30:00,,0.0,-46.12999999997555,0.0,0.0,99887,14.11.2013 17:00:00,9863,-0.021767758076154484,49.91,IS,0.27,0.0,Phase3-EA-S1v2-USDJPY-M15-0,USDJPYMT4,2846,30m 0s,Buy
121808.46,1.23457,15.11.2013 06:20:00,,-2.24,-110.46999999997206,0.0,0.0,1.23318,14.11.2013 22:00:00,9864,-0.052128424770723,-64.34,IS,0.41,0.0,Phase3-EA-SA2v2-EURCHF-M5-43,EURCHFMT4,5078,8h 20m,Sell
121779.56,1.23426,15.11.2013 11:00:00,,0.0,-139.36999999996624,0.0,0.0,1.23348,15.11.2013 02:15:00,9865,-0.06576571521947806,-28.9,IS,0.34,0.0,Phase3-EA-S4v1-EURCHF-M15-221,EURCHFMT4,2570,8h 45m,Sell
121945.49,161557,15.11.2013 18:29:58,tp 161.557,-0.32,-0.0,0.0,0.0,159707,14.11.2013 06:00:00,9866,-0.0,165.93,IS,0.09,0.0,Phase3-EA-B1v1-GBPJPY-M30-1,GBPJPYMT4,930,1d 12h 29m,Buy
121974.32,100314,18.11.2013 02:15:00,,-0.78,-0.0,0.0,0.0,100204,15.11.2013 17:00:00,9867,-0.0,28.83,IS,0.27,0.0,Phase3-EA-S1v2-USDJPY-M15-0,USDJPYMT4,2848,2d 9h 15m,Buy
121948.34,1.23444,18.11.2013 05:00:00,,-2.24,-25.980000000010477,0.0,0.0,1.23391,15.11.2013 20:40:00,9868,-0.012256201600274156,-25.98,IS,0.41,0.0,Phase3-EA-SA2v2-EURCHF-M5-43,EURCHFMT4,5080,2d 8h 20m,Sell
121977.38,135136,18.11.2013 07:00:00,,-0.83,-0.0,0.0,0.0,134.96,15.11.2013 11:30:00,9869,-0.0,29.04,IS,0.17,0.0,Phase3-EA-T1v2-EURJPY-M15-322,EURJPYMT4,1740,2d 19h 30m,Buy
121916.8,160866,18.11.2013 23:29:58,sl 160.866,-0.32,-60.579999999987194,0.0,0.0,161536,15.11.2013 18:30:00,9870,-0.028578520972372942,-60.58,IS,0.09,0.0,Phase3-EA-B1v1-GBPJPY-M30-1,GBPJPYMT4,932,3d 4h 59m,Buy
121963.96,1.23249,19.11.2013 02:39:59,tp 1.23249,-2.25,-13.419999999983702,0.0,0.0,1.23359,18.11.2013 20:35:00,9871,-0.006330864170499508,47.16,IS,0.41,0.0,Phase3-EA-SA2v2-EURCHF-M5-43,EURCHFMT4,5082,6h 4m,Sell
121897.34,160.58,19.11.2013 04:45:00,,-0.83,-80.03999999997905,0.0,0.0,160865,18.11.2013 23:20:00,9872,-0.03775874576805241,-66.62,IS,0.23,0.0,Phase3-EA-S4v1-GBPJPY-M5-194,GBPJPYMT4,2314,5h 25m,Buy
121895.85,1.23265,19.11.2013 10:30:00,,0.0,-81.52999999996973,0.0,0.0,1.23269,19.11.2013 01:45:00,9873,-0.03846165095538451,-1.49,IS,0.34,0.0,Phase3-EA-S4v1-EURCHF-M15-221,EURCHFMT4,2572,8h 45m,Buy
121930.5,1.23324,19.11.2013 11:10:00,,0.0,-46.87999999997555,0.0,0.0,1.23247,19.11.2013 02:50:00,9874,-0.02211556723645474,34.65,IS,0.41,0.0,Phase3-EA-SA2v2-EURCHF-M5-43,EURCHFMT4,5084,8h 20m,Buy
121891.36,135005,19.11.2013 16:44:58,sl 135.005,0.0,-86.01999999998952,0.0,0.0,134775,19.11.2013 13:00:00,9875,-0.04057980148636086,-39.14,IS,0.17,0.0,Phase3-EA-T1v2-EURJPY-M15-322,EURJPYMT4,1742,3h 44m,Sell
121820.55,135548,19.11.2013 18:29:58,sl 135.548,-0.63,-156.8299999999872,0.0,0.0,134768,15.11.2013 07:30:00,9876,-0.07398430908051883,-70.81,IS,0.09,0.0,Phase3-EA-TR1v1-EURJPY-M30-91,EURJPYMT4,1730,4d 10h 59m,Sell
121845.33,100.23,19.11.2013 22:00:00,,0.0,-132.04999999998836,0.0,0.0,100138,19.11.2013 21:45:00,9877,-0.062294382542131266,24.78,IS,0.27,0.0,Phase3-EA-S1v2-USDJPY-M15-0,USDJPYMT4,2850,15m 0s,Buy
121853.89,1.23312,20.11.2013 09:45:00,,0.0,-123.48999999999069,0.0,0.0,1.23331,20.11.2013 01:25:00,9878,-0.05825621582830661,8.56,IS,0.41,0.0,Phase3-EA-SA2v2-EURCHF-M5-43,EURCHFMT4,5086,8h 20m,Sell
121819.16,1.23183,20.11.2013 11:30:00,,0.0,-158.22000000000116,0.0,0.0,1.23276,20.11.2013 02:45:00,9879,-0.07464003942307422,-34.73,IS,0.34,0.0,Phase3-EA-S4v1-EURCHF-M15-221,EURCHFMT4,2574,8h 45m,Buy
121753.83,134856,20.11.2013 18:29:58,sl 134.856,-0.44,-223.54999999998836,0.0,0.0,135576,19.11.2013 22:30:00,9880,-0.10545936552286216,-65.33,IS,0.09,0.0,Phase3-EA-TR1v1-EURJPY-M30-91,EURJPYMT4,1732,19h 59m,Buy
121711.3,1.60985,20.11.2013 22:29:57,sl 1.60985,-0.53,-266.0799999999872,0.0,0.0,1.61285,19.11.2013 20:30:00,9881,-0.12552282701106363,-42.53,IS,0.14,0.0,Phase3-EA-B1v1-GBPUSD-M30-14,GBPUSDMT4,638,1d 1h 59m,Buy
121760.45,1.23145,20.11.2013 23:14:58,tp 1.23145,0.0,-216.92999999999302,0.0,0.0,1.23255,20.11.2013 21:25:00,9882,-0.10233639079791967,49.15,IS,0.41,0.0,Phase3-EA-SA2v2-EURCHF-M5-43,EURCHFMT4,5088,1h 49m,Sell
121847.5,161367,21.11.2013 02:59:58,tp 161.367,-2.48,-129.88000000000466,0.0,0.0,160977,20.11.2013 23:15:00,9883,-0.061270688410246216,87.05,IS,0.23,0.0,Phase3-EA-S4v1-GBPJPY-M5-194,GBPJPYMT4,2316,3h 44m,Buy
121835.79,1.23131,21.11.2013 07:40:00,,-3.22,-141.5899999999965,0.0,0.0,1.2315,20.11.2013 23:20:00,9884,-0.06679486273488017,-11.71,IS,0.41,0.0,Phase3-EA-SA2v2-EURCHF-M5-43,EURCHFMT4,5090,8h 20m,Buy
121950.89,135927,21.11.2013 16:59:57,tp 135.927,0.0,-26.489999999990687,0.0,0.0,134637,21.11.2013 03:00:00,9885,-0.012496616384253105,115.1,IS,0.09,0.0,Phase3-EA-TR1v1-EURJPY-M30-91,EURJPYMT4,1734,13h 59m,Buy
122062.52,136432,22.11.2013 02:59:58,tp 136.432,-0.44,-0.0,0.0,0.0,135172,21.11.2013 09:30:00,9886,-0.0,111.63,IS,0.09,0.0,Phase3-EA-TR1v1-EURJPY-M30-91,EURJPYMT4,1735,17h 29m,Buy
122007.18,0.91382,22.11.2013 03:45:00,,-0.76,-55.33999999999651,0.0,0.0,0.91468,21.11.2013 23:30:00,9887,-0.02609607770387527,-55.34,IS,0.58,0.0,Phase3-EA-SA2v2-USDCHF-M15-107,USDCHFMT4,1896,4h 15m,Buy
121997.18,163833,22.11.2013 05:50:00,,0.0,-65.33999999999651,0.0,0.0,163789,22.11.2013 00:25:00,9888,-0.03081166818162679,-10.0,IS,0.23,0.0,Phase3-EA-S4v1-GBPJPY-M5-194,GBPJPYMT4,2318,5h 25m,Sell
121996.28,1.23164,22.11.2013 08:45:00,,0.0,-66.23999999999069,0.0,0.0,1.23166,22.11.2013 00:25:00,9889,-0.03123607132462168,-0.9,IS,0.41,0.0,Phase3-EA-SA2v2-EURCHF-M5-43,EURCHFMT4,5092,8h 20m,Buy
121999.63,1.23115,22.11.2013 10:15:00,,0.0,-62.889999999984866,0.0,0.0,1.23106,22.11.2013 01:30:00,9890,-0.02965634851457218,3.35,IS,0.34,0.0,Phase3-EA-S4v1-EURCHF-M15-221,EURCHFMT4,2576,8h 45m,Buy
121930.26,137127,22.11.2013 19:59:58,sl 137.127,0.0,-132.2599999999802,0.0,0.0,136347,22.11.2013 06:00:00,9891,-0.06236839965873228,-69.37,IS,0.09,0.0,Phase3-EA-TR1v1-EURJPY-M30-91,EURJPYMT4,1738,13h 59m,Sell
122094.24,164601,25.11.2013 03:59:58,tp 164.601,-0.64,-0.0,0.0,0.0,162751,21.11.2013 17:30:00,9892,-0.0,163.98,IS,0.09,0.0,Phase3-EA-B1v1-GBPJPY-M30-1,GBPJPYMT4,934,3d 10h 29m,Buy
122112.65,0.90743,25.11.2013 04:00:00,,-0.77,-0.0,0.0,0.0,0.90713,22.11.2013 23:45:00,9893,-0.0,18.41,IS,0.58,0.0,Phase3-EA-SA2v2-USDCHF-M15-107,USDCHFMT4,1898,2d 4h 15m,Buy
122162.33,1.23002,25.11.2013 04:39:57,tp 1.23002,0.0,-0.0,0.0,0.0,1.22892,25.11.2013 02:10:00,9894,-0.0,49.68,IS,0.41,0.0,Phase3-EA-SA2v2-EURCHF-M5-43,EURCHFMT4,5094,2h 29m,Buy
122136.55,1.2311,25.11.2013 15:00:00,,0.0,-25.779999999998836,0.0,0.0,1.23041,25.11.2013 06:15:00,9895,-0.012151073190042083,-25.78,IS,0.34,0.0,Phase3-EA-S4v1-EURCHF-M15-221,EURCHFMT4,2578,8h 45m,Sell
122077.23,163928,25.11.2013 23:29:58,sl 163.928,0.0,-85.10000000000582,0.0,0.0,164598,25.11.2013 04:00:00,9896,-0.040110796294518955,-59.32,IS,0.09,0.0,Phase3-EA-B1v1-GBPJPY-M30-1,GBPJPYMT4,936,19h 29m,Buy
122164.62,164274,26.11.2013 00:59:57,tp 164.274,-0.82,-0.0,0.0,0.0,163884,25.11.2013 23:45:00,9897,-0.0,87.39,IS,0.23,0.0,Phase3-EA-S4v1-GBPJPY-M5-194,GBPJPYMT4,2320,1h 14m,Buy
122114.86,0.91136,26.11.2013 02:15:00,,-0.76,-49.76000000000931,0.0,0.0,0.91213,25.11.2013 22:00:00,9898,-0.023453486259871644,-49.76,IS,0.58,0.0,Phase3-EA-SA2v2-USDCHF-M15-107,USDCHFMT4,1900,4h 15m,Buy
122100.9,1.23239,26.11.2013 04:20:00,,-2.25,-63.720000000001164,0.0,0.0,1.23213,25.11.2013 20:00:00,9899,-0.030033282646277505,-13.96,IS,0.41,0.0,Phase3-EA-SA2v2-EURCHF-M5-43,EURCHFMT4,5096,8h 20m,Sell
122062.35,137548,26.11.2013 11:29:58,sl 137.548,0.0,-102.26999999998952,0.0,0.0,137318,26.11.2013 06:30:00,9900,-0.04820313584799796,-38.55,IS,0.17,0.0,Phase3-EA-T1v2-EURJPY-M15-322,EURJPYMT4,1744,4h 59m,Sell
122020.8,1.23123,26.11.2013 12:30:00,,0.0,-143.81999999997788,0.0,0.0,1.23234,26.11.2013 03:45:00,9901,-0.06778698540782938,-41.55,IS,0.34,0.0,Phase3-EA-S4v1-EURCHF-M15-221,EURCHFMT4,2580,8h 45m,Buy
122008.39,137345,26.11.2013 16:15:00,,0.0,-156.22999999998137,0.0,0.0,137419,26.11.2013 15:15:00,9902,-0.07363621700921673,-12.41,IS,0.17,0.0,Phase3-EA-T1v2-EURJPY-M15-322,EURJPYMT4,1746,1h 0m,Buy
121985.73,137286,26.11.2013 21:00:00,,0.0,-178.88999999998487,0.0,0.0,137421,26.11.2013 20:00:00,9903,-0.08431660283414988,-22.66,IS,0.17,0.0,Phase3-EA-T1v2-EURJPY-M15-322,EURJPYMT4,1748,1h 0m,Buy
122004.93,101226,27.11.2013 02:45:00,,0.0,-159.68999999997322,0.0,0.0,101298,27.11.2013 01:15:00,9904,-0.0752670261422342,19.2,IS,0.27,0.0,Phase3-EA-S1v2-USDJPY-M15-0,USDJPYMT4,2852,1h 30m,Sell
121966.35,137589,27.11.2013 04:14:58,sl 137.589,0.0,-198.26999999996042,0.0,0.0,137359,27.11.2013 03:00:00,9905,-0.0934510193075352,-38.58,IS,0.17,0.0,Phase3-EA-T1v2-EURJPY-M15-322,EURJPYMT4,1750,1h 14m,Sell
121984.69,1231,27.11.2013 06:10:00,,-1.09,-179.9299999999639,0.0,0.0,1.23057,26.11.2013 21:50:00,9906,-0.08480678823828514,18.34,IS,0.41,0.0,Phase3-EA-SA2v2-EURCHF-M5-43,EURCHFMT4,5098,8h 20m,Buy
121924.19,164639,27.11.2013 06:59:58,sl 164.639,-1.03,-240.4299999999639,0.0,0.0,163969,25.11.2013 23:30:00,9907,-0.11332238146018965,-60.5,IS,0.09,0.0,Phase3-EA-B1v1-GBPJPY-M30-1,GBPJPYMT4,938,1d 7h 29m,Sell
122034.32,138199,27.11.2013 11:59:58,tp 138.199,-1.31,-130.29999999995925,0.0,0.0,136939,22.11.2013 15:30:00,9908,-0.06141457515393383,110.13,IS,0.09,0.0,Phase3-EA-TR1v1-EURJPY-M30-91,EURJPYMT4,1739,4d 20h 29m,Buy
122017.03,1.23121,27.11.2013 12:45:00,,0.0,-147.5899999999674,0.0,0.0,1.23075,27.11.2013 04:00:00,9909,-0.06956390749785055,-17.29,IS,0.34,0.0,Phase3-EA-S4v1-EURCHF-M15-221,EURCHFMT4,2582,8h 45m,Sell
122016.5,101828,27.11.2013 17:30:00,,0.0,-148.11999999996624,0.0,0.0,101.83,27.11.2013 17:00:00,9910,-0.06981371352111627,-0.53,IS,0.27,0.0,Phase3-EA-S1v2-USDJPY-M15-0,USDJPYMT4,2854,30m 0s,Buy
122032.95,102229,28.11.2013 01:30:00,,-2.3,-131.6699999999546,0.0,0.0,102158,27.11.2013 23:45:00,9911,-0.06206030015746898,16.45,IS,0.27,0.0,Phase3-EA-S1v2-USDJPY-M15-0,USDJPYMT4,2856,1h 45m,Buy
122120.85,165972,28.11.2013 03:54:58,tp 165.972,0.0,-43.76999999996042,0.0,0.0,166362,28.11.2013 00:55:00,9912,-0.020630206864820366,87.9,IS,0.23,0.0,Phase3-EA-S4v1-GBPJPY-M5-194,GBPJPYMT4,2322,2h 59m,Sell
122133.95,1.23235,28.11.2013 04:25:00,,-6.77,-30.669999999954598,0.0,0.0,1.23279,27.11.2013 20:05:00,9913,-0.014455756101066395,13.1,IS,0.41,0.0,Phase3-EA-SA2v2-EURCHF-M5-43,EURCHFMT4,5100,8h 20m,Sell
122140.31,1.23234,28.11.2013 10:15:00,,0.0,-24.309999999968568,0.0,0.0,1.23217,28.11.2013 01:30:00,9914,-0.011458083821877728,6.36,IS,0.34,0.0,Phase3-EA-S4v1-EURCHF-M15-221,EURCHFMT4,2584,8h 45m,Buy
122071.35,139201,29.11.2013 00:59:58,sl 139.201,-0.31,-93.26999999996042,0.0,0.0,138421,28.11.2013 04:00:00,9915,-0.04396114677365134,-68.96,IS,0.09,0.0,Phase3-EA-TR1v1-EURJPY-M30-91,EURJPYMT4,1742,20h 59m,Sell
122086.57,1.23233,29.11.2013 05:45:00,,-1.09,-78.04999999995925,0.0,0.0,1.23197,28.11.2013 21:25:00,9916,-0.03678747191683448,15.22,IS,0.41,0.0,Phase3-EA-SA2v2-EURCHF-M5-43,EURCHFMT4,5102,8h 20m,Buy
122134.0,139031,29.11.2013 10:30:00,,-0.81,-30.61999999996624,0.0,0.0,138741,28.11.2013 08:30:00,9917,-0.014432189495103366,47.43,IS,0.17,0.0,Phase3-EA-T1v2-EURJPY-M15-322,EURJPYMT4,1752,1d 2h 0m,Buy
122115.61,1.23283,29.11.2013 12:15:00,,0.0,-49.00999999998021,0.0,0.0,1.23234,29.11.2013 03:30:00,9918,-0.023099987170330183,-18.39,IS,0.34,0.0,Phase3-EA-S4v1-EURCHF-M15-221,EURCHFMT4,2586,8h 45m,Sell
122276.55,167981,02.12.2013 03:29:58,tp 167.981,-1.59,-0.0,0.0,0.0,166131,27.11.2013 17:00:00,9919,-0.0,160.94,IS,0.09,0.0,Phase3-EA-B1v1-GBPJPY-M30-1,GBPJPYMT4,940,4d 10h 29m,Buy
122538.49,1.63925,02.12.2013 03:59:58,tp 1.63925,-2.66,-0.0,0.0,0.0,1.62035,27.11.2013 05:30:00,9920,-0.0,261.94,IS,0.14,0.0,Phase3-EA-B1v1-GBPUSD-M30-14,GBPUSDMT4,640,4d 22h 29m,Buy
122521.74,1.23132,02.12.2013 04:30:00,,-2.26,-16.75,0.0,0.0,1231,29.11.2013 20:10:00,9921,-0.007880925473781174,-16.75,IS,0.41,0.0,Phase3-EA-SA2v2-EURCHF-M5-43,EURCHFMT4,5104,2d 8h 20m,Sell
122609.44,167985,02.12.2013 04:39:58,tp 167.985,0.0,-0.0,0.0,0.0,168375,02.12.2013 03:50:00,9922,-0.0,87.7,IS,0.23,0.0,Phase3-EA-S4v1-GBPJPY-M5-194,GBPJPYMT4,2324,49m 58s,Sell
122635.61,1.23189,02.12.2013 14:15:00,,0.0,-0.0,0.0,0.0,1.23119,02.12.2013 05:30:00,9923,-0.0,26.17,IS,0.34,0.0,Phase3-EA-S4v1-EURCHF-M15-221,EURCHFMT4,2588,8h 45m,Buy
122623.04,139187,02.12.2013 15:30:00,,0.0,-12.570000000006985,0.0,0.0,139263,02.12.2013 08:00:00,9924,-0.005911521593211445,-12.57,IS,0.17,0.0,Phase3-EA-T1v2-EURJPY-M15-322,EURJPYMT4,1754,7h 30m,Buy
122585.02,139255,02.12.2013 17:59:57,sl 139.255,0.0,-50.58999999999651,0.0,0.0,139485,02.12.2013 17:30:00,9925,-0.023791875688176624,-38.02,IS,0.17,0.0,Phase3-EA-T1v2-EURJPY-M15-322,EURJPYMT4,1756,29m 57s,Buy
122601.02,102921,02.12.2013 18:15:00,,0.0,-34.58999999999651,0.0,0.0,102.86,02.12.2013 18:00:00,9926,-0.016267265863886205,16.0,IS,0.27,0.0,Phase3-EA-S1v2-USDJPY-M15-0,USDJPYMT4,2858,15m 0s,Buy
122586.59,1.23071,03.12.2013 06:40:00,,-2.26,-49.01999999998952,0.0,0.0,1.23044,02.12.2013 22:20:00,9927,-0.023053523349164842,-14.43,IS,0.41,0.0,Phase3-EA-SA2v2-EURCHF-M5-43,EURCHFMT4,5106,8h 20m,Sell
122586.22,1.23055,03.12.2013 11:15:00,,0.0,-49.389999999984866,0.0,0.0,1.23054,03.12.2013 02:30:00,9928,-0.023227529951349368,-0.37,IS,0.34,0.0,Phase3-EA-S4v1-EURCHF-M15-221,EURCHFMT4,2590,8h 45m,Sell
122517.52,140017,03.12.2013 12:29:57,sl 140.017,-0.62,-118.08999999999651,0.0,0.0,139237,29.11.2013 07:30:00,9929,-0.05553632338440183,-68.7,IS,0.09,0.0,Phase3-EA-TR1v1-EURJPY-M30-91,EURJPYMT4,1744,4d 4h 59m,Sell
122576.29,102446,03.12.2013 19:00:00,,0.0,-59.320000000006985,0.0,0.0,102669,03.12.2013 18:15:00,9930,-0.027897490923560014,58.77,IS,0.27,0.0,Phase3-EA-S1v2-USDJPY-M15-0,USDJPYMT4,2860,45m 0s,Sell
122538.16,139374,04.12.2013 03:44:57,sl 139.374,0.0,-97.45000000001164,0.0,0.0,139144,04.12.2013 02:45:00,9931,-0.04582957671107431,-38.13,IS,0.17,0.0,Phase3-EA-T1v2-EURJPY-M15-322,EURJPYMT4,1758,59m 57s,Sell
122625.88,167617,04.12.2013 04:39:58,tp 167.617,0.0,-9.730000000010477,0.0,0.0,168007,04.12.2013 01:00:00,9932,-0.004575903349401538,87.72,IS,0.23,0.0,Phase3-EA-S4v1-GBPJPY-M5-194,GBPJPYMT4,2326,3h 39m,Sell
122662.31,102291,04.12.2013 04:45:00,,0.0,-0.0,0.0,0.0,102429,04.12.2013 00:30:00,9933,-0.0,36.43,IS,0.27,0.0,Phase3-EA-S1v2-USDJPY-M15-0,USDJPYMT4,2862,4h 15m,Sell
122654.15,1.22927,04.12.2013 07:25:00,,-2.27,-8.160000000003492,0.0,0.0,1.22914,03.12.2013 23:05:00,9934,-0.0038370692014035876,-8.16,IS,0.41,0.0,Phase3-EA-SA2v2-EURCHF-M5-43,EURCHFMT4,5108,8h 20m,Sell
122617.71,1.22582,05.12.2013 04:30:00,,-3.27,-44.60000000000582,0.0,0.0,1.22655,04.12.2013 20:10:00,9935,-0.020972216468449646,-36.44,IS,0.41,0.0,Phase3-EA-SA2v2-EURCHF-M5-43,EURCHFMT4,5110,8h 20m,Buy
122624.45,102255,05.12.2013 04:45:00,,-3.56,-37.860000000015134,0.0,0.0,102294,04.12.2013 23:45:00,9936,-0.017802872544747026,6.74,IS,0.27,0.0,Phase3-EA-S1v2-USDJPY-M15-0,USDJPYMT4,2864,5h 0m,Sell
122586.25,139.14,05.12.2013 07:44:58,sl 139.140,0.0,-76.06000000002678,0.0,0.0,138.91,05.12.2013 05:30:00,9937,-0.03576562297288415,-38.2,IS,0.17,0.0,Phase3-EA-T1v2-EURJPY-M15-322,EURJPYMT4,1760,2h 14m,Sell
122547.92,139103,05.12.2013 09:29:58,sl 139.103,0.0,-114.39000000001397,0.0,0.0,138873,05.12.2013 09:00:00,9938,-0.05378950317995369,-38.33,IS,0.17,0.0,Phase3-EA-T1v2-EURJPY-M15-322,EURJPYMT4,1762,29m 58s,Sell
122575.07,1.22681,05.12.2013 12:00:00,,0.0,-87.24000000001979,0.0,0.0,1.22609,05.12.2013 03:15:00,9939,-0.04102278396205657,27.15,IS,0.34,0.0,Phase3-EA-S4v1-EURCHF-M15-221,EURCHFMT4,2592,8h 45m,Buy
122531.47,1.63583,05.12.2013 12:29:58,sl 1.63583,-1.6,-130.8400000000256,0.0,0.0,1.63883,04.12.2013 21:00:00,9940,-0.06152477136170696,-43.6,IS,0.14,0.0,Phase3-EA-B1v1-GBPUSD-M30-14,GBPUSDMT4,642,15h 29m,Buy
122561.48,101675,06.12.2013 02:15:00,,0.0,-100.8300000000163,0.0,0.0,101788,06.12.2013 01:00:00,9941,-0.04741319700703685,30.01,IS,0.27,0.0,Phase3-EA-S1v2-USDJPY-M15-0,USDJPYMT4,2866,1h 15m,Sell
122574.28,0.89664,06.12.2013 03:00:00,,-0.78,-88.03000000002794,0.0,0.0,0.89643,05.12.2013 22:45:00,9942,-0.04139426492641182,12.8,IS,0.58,0.0,Phase3-EA-SA2v2-USDCHF-M15-107,USDCHFMT4,1902,4h 15m,Buy
122546.2,1.22545,06.12.2013 05:25:00,,-1.1,-116.11000000001513,0.0,0.0,1.22604,05.12.2013 21:05:00,9943,-0.054598297178288964,-28.08,IS,0.41,0.0,Phase3-EA-SA2v2-EURCHF-M5-43,EURCHFMT4,5112,8h 20m,Buy
122486.63,166746,06.12.2013 09:59:58,sl 166.746,-0.51,-175.68000000002212,0.0,0.0,166076,05.12.2013 19:30:00,9944,-0.08260984280666404,-59.57,IS,0.09,0.0,Phase3-EA-B1v1-GBPJPY-M30-1,GBPJPYMT4,942,14h 29m,Sell
122444.63,1.63144,06.12.2013 16:59:57,sl 1.63144,0.0,-217.68000000002212,0.0,0.0,1.63444,06.12.2013 11:30:00,9945,-0.10235946369623289,-42.0,IS,0.14,0.0,Phase3-EA-B1v1-GBPUSD-M30-14,GBPUSDMT4,644,5h 29m,Buy
122374.64,140259,06.12.2013 16:59:58,sl 140.259,-1.54,-287.6700000000128,0.0,0.0,139479,03.12.2013 13:00:00,9946,-0.13527079622148858,-69.99,IS,0.09,0.0,Phase3-EA-TR1v1-EURJPY-M30-91,EURJPYMT4,1746,3d 3h 59m,Sell
122655.42,140894,06.12.2013 20:29:58,tp 140.894,0.0,-6.89000000001397,0.0,0.0,139194,06.12.2013 03:30:00,9947,-0.0032398782840334568,280.78,IS,0.17,0.0,Phase3-EA-T1v2-EURJPY-M15-322,EURJPYMT4,1764,16h 59m,Buy
122742.43,168223,09.12.2013 03:19:58,tp 168.223,0.0,-0.0,0.0,0.0,168613,09.12.2013 02:20:00,9948,-0.0,87.01,IS,0.23,0.0,Phase3-EA-S4v1-GBPJPY-M5-194,GBPJPYMT4,2328,59m 58s,Sell
122739.7,0.89239,09.12.2013 03:30:00,,-0.78,-2.7300000000104774,0.0,0.0,0.89242,06.12.2013 23:15:00,9949,-0.00128324189961093,-2.73,IS,0.58,0.0,Phase3-EA-SA2v2-USDCHF-M15-107,USDCHFMT4,1904,2d 4h 15m,Buy
122732.63,1.22303,09.12.2013 05:25:00,,-1.1,-9.800000000017462,0.0,0.0,1.22316,06.12.2013 21:05:00,9950,-0.0046065093832092525,-7.07,IS,0.41,0.0,Phase3-EA-SA2v2-EURCHF-M5-43,EURCHFMT4,5114,2d 8h 20m,Buy
122893.74,169309,09.12.2013 19:59:58,tp 169.309,-0.31,-0.0,0.0,0.0,167459,06.12.2013 16:30:00,9951,-0.0,161.11,IS,0.09,0.0,Phase3-EA-B1v1-GBPJPY-M30-1,GBPJPYMT4,944,3d 3h 29m,Buy
123003.16,141837,09.12.2013 21:59:58,tp 141.837,-0.43,-0.0,0.0,0.0,140577,06.12.2013 18:00:00,9952,-0.0,109.42,IS,0.09,0.0,Phase3-EA-TR1v1-EURJPY-M30-91,EURJPYMT4,1748,3d 3h 59m,Buy
123027.49,103316,10.12.2013 00:30:00,,-0.76,-0.0,0.0,0.0,103.22,09.12.2013 23:00:00,9953,-0.0,24.33,IS,0.27,0.0,Phase3-EA-S1v2-USDJPY-M15-0,USDJPYMT4,2868,1h 30m,Buy
123063.26,1.22366,10.12.2013 06:00:00,,-1.11,-0.0,0.0,0.0,1.22286,09.12.2013 21:40:00,9954,-0.0,35.77,IS,0.41,0.0,Phase3-EA-SA2v2-EURCHF-M5-43,EURCHFMT4,5116,8h 20m,Buy
123110.05,102722,10.12.2013 21:30:00,,0.0,-0.0,0.0,0.0,102.9,10.12.2013 19:30:00,9955,-0.0,46.79,IS,0.27,0.0,Phase3-EA-S1v2-USDJPY-M15-0,USDJPYMT4,2870,2h 0m,Sell
123099.7,1.22071,11.12.2013 07:10:00,,-1.11,-10.35000000000582,0.0,0.0,1.22091,10.12.2013 22:50:00,9956,-0.004856645662654451,-10.35,IS,0.41,0.0,Phase3-EA-SA2v2-EURCHF-M5-43,EURCHFMT4,5118,8h 20m,Buy
123040.38,168644,11.12.2013 10:29:58,sl 168.644,-0.63,-69.6700000000128,0.0,0.0,169314,09.12.2013 20:00:00,9957,-0.03269202930599106,-59.32,IS,0.09,0.0,Phase3-EA-B1v1-GBPJPY-M30-1,GBPJPYMT4,946,1d 14h 29m,Buy
122998.38,1.64221,11.12.2013 11:29:57,sl 1.64221,0.0,-111.6700000000128,0.0,0.0,1.64521,11.12.2013 02:30:00,9958,-0.0524001566326937,-42.0,IS,0.14,0.0,Phase3-EA-B1v1-GBPUSD-M30-14,GBPUSDMT4,646,8h 59m,Buy
122998.38,1.22141,11.12.2013 14:00:00,,0.0,-111.6700000000128,0.0,0.0,1.22141,11.12.2013 05:15:00,9959,-0.0524001566326937,0.0,IS,0.34,0.0,Phase3-EA-S4v1-EURCHF-M15-221,EURCHFMT4,2594,8h 45m,Sell
122960.3,141618,11.12.2013 17:29:57,sl 141.618,0.0,-149.75,0.0,0.0,141388,11.12.2013 04:30:00,9960,-0.0702688587422314,-38.08,IS,0.17,0.0,Phase3-EA-T1v2-EURJPY-M15-322,EURJPYMT4,1766,12h 59m,Sell
122929.31,1.22262,12.12.2013 06:00:00,,-6.94,-180.7399999999907,0.0,0.0,1.2221,11.12.2013 21:40:00,9961,-0.08481064126257262,-30.99,IS,0.41,0.0,Phase3-EA-SA2v2-EURCHF-M5-43,EURCHFMT4,5120,8h 20m,Sell
122869.1,168308,12.12.2013 10:59:58,sl 168.308,-1.53,-240.94999999998254,0.0,0.0,167638,11.12.2013 18:30:00,9962,-0.1130636495087775,-60.21,IS,0.09,0.0,Phase3-EA-B1v1-GBPJPY-M30-1,GBPJPYMT4,948,16h 29m,Sell
122943.93,1.22088,12.12.2013 15:30:00,,0.0,-166.11999999999534,0.0,0.0,1.22283,12.12.2013 06:45:00,9963,-0.07795033598837499,74.83,IS,0.34,0.0,Phase3-EA-S4v1-EURCHF-M15-221,EURCHFMT4,2596,8h 45m,Sell
122879.67,142101,13.12.2013 00:29:58,sl 142.101,-1.53,-230.38000000000466,0.0,0.0,141893,10.12.2013 04:00:00,9964,-0.10810377079823438,-64.26,IS,0.09,0.0,Phase3-EA-TR1v1-EURJPY-M30-91,EURJPYMT4,1750,2d 20h 29m,Sell
122794.61,169309,13.12.2013 06:00:00,,0.0,-315.4400000000023,0.0,0.0,168926,13.12.2013 00:35:00,9965,-0.14801742104607438,-85.06,IS,0.23,0.0,Phase3-EA-S4v1-GBPJPY-M5-194,GBPJPYMT4,2330,5h 25m,Sell
122828.53,1.22383,13.12.2013 06:45:00,,-1.11,-281.5199999999895,0.0,0.0,1.22307,12.12.2013 22:25:00,9966,-0.13210076202412185,33.92,IS,0.41,0.0,Phase3-EA-SA2v2-EURCHF-M5-43,EURCHFMT4,5122,8h 20m,Buy
122759.21,142673,13.12.2013 06:59:58,sl 142.673,-1.53,-350.8399999999965,0.0,0.0,141381,10.12.2013 16:30:00,9967,-0.164628556935721,-69.32,IS,0.09,0.0,Phase3-EA-TR1v1-EURJPY-M30-91,EURJPYMT4,1751,2d 14h 29m,Sell
122911.79,142326,13.12.2013 13:00:00,,-0.81,-198.2600000000093,0.0,0.0,141392,12.12.2013 04:00:00,9968,-0.09303174580457732,152.58,IS,0.17,0.0,Phase3-EA-T1v2-EURJPY-M15-322,EURJPYMT4,1768,1d 9h 0m,Buy
122853.53,168971,13.12.2013 13:29:58,sl 168.971,0.0,-256.5200000000186,0.0,0.0,169641,13.12.2013 07:00:00,9969,-0.1203697338534792,-58.26,IS,0.09,0.0,Phase3-EA-B1v1-GBPJPY-M30-1,GBPJPYMT4,950,6h 29m,Buy
122790.77,141452,13.12.2013 17:59:58,sl 141.452,0.0,-319.28000000002794,0.0,0.0,142172,13.12.2013 01:00:00,9970,-0.1498193069730992,-62.76,IS,0.09,0.0,Phase3-EA-TR1v1-EURJPY-M30-91,EURJPYMT4,1753,16h 59m,Buy
122813.29,103126,13.12.2013 22:30:00,,0.0,-296.7600000000384,0.0,0.0,103212,13.12.2013 21:15:00,9971,-0.13925199679697692,22.52,IS,0.27,0.0,Phase3-EA-S1v2-USDJPY-M15-0,USDJPYMT4,2872,1h 15m,Sell
122862.88,1.22261,16.12.2013 02:59:58,tp 1.22261,-1.11,-247.1700000000419,0.0,0.0,1.22151,13.12.2013 20:25:00,9972,-0.11598232931766465,49.59,IS,0.41,0.0,Phase3-EA-SA2v2-EURCHF-M5-43,EURCHFMT4,5124,2d 6h 34m,Buy
122841.44,1.22121,16.12.2013 11:00:00,,0.0,-268.61000000004424,0.0,0.0,1.22177,16.12.2013 02:15:00,9973,-0.1260428590768206,-21.44,IS,0.34,0.0,Phase3-EA-S4v1-EURCHF-M15-221,EURCHFMT4,2598,8h 45m,Buy
122803.49,141808,16.12.2013 11:59:58,sl 141.808,0.0,-306.5600000000559,0.0,0.0,141578,16.12.2013 06:00:00,9974,-0.14385055983988237,-37.95,IS,0.17,0.0,Phase3-EA-T1v2-EURJPY-M15-322,EURJPYMT4,1770,5h 59m,Sell
122806.64,103015,16.12.2013 18:15:00,,0.0,-303.4100000000617,0.0,0.0,103003,16.12.2013 17:00:00,9975,-0.14237245029038242,3.15,IS,0.27,0.0,Phase3-EA-S1v2-USDJPY-M15-0,USDJPYMT4,2874,1h 15m,Buy
122815.89,1.22101,17.12.2013 08:50:00,,0.0,-294.1600000000617,0.0,0.0,1.22081,17.12.2013 00:30:00,9976,-0.13803196986723956,9.25,IS,0.41,0.0,Phase3-EA-SA2v2-EURCHF-M5-43,EURCHFMT4,5126,8h 20m,Buy
122795.07,141.65,17.12.2013 12:15:00,,0.0,-314.9800000000687,0.0,0.0,141776,17.12.2013 00:45:00,9977,-0.14780157012776543,-20.82,IS,0.17,0.0,Phase3-EA-T1v2-EURJPY-M15-322,EURJPYMT4,1772,11h 30m,Buy
122801.2,1.22096,17.12.2013 15:00:00,,0.0,-308.85000000006403,0.0,0.0,1.22112,17.12.2013 06:15:00,9978,-0.14492512202031832,6.13,IS,0.34,0.0,Phase3-EA-S4v1-EURCHF-M15-221,EURCHFMT4,2600,8h 45m,Sell
122852.16,1.21833,17.12.2013 22:59:59,tp 1.21833,0.0,-257.8900000000722,0.0,0.0,1.21723,17.12.2013 21:30:00,9979,-0.12101259419725628,50.96,IS,0.41,0.0,Phase3-EA-SA2v2-EURCHF-M5-43,EURCHFMT4,5128,1h 29m,Buy
122867.43,102576,18.12.2013 02:00:00,,0.0,-242.62000000008265,0.0,0.0,102634,18.12.2013 00:45:00,9980,-0.11384728219062432,15.27,IS,0.27,0.0,Phase3-EA-S1v2-USDJPY-M15-0,USDJPYMT4,2876,1h 15m,Sell
122864.15,0.8849,18.12.2013 04:30:00,,0.0,-245.9000000000815,0.0,0.0,0.88485,18.12.2013 00:15:00,9981,-0.11538639308661389,-3.28,IS,0.58,0.0,Phase3-EA-SA2v2-USDCHF-M15-107,USDCHFMT4,1906,4h 15m,Sell
122787.33,167742,18.12.2013 09:15:00,,0.0,-322.7200000000885,0.0,0.0,167398,18.12.2013 03:50:00,9982,-0.15143349644940993,-76.82,IS,0.23,0.0,Phase3-EA-S4v1-GBPJPY-M5-194,GBPJPYMT4,2332,5h 25m,Sell
122638.13,1.22252,18.12.2013 13:14:57,sl 1.22252,0.0,-471.9200000001001,0.0,0.0,1.21862,18.12.2013 06:00:00,9983,-0.22144427257189236,-149.2,IS,0.34,0.0,Phase3-EA-S4v1-EURCHF-M15-221,EURCHFMT4,2602,7h 14m,Sell
122578.55,168562,18.12.2013 16:29:58,sl 168.562,-1.02,-531.5000000000873,0.0,0.0,167892,16.12.2013 05:00:00,9984,-0.24940165890819452,-59.58,IS,0.09,0.0,Phase3-EA-B1v1-GBPJPY-M30-1,GBPJPYMT4,952,2d 11h 29m,Sell
122540.5,141569,18.12.2013 22:00:00,sl 141.569,0.0,-569.5500000000757,0.0,0.0,141799,18.12.2013 18:00:00,9985,-0.26725628378392796,-38.05,IS,0.17,0.0,Phase3-EA-T1v2-EURJPY-M15-322,EURJPYMT4,1774,4h 0m,Buy
122591.33,1.22057,18.12.2013 22:04:57,tp 1.22057,0.0,-518.7200000000885,0.0,0.0,1.22167,18.12.2013 20:45:00,9986,-0.24340475730735553,50.83,IS,0.41,0.0,Phase3-EA-SA2v2-EURCHF-M5-43,EURCHFMT4,5130,1h 19m,Sell
122527.32,142319,18.12.2013 22:29:57,sl 142.319,-0.93,-582.7300000000978,0.0,0.0,141599,13.12.2013 19:00:00,9987,-0.27344088183550835,-64.01,IS,0.09,0.0,Phase3-EA-TR1v1-EURJPY-M30-91,EURJPYMT4,1756,5d 3h 29m,Sell
122613.44,170588,19.12.2013 03:14:58,tp 170.588,0.0,-496.61000000010245,0.0,0.0,170978,19.12.2013 00:45:00,9988,-0.23302983599323362,86.12,IS,0.23,0.0,Phase3-EA-S4v1-GBPJPY-M5-194,GBPJPYMT4,2334,2h 29m,Sell
122511.68,0.89431,19.12.2013 04:00:00,,-10.32,-598.3700000001118,0.0,0.0,0.8929,18.12.2013 23:45:00,9989,-0.2807798130590775,-101.76,IS,0.58,0.0,Phase3-EA-SA2v2-USDCHF-M15-107,USDCHFMT4,1908,4h 15m,Sell
122451.7,1.22316,19.12.2013 06:35:00,,-6.88,-658.3500000001222,0.0,0.0,1222,18.12.2013 22:15:00,9990,-0.3089248958461211,-59.98,IS,0.41,0.0,Phase3-EA-SA2v2-EURCHF-M5-43,EURCHFMT4,5132,8h 20m,Sell
122463.1,1.2237,19.12.2013 11:15:00,,0.0,-646.9500000001281,0.0,0.0,1224,19.12.2013 02:30:00,9991,-0.30357554700030454,11.4,IS,0.34,0.0,Phase3-EA-S4v1-EURCHF-M15-221,EURCHFMT4,2604,8h 45m,Sell
122457.06,142265,19.12.2013 21:00:00,,0.0,-652.9900000001362,0.0,0.0,142302,19.12.2013 12:45:00,9992,-0.30640976340633896,-6.04,IS,0.17,0.0,Phase3-EA-T1v2-EURJPY-M15-322,EURJPYMT4,1776,8h 15m,Buy
122507.32,1.22584,19.12.2013 21:24:57,tp 1.22584,0.0,-602.7300000001269,0.0,0.0,1.22474,19.12.2013 20:35:00,9993,-0.28282570437204707,50.26,IS,0.41,0.0,Phase3-EA-SA2v2-EURCHF-M5-43,EURCHFMT4,5134,49m 57s,Buy
122443.87,0.89852,20.12.2013 02:30:00,,-3.42,-666.1800000001385,0.0,0.0,0.89759,19.12.2013 22:15:00,9994,-0.3125990538691783,-63.45,IS,0.58,0.0,Phase3-EA-SA2v2-USDCHF-M15-107,USDCHFMT4,1910,4h 15m,Sell
122472.62,1.22579,20.12.2013 06:20:00,,-2.28,-637.4300000001385,0.0,0.0,1.22647,19.12.2013 22:00:00,9995,-0.2991083714729235,28.75,IS,0.41,0.0,Phase3-EA-SA2v2-EURCHF-M5-43,EURCHFMT4,5136,8h 20m,Sell
122480.37,0.89835,20.12.2013 07:00:00,,0.0,-629.6800000001385,0.0,0.0,0.89847,20.12.2013 02:45:00,9996,-0.2954717527400201,7.75,IS,0.58,0.0,Phase3-EA-SA2v2-USDCHF-M15-107,USDCHFMT4,1912,4h 15m,Sell
122480.37,1.22574,20.12.2013 13:30:00,,0.0,-629.6800000001385,0.0,0.0,1.22574,20.12.2013 04:45:00,9997,-0.2954717527400201,0.0,IS,0.34,0.0,Phase3-EA-S4v1-EURCHF-M15-221,EURCHFMT4,2606,8h 45m,Buy
122442.82,142131,20.12.2013 19:14:58,sl 142.131,0.0,-667.2300000001269,0.0,0.0,142361,20.12.2013 05:45:00,9998,-0.31309175705234044,-37.55,IS,0.17,0.0,Phase3-EA-T1v2-EURJPY-M15-322,EURJPYMT4,1778,13h 29m,Buy
122404.66,142399,23.12.2013 03:44:57,sl 142.399,-0.57,-705.3900000001304,0.0,0.0,142169,20.12.2013 19:15:00,9999,-0.33099799845203187,-38.16,IS,0.17,0.0,Phase3-EA-T1v2-EURJPY-M15-322,EURJPYMT4,1780,2d 8h 29m,Sell
122391.76,1.22567,23.12.2013 13:45:00,,0.0,-718.2900000001246,0.0,0.0,1.22533,23.12.2013 05:00:00,10000,-0.3370512089880878,-12.9,IS,0.34,0.0,Phase3-EA-S4v1-EURCHF-M15-221,EURCHFMT4,2608,8h 45m,Sell
122354.19,142523,23.12.2013 17:59:58,sl 142.523,0.0,-755.8600000001315,0.0,0.0,142293,23.12.2013 06:45:00,10001,-0.35468059812295344,-37.57,IS,0.17,0.0,Phase3-EA-T1v2-EURJPY-M15-322,EURJPYMT4,1782,11h 14m,Sell
122371.83,104088,23.12.2013 23:00:00,,0.0,-738.2200000001176,0.0,0.0,104.02,23.12.2013 22:15:00,10002,-0.3464031846457318,17.64,IS,0.27,0.0,Phase3-EA-S1v2-USDJPY-M15-0,USDJPYMT4,2878,45m 0s,Buy
122303.29,143028,26.12.2013 10:00:00,sl 143.028,-1.2,-806.7600000001257,0.0,0.0,142248,19.12.2013 05:00:00,10003,-0.37856497147840695,-68.54,IS,0.09,0.0,Phase3-EA-TR1v1-EURJPY-M30-91,EURJPYMT4,1758,7d 5h 0m,Sell
122460.06,171709,26.12.2013 12:59:58,tp 171.709,-2.17,-649.9900000001362,0.0,0.0,169859,18.12.2013 22:30:00,10004,-0.3050020400258602,156.77,IS,0.09,0.0,Phase3-EA-B1v1-GBPJPY-M30-1,GBPJPYMT4,954,7d 14h 29m,Buy
122452.28,1.22698,27.12.2013 04:20:00,,-9.15,-657.770000000135,0.0,0.0,1.22701,26.12.2013 20:00:00,10005,-0.3086527359925679,-7.78,IS,0.41,0.0,Phase3-EA-SA2v2-EURCHF-M5-43,EURCHFMT4,5138,8h 20m,Sell
122420.45,172.29,27.12.2013 08:20:00,,0.0,-689.6000000001222,0.0,0.0,172145,27.12.2013 02:55:00,10006,-0.3235886810594415,-31.83,IS,0.23,0.0,Phase3-EA-S4v1-GBPJPY-M5-194,GBPJPYMT4,2336,5h 25m,Sell
122323.06,1.22432,27.12.2013 13:45:00,,0.0,-786.9900000001362,0.0,0.0,1.22686,27.12.2013 05:00:00,10007,-0.3692880744010569,-97.39,IS,0.34,0.0,Phase3-EA-S4v1-EURCHF-M15-221,EURCHFMT4,2610,8h 45m,Buy
122595.57,145097,27.12.2013 14:44:58,tp 145.097,-3.18,-514.4800000001269,0.0,0.0,143397,26.12.2013 10:00:00,10008,-0.24141517492963024,272.51,IS,0.17,0.0,Phase3-EA-T1v2-EURJPY-M15-322,EURJPYMT4,1784,1d 4h 44m,Buy
122753.16,173597,27.12.2013 14:59:58,tp 173.597,-1.24,-356.8900000001304,0.0,0.0,171747,26.12.2013 15:30:00,10009,-0.16746746575308266,157.59,IS,0.09,0.0,Phase3-EA-B1v1-GBPJPY-M30-1,GBPJPYMT4,956,23h 29m,Buy
122861.34,145237,27.12.2013 14:59:58,tp 145.237,0.0,-248.71000000013737,0.0,0.0,143977,27.12.2013 06:30:00,10010,-0.11670496065302187,108.18,IS,0.09,0.0,Phase3-EA-TR1v1-EURJPY-M30-91,EURJPYMT4,1760,8h 29m,Buy
122799.54,144664,27.12.2013 18:59:58,sl 144.664,0.0,-310.51000000012573,0.0,0.0,145384,27.12.2013 15:00:00,10011,-0.14570406229087884,-61.8,IS,0.09,0.0,Phase3-EA-TR1v1-EURJPY-M30-91,EURJPYMT4,1762,3h 59m,Buy
122796.74,0.89157,30.12.2013 02:45:00,,-3.45,-313.3100000001141,0.0,0.0,0.89158,27.12.2013 22:30:00,10012,-0.1470179374459869,-2.8,IS,0.58,0.0,Phase3-EA-SA2v2-USDCHF-M15-107,USDCHFMT4,1914,2d 4h 15m,Sell
122710.31,1.22613,30.12.2013 05:45:00,,-2.3,-399.7400000001071,0.0,0.0,1.2243,27.12.2013 21:25:00,10013,-0.1875744480375767,-86.43,IS,0.41,0.0,Phase3-EA-SA2v2-EURCHF-M5-43,EURCHFMT4,5140,2d 8h 20m,Sell
122750.06,173475,30.12.2013 07:50:00,,0.0,-359.9900000001071,0.0,0.0,173657,30.12.2013 02:25:00,10014,-0.16892211324623313,39.75,IS,0.23,0.0,Phase3-EA-S4v1-GBPJPY-M5-194,GBPJPYMT4,2338,5h 25m,Sell
122749.3,1.22564,30.12.2013 12:00:00,,0.0,-360.7500000001164,0.0,0.0,1.22562,30.12.2013 03:15:00,10015,-0.16927873650262545,-0.76,IS,0.34,0.0,Phase3-EA-S4v1-EURCHF-M15-221,EURCHFMT4,2612,8h 45m,Sell
122776.66,144922,31.12.2013 02:00:00,,-0.79,-333.3900000001304,0.0,0.0,144748,30.12.2013 09:15:00,10016,-0.1564402992726657,27.36,IS,0.17,0.0,Phase3-EA-T1v2-EURJPY-M15-322,EURJPYMT4,1786,16h 45m,Buy
122793.46,0.88727,31.12.2013 03:00:00,,-3.46,-316.590000000142,0.0,0.0,0.88758,30.12.2013 22:45:00,10017,-0.14855704834199013,16.8,IS,0.58,0.0,Phase3-EA-SA2v2-USDCHF-M15-107,USDCHFMT4,1916,4h 15m,Sell
122692.4,172972,31.12.2013 05:30:00,,0.0,-417.6500000001397,0.0,0.0,173433,31.12.2013 00:05:00,10018,-0.19597855661905017,-101.06,IS,0.23,0.0,Phase3-EA-S4v1-GBPJPY-M5-194,GBPJPYMT4,2340,5h 25m,Buy
122634.63,172869,31.12.2013 05:59:58,sl 172.869,-0.31,-475.4200000001292,0.0,0.0,173539,30.12.2013 02:30:00,10019,-0.2230866165157979,-57.77,IS,0.09,0.0,Phase3-EA-B1v1-GBPJPY-M30-1,GBPJPYMT4,958,1d 3h 29m,Buy
122707.12,1.22663,31.12.2013 14:00:00,,0.0,-402.93000000013853,0.0,0.0,1.22473,31.12.2013 05:15:00,10020,-0.18907132723216719,72.49,IS,0.34,0.0,Phase3-EA-S4v1-EURCHF-M15-221,EURCHFMT4,2614,8h 45m,Buy
122743.38,174597,02.01.2014 07:45:00,,0.0,-366.6700000001292,0.0,0.0,174763,02.01.2014 02:20:00,10021,-0.17205664397344286,36.26,IS,0.23,0.0,Phase3-EA-S4v1-GBPJPY-M5-194,GBPJPYMT4,2342,5h 25m,Sell
122700.85,1.64974,02.01.2014 15:29:58,sl 1.64974,-0.53,-409.20000000012806,0.0,0.0,1.65274,31.12.2013 11:00:00,10022,-0.19201346909736286,-42.53,IS,0.14,0.0,Phase3-EA-B1v1-GBPUSD-M30-14,GBPUSDMT4,648,2d 4h 29m,Buy
122643.65,174147,02.01.2014 15:29:58,sl 174.147,0.0,-466.4000000001397,0.0,0.0,174817,02.01.2014 09:00:00,10023,-0.21885406155183001,-57.2,IS,0.09,0.0,Phase3-EA-B1v1-GBPJPY-M30-1,GBPJPYMT4,960,6h 29m,Buy
122753.66,143632,02.01.2014 16:29:59,tp 143.632,-0.3,-356.3900000001304,0.0,0.0,144922,31.12.2013 02:00:00,10024,-0.16723284518966955,110.01,IS,0.09,0.0,Phase3-EA-TR1v1-EURJPY-M30-91,EURJPYMT4,1764,2d 14h 29m,Sell
122818.09,0.90025,03.01.2014 04:29:58,tp 0.90025,0.0,-291.96000000013737,0.0,0.0,0.89925,03.01.2014 01:15:00,10025,-0.13699963938825732,64.43,IS,0.58,0.0,Phase3-EA-SA2v2-USDCHF-M15-107,USDCHFMT4,1918,3h 14m,Buy
122875.41,104566,03.01.2014 05:15:00,,0.0,-234.64000000013039,0.0,0.0,104788,03.01.2014 01:45:00,10026,-0.11010273799857322,57.32,IS,0.27,0.0,Phase3-EA-S1v2-USDJPY-M15-0,USDJPYMT4,2880,3h 30m,Sell
122982.78,142.34,03.01.2014 05:59:57,tp 142.340,-1.2,-127.27000000013504,0.0,0.0,143.6,02.01.2014 16:30:00,10027,-0.0597203182112406,107.37,IS,0.09,0.0,Phase3-EA-TR1v1-EURJPY-M30-91,EURJPYMT4,1766,13h 29m,Sell
122931.91,1.22869,03.01.2014 06:05:00,,-4.38,-178.14000000013039,0.0,0.0,1.22971,02.01.2014 21:45:00,10028,-0.08359061433288992,-50.87,IS,0.41,0.0,Phase3-EA-SA2v2-EURCHF-M5-43,EURCHFMT4,5142,8h 20m,Buy
123016.35,171565,06.01.2014 04:04:58,tp 171.565,-1.27,-93.70000000012806,0.0,0.0,171955,03.01.2014 23:25:00,10029,-0.04396789358368001,84.44,IS,0.23,0.0,Phase3-EA-S4v1-GBPJPY-M5-194,GBPJPYMT4,2344,2d 4h 39m,Sell
123065.03,1.23096,06.01.2014 05:24:57,tp 1.23096,-1.09,-45.02000000013504,0.0,0.0,1.22986,03.01.2014 22:20:00,10030,-0.021125235529781284,48.68,IS,0.41,0.0,Phase3-EA-SA2v2-EURCHF-M5-43,EURCHFMT4,5144,2d 7h 4m,Buy
123150.24,171258,07.01.2014 03:14:58,tp 171.258,-0.79,-0.0,0.0,0.0,170868,06.01.2014 23:45:00,10031,-0.0,85.21,IS,0.23,0.0,Phase3-EA-S4v1-GBPJPY-M5-194,GBPJPYMT4,2346,3h 29m,Buy
123079.15,1.23386,07.01.2014 07:25:00,,-2.27,-71.08999999999651,0.0,0.0,1.23234,06.01.2014 23:05:00,10032,-0.033352061907129894,-71.09,IS,0.41,0.0,Phase3-EA-SA2v2-EURCHF-M5-43,EURCHFMT4,5146,8h 20m,Sell
123050.16,104328,07.01.2014 11:30:00,,0.0,-100.0799999999872,0.0,0.0,104216,07.01.2014 01:00:00,10033,-0.046952797238223334,-28.99,IS,0.27,0.0,Phase3-EA-S1v2-USDJPY-M15-0,USDJPYMT4,2882,10h 30m,Sell
122903.88,1.23659,07.01.2014 13:14:58,sl 1.23659,0.0,-246.35999999998603,0.0,0.0,1.23269,07.01.2014 04:30:00,10034,-0.1155804469185604,-146.28,IS,0.34,0.0,Phase3-EA-S4v1-EURCHF-M15-221,EURCHFMT4,2616,8h 44m,Sell
122967.74,0.90827,08.01.2014 04:44:58,tp 0.90827,0.0,-182.5,0.0,0.0,0.90927,08.01.2014 00:45:00,10035,-0.08562035867283029,63.86,IS,0.58,0.0,Phase3-EA-SA2v2-USDCHF-M15-107,USDCHFMT4,1920,3h 59m,Sell
122893.18,171943,08.01.2014 06:35:00,,0.0,-257.0599999999977,0.0,0.0,171603,08.01.2014 01:10:00,10036,-0.12060038027637016,-74.56,IS,0.23,0.0,Phase3-EA-S4v1-GBPJPY-M5-194,GBPJPYMT4,2348,5h 25m,Sell
122881.45,1.23749,08.01.2014 07:35:00,,-2.25,-268.79000000000815,0.0,0.0,1.23728,07.01.2014 23:15:00,10037,-0.12610354086394931,-11.73,IS,0.41,0.0,Phase3-EA-SA2v2-EURCHF-M5-43,EURCHFMT4,5148,8h 20m,Sell
122818.76,143014,08.01.2014 07:59:58,sl 143.014,-0.9,-331.4800000000105,0.0,0.0,142294,03.01.2014 08:30:00,10038,-0.15551472050888043,-62.69,IS,0.09,0.0,Phase3-EA-TR1v1-EURJPY-M30-91,EURJPYMT4,1768,4d 23h 29m,Sell
122810.17,1.23841,08.01.2014 12:00:00,,0.0,-340.070000000007,0.0,0.0,1.23818,08.01.2014 03:15:00,10039,-0.1595447417746301,-8.59,IS,0.34,0.0,Phase3-EA-S4v1-EURCHF-M15-221,EURCHFMT4,2618,8h 45m,Sell
122748.39,142352,08.01.2014 13:59:57,sl 142.352,0.0,-401.8500000000058,0.0,0.0,143072,08.01.2014 08:00:00,10040,-0.1885289925078211,-61.78,IS,0.09,0.0,Phase3-EA-TR1v1-EURJPY-M30-91,EURJPYMT4,1770,5h 59m,Buy
122687.41,172688,08.01.2014 18:59:58,sl 172.688,-3.49,-462.8300000000163,0.0,0.0,172018,02.01.2014 22:00:00,10041,-0.21713792112080788,-60.98,IS,0.09,0.0,Phase3-EA-B1v1-GBPJPY-M30-1,GBPJPYMT4,962,5d 20h 59m,Sell
122688.18,104868,08.01.2014 22:30:00,,0.0,-462.0600000000268,0.0,0.0,104871,08.01.2014 18:45:00,10042,-0.216776673580111,0.77,IS,0.27,0.0,Phase3-EA-S1v2-USDJPY-M15-0,USDJPYMT4,2884,3h 45m,Sell
122666.11,1.23758,09.01.2014 10:10:00,,0.0,-484.13000000003376,0.0,0.0,1.23709,09.01.2014 01:50:00,10043,-0.22713087257139844,-22.07,IS,0.41,0.0,Phase3-EA-SA2v2-EURCHF-M5-43,EURCHFMT4,5150,8h 20m,Sell
122647.81,1.2376,09.01.2014 10:45:00,,0.0,-502.4300000000221,0.0,0.0,1.23711,09.01.2014 02:00:00,10044,-0.23571636607118912,-18.3,IS,0.34,0.0,Phase3-EA-S4v1-EURCHF-M15-221,EURCHFMT4,2620,8h 45m,Sell
122655.99,0.90725,10.01.2014 04:00:00,,-0.77,-494.2500000000291,0.0,0.0,0.90711,09.01.2014 23:45:00,10045,-0.23187869739204856,8.18,IS,0.58,0.0,Phase3-EA-SA2v2-USDCHF-M15-107,USDCHFMT4,1922,4h 15m,Buy
122624.45,172779,10.01.2014 04:50:00,,-1.27,-525.7900000000373,0.0,0.0,172641,09.01.2014 23:25:00,10046,-0.2466757719813185,-31.54,IS,0.23,0.0,Phase3-EA-S4v1-GBPJPY-M5-194,GBPJPYMT4,2350,5h 25m,Sell
122601.21,1.23398,10.01.2014 07:05:00,,-1.08,-549.0300000000279,0.0,0.0,1.23447,09.01.2014 22:45:00,10047,-0.257578879573405,-23.24,IS,0.41,0.0,Phase3-EA-SA2v2-EURCHF-M5-43,EURCHFMT4,5152,8h 20m,Buy
122606.09,1.23411,10.01.2014 09:45:00,,0.0,-544.1500000000233,0.0,0.0,1.23398,10.01.2014 01:00:00,10048,-0.2552894146401238,4.88,IS,0.34,0.0,Phase3-EA-S4v1-EURCHF-M15-221,EURCHFMT4,2622,8h 45m,Buy
122544.19,142.17,10.01.2014 16:29:59,sl 142.170,0.0,-606.0500000000175,0.0,0.0,142457,09.01.2014 06:30:00,10049,-0.28432996369134406,-61.9,IS,0.09,0.0,Phase3-EA-TR1v1-EURJPY-M30-91,EURJPYMT4,1772,1d 9h 59m,Buy
122608.41,0.90321,10.01.2014 22:59:58,tp 0.90321,0.0,-541.8300000000163,0.0,0.0,0.90221,10.01.2014 22:15:00,10050,-0.2542009804915125,64.22,IS,0.58,0.0,Phase3-EA-SA2v2-USDCHF-M15-107,USDCHFMT4,1924,44m 58s,Buy
122650.62,103946,13.01.2014 03:00:00,,-1.17,-499.62000000002445,0.0,0.0,104113,10.01.2014 23:15:00,10051,-0.23439804712395376,42.21,IS,0.27,0.0,Phase3-EA-S1v2-USDJPY-M15-0,USDJPYMT4,2886,2d 3h 45m,Sell
122582.22,141677,13.01.2014 04:59:57,sl 141.677,-0.84,-568.0200000000186,0.0,0.0,142.89,10.01.2014 09:00:00,10052,-0.26648808840187754,-68.4,IS,0.09,0.0,Phase3-EA-TR1v1-EURJPY-M30-91,EURJPYMT4,1773,2d 19h 59m,Buy
122404.55,170655,13.01.2014 05:04:57,sl 170.655,0.0,-745.6900000000314,0.0,0.0,171455,13.01.2014 03:05:00,10053,-0.34984243977394797,-177.67,IS,0.23,0.0,Phase3-EA-S4v1-GBPJPY-M5-194,GBPJPYMT4,2352,1h 59m,Buy
122679.07,141371,13.01.2014 05:14:57,tp 141.371,-4.55,-471.1700000000419,0.0,0.0,143071,03.01.2014 05:00:00,10054,-0.22105065422400566,274.52,IS,0.17,0.0,Phase3-EA-T1v2-EURJPY-M15-322,EURJPYMT4,1788,10d 0h 14m,Sell
122592.17,0.90104,13.01.2014 06:30:00,,0.0,-558.0700000000361,0.0,0.0,0.90239,13.01.2014 02:15:00,10055,-0.261820019531778,-86.9,IS,0.58,0.0,Phase3-EA-SA2v2-USDCHF-M15-107,USDCHFMT4,1926,4h 15m,Buy
122549.64,1.64459,13.01.2014 11:29:58,sl 1.64459,-0.53,-600.6000000000349,0.0,0.0,1.64759,10.01.2014 17:00:00,10056,-0.2817730817474239,-42.53,IS,0.14,0.0,Phase3-EA-B1v1-GBPUSD-M30-14,GBPUSDMT4,650,2d 18h 29m,Buy
122658.93,140981,13.01.2014 16:59:58,tp 140.981,-0.3,-491.3100000000268,0.0,0.0,142241,10.01.2014 21:30:00,10057,-0.23049938860027694,109.29,IS,0.09,0.0,Phase3-EA-TR1v1-EURJPY-M30-91,EURJPYMT4,1775,2d 19h 29m,Sell
122820.2,168.58,13.01.2014 17:29:58,tp 168.580,0.0,-330.04000000003725,0.0,0.0,170.43,13.01.2014 11:00:00,10058,-0.15483914069251561,161.27,IS,0.09,0.0,Phase3-EA-B1v1-GBPJPY-M30-1,GBPJPYMT4,964,6h 29m,Sell
122761.26,169.37,14.01.2014 03:59:58,sl 169.370,-0.51,-388.9800000000396,0.0,0.0,168.7,13.01.2014 21:30:00,10059,-0.18249099789896392,-58.94,IS,0.09,0.0,Phase3-EA-B1v1-GBPJPY-M30-1,GBPJPYMT4,966,6h 29m,Sell
122710.53,1.22979,14.01.2014 05:25:00,,-1.09,-439.71000000005006,0.0,0.0,1.23088,13.01.2014 21:05:00,10060,-0.20629111184676432,-50.73,IS,0.41,0.0,Phase3-EA-SA2v2-EURCHF-M5-43,EURCHFMT4,5154,8h 20m,Buy
122628.4,169349,14.01.2014 08:10:00,,0.0,-521.8400000000547,0.0,0.0,168.98,14.01.2014 02:45:00,10061,-0.24482261901279145,-82.13,IS,0.23,0.0,Phase3-EA-S4v1-GBPJPY-M5-194,GBPJPYMT4,2354,5h 25m,Sell
122703.43,1.23116,14.01.2014 10:30:00,,0.0,-446.8100000000559,0.0,0.0,1.22917,14.01.2014 01:45:00,10062,-0.20962209566362786,75.03,IS,0.34,0.0,Phase3-EA-S4v1-EURCHF-M15-221,EURCHFMT4,2624,8h 45m,Buy
122487.7,103.88,14.01.2014 19:59:57,sl 103.880,0.0,-662.5400000000664,0.0,0.0,103.05,14.01.2014 01:30:00,10063,-0.3108323969046721,-215.73,IS,0.27,0.0,Phase3-EA-S1v2-USDJPY-M15-0,USDJPYMT4,2888,18h 29m,Sell
122598.83,142408,14.01.2014 22:29:58,tp 142.408,-0.43,-551.4100000000617,0.0,0.0,141118,13.01.2014 19:00:00,10064,-0.25869546288104456,111.13,IS,0.09,0.0,Phase3-EA-TR1v1-EURJPY-M30-91,EURJPYMT4,1778,1d 3h 29m,Buy
122508.74,1.23515,15.01.2014 05:20:00,,-2.27,-641.5000000000582,0.0,0.0,1.23321,14.01.2014 21:00:00,10065,-0.30096142514315405,-90.09,IS,0.41,0.0,Phase3-EA-SA2v2-EURCHF-M5-43,EURCHFMT4,5156,8h 20m,Sell
122594.63,171502,15.01.2014 05:54:57,tp 171.502,0.0,-555.6100000000442,0.0,0.0,171112,15.01.2014 03:30:00,10066,-0.26066590401213713,85.89,IS,0.23,0.0,Phase3-EA-S4v1-GBPJPY-M5-194,GBPJPYMT4,2356,2h 24m,Buy
122559.35,1.23538,15.01.2014 09:45:00,,0.0,-590.8900000000431,0.0,0.0,1.23444,15.01.2014 01:00:00,10067,-0.27721760951338287,-35.28,IS,0.34,0.0,Phase3-EA-S4v1-EURCHF-M15-221,EURCHFMT4,2626,8h 45m,Sell
122579.78,0.90841,16.01.2014 06:30:00,,0.0,-570.4600000000501,0.0,0.0,0.90873,16.01.2014 02:15:00,10068,-0.2676328208685318,20.43,IS,0.58,0.0,Phase3-EA-SA2v2-USDCHF-M15-107,USDCHFMT4,1928,4h 15m,Sell
122579.78,1.23625,16.01.2014 11:00:00,,0.0,-570.4600000000501,0.0,0.0,1.23625,16.01.2014 02:15:00,10069,-0.2676328208685318,0.0,IS,0.34,0.0,Phase3-EA-S4v1-EURCHF-M15-221,EURCHFMT4,2628,8h 45m,Sell
122607.62,104279,17.01.2014 02:45:00,,-1.16,-542.6200000000536,0.0,0.0,104391,16.01.2014 21:00:00,10070,-0.254571611085237,27.84,IS,0.27,0.0,Phase3-EA-S1v2-USDJPY-M15-0,USDJPYMT4,2890,5h 45m,Sell
122617.4,1.23253,17.01.2014 04:40:00,,-1.09,-532.8400000000547,0.0,0.0,1.23229,16.01.2014 20:20:00,10071,-0.24998329816567438,9.78,IS,0.41,0.0,Phase3-EA-SA2v2-EURCHF-M5-43,EURCHFMT4,5158,8h 20m,Buy
122594.14,1.2331,17.01.2014 13:45:00,,0.0,-556.100000000064,0.0,0.0,1.23248,17.01.2014 05:00:00,10072,-0.2608957888107748,-23.26,IS,0.34,0.0,Phase3-EA-S4v1-EURCHF-M15-221,EURCHFMT4,2630,8h 45m,Sell
122529.99,141509,17.01.2014 16:59:58,sl 141.509,-2.1,-620.2500000000582,0.0,0.0,142229,14.01.2014 21:30:00,10073,-0.2909919313250848,-64.15,IS,0.09,0.0,Phase3-EA-TR1v1-EURJPY-M30-91,EURJPYMT4,1779,2d 19h 29m,Buy
122593.57,0.91227,20.01.2014 03:14:58,tp 0.91227,0.0,-556.670000000071,0.0,0.0,0.91127,20.01.2014 02:15:00,10074,-0.2611632058214275,63.58,IS,0.58,0.0,Phase3-EA-SA2v2-USDCHF-M15-107,USDCHFMT4,1930,59m 58s,Buy
122611.69,170828,20.01.2014 09:00:00,,0.0,-538.5500000000757,0.0,0.0,170746,20.01.2014 03:35:00,10075,-0.25266215979868073,18.12,IS,0.23,0.0,Phase3-EA-S4v1-GBPJPY-M5-194,GBPJPYMT4,2358,5h 25m,Buy
122661.19,1.23391,20.01.2014 10:04:58,tp 1.23391,0.0,-489.05000000007567,0.0,0.0,1.23281,20.01.2014 02:05:00,10076,-0.22943910361070757,49.5,IS,0.41,0.0,Phase3-EA-SA2v2-EURCHF-M5-43,EURCHFMT4,5160,7h 59m,Buy
122669.78,1.23307,20.01.2014 12:30:00,,0.0,-480.46000000007916,0.0,0.0,1.2333,20.01.2014 03:45:00,10077,-0.2254090823449579,8.59,IS,0.34,0.0,Phase3-EA-S4v1-EURCHF-M15-221,EURCHFMT4,2632,8h 45m,Sell
122732.73,0.91017,21.01.2014 01:14:58,tp 0.91017,-0.77,-417.5100000000675,0.0,0.0,0.90917,20.01.2014 22:15:00,10078,-0.19587592301095427,62.95,IS,0.58,0.0,Phase3-EA-SA2v2-USDCHF-M15-107,USDCHFMT4,1932,2h 59m,Buy
122639.26,171844,21.01.2014 08:50:00,,0.0,-510.9800000000687,0.0,0.0,171419,21.01.2014 03:25:00,10079,-0.2397276212309518,-93.47,IS,0.23,0.0,Phase3-EA-S4v1-GBPJPY-M5-194,GBPJPYMT4,2360,5h 25m,Sell
122583.47,1.23527,21.01.2014 10:50:00,,0.0,-566.7700000000768,0.0,0.0,1.23403,21.01.2014 02:30:00,10080,-0.26590164758907725,-55.79,IS,0.41,0.0,Phase3-EA-SA2v2-EURCHF-M5-43,EURCHFMT4,5162,8h 20m,Sell
122491.53,1.23639,21.01.2014 11:45:00,,0.0,-658.7100000000792,0.0,0.0,1.23392,21.01.2014 03:00:00,10081,-0.30903554225417434,-91.94,IS,0.34,0.0,Phase3-EA-S4v1-EURCHF-M15-221,EURCHFMT4,2634,8h 45m,Sell
122648.4,172115,21.01.2014 13:29:58,tp 172.115,-2.17,-501.8400000000838,0.0,0.0,170265,14.01.2014 14:30:00,10082,-0.23543956600756344,156.87,IS,0.09,0.0,Phase3-EA-B1v1-GBPJPY-M30-1,GBPJPYMT4,968,6d 22h 59m,Buy
122600.89,1.64694,21.01.2014 16:59:58,sl 1.64694,-5.51,-549.3500000000931,0.0,0.0,1.64394,13.01.2014 11:30:00,10083,-0.2577290084215194,-47.51,IS,0.14,0.0,Phase3-EA-B1v1-GBPUSD-M30-14,GBPUSDMT4,652,8d 5h 29m,Sell
122623.05,104196,22.01.2014 02:45:00,,-1.16,-527.1900000000896,0.0,0.0,104286,21.01.2014 23:15:00,10084,-0.24733258569171,22.16,IS,0.27,0.0,Phase3-EA-S1v2-USDJPY-M15-0,USDJPYMT4,2892,3h 30m,Sell
122593.75,1.23476,22.01.2014 06:30:00,,-2.25,-556.490000000078,0.0,0.0,1.23416,21.01.2014 22:10:00,10085,-0.2610787583443836,-29.3,IS,0.41,0.0,Phase3-EA-SA2v2-EURCHF-M5-43,EURCHFMT4,5164,8h 20m,Sell
122661.17,171993,22.01.2014 08:15:00,,0.0,-489.0700000000652,0.0,0.0,171687,22.01.2014 02:50:00,10086,-0.2294484866637079,67.42,IS,0.23,0.0,Phase3-EA-S4v1-GBPJPY-M5-194,GBPJPYMT4,2362,5h 25m,Buy
122683.21,1.23423,22.01.2014 14:45:00,,0.0,-467.03000000005704,0.0,0.0,1.23482,22.01.2014 06:00:00,10087,-0.21910836225192773,22.04,IS,0.34,0.0,Phase3-EA-S4v1-EURCHF-M15-221,EURCHFMT4,2636,8h 45m,Sell
122619.48,141867,23.01.2014 03:29:58,sl 141.867,-1.8,-530.7600000000675,0.0,0.0,141147,17.01.2014 21:00:00,10088,-0.24900746065313525,-63.73,IS,0.09,0.0,Phase3-EA-TR1v1-EURJPY-M30-91,EURJPYMT4,1782,5d 6h 29m,Sell
122705.29,173126,23.01.2014 05:19:57,tp 173.126,0.0,-444.95000000006985,0.0,0.0,173516,23.01.2014 03:40:00,10089,-0.20874947173414693,85.81,IS,0.23,0.0,Phase3-EA-S4v1-GBPJPY-M5-194,GBPJPYMT4,2364,1h 39m,Sell
122754.79,1.23434,23.01.2014 09:54:58,tp 1.23434,0.0,-395.45000000006985,0.0,0.0,1.23544,23.01.2014 02:50:00,10090,-0.1855264155461738,49.5,IS,0.41,0.0,Phase3-EA-SA2v2-EURCHF-M5-43,EURCHFMT4,5166,7h 4m,Sell
122904.72,1.23175,23.01.2014 11:14:58,tp 1.23175,0.0,-245.52000000007683,0.0,0.0,1.23575,23.01.2014 05:15:00,10091,-0.11518635869238285,149.93,IS,0.34,0.0,Phase3-EA-S4v1-EURCHF-M15-221,EURCHFMT4,2638,5h 59m,Sell
122863.83,142182,23.01.2014 11:44:57,sl 142.182,-3.42,-286.4100000000908,0.0,0.0,141952,17.01.2014 15:00:00,10092,-0.13437001056160602,-40.89,IS,0.17,0.0,Phase3-EA-T1v2-EURJPY-M15-322,EURJPYMT4,1790,5d 20h 44m,Sell
122928.44,0.89766,23.01.2014 22:29:58,tp 0.89766,0.0,-221.80000000010477,0.0,0.0,0.89666,23.01.2014 22:15:00,10093,-0.10405805782817934,64.61,IS,0.58,0.0,Phase3-EA-SA2v2-USDCHF-M15-107,USDCHFMT4,1934,14m 58s,Buy
122902.25,1.22973,24.01.2014 04:50:00,,-1.1,-247.9900000001071,0.0,0.0,1.23028,23.01.2014 20:30:00,10094,-0.1163451657385444,-26.19,IS,0.41,0.0,Phase3-EA-SA2v2-EURCHF-M5-43,EURCHFMT4,5168,8h 20m,Buy
122815.82,172161,24.01.2014 06:25:00,,0.0,-334.4200000001001,0.0,0.0,171772,24.01.2014 01:00:00,10095,-0.15689402930069302,-86.43,IS,0.23,0.0,Phase3-EA-S4v1-GBPJPY-M5-194,GBPJPYMT4,2366,5h 25m,Sell
122841.45,103237,24.01.2014 08:00:00,,0.0,-308.79000000009546,0.0,0.0,103335,24.01.2014 01:30:00,10096,-0.14486964687447362,25.63,IS,0.27,0.0,Phase3-EA-S1v2-USDJPY-M15-0,USDJPYMT4,2894,6h 30m,Sell
122803.58,141516,24.01.2014 09:14:58,sl 141.516,0.0,-346.6600000000908,0.0,0.0,141286,24.01.2014 08:00:00,10097,-0.16263645773989657,-37.87,IS,0.17,0.0,Phase3-EA-T1v2-EURJPY-M15-322,EURJPYMT4,1792,1h 14m,Sell
122955.24,1.22575,24.01.2014 13:29:57,tp 1.22575,0.0,-195.0000000000873,0.0,0.0,1.22975,24.01.2014 05:45:00,10098,-0.0914847668011473,151.66,IS,0.34,0.0,Phase3-EA-S4v1-EURCHF-M15-221,EURCHFMT4,2640,7h 44m,Sell
122913.24,1.6602,24.01.2014 14:29:58,sl 1.66020,0.0,-237.0000000000873,0.0,0.0,1.6632,24.01.2014 05:30:00,10099,-0.11118917811215481,-42.0,IS,0.14,0.0,Phase3-EA-B1v1-GBPUSD-M30-14,GBPUSDMT4,654,8h 59m,Buy
123074.96,169995,24.01.2014 14:29:58,tp 169.995,-0.51,-75.28000000008615,0.0,0.0,171845,23.01.2014 20:30:00,10100,-0.03531781151177008,161.72,IS,0.09,0.0,Phase3-EA-B1v1-GBPJPY-M30-1,GBPJPYMT4,970,17h 59m,Sell
123123.26,102308,24.01.2014 18:00:00,,0.0,-26.98000000009779,0.0,0.0,102491,24.01.2014 17:00:00,10101,-0.012657738504116898,48.3,IS,0.27,0.0,Phase3-EA-S1v2-USDJPY-M15-0,USDJPYMT4,2896,1h 0m,Sell
123159.18,102.24,24.01.2014 23:30:00,,0.0,-0.0,0.0,0.0,102376,24.01.2014 18:15:00,10102,-0.0,35.92,IS,0.27,0.0,Phase3-EA-S1v2-USDJPY-M15-0,USDJPYMT4,2898,5h 15m,Sell
123220.62,0.89394,27.01.2014 02:14:58,tp 0.89394,-3.44,-0.0,0.0,0.0,0.89494,24.01.2014 23:00:00,10103,-0.0,61.44,IS,0.58,0.0,Phase3-EA-SA2v2-USDCHF-M15-107,USDCHFMT4,1936,2d 3h 14m,Sell
123308.51,168524,27.01.2014 03:04:58,tp 168.524,0.0,-0.0,0.0,0.0,168134,27.01.2014 02:15:00,10104,-0.0,87.89,IS,0.23,0.0,Phase3-EA-S4v1-GBPJPY-M5-194,GBPJPYMT4,2368,49m 58s,Buy
123358.93,1.22443,27.01.2014 05:49:57,tp 1.22443,0.0,-0.0,0.0,0.0,1.22333,27.01.2014 02:05:00,10105,-0.0,50.42,IS,0.41,0.0,Phase3-EA-SA2v2-EURCHF-M5-43,EURCHFMT4,5170,3h 44m,Buy
123299.64,169785,27.01.2014 10:59:58,sl 169.785,-0.51,-59.29000000000815,0.0,0.0,169115,24.01.2014 17:30:00,10106,-0.027788853271811825,-59.29,IS,0.09,0.0,Phase3-EA-B1v1-GBPJPY-M30-1,GBPJPYMT4,972,2d 17h 29m,Sell
123363.47,1.22498,27.01.2014 11:00:00,,0.0,-0.0,0.0,0.0,1.2233,27.01.2014 02:15:00,10107,-0.0,63.83,IS,0.34,0.0,Phase3-EA-S4v1-EURCHF-M15-221,EURCHFMT4,2642,8h 45m,Buy
123411.52,1.22487,28.01.2014 01:19:58,tp 1.22487,-2.29,-0.0,0.0,0.0,1.22597,27.01.2014 22:45:00,10108,-0.0,48.05,IS,0.41,0.0,Phase3-EA-SA2v2-EURCHF-M5-43,EURCHFMT4,5172,2h 34m,Sell
123472.85,0.89568,28.01.2014 01:29:57,tp 0.89568,-3.43,-0.0,0.0,0.0,0.89668,27.01.2014 22:30:00,10109,-0.0,61.33,IS,0.58,0.0,Phase3-EA-SA2v2-USDCHF-M15-107,USDCHFMT4,1938,2h 59m,Sell
123434.74,140.39,28.01.2014 02:29:58,sl 140.390,0.0,-38.10999999998603,0.0,0.0,140.16,28.01.2014 01:30:00,10110,-0.01785238731763114,-38.11,IS,0.17,0.0,Phase3-EA-T1v2-EURJPY-M15-322,EURJPYMT4,1794,59m 58s,Sell
123499.41,0.89691,28.01.2014 04:29:58,tp 0.89691,0.0,-0.0,0.0,0.0,0.89591,28.01.2014 01:30:00,10111,-0.0,64.67,IS,0.58,0.0,Phase3-EA-SA2v2-USDCHF-M15-107,USDCHFMT4,1940,2h 59m,Buy
123517.45,102558,28.01.2014 05:15:00,,-1.18,-0.0,0.0,0.0,102631,27.01.2014 22:30:00,10112,-0.0,18.04,IS,0.27,0.0,Phase3-EA-S1v2-USDJPY-M15-0,USDJPYMT4,2900,6h 45m,Sell
123549.03,1.22582,28.01.2014 09:40:00,,0.0,-0.0,0.0,0.0,1.22513,28.01.2014 01:20:00,10113,-0.0,31.58,IS,0.41,0.0,Phase3-EA-SA2v2-EURCHF-M5-43,EURCHFMT4,5174,8h 20m,Buy
123507.03,1.65813,28.01.2014 12:29:59,sl 1.65813,0.0,-42.0,0.0,0.0,1.66113,28.01.2014 06:30:00,10114,-0.01966761450520271,-42.0,IS,0.14,0.0,Phase3-EA-B1v1-GBPUSD-M30-14,GBPUSDMT4,656,5h 59m,Buy
123556.35,102985,29.01.2014 00:45:00,,-0.76,-0.0,0.0,0.0,102794,28.01.2014 17:00:00,10115,-0.0,49.32,IS,0.27,0.0,Phase3-EA-S1v2-USDJPY-M15-0,USDJPYMT4,2902,7h 45m,Buy
123620.9,0.89846,29.01.2014 01:14:58,tp 0.89846,0.0,-0.0,0.0,0.0,0.89746,29.01.2014 00:45:00,10116,-0.0,64.55,IS,0.58,0.0,Phase3-EA-SA2v2-USDCHF-M15-107,USDCHFMT4,1942,29m 58s,Buy
123669.98,1.22847,29.01.2014 01:19:58,tp 1.22847,-1.1,-0.0,0.0,0.0,1.22737,28.01.2014 22:20:00,10117,-0.0,49.08,IS,0.41,0.0,Phase3-EA-SA2v2-EURCHF-M5-43,EURCHFMT4,5176,2h 59m,Buy
123606.09,141094,29.01.2014 01:29:58,sl 141.094,-0.93,-63.89000000001397,0.0,0.0,140374,24.01.2014 15:30:00,10118,-0.029901252389321842,-63.89,IS,0.09,0.0,Phase3-EA-TR1v1-EURJPY-M30-91,EURJPYMT4,1784,4d 9h 59m,Sell
123670.54,0.89989,29.01.2014 01:29:58,tp 0.89989,0.0,-0.0,0.0,0.0,0.89889,29.01.2014 01:15:00,10119,-0.0,64.45,IS,0.58,0.0,Phase3-EA-SA2v2-USDCHF-M15-107,USDCHFMT4,1944,14m 58s,Buy
123605.67,171.02,29.01.2014 06:15:00,,0.0,-64.86999999999534,0.0,0.0,170729,29.01.2014 00:50:00,10120,-0.030359824054357172,-64.87,IS,0.23,0.0,Phase3-EA-S4v1-GBPJPY-M5-194,GBPJPYMT4,2370,5h 25m,Sell
123593.56,1.22886,29.01.2014 11:30:00,,0.0,-76.97999999998137,0.0,0.0,1.22854,29.01.2014 02:45:00,10121,-0.03602742802071863,-12.11,IS,0.34,0.0,Phase3-EA-S4v1-EURCHF-M15-221,EURCHFMT4,2644,8h 45m,Sell
123609.1,140702,29.01.2014 13:30:00,,-0.81,-61.439999999973224,0.0,0.0,140603,28.01.2014 23:45:00,10122,-0.028754548942485365,15.54,IS,0.17,0.0,Phase3-EA-T1v2-EURJPY-M15-322,EURJPYMT4,1796,13h 45m,Buy
123567.1,1.6569,29.01.2014 14:29:58,sl 1.65690,0.0,-103.43999999997322,0.0,0.0,1.6599,29.01.2014 11:30:00,10123,-0.04841097888364604,-42.0,IS,0.14,0.0,Phase3-EA-B1v1-GBPUSD-M30-14,GBPUSDMT4,658,2h 59m,Buy
123617.53,1.22314,29.01.2014 22:04:57,tp 1.22314,0.0,-53.00999999998021,0.0,0.0,1.22204,29.01.2014 20:40:00,10124,-0.02480922264715567,50.43,IS,0.41,0.0,Phase3-EA-SA2v2-EURCHF-M5-43,EURCHFMT4,5178,1h 24m,Buy
123682.32,0.89526,29.01.2014 22:14:58,tp 0.89526,0.0,-0.0,0.0,0.0,0.89426,29.01.2014 22:00:00,10125,-0.0,64.79,IS,0.58,0.0,Phase3-EA-SA2v2-USDCHF-M15-107,USDCHFMT4,1946,14m 58s,Buy
123687.61,102108,29.01.2014 22:30:00,,0.0,-0.0,0.0,0.0,102128,29.01.2014 22:15:00,10126,-0.0,5.29,IS,0.27,0.0,Phase3-EA-S1v2-USDJPY-M15-0,USDJPYMT4,2904,15m 0s,Sell
123631.77,102031,29.01.2014 23:00:00,,0.0,-55.83999999999651,0.0,0.0,102242,29.01.2014 22:45:00,10127,-0.026131603980219575,-55.84,IS,0.27,0.0,Phase3-EA-S1v2-USDJPY-M15-0,USDJPYMT4,2906,15m 0s,Buy
123686.55,102033,29.01.2014 23:00:00,,0.0,-1.0599999999976717,0.0,0.0,102.24,29.01.2014 22:45:00,10128,-4.960512216864906E-4,54.78,IS,0.27,0.0,Phase3-EA-S1v2-USDJPY-M15-0,USDJPYMT4,2907,15m 0s,Sell
123682.58,102046,29.01.2014 23:15:00,,0.0,-5.029999999998836,0.0,0.0,102031,29.01.2014 23:00:00,10129,-0.002353903438762218,-3.97,IS,0.27,0.0,Phase3-EA-S1v2-USDJPY-M15-0,USDJPYMT4,2910,15m 0s,Sell
123664.6,102112,29.01.2014 23:30:00,,0.0,-23.010000000009313,0.0,0.0,102044,29.01.2014 23:15:00,10130,-0.01076805529343004,-17.98,IS,0.27,0.0,Phase3-EA-S1v2-USDJPY-M15-0,USDJPYMT4,2912,15m 0s,Sell
123639.77,102204,29.01.2014 23:45:00,,0.0,-47.83999999999651,0.0,0.0,102.11,29.01.2014 23:30:00,10131,-0.02238782117503029,-24.83,IS,0.27,0.0,Phase3-EA-S1v2-USDJPY-M15-0,USDJPYMT4,2914,15m 0s,Sell
123690.13,1223,30.01.2014 06:54:58,tp 1.22300,0.0,-0.0,0.0,0.0,1.2219,30.01.2014 01:55:00,10132,-0.0,50.36,IS,0.41,0.0,Phase3-EA-SA2v2-EURCHF-M5-43,EURCHFMT4,5180,4h 59m,Buy
123651.91,139749,30.01.2014 07:14:58,sl 139.749,0.0,-38.220000000001164,0.0,0.0,139519,30.01.2014 04:45:00,10133,-0.017885711427102824,-38.22,IS,0.17,0.0,Phase3-EA-T1v2-EURJPY-M15-322,EURJPYMT4,1798,2h 29m,Sell
123612.62,1.22356,30.01.2014 15:00:00,,0.0,-77.51000000000931,0.0,0.0,1.22252,30.01.2014 06:15:00,10134,-0.03627214789939467,-39.29,IS,0.34,0.0,Phase3-EA-S4v1-EURCHF-M15-221,EURCHFMT4,2646,8h 45m,Sell
123575.22,0.9025,31.01.2014 02:45:00,,-0.77,-114.91000000000349,0.0,0.0,0.90307,30.01.2014 22:30:00,10135,-0.053774126114295794,-37.4,IS,0.58,0.0,Phase3-EA-SA2v2-USDCHF-M15-107,USDCHFMT4,1948,4h 15m,Buy
123594.42,102.79,31.01.2014 02:45:00,,-0.76,-95.70999999999185,0.0,0.0,102714,30.01.2014 21:45:00,10136,-0.04478915334086377,19.2,IS,0.27,0.0,Phase3-EA-S1v2-USDJPY-M15-0,USDJPYMT4,2916,5h 0m,Buy
123548.33,1.22272,31.01.2014 06:40:00,,-1.09,-141.79999999998836,0.0,0.0,1.22371,30.01.2014 22:20:00,10137,-0.06635776767040541,-46.09,IS,0.41,0.0,Phase3-EA-SA2v2-EURCHF-M5-43,EURCHFMT4,5182,8h 20m,Buy
123558.87,1.22345,31.01.2014 09:45:00,,0.0,-131.2599999999802,0.0,0.0,1.22317,31.01.2014 01:00:00,10138,-0.06142539199165597,10.54,IS,0.34,0.0,Phase3-EA-S4v1-EURCHF-M15-221,EURCHFMT4,2648,8h 45m,Buy
123668.56,138147,31.01.2014 16:29:57,tp 138.147,-1.23,-21.56999999997788,0.0,0.0,139407,29.01.2014 17:00:00,10139,-0.010094055350136069,109.69,IS,0.09,0.0,Phase3-EA-TR1v1-EURJPY-M30-91,EURJPYMT4,1786,1d 23h 29m,Sell
123950.39,137853,31.01.2014 18:29:58,tp 137.853,-0.58,-0.0,0.0,0.0,139553,30.01.2014 11:15:00,10140,-0.0,281.83,IS,0.17,0.0,Phase3-EA-T1v2-EURJPY-M15-322,EURJPYMT4,1800,1d 7h 14m,Sell
123954.09,102069,31.01.2014 18:45:00,,0.0,-0.0,0.0,0.0,102083,31.01.2014 18:30:00,10141,-0.0,3.7,IS,0.27,0.0,Phase3-EA-S1v2-USDJPY-M15-0,USDJPYMT4,2918,15m 0s,Sell
123965.32,102144,03.02.2014 02:00:00,,-1.19,-0.0,0.0,0.0,102191,31.01.2014 19:45:00,10142,-0.0,11.23,IS,0.27,0.0,Phase3-EA-S1v2-USDJPY-M15-0,USDJPYMT4,2920,2d 6h 15m,Sell
123920.59,1.22372,03.02.2014 07:10:00,,-2.26,-44.73000000001048,0.0,0.0,1.22278,31.01.2014 22:50:00,10143,-0.020905256982771847,-44.73,IS,0.41,0.0,Phase3-EA-SA2v2-EURCHF-M5-43,EURCHFMT4,5184,2d 8h 20m,Sell
123882.3,137962,03.02.2014 11:14:57,sl 137.962,0.0,-83.02000000001863,0.0,0.0,137732,03.02.2014 09:15:00,10144,-0.03880068040933829,-38.29,IS,0.17,0.0,Phase3-EA-T1v2-EURJPY-M15-322,EURJPYMT4,1802,1h 59m,Sell
123933.43,1.22209,03.02.2014 13:30:00,,0.0,-31.89000000001397,0.0,0.0,1.22345,03.02.2014 04:45:00,10145,-0.014904284488726362,51.13,IS,0.34,0.0,Phase3-EA-S4v1-EURCHF-M15-221,EURCHFMT4,2650,8h 45m,Sell
123951.74,101738,03.02.2014 18:00:00,,0.0,-13.580000000016298,0.0,0.0,101807,03.02.2014 17:45:00,10146,-0.006346822933742811,18.31,IS,0.27,0.0,Phase3-EA-S1v2-USDJPY-M15-0,USDJPYMT4,2922,15m 0s,Sell
124063.5,136526,03.02.2014 22:59:58,tp 136.526,-0.31,-0.0,0.0,0.0,137786,31.01.2014 18:30:00,10147,-0.0,111.76,IS,0.09,0.0,Phase3-EA-TR1v1-EURJPY-M30-91,EURJPYMT4,1788,3d 4h 29m,Sell
124151.45,164826,04.02.2014 01:34:58,tp 164.826,-0.82,-0.0,0.0,0.0,164436,03.02.2014 23:00:00,10148,-0.0,87.95,IS,0.23,0.0,Phase3-EA-S4v1-GBPJPY-M5-194,GBPJPYMT4,2372,2h 34m,Buy
124157.63,1.2192,04.02.2014 04:25:00,,-1.09,-0.0,0.0,0.0,1.21904,03.02.2014 20:05:00,10149,-0.0,6.18,IS,0.41,0.0,Phase3-EA-SA2v2-EURCHF-M5-43,EURCHFMT4,5186,8h 20m,Buy
124122.42,164986,04.02.2014 07:20:00,,0.0,-35.20999999999185,0.0,0.0,164831,04.02.2014 01:55:00,10150,-0.01644116065348294,-35.21,IS,0.23,0.0,Phase3-EA-S4v1-GBPJPY-M5-194,GBPJPYMT4,2374,5h 25m,Sell
124168.16,100936,04.02.2014 09:00:00,,0.0,-0.0,0.0,0.0,101107,04.02.2014 01:45:00,10151,-0.0,45.74,IS,0.27,0.0,Phase3-EA-S1v2-USDJPY-M15-0,USDJPYMT4,2924,7h 15m,Sell
124431.38,1.62736,04.02.2014 09:29:58,tp 1.62736,-1.38,-0.0,0.0,0.0,1.64626,31.01.2014 11:00:00,10152,-0.0,263.22,IS,0.14,0.0,Phase3-EA-B1v1-GBPUSD-M30-14,GBPUSDMT4,660,3d 22h 29m,Sell
124452.88,1.21931,04.02.2014 10:00:00,,0.0,-0.0,0.0,0.0,1.21874,04.02.2014 01:15:00,10153,-0.0,21.5,IS,0.34,0.0,Phase3-EA-S4v1-EURCHF-M15-221,EURCHFMT4,2652,8h 45m,Buy
124483.5,101.41,04.02.2014 18:00:00,,0.0,-0.0,0.0,0.0,101295,04.02.2014 17:45:00,10154,-0.0,30.62,IS,0.27,0.0,Phase3-EA-S1v2-USDJPY-M15-0,USDJPYMT4,2926,15m 0s,Buy
124499.46,101472,04.02.2014 18:15:00,,0.0,-0.0,0.0,0.0,101412,04.02.2014 18:00:00,10155,-0.0,15.96,IS,0.27,0.0,Phase3-EA-S1v2-USDJPY-M15-0,USDJPYMT4,2928,15m 0s,Buy
124496.77,0.90421,05.02.2014 02:30:00,,-0.77,-2.6900000000023283,0.0,0.0,0.90424,04.02.2014 22:15:00,10156,-0.0012540824112108756,-2.69,IS,0.58,0.0,Phase3-EA-SA2v2-USDCHF-M15-107,USDCHFMT4,1950,4h 15m,Buy
124454.4,1.22129,05.02.2014 07:45:00,,-1.09,-45.05999999999767,0.0,0.0,1.2222,04.02.2014 23:25:00,10157,-0.021007045891862537,-42.37,IS,0.41,0.0,Phase3-EA-SA2v2-EURCHF-M5-43,EURCHFMT4,5188,8h 20m,Buy
124456.66,1.22167,05.02.2014 10:15:00,,0.0,-42.79999999998836,0.0,0.0,1.22161,05.02.2014 01:30:00,10158,-0.01995343018578603,2.26,IS,0.34,0.0,Phase3-EA-S4v1-EURCHF-M15-221,EURCHFMT4,2654,8h 45m,Buy
124392.71,136681,05.02.2014 10:59:58,sl 136.681,0.0,-106.75,0.0,0.0,136.77,04.02.2014 02:30:00,10159,-0.049767025054514906,-63.95,IS,0.09,0.0,Phase3-EA-TR1v1-EURJPY-M30-91,EURJPYMT4,1790,1d 8h 29m,Buy
124350.71,1.6299,05.02.2014 12:29:58,sl 1.62990,0.0,-148.75,0.0,0.0,1.6329,05.02.2014 03:00:00,10160,-0.06934749392842242,-42.0,IS,0.14,0.0,Phase3-EA-B1v1-GBPUSD-M30-14,GBPUSDMT4,662,9h 29m,Buy
124394.68,101484,06.02.2014 01:15:00,,-2.32,-104.77999999999884,0.0,0.0,101.31,05.02.2014 23:00:00,10161,-0.048848607824000134,43.97,IS,0.27,0.0,Phase3-EA-S1v2-USDJPY-M15-0,USDJPYMT4,2930,2h 15m,Buy
124480.65,165702,06.02.2014 03:04:58,tp 165.702,-2.45,-18.80999999999767,0.0,0.0,165312,05.02.2014 23:10:00,10162,-0.008769252845670348,85.97,IS,0.23,0.0,Phase3-EA-S4v1-GBPJPY-M5-194,GBPJPYMT4,2376,3h 54m,Buy
124569.09,165.39,06.02.2014 04:44:57,tp 165.390,0.0,-0.0,0.0,0.0,165.78,06.02.2014 03:30:00,10163,-0.0,88.44,IS,0.23,0.0,Phase3-EA-S4v1-GBPJPY-M5-194,GBPJPYMT4,2378,1h 14m,Sell
124543.24,1.22326,06.02.2014 07:10:00,,-6.81,-25.85000000000582,0.0,0.0,1.22284,05.02.2014 22:50:00,10164,-0.012047401608500844,-25.85,IS,0.41,0.0,Phase3-EA-SA2v2-EURCHF-M5-43,EURCHFMT4,5190,8h 20m,Sell
124532.7,137384,06.02.2014 08:00:00,,0.0,-36.39000000001397,0.0,0.0,137447,06.02.2014 07:30:00,10165,-0.016959572322375834,-10.54,IS,0.17,0.0,Phase3-EA-T1v2-EURJPY-M15-322,EURJPYMT4,1804,30m 0s,Buy
124565.81,1.22245,06.02.2014 11:30:00,,0.0,-3.2800000000279397,0.0,0.0,1.22333,06.02.2014 02:45:00,10166,-0.0015286451557528229,33.11,IS,0.34,0.0,Phase3-EA-S4v1-EURCHF-M15-221,EURCHFMT4,2656,8h 45m,Sell
124527.29,137131,06.02.2014 15:14:58,sl 137.131,0.0,-41.80000000001746,0.0,0.0,137361,06.02.2014 13:45:00,10167,-0.019480904728643413,-38.52,IS,0.17,0.0,Phase3-EA-T1v2-EURJPY-M15-322,EURJPYMT4,1806,1h 29m,Buy
124488.77,137332,06.02.2014 16:44:58,sl 137.332,0.0,-80.32000000000698,0.0,0.0,137102,06.02.2014 15:15:00,10168,-0.037433164301534004,-38.52,IS,0.17,0.0,Phase3-EA-T1v2-EURJPY-M15-322,EURJPYMT4,1808,1h 29m,Sell
124601.68,138.06,06.02.2014 17:29:58,tp 138.060,-1.74,-0.0,0.0,0.0,137401,05.02.2014 01:00:00,10169,-0.0,112.91,IS,0.09,0.0,Phase3-EA-TR1v1-EURJPY-M30-91,EURJPYMT4,1791,1d 16h 29m,Buy
124539.85,166283,06.02.2014 18:29:57,sl 166.283,-2.57,-61.829999999987194,0.0,0.0,165613,03.02.2014 18:30:00,10170,-0.02881151722576763,-61.83,IS,0.09,0.0,Phase3-EA-B1v1-GBPJPY-M30-1,GBPJPYMT4,974,2d 23h 59m,Sell
124655.72,138613,07.02.2014 05:30:00,,-0.82,-0.0,0.0,0.0,137913,06.02.2014 17:15:00,10171,-0.0,115.87,IS,0.17,0.0,Phase3-EA-T1v2-EURJPY-M15-322,EURJPYMT4,1810,12h 15m,Buy
124621.58,1.22417,07.02.2014 05:35:00,,-2.28,-34.14000000001397,0.0,0.0,1.22347,06.02.2014 21:15:00,10172,-0.01590453774071975,-34.14,IS,0.41,0.0,Phase3-EA-SA2v2-EURCHF-M5-43,EURCHFMT4,5192,8h 20m,Sell
124625.41,166476,07.02.2014 07:30:00,,0.0,-30.310000000026776,0.0,0.0,166459,07.02.2014 02:05:00,10173,-0.014120285264248513,3.83,IS,0.23,0.0,Phase3-EA-S4v1-GBPJPY-M5-194,GBPJPYMT4,2380,5h 25m,Buy
124628.05,1.22422,07.02.2014 09:45:00,,0.0,-27.670000000012806,0.0,0.0,1.22429,07.02.2014 01:00:00,10174,-0.012890408883589312,2.64,IS,0.34,0.0,Phase3-EA-S4v1-EURCHF-M15-221,EURCHFMT4,2658,8h 45m,Sell
124586.05,1.63051,07.02.2014 12:59:57,sl 1.63051,0.0,-69.6700000000128,0.0,0.0,1.63351,07.02.2014 09:30:00,10175,-0.03245662403033671,-42.0,IS,0.14,0.0,Phase3-EA-B1v1-GBPUSD-M30-14,GBPUSDMT4,664,3h 29m,Buy
124547.9,138579,07.02.2014 16:44:58,sl 138.579,0.0,-107.82000000000698,0.0,0.0,138809,07.02.2014 16:00:00,10176,-0.05022926945529622,-38.15,IS,0.17,0.0,Phase3-EA-T1v2-EURJPY-M15-322,EURJPYMT4,1812,44m 58s,Buy
124478.98,139518,10.02.2014 02:00:00,sl 139.518,-0.31,-176.7400000000198,0.0,0.0,138738,07.02.2014 11:00:00,10177,-0.08233649678658386,-68.92,IS,0.09,0.0,Phase3-EA-TR1v1-EURJPY-M30-91,EURJPYMT4,1794,2d 15h 0m,Sell
124565.57,102609,10.02.2014 02:00:00,,-0.77,-90.15000000002328,0.0,0.0,102277,07.02.2014 23:30:00,10178,-0.04199748322570794,86.59,IS,0.27,0.0,Phase3-EA-S1v2-USDJPY-M15-0,USDJPYMT4,2932,2d 2h 30m,Buy
124600.94,0.89853,10.02.2014 02:30:00,,-0.78,-54.78000000002794,0.0,0.0,0.89797,07.02.2014 22:15:00,10179,-0.025519934898556407,35.37,IS,0.58,0.0,Phase3-EA-SA2v2-USDCHF-M15-107,USDCHFMT4,1952,2d 4h 15m,Buy
124650.0,1.22454,10.02.2014 03:29:58,tp 1.22454,-1.1,-5.720000000030268,0.0,0.0,1.22344,07.02.2014 22:05:00,10180,-0.002664732158094937,49.06,IS,0.41,0.0,Phase3-EA-SA2v2-EURCHF-M5-43,EURCHFMT4,5194,2d 5h 24m,Buy
124591.13,167603,10.02.2014 10:29:58,sl 167.603,0.0,-64.59000000002561,0.0,0.0,168273,10.02.2014 02:30:00,10181,-0.030090043722117037,-58.87,IS,0.09,0.0,Phase3-EA-B1v1-GBPJPY-M30-1,GBPJPYMT4,976,7h 59m,Buy
124664.33,1.22267,10.02.2014 13:30:00,,0.0,-0.0,0.0,0.0,1.2246,10.02.2014 04:45:00,10182,-0.0,73.2,IS,0.34,0.0,Phase3-EA-S4v1-EURCHF-M15-221,EURCHFMT4,2660,8h 45m,Sell
124659.29,1.22378,11.02.2014 08:35:00,,0.0,-5.040000000008149,0.0,0.0,1.22367,11.02.2014 00:15:00,10183,-0.0023478516435441843,-5.04,IS,0.41,0.0,Phase3-EA-SA2v2-EURCHF-M5-43,EURCHFMT4,5196,8h 20m,Sell
124690.05,1.22399,11.02.2014 13:00:00,,0.0,-0.0,0.0,0.0,1.22318,11.02.2014 04:15:00,10184,-0.0,30.76,IS,0.34,0.0,Phase3-EA-S4v1-EURCHF-M15-221,EURCHFMT4,2662,8h 45m,Buy
124703.46,102661,12.02.2014 01:45:00,,0.0,-0.0,0.0,0.0,102.61,12.02.2014 01:15:00,10185,-0.0,13.41,IS,0.27,0.0,Phase3-EA-S1v2-USDJPY-M15-0,USDJPYMT4,2934,30m 0s,Buy
124693.2,102624,12.02.2014 02:00:00,,0.0,-10.260000000009313,0.0,0.0,102663,12.02.2014 01:45:00,10186,-0.004778684051020526,-10.26,IS,0.27,0.0,Phase3-EA-S1v2-USDJPY-M15-0,USDJPYMT4,2936,15m 0s,Buy
124672.66,1.22497,12.02.2014 04:20:00,,-2.28,-30.800000000017462,0.0,0.0,1.22457,11.02.2014 20:00:00,10187,-0.014345367326645424,-20.54,IS,0.41,0.0,Phase3-EA-SA2v2-EURCHF-M5-43,EURCHFMT4,5198,8h 20m,Sell
124630.66,1.64675,12.02.2014 12:59:58,sl 1.64675,0.0,-72.80000000001746,0.0,0.0,1.64375,12.02.2014 10:30:00,10188,-0.033907231862969005,-42.0,IS,0.14,0.0,Phase3-EA-B1v1-GBPUSD-M30-14,GBPUSDMT4,666,2h 29m,Sell
124566.52,138965,12.02.2014 14:59:58,sl 138.965,-0.86,-136.94000000003143,0.0,0.0,139685,10.02.2014 02:30:00,10189,-0.06378099356201823,-64.14,IS,0.09,0.0,Phase3-EA-TR1v1-EURJPY-M30-91,EURJPYMT4,1796,2d 12h 29m,Buy
124616.57,1.22523,12.02.2014 21:44:57,tp 1.22523,0.0,-86.89000000004307,0.0,0.0,1.22413,12.02.2014 20:00:00,10190,-0.04046977165623806,50.05,IS,0.41,0.0,Phase3-EA-SA2v2-EURCHF-M5-43,EURCHFMT4,5200,1h 44m,Buy
124642.98,102546,13.02.2014 01:45:00,,-2.29,-60.48000000003958,0.0,0.0,102437,12.02.2014 22:45:00,10191,-0.02816908493232439,26.41,IS,0.27,0.0,Phase3-EA-S1v2-USDJPY-M15-0,USDJPYMT4,2938,3h 0m,Buy
124730.67,169918,13.02.2014 04:54:57,tp 169.918,0.0,-0.0,0.0,0.0,170308,13.02.2014 01:50:00,10192,-0.0,87.69,IS,0.23,0.0,Phase3-EA-S4v1-GBPJPY-M5-194,GBPJPYMT4,2382,3h 4m,Sell
124679.46,1.22298,13.02.2014 07:05:00,,-3.28,-51.20999999999185,0.0,0.0,1.22403,12.02.2014 22:45:00,10193,-0.02384847958607472,-51.21,IS,0.41,0.0,Phase3-EA-SA2v2-EURCHF-M5-43,EURCHFMT4,5202,8h 20m,Buy
124610.47,1.22209,13.02.2014 12:15:00,,0.0,-120.19999999998254,0.0,0.0,1.22391,13.02.2014 03:30:00,10194,-0.05597709912607344,-68.99,IS,0.34,0.0,Phase3-EA-S4v1-EURCHF-M15-221,EURCHFMT4,2664,8h 45m,Buy
124572.14,139.46,13.02.2014 12:29:58,sl 139.460,0.0,-158.52999999996973,0.0,0.0,139.23,13.02.2014 03:30:00,10195,-0.07382736709198018,-38.33,IS,0.17,0.0,Phase3-EA-T1v2-EURJPY-M15-322,EURJPYMT4,1814,8h 59m,Sell
124544.74,0.89341,14.02.2014 02:30:00,,-0.78,-185.9299999999639,0.0,0.0,0.89382,13.02.2014 22:15:00,10196,-0.08658753777462834,-27.4,IS,0.58,0.0,Phase3-EA-SA2v2-USDCHF-M15-107,USDCHFMT4,1954,4h 15m,Buy
124587.48,102.35,14.02.2014 03:15:00,,0.0,-143.18999999997322,0.0,0.0,102188,14.02.2014 00:45:00,10197,-0.06668353430833712,42.74,IS,0.27,0.0,Phase3-EA-S1v2-USDJPY-M15-0,USDJPYMT4,2940,2h 30m,Buy
124571.55,170415,14.02.2014 04:25:00,,-1.31,-159.11999999996624,0.0,0.0,170.35,13.02.2014 23:00:00,10198,-0.0741021298913495,-15.93,IS,0.23,0.0,Phase3-EA-S4v1-GBPJPY-M5-194,GBPJPYMT4,2384,5h 25m,Sell
124553.92,1.22157,14.02.2014 06:15:00,,-1.1,-176.7499999999709,0.0,0.0,1.22193,13.02.2014 21:55:00,10199,-0.0823124148962836,-17.63,IS,0.41,0.0,Phase3-EA-SA2v2-EURCHF-M5-43,EURCHFMT4,5204,8h 20m,Buy
124555.44,1.22195,14.02.2014 10:15:00,,0.0,-175.22999999998137,0.0,0.0,1.22191,14.02.2014 01:30:00,10200,-0.08160455141316332,1.52,IS,0.34,0.0,Phase3-EA-S4v1-EURCHF-M15-221,EURCHFMT4,2666,8h 45m,Buy
124818.98,1.68201,17.02.2014 04:59:58,tp 1.68201,-1.06,-0.0,0.0,0.0,1.66311,13.02.2014 11:30:00,10201,-0.0,263.54,IS,0.14,0.0,Phase3-EA-B1v1-GBPUSD-M30-14,GBPUSDMT4,668,3d 17h 29m,Buy
124808.22,1.22146,17.02.2014 06:25:00,,-1.1,-10.760000000009313,0.0,0.0,1.22167,14.02.2014 22:05:00,10202,-0.005008868397014655,-10.76,IS,0.41,0.0,Phase3-EA-SA2v2-EURCHF-M5-43,EURCHFMT4,5206,2d 8h 20m,Buy
124814.31,101902,17.02.2014 18:00:00,,0.0,-4.670000000012806,0.0,0.0,101879,17.02.2014 17:00:00,10203,-0.002173923365622894,6.09,IS,0.27,0.0,Phase3-EA-S1v2-USDJPY-M15-0,USDJPYMT4,2942,1h 0m,Buy
124879.31,0.89232,18.02.2014 03:29:57,tp 0.89232,0.0,-0.0,0.0,0.0,0.89132,18.02.2014 01:15:00,10204,-0.0,65.0,IS,0.58,0.0,Phase3-EA-SA2v2-USDCHF-M15-107,USDCHFMT4,1956,2h 14m,Buy
124911.76,1.22247,18.02.2014 05:25:00,,-1.1,-0.0,0.0,0.0,1.22174,17.02.2014 21:05:00,10205,-0.0,32.45,IS,0.41,0.0,Phase3-EA-SA2v2-EURCHF-M5-43,EURCHFMT4,5208,8h 20m,Buy
124999.71,170247,18.02.2014 06:29:58,tp 170.247,0.0,-0.0,0.0,0.0,170637,18.02.2014 02:30:00,10206,-0.0,87.95,IS,0.23,0.0,Phase3-EA-S4v1-GBPJPY-M5-194,GBPJPYMT4,2386,3h 59m,Sell
125110.51,140704,18.02.2014 07:29:58,tp 140.704,-2.58,-0.0,0.0,0.0,139414,12.02.2014 19:30:00,10207,-0.0,110.8,IS,0.09,0.0,Phase3-EA-TR1v1-EURJPY-M30-91,EURJPYMT4,1798,5d 11h 59m,Buy
125149.41,1.22275,18.02.2014 10:45:00,,0.0,-0.0,0.0,0.0,1.22173,18.02.2014 02:00:00,10208,-0.0,38.9,IS,0.34,0.0,Phase3-EA-S4v1-EURCHF-M15-221,EURCHFMT4,2668,8h 45m,Buy
125107.41,1.67235,18.02.2014 18:29:57,sl 1.67235,0.0,-42.0,0.0,0.0,1.66935,18.02.2014 11:30:00,10209,-0.019521317767034398,-42.0,IS,0.14,0.0,Phase3-EA-B1v1-GBPUSD-M30-14,GBPUSDMT4,670,6h 59m,Sell
125097.25,102354,19.02.2014 02:45:00,,-1.19,-52.16000000000349,0.0,0.0,102.32,18.02.2014 23:00:00,10210,-0.024243617493537675,-10.16,IS,0.27,0.0,Phase3-EA-S1v2-USDJPY-M15-0,USDJPYMT4,2944,3h 45m,Sell
125145.42,0.8874,19.02.2014 03:30:00,,-3.46,-3.9899999999906868,0.0,0.0,0.88819,18.02.2014 23:15:00,10211,-0.0018545251878639391,48.17,IS,0.58,0.0,Phase3-EA-SA2v2-USDCHF-M15-107,USDCHFMT4,1958,4h 15m,Sell
125168.98,1.22148,19.02.2014 07:25:00,,-2.31,-0.0,0.0,0.0,1.22204,18.02.2014 23:05:00,10212,-0.0,23.56,IS,0.41,0.0,Phase3-EA-SA2v2-EURCHF-M5-43,EURCHFMT4,5210,8h 20m,Sell
125105.64,140858,19.02.2014 19:59:57,sl 140.858,0.0,-63.33999999999651,0.0,0.0,140.52,18.02.2014 12:30:00,10213,-0.029437328745061688,-63.34,IS,0.09,0.0,Phase3-EA-TR1v1-EURJPY-M30-91,EURJPYMT4,1800,1d 7h 29m,Sell
125156.36,1.22089,19.02.2014 22:29:58,tp 1.22089,0.0,-12.619999999995343,0.0,0.0,1.21979,19.02.2014 20:05:00,10214,-0.005865157700703535,50.72,IS,0.41,0.0,Phase3-EA-SA2v2-EURCHF-M5-43,EURCHFMT4,5212,2h 24m,Buy
125170.16,102324,20.02.2014 03:15:00,,-2.3,-0.0,0.0,0.0,102263,19.02.2014 23:30:00,10215,-0.0,13.8,IS,0.27,0.0,Phase3-EA-S1v2-USDJPY-M15-0,USDJPYMT4,2946,3h 45m,Buy
125282.98,139.23,20.02.2014 11:29:57,tp 139.230,-1.23,-0.0,0.0,0.0,140138,19.02.2014 15:30:00,10216,-0.0,112.82,IS,0.09,0.0,Phase3-EA-TR1v1-EURJPY-M30-91,EURJPYMT4,1801,19h 59m,Sell
125303.58,1.2201,20.02.2014 14:15:00,,0.0,-0.0,0.0,0.0,1.21956,20.02.2014 05:30:00,10217,-0.0,20.6,IS,0.34,0.0,Phase3-EA-S4v1-EURCHF-M15-221,EURCHFMT4,2670,8h 45m,Buy
125335.49,102433,21.02.2014 03:15:00,,-0.77,-0.0,0.0,0.0,102309,20.02.2014 23:00:00,10218,-0.0,31.91,IS,0.27,0.0,Phase3-EA-S1v2-USDJPY-M15-0,USDJPYMT4,2948,4h 15m,Buy
125318.24,1.21968,21.02.2014 06:45:00,,-1.11,-17.25,0.0,0.0,1.22003,20.02.2014 22:25:00,10219,-0.00801075568175031,-17.25,IS,0.41,0.0,Phase3-EA-SA2v2-EURCHF-M5-43,EURCHFMT4,5214,8h 20m,Buy
125326.76,170594,21.02.2014 08:45:00,,0.0,-8.730000000010477,0.0,0.0,170632,21.02.2014 03:20:00,10220,-0.0040541389624211095,8.52,IS,0.23,0.0,Phase3-EA-S4v1-GBPJPY-M5-194,GBPJPYMT4,2388,5h 25m,Sell
125439.31,141.1,21.02.2014 17:59:58,tp 141.100,-0.43,-0.0,0.0,0.0,139.81,20.02.2014 16:00:00,10221,-0.0,112.55,IS,0.09,0.0,Phase3-EA-TR1v1-EURJPY-M30-91,EURJPYMT4,1804,1d 1h 59m,Buy
125482.1,140861,24.02.2014 03:00:00,,-0.81,-0.0,0.0,0.0,140598,21.02.2014 16:45:00,10222,-0.0,42.79,IS,0.17,0.0,Phase3-EA-T1v2-EURJPY-M15-322,EURJPYMT4,1816,2d 10h 15m,Buy
125477.66,102622,24.02.2014 04:00:00,,-0.76,-4.440000000002328,0.0,0.0,102636,21.02.2014 21:30:00,10223,-0.0020604959762329654,-4.44,IS,0.27,0.0,Phase3-EA-S1v2-USDJPY-M15-0,USDJPYMT4,2950,2d 6h 30m,Buy
125470.09,1.21908,24.02.2014 04:55:00,,-1.11,-12.010000000009313,0.0,0.0,1.21922,21.02.2014 20:35:00,10224,-0.005573548800577506,-7.57,IS,0.41,0.0,Phase3-EA-SA2v2-EURCHF-M5-43,EURCHFMT4,5216,2d 8h 20m,Buy
125455.06,0.88727,24.02.2014 06:30:00,,0.0,-27.04000000000815,0.0,0.0,0.88704,24.02.2014 02:15:00,10225,-0.01254860612552409,-15.03,IS,0.58,0.0,Phase3-EA-SA2v2-USDCHF-M15-107,USDCHFMT4,1960,4h 15m,Sell
125518.54,1.22052,24.02.2014 15:15:00,,0.0,-0.0,0.0,0.0,1.21886,24.02.2014 06:30:00,10226,-0.0,63.48,IS,0.34,0.0,Phase3-EA-S4v1-EURCHF-M15-221,EURCHFMT4,2672,8h 45m,Buy
125480.38,140.78,24.02.2014 19:29:58,sl 140.780,0.0,-38.16000000000349,0.0,0.0,140.55,24.02.2014 17:15:00,10227,-0.017706133309924616,-38.16,IS,0.17,0.0,Phase3-EA-T1v2-EURJPY-M15-322,EURJPYMT4,1818,2h 14m,Sell
125462.2,1.22058,25.02.2014 05:05:00,,-1.11,-56.33999999999651,0.0,0.0,1.22095,24.02.2014 20:45:00,10228,-0.026141602481158273,-18.18,IS,0.41,0.0,Phase3-EA-SA2v2-EURCHF-M5-43,EURCHFMT4,5218,8h 20m,Buy
125435.37,1.21989,25.02.2014 12:30:00,,0.0,-83.1699999999837,0.0,0.0,1.22059,25.02.2014 03:45:00,10229,-0.038590647468186766,-26.83,IS,0.34,0.0,Phase3-EA-S4v1-EURCHF-M15-221,EURCHFMT4,2674,8h 45m,Buy
125522.28,170618,26.02.2014 04:39:57,tp 170.618,-0.81,-0.0,0.0,0.0,170228,25.02.2014 23:35:00,10230,-0.0,86.91,IS,0.23,0.0,Phase3-EA-S4v1-GBPJPY-M5-194,GBPJPYMT4,2390,5h 4m,Buy
125527.64,1.21914,26.02.2014 07:15:00,,-1.11,-0.0,0.0,0.0,1219,25.02.2014 22:55:00,10231,-0.0,5.36,IS,0.41,0.0,Phase3-EA-SA2v2-EURCHF-M5-43,EURCHFMT4,5220,8h 20m,Buy
125541.82,1.21932,26.02.2014 10:00:00,,0.0,-0.0,0.0,0.0,1.21895,26.02.2014 01:15:00,10232,-0.0,14.18,IS,0.34,0.0,Phase3-EA-S4v1-EURCHF-M15-221,EURCHFMT4,2676,8h 45m,Buy
125499.29,1.6639,26.02.2014 18:29:58,sl 1.66390,-0.53,-42.529999999998836,0.0,0.0,1.6669,25.02.2014 06:00:00,10233,-0.019731669705674065,-42.53,IS,0.14,0.0,Phase3-EA-B1v1-GBPUSD-M30-14,GBPUSDMT4,672,1d 12h 29m,Buy
125488.49,0.8908,27.02.2014 03:30:00,,-2.34,-53.329999999987194,0.0,0.0,0.89093,26.02.2014 23:15:00,10234,-0.024742298269536184,-10.8,IS,0.58,0.0,Phase3-EA-SA2v2-USDCHF-M15-107,USDCHFMT4,1962,4h 15m,Buy
125501.94,102411,27.02.2014 06:30:00,,0.0,-39.87999999997555,0.0,0.0,102.36,27.02.2014 00:15:00,10235,-0.01850220991915873,13.45,IS,0.27,0.0,Phase3-EA-S1v2-USDJPY-M15-0,USDJPYMT4,2952,6h 15m,Buy
125464.54,1.21839,27.02.2014 07:00:00,,-3.31,-77.27999999996973,0.0,0.0,1.21913,26.02.2014 22:40:00,10236,-0.03585383105699356,-37.4,IS,0.41,0.0,Phase3-EA-SA2v2-EURCHF-M5-43,EURCHFMT4,5222,8h 20m,Buy
125456.52,1.2186,27.02.2014 09:45:00,,0.0,-85.29999999995925,0.0,0.0,1.21881,27.02.2014 01:00:00,10237,-0.03957468671274958,-8.02,IS,0.34,0.0,Phase3-EA-S4v1-EURCHF-M15-221,EURCHFMT4,2678,8h 45m,Buy
125414.52,1.6642,27.02.2014 10:59:57,sl 1.66420,0.0,-127.29999999995925,0.0,0.0,1.6672,27.02.2014 09:30:00,10238,-0.05906046446112328,-42.0,IS,0.14,0.0,Phase3-EA-B1v1-GBPUSD-M30-14,GBPUSDMT4,674,1h 29m,Buy
125351.04,139.85,27.02.2014 19:29:58,sl 139.850,0.0,-190.77999999996973,0.0,0.0,139.13,27.02.2014 13:30:00,10239,-0.08851182568652724,-63.48,IS,0.09,0.0,Phase3-EA-TR1v1-EURJPY-M30-91,EURJPYMT4,1806,5h 59m,Sell
125362.82,102041,28.02.2014 03:15:00,,-1.19,-178.9999999999709,0.0,0.0,102.09,27.02.2014 17:00:00,10240,-0.08304652897519821,11.78,IS,0.27,0.0,Phase3-EA-S1v2-USDJPY-M15-0,USDJPYMT4,2954,10h 15m,Sell
125381.75,1.21741,28.02.2014 05:35:00,,-2.31,-160.06999999997788,0.0,0.0,1.21787,27.02.2014 21:15:00,10241,-0.07426401057575588,18.93,IS,0.41,0.0,Phase3-EA-SA2v2-EURCHF-M5-43,EURCHFMT4,5224,8h 20m,Sell
125318.05,139994,28.02.2014 13:29:57,sl 139.994,0.0,-223.76999999998952,0.0,0.0,139274,28.02.2014 08:30:00,10242,-0.10381744016079472,-63.7,IS,0.09,0.0,Phase3-EA-TR1v1-EURJPY-M30-91,EURJPYMT4,1808,4h 59m,Sell
125265.95,1.21603,28.02.2014 14:15:00,,0.0,-275.86999999999534,0.0,0.0,1.21738,28.02.2014 05:30:00,10243,-0.12798908351056573,-52.1,IS,0.34,0.0,Phase3-EA-S4v1-EURCHF-M15-221,EURCHFMT4,2680,8h 45m,Buy
125331.94,0.87894,28.02.2014 23:14:58,tp 0.87894,0.0,-209.88000000000466,0.0,0.0,0.87794,28.02.2014 23:00:00,10244,-0.09737321509116101,65.99,IS,0.58,0.0,Phase3-EA-SA2v2-USDCHF-M15-107,USDCHFMT4,1964,14m 58s,Buy
125102.06,1.21057,03.03.2014 02:04:58,sl 1.21057,-1.12,-439.7600000000093,0.0,0.0,1.21547,28.02.2014 21:00:00,10245,-0.20402537196726186,-229.88,IS,0.41,0.0,Phase3-EA-SA2v2-EURCHF-M5-43,EURCHFMT4,5226,2d 5h 4m,Buy
124919.82,169622,03.03.2014 02:19:57,sl 169.622,-0.81,-622.0,0.0,0.0,170422,28.02.2014 23:15:00,10246,-0.2885750895116295,-182.24,IS,0.23,0.0,Phase3-EA-S4v1-GBPJPY-M5-194,GBPJPYMT4,2392,2d 3h 4m,Buy
124971.1,1.21192,03.03.2014 03:04:58,tp 1.21192,0.0,-570.7200000000012,0.0,0.0,1.21082,03.03.2014 02:10:00,10247,-0.2647838827750443,51.28,IS,0.41,0.0,Phase3-EA-SA2v2-EURCHF-M5-43,EURCHFMT4,5228,54m 58s,Buy
124982.67,169826,03.03.2014 07:55:00,,0.0,-559.1499999999942,0.0,0.0,169775,03.03.2014 02:30:00,10248,-0.2594160149524533,11.57,IS,0.23,0.0,Phase3-EA-S4v1-GBPJPY-M5-194,GBPJPYMT4,2394,5h 25m,Buy
124828.35,101458,03.03.2014 08:15:00,,-0.77,-713.4700000000012,0.0,0.0,102035,28.02.2014 22:30:00,10249,-0.3310123297650525,-154.32,IS,0.27,0.0,Phase3-EA-S1v2-USDJPY-M15-0,USDJPYMT4,2956,2d 9h 45m,Buy
124874.28,1.21308,03.03.2014 11:45:00,,0.0,-667.5400000000081,0.0,0.0,1.21189,03.03.2014 03:00:00,10250,-0.30970323995594135,45.93,IS,0.34,0.0,Phase3-EA-S4v1-EURCHF-M15-221,EURCHFMT4,2682,8h 45m,Buy
124925.35,1.21349,03.03.2014 22:29:58,tp 1.21349,0.0,-616.4700000000012,0.0,0.0,1.21239,03.03.2014 20:10:00,10251,-0.2860094621080942,51.07,IS,0.41,0.0,Phase3-EA-SA2v2-EURCHF-M5-43,EURCHFMT4,5230,2h 19m,Buy
124937.09,101444,04.03.2014 01:00:00,,-0.77,-604.7300000000105,0.0,0.0,101397,03.03.2014 21:45:00,10252,-0.2805627232803388,11.74,IS,0.27,0.0,Phase3-EA-S1v2-USDJPY-M15-0,USDJPYMT4,2958,3h 15m,Buy
124893.5,1.6642,04.03.2014 04:59:58,sl 1.66420,-1.59,-648.320000000007,0.0,0.0,1.6672,27.02.2014 17:30:00,10253,-0.3007861769006136,-43.59,IS,0.14,0.0,Phase3-EA-B1v1-GBPUSD-M30-14,GBPUSDMT4,676,4d 11h 29m,Buy
124884.69,1.21357,04.03.2014 06:55:00,,-2.32,-657.1300000000047,0.0,0.0,1.21343,03.03.2014 22:35:00,10254,-0.30487355075687855,-8.81,IS,0.41,0.0,Phase3-EA-SA2v2-EURCHF-M5-43,EURCHFMT4,5232,8h 20m,Sell
124881.92,1.21885,05.03.2014 07:45:00,,-2.31,-659.8999999999942,0.0,0.0,1.21884,04.03.2014 23:25:00,10255,-0.30615868419408787,-2.77,IS,0.41,0.0,Phase3-EA-SA2v2-EURCHF-M5-43,EURCHFMT4,5234,8h 20m,Sell
124901.07,1.21883,05.03.2014 10:15:00,,0.0,-640.75,0.0,0.0,1.21933,05.03.2014 01:30:00,10256,-0.29727409743501065,19.15,IS,0.34,0.0,Phase3-EA-S4v1-EURCHF-M15-221,EURCHFMT4,2684,8h 45m,Sell
124831.76,140666,05.03.2014 11:29:58,sl 140.666,-0.62,-710.0599999999977,0.0,0.0,139886,03.03.2014 02:00:00,10257,-0.32943027019071863,-69.31,IS,0.09,0.0,Phase3-EA-TR1v1-EURJPY-M30-91,EURJPYMT4,1810,2d 9h 29m,Sell
124827.77,140552,05.03.2014 22:00:00,,0.0,-714.0499999999884,0.0,0.0,140576,05.03.2014 11:15:00,10258,-0.3312814190768098,-3.99,IS,0.17,0.0,Phase3-EA-T1v2-EURJPY-M15-322,EURJPYMT4,1820,10h 45m,Buy
124840.44,102297,06.03.2014 01:00:00,,0.0,-701.3799999999756,0.0,0.0,102345,06.03.2014 00:15:00,10259,-0.32540320945604445,12.67,IS,0.27,0.0,Phase3-EA-S1v2-USDJPY-M15-0,USDJPYMT4,2960,45m 0s,Sell
124831.36,0.88745,06.03.2014 03:30:00,,-10.39,-710.4599999999627,0.0,0.0,0.88747,05.03.2014 23:15:00,10260,-0.32961584902640123,-9.08,IS,0.58,0.0,Phase3-EA-SA2v2-USDCHF-M15-107,USDCHFMT4,1966,4h 15m,Sell
124793.05,1.21943,06.03.2014 06:10:00,,-6.93,-748.7699999999604,0.0,0.0,1.21875,05.03.2014 21:50:00,10261,-0.34738966201545246,-38.31,IS,0.41,0.0,Phase3-EA-SA2v2-EURCHF-M5-43,EURCHFMT4,5236,8h 20m,Sell
124784.62,1.21919,06.03.2014 13:45:00,,0.0,-757.1999999999534,0.0,0.0,1.21897,06.03.2014 05:00:00,10262,-0.35130073597780137,-8.43,IS,0.34,0.0,Phase3-EA-S4v1-EURCHF-M15-221,EURCHFMT4,2686,8h 45m,Sell
125065.59,142.26,06.03.2014 16:44:57,tp 142.260,0.0,-476.22999999995227,0.0,0.0,140.56,06.03.2014 03:00:00,10263,-0.22094552231207323,280.97,IS,0.17,0.0,Phase3-EA-T1v2-EURJPY-M15-322,EURJPYMT4,1822,13h 44m,Buy
125174.12,141461,06.03.2014 16:59:57,tp 141.461,-1.72,-367.69999999995343,0.0,0.0,140201,04.03.2014 10:30:00,10264,-0.17059334471609766,108.53,IS,0.09,0.0,Phase3-EA-TR1v1-EURJPY-M30-91,EURJPYMT4,1811,2d 6h 29m,Buy
125334.72,172348,06.03.2014 16:59:58,tp 172.348,-1.27,-207.0999999999476,0.0,0.0,170498,04.03.2014 23:00:00,10265,-0.0960834421830279,160.6,IS,0.09,0.0,Phase3-EA-B1v1-GBPJPY-M30-1,GBPJPYMT4,978,1d 17h 59m,Buy
125356.49,103057,07.03.2014 00:30:00,,-0.76,-185.3299999999581,0.0,0.0,102971,06.03.2014 21:00:00,10266,-0.08598331405012573,21.77,IS,0.27,0.0,Phase3-EA-S1v2-USDJPY-M15-0,USDJPYMT4,2962,3h 30m,Buy
125312.02,1.21916,07.03.2014 04:30:00,,-1.12,-229.79999999995925,0.0,0.0,1.22009,06.03.2014 20:10:00,10267,-0.10661504110894005,-44.47,IS,0.41,0.0,Phase3-EA-SA2v2-EURCHF-M5-43,EURCHFMT4,5238,8h 20m,Buy
125305.05,1.21905,07.03.2014 14:15:00,,0.0,-236.76999999996042,0.0,0.0,1.21923,07.03.2014 05:30:00,10268,-0.10984875232099212,-6.97,IS,0.34,0.0,Phase3-EA-S4v1-EURCHF-M15-221,EURCHFMT4,2688,8h 45m,Buy
125298.97,0.87759,10.03.2014 02:15:00,,-0.79,-242.8499999999476,0.0,0.0,0.87767,07.03.2014 22:00:00,10269,-0.1126695506236079,-6.08,IS,0.58,0.0,Phase3-EA-SA2v2-USDCHF-M15-107,USDCHFMT4,1968,2d 4h 15m,Buy
125303.92,1.21817,10.03.2014 05:05:00,,-1.12,-237.89999999993597,0.0,0.0,1.21804,07.03.2014 20:45:00,10270,-0.11037301253182988,4.95,IS,0.41,0.0,Phase3-EA-SA2v2-EURCHF-M5-43,EURCHFMT4,5240,2d 8h 20m,Buy
125247.12,103098,10.03.2014 11:00:00,,-0.76,-294.69999999992433,0.0,0.0,103312,07.03.2014 21:15:00,10271,-0.13672520720105366,-56.8,IS,0.27,0.0,Phase3-EA-S1v2-USDJPY-M15-0,USDJPYMT4,2964,2d 13h 45m,Buy
125240.15,1.21844,10.03.2014 12:45:00,,0.0,-301.6699999999255,0.0,0.0,1.21826,10.03.2014 04:00:00,10272,-0.13995891841310576,-6.97,IS,0.34,0.0,Phase3-EA-S4v1-EURCHF-M15-221,EURCHFMT4,2690,8h 45m,Sell
125181.17,171642,10.03.2014 17:29:58,sl 171.642,-0.62,-360.64999999993597,0.0,0.0,172312,06.03.2014 17:00:00,10273,-0.16732251773689824,-58.98,IS,0.09,0.0,Phase3-EA-B1v1-GBPJPY-M30-1,GBPJPYMT4,980,4d 0h 29m,Buy
125245.09,143.23,10.03.2014 19:45:00,,-0.81,-296.72999999992317,0.0,0.0,142837,07.03.2014 12:15:00,10274,-0.13766701979222454,63.92,IS,0.17,0.0,Phase3-EA-T1v2-EURJPY-M15-322,EURJPYMT4,1824,3d 7h 30m,Buy
125254.0,103291,11.03.2014 00:15:00,,-0.76,-287.8199999999197,0.0,0.0,103254,10.03.2014 17:15:00,10275,-0.1335332512270322,8.91,IS,0.27,0.0,Phase3-EA-S1v2-USDJPY-M15-0,USDJPYMT4,2966,7h 0m,Buy
125222.38,143.15,11.03.2014 08:00:00,,0.0,-319.439999999915,0.0,0.0,143342,11.03.2014 00:30:00,10276,-0.14820325818901994,-31.62,IS,0.17,0.0,Phase3-EA-T1v2-EURJPY-M15-322,EURJPYMT4,1826,7h 30m,Buy
125240.53,1.21813,11.03.2014 14:15:00,,0.0,-301.28999999992084,0.0,0.0,1.2186,11.03.2014 05:30:00,10277,-0.13978261851918974,18.15,IS,0.34,0.0,Phase3-EA-S4v1-EURCHF-M15-221,EURCHFMT4,2692,8h 45m,Sell
125268.09,102859,12.03.2014 02:45:00,,0.0,-273.72999999992317,0.0,0.0,102964,12.03.2014 00:15:00,10278,-0.1269962367395437,27.56,IS,0.27,0.0,Phase3-EA-S1v2-USDJPY-M15-0,USDJPYMT4,2968,2h 30m,Sell
125355.2,171302,12.03.2014 05:19:57,tp 171.302,0.0,-186.61999999993714,0.0,0.0,170912,12.03.2014 02:55:00,10279,-0.08658180579524463,87.11,IS,0.23,0.0,Phase3-EA-S4v1-GBPJPY-M5-194,GBPJPYMT4,2396,2h 24m,Buy
125380.86,1.21661,12.03.2014 10:50:00,,0.0,-160.95999999993364,0.0,0.0,1.21606,12.03.2014 02:30:00,10280,-0.07467692348516518,25.66,IS,0.41,0.0,Phase3-EA-SA2v2-EURCHF-M5-43,EURCHFMT4,5242,8h 20m,Buy
125363.82,1.21574,12.03.2014 12:15:00,,0.0,-177.9999999999418,0.0,0.0,1.21618,12.03.2014 03:30:00,10281,-0.08258258188593771,-17.04,IS,0.34,0.0,Phase3-EA-S4v1-EURCHF-M15-221,EURCHFMT4,2694,8h 45m,Buy
125395.39,102641,12.03.2014 20:15:00,,0.0,-146.4299999999348,0.0,0.0,102761,12.03.2014 18:00:00,10282,-0.06793577227840691,31.57,IS,0.27,0.0,Phase3-EA-S1v2-USDJPY-M15-0,USDJPYMT4,2970,2h 15m,Sell
125417.33,1.21576,13.03.2014 07:10:00,,-3.38,-124.48999999993248,0.0,0.0,1.21522,12.03.2014 22:50:00,10283,-0.05775677314032681,21.94,IS,0.41,0.0,Phase3-EA-SA2v2-EURCHF-M5-43,EURCHFMT4,5244,8h 20m,Buy
125376.95,143112,13.03.2014 07:44:58,sl 143.112,-2.32,-164.86999999993714,0.0,0.0,142882,11.03.2014 19:30:00,10284,-0.07649095660412254,-40.38,IS,0.17,0.0,Phase3-EA-T1v2-EURJPY-M15-322,EURJPYMT4,1828,1d 12h 14m,Sell
125394.92,1.21528,13.03.2014 13:00:00,,0.0,-146.89999999993597,0.0,0.0,1.21574,13.03.2014 04:15:00,10285,-0.06815382741035354,17.97,IS,0.34,0.0,Phase3-EA-S4v1-EURCHF-M15-221,EURCHFMT4,2696,8h 45m,Sell
125555.39,169784,13.03.2014 19:29:58,tp 169.784,-2.54,-0.0,0.0,0.0,171634,10.03.2014 17:30:00,10286,-0.0,160.47,IS,0.09,0.0,Phase3-EA-B1v1-GBPJPY-M30-1,GBPJPYMT4,982,3d 1h 59m,Sell
125488.94,141955,13.03.2014 19:29:58,sl 141.955,-3.01,-66.45000000001164,0.0,0.0,142675,06.03.2014 19:30:00,10287,-0.030827343264304884,-66.45,IS,0.09,0.0,Phase3-EA-TR1v1-EURJPY-M30-91,EURJPYMT4,1814,6d 23h 59m,Buy
125500.62,101743,14.03.2014 06:00:00,,0.0,-54.77000000001863,0.0,0.0,101787,14.03.2014 00:15:00,10288,-0.02540878240159905,11.68,IS,0.27,0.0,Phase3-EA-S1v2-USDJPY-M15-0,USDJPYMT4,2972,5h 45m,Sell
125514.01,1.21324,14.03.2014 06:40:00,,-1.13,-41.38000000000466,0.0,0.0,1.21293,13.03.2014 22:20:00,10289,-0.019196921960524548,13.39,IS,0.41,0.0,Phase3-EA-SA2v2-EURCHF-M5-43,EURCHFMT4,5246,8h 20m,Buy
125486.02,1.21435,14.03.2014 13:45:00,,0.0,-69.36999999999534,0.0,0.0,1.21363,14.03.2014 05:00:00,10290,-0.03218198347997459,-27.99,IS,0.34,0.0,Phase3-EA-S4v1-EURCHF-M15-221,EURCHFMT4,2698,8h 45m,Sell
125544.96,101244,14.03.2014 18:15:00,,0.0,-10.429999999993015,0.0,0.0,101465,14.03.2014 17:30:00,10291,-0.0048386635101042635,58.94,IS,0.27,0.0,Phase3-EA-S1v2-USDJPY-M15-0,USDJPYMT4,2974,45m 0s,Sell
125579.88,101278,14.03.2014 22:00:00,,0.0,-0.0,0.0,0.0,101409,14.03.2014 18:45:00,10292,-0.0,34.92,IS,0.27,0.0,Phase3-EA-S1v2-USDJPY-M15-0,USDJPYMT4,2976,3h 15m,Sell
125540.72,141074,17.03.2014 03:44:58,sl 141.074,-0.59,-39.16000000000349,0.0,0.0,140844,14.03.2014 21:45:00,10293,-0.01816496047776035,-39.16,IS,0.17,0.0,Phase3-EA-T1v2-EURJPY-M15-322,EURJPYMT4,1830,2d 5h 59m,Sell
125579.92,0.87299,17.03.2014 06:30:00,,0.0,-0.0,0.0,0.0,0.8724,17.03.2014 02:15:00,10294,-0.0,39.2,IS,0.58,0.0,Phase3-EA-SA2v2-USDCHF-M15-107,USDCHFMT4,1970,4h 15m,Buy
125551.28,1.21416,17.03.2014 07:10:00,,-2.35,-28.64000000001397,0.0,0.0,1.2136,14.03.2014 22:50:00,10295,-0.01328509631138825,-28.64,IS,0.41,0.0,Phase3-EA-SA2v2-EURCHF-M5-43,EURCHFMT4,5248,2d 8h 20m,Sell
125491.36,169057,17.03.2014 09:29:58,sl 169.057,-0.52,-88.56000000002678,0.0,0.0,168387,14.03.2014 14:30:00,10296,-0.04107989278408957,-59.92,IS,0.09,0.0,Phase3-EA-B1v1-GBPJPY-M30-1,GBPJPYMT4,984,2d 18h 59m,Sell
125427.06,141591,17.03.2014 12:29:58,sl 141.591,-0.62,-152.86000000001513,0.0,0.0,140871,13.03.2014 22:00:00,10297,-0.0709064183714392,-64.3,IS,0.09,0.0,Phase3-EA-TR1v1-EURJPY-M30-91,EURJPYMT4,1816,3d 14h 29m,Sell
125360.99,1.2155,17.03.2014 13:45:00,,0.0,-218.93000000002212,0.0,0.0,1.2138,17.03.2014 05:00:00,10298,-0.1015539851763654,-66.07,IS,0.34,0.0,Phase3-EA-S4v1-EURCHF-M15-221,EURCHFMT4,2700,8h 45m,Sell
125366.83,101746,17.03.2014 23:00:00,,0.0,-213.0900000000256,0.0,0.0,101724,17.03.2014 17:30:00,10299,-0.09884501302348749,5.84,IS,0.27,0.0,Phase3-EA-S1v2-USDJPY-M15-0,USDJPYMT4,2978,5h 30m,Buy
125345.22,1.21599,18.03.2014 05:45:00,,-2.35,-234.70000000001164,0.0,0.0,1.21558,17.03.2014 21:25:00,10300,-0.10886913771932459,-21.61,IS,0.41,0.0,Phase3-EA-SA2v2-EURCHF-M5-43,EURCHFMT4,5250,8h 20m,Sell
125302.16,1.66028,18.03.2014 10:59:58,sl 1.66028,-1.06,-277.7600000000093,0.0,0.0,1.66328,14.03.2014 21:30:00,10301,-0.12884316869586326,-43.06,IS,0.14,0.0,Phase3-EA-B1v1-GBPUSD-M30-14,GBPUSDMT4,678,3d 13h 29m,Buy
125333.68,1.21544,18.03.2014 12:15:00,,0.0,-246.2400000000198,0.0,0.0,1.21625,18.03.2014 03:30:00,10302,-0.11422214091183346,31.52,IS,0.34,0.0,Phase3-EA-S4v1-EURCHF-M15-221,EURCHFMT4,2702,8h 45m,Sell
125269.82,141833,18.03.2014 14:59:58,sl 141.833,0.0,-310.1000000000058,0.0,0.0,141486,17.03.2014 19:30:00,10303,-0.1438445658575267,-63.86,IS,0.09,0.0,Phase3-EA-TR1v1-EURJPY-M30-91,EURJPYMT4,1818,19h 29m,Sell
125313.64,101353,19.03.2014 04:15:00,,-1.2,-266.27999999999884,0.0,0.0,101522,18.03.2014 22:00:00,10304,-0.1235179974090336,43.82,IS,0.27,0.0,Phase3-EA-S1v2-USDJPY-M15-0,USDJPYMT4,2980,6h 15m,Sell
125335.22,1.21643,19.03.2014 06:50:00,,-2.35,-244.70000000001164,0.0,0.0,1.21694,18.03.2014 22:30:00,10305,-0.1135077886660361,21.58,IS,0.41,0.0,Phase3-EA-SA2v2-EURCHF-M5-43,EURCHFMT4,5252,8h 20m,Sell
125296.69,141366,19.03.2014 07:59:57,sl 141.366,0.0,-283.2300000000105,0.0,0.0,141136,19.03.2014 05:00:00,10306,-0.131380510763715,-38.53,IS,0.17,0.0,Phase3-EA-T1v2-EURJPY-M15-322,EURJPYMT4,1832,2h 59m,Sell
125276.94,141232,19.03.2014 17:30:00,,0.0,-302.9800000000105,0.0,0.0,141.35,19.03.2014 08:30:00,10307,-0.14054184638347025,-19.75,IS,0.17,0.0,Phase3-EA-T1v2-EURJPY-M15-322,EURJPYMT4,1834,9h 0m,Buy
125234.94,1.65673,19.03.2014 21:29:58,sl 1.65673,0.0,-344.9800000000105,0.0,0.0,1.65973,19.03.2014 09:30:00,10308,-0.1600241803596586,-42.0,IS,0.14,0.0,Phase3-EA-B1v1-GBPUSD-M30-14,GBPUSDMT4,680,11h 59m,Buy
125243.96,141554,20.03.2014 04:45:00,,-2.44,-335.96000000002095,0.0,0.0,141485,19.03.2014 20:45:00,10309,-0.15584011720572968,9.02,IS,0.17,0.0,Phase3-EA-T1v2-EURJPY-M15-322,EURJPYMT4,1836,8h 0m,Buy
125171.86,1.21874,20.03.2014 05:10:00,,-6.98,-408.0600000000268,0.0,0.0,1.21734,19.03.2014 20:50:00,10310,-0.1892847905315224,-72.1,IS,0.41,0.0,Phase3-EA-SA2v2-EURCHF-M5-43,EURCHFMT4,5254,8h 20m,Sell
125133.62,141391,20.03.2014 07:44:57,sl 141.391,0.0,-446.30000000001746,0.0,0.0,141621,20.03.2014 05:30:00,10311,-0.20702299175174288,-38.24,IS,0.17,0.0,Phase3-EA-T1v2-EURJPY-M15-322,EURJPYMT4,1838,2h 14m,Buy
125107.53,1.21941,20.03.2014 14:00:00,,0.0,-472.39000000001397,0.0,0.0,1.21873,20.03.2014 05:15:00,10312,-0.21912523207171158,-26.09,IS,0.34,0.0,Phase3-EA-S4v1-EURCHF-M15-221,EURCHFMT4,2704,8h 45m,Sell
125125.64,1.21755,21.03.2014 05:40:00,,-2.32,-454.28000000002794,0.0,0.0,1.21799,20.03.2014 21:20:00,10313,-0.21072463520722354,18.11,IS,0.41,0.0,Phase3-EA-SA2v2-EURCHF-M5-43,EURCHFMT4,5256,8h 20m,Sell
125102.65,0.88307,21.03.2014 05:45:00,,0.0,-477.2700000000186,0.0,0.0,0.88342,21.03.2014 01:30:00,10314,-0.22138889373370899,-22.99,IS,0.58,0.0,Phase3-EA-SA2v2-USDCHF-M15-107,USDCHFMT4,1972,4h 15m,Buy
125135.38,1.2182,21.03.2014 15:30:00,,0.0,-444.54000000000815,0.0,0.0,1.21735,21.03.2014 06:45:00,10315,-0.20620658918511733,32.73,IS,0.34,0.0,Phase3-EA-S4v1-EURCHF-M15-221,EURCHFMT4,2706,8h 45m,Buy
125157.8,102373,21.03.2014 19:00:00,,0.0,-422.11999999999534,0.0,0.0,102288,21.03.2014 18:45:00,10316,-0.19580673376258417,22.42,IS,0.27,0.0,Phase3-EA-S1v2-USDJPY-M15-0,USDJPYMT4,2982,15m 0s,Buy
125149.89,102345,21.03.2014 19:15:00,,0.0,-430.02999999999884,0.0,0.0,102375,21.03.2014 19:00:00,10317,-0.1994759066614346,-7.91,IS,0.27,0.0,Phase3-EA-S1v2-USDJPY-M15-0,USDJPYMT4,2984,15m 0s,Buy
125164.88,0.88226,24.03.2014 02:45:00,,-0.79,-415.04000000000815,0.0,0.0,0.88202,21.03.2014 22:30:00,10318,-0.19252256889231836,14.99,IS,0.58,0.0,Phase3-EA-SA2v2-USDCHF-M15-107,USDCHFMT4,1974,2d 4h 15m,Buy
125178.16,1.21792,24.03.2014 05:00:00,,-1.11,-401.7600000000093,0.0,0.0,1.21761,21.03.2014 20:40:00,10319,-0.186362440435086,13.28,IS,0.41,0.0,Phase3-EA-SA2v2-EURCHF-M5-43,EURCHFMT4,5258,2d 8h 20m,Buy
125138.87,141569,24.03.2014 11:00:00,sl 141.569,-1.16,-441.05000000001746,0.0,0.0,141339,20.03.2014 12:15:00,10320,-0.20458770000471935,-39.29,IS,0.17,0.0,Phase3-EA-T1v2-EURJPY-M15-322,EURJPYMT4,1840,3d 22h 45m,Sell
125090.51,1.21977,24.03.2014 15:30:00,,0.0,-489.4100000000035,0.0,0.0,1.21851,24.03.2014 06:45:00,10321,-0.22702021598300973,-48.36,IS,0.34,0.0,Phase3-EA-S4v1-EURCHF-M15-221,EURCHFMT4,2708,8h 45m,Sell
125052.23,141506,24.03.2014 21:14:58,sl 141.506,0.0,-527.6900000000023,0.0,0.0,141736,24.03.2014 21:00:00,10322,-0.24477697180702085,-38.28,IS,0.17,0.0,Phase3-EA-T1v2-EURJPY-M15-322,EURJPYMT4,1842,14m 58s,Buy
125103.45,1.21825,24.03.2014 23:04:57,tp 1.21825,0.0,-476.47000000000116,0.0,0.0,1.21935,24.03.2014 20:10:00,10323,-0.22101780165796395,51.22,IS,0.41,0.0,Phase3-EA-SA2v2-EURCHF-M5-43,EURCHFMT4,5260,2h 54m,Sell
125116.92,102193,24.03.2014 23:15:00,,0.0,-463.0,0.0,0.0,102244,24.03.2014 22:00:00,10324,-0.214769538832743,13.47,IS,0.27,0.0,Phase3-EA-S1v2-USDJPY-M15-0,USDJPYMT4,2986,1h 15m,Sell
125111.61,1.21849,25.03.2014 07:25:00,,-1.12,-468.3099999999977,0.0,0.0,1.21858,24.03.2014 23:05:00,10325,-0.21723266248544573,-5.31,IS,0.41,0.0,Phase3-EA-SA2v2-EURCHF-M5-43,EURCHFMT4,5262,8h 20m,Buy
125171.65,168955,26.03.2014 08:50:00,,0.0,-408.2699999999895,0.0,0.0,169222,26.03.2014 03:25:00,10326,-0.18938220220138605,60.04,IS,0.23,0.0,Phase3-EA-S4v1-GBPJPY-M5-194,GBPJPYMT4,2398,5h 25m,Sell
125192.04,101.98,27.03.2014 02:30:00,,0.0,-387.87999999997555,0.0,0.0,102057,27.03.2014 01:30:00,10327,-0.17992399292103478,20.39,IS,0.27,0.0,Phase3-EA-S1v2-USDJPY-M15-0,USDJPYMT4,2988,1h 0m,Sell
125169.71,1.22005,27.03.2014 04:35:00,,-3.34,-410.20999999996275,0.0,0.0,1.22046,26.03.2014 20:15:00,10328,-0.19028210048503566,-22.33,IS,0.41,0.0,Phase3-EA-SA2v2-EURCHF-M5-43,EURCHFMT4,5264,8h 20m,Buy
125257.51,169426,27.03.2014 07:34:57,tp 169.426,0.0,-322.4099999999744,0.0,0.0,169036,27.03.2014 02:35:00,10329,-0.14955474517291398,87.8,IS,0.23,0.0,Phase3-EA-S4v1-GBPJPY-M5-194,GBPJPYMT4,2400,4h 59m,Buy
125219.2,140619,27.03.2014 12:14:58,sl 140.619,0.0,-360.71999999997206,0.0,0.0,140389,27.03.2014 11:30:00,10330,-0.1673254169497647,-38.31,IS,0.17,0.0,Phase3-EA-T1v2-EURJPY-M15-322,EURJPYMT4,1844,44m 58s,Sell
125329.24,140196,27.03.2014 19:29:58,tp 140.196,-3.71,-250.6799999999639,0.0,0.0,141113,18.03.2014 14:30:00,10331,-0.11628170193214744,110.04,IS,0.09,0.0,Phase3-EA-TR1v1-EURJPY-M30-91,EURJPYMT4,1819,9d 4h 59m,Sell
125343.39,102.11,28.03.2014 03:30:00,,-1.19,-236.52999999996973,0.0,0.0,102168,27.03.2014 22:45:00,10332,-0.10971801084255335,14.15,IS,0.27,0.0,Phase3-EA-S1v2-USDJPY-M15-0,USDJPYMT4,2990,4h 45m,Sell
125330.31,0.88676,28.03.2014 06:45:00,,0.0,-249.60999999995693,0.0,0.0,0.88656,28.03.2014 02:30:00,10333,-0.11578536628084607,-13.08,IS,0.58,0.0,Phase3-EA-SA2v2-USDCHF-M15-107,USDCHFMT4,1976,4h 15m,Sell
125281.33,1.2194,28.03.2014 10:05:00,,0.0,-298.5899999999674,0.0,0.0,1.21834,28.03.2014 01:45:00,10334,-0.1385054786178439,-48.98,IS,0.41,0.0,Phase3-EA-SA2v2-EURCHF-M5-43,EURCHFMT4,5266,8h 20m,Sell
125285.55,1.21862,28.03.2014 14:15:00,,0.0,-294.36999999996624,0.0,0.0,1.21873,28.03.2014 05:30:00,10335,-0.13654796791833113,4.22,IS,0.34,0.0,Phase3-EA-S4v1-EURCHF-M15-221,EURCHFMT4,2710,8h 45m,Sell
125311.82,102878,31.03.2014 01:15:00,,-0.76,-268.0999999999767,0.0,0.0,102775,28.03.2014 22:15:00,10336,-0.12436223188132484,26.27,IS,0.27,0.0,Phase3-EA-S1v2-USDJPY-M15-0,USDJPYMT4,2992,2d 3h 0m,Buy
125377.27,0.8862,31.03.2014 03:59:58,tp 0.88620,0.0,-202.64999999996508,0.0,0.0,0.8872,31.03.2014 01:30:00,10337,-0.09400226143509259,65.45,IS,0.58,0.0,Phase3-EA-SA2v2-USDCHF-M15-107,USDCHFMT4,1978,2h 29m,Sell
125383.1,1.21939,31.03.2014 05:40:00,,-1.11,-196.81999999997788,0.0,0.0,1.21924,28.03.2014 21:20:00,10338,-0.09129792793316571,5.83,IS,0.41,0.0,Phase3-EA-SA2v2-EURCHF-M5-43,EURCHFMT4,5268,2d 8h 20m,Buy
125378.5,1.2198,31.03.2014 10:15:00,,0.0,-201.4199999999837,0.0,0.0,1.21968,31.03.2014 01:30:00,10339,-0.09343170736865572,-4.6,IS,0.34,0.0,Phase3-EA-S4v1-EURCHF-M15-221,EURCHFMT4,2712,8h 45m,Sell
125490.82,141797,31.03.2014 11:59:57,tp 141.797,-0.43,-89.09999999997672,0.0,0.0,140507,28.03.2014 08:00:00,10340,-0.041330379935188774,112.32,IS,0.09,0.0,Phase3-EA-TR1v1-EURJPY-M30-91,EURJPYMT4,1822,3d 3h 59m,Buy
125600.14,142.57,31.03.2014 16:29:58,tp 142.570,-0.43,-0.0,0.0,0.0,141.31,28.03.2014 18:00:00,10341,-0.0,109.32,IS,0.09,0.0,Phase3-EA-TR1v1-EURJPY-M30-91,EURJPYMT4,1823,2d 22h 29m,Buy
125665.64,141903,31.03.2014 20:30:00,,0.0,-0.0,0.0,0.0,141506,31.03.2014 09:00:00,10342,-0.0,65.5,IS,0.17,0.0,Phase3-EA-T1v2-EURJPY-M15-322,EURJPYMT4,1846,11h 30m,Buy
125676.38,103309,01.04.2014 04:15:00,,-0.76,-0.0,0.0,0.0,103265,31.03.2014 17:00:00,10343,-0.0,10.74,IS,0.27,0.0,Phase3-EA-S1v2-USDJPY-M15-0,USDJPYMT4,2994,11h 15m,Buy
125656.71,0.88456,01.04.2014 04:30:00,,0.0,-19.670000000012806,0.0,0.0,0.88426,01.04.2014 00:15:00,10344,-0.009120145655269554,-19.67,IS,0.58,0.0,Phase3-EA-SA2v2-USDCHF-M15-107,USDCHFMT4,1980,4h 15m,Sell
125706.59,1.21836,01.04.2014 04:39:57,tp 1.21836,-1.11,-0.0,0.0,0.0,1.21726,31.03.2014 21:05:00,10345,-0.0,49.88,IS,0.41,0.0,Phase3-EA-SA2v2-EURCHF-M5-43,EURCHFMT4,5270,7h 34m,Buy
125697.74,1.21834,01.04.2014 11:15:00,,0.0,-8.85000000000582,0.0,0.0,1.21811,01.04.2014 02:30:00,10346,-0.004102795375888029,-8.85,IS,0.34,0.0,Phase3-EA-S4v1-EURCHF-M15-221,EURCHFMT4,2714,8h 45m,Sell
125629.47,142727,01.04.2014 15:59:58,sl 142.727,-0.31,-77.11999999999534,0.0,0.0,141947,31.03.2014 18:00:00,10347,-0.035752268857430235,-68.27,IS,0.09,0.0,Phase3-EA-TR1v1-EURJPY-M30-91,EURJPYMT4,1826,21h 59m,Sell
125639.51,1.2185,02.04.2014 05:05:00,,-1.11,-67.0799999999872,0.0,0.0,1.21826,01.04.2014 20:45:00,10348,-0.03109779817111135,10.04,IS,0.41,0.0,Phase3-EA-SA2v2-EURCHF-M5-43,EURCHFMT4,5272,8h 20m,Buy
125618.32,1.21911,02.04.2014 10:00:00,,0.0,-88.26999999998952,0.0,0.0,1.21856,02.04.2014 01:15:00,10349,-0.040921327438345215,-21.19,IS,0.34,0.0,Phase3-EA-S4v1-EURCHF-M15-221,EURCHFMT4,2716,8h 45m,Sell
125773.93,143.17,02.04.2014 13:00:00,,-0.8,-0.0,0.0,0.0,142215,01.04.2014 01:30:00,10350,-0.0,155.61,IS,0.17,0.0,Phase3-EA-T1v2-EURJPY-M15-322,EURJPYMT4,1848,1d 11h 30m,Buy
125932.71,173.08,03.04.2014 04:29:58,tp 173.080,-1.56,-0.0,0.0,0.0,171.23,31.03.2014 02:00:00,10351,-0.0,158.78,IS,0.09,0.0,Phase3-EA-B1v1-GBPJPY-M30-1,GBPJPYMT4,986,3d 2h 29m,Buy
125928.08,1.22048,03.04.2014 07:35:00,,-6.94,-4.630000000004657,0.0,0.0,1.22053,02.04.2014 23:15:00,10352,-0.002144186492173705,-4.63,IS,0.41,0.0,Phase3-EA-SA2v2-EURCHF-M5-43,EURCHFMT4,5274,8h 20m,Sell
125908.54,1.22128,03.04.2014 13:15:00,,0.0,-24.170000000012806,0.0,0.0,1.22077,03.04.2014 04:30:00,10353,-0.011193301839268636,-19.54,IS,0.34,0.0,Phase3-EA-S4v1-EURCHF-M15-221,EURCHFMT4,2718,8h 45m,Sell
125940.99,1.22316,04.04.2014 07:10:00,,-1.1,-0.0,0.0,0.0,1.22243,03.04.2014 22:50:00,10354,-0.0,32.45,IS,0.41,0.0,Phase3-EA-SA2v2-EURCHF-M5-43,EURCHFMT4,5276,8h 20m,Buy
125910.89,1.22355,04.04.2014 13:00:00,,0.0,-30.10000000000582,0.0,0.0,1.22276,04.04.2014 04:15:00,10355,-0.01393899324070228,-30.1,IS,0.34,0.0,Phase3-EA-S4v1-EURCHF-M15-221,EURCHFMT4,2720,8h 45m,Sell
125846.5,142148,04.04.2014 15:59:57,sl 142.148,-2.12,-94.49000000001979,0.0,0.0,142868,01.04.2014 18:00:00,10356,-0.04375732462837141,-64.39,IS,0.09,0.0,Phase3-EA-TR1v1-EURJPY-M30-91,EURJPYMT4,1828,2d 21h 59m,Buy
125879.46,103215,07.04.2014 03:45:00,,0.0,-61.53000000002794,0.0,0.0,103341,07.04.2014 01:00:00,10357,-0.028493895485070926,32.96,IS,0.27,0.0,Phase3-EA-S1v2-USDJPY-M15-0,USDJPYMT4,2996,2h 45m,Sell
125919.6,0.89147,07.04.2014 04:00:00,,-3.45,-21.39000000001397,0.0,0.0,0.89214,04.04.2014 23:45:00,10358,-0.009905483900955442,40.14,IS,0.58,0.0,Phase3-EA-SA2v2-USDCHF-M15-107,USDCHFMT4,1982,2d 4h 15m,Sell
125915.74,1.22179,07.04.2014 04:40:00,,-1.1,-25.25,0.0,0.0,1.22185,04.04.2014 20:20:00,10359,-0.011693009279988854,-3.86,IS,0.41,0.0,Phase3-EA-SA2v2-EURCHF-M5-43,EURCHFMT4,5278,2d 8h 20m,Buy
125954.79,171213,07.04.2014 05:10:00,,-0.8,-0.0,0.0,0.0,171034,04.04.2014 23:45:00,10360,-0.0,39.05,IS,0.23,0.0,Phase3-EA-S4v1-GBPJPY-M5-194,GBPJPYMT4,2402,2d 5h 25m,Buy
125939.14,1.22137,07.04.2014 12:15:00,,0.0,-15.64999999999418,0.0,0.0,1.22178,07.04.2014 03:30:00,10361,-0.007246887184115739,-15.65,IS,0.34,0.0,Phase3-EA-S4v1-EURCHF-M15-221,EURCHFMT4,2722,8h 45m,Buy
125912.21,0.88726,08.04.2014 03:30:00,,-0.78,-42.579999999987194,0.0,0.0,0.88766,07.04.2014 23:15:00,10362,-0.019717089859403843,-26.93,IS,0.58,0.0,Phase3-EA-SA2v2-USDCHF-M15-107,USDCHFMT4,1984,4h 15m,Buy
125960.72,1.21959,08.04.2014 03:44:59,tp 1.21959,-2.31,-0.0,0.0,0.0,1.22069,07.04.2014 20:05:00,10363,-0.0,48.51,IS,0.41,0.0,Phase3-EA-SA2v2-EURCHF-M5-43,EURCHFMT4,5280,7h 39m,Sell
125954.69,171037,08.04.2014 08:45:00,,0.0,-6.029999999998836,0.0,0.0,171064,08.04.2014 03:20:00,10364,-0.0027921744287566683,-6.03,IS,0.23,0.0,Phase3-EA-S4v1-GBPJPY-M5-194,GBPJPYMT4,2404,5h 25m,Buy
126212.38,1.67313,08.04.2014 15:29:58,tp 1.67313,-6.91,-0.0,0.0,0.0,1.65423,26.03.2014 11:00:00,10365,-0.0,257.69,IS,0.14,0.0,Phase3-EA-B1v1-GBPUSD-M30-14,GBPUSDMT4,682,13d 4h 29m,Buy
126493.57,140806,08.04.2014 15:29:58,tp 140.806,-1.16,-0.0,0.0,0.0,142506,04.04.2014 04:30:00,10366,-0.0,281.19,IS,0.17,0.0,Phase3-EA-T1v2-EURJPY-M15-322,EURJPYMT4,1850,4d 10h 59m,Sell
126604.21,140.36,08.04.2014 21:29:58,tp 140.360,-0.62,-0.0,0.0,0.0,141.62,04.04.2014 20:00:00,10367,-0.0,110.64,IS,0.09,0.0,Phase3-EA-TR1v1-EURJPY-M30-91,EURJPYMT4,1830,4d 1h 29m,Sell
126606.35,1.21902,09.04.2014 04:30:00,,-1.11,-0.0,0.0,0.0,1.21895,08.04.2014 20:10:00,10368,-0.0,2.14,IS,0.41,0.0,Phase3-EA-SA2v2-EURCHF-M5-43,EURCHFMT4,5282,8h 20m,Buy
126607.89,1.21907,09.04.2014 11:45:00,,0.0,-0.0,0.0,0.0,1.21911,09.04.2014 03:00:00,10369,-0.0,1.54,IS,0.34,0.0,Phase3-EA-S4v1-EURCHF-M15-221,EURCHFMT4,2724,8h 45m,Sell
126566.08,102021,09.04.2014 15:00:00,,0.0,-41.80999999999767,0.0,0.0,101863,09.04.2014 00:45:00,10370,-0.01930215930730747,-41.81,IS,0.27,0.0,Phase3-EA-S1v2-USDJPY-M15-0,USDJPYMT4,2998,14h 15m,Sell
126502.25,141001,09.04.2014 21:29:58,sl 141.001,-0.31,-105.63999999998487,0.0,0.0,140281,08.04.2014 21:30:00,10371,-0.04877015329403929,-63.83,IS,0.09,0.0,Phase3-EA-TR1v1-EURJPY-M30-91,EURJPYMT4,1832,23h 59m,Sell
126508.32,1218,10.04.2014 05:00:00,,-6.99,-99.56999999997788,0.0,0.0,1.21828,09.04.2014 20:40:00,10372,-0.045967854633539466,6.07,IS,0.41,0.0,Phase3-EA-SA2v2-EURCHF-M5-43,EURCHFMT4,5284,8h 20m,Sell
126596.45,170976,10.04.2014 06:34:58,tp 170.976,0.0,-11.439999999973224,0.0,0.0,171366,10.04.2014 01:40:00,10373,-0.005281432730808251,88.13,IS,0.23,0.0,Phase3-EA-S4v1-GBPJPY-M5-194,GBPJPYMT4,2406,4h 54m,Sell
126623.88,141041,10.04.2014 07:15:00,,-2.45,-0.0,0.0,0.0,140862,09.04.2014 20:45:00,10374,-0.0,27.43,IS,0.17,0.0,Phase3-EA-T1v2-EURJPY-M15-322,EURJPYMT4,1852,10h 30m,Buy
126640.1,1.21824,10.04.2014 09:45:00,,0.0,-0.0,0.0,0.0,1.21866,10.04.2014 01:00:00,10375,-0.0,16.22,IS,0.34,0.0,Phase3-EA-S4v1-EURCHF-M15-221,EURCHFMT4,2726,8h 45m,Sell
126576.32,140639,10.04.2014 12:29:58,sl 140.639,0.0,-63.779999999998836,0.0,0.0,141359,10.04.2014 02:00:00,10376,-0.029440532939191917,-63.78,IS,0.09,0.0,Phase3-EA-TR1v1-EURJPY-M30-91,EURJPYMT4,1834,10h 29m,Buy
126576.98,101426,11.04.2014 02:30:00,,-1.2,-63.11999999999534,0.0,0.0,101433,10.04.2014 23:00:00,10377,-0.029135880199462064,0.66,IS,0.27,0.0,Phase3-EA-S1v2-USDJPY-M15-0,USDJPYMT4,3000,3h 30m,Sell
126665.26,170467,11.04.2014 04:24:58,tp 170.467,0.0,-0.0,0.0,0.0,170077,11.04.2014 02:50:00,10378,-0.0,88.28,IS,0.23,0.0,Phase3-EA-S4v1-GBPJPY-M5-194,GBPJPYMT4,2408,1h 34m,Buy
126682.57,1.21713,11.04.2014 09:35:00,,0.0,-0.0,0.0,0.0,1.21676,11.04.2014 01:15:00,10379,-0.0,17.31,IS,0.41,0.0,Phase3-EA-SA2v2-EURCHF-M5-43,EURCHFMT4,5286,8h 20m,Buy
126707.03,1.21677,11.04.2014 13:45:00,,0.0,-0.0,0.0,0.0,1.2174,11.04.2014 05:00:00,10380,-0.0,24.46,IS,0.34,0.0,Phase3-EA-S4v1-EURCHF-M15-221,EURCHFMT4,2728,8h 45m,Sell
126867.42,169792,11.04.2014 14:29:58,tp 169.792,-3.58,-0.0,0.0,0.0,171642,04.04.2014 18:30:00,10381,-0.0,160.39,IS,0.09,0.0,Phase3-EA-B1v1-GBPJPY-M30-1,GBPJPYMT4,988,6d 19h 59m,Sell
126878.99,101501,14.04.2014 01:45:00,,-1.2,-0.0,0.0,0.0,101549,11.04.2014 17:00:00,10382,-0.0,11.57,IS,0.27,0.0,Phase3-EA-S1v2-USDJPY-M15-0,USDJPYMT4,3002,2d 8h 45m,Sell
126782.23,877,14.04.2014 03:00:00,,-3.51,-96.76000000000931,0.0,0.0,0.87559,11.04.2014 22:45:00,10383,-0.044614741151279114,-96.76,IS,0.58,0.0,Phase3-EA-SA2v2-USDCHF-M15-107,USDCHFMT4,1986,2d 4h 15m,Sell
126748.38,1.21473,14.04.2014 05:00:00,,-1.12,-130.61000000001513,0.0,0.0,1.21543,11.04.2014 20:40:00,10384,-0.06022252316834104,-33.85,IS,0.41,0.0,Phase3-EA-SA2v2-EURCHF-M5-43,EURCHFMT4,5288,2d 8h 20m,Buy
126753.59,169.94,14.04.2014 06:40:00,,0.0,-125.40000000002328,0.0,0.0,169917,14.04.2014 01:15:00,10385,-0.05782026188890969,5.21,IS,0.23,0.0,Phase3-EA-S4v1-GBPJPY-M5-194,GBPJPYMT4,2410,5h 25m,Buy
126715.1,140887,14.04.2014 10:29:58,sl 140.887,0.0,-163.89000000001397,0.0,0.0,140657,14.04.2014 01:15:00,10386,-0.07556748581317749,-38.49,IS,0.17,0.0,Phase3-EA-T1v2-EURJPY-M15-322,EURJPYMT4,1854,9h 14m,Sell
126752.22,1.21553,14.04.2014 12:30:00,,0.0,-126.77000000001863,0.0,0.0,1.21457,14.04.2014 03:45:00,10387,-0.05845195055547685,37.12,IS,0.34,0.0,Phase3-EA-S4v1-EURCHF-M15-221,EURCHFMT4,2730,8h 45m,Buy
126713.8,140.78,14.04.2014 15:14:58,sl 140.780,0.0,-165.19000000003143,0.0,0.0,140.55,14.04.2014 12:30:00,10388,-0.07616689841649948,-38.42,IS,0.17,0.0,Phase3-EA-T1v2-EURJPY-M15-322,EURJPYMT4,1856,2h 44m,Sell
126674.85,140802,15.04.2014 00:44:59,sl 140.802,-0.58,-204.14000000004307,0.0,0.0,140572,14.04.2014 17:15:00,10389,-0.09412622218502649,-38.95,IS,0.17,0.0,Phase3-EA-T1v2-EURJPY-M15-322,EURJPYMT4,1858,7h 29m,Sell
126614.78,1.21645,15.04.2014 04:30:00,,-2.33,-264.21000000005006,0.0,0.0,1.21521,14.04.2014 20:10:00,10390,-0.12182369532431328,-60.07,IS,0.41,0.0,Phase3-EA-SA2v2-EURCHF-M5-43,EURCHFMT4,5290,8h 20m,Sell
126617.1,1.21595,15.04.2014 12:15:00,,0.0,-261.8900000000431,0.0,0.0,1.21601,15.04.2014 03:30:00,10391,-0.12075397437070363,2.32,IS,0.34,0.0,Phase3-EA-S4v1-EURCHF-M15-221,EURCHFMT4,2732,8h 45m,Sell
126652.0,0.88069,16.04.2014 04:30:00,,0.0,-226.9900000000489,0.0,0.0,0.88016,16.04.2014 00:15:00,10392,-0.10466205140481659,34.9,IS,0.58,0.0,Phase3-EA-SA2v2-USDCHF-M15-107,USDCHFMT4,1988,4h 15m,Buy
126611.03,1.21647,16.04.2014 05:10:00,,-2.33,-267.96000000005006,0.0,0.0,1.21564,15.04.2014 20:50:00,10393,-0.12355277014156504,-40.97,IS,0.41,0.0,Phase3-EA-SA2v2-EURCHF-M5-43,EURCHFMT4,5292,8h 20m,Sell
126511.81,170909,16.04.2014 05:30:00,,0.0,-367.1800000000512,0.0,0.0,170468,16.04.2014 00:05:00,10394,-0.16930178437295756,-99.22,IS,0.23,0.0,Phase3-EA-S4v1-GBPJPY-M5-194,GBPJPYMT4,2412,5h 25m,Sell
126488.22,1.21684,16.04.2014 14:00:00,,0.0,-390.77000000004773,0.0,0.0,1.21623,16.04.2014 05:15:00,10395,-0.18017881769001437,-23.59,IS,0.34,0.0,Phase3-EA-S4v1-EURCHF-M15-221,EURCHFMT4,2734,8h 45m,Sell
126489.6,0.88163,17.04.2014 02:45:00,,-10.46,-389.3900000000431,0.0,0.0,0.88181,16.04.2014 22:30:00,10396,-0.17954251815726358,1.38,IS,0.58,0.0,Phase3-EA-SA2v2-USDCHF-M15-107,USDCHFMT4,1990,4h 15m,Sell
126495.21,1.21809,17.04.2014 07:30:00,,-6.97,-383.78000000005704,0.0,0.0,1.21836,16.04.2014 23:10:00,10397,-0.1769558222306614,5.61,IS,0.41,0.0,Phase3-EA-SA2v2-EURCHF-M5-43,EURCHFMT4,5294,8h 20m,Sell
126530.61,171674,17.04.2014 08:50:00,,0.0,-348.38000000006286,0.0,0.0,171831,17.04.2014 03:25:00,10398,-0.1606333559558074,35.4,IS,0.23,0.0,Phase3-EA-S4v1-GBPJPY-M5-194,GBPJPYMT4,2414,5h 25m,Sell
126493.44,1.21707,17.04.2014 14:45:00,,0.0,-385.55000000007567,0.0,0.0,1.21803,17.04.2014 06:00:00,10399,-0.1777719455444128,-37.17,IS,0.34,0.0,Phase3-EA-S4v1-EURCHF-M15-221,EURCHFMT4,2736,8h 45m,Buy
126502.93,102434,18.04.2014 01:45:00,,0.0,-376.060000000085,0.0,0.0,102398,18.04.2014 01:00:00,10400,-0.1733962335402253,9.49,IS,0.27,0.0,Phase3-EA-S1v2-USDJPY-M15-0,USDJPYMT4,3004,45m 0s,Buy
126465.33,1.22018,18.04.2014 04:45:00,,-2.32,-413.6600000000908,0.0,0.0,1.21942,17.04.2014 20:25:00,10401,-0.19073309037453898,-37.6,IS,0.41,0.0,Phase3-EA-SA2v2-EURCHF-M5-43,EURCHFMT4,5296,8h 20m,Sell
126449.22,141428,18.04.2014 08:15:00,,0.0,-429.77000000007683,0.0,0.0,141525,18.04.2014 02:00:00,10402,-0.19816119578944613,-16.11,IS,0.17,0.0,Phase3-EA-T1v2-EURJPY-M15-322,EURJPYMT4,1860,6h 15m,Buy
126449.55,141501,18.04.2014 17:30:00,,0.0,-429.44000000008964,0.0,0.0,141499,18.04.2014 10:15:00,10403,-0.19800903720553387,0.33,IS,0.17,0.0,Phase3-EA-T1v2-EURJPY-M15-322,EURJPYMT4,1862,7h 15m,Buy
126379.67,172308,21.04.2014 04:40:00,,-1.3,-499.3200000000943,0.0,0.0,172002,18.04.2014 23:15:00,10404,-0.2302297700667502,-69.88,IS,0.23,0.0,Phase3-EA-S4v1-GBPJPY-M5-194,GBPJPYMT4,2416,2d 5h 25m,Sell
126394.52,1.21998,21.04.2014 05:35:00,,-2.32,-484.4700000000885,0.0,0.0,1.22035,18.04.2014 21:15:00,10405,-0.22338263379043052,14.85,IS,0.41,0.0,Phase3-EA-SA2v2-EURCHF-M5-43,EURCHFMT4,5298,2d 8h 20m,Sell
126370.62,1.21935,21.04.2014 11:00:00,,0.0,-508.37000000008265,0.0,0.0,1.21997,21.04.2014 02:15:00,10406,-0.23440260395904575,-23.9,IS,0.34,0.0,Phase3-EA-S4v1-EURCHF-M15-221,EURCHFMT4,2738,8h 45m,Buy
126360.89,1.22068,22.04.2014 05:30:00,,-2.32,-518.1000000000931,0.0,0.0,1.22052,21.04.2014 21:10:00,10407,-0.2388889767515465,-9.73,IS,0.41,0.0,Phase3-EA-SA2v2-EURCHF-M5-43,EURCHFMT4,5300,8h 20m,Sell
126321.94,141341,22.04.2014 09:14:58,sl 141.341,-0.81,-557.0500000001048,0.0,0.0,141571,21.04.2014 02:15:00,10408,-0.2568483005200735,-38.95,IS,0.17,0.0,Phase3-EA-T1v2-EURJPY-M15-322,EURJPYMT4,1864,1d 6h 59m,Buy
126312.33,1.22104,22.04.2014 12:00:00,,0.0,-566.6600000000908,0.0,0.0,1.22079,22.04.2014 03:15:00,10409,-0.26127934291841093,-9.61,IS,0.34,0.0,Phase3-EA-S4v1-EURCHF-M15-221,EURCHFMT4,2740,8h 45m,Sell
126472.9,172526,22.04.2014 13:29:58,tp 172.526,-1.91,-406.0900000000838,0.0,0.0,170676,16.04.2014 03:30:00,10410,-0.1872426646767769,160.57,IS,0.09,0.0,Phase3-EA-B1v1-GBPJPY-M30-1,GBPJPYMT4,990,6d 9h 59m,Buy
126466.27,141595,22.04.2014 20:45:00,,0.0,-412.7200000000885,0.0,0.0,141635,22.04.2014 19:45:00,10411,-0.19029966895368014,-6.63,IS,0.17,0.0,Phase3-EA-T1v2-EURJPY-M15-322,EURJPYMT4,1866,1h 0m,Buy
126472.58,1.22137,23.04.2014 05:00:00,,-1.11,-406.4100000000908,0.0,0.0,1.22121,22.04.2014 20:40:00,10412,-0.18739021239451892,6.31,IS,0.41,0.0,Phase3-EA-SA2v2-EURCHF-M5-43,EURCHFMT4,5302,8h 20m,Buy
126473.73,1.22171,23.04.2014 10:30:00,,0.0,-405.2600000000966,0.0,0.0,1.22174,23.04.2014 01:45:00,10413,-0.18685996278389772,1.15,IS,0.34,0.0,Phase3-EA-S4v1-EURCHF-M15-221,EURCHFMT4,2742,8h 45m,Sell
126430.14,1.6767,23.04.2014 17:59:58,sl 1.67670,-1.59,-448.85000000009313,0.0,0.0,1.6797,18.04.2014 17:00:00,10414,-0.20695872845963062,-43.59,IS,0.14,0.0,Phase3-EA-B1v1-GBPUSD-M30-14,GBPUSDMT4,684,5d 0h 59m,Buy
126391.98,141632,23.04.2014 23:44:57,sl 141.632,0.0,-487.0100000000966,0.0,0.0,141402,23.04.2014 13:15:00,10415,-0.22455379379998616,-38.16,IS,0.17,0.0,Phase3-EA-T1v2-EURJPY-M15-322,EURJPYMT4,1868,10h 29m,Sell
126374.39,172008,24.04.2014 04:45:00,,-3.9,-504.60000000009313,0.0,0.0,171947,23.04.2014 23:20:00,10416,-0.23266430740944014,-17.59,IS,0.23,0.0,Phase3-EA-S4v1-GBPJPY-M5-194,GBPJPYMT4,2418,5h 25m,Sell
126347.91,102457,24.04.2014 05:00:00,,-3.55,-531.0800000001036,0.0,0.0,102.37,23.04.2014 17:00:00,10417,-0.2448738810523321,-26.48,IS,0.27,0.0,Phase3-EA-S1v2-USDJPY-M15-0,USDJPYMT4,3006,12h 0m,Sell
126330.27,1.22034,24.04.2014 06:20:00,,-6.96,-548.7200000001176,0.0,0.0,1.22011,23.04.2014 22:00:00,10418,-0.25300744899269084,-17.64,IS,0.41,0.0,Phase3-EA-SA2v2-EURCHF-M5-43,EURCHFMT4,5304,8h 20m,Sell
126341.44,1.22013,24.04.2014 09:45:00,,0.0,-537.5500000001048,0.0,0.0,1.22042,24.04.2014 01:00:00,10419,-0.24785711147036435,11.17,IS,0.34,0.0,Phase3-EA-S4v1-EURCHF-M15-221,EURCHFMT4,2744,8h 45m,Sell
126303.25,141514,24.04.2014 12:14:58,sl 141.514,0.0,-575.7400000001071,0.0,0.0,141744,24.04.2014 11:15:00,10420,-0.26546600940925735,-38.19,IS,0.17,0.0,Phase3-EA-T1v2-EURJPY-M15-322,EURJPYMT4,1870,59m 58s,Buy
126316.58,102285,25.04.2014 00:45:00,,-1.19,-562.4100000001199,0.0,0.0,102.34,24.04.2014 22:15:00,10421,-0.25931972479220566,13.33,IS,0.27,0.0,Phase3-EA-S1v2-USDJPY-M15-0,USDJPYMT4,3008,2h 30m,Sell
126348.47,1.21976,25.04.2014 05:05:00,,-1.12,-530.5200000001059,0.0,0.0,1.21905,24.04.2014 20:45:00,10422,-0.24461567254629024,31.89,IS,0.41,0.0,Phase3-EA-SA2v2-EURCHF-M5-43,EURCHFMT4,5306,8h 20m,Buy
126328.52,141463,25.04.2014 10:30:00,,0.0,-550.4700000001176,0.0,0.0,141583,25.04.2014 09:15:00,10423,-0.253814350574075,-19.95,IS,0.17,0.0,Phase3-EA-T1v2-EURJPY-M15-322,EURJPYMT4,1872,1h 15m,Buy
126347.03,1.21936,25.04.2014 15:00:00,,0.0,-531.9600000001083,0.0,0.0,1.21984,25.04.2014 06:15:00,10424,-0.24527963727611599,18.51,IS,0.34,0.0,Phase3-EA-S4v1-EURCHF-M15-221,EURCHFMT4,2746,8h 45m,Sell
126268.79,0.88215,28.04.2014 05:30:00,,0.0,-610.200000000099,0.0,0.0,0.88096,28.04.2014 01:15:00,10425,-0.28135505426325247,-78.24,IS,0.58,0.0,Phase3-EA-SA2v2-USDCHF-M15-107,USDCHFMT4,1992,4h 15m,Sell
126277.43,1.21934,28.04.2014 06:25:00,,-1.12,-601.560000000085,0.0,0.0,1.21913,25.04.2014 22:05:00,10426,-0.27737126588429795,8.64,IS,0.41,0.0,Phase3-EA-SA2v2-EURCHF-M5-43,EURCHFMT4,5308,2d 8h 20m,Buy
126292.28,171572,28.04.2014 08:35:00,,0.0,-586.7100000000792,0.0,0.0,171506,28.04.2014 03:10:00,10427,-0.2705241296079783,14.85,IS,0.23,0.0,Phase3-EA-S4v1-GBPJPY-M5-194,GBPJPYMT4,2420,5h 25m,Buy
126254.02,141401,28.04.2014 09:59:59,sl 141.401,0.0,-624.9700000000885,0.0,0.0,141171,28.04.2014 03:30:00,10428,-0.28816530361012993,-38.26,IS,0.17,0.0,Phase3-EA-T1v2-EURJPY-M15-322,EURJPYMT4,1874,6h 29m,Sell
126325.27,1.21755,28.04.2014 13:00:00,,0.0,-553.7200000000885,0.0,0.0,1.21939,28.04.2014 04:15:00,10429,-0.2553128820823464,71.25,IS,0.34,0.0,Phase3-EA-S4v1-EURCHF-M15-221,EURCHFMT4,2748,8h 45m,Sell
126359.1,1.21932,29.04.2014 04:50:00,,-1.12,-519.8900000001013,0.0,0.0,1.21857,28.04.2014 20:30:00,10430,-0.23971432179765176,33.83,IS,0.41,0.0,Phase3-EA-SA2v2-EURCHF-M5-43,EURCHFMT4,5310,8h 20m,Buy
126343.64,1.21976,29.04.2014 12:00:00,,0.0,-535.3500000000931,0.0,0.0,1.21936,29.04.2014 03:15:00,10431,-0.2468427209109046,-15.46,IS,0.34,0.0,Phase3-EA-S4v1-EURCHF-M15-221,EURCHFMT4,2750,8h 45m,Sell
126326.77,141.91,29.04.2014 16:45:00,,-0.81,-552.2200000000885,0.0,0.0,142007,28.04.2014 22:45:00,10432,-0.25462125215544573,-16.87,IS,0.17,0.0,Phase3-EA-T1v2-EURJPY-M15-322,EURJPYMT4,1876,18h 0m,Buy
126331.89,0.88357,30.04.2014 03:15:00,,-0.79,-547.1000000000931,0.0,0.0,0.88348,29.04.2014 23:00:00,10433,-0.2522604886716268,5.12,IS,0.58,0.0,Phase3-EA-SA2v2-USDCHF-M15-107,USDCHFMT4,1994,4h 15m,Buy
126302.95,1.22009,30.04.2014 05:55:00,,-1.11,-576.0400000000955,0.0,0.0,1.22069,29.04.2014 21:35:00,10434,-0.26560433539463213,-28.94,IS,0.41,0.0,Phase3-EA-SA2v2-EURCHF-M5-43,EURCHFMT4,5312,8h 20m,Buy
126264.82,141854,30.04.2014 12:29:57,sl 141.854,0.0,-614.1700000001001,0.0,0.0,141624,30.04.2014 03:30:00,10435,-0.2831855681364502,-38.13,IS,0.17,0.0,Phase3-EA-T1v2-EURJPY-M15-322,EURJPYMT4,1878,8h 59m,Sell
126235.91,102294,01.05.2014 06:30:00,,-3.57,-643.0800000001036,0.0,0.0,102198,30.04.2014 21:15:00,10436,-0.29651558226091806,-28.91,IS,0.27,0.0,Phase3-EA-S1v2-USDJPY-M15-0,USDJPYMT4,3010,9h 15m,Sell
126200.48,172684,01.05.2014 06:35:00,,-3.91,-678.5100000000966,0.0,0.0,172544,30.04.2014 23:05:00,10437,-0.3128518811343095,-35.43,IS,0.23,0.0,Phase3-EA-S4v1-GBPJPY-M5-194,GBPJPYMT4,2422,7h 30m,Sell
126201.32,1.22056,01.05.2014 07:55:00,,-3.35,-677.6700000001001,0.0,0.0,1.22047,30.04.2014 21:20:00,10438,-0.3124645683752467,0.84,IS,0.41,0.0,Phase3-EA-SA2v2-EURCHF-M5-43,EURCHFMT4,5314,10h 35m,Buy
126207.66,1.21924,02.05.2014 06:00:00,,-1.12,-671.3300000001036,0.0,0.0,1.21908,01.05.2014 21:40:00,10439,-0.30954127921754804,6.34,IS,0.41,0.0,Phase3-EA-SA2v2-EURCHF-M5-43,EURCHFMT4,5316,8h 20m,Buy
126206.0,141867,02.05.2014 06:30:00,,0.0,-672.9900000001071,0.0,0.0,141877,02.05.2014 00:30:00,10440,-0.31030668300331976,-1.66,IS,0.17,0.0,Phase3-EA-T1v2-EURJPY-M15-322,EURJPYMT4,1880,6h 0m,Buy
126170.77,1.21722,05.05.2014 05:00:00,,-1.12,-708.2200000001176,0.0,0.0,1.21795,02.05.2014 20:40:00,10441,-0.3265507645531325,-35.23,IS,0.41,0.0,Phase3-EA-SA2v2-EURCHF-M5-43,EURCHFMT4,5318,2d 8h 20m,Buy
126172.09,0.87748,05.05.2014 05:45:00,,0.0,-706.9000000001106,0.0,0.0,0.87746,05.05.2014 01:30:00,10442,-0.3259421302174566,1.32,IS,0.58,0.0,Phase3-EA-SA2v2-USDCHF-M15-107,USDCHFMT4,1996,4h 15m,Buy
126127.13,102027,05.05.2014 10:00:00,,-0.77,-751.8600000001024,0.0,0.0,102194,02.05.2014 23:45:00,10443,-0.3466725845597567,-44.96,IS,0.27,0.0,Phase3-EA-S1v2-USDJPY-M15-0,USDJPYMT4,3012,2d 10h 15m,Buy
126112.4,1.2173,05.05.2014 10:30:00,,0.0,-766.5900000001129,0.0,0.0,1.21768,05.05.2014 01:45:00,10444,-0.35346439044192646,-14.73,IS,0.34,0.0,Phase3-EA-S4v1-EURCHF-M15-221,EURCHFMT4,2752,8h 45m,Buy
126074.05,141668,05.05.2014 16:59:59,sl 141.668,0.0,-804.9400000001187,0.0,0.0,141438,05.05.2014 15:45:00,10445,-0.37114706223969046,-38.35,IS,0.17,0.0,Phase3-EA-T1v2-EURJPY-M15-322,EURJPYMT4,1882,1h 14m,Sell
126077.6,1.21792,06.05.2014 04:40:00,,-1.12,-801.3900000001304,0.0,0.0,1.21782,05.05.2014 20:20:00,10446,-0.36951020474603086,3.55,IS,0.41,0.0,Phase3-EA-SA2v2-EURCHF-M5-43,EURCHFMT4,5320,8h 20m,Buy
126039.13,141602,06.05.2014 15:44:58,sl 141.602,0.0,-839.8600000001315,0.0,0.0,141832,06.05.2014 10:30:00,10447,-0.3872482069379448,-38.47,IS,0.17,0.0,Phase3-EA-T1v2-EURJPY-M15-322,EURJPYMT4,1884,5h 14m,Buy
126298.95,1.69954,06.05.2014 17:29:58,tp 1.69954,-4.78,-580.0400000001246,0.0,0.0,1.68064,25.04.2014 02:00:00,10448,-0.26744868186638077,259.82,IS,0.14,0.0,Phase3-EA-B1v1-GBPUSD-M30-14,GBPUSDMT4,686,11d 15h 29m,Buy
126298.03,101605,07.05.2014 03:45:00,,-1.19,-580.9600000001374,0.0,0.0,101606,06.05.2014 21:15:00,10449,-0.26787288155488576,-0.92,IS,0.27,0.0,Phase3-EA-S1v2-USDJPY-M15-0,USDJPYMT4,3014,6h 30m,Sell
126317.08,0.87379,07.05.2014 04:00:00,,-3.52,-561.910000000149,0.0,0.0,0.87413,06.05.2014 23:45:00,10450,-0.25908918148325216,19.05,IS,0.58,0.0,Phase3-EA-SA2v2-USDCHF-M15-107,USDCHFMT4,1998,4h 15m,Sell
126331.63,1.21716,07.05.2014 07:05:00,,-2.34,-547.3600000001607,0.0,0.0,1.21752,06.05.2014 22:45:00,10451,-0.2523803711923207,14.55,IS,0.41,0.0,Phase3-EA-SA2v2-EURCHF-M5-43,EURCHFMT4,5322,8h 20m,Sell
126379.4,172462,07.05.2014 08:40:00,,0.0,-499.59000000017113,0.0,0.0,172673,07.05.2014 03:15:00,10452,-0.23035426345362775,47.77,IS,0.23,0.0,Phase3-EA-S4v1-GBPJPY-M5-194,GBPJPYMT4,2424,5h 25m,Sell
126416.76,1.21672,07.05.2014 10:30:00,,0.0,-462.2300000001851,0.0,0.0,1.21768,07.05.2014 01:45:00,10453,-0.2131280674076273,37.36,IS,0.34,0.0,Phase3-EA-S4v1-EURCHF-M15-221,EURCHFMT4,2754,8h 45m,Sell
126378.29,141689,07.05.2014 15:14:58,sl 141.689,0.0,-500.70000000018626,0.0,0.0,141459,07.05.2014 05:00:00,10454,-0.23086606959954126,-38.47,IS,0.17,0.0,Phase3-EA-T1v2-EURJPY-M15-322,EURJPYMT4,1886,10h 14m,Sell
126355.86,0.87621,08.05.2014 02:45:00,,-10.52,-523.1300000001793,0.0,0.0,0.87603,07.05.2014 22:30:00,10455,-0.24120824243979325,-22.43,IS,0.58,0.0,Phase3-EA-SA2v2-USDCHF-M15-107,USDCHFMT4,2000,4h 15m,Sell
126354.93,1.21884,08.05.2014 07:05:00,,-7.02,-524.0600000001723,0.0,0.0,1.21897,07.05.2014 22:45:00,10456,-0.24163705299446847,-0.93,IS,0.41,0.0,Phase3-EA-SA2v2-EURCHF-M5-43,EURCHFMT4,5324,8h 20m,Sell
126359.49,141678,08.05.2014 08:00:00,,-2.45,-519.5000000001746,0.0,0.0,141636,07.05.2014 22:00:00,10457,-0.23953449801669138,4.56,IS,0.17,0.0,Phase3-EA-T1v2-EURJPY-M15-322,EURJPYMT4,1888,10h 0m,Buy
126317.49,1.69342,08.05.2014 15:59:58,sl 1.69342,0.0,-561.5000000001746,0.0,0.0,1.69642,08.05.2014 13:00:00,10458,-0.2589001359699111,-42.0,IS,0.14,0.0,Phase3-EA-B1v1-GBPUSD-M30-14,GBPUSDMT4,688,2h 59m,Buy
126279.05,141585,08.05.2014 15:59:58,sl 141.585,0.0,-599.940000000177,0.0,0.0,141815,08.05.2014 10:45:00,10459,-0.2766243055632876,-38.44,IS,0.17,0.0,Phase3-EA-T1v2-EURJPY-M15-322,EURJPYMT4,1890,5h 14m,Buy
126233.41,0.88069,09.05.2014 03:30:00,,-3.49,-645.5800000001909,0.0,0.0,0.88005,08.05.2014 23:15:00,10460,-0.2976682988057928,-45.64,IS,0.58,0.0,Phase3-EA-SA2v2-USDCHF-M15-107,USDCHFMT4,2002,4h 15m,Sell
126158.9,140519,09.05.2014 09:59:58,sl 140.519,-10.76,-720.0900000002002,0.0,0.0,141239,16.04.2014 06:00:00,10461,-0.33202386270804485,-74.51,IS,0.09,0.0,Phase3-EA-TR1v1-EURJPY-M30-91,EURJPYMT4,1836,23d 3h 59m,Buy
126155.44,1.21885,09.05.2014 14:00:00,,0.0,-723.5500000001921,0.0,0.0,1.21876,09.05.2014 05:15:00,10462,-0.33361922240609204,-3.46,IS,0.34,0.0,Phase3-EA-S4v1-EURCHF-M15-221,EURCHFMT4,2756,8h 45m,Sell
126092.03,171762,09.05.2014 14:29:58,sl 171.762,-4.14,-786.9600000001956,0.0,0.0,172432,28.04.2014 14:30:00,10463,-0.3628567248492761,-63.41,IS,0.09,0.0,Phase3-EA-B1v1-GBPJPY-M30-1,GBPJPYMT4,992,10d 23h 59m,Buy
126078.88,101643,09.05.2014 14:45:00,,-1.2,-800.1100000001898,0.0,0.0,101598,08.05.2014 23:45:00,10464,-0.3689200138751029,-13.15,IS,0.27,0.0,Phase3-EA-S1v2-USDJPY-M15-0,USDJPYMT4,3016,15h 0m,Sell
126091.11,0.88685,12.05.2014 02:30:00,,-3.47,-787.8800000001793,0.0,0.0,0.88709,09.05.2014 22:15:00,10465,-0.3632809245377677,12.23,IS,0.58,0.0,Phase3-EA-SA2v2-USDCHF-M15-107,USDCHFMT4,2004,2d 4h 15m,Sell
126059.69,1.22047,12.05.2014 04:50:00,,-2.31,-819.3000000001921,0.0,0.0,1.21984,09.05.2014 20:30:00,10466,-0.3777682660732537,-31.42,IS,0.41,0.0,Phase3-EA-SA2v2-EURCHF-M5-43,EURCHFMT4,5326,2d 8h 20m,Sell
126032.4,171.88,12.05.2014 08:25:00,,0.0,-846.5900000002002,0.0,0.0,171759,12.05.2014 03:00:00,10467,-0.390351319876671,-27.29,IS,0.23,0.0,Phase3-EA-S4v1-GBPJPY-M5-194,GBPJPYMT4,2426,5h 25m,Sell
126014.75,1.22028,12.05.2014 10:30:00,,0.0,-864.2400000001944,0.0,0.0,1.21982,12.05.2014 01:45:00,10468,-0.3984894986831999,-17.65,IS,0.34,0.0,Phase3-EA-S4v1-EURCHF-M15-221,EURCHFMT4,2758,8h 45m,Sell
126017.52,1.22129,13.05.2014 05:15:00,,-2.31,-861.4700000002049,0.0,0.0,1.2214,12.05.2014 20:55:00,10469,-0.3972122887515281,2.77,IS,0.41,0.0,Phase3-EA-SA2v2-EURCHF-M5-43,EURCHFMT4,5328,8h 20m,Sell
125972.3,172532,13.05.2014 06:45:00,,0.0,-906.690000000206,0.0,0.0,172331,13.05.2014 01:20:00,10470,-0.41806262561449525,-45.22,IS,0.23,0.0,Phase3-EA-S4v1-GBPJPY-M5-194,GBPJPYMT4,2428,5h 25m,Sell
125973.83,1.2212,13.05.2014 11:45:00,,0.0,-905.1600000002072,0.0,0.0,1.22116,13.05.2014 03:00:00,10471,-0.41735716308905707,1.53,IS,0.34,0.0,Phase3-EA-S4v1-EURCHF-M15-221,EURCHFMT4,2760,8h 45m,Buy
125956.1,0.88991,14.05.2014 03:45:00,,-0.78,-922.8900000002177,0.0,0.0,0.89017,13.05.2014 23:30:00,10472,-0.4255322288250282,-17.73,IS,0.58,0.0,Phase3-EA-SA2v2-USDCHF-M15-107,USDCHFMT4,2006,4h 15m,Buy
125969.94,1.21943,14.05.2014 06:10:00,,-2.3,-909.0500000002212,0.0,0.0,1.21978,13.05.2014 21:50:00,10473,-0.41915079003282596,13.84,IS,0.41,0.0,Phase3-EA-SA2v2-EURCHF-M5-43,EURCHFMT4,5330,8h 20m,Sell
126027.13,172.18,14.05.2014 08:55:00,,0.0,-851.8600000002189,0.0,0.0,171926,14.05.2014 03:30:00,10474,-0.39278124635319067,57.19,IS,0.23,0.0,Phase3-EA-S4v1-GBPJPY-M5-194,GBPJPYMT4,2430,5h 25m,Buy
125967.64,171886,14.05.2014 11:29:59,sl 171.886,-0.32,-911.3500000002095,0.0,0.0,172556,13.05.2014 06:30:00,10475,-0.42021128925406837,-59.49,IS,0.09,0.0,Phase3-EA-B1v1-GBPJPY-M30-1,GBPJPYMT4,994,1d 4h 59m,Buy
126249.03,139512,14.05.2014 12:44:58,tp 139.512,-2.33,-629.9600000001956,0.0,0.0,141212,08.05.2014 16:15:00,10476,-0.290466125833669,281.39,IS,0.17,0.0,Phase3-EA-T1v2-EURJPY-M15-322,EURJPYMT4,1892,5d 20h 29m,Sell
126272.36,1.21985,14.05.2014 13:30:00,,0.0,-606.6300000002084,0.0,0.0,1.21924,14.05.2014 04:45:00,10477,-0.27970897503727926,23.33,IS,0.34,0.0,Phase3-EA-S4v1-EURCHF-M15-221,EURCHFMT4,2762,8h 45m,Buy
126283.33,1.22019,15.05.2014 07:05:00,,-3.32,-595.6600000002072,0.0,0.0,1.21988,14.05.2014 22:45:00,10478,-0.2746508548385449,10.97,IS,0.41,0.0,Phase3-EA-SA2v2-EURCHF-M5-43,EURCHFMT4,5332,8h 20m,Buy
126392.81,139034,15.05.2014 16:59:58,tp 139.034,-1.86,-486.18000000019674,0.0,0.0,140294,09.05.2014 16:00:00,10479,-0.22417109190714726,109.48,IS,0.09,0.0,Phase3-EA-TR1v1-EURJPY-M30-91,EURJPYMT4,1838,6d 0h 59m,Sell
126402.51,101514,16.05.2014 03:15:00,,-1.2,-476.4800000001851,0.0,0.0,101555,15.05.2014 22:45:00,10480,-0.219698551713184,9.7,IS,0.27,0.0,Phase3-EA-S1v2-USDJPY-M15-0,USDJPYMT4,3018,4h 30m,Sell
126383.44,0.8909,16.05.2014 03:30:00,,-3.45,-495.5500000001921,0.0,0.0,0.89066,15.05.2014 23:15:00,10481,-0.22849147351718485,-19.07,IS,0.58,0.0,Phase3-EA-SA2v2-USDCHF-M15-107,USDCHFMT4,2008,4h 15m,Sell
126386.21,1.22116,16.05.2014 07:50:00,,-2.3,-492.78000000020256,0.0,0.0,1.22127,15.05.2014 23:30:00,10482,-0.22721426358551305,2.77,IS,0.41,0.0,Phase3-EA-SA2v2-EURCHF-M5-43,EURCHFMT4,5334,8h 20m,Sell
126390.03,1.22135,16.05.2014 09:45:00,,0.0,-488.9600000001956,0.0,0.0,1.22145,16.05.2014 01:00:00,10483,-0.2254529127050027,3.82,IS,0.34,0.0,Phase3-EA-S4v1-EURCHF-M15-221,EURCHFMT4,2764,8h 45m,Sell
126429.52,0.89172,19.05.2014 03:30:00,,-3.44,-449.4700000002049,0.0,0.0,0.89238,16.05.2014 23:15:00,10484,-0.2072446021628011,39.49,IS,0.58,0.0,Phase3-EA-SA2v2-USDCHF-M15-107,USDCHFMT4,2010,2d 4h 15m,Sell
126420.78,1.22184,19.05.2014 05:55:00,,-2.3,-458.2100000001956,0.0,0.0,1.2217,16.05.2014 21:35:00,10485,-0.21127449920353825,-8.74,IS,0.41,0.0,Phase3-EA-SA2v2-EURCHF-M5-43,EURCHFMT4,5336,2d 8h 20m,Sell
126488.38,170617,19.05.2014 08:55:00,,0.0,-390.61000000018976,0.0,0.0,170915,19.05.2014 03:30:00,10486,-0.18010504383121045,67.6,IS,0.23,0.0,Phase3-EA-S4v1-GBPJPY-M5-194,GBPJPYMT4,2432,5h 25m,Sell
126497.54,1.22176,19.05.2014 10:00:00,,0.0,-381.45000000018626,0.0,0.0,1222,19.05.2014 01:15:00,10487,-0.1758814904109352,9.16,IS,0.34,0.0,Phase3-EA-S4v1-EURCHF-M15-221,EURCHFMT4,2766,8h 45m,Sell
126452.1,1.68397,19.05.2014 14:59:57,sl 1.68397,-3.44,-426.8900000001886,0.0,0.0,1.68097,14.05.2014 12:00:00,10488,-0.1968332663298483,-45.44,IS,0.14,0.0,Phase3-EA-B1v1-GBPUSD-M30-14,GBPUSDMT4,690,5d 2h 59m,Sell
126439.55,0.89203,20.05.2014 03:15:00,,-3.45,-439.44000000017695,0.0,0.0,0.89189,19.05.2014 23:00:00,10489,-0.20261990338491218,-12.55,IS,0.58,0.0,Phase3-EA-SA2v2-USDCHF-M15-107,USDCHFMT4,2012,4h 15m,Sell
126452.24,1.22299,20.05.2014 04:40:00,,-1.1,-426.7500000001746,0.0,0.0,1.22269,19.05.2014 20:20:00,10490,-0.1967687142033311,12.69,IS,0.41,0.0,Phase3-EA-SA2v2-EURCHF-M5-43,EURCHFMT4,5338,8h 20m,Buy
126394.86,101399,20.05.2014 09:15:00,,-1.2,-484.1300000001793,0.0,0.0,101188,19.05.2014 17:30:00,10491,-0.22322586434037492,-57.38,IS,0.27,0.0,Phase3-EA-S1v2-USDJPY-M15-0,USDJPYMT4,3020,15h 45m,Sell
126384.58,1.22333,20.05.2014 10:00:00,,0.0,-494.4100000001781,0.0,0.0,1.22306,20.05.2014 01:15:00,10492,-0.22796583477273388,-10.28,IS,0.34,0.0,Phase3-EA-S4v1-EURCHF-M15-221,EURCHFMT4,2768,8h 45m,Sell
126385.04,1.22192,21.05.2014 05:35:00,,-2.3,-493.95000000018626,0.0,0.0,1.22198,20.05.2014 21:15:00,10493,-0.22775373492848808,0.46,IS,0.41,0.0,Phase3-EA-SA2v2-EURCHF-M5-43,EURCHFMT4,5340,8h 20m,Sell
126325.13,170.09,21.05.2014 09:59:57,sl 170.090,-0.32,-553.8600000001898,0.0,0.0,170.76,20.05.2014 05:00:00,10494,-0.25537743420890385,-59.91,IS,0.09,0.0,Phase3-EA-B1v1-GBPJPY-M30-1,GBPJPYMT4,996,1d 4h 59m,Buy
126254.03,138409,21.05.2014 09:59:58,sl 138.409,-1.73,-624.9600000001956,0.0,0.0,139189,15.05.2014 22:30:00,10495,-0.28816069274399997,-71.1,IS,0.09,0.0,Phase3-EA-TR1v1-EURJPY-M30-91,EURJPYMT4,1840,5d 11h 29m,Buy
126189.56,138382,21.05.2014 09:59:58,sl 138.382,-0.44,-689.4300000001967,0.0,0.0,139102,20.05.2014 01:30:00,10496,-0.31788694700219283,-64.47,IS,0.09,0.0,Phase3-EA-TR1v1-EURJPY-M30-91,EURJPYMT4,1841,1d 8h 29m,Buy
126182.31,1.22158,21.05.2014 12:15:00,,0.0,-696.6800000001967,0.0,0.0,1.22177,21.05.2014 03:30:00,10497,-0.32122982498221286,-7.25,IS,0.34,0.0,Phase3-EA-S4v1-EURCHF-M15-221,EURCHFMT4,2770,8h 45m,Buy
126173.6,101429,22.05.2014 03:00:00,,-2.32,-705.3900000001886,0.0,0.0,101453,21.05.2014 21:15:00,10498,-0.32524588942441257,-8.71,IS,0.27,0.0,Phase3-EA-S1v2-USDJPY-M15-0,USDJPYMT4,3022,5h 45m,Buy
126176.45,0.89333,22.05.2014 03:30:00,,-2.34,-702.5400000001828,0.0,0.0,0.89325,21.05.2014 23:15:00,10499,-0.3239317925632985,2.85,IS,0.58,0.0,Phase3-EA-SA2v2-USDCHF-M15-107,USDCHFMT4,2014,4h 15m,Buy
126201.22,1.22203,22.05.2014 08:50:00,,0.0,-677.7700000001932,0.0,0.0,1.22257,22.05.2014 00:30:00,10500,-0.3125106770370831,24.77,IS,0.41,0.0,Phase3-EA-SA2v2-EURCHF-M5-43,EURCHFMT4,5342,8h 20m,Sell
126173.8,1.22156,22.05.2014 12:30:00,,0.0,-705.190000000206,0.0,0.0,1.22228,22.05.2014 03:45:00,10501,-0.32515367210083385,-27.42,IS,0.34,0.0,Phase3-EA-S4v1-EURCHF-M15-221,EURCHFMT4,2772,8h 45m,Buy
126188.58,0.89466,23.05.2014 03:30:00,,-0.78,-690.4100000002072,0.0,0.0,0.89442,22.05.2014 23:15:00,10502,-0.31833881188777274,14.78,IS,0.58,0.0,Phase3-EA-SA2v2-USDCHF-M15-107,USDCHFMT4,2016,4h 15m,Buy
126187.94,1.22122,23.05.2014 07:25:00,,-1.1,-691.0500000002212,0.0,0.0,1.22121,22.05.2014 23:05:00,10503,-0.31863390732325686,-0.64,IS,0.41,0.0,Phase3-EA-SA2v2-EURCHF-M5-43,EURCHFMT4,5344,8h 20m,Buy
126204.64,1.22088,23.05.2014 14:15:00,,0.0,-674.3500000002095,0.0,0.0,1.22132,23.05.2014 05:30:00,10504,-0.31093376080375695,16.7,IS,0.34,0.0,Phase3-EA-S4v1-EURCHF-M15-221,EURCHFMT4,2774,8h 45m,Sell
126220.27,101936,23.05.2014 19:15:00,,0.0,-658.7200000002049,0.0,0.0,101877,23.05.2014 17:00:00,10505,-0.3037269769654495,15.63,IS,0.27,0.0,Phase3-EA-S1v2-USDJPY-M15-0,USDJPYMT4,3024,2h 15m,Buy
126177.37,0.89637,26.05.2014 03:45:00,,-3.43,-701.6200000001991,0.0,0.0,0.89576,23.05.2014 23:30:00,10506,-0.32350759287480696,-42.9,IS,0.58,0.0,Phase3-EA-SA2v2-USDCHF-M15-107,USDCHFMT4,2018,2d 4h 15m,Sell
126178.1,1.22065,26.05.2014 07:10:00,,-1.1,-700.8900000001886,0.0,0.0,1.22061,23.05.2014 22:50:00,10507,-0.32317099964371043,0.73,IS,0.41,0.0,Phase3-EA-SA2v2-EURCHF-M5-43,EURCHFMT4,5346,2d 8h 20m,Buy
126191.87,171.84,27.05.2014 09:15:00,,0.0,-687.1200000001991,0.0,0.0,171901,27.05.2014 03:50:00,10508,-0.3168218369147668,13.77,IS,0.23,0.0,Phase3-EA-S4v1-GBPJPY-M5-194,GBPJPYMT4,2434,5h 25m,Sell
126173.55,1.22152,27.05.2014 11:15:00,,0.0,-705.440000000206,0.0,0.0,1.22112,27.05.2014 02:55:00,10509,-0.3252689437553173,-18.32,IS,0.41,0.0,Phase3-EA-SA2v2-EURCHF-M5-43,EURCHFMT4,5348,8h 20m,Sell
126171.26,1.22263,28.05.2014 05:20:00,,-2.29,-707.7300000002142,0.0,0.0,1.22263,27.05.2014 21:00:00,10510,-0.3263248321103895,-2.29,IS,0.41,0.0,Phase3-EA-SA2v2-EURCHF-M5-43,EURCHFMT4,5350,8h 20m,Sell
126185.27,1.22286,28.05.2014 11:30:00,,0.0,-693.7200000002049,0.0,0.0,1.22249,28.05.2014 02:45:00,10511,-0.3198650085931326,14.01,IS,0.34,0.0,Phase3-EA-S4v1-EURCHF-M15-221,EURCHFMT4,2776,8h 45m,Buy
126196.81,101761,29.05.2014 01:45:00,,-3.58,-682.1800000001967,0.0,0.0,101818,28.05.2014 21:30:00,10512,-0.31454406902217275,11.54,IS,0.27,0.0,Phase3-EA-S1v2-USDJPY-M15-0,USDJPYMT4,3026,4h 15m,Sell
126194.89,1.22101,29.05.2014 06:50:00,,-3.29,-684.1000000002095,0.0,0.0,1.22098,28.05.2014 22:30:00,10513,-0.31542935532861155,-1.92,IS,0.41,0.0,Phase3-EA-SA2v2-EURCHF-M5-43,EURCHFMT4,5352,8h 20m,Buy
126204.37,1.22087,29.05.2014 13:30:00,,0.0,-674.6200000001991,0.0,0.0,1.22112,29.05.2014 04:45:00,10514,-0.31105825419059424,9.48,IS,0.34,0.0,Phase3-EA-S4v1-EURCHF-M15-221,EURCHFMT4,2778,8h 45m,Sell
126184.27,1.22118,30.05.2014 04:50:00,,-2.28,-694.7200000002049,0.0,0.0,1.22079,29.05.2014 20:30:00,10515,-0.32032609521106636,-20.1,IS,0.41,0.0,Phase3-EA-SA2v2-EURCHF-M5-43,EURCHFMT4,5354,8h 20m,Sell
126163.79,1.22043,30.05.2014 14:30:00,,0.0,-715.2000000002154,0.0,0.0,1.22097,30.05.2014 05:45:00,10516,-0.3297691491463555,-20.48,IS,0.34,0.0,Phase3-EA-S4v1-EURCHF-M15-221,EURCHFMT4,2780,8h 45m,Buy
126119.58,0.89599,02.06.2014 03:15:00,,-3.43,-759.4100000002072,0.0,0.0,0.89536,30.05.2014 23:00:00,10517,-0.3501537885252052,-44.21,IS,0.58,0.0,Phase3-EA-SA2v2-USDCHF-M15-107,USDCHFMT4,2020,2d 4h 15m,Sell
126098.98,1.22083,02.06.2014 07:15:00,,-2.29,-780.010000000213,0.0,0.0,1.22043,30.05.2014 22:55:00,10518,-0.35965217285464424,-20.6,IS,0.41,0.0,Phase3-EA-SA2v2-EURCHF-M5-43,EURCHFMT4,5356,2d 8h 20m,Sell
126114.79,102436,03.06.2014 03:00:00,,0.0,-764.2000000002154,0.0,0.0,102376,03.06.2014 00:15:00,10519,-0.3523623934251119,15.81,IS,0.27,0.0,Phase3-EA-S1v2-USDJPY-M15-0,USDJPYMT4,3028,2h 45m,Buy
126118.9,1.22189,03.06.2014 09:00:00,,0.0,-760.0900000002293,0.0,0.0,1.2218,03.06.2014 00:40:00,10520,-0.35046732742541037,4.11,IS,0.41,0.0,Phase3-EA-SA2v2-EURCHF-M5-43,EURCHFMT4,5358,8h 20m,Buy
126143.87,1.22231,03.06.2014 10:30:00,,0.0,-735.1200000002282,0.0,0.0,1.22165,03.06.2014 01:45:00,10521,-0.33895399457560277,24.97,IS,0.34,0.0,Phase3-EA-S4v1-EURCHF-M15-221,EURCHFMT4,2782,8h 45m,Buy
126095.75,139738,03.06.2014 16:44:58,sl 139.738,-9.93,-783.2400000002235,0.0,0.0,139508,15.05.2014 11:00:00,10522,-0.3611414826305753,-48.12,IS,0.17,0.0,Phase3-EA-T1v2-EURJPY-M15-322,EURJPYMT4,1894,19d 5h 44m,Sell
126024.08,139692,03.06.2014 16:59:58,sl 139.692,-3.1,-854.9100000002363,0.0,0.0,138912,22.05.2014 11:00:00,10523,-0.39418756053789683,-71.67,IS,0.09,0.0,Phase3-EA-TR1v1-EURJPY-M30-91,EURJPYMT4,1844,12d 5h 59m,Sell
126005.13,0.89682,04.06.2014 02:30:00,,-3.43,-873.860000000248,0.0,0.0,0.89658,03.06.2014 22:15:00,10524,-0.4029251519477478,-18.95,IS,0.58,0.0,Phase3-EA-SA2v2-USDCHF-M15-107,USDCHFMT4,2022,4h 15m,Sell
126023.85,1.22188,04.06.2014 09:50:00,,0.0,-855.1400000002468,0.0,0.0,1.22147,04.06.2014 01:30:00,10525,-0.3942936104600265,18.72,IS,0.41,0.0,Phase3-EA-SA2v2-EURCHF-M5-43,EURCHFMT4,5360,8h 20m,Buy
126061.77,1.22066,04.06.2014 13:45:00,,0.0,-817.220000000234,0.0,0.0,1.22166,04.06.2014 05:00:00,10526,-0.37680920590797073,37.92,IS,0.34,0.0,Phase3-EA-S4v1-EURCHF-M15-221,EURCHFMT4,2784,8h 45m,Sell
126021.25,139566,05.06.2014 03:59:58,sl 139.566,-2.43,-857.7400000002235,0.0,0.0,139796,04.06.2014 14:45:00,10527,-0.3954924356666436,-40.52,IS,0.17,0.0,Phase3-EA-T1v2-EURJPY-M15-322,EURJPYMT4,1896,13h 14m,Buy
126005.24,1.21963,05.06.2014 10:05:00,,0.0,-873.7500000002328,0.0,0.0,1.21998,05.06.2014 01:45:00,10528,-0.4028744324197681,-16.01,IS,0.41,0.0,Phase3-EA-SA2v2-EURCHF-M5-43,EURCHFMT4,5362,8h 20m,Buy
126037.88,1.21946,05.06.2014 13:15:00,,0.0,-841.1100000002189,0.0,0.0,1.22032,05.06.2014 04:30:00,10529,-0.3878245652104023,32.64,IS,0.34,0.0,Phase3-EA-S4v1-EURCHF-M15-221,EURCHFMT4,2786,8h 45m,Sell
126053.8,1.21775,06.06.2014 04:20:00,,-1.1,-825.190000000206,0.0,0.0,1.21738,05.06.2014 20:00:00,10530,-0.3804840662528903,15.92,IS,0.41,0.0,Phase3-EA-SA2v2-EURCHF-M5-43,EURCHFMT4,5364,8h 20m,Buy
126071.46,102603,09.06.2014 01:15:00,,-0.76,-807.5300000002026,0.0,0.0,102533,06.06.2014 22:45:00,10531,-0.3723412765801777,17.66,IS,0.27,0.0,Phase3-EA-S1v2-USDJPY-M15-0,USDJPYMT4,3030,2d 2h 30m,Buy
126075.87,1.21906,09.06.2014 05:40:00,,-1.1,-803.1200000001991,0.0,0.0,1.21894,06.06.2014 21:20:00,10532,-0.370307884595088,4.41,IS,0.41,0.0,Phase3-EA-SA2v2-EURCHF-M5-43,EURCHFMT4,5366,2d 8h 20m,Buy
126080.82,1.21898,09.06.2014 10:30:00,,0.0,-798.1700000001874,0.0,0.0,1.21911,09.06.2014 01:45:00,10533,-0.3680255058363103,4.95,IS,0.34,0.0,Phase3-EA-S4v1-EURCHF-M15-221,EURCHFMT4,2788,8h 45m,Sell
126117.72,172105,10.06.2014 05:00:00,,-1.3,-761.2700000001932,0.0,0.0,172275,09.06.2014 23:35:00,10534,-0.3510114096345556,36.9,IS,0.23,0.0,Phase3-EA-S4v1-GBPJPY-M5-194,GBPJPYMT4,2436,5h 25m,Sell
126110.22,1.21927,10.06.2014 07:00:00,,-1.1,-768.7700000001932,0.0,0.0,1.21941,09.06.2014 22:40:00,10535,-0.35446955926905915,-7.5,IS,0.41,0.0,Phase3-EA-SA2v2-EURCHF-M5-43,EURCHFMT4,5368,8h 20m,Buy
126106.4,1.21794,11.06.2014 06:20:00,,-1.09,-772.5900000002002,0.0,0.0,1218,10.06.2014 22:00:00,10536,-0.35623091014956954,-3.82,IS,0.41,0.0,Phase3-EA-SA2v2-EURCHF-M5-43,EURCHFMT4,5370,8h 20m,Buy
126039.18,138315,11.06.2014 06:29:58,sl 138.315,-3.87,-839.8100000002014,0.0,0.0,139035,02.06.2014 07:00:00,10537,-0.3872251526070803,-67.22,IS,0.09,0.0,Phase3-EA-TR1v1-EURJPY-M30-91,EURJPYMT4,1845,8d 23h 29m,Buy
126022.76,171339,11.06.2014 07:35:00,,0.0,-856.2300000002142,0.0,0.0,171412,11.06.2014 02:10:00,10538,-0.39479619487355927,-16.42,IS,0.23,0.0,Phase3-EA-S4v1-GBPJPY-M5-194,GBPJPYMT4,2438,5h 25m,Buy
126025.4,0.89967,12.06.2014 02:30:00,,-10.25,-853.5900000002002,0.0,0.0,0.89987,11.06.2014 22:15:00,10539,-0.3935789262022076,2.64,IS,0.58,0.0,Phase3-EA-SA2v2-USDCHF-M15-107,USDCHFMT4,2024,4h 15m,Sell
125998.97,1218,12.06.2014 04:35:00,,-6.83,-880.0200000001932,0.0,0.0,1.21757,11.06.2014 20:15:00,10540,-0.4057654455141948,-26.43,IS,0.41,0.0,Phase3-EA-SA2v2-EURCHF-M5-43,EURCHFMT4,5372,8h 20m,Sell
125957.74,171486,12.06.2014 08:45:00,,0.0,-921.2500000002037,0.0,0.0,171303,12.06.2014 03:20:00,10541,-0.42477604677161035,-41.23,IS,0.23,0.0,Phase3-EA-S4v1-GBPJPY-M5-194,GBPJPYMT4,2440,5h 25m,Sell
125986.83,1.21726,12.06.2014 14:15:00,,0.0,-892.1600000002072,0.0,0.0,1.21803,12.06.2014 05:30:00,10542,-0.4113630370559176,29.09,IS,0.34,0.0,Phase3-EA-S4v1-EURCHF-M15-221,EURCHFMT4,2790,8h 45m,Sell
125931.06,1.68861,12.06.2014 23:29:57,sl 1.68861,-13.77,-947.9300000001967,0.0,0.0,1.68561,23.05.2014 04:00:00,10543,-0.437077837738081,-55.77,IS,0.14,0.0,Phase3-EA-B1v1-GBPUSD-M30-14,GBPUSDMT4,692,20d 19h 29m,Sell
125748.85,172462,13.06.2014 02:59:58,sl 172.462,-1.31,-1130.1400000001886,0.0,0.0,171662,12.06.2014 23:15:00,10544,-0.5210924303917955,-182.21,IS,0.23,0.0,Phase3-EA-S4v1-GBPJPY-M5-194,GBPJPYMT4,2442,3h 44m,Sell
125687.06,172592,13.06.2014 06:59:58,sl 172.592,-2.55,-1191.9300000001967,0.0,0.0,171922,10.06.2014 09:30:00,10545,-0.5495829725139291,-61.79,IS,0.09,0.0,Phase3-EA-B1v1-GBPJPY-M30-1,GBPJPYMT4,998,2d 21h 29m,Sell
125692.53,1.21821,16.06.2014 05:10:00,,-2.28,-1186.4600000001956,0.0,0.0,1.21838,13.06.2014 20:50:00,10546,-0.5470608287138305,5.47,IS,0.41,0.0,Phase3-EA-SA2v2-EURCHF-M5-43,EURCHFMT4,5374,2d 8h 20m,Sell
125739.59,0.8997,16.06.2014 06:30:00,,0.0,-1139.400000000198,0.0,0.0,0.90043,16.06.2014 02:15:00,10547,-0.5253620924738669,47.06,IS,0.58,0.0,Phase3-EA-SA2v2-USDCHF-M15-107,USDCHFMT4,2026,4h 15m,Sell
125766.06,1.21782,16.06.2014 09:45:00,,0.0,-1112.9300000001967,0.0,0.0,1.21852,16.06.2014 01:00:00,10548,-0.5131571296971585,26.47,IS,0.34,0.0,Phase3-EA-S4v1-EURCHF-M15-221,EURCHFMT4,2792,8h 45m,Sell
125762.69,0.89724,17.06.2014 04:00:00,,-0.78,-1116.300000000192,0.0,0.0,0.89728,16.06.2014 23:45:00,10549,-0.5147109915995933,-3.37,IS,0.58,0.0,Phase3-EA-SA2v2-USDCHF-M15-107,USDCHFMT4,2028,4h 15m,Buy
125736.67,1.21832,17.06.2014 05:25:00,,-2.29,-1142.3200000001816,0.0,0.0,1.2178,16.06.2014 21:05:00,10550,-0.526708465398226,-26.02,IS,0.41,0.0,Phase3-EA-SA2v2-EURCHF-M5-43,EURCHFMT4,5376,8h 20m,Sell
125713.59,1.21872,17.06.2014 13:00:00,,0.0,-1165.4000000001688,0.0,0.0,1.21811,17.06.2014 04:15:00,10551,-0.5373503445401323,-23.08,IS,0.34,0.0,Phase3-EA-S4v1-EURCHF-M15-221,EURCHFMT4,2794,8h 45m,Sell
125711.26,138341,17.06.2014 21:30:00,,0.0,-1167.730000000156,0.0,0.0,138355,17.06.2014 11:45:00,10552,-0.5384246763599122,-2.33,IS,0.17,0.0,Phase3-EA-T1v2-EURJPY-M15-322,EURJPYMT4,1898,9h 45m,Buy
125711.55,102.16,18.06.2014 01:45:00,,-0.77,-1167.4400000001478,0.0,0.0,102156,17.06.2014 21:45:00,10553,-0.5382909612407076,0.29,IS,0.27,0.0,Phase3-EA-S1v2-USDJPY-M15-0,USDJPYMT4,3032,4h 0m,Buy
125692.2,0.89907,18.06.2014 04:30:00,,0.0,-1186.7900000001537,0.0,0.0,0.89937,18.06.2014 00:15:00,10554,-0.5472129872977294,-19.35,IS,0.58,0.0,Phase3-EA-SA2v2-USDCHF-M15-107,USDCHFMT4,2030,4h 15m,Buy
125665.57,1.21796,18.06.2014 04:40:00,,-1.09,-1213.4200000001583,0.0,0.0,1.21852,17.06.2014 20:20:00,10555,-0.5594917239333087,-26.63,IS,0.41,0.0,Phase3-EA-SA2v2-EURCHF-M5-43,EURCHFMT4,5378,8h 20m,Buy
125668.97,1.21833,18.06.2014 11:15:00,,0.0,-1210.0200000001641,0.0,0.0,1.21824,18.06.2014 02:30:00,10556,-0.5579240294323365,3.4,IS,0.34,0.0,Phase3-EA-S4v1-EURCHF-M15-221,EURCHFMT4,2796,8h 45m,Buy
125682.3,138464,18.06.2014 21:45:00,,0.0,-1196.690000000177,0.0,0.0,138384,18.06.2014 00:30:00,10557,-0.5517777448152849,13.33,IS,0.17,0.0,Phase3-EA-T1v2-EURJPY-M15-322,EURJPYMT4,1900,21h 15m,Buy
125704.95,0.8964,19.06.2014 04:30:00,,0.0,-1174.0400000001828,0.0,0.0,0.89605,19.06.2014 00:15:00,10558,-0.5413341329190868,22.65,IS,0.58,0.0,Phase3-EA-SA2v2-USDCHF-M15-107,USDCHFMT4,2032,4h 15m,Buy
125666.58,138678,19.06.2014 09:14:58,sl 138.678,0.0,-1212.4100000001781,0.0,0.0,138448,19.06.2014 07:45:00,10559,-0.5590260264492047,-38.37,IS,0.17,0.0,Phase3-EA-T1v2-EURJPY-M15-322,EURJPYMT4,1902,1h 29m,Sell
125681.92,138726,19.06.2014 21:15:00,,0.0,-1197.0700000001816,0.0,0.0,138634,19.06.2014 09:15:00,10560,-0.5519529577301018,15.34,IS,0.17,0.0,Phase3-EA-T1v2-EURJPY-M15-322,EURJPYMT4,1904,12h 0m,Buy
125706.38,0.89397,20.06.2014 02:45:00,,-3.44,-1172.6100000001898,0.0,0.0,0.8944,19.06.2014 22:30:00,10561,-0.5406747790554447,24.46,IS,0.58,0.0,Phase3-EA-SA2v2-USDCHF-M15-107,USDCHFMT4,2034,4h 15m,Sell
125715.56,1.21657,20.06.2014 05:05:00,,-2.29,-1163.4300000001967,0.0,0.0,1.21682,19.06.2014 20:45:00,10562,-0.5364420039028156,9.18,IS,0.41,0.0,Phase3-EA-SA2v2-EURCHF-M5-43,EURCHFMT4,5380,8h 20m,Sell
125732.27,173.64,20.06.2014 08:45:00,,0.0,-1146.720000000205,0.0,0.0,173566,20.06.2014 03:20:00,10563,-0.5287372465171455,16.71,IS,0.23,0.0,Phase3-EA-S4v1-GBPJPY-M5-194,GBPJPYMT4,2444,5h 25m,Buy
125753.92,1.21699,20.06.2014 15:00:00,,0.0,-1125.0700000002107,0.0,0.0,1.21642,20.06.2014 06:15:00,10564,-0.5187547212388813,21.65,IS,0.34,0.0,Phase3-EA-S4v1-EURCHF-M15-221,EURCHFMT4,2798,8h 45m,Buy
125762.34,0.89532,23.06.2014 05:30:00,,0.0,-1116.650000000198,0.0,0.0,0.89519,23.06.2014 01:15:00,10565,-0.5148723719158729,8.42,IS,0.58,0.0,Phase3-EA-SA2v2-USDCHF-M15-107,USDCHFMT4,2036,4h 15m,Buy
125782.51,1.21734,23.06.2014 09:25:00,,0.0,-1096.480000000185,0.0,0.0,1.2169,23.06.2014 01:05:00,10566,-0.5055722548321421,20.17,IS,0.41,0.0,Phase3-EA-SA2v2-EURCHF-M5-43,EURCHFMT4,5382,8h 20m,Buy
125805.31,1.21756,23.06.2014 10:00:00,,0.0,-1073.6800000001967,0.0,0.0,1.21696,23.06.2014 01:15:00,10567,-0.4950594799432568,22.8,IS,0.34,0.0,Phase3-EA-S4v1-EURCHF-M15-221,EURCHFMT4,2800,8h 45m,Buy
125846.9,173389,24.06.2014 05:05:00,,-1.31,-1032.0900000002002,0.0,0.0,173579,23.06.2014 23:40:00,10568,-0.47588288750339147,41.59,IS,0.23,0.0,Phase3-EA-S4v1-GBPJPY-M5-194,GBPJPYMT4,2446,5h 25m,Sell
125788.59,0.8952,24.06.2014 06:15:00,,0.0,-1090.400000000198,0.0,0.0,0.8943,24.06.2014 02:00:00,10569,-0.5027688481951105,-58.31,IS,0.58,0.0,Phase3-EA-SA2v2-USDCHF-M15-107,USDCHFMT4,2038,4h 15m,Sell
125806.73,1.21682,24.06.2014 07:35:00,,-1.1,-1072.260000000184,0.0,0.0,1.2164,23.06.2014 23:15:00,10570,-0.49440473694578485,18.14,IS,0.41,0.0,Phase3-EA-SA2v2-EURCHF-M5-43,EURCHFMT4,5384,8h 20m,Buy
125828.82,1.21602,24.06.2014 12:45:00,,0.0,-1050.1700000001874,0.0,0.0,1.2166,24.06.2014 04:00:00,10571,-0.48421933355562874,22.09,IS,0.34,0.0,Phase3-EA-S4v1-EURCHF-M15-221,EURCHFMT4,2802,8h 45m,Sell
125849.16,138726,24.06.2014 21:30:00,,0.0,-1029.830000000191,0.0,0.0,138604,24.06.2014 09:00:00,10572,-0.4748408317468568,20.34,IS,0.17,0.0,Phase3-EA-T1v2-EURJPY-M15-322,EURJPYMT4,1906,12h 30m,Buy
125853.56,1.21647,25.06.2014 04:50:00,,-1.1,-1025.4300000001967,0.0,0.0,1.21635,24.06.2014 20:30:00,10573,-0.47281205062795073,4.4,IS,0.41,0.0,Phase3-EA-SA2v2-EURCHF-M5-43,EURCHFMT4,5386,8h 20m,Buy
125821.05,172922,25.06.2014 08:25:00,,0.0,-1057.940000000206,0.0,0.0,173066,25.06.2014 03:00:00,10574,-0.487801976576983,-32.51,IS,0.23,0.0,Phase3-EA-S4v1-GBPJPY-M5-194,GBPJPYMT4,2448,5h 25m,Buy
125810.78,1.21662,25.06.2014 14:15:00,,0.0,-1068.2100000001956,0.0,0.0,1.21635,25.06.2014 05:30:00,10575,-0.4925373361431583,-10.27,IS,0.34,0.0,Phase3-EA-S4v1-EURCHF-M15-221,EURCHFMT4,2804,8h 45m,Sell
125772.38,138893,25.06.2014 20:29:58,sl 138.893,0.0,-1106.6100000001898,0.0,0.0,138663,25.06.2014 14:15:00,10576,-0.5102430622718137,-38.4,IS,0.17,0.0,Phase3-EA-T1v2-EURJPY-M15-322,EURJPYMT4,1908,6h 14m,Sell
125745.74,1.21673,26.06.2014 04:40:00,,-6.89,-1133.2500000002037,0.0,0.0,1.2163,25.06.2014 20:20:00,10577,-0.5225264097735767,-26.64,IS,0.41,0.0,Phase3-EA-SA2v2-EURCHF-M5-43,EURCHFMT4,5388,8h 20m,Sell
125758.53,0.89348,27.06.2014 02:30:00,,-3.44,-1120.4600000001956,0.0,0.0,0.89373,26.06.2014 22:15:00,10578,-0.5166291119301996,12.79,IS,0.58,0.0,Phase3-EA-SA2v2-USDCHF-M15-107,USDCHFMT4,2040,4h 15m,Sell
125746.14,1.21635,27.06.2014 04:50:00,,-2.29,-1132.8500000002095,0.0,0.0,1.21613,26.06.2014 20:30:00,10579,-0.5223419751264058,-12.39,IS,0.41,0.0,Phase3-EA-SA2v2-EURCHF-M5-43,EURCHFMT4,5390,8h 20m,Sell
125747.66,1.21606,27.06.2014 15:15:00,,0.0,-1131.33000000022,0.0,0.0,1.21602,27.06.2014 06:30:00,10580,-0.5216411234671513,1.52,IS,0.34,0.0,Phase3-EA-S4v1-EURCHF-M15-221,EURCHFMT4,2806,8h 45m,Buy
125683.74,172474,27.06.2014 17:29:57,sl 172.474,-4.46,-1195.2500000002328,0.0,0.0,173144,13.06.2014 16:00:00,10581,-0.5511137800854858,-63.92,IS,0.09,0.0,Phase3-EA-B1v1-GBPJPY-M30-1,GBPJPYMT4,1000,14d 1h 29m,Buy
125758.72,172477,30.06.2014 04:45:00,,-1.32,-1120.2700000002224,0.0,0.0,172813,27.06.2014 23:20:00,10582,-0.5165415054728045,74.98,IS,0.23,0.0,Phase3-EA-S4v1-GBPJPY-M5-194,GBPJPYMT4,2450,2d 5h 25m,Sell
125754.81,0.89079,30.06.2014 05:30:00,,0.0,-1124.1800000002258,0.0,0.0,0.89085,30.06.2014 01:15:00,10583,-0.5183443541489272,-3.91,IS,0.58,0.0,Phase3-EA-SA2v2-USDCHF-M15-107,USDCHFMT4,2042,4h 15m,Buy
125763.09,1.21569,30.06.2014 06:15:00,,-2.3,-1115.900000000227,0.0,0.0,1.21592,27.06.2014 21:55:00,10584,-0.5145265569524359,8.28,IS,0.41,0.0,Phase3-EA-SA2v2-EURCHF-M5-43,EURCHFMT4,5392,2d 8h 20m,Sell
126019.19,1.71014,30.06.2014 18:29:58,tp 1.71014,-8.5,-859.8000000002212,0.0,0.0,1.69124,12.06.2014 23:30:00,10585,-0.39644227409958616,256.1,IS,0.14,0.0,Phase3-EA-B1v1-GBPUSD-M30-14,GBPUSDMT4,694,17d 18h 59m,Buy
125978.87,138896,01.07.2014 03:59:58,sl 138.896,-1.76,-900.1200000002282,0.0,0.0,138666,26.06.2014 11:00:00,10586,-0.41503328653468036,-40.32,IS,0.17,0.0,Phase3-EA-T1v2-EURJPY-M15-322,EURJPYMT4,1910,4d 16h 59m,Sell
125990.43,1.21429,01.07.2014 05:20:00,,-2.31,-888.5600000002305,0.0,0.0,1.21459,30.06.2014 21:00:00,10587,-0.40970312523136665,11.56,IS,0.41,0.0,Phase3-EA-SA2v2-EURCHF-M5-43,EURCHFMT4,5394,8h 20m,Sell
125962.32,173501,01.07.2014 08:50:00,,0.0,-916.6700000002165,0.0,0.0,173377,01.07.2014 03:25:00,10588,-0.42266427006147944,-28.11,IS,0.23,0.0,Phase3-EA-S4v1-GBPJPY-M5-194,GBPJPYMT4,2452,5h 25m,Sell
125892.29,139016,01.07.2014 11:29:57,sl 139.016,-6.2,-986.7000000002154,0.0,0.0,138296,11.06.2014 06:30:00,10589,-0.4549541659153831,-70.03,IS,0.09,0.0,Phase3-EA-TR1v1-EURJPY-M30-91,EURJPYMT4,1848,20d 4h 59m,Sell
125900.16,138872,01.07.2014 18:30:00,,0.0,-978.83000000022,0.0,0.0,138825,01.07.2014 10:15:00,10590,-0.45132541423224626,7.87,IS,0.17,0.0,Phase3-EA-T1v2-EURJPY-M15-322,EURJPYMT4,1912,8h 15m,Buy
125866.91,1.21423,02.07.2014 05:45:00,,-2.31,-1012.08000000022,0.0,0.0,1.21356,01.07.2014 21:25:00,10591,-0.4666565442785452,-33.25,IS,0.41,0.0,Phase3-EA-SA2v2-EURCHF-M5-43,EURCHFMT4,5396,8h 20m,Sell
125855.03,138871,02.07.2014 09:30:00,,0.0,-1023.9600000002247,0.0,0.0,138942,02.07.2014 02:30:00,10592,-0.47213425329960096,-11.88,IS,0.17,0.0,Phase3-EA-T1v2-EURJPY-M15-322,EURJPYMT4,1914,7h 0m,Buy
125855.03,1.21406,02.07.2014 12:00:00,,0.0,-1023.9600000002247,0.0,0.0,1.21406,02.07.2014 03:15:00,10593,-0.47213425329960096,0.0,IS,0.34,0.0,Phase3-EA-S4v1-EURCHF-M15-221,EURCHFMT4,2808,8h 45m,Sell
125888.94,0.88937,03.07.2014 04:30:00,,0.0,-990.0500000002212,0.0,0.0,0.88885,03.07.2014 00:15:00,10594,-0.45649880608546406,33.91,IS,0.58,0.0,Phase3-EA-SA2v2-USDCHF-M15-107,USDCHFMT4,2044,4h 15m,Buy
125872.34,1.21414,03.07.2014 05:10:00,,-6.92,-1006.650000000227,0.0,0.0,1.21393,02.07.2014 20:50:00,10595,-0.46415284394316786,-16.6,IS,0.41,0.0,Phase3-EA-SA2v2-EURCHF-M5-43,EURCHFMT4,5398,8h 20m,Sell
125867.15,174777,03.07.2014 08:20:00,,0.0,-1011.8400000002293,0.0,0.0,174754,03.07.2014 02:55:00,10596,-0.4665458834902454,-5.19,IS,0.23,0.0,Phase3-EA-S4v1-GBPJPY-M5-194,GBPJPYMT4,2454,5h 25m,Sell
126028.51,175142,03.07.2014 16:29:58,tp 175.142,-1.6,-850.4800000002433,0.0,0.0,173292,30.06.2014 21:30:00,10597,-0.3921449468204533,161.36,IS,0.09,0.0,Phase3-EA-B1v1-GBPJPY-M30-1,GBPJPYMT4,1002,2d 18h 59m,Buy
126029.57,102184,03.07.2014 23:15:00,,0.0,-849.4200000002456,0.0,0.0,102.19,03.07.2014 22:00:00,10598,-0.3916561950054446,1.06,IS,0.27,0.0,Phase3-EA-S1v2-USDJPY-M15-0,USDJPYMT4,3034,1h 15m,Buy
126035.14,102214,04.07.2014 00:15:00,,-0.77,-843.8500000002387,0.0,0.0,102188,03.07.2014 22:00:00,10599,-0.38908794254355006,5.57,IS,0.27,0.0,Phase3-EA-S1v2-USDJPY-M15-0,USDJPYMT4,3035,2h 15m,Sell
126028.27,1.21593,04.07.2014 11:10:00,,0.0,-850.720000000234,0.0,0.0,1.21578,04.07.2014 02:50:00,10600,-0.3922556076087531,-6.87,IS,0.41,0.0,Phase3-EA-SA2v2-EURCHF-M5-43,EURCHFMT4,5400,8h 20m,Sell
126038.53,1.21586,04.07.2014 14:30:00,,0.0,-840.4600000002247,0.0,0.0,1.21559,04.07.2014 05:45:00,10601,-0.387524858908748,10.26,IS,0.34,0.0,Phase3-EA-S4v1-EURCHF-M15-221,EURCHFMT4,2810,8h 45m,Buy
126085.82,0.89525,07.07.2014 05:30:00,,0.0,-793.1700000002165,0.0,0.0,0.89452,07.07.2014 01:15:00,10602,-0.3657200727466547,47.29,IS,0.58,0.0,Phase3-EA-SA2v2-USDCHF-M15-107,USDCHFMT4,2046,4h 15m,Buy
126086.28,1.21599,07.07.2014 10:35:00,,0.0,-792.7100000002247,0.0,0.0,1216,07.07.2014 02:15:00,10603,-0.3655079729024089,0.46,IS,0.41,0.0,Phase3-EA-SA2v2-EURCHF-M5-43,EURCHFMT4,5402,8h 20m,Sell
126108.71,1.21571,07.07.2014 14:15:00,,0.0,-770.2800000002317,0.0,0.0,1.2163,07.07.2014 05:30:00,10604,-0.3551658000621569,22.43,IS,0.34,0.0,Phase3-EA-S4v1-EURCHF-M15-221,EURCHFMT4,2812,8h 45m,Sell
126119.75,0.8932,08.07.2014 04:30:00,,0.0,-759.2400000002235,0.0,0.0,0.89337,08.07.2014 00:15:00,10605,-0.35007540380016394,11.04,IS,0.58,0.0,Phase3-EA-SA2v2-USDCHF-M15-107,USDCHFMT4,2048,4h 15m,Sell
126119.75,101.54,08.07.2014 22:45:00,,0.0,-759.2400000002235,0.0,0.0,101.54,08.07.2014 22:15:00,10606,-0.35007540380016394,0.0,IS,0.27,0.0,Phase3-EA-S1v2-USDJPY-M15-0,USDJPYMT4,3038,30m 0s,Sell
126118.55,101538,09.07.2014 01:30:00,,-1.2,-760.4400000002352,0.0,0.0,101538,08.07.2014 22:45:00,10607,-0.3506287077416899,-1.2,IS,0.27,0.0,Phase3-EA-S1v2-USDJPY-M15-0,USDJPYMT4,3040,2h 45m,Sell
126105.23,1.21558,09.07.2014 05:10:00,,-2.3,-773.7600000002421,0.0,0.0,1.21534,08.07.2014 20:50:00,10608,-0.3567703814925714,-13.32,IS,0.41,0.0,Phase3-EA-SA2v2-EURCHF-M5-43,EURCHFMT4,5404,8h 20m,Sell
126062.7,1.71023,09.07.2014 15:29:58,sl 1.71023,-0.53,-816.290000000241,0.0,0.0,1.71323,08.07.2014 23:00:00,10609,-0.3763803953532955,-42.53,IS,0.14,0.0,Phase3-EA-B1v1-GBPUSD-M30-14,GBPUSDMT4,696,16h 29m,Buy
126076.98,1.21534,10.07.2014 04:40:00,,-6.9,-802.0100000002421,0.0,0.0,1.2158,09.07.2014 20:20:00,10610,-0.3697960784492013,14.28,IS,0.41,0.0,Phase3-EA-SA2v2-EURCHF-M5-43,EURCHFMT4,5406,8h 20m,Sell
126046.85,174149,10.07.2014 07:45:00,,0.0,-832.1400000002468,0.0,0.0,174282,10.07.2014 02:20:00,10611,-0.38368861824754896,-30.13,IS,0.23,0.0,Phase3-EA-S4v1-GBPJPY-M5-194,GBPJPYMT4,2456,5h 25m,Buy
126089.13,1.21429,10.07.2014 15:15:00,,0.0,-789.860000000248,0.0,0.0,1.2154,10.07.2014 06:30:00,10612,-0.3641938760413083,42.28,IS,0.34,0.0,Phase3-EA-S4v1-EURCHF-M15-221,EURCHFMT4,2814,8h 45m,Sell
126200.29,137653,10.07.2014 15:59:58,tp 137.653,-3.41,-678.7000000002445,0.0,0.0,138943,01.07.2014 15:00:00,10613,-0.3129394875917851,111.16,IS,0.09,0.0,Phase3-EA-TR1v1-EURJPY-M30-91,EURJPYMT4,1850,9d 0h 59m,Sell
126201.22,101275,11.07.2014 01:30:00,,-1.2,-677.7700000002515,0.0,0.0,101283,10.07.2014 18:00:00,10614,-0.3125106770371099,0.93,IS,0.27,0.0,Phase3-EA-S1v2-USDJPY-M15-0,USDJPYMT4,3042,7h 30m,Sell
126190.2,1.21452,11.07.2014 05:55:00,,-2.3,-688.790000000241,0.0,0.0,1.21433,10.07.2014 21:35:00,10615,-0.3175918515667356,-11.02,IS,0.41,0.0,Phase3-EA-SA2v2-EURCHF-M5-43,EURCHFMT4,5408,8h 20m,Sell
126176.56,0.89275,11.07.2014 06:15:00,,0.0,-702.430000000255,0.0,0.0,0.89254,11.07.2014 02:00:00,10616,-0.32388107303535907,-13.64,IS,0.58,0.0,Phase3-EA-SA2v2-USDCHF-M15-107,USDCHFMT4,2050,4h 15m,Sell
126184.28,173502,11.07.2014 07:00:00,,0.0,-694.7100000002538,0.0,0.0,173468,11.07.2014 01:35:00,10617,-0.3203214843449096,7.72,IS,0.23,0.0,Phase3-EA-S4v1-GBPJPY-M5-194,GBPJPYMT4,2458,5h 25m,Buy
126195.71,1.21409,11.07.2014 10:15:00,,0.0,-683.2800000002608,0.0,0.0,1.21439,11.07.2014 01:30:00,10618,-0.3150512643019294,11.43,IS,0.34,0.0,Phase3-EA-S4v1-EURCHF-M15-221,EURCHFMT4,2816,8h 45m,Sell
126230.67,0.89262,14.07.2014 03:30:00,,-0.78,-648.3200000002689,0.0,0.0,0.89207,11.07.2014 23:15:00,10619,-0.29893167613896743,34.96,IS,0.58,0.0,Phase3-EA-SA2v2-USDCHF-M15-107,USDCHFMT4,2052,2d 4h 15m,Buy
126265.1,1.21458,14.07.2014 09:25:00,,0.0,-613.8900000002759,0.0,0.0,1.21383,14.07.2014 01:05:00,10620,-0.2830564638835098,34.43,IS,0.41,0.0,Phase3-EA-SA2v2-EURCHF-M5-43,EURCHFMT4,5410,8h 20m,Buy
126287.58,1.21449,14.07.2014 10:00:00,,0.0,-591.4100000002654,0.0,0.0,1.2139,14.07.2014 01:15:00,10621,-0.27269123671235307,22.48,IS,0.34,0.0,Phase3-EA-S4v1-EURCHF-M15-221,EURCHFMT4,2818,8h 45m,Buy
126276.39,0.89172,15.07.2014 02:45:00,,-0.78,-602.6000000002678,0.0,0.0,0.89188,14.07.2014 22:30:00,10622,-0.2778507959670334,-11.19,IS,0.58,0.0,Phase3-EA-SA2v2-USDCHF-M15-107,USDCHFMT4,2054,4h 15m,Buy
126278.51,1.21473,15.07.2014 06:20:00,,-1.1,-600.4800000002724,0.0,0.0,1.21466,14.07.2014 22:00:00,10623,-0.2768732923370159,2.12,IS,0.41,0.0,Phase3-EA-SA2v2-EURCHF-M5-43,EURCHFMT4,5412,8h 20m,Buy
126273.98,173516,15.07.2014 06:45:00,,0.0,-605.0100000002712,0.0,0.0,173496,15.07.2014 01:20:00,10624,-0.2789620147162555,-4.53,IS,0.23,0.0,Phase3-EA-S4v1-GBPJPY-M5-194,GBPJPYMT4,2460,5h 25m,Sell
126281.75,0.89581,16.07.2014 04:30:00,,0.0,-597.2400000002817,0.0,0.0,0.89569,16.07.2014 00:15:00,10625,-0.27537937169491467,7.77,IS,0.58,0.0,Phase3-EA-SA2v2-USDCHF-M15-107,USDCHFMT4,2056,4h 15m,Buy
126272.41,1.21527,16.07.2014 08:15:00,,-1.1,-606.5800000002782,0.0,0.0,1.21545,15.07.2014 23:55:00,10626,-0.2796859207064148,-9.34,IS,0.41,0.0,Phase3-EA-SA2v2-EURCHF-M5-43,EURCHFMT4,5414,8h 20m,Buy
126239.72,0.89797,17.07.2014 03:30:00,,-2.33,-639.2700000002806,0.0,0.0,0.89844,16.07.2014 23:15:00,10627,-0.29475884224667187,-32.69,IS,0.58,0.0,Phase3-EA-SA2v2-USDCHF-M15-107,USDCHFMT4,2058,4h 15m,Buy
126210.86,1.2148,17.07.2014 04:20:00,,-3.29,-668.1300000002666,0.0,0.0,1.21536,16.07.2014 20:00:00,10628,-0.308065802040235,-28.86,IS,0.41,0.0,Phase3-EA-SA2v2-EURCHF-M5-43,EURCHFMT4,5416,8h 20m,Buy
126317.26,137318,17.07.2014 07:29:58,tp 137.318,-5.27,-561.7300000002724,0.0,0.0,138578,02.07.2014 12:30:00,10629,-0.259006185892081,106.4,IS,0.09,0.0,Phase3-EA-TR1v1-EURJPY-M30-91,EURJPYMT4,1851,14d 18h 59m,Sell
126305.52,1.21454,17.07.2014 11:00:00,,0.0,-573.4700000002631,0.0,0.0,1.21485,17.07.2014 02:15:00,10630,-0.26441934278661955,-11.74,IS,0.34,0.0,Phase3-EA-S4v1-EURCHF-M15-221,EURCHFMT4,2820,8h 45m,Buy
126583.33,137.04,17.07.2014 18:29:57,tp 137.040,-7.05,-295.6600000002654,0.0,0.0,138.74,07.07.2014 07:15:00,10631,-0.1363248694584307,277.81,IS,0.17,0.0,Phase3-EA-T1v2-EURJPY-M15-322,EURJPYMT4,1916,10d 11h 14m,Sell
126587.26,1.21401,18.07.2014 07:00:00,,-1.1,-291.7300000002724,0.0,0.0,1.2139,17.07.2014 22:40:00,10632,-0.13451279904995408,3.93,IS,0.41,0.0,Phase3-EA-SA2v2-EURCHF-M5-43,EURCHFMT4,5418,8h 20m,Buy
126606.2,1.21426,18.07.2014 11:15:00,,0.0,-272.7900000002701,0.0,0.0,1.21376,18.07.2014 02:30:00,10633,-0.12577981850628678,18.94,IS,0.34,0.0,Phase3-EA-S4v1-EURCHF-M15-221,EURCHFMT4,2822,8h 45m,Buy
126564.2,1.70794,18.07.2014 15:29:58,sl 1.70794,0.0,-314.7900000002701,0.0,0.0,1.71094,18.07.2014 09:30:00,10634,-0.14514545645950652,-42.0,IS,0.14,0.0,Phase3-EA-B1v1-GBPUSD-M30-14,GBPUSDMT4,698,5h 59m,Buy
126553.81,137052,21.07.2014 06:15:00,,-0.82,-325.18000000028405,0.0,0.0,137109,18.07.2014 21:00:00,10635,-0.14993614641984518,-10.39,IS,0.17,0.0,Phase3-EA-T1v2-EURJPY-M15-322,EURJPYMT4,1918,2d 9h 15m,Buy
126561.08,173125,21.07.2014 06:30:00,,0.0,-317.91000000029453,0.0,0.0,173093,21.07.2014 01:05:00,10636,-0.14658404670747124,7.27,IS,0.23,0.0,Phase3-EA-S4v1-GBPJPY-M5-194,GBPJPYMT4,2462,5h 25m,Buy
126542.36,1.21526,21.07.2014 07:20:00,,-2.28,-336.6300000002957,0.0,0.0,1.2149,18.07.2014 23:00:00,10637,-0.15521558819519257,-18.72,IS,0.41,0.0,Phase3-EA-SA2v2-EURCHF-M5-43,EURCHFMT4,5420,2d 8h 20m,Sell
126568.19,0.89824,22.07.2014 04:30:00,,0.0,-310.8000000003085,0.0,0.0,0.89784,22.07.2014 00:15:00,10638,-0.14330572085396834,25.83,IS,0.58,0.0,Phase3-EA-SA2v2-USDCHF-M15-107,USDCHFMT4,2060,4h 15m,Buy
126551.3,1.21477,22.07.2014 05:35:00,,-2.28,-327.69000000032247,0.0,0.0,1.21445,21.07.2014 21:15:00,10639,-0.15109347383087673,-16.89,IS,0.41,0.0,Phase3-EA-SA2v2-EURCHF-M5-43,EURCHFMT4,5422,8h 20m,Sell
126536.59,1.21513,22.07.2014 13:45:00,,0.0,-342.4000000003143,0.0,0.0,1.21474,22.07.2014 05:00:00,10640,-0.15787605798067922,-14.71,IS,0.34,0.0,Phase3-EA-S4v1-EURCHF-M15-221,EURCHFMT4,2824,8h 45m,Sell
126530.23,1.21489,23.07.2014 08:25:00,,0.0,-348.76000000030035,0.0,0.0,1.21503,23.07.2014 00:05:00,10641,-0.16080856887073178,-6.36,IS,0.41,0.0,Phase3-EA-SA2v2-EURCHF-M5-43,EURCHFMT4,5424,8h 20m,Buy
126488.23,1.70414,23.07.2014 12:29:58,sl 1.70414,0.0,-390.76000000030035,0.0,0.0,1.70714,23.07.2014 06:00:00,10642,-0.18017420682395152,-42.0,IS,0.14,0.0,Phase3-EA-B1v1-GBPUSD-M30-14,GBPUSDMT4,700,6h 29m,Buy
126449.71,136.75,23.07.2014 18:14:58,sl 136.750,0.0,-429.2800000002899,0.0,0.0,136.52,23.07.2014 04:45:00,10643,-0.1979352633467568,-38.52,IS,0.17,0.0,Phase3-EA-T1v2-EURJPY-M15-322,EURJPYMT4,1920,13h 29m,Sell
126463.2,0.90265,24.07.2014 04:30:00,,0.0,-415.7900000002992,0.0,0.0,0.90244,24.07.2014 00:15:00,10644,-0.19171520487083407,13.49,IS,0.58,0.0,Phase3-EA-SA2v2-USDCHF-M15-107,USDCHFMT4,2062,4h 15m,Buy
126466.29,1.21484,24.07.2014 04:45:00,,-3.27,-412.7000000003027,0.0,0.0,1.2147,23.07.2014 20:25:00,10645,-0.19029044722142024,3.09,IS,0.41,0.0,Phase3-EA-SA2v2-EURCHF-M5-43,EURCHFMT4,5426,8h 20m,Buy
126490.36,137029,25.07.2014 01:15:00,,-0.82,-388.6300000002957,0.0,0.0,136.88,24.07.2014 11:45:00,10646,-0.17919209232775035,24.07,IS,0.17,0.0,Phase3-EA-T1v2-EURJPY-M15-322,EURJPYMT4,1922,13h 30m,Buy
126489.72,1.21527,25.07.2014 05:30:00,,-1.09,-389.27000000030966,0.0,0.0,1.21526,24.07.2014 21:10:00,10647,-0.17948718776323444,-0.64,IS,0.41,0.0,Phase3-EA-SA2v2-EURCHF-M5-43,EURCHFMT4,5428,8h 20m,Buy
126508.75,172788,28.07.2014 04:25:00,,-1.31,-370.24000000031083,0.0,0.0,172878,25.07.2014 23:00:00,10648,-0.1707127094239547,19.03,IS,0.23,0.0,Phase3-EA-S4v1-GBPJPY-M5-194,GBPJPYMT4,2464,2d 5h 25m,Sell
126533.03,1.21536,28.07.2014 04:45:00,,-1.09,-345.960000000312,0.0,0.0,1.2148,25.07.2014 20:25:00,10649,-0.1595175263405225,24.28,IS,0.41,0.0,Phase3-EA-SA2v2-EURCHF-M5-43,EURCHFMT4,5430,2d 8h 20m,Buy
126545.21,0.90482,28.07.2014 05:30:00,,0.0,-333.780000000319,0.0,0.0,0.90463,28.07.2014 01:15:00,10650,-0.15390149133409198,12.18,IS,0.58,0.0,Phase3-EA-SA2v2-USDCHF-M15-107,USDCHFMT4,2064,4h 15m,Buy
126554.27,1.2149,29.07.2014 08:25:00,,0.0,-324.7200000003213,0.0,0.0,1.2147,29.07.2014 00:05:00,10651,-0.1497240465756128,9.06,IS,0.41,0.0,Phase3-EA-SA2v2-EURCHF-M5-43,EURCHFMT4,5432,8h 20m,Buy
126511.74,1.6956,29.07.2014 13:29:58,sl 1.69560,-0.53,-367.25000000032014,0.0,0.0,1.6986,28.07.2014 13:00:00,10652,-0.16933406043633692,-42.53,IS,0.14,0.0,Phase3-EA-B1v1-GBPUSD-M30-14,GBPUSDMT4,702,1d 0h 29m,Buy
126512.75,136859,29.07.2014 17:00:00,,-0.82,-366.24000000031083,0.0,0.0,136848,28.07.2014 19:15:00,10653,-0.1688683629522195,1.01,IS,0.17,0.0,Phase3-EA-T1v2-EURJPY-M15-322,EURJPYMT4,1924,21h 45m,Buy
126504.26,136906,30.07.2014 10:30:00,,0.0,-374.7300000003015,0.0,0.0,136957,30.07.2014 05:15:00,10654,-0.1727829883384732,-8.49,IS,0.17,0.0,Phase3-EA-T1v2-EURJPY-M15-322,EURJPYMT4,1926,5h 15m,Buy
126503.89,1.21615,30.07.2014 13:15:00,,0.0,-375.10000000029686,0.0,0.0,1.21614,30.07.2014 04:30:00,10655,-0.17295359038710653,-0.37,IS,0.34,0.0,Phase3-EA-S4v1-EURCHF-M15-221,EURCHFMT4,2826,8h 45m,Sell
126553.44,1.21638,30.07.2014 20:59:59,tp 1.21638,0.0,-325.5500000003085,0.0,0.0,1.21748,30.07.2014 20:00:00,10656,-0.15010674846849195,49.55,IS,0.41,0.0,Phase3-EA-SA2v2-EURCHF-M5-43,EURCHFMT4,5434,59m 59s,Sell
126541.95,0.90835,31.07.2014 04:30:00,,0.0,-337.0400000002992,0.0,0.0,0.90853,31.07.2014 00:15:00,10657,-0.15540463370854707,-11.49,IS,0.58,0.0,Phase3-EA-SA2v2-USDCHF-M15-107,USDCHFMT4,2066,4h 15m,Buy
126530.58,1.21707,31.07.2014 05:25:00,,-3.25,-348.41000000029453,0.0,0.0,1.21725,30.07.2014 21:05:00,10658,-0.16064718855445226,-11.37,IS,0.41,0.0,Phase3-EA-SA2v2-EURCHF-M5-43,EURCHFMT4,5436,8h 20m,Buy
126535.64,102815,31.07.2014 09:30:00,,-2.29,-343.35000000029686,0.0,0.0,102787,30.07.2014 21:30:00,10659,-0.1583140902677083,5.06,IS,0.27,0.0,Phase3-EA-S1v2-USDJPY-M15-0,USDJPYMT4,3044,12h 0m,Buy
126513.5,137652,31.07.2014 15:15:00,,0.0,-365.49000000031083,0.0,0.0,137786,31.07.2014 10:45:00,10660,-0.16852254798876912,-22.14,IS,0.17,0.0,Phase3-EA-T1v2-EURJPY-M15-322,EURJPYMT4,1928,4h 30m,Buy
126497.48,137633,01.08.2014 02:00:00,,-0.81,-381.51000000030035,0.0,0.0,137725,31.07.2014 16:00:00,10661,-0.17590915560806383,-16.02,IS,0.17,0.0,Phase3-EA-T1v2-EURJPY-M15-322,EURJPYMT4,1930,10h 0m,Buy
126506.41,0.90886,01.08.2014 04:30:00,,0.0,-372.58000000030734,0.0,0.0,0.90872,01.08.2014 00:15:00,10662,-0.17179165210991817,8.93,IS,0.58,0.0,Phase3-EA-SA2v2-USDCHF-M15-107,USDCHFMT4,2068,4h 15m,Buy
126510.02,1.21678,01.08.2014 06:25:00,,-2.26,-368.9700000003213,0.0,0.0,1.21691,31.07.2014 22:05:00,10663,-0.1701271294191836,3.61,IS,0.41,0.0,Phase3-EA-SA2v2-EURCHF-M5-43,EURCHFMT4,5438,8h 20m,Sell
126659.2,172476,01.08.2014 18:29:58,tp 172.476,-13.34,-219.7900000003283,0.0,0.0,174326,08.07.2014 03:30:00,10664,-0.10134222775582202,149.18,IS,0.09,0.0,Phase3-EA-B1v1-GBPJPY-M30-1,GBPJPYMT4,1004,24d 14h 59m,Sell
126676.99,102503,04.08.2014 03:15:00,,-1.18,-202.00000000032014,0.0,0.0,102575,01.08.2014 22:15:00,10665,-0.0931394968227759,17.79,IS,0.27,0.0,Phase3-EA-S1v2-USDJPY-M15-0,USDJPYMT4,3046,2d 5h 0m,Sell
126657.09,1.21646,04.08.2014 04:55:00,,-2.26,-221.90000000031432,0.0,0.0,1.21607,01.08.2014 20:35:00,10666,-0.10231512051965591,-19.9,IS,0.41,0.0,Phase3-EA-SA2v2-EURCHF-M5-43,EURCHFMT4,5440,2d 8h 20m,Sell
126655.59,1.21651,04.08.2014 12:00:00,,0.0,-223.40000000031432,0.0,0.0,1.21647,04.08.2014 03:15:00,10667,-0.10300675044655662,-1.5,IS,0.34,0.0,Phase3-EA-S4v1-EURCHF-M15-221,EURCHFMT4,2828,8h 45m,Sell
126617.44,137567,04.08.2014 16:59:58,sl 137.567,0.0,-261.5500000003085,0.0,0.0,137797,04.08.2014 13:30:00,10668,-0.12059720492072853,-38.15,IS,0.17,0.0,Phase3-EA-T1v2-EURJPY-M15-322,EURJPYMT4,1932,3h 29m,Buy
126603.88,1.21693,05.08.2014 05:50:00,,-2.26,-275.1100000003062,0.0,0.0,1.21668,04.08.2014 21:30:00,10669,-0.12684953945990984,-13.56,IS,0.41,0.0,Phase3-EA-SA2v2-EURCHF-M5-43,EURCHFMT4,5442,8h 20m,Sell
126618.62,102558,06.08.2014 03:30:00,,0.0,-260.3700000003155,0.0,0.0,102614,06.08.2014 01:00:00,10670,-0.12005312271156986,14.74,IS,0.27,0.0,Phase3-EA-S1v2-USDJPY-M15-0,USDJPYMT4,3048,2h 30m,Sell
126586.89,1.21586,06.08.2014 04:20:00,,-1.08,-292.10000000032596,0.0,0.0,1.21654,05.08.2014 20:00:00,10671,-0.13468340109861426,-31.73,IS,0.41,0.0,Phase3-EA-SA2v2-EURCHF-M5-43,EURCHFMT4,5444,8h 20m,Buy
126584.34,0.90942,06.08.2014 05:45:00,,0.0,-294.6500000003143,0.0,0.0,0.90938,06.08.2014 01:30:00,10672,-0.1358591719743401,-2.55,IS,0.58,0.0,Phase3-EA-SA2v2-USDCHF-M15-107,USDCHFMT4,2070,4h 15m,Sell
126541.81,1.68492,06.08.2014 11:29:59,sl 1.68492,-0.53,-337.18000000031316,0.0,0.0,1.68792,05.08.2014 12:00:00,10673,-0.15546918583506422,-42.53,IS,0.14,0.0,Phase3-EA-B1v1-GBPUSD-M30-14,GBPUSDMT4,704,23h 29m,Buy
126554.59,0.9075,07.08.2014 06:00:00,,0.0,-324.4000000003143,0.0,0.0,0.9077,07.08.2014 01:45:00,10674,-0.14957649885787075,12.78,IS,0.58,0.0,Phase3-EA-SA2v2-USDCHF-M15-107,USDCHFMT4,2072,4h 15m,Sell
126536.51,1.21469,07.08.2014 07:35:00,,-6.78,-342.4800000003015,0.0,0.0,1.21444,06.08.2014 23:15:00,10675,-0.15791294491010802,-18.08,IS,0.41,0.0,Phase3-EA-SA2v2-EURCHF-M5-43,EURCHFMT4,5446,8h 20m,Sell
126517.05,1.21512,07.08.2014 10:30:00,,0.0,-361.94000000029337,0.0,0.0,1.2146,07.08.2014 01:45:00,10676,-0.16688569049509608,-19.46,IS,0.34,0.0,Phase3-EA-S4v1-EURCHF-M15-221,EURCHFMT4,2830,8h 45m,Sell
126526.19,136866,07.08.2014 14:15:00,,0.0,-352.8000000002794,0.0,0.0,136811,07.08.2014 12:30:00,10677,-0.16267135880717468,9.14,IS,0.17,0.0,Phase3-EA-T1v2-EURJPY-M15-322,EURJPYMT4,1934,1h 45m,Buy
126491.06,102227,07.08.2014 15:00:00,,0.0,-387.93000000028405,0.0,0.0,102094,07.08.2014 00:30:00,10678,-0.17886933169519134,-35.13,IS,0.27,0.0,Phase3-EA-S1v2-USDJPY-M15-0,USDJPYMT4,3050,14h 30m,Sell
126508.0,102024,08.08.2014 04:30:00,,0.0,-370.9900000002817,0.0,0.0,102088,08.08.2014 00:15:00,10679,-0.17105852438739164,16.94,IS,0.27,0.0,Phase3-EA-S1v2-USDJPY-M15-0,USDJPYMT4,3052,4h 15m,Sell
126612.33,136025,08.08.2014 04:59:59,tp 136.025,-6.81,-266.66000000029453,0.0,0.0,137285,17.07.2014 08:00:00,10680,-0.12295335753836382,104.33,IS,0.09,0.0,Phase3-EA-TR1v1-EURJPY-M30-91,EURJPYMT4,1854,21d 20h 59m,Sell
126571.81,1.21314,08.08.2014 12:30:00,,0.0,-307.18000000028405,0.0,0.0,1.21422,08.08.2014 03:45:00,10681,-0.1416365872970367,-40.52,IS,0.34,0.0,Phase3-EA-S4v1-EURCHF-M15-221,EURCHFMT4,2832,8h 45m,Buy
126533.4,136.5,08.08.2014 13:44:58,sl 136.500,0.0,-345.59000000028755,0.0,0.0,136.27,08.08.2014 04:15:00,10682,-0.15934692429187572,-38.41,IS,0.17,0.0,Phase3-EA-T1v2-EURJPY-M15-322,EURJPYMT4,1936,9h 29m,Sell
126563.32,101981,08.08.2014 20:30:00,,0.0,-315.67000000027474,0.0,0.0,101868,08.08.2014 17:00:00,10683,-0.1455512126832904,29.92,IS,0.27,0.0,Phase3-EA-S1v2-USDJPY-M15-0,USDJPYMT4,3054,3h 30m,Buy
126559.24,1.21417,11.08.2014 04:45:00,,-2.27,-319.75000000026193,0.0,0.0,1.21413,08.08.2014 20:25:00,10684,-0.1474324460844544,-4.08,IS,0.41,0.0,Phase3-EA-SA2v2-EURCHF-M5-43,EURCHFMT4,5448,2d 8h 20m,Sell
126579.72,0.90609,11.08.2014 05:30:00,,0.0,-299.27000000025146,0.0,0.0,0.90577,11.08.2014 01:15:00,10685,-0.13798939214916528,20.48,IS,0.58,0.0,Phase3-EA-SA2v2-USDCHF-M15-107,USDCHFMT4,2074,4h 15m,Buy
126520.18,171502,11.08.2014 19:59:58,sl 171.502,-0.51,-358.8100000002596,0.0,0.0,170832,08.08.2014 11:00:00,10686,-0.16544248938094772,-59.54,IS,0.09,0.0,Phase3-EA-B1v1-GBPJPY-M30-1,GBPJPYMT4,1006,3d 8h 59m,Sell
126474.59,0.90715,12.08.2014 03:30:00,,-3.39,-404.4000000002561,0.0,0.0,0.90649,11.08.2014 23:15:00,10687,-0.1864634282925482,-45.59,IS,0.58,0.0,Phase3-EA-SA2v2-USDCHF-M15-107,USDCHFMT4,2076,4h 15m,Sell
126506.97,171488,12.08.2014 07:20:00,,0.0,-372.02000000025146,0.0,0.0,171632,12.08.2014 01:55:00,10688,-0.17153344360384948,32.38,IS,0.23,0.0,Phase3-EA-S4v1-GBPJPY-M5-194,GBPJPYMT4,2466,5h 25m,Sell
126478.06,1.21397,12.08.2014 07:30:00,,-2.26,-400.93000000025495,0.0,0.0,1.21338,11.08.2014 23:10:00,10689,-0.18486345772831736,-28.91,IS,0.41,0.0,Phase3-EA-SA2v2-EURCHF-M5-43,EURCHFMT4,5450,8h 20m,Sell
126469.45,1.21373,12.08.2014 11:45:00,,0.0,-409.540000000241,0.0,0.0,1.2135,12.08.2014 03:00:00,10690,-0.18883341350872096,-8.61,IS,0.34,0.0,Phase3-EA-S4v1-EURCHF-M15-221,EURCHFMT4,2834,8h 45m,Sell
126467.02,1.21314,13.08.2014 05:35:00,,-1.08,-411.970000000234,0.0,0.0,1.21317,12.08.2014 21:15:00,10691,-0.18995385399029688,-2.43,IS,0.41,0.0,Phase3-EA-SA2v2-EURCHF-M5-43,EURCHFMT4,5452,8h 20m,Buy
126492.09,1.21373,13.08.2014 11:45:00,,0.0,-386.900000000227,0.0,0.0,1.21306,13.08.2014 03:00:00,10692,-0.17839441247869323,25.07,IS,0.34,0.0,Phase3-EA-S4v1-EURCHF-M15-221,EURCHFMT4,2836,8h 45m,Buy
126450.09,1.67834,13.08.2014 12:59:58,sl 1.67834,0.0,-428.900000000227,0.0,0.0,1.68134,13.08.2014 09:00:00,10693,-0.19776005043191297,-42.0,IS,0.14,0.0,Phase3-EA-B1v1-GBPUSD-M30-14,GBPUSDMT4,706,3h 59m,Buy
126386.53,137157,13.08.2014 15:59:58,sl 137.157,-0.31,-492.4600000002247,0.0,0.0,136104,08.08.2014 10:30:00,10694,-0.22706671586778443,-63.56,IS,0.09,0.0,Phase3-EA-TR1v1-EURJPY-M30-91,EURJPYMT4,1856,5d 5h 29m,Buy
126416.74,136873,13.08.2014 23:00:00,,0.0,-462.25000000023283,0.0,0.0,136691,13.08.2014 05:45:00,10695,-0.21313728914000798,30.21,IS,0.17,0.0,Phase3-EA-T1v2-EURJPY-M15-322,EURJPYMT4,1938,17h 15m,Buy
126437.45,0.90752,14.08.2014 02:15:00,,-2.3,-441.540000000241,0.0,0.0,0.90716,13.08.2014 22:00:00,10696,-0.20358818528260267,20.71,IS,0.58,0.0,Phase3-EA-SA2v2-USDCHF-M15-107,USDCHFMT4,2078,4h 15m,Buy
126426.52,1213,14.08.2014 05:25:00,,-3.25,-452.470000000234,0.0,0.0,1.21317,13.08.2014 21:05:00,10697,-0.20862786201661593,-10.93,IS,0.41,0.0,Phase3-EA-SA2v2-EURCHF-M5-43,EURCHFMT4,5454,8h 20m,Buy
126388.35,136797,14.08.2014 11:29:57,sl 136.797,0.0,-490.6400000002468,0.0,0.0,137027,14.08.2014 04:00:00,10698,-0.2262275382231551,-38.17,IS,0.17,0.0,Phase3-EA-T1v2-EURJPY-M15-322,EURJPYMT4,1940,7h 29m,Buy
126421.37,1.21215,14.08.2014 13:45:00,,0.0,-457.6200000002573,0.0,0.0,1.21303,14.08.2014 05:00:00,10699,-0.21100245809898574,33.02,IS,0.34,0.0,Phase3-EA-S4v1-EURCHF-M15-221,EURCHFMT4,2838,8h 45m,Sell
126413.08,136971,14.08.2014 21:45:00,,0.0,-465.9100000002654,0.0,0.0,137021,14.08.2014 13:45:00,10700,-0.21482486616166074,-8.29,IS,0.17,0.0,Phase3-EA-T1v2-EURJPY-M15-322,EURJPYMT4,1942,8h 0m,Buy
126409.92,1.21168,15.08.2014 04:20:00,,-2.26,-469.0700000002689,0.0,0.0,1.21166,14.08.2014 20:00:00,10701,-0.21628189987433316,-3.16,IS,0.41,0.0,Phase3-EA-SA2v2-EURCHF-M5-43,EURCHFMT4,5456,8h 20m,Sell
126520.12,137394,15.08.2014 15:29:58,tp 137.394,-3.01,-358.8700000002573,0.0,0.0,136437,12.08.2014 14:00:00,10702,-0.16547015457802267,110.2,IS,0.09,0.0,Phase3-EA-TR1v1-EURJPY-M30-91,EURJPYMT4,1857,3d 1h 29m,Sell
126518.67,102334,18.08.2014 04:15:00,,-1.19,-360.3200000002689,0.0,0.0,102333,15.08.2014 23:30:00,10703,-0.16613873017403205,-1.45,IS,0.27,0.0,Phase3-EA-S1v2-USDJPY-M15-0,USDJPYMT4,3056,2d 4h 45m,Sell
126483.98,0.90285,18.08.2014 05:30:00,,0.0,-395.01000000027125,0.0,0.0,0.90339,18.08.2014 01:15:00,10704,-0.18213382495015676,-34.69,IS,0.58,0.0,Phase3-EA-SA2v2-USDCHF-M15-107,USDCHFMT4,2080,4h 15m,Buy
126490.95,171121,18.08.2014 06:35:00,,0.0,-388.0400000002701,0.0,0.0,171152,18.08.2014 01:10:00,10705,-0.1789200512231576,6.97,IS,0.23,0.0,Phase3-EA-S4v1-GBPJPY-M5-194,GBPJPYMT4,2468,5h 25m,Sell
126471.5,137032,18.08.2014 06:45:00,,0.0,-407.4900000002817,0.0,0.0,137149,18.08.2014 03:30:00,10706,-0.18788818594197546,-19.45,IS,0.17,0.0,Phase3-EA-T1v2-EURJPY-M15-322,EURJPYMT4,1944,3h 15m,Buy
126437.04,1.21059,18.08.2014 09:35:00,,0.0,-441.9500000002736,0.0,0.0,1.20983,18.08.2014 01:15:00,10707,-0.20377723079597057,-34.46,IS,0.41,0.0,Phase3-EA-SA2v2-EURCHF-M5-43,EURCHFMT4,5458,8h 20m,Sell
126409.59,1.21055,18.08.2014 11:15:00,,0.0,-469.4000000002852,0.0,0.0,1.20982,18.08.2014 02:30:00,10708,-0.21643405845825883,-27.45,IS,0.34,0.0,Phase3-EA-S4v1-EURCHF-M15-221,EURCHFMT4,2840,8h 45m,Sell
126400.55,1.21121,19.08.2014 05:15:00,,-2.26,-478.44000000029337,0.0,0.0,1.21106,18.08.2014 20:55:00,10709,-0.22060228148438418,-9.04,IS,0.41,0.0,Phase3-EA-SA2v2-EURCHF-M5-43,EURCHFMT4,5460,8h 20m,Sell
126383.28,0.90691,19.08.2014 06:30:00,,0.0,-495.7100000002829,0.0,0.0,0.90664,19.08.2014 02:15:00,10710,-0.22856524737609613,-17.27,IS,0.58,0.0,Phase3-EA-SA2v2-USDCHF-M15-107,USDCHFMT4,2082,4h 15m,Sell
126391.9,1.21107,19.08.2014 10:30:00,,0.0,-487.09000000028755,0.0,0.0,1.2113,19.08.2014 01:45:00,10711,-0.22459068072950888,8.62,IS,0.34,0.0,Phase3-EA-S4v1-EURCHF-M15-221,EURCHFMT4,2842,8h 45m,Sell
126349.37,1.66879,19.08.2014 11:29:57,sl 1.66879,-0.53,-529.6200000002864,0.0,0.0,1.67179,18.08.2014 01:30:00,10712,-0.24420069459023303,-42.53,IS,0.14,0.0,Phase3-EA-B1v1-GBPUSD-M30-14,GBPUSDMT4,708,1d 9h 59m,Buy
126310.91,137257,20.08.2014 06:44:59,sl 137.257,-0.58,-568.0800000002782,0.0,0.0,137027,19.08.2014 04:45:00,10713,-0.26193408591596334,-38.46,IS,0.17,0.0,Phase3-EA-T1v2-EURJPY-M15-322,EURJPYMT4,1946,1d 1h 59m,Sell
126299.64,1.21108,20.08.2014 07:55:00,,-2.26,-579.3500000002678,0.0,0.0,1.21088,19.08.2014 23:35:00,10714,-0.2671305321000725,-11.27,IS,0.41,0.0,Phase3-EA-SA2v2-EURCHF-M5-43,EURCHFMT4,5462,8h 20m,Sell
126237.67,172.11,20.08.2014 11:59:57,sl 172.110,-3.57,-641.3200000002689,0.0,0.0,171.44,13.08.2014 13:00:00,10715,-0.2957040698134308,-61.97,IS,0.09,0.0,Phase3-EA-B1v1-GBPJPY-M30-1,GBPJPYMT4,1008,6d 22h 59m,Sell
126195.67,1.6594,20.08.2014 21:29:58,sl 1.65940,0.0,-683.3200000002689,0.0,0.0,1.6624,20.08.2014 10:30:00,10716,-0.31506970776665055,-42.0,IS,0.14,0.0,Phase3-EA-B1v1-GBPUSD-M30-14,GBPUSDMT4,710,10h 59m,Buy
126171.6,0.91359,21.08.2014 03:15:00,,-10.1,-707.3900000002759,0.0,0.0,0.91337,20.08.2014 23:00:00,10717,-0.3261680626603204,-24.07,IS,0.58,0.0,Phase3-EA-SA2v2-USDCHF-M15-107,USDCHFMT4,2084,4h 15m,Sell
126217.72,1.21152,21.08.2014 04:04:57,tp 1.21152,-3.23,-661.2700000002806,0.0,0.0,1.21042,20.08.2014 20:00:00,10718,-0.30490274784121557,46.12,IS,0.41,0.0,Phase3-EA-SA2v2-EURCHF-M5-43,EURCHFMT4,5464,8h 4m,Buy
126214.39,1.21046,22.08.2014 05:00:00,,-1.08,-664.6000000002678,0.0,0.0,1.21051,21.08.2014 20:40:00,10719,-0.3064381662789292,-3.33,IS,0.41,0.0,Phase3-EA-SA2v2-EURCHF-M5-43,EURCHFMT4,5466,8h 20m,Buy
126245.59,0.91103,22.08.2014 07:00:00,,0.0,-633.4000000002561,0.0,0.0,0.91152,22.08.2014 02:45:00,10720,-0.2920522637993892,31.2,IS,0.58,0.0,Phase3-EA-SA2v2-USDCHF-M15-107,USDCHFMT4,2086,4h 15m,Sell
126229.93,1.20989,22.08.2014 15:15:00,,0.0,-649.0600000002596,0.0,0.0,1.21031,22.08.2014 06:30:00,10721,-0.29927288023623416,-15.66,IS,0.34,0.0,Phase3-EA-S4v1-EURCHF-M15-221,EURCHFMT4,2844,8h 45m,Buy
126285.17,104167,25.08.2014 01:15:00,,-0.75,-593.8200000002689,0.0,0.0,103951,22.08.2014 23:00:00,10722,-0.27380245546157517,55.24,IS,0.27,0.0,Phase3-EA-S1v2-USDJPY-M15-0,USDJPYMT4,3058,2d 2h 15m,Buy
126264.4,1.20926,25.08.2014 05:25:00,,-1.08,-614.5900000002584,0.0,0.0,1.2097,22.08.2014 21:05:00,10723,-0.2833792245160554,-20.77,IS,0.41,0.0,Phase3-EA-SA2v2-EURCHF-M5-43,EURCHFMT4,5468,2d 8h 20m,Buy
126251.78,1.2091,25.08.2014 13:00:00,,0.0,-627.2100000002538,0.0,0.0,1.20944,25.08.2014 04:15:00,10724,-0.28919813763437785,-12.62,IS,0.34,0.0,Phase3-EA-S4v1-EURCHF-M15-221,EURCHFMT4,2846,8h 45m,Buy
126195.87,0.91603,26.08.2014 02:15:00,,-3.36,-683.1200000002573,0.0,0.0,0.9152,25.08.2014 22:00:00,10725,-0.3149774904430584,-55.91,IS,0.58,0.0,Phase3-EA-SA2v2-USDCHF-M15-107,USDCHFMT4,2088,4h 15m,Sell
126259.25,0.91506,26.08.2014 04:29:59,tp 0.91506,0.0,-619.7400000002526,0.0,0.0,0.91606,26.08.2014 02:45:00,10726,-0.2857538205984118,63.38,IS,0.58,0.0,Phase3-EA-SA2v2-USDCHF-M15-107,USDCHFMT4,2090,1h 44m,Sell
126303.59,172268,26.08.2014 04:50:00,,-1.28,-575.4000000002561,0.0,0.0,172474,25.08.2014 23:25:00,10727,-0.26530923995922856,44.34,IS,0.23,0.0,Phase3-EA-S4v1-GBPJPY-M5-194,GBPJPYMT4,2470,5h 25m,Sell
126298.03,1.20736,26.08.2014 06:20:00,,-1.08,-580.9600000002538,0.0,0.0,1.20746,25.08.2014 22:00:00,10728,-0.26787288155493943,-5.56,IS,0.41,0.0,Phase3-EA-SA2v2-EURCHF-M5-43,EURCHFMT4,5470,8h 20m,Buy
126303.61,1.20765,26.08.2014 10:15:00,,0.0,-575.3800000002666,0.0,0.0,1.2078,26.08.2014 01:30:00,10729,-0.2653000182268747,5.58,IS,0.34,0.0,Phase3-EA-S4v1-EURCHF-M15-221,EURCHFMT4,2848,8h 45m,Sell
126323.34,104132,27.08.2014 03:15:00,,-0.75,-555.6500000002561,0.0,0.0,104053,26.08.2014 23:00:00,10730,-0.256202779255036,19.73,IS,0.27,0.0,Phase3-EA-S1v2-USDJPY-M15-0,USDJPYMT4,3060,4h 15m,Buy
126333.37,172178,27.08.2014 04:45:00,,-0.8,-545.6200000002573,0.0,0.0,172129,26.08.2014 23:20:00,10731,-0.25157808047716046,10.03,IS,0.23,0.0,Phase3-EA-S4v1-GBPJPY-M5-194,GBPJPYMT4,2472,5h 25m,Buy
126305.94,1.20796,27.08.2014 05:25:00,,-1.07,-573.0500000002503,0.0,0.0,1.20855,26.08.2014 21:05:00,10732,-0.26422568640708144,-27.43,IS,0.41,0.0,Phase3-EA-SA2v2-EURCHF-M5-43,EURCHFMT4,5472,8h 20m,Buy
126292.95,1.20762,27.08.2014 13:15:00,,0.0,-586.040000000241,0.0,0.0,1.20797,27.08.2014 04:30:00,10733,-0.2702152015740373,-12.99,IS,0.34,0.0,Phase3-EA-S4v1-EURCHF-M15-221,EURCHFMT4,2850,8h 45m,Buy
126290.27,1.20693,28.08.2014 06:00:00,,-6.72,-588.720000000234,0.0,0.0,1.20702,27.08.2014 21:40:00,10734,-0.27145091371009666,-2.68,IS,0.41,0.0,Phase3-EA-SA2v2-EURCHF-M5-43,EURCHFMT4,5474,8h 20m,Sell
126305.57,172191,28.08.2014 08:45:00,,0.0,-573.4200000002456,0.0,0.0,172122,28.08.2014 03:20:00,10735,-0.26439628845571483,15.3,IS,0.23,0.0,Phase3-EA-S4v1-GBPJPY-M5-194,GBPJPYMT4,2474,5h 25m,Buy
126332.75,1.20627,28.08.2014 11:45:00,,0.0,-546.2400000002526,0.0,0.0,1207,28.08.2014 03:00:00,10736,-0.25186395418027724,27.18,IS,0.34,0.0,Phase3-EA-S4v1-EURCHF-M15-221,EURCHFMT4,2852,8h 45m,Sell
126264.72,136524,28.08.2014 13:59:58,sl 136.524,-5.52,-614.2700000002515,0.0,0.0,137244,15.08.2014 12:00:00,10737,-0.28323167679831335,-68.03,IS,0.09,0.0,Phase3-EA-TR1v1-EURJPY-M30-91,EURJPYMT4,1859,13d 1h 59m,Buy
126246.8,1.20645,29.08.2014 04:20:00,,-2.24,-632.1900000002643,0.0,0.0,1.2061,28.08.2014 20:00:00,10738,-0.291494348991693,-17.92,IS,0.41,0.0,Phase3-EA-SA2v2-EURCHF-M5-43,EURCHFMT4,5476,8h 20m,Sell
126272.79,1.20571,29.08.2014 10:15:00,,0.0,-606.2000000002736,0.0,0.0,1.20641,29.08.2014 01:30:00,10739,-0.27951070779159776,25.99,IS,0.34,0.0,Phase3-EA-S4v1-EURCHF-M15-221,EURCHFMT4,2854,8h 45m,Sell
126233.08,172853,01.09.2014 04:30:00,,-1.28,-645.9100000002654,0.0,0.0,172679,29.08.2014 23:05:00,10740,-0.29782045738974533,-39.71,IS,0.23,0.0,Phase3-EA-S4v1-GBPJPY-M5-194,GBPJPYMT4,2476,2d 5h 25m,Sell
126193.34,0.91937,01.09.2014 05:45:00,,0.0,-685.6500000002561,0.0,0.0,0.91874,01.09.2014 01:30:00,10741,-0.3161440395864304,-39.74,IS,0.58,0.0,Phase3-EA-SA2v2-USDCHF-M15-107,USDCHFMT4,2092,4h 15m,Sell
126201.63,1.20637,01.09.2014 07:10:00,,-1.07,-677.360000000248,0.0,0.0,1.20616,29.08.2014 22:50:00,10742,-0.3123216315237554,8.29,IS,0.41,0.0,Phase3-EA-SA2v2-EURCHF-M5-43,EURCHFMT4,5478,2d 8h 20m,Buy
126217.92,1.20626,01.09.2014 11:15:00,,0.0,-661.0700000002398,0.0,0.0,1.2067,01.09.2014 02:30:00,10743,-0.30481053051761,16.29,IS,0.34,0.0,Phase3-EA-S4v1-EURCHF-M15-221,EURCHFMT4,2856,8h 45m,Sell
126219.25,1.20726,02.09.2014 05:00:00,,-2.23,-659.7400000002526,0.0,0.0,1.20734,01.09.2014 20:40:00,10744,-0.30419728531576395,1.33,IS,0.41,0.0,Phase3-EA-SA2v2-EURCHF-M5-43,EURCHFMT4,5480,8h 20m,Sell
126113.25,173.85,02.09.2014 08:20:00,,0.0,-765.7400000002526,0.0,0.0,173367,02.09.2014 02:55:00,10745,-0.3530724668167471,-106.0,IS,0.23,0.0,Phase3-EA-S4v1-GBPJPY-M5-194,GBPJPYMT4,2478,5h 25m,Sell
126045.66,137598,02.09.2014 08:29:58,sl 137.598,-0.6,-833.3300000002491,0.0,0.0,136818,29.08.2014 18:00:00,10746,-0.3842373113228913,-67.59,IS,0.09,0.0,Phase3-EA-TR1v1-EURJPY-M30-91,EURJPYMT4,1862,3d 14h 29m,Sell
126051.57,1.20723,02.09.2014 15:30:00,,0.0,-827.4200000002456,0.0,0.0,1.20739,02.09.2014 06:45:00,10747,-0.3815122894109009,5.91,IS,0.34,0.0,Phase3-EA-S4v1-EURCHF-M15-221,EURCHFMT4,2858,8h 45m,Sell
126009.19,137813,02.09.2014 16:59:58,sl 137.813,-5.14,-869.8000000002503,0.0,0.0,137583,22.08.2014 23:30:00,10748,-0.4010531402789376,-42.38,IS,0.17,0.0,Phase3-EA-T1v2-EURJPY-M15-322,EURJPYMT4,1948,10d 17h 29m,Sell
126012.81,105153,03.09.2014 02:30:00,,-0.75,-866.180000000255,0.0,0.0,105136,02.09.2014 23:00:00,10749,-0.3993840067220194,3.62,IS,0.27,0.0,Phase3-EA-S1v2-USDJPY-M15-0,USDJPYMT4,3062,3h 30m,Buy
126014.57,0.91928,03.09.2014 03:15:00,,-0.76,-864.4200000002456,0.0,0.0,0.91924,02.09.2014 23:00:00,10750,-0.3985724942744516,1.76,IS,0.58,0.0,Phase3-EA-SA2v2-USDCHF-M15-107,USDCHFMT4,2094,4h 15m,Buy
126048.54,173206,03.09.2014 05:00:00,,-0.79,-830.4500000002445,0.0,0.0,173047,02.09.2014 23:35:00,10751,-0.38290938186323975,33.97,IS,0.23,0.0,Phase3-EA-S4v1-GBPJPY-M5-194,GBPJPYMT4,2480,5h 25m,Buy
126062.18,1.20718,03.09.2014 07:15:00,,-1.07,-816.8100000002305,0.0,0.0,1.20685,02.09.2014 22:55:00,10752,-0.37662016039461627,13.64,IS,0.41,0.0,Phase3-EA-SA2v2-EURCHF-M5-43,EURCHFMT4,5482,8h 20m,Buy
126025.19,1.20807,03.09.2014 12:15:00,,0.0,-853.8000000002212,0.0,0.0,1.20707,03.09.2014 03:30:00,10753,-0.3936757543919833,-36.99,IS,0.34,0.0,Phase3-EA-S4v1-EURCHF-M15-221,EURCHFMT4,2860,8h 45m,Sell
125987.94,137915,03.09.2014 17:29:58,sl 137.915,0.0,-891.0500000002212,0.0,0.0,138145,03.09.2014 13:30:00,10754,-0.4108512309100175,-37.25,IS,0.17,0.0,Phase3-EA-T1v2-EURJPY-M15-322,EURJPYMT4,1950,3h 59m,Buy
125991.87,1.20672,04.09.2014 05:20:00,,-3.22,-887.1200000002282,0.0,0.0,1.20656,03.09.2014 21:00:00,10755,-0.4090391605015409,3.93,IS,0.41,0.0,Phase3-EA-SA2v2-EURCHF-M5-43,EURCHFMT4,5484,8h 20m,Buy
125972.8,172661,04.09.2014 05:55:00,,0.0,-906.1900000002352,0.0,0.0,172574,04.09.2014 00:30:00,10756,-0.41783208230554175,-19.07,IS,0.23,0.0,Phase3-EA-S4v1-GBPJPY-M5-194,GBPJPYMT4,2482,5h 25m,Sell
125971.69,1.20688,04.09.2014 12:30:00,,0.0,-907.3000000002212,0.0,0.0,1.20685,04.09.2014 03:45:00,10757,-0.4183438884514418,-1.11,IS,0.34,0.0,Phase3-EA-S4v1-EURCHF-M15-221,EURCHFMT4,2862,8h 45m,Sell
125934.42,137702,04.09.2014 13:59:57,sl 137.702,0.0,-944.5700000002107,0.0,0.0,137932,04.09.2014 10:00:00,10758,-0.43552858670182987,-37.27,IS,0.17,0.0,Phase3-EA-T1v2-EURJPY-M15-322,EURJPYMT4,1952,3h 59m,Buy
125870.9,136.66,04.09.2014 15:59:58,sl 136.660,-1.68,-1008.0900000002002,0.0,0.0,137.38,02.09.2014 05:30:00,10759,-0.4648168086729802,-63.52,IS,0.09,0.0,Phase3-EA-TR1v1-EURJPY-M30-91,EURJPYMT4,1863,2d 10h 29m,Buy
125919.13,105.3,05.09.2014 00:15:00,,-0.74,-959.8600000001898,0.0,0.0,105109,04.09.2014 22:45:00,10760,-0.44257860109002806,48.23,IS,0.27,0.0,Phase3-EA-S1v2-USDJPY-M15-0,USDJPYMT4,3064,1h 30m,Buy
125874.17,0.9327,05.09.2014 02:30:00,,-3.3,-1004.8200000001816,0.0,0.0,0.93203,04.09.2014 22:15:00,10761,-0.4633090554323281,-44.96,IS,0.58,0.0,Phase3-EA-SA2v2-USDCHF-M15-107,USDCHFMT4,2096,4h 15m,Sell
125904.07,1.20585,05.09.2014 05:40:00,,-2.2,-974.9200000001874,0.0,0.0,1.20658,04.09.2014 21:20:00,10762,-0.44952256555611003,29.9,IS,0.41,0.0,Phase3-EA-SA2v2-EURCHF-M5-43,EURCHFMT4,5486,8h 20m,Sell
125895.3,1.20582,05.09.2014 12:15:00,,0.0,-983.690000000177,0.0,0.0,1.20606,05.09.2014 03:30:00,10763,-0.45356629519538466,-8.77,IS,0.34,0.0,Phase3-EA-S4v1-EURCHF-M15-221,EURCHFMT4,2864,8h 45m,Buy
125832.4,171.49,05.09.2014 14:29:58,sl 171.490,-5.6,-1046.5900000001711,0.0,0.0,172.16,20.08.2014 21:30:00,10764,-0.4825686434634182,-62.9,IS,0.09,0.0,Phase3-EA-B1v1-GBPJPY-M30-1,GBPJPYMT4,1010,15d 16h 59m,Buy
125789.87,1.62989,08.09.2014 01:00:00,sl 1.62989,-0.53,-1089.12000000017,0.0,0.0,1.63289,05.09.2014 23:00:00,10765,-0.5021786573241424,-42.53,IS,0.14,0.0,Phase3-EA-B1v1-GBPUSD-M30-14,GBPUSDMT4,712,2d 2h 0m,Buy
125774.32,105055,08.09.2014 04:30:00,,-1.16,-1104.6700000001583,0.0,0.0,104999,05.09.2014 21:15:00,10766,-0.5093485542330076,-15.55,IS,0.27,0.0,Phase3-EA-S1v2-USDJPY-M15-0,USDJPYMT4,3066,2d 7h 15m,Sell
125773.66,170376,08.09.2014 06:40:00,,0.0,-1105.3300000001618,0.0,0.0,170379,08.09.2014 01:15:00,10767,-0.5096528714008456,-0.66,IS,0.23,0.0,Phase3-EA-S4v1-GBPJPY-M5-194,GBPJPYMT4,2484,5h 25m,Buy
125795.03,1.20636,08.09.2014 07:40:00,,-1.06,-1083.9600000001665,0.0,0.0,1.20585,05.09.2014 23:20:00,10768,-0.4997994503756023,21.37,IS,0.41,0.0,Phase3-EA-SA2v2-EURCHF-M5-43,EURCHFMT4,5488,2d 8h 20m,Buy
125787.37,1.20684,08.09.2014 15:30:00,,0.0,-1091.62000000017,0.0,0.0,1.20663,08.09.2014 06:45:00,10769,-0.5033313738689769,-7.66,IS,0.34,0.0,Phase3-EA-S4v1-EURCHF-M15-221,EURCHFMT4,2866,8h 45m,Sell
125749.7,136469,08.09.2014 17:44:58,sl 136.469,-0.57,-1129.2900000001828,0.0,0.0,136239,05.09.2014 05:45:00,10770,-0.5207005067665491,-37.67,IS,0.17,0.0,Phase3-EA-T1v2-EURJPY-M15-322,EURJPYMT4,1954,3d 11h 59m,Sell
125687.76,136991,08.09.2014 19:59:58,sl 136.991,-0.6,-1191.230000000185,0.0,0.0,136271,04.09.2014 18:30:00,10771,-0.54926021188137,-61.94,IS,0.09,0.0,Phase3-EA-TR1v1-EURJPY-M30-91,EURJPYMT4,1866,4d 1h 29m,Sell
125681.62,1.20654,09.09.2014 04:25:00,,-2.19,-1197.370000000199,0.0,0.0,1.20645,08.09.2014 20:05:00,10772,-0.55209128371549,-6.14,IS,0.41,0.0,Phase3-EA-SA2v2-EURCHF-M5-43,EURCHFMT4,5490,8h 20m,Sell
125766.16,170992,09.09.2014 05:34:58,tp 170.992,0.0,-1112.830000000191,0.0,0.0,170602,09.09.2014 01:05:00,10773,-0.5131110210353624,84.54,IS,0.23,0.0,Phase3-EA-S4v1-GBPJPY-M5-194,GBPJPYMT4,2486,4h 29m,Buy
125794.14,1.20582,09.09.2014 12:15:00,,0.0,-1084.8500000001804,0.0,0.0,1.20659,09.09.2014 03:30:00,10774,-0.5002098174655698,27.98,IS,0.34,0.0,Phase3-EA-S4v1-EURCHF-M15-221,EURCHFMT4,2868,8h 45m,Sell
125856.37,0.93197,10.09.2014 03:29:58,tp 0.93197,0.0,-1022.62000000017,0.0,0.0,0.93297,10.09.2014 01:45:00,10775,-0.4715163972315444,62.23,IS,0.58,0.0,Phase3-EA-SA2v2-USDCHF-M15-107,USDCHFMT4,2098,1h 44m,Sell
125828.71,1.20748,10.09.2014 06:00:00,,-2.2,-1050.2800000001735,0.0,0.0,1.2069,09.09.2014 21:40:00,10776,-0.48427005308359505,-27.66,IS,0.41,0.0,Phase3-EA-SA2v2-EURCHF-M5-43,EURCHFMT4,5492,8h 20m,Sell
125731.07,171606,10.09.2014 08:45:00,,0.0,-1147.9200000001874,0.0,0.0,171154,10.09.2014 03:20:00,10777,-0.529290550458658,-97.64,IS,0.23,0.0,Phase3-EA-S4v1-GBPJPY-M5-194,GBPJPYMT4,2488,5h 25m,Sell
125732.16,1.2073,10.09.2014 15:00:00,,0.0,-1146.830000000191,0.0,0.0,1.20733,10.09.2014 06:15:00,10778,-0.5287879660451118,1.09,IS,0.34,0.0,Phase3-EA-S4v1-EURCHF-M15-221,EURCHFMT4,2870,8h 45m,Sell
125868.62,137712,10.09.2014 18:15:00,,-0.78,-1010.3700000001991,0.0,0.0,136851,09.09.2014 05:45:00,10779,-0.46586808616186876,136.46,IS,0.17,0.0,Phase3-EA-T1v2-EURJPY-M15-322,EURJPYMT4,1956,1d 12h 30m,Buy
126024.25,172805,10.09.2014 20:29:57,tp 172.805,-0.31,-854.7400000001944,0.0,0.0,170955,09.09.2014 09:30:00,10780,-0.3941091758128288,155.63,IS,0.09,0.0,Phase3-EA-B1v1-GBPJPY-M30-1,GBPJPYMT4,1012,1d 10h 59m,Buy
126009.39,0.93666,11.09.2014 04:30:00,,0.0,-869.6000000001804,0.0,0.0,0.9369,11.09.2014 00:15:00,10781,-0.40096092295531865,-14.86,IS,0.58,0.0,Phase3-EA-SA2v2-USDCHF-M15-107,USDCHFMT4,2100,4h 15m,Buy
126006.67,1.21011,11.09.2014 04:55:00,,-3.16,-872.3200000001816,0.0,0.0,1.2101,10.09.2014 20:35:00,10782,-0.4022150785560991,-2.72,IS,0.41,0.0,Phase3-EA-SA2v2-EURCHF-M5-43,EURCHFMT4,5494,8h 20m,Buy
125998.44,137876,11.09.2014 06:15:00,,-2.34,-880.5500000001921,0.0,0.0,137913,10.09.2014 22:45:00,10783,-0.40600982142169917,-8.23,IS,0.17,0.0,Phase3-EA-T1v2-EURJPY-M15-322,EURJPYMT4,1958,7h 30m,Buy
126102.44,138211,11.09.2014 10:59:58,tp 138.211,-2.08,-776.5500000001921,0.0,0.0,136951,08.09.2014 20:00:00,10784,-0.3580568131565836,104.0,IS,0.09,0.0,Phase3-EA-TR1v1-EURJPY-M30-91,EURJPYMT4,1868,2d 14h 59m,Buy
126117.33,1.21008,11.09.2014 14:45:00,,0.0,-761.6600000001781,0.0,0.0,1.20967,11.09.2014 06:00:00,10785,-0.3511912334155428,14.89,IS,0.34,0.0,Phase3-EA-S4v1-EURCHF-M15-221,EURCHFMT4,2872,8h 45m,Buy
126131.17,138.18,11.09.2014 20:45:00,,0.0,-747.8200000001816,0.0,0.0,138093,11.09.2014 08:15:00,10786,-0.3448097946233406,13.84,IS,0.17,0.0,Phase3-EA-T1v2-EURJPY-M15-322,EURJPYMT4,1960,12h 30m,Buy
126153.76,1.20968,12.09.2014 04:55:00,,-1.05,-725.2300000001851,0.0,0.0,1.20914,11.09.2014 20:35:00,10787,-0.3343938479242176,22.59,IS,0.41,0.0,Phase3-EA-SA2v2-EURCHF-M5-43,EURCHFMT4,5496,8h 20m,Buy
126119.88,174149,12.09.2014 05:30:00,,0.0,-759.1100000001898,0.0,0.0,173991,12.09.2014 00:05:00,10788,-0.350015462539817,-33.88,IS,0.23,0.0,Phase3-EA-S4v1-GBPJPY-M5-194,GBPJPYMT4,2490,5h 25m,Sell
126052.74,107.16,12.09.2014 09:30:00,,-1.13,-826.2500000002037,0.0,0.0,106898,11.09.2014 20:45:00,10789,-0.380972818067899,-67.14,IS,0.27,0.0,Phase3-EA-S1v2-USDJPY-M15-0,USDJPYMT4,3068,12h 45m,Sell
125987.02,139021,12.09.2014 19:29:58,sl 139.021,-0.29,-891.9700000002049,0.0,0.0,138241,11.09.2014 19:00:00,10790,-0.41127543059850913,-65.72,IS,0.09,0.0,Phase3-EA-TR1v1-EURJPY-M30-91,EURJPYMT4,1870,1d 0h 29m,Sell
126049.1,0.93421,15.09.2014 03:29:58,tp 0.93421,0.0,-829.8900000002177,0.0,0.0,0.93321,15.09.2014 01:15:00,10791,-0.3826511733571845,62.08,IS,0.58,0.0,Phase3-EA-SA2v2-USDCHF-M15-107,USDCHFMT4,2102,2h 14m,Buy
126076.6,1.21027,15.09.2014 05:15:00,,-1.05,-802.3900000002177,0.0,0.0,1.20962,12.09.2014 20:55:00,10792,-0.3699712913640049,27.5,IS,0.41,0.0,Phase3-EA-SA2v2-EURCHF-M5-43,EURCHFMT4,5498,2d 8h 20m,Buy
126129.57,138999,15.09.2014 06:45:00,,-0.78,-749.4200000002165,0.0,0.0,138.66,12.09.2014 14:45:00,10793,-0.3455475332120508,52.97,IS,0.17,0.0,Phase3-EA-T1v2-EURJPY-M15-322,EURJPYMT4,1962,2d 16h 0m,Buy
126104.5,1.21057,15.09.2014 10:45:00,,0.0,-774.4900000002235,0.0,0.0,1.20988,15.09.2014 02:00:00,10794,-0.3571069747236545,-25.07,IS,0.34,0.0,Phase3-EA-S4v1-EURCHF-M15-221,EURCHFMT4,2874,8h 45m,Sell
126133.9,1.20975,16.09.2014 04:30:00,,-2.19,-745.0900000002293,0.0,0.0,1.21047,15.09.2014 20:10:00,10795,-0.3435510281564033,29.4,IS,0.41,0.0,Phase3-EA-SA2v2-EURCHF-M5-43,EURCHFMT4,5500,8h 20m,Sell
126122.31,173.88,16.09.2014 06:35:00,,0.0,-756.6800000002258,0.0,0.0,173934,16.09.2014 01:10:00,10796,-0.3488950220582545,-11.59,IS,0.23,0.0,Phase3-EA-S4v1-GBPJPY-M5-194,GBPJPYMT4,2492,5h 25m,Buy
126182.38,1.20887,16.09.2014 11:45:00,,0.0,-696.6100000002189,0.0,0.0,1.21052,16.09.2014 03:00:00,10797,-0.32119754891896773,60.07,IS,0.34,0.0,Phase3-EA-S4v1-EURCHF-M15-221,EURCHFMT4,2876,8h 45m,Sell
126145.82,138854,16.09.2014 19:59:57,sl 138.854,0.0,-733.1700000002165,0.0,0.0,138624,16.09.2014 02:15:00,10798,-0.3380548756706265,-36.56,IS,0.17,0.0,Phase3-EA-T1v2-EURJPY-M15-322,EURJPYMT4,1964,17h 44m,Sell
126132.45,1.20843,17.09.2014 05:55:00,,-1.06,-746.5400000002119,0.0,0.0,1.20871,16.09.2014 21:35:00,10799,-0.3442196037523993,-13.37,IS,0.41,0.0,Phase3-EA-SA2v2-EURCHF-M5-43,EURCHFMT4,5502,8h 20m,Buy
126146.13,0.93289,17.09.2014 06:00:00,,0.0,-732.8600000002189,0.0,0.0,0.93311,17.09.2014 01:45:00,10800,-0.3379119388190681,13.68,IS,0.58,0.0,Phase3-EA-SA2v2-USDCHF-M15-107,USDCHFMT4,2104,4h 15m,Sell
126300.16,175025,17.09.2014 10:59:58,tp 175.025,-1.2,-578.83000000022,0.0,0.0,173175,11.09.2014 08:00:00,10801,-0.2668907670587249,154.03,IS,0.09,0.0,Phase3-EA-B1v1-GBPJPY-M30-1,GBPJPYMT4,1014,6d 2h 59m,Buy
126354.77,1.20992,17.09.2014 15:30:00,,0.0,-524.220000000234,0.0,0.0,1.20842,17.09.2014 06:45:00,10802,-0.2417108268533663,54.61,IS,0.34,0.0,Phase3-EA-S4v1-EURCHF-M15-221,EURCHFMT4,2878,8h 45m,Buy
126312.29,176524,18.09.2014 04:50:00,,-3.69,-566.7000000002445,0.0,0.0,176341,17.09.2014 23:25:00,10803,-0.2612977863831991,-42.48,IS,0.23,0.0,Phase3-EA-S4v1-GBPJPY-M5-194,GBPJPYMT4,2494,5h 25m,Sell
126313.94,1.21082,18.09.2014 05:10:00,,-3.14,-565.0500000002503,0.0,0.0,1.21071,17.09.2014 20:50:00,10804,-0.26053699346361103,1.65,IS,0.41,0.0,Phase3-EA-SA2v2-EURCHF-M5-43,EURCHFMT4,5504,8h 20m,Buy
126466.06,177112,18.09.2014 08:59:58,tp 177.112,-0.9,-412.93000000025495,0.0,0.0,175262,17.09.2014 16:30:00,10805,-0.190396497143523,152.12,IS,0.09,0.0,Phase3-EA-B1v1-GBPJPY-M30-1,GBPJPYMT4,1016,16h 29m,Buy
126567.83,139.99,18.09.2014 08:59:58,tp 139.990,-2.45,-311.1600000002654,0.0,0.0,138.73,12.09.2014 06:30:00,10806,-0.14347171203640466,101.77,IS,0.09,0.0,Phase3-EA-TR1v1-EURJPY-M30-91,EURJPYMT4,1871,6d 2h 29m,Buy
126593.14,1.21115,18.09.2014 09:45:00,,0.0,-285.85000000026776,0.0,0.0,1.21045,18.09.2014 01:00:00,10807,-0.13180160973650115,25.31,IS,0.34,0.0,Phase3-EA-S4v1-EURCHF-M15-221,EURCHFMT4,2880,8h 45m,Buy
126643.27,0.93474,19.09.2014 03:45:00,,-0.75,-235.7200000002631,0.0,0.0,0.93392,18.09.2014 23:30:00,10808,-0.10868733757947745,50.13,IS,0.58,0.0,Phase3-EA-SA2v2-USDCHF-M15-107,USDCHFMT4,2106,4h 15m,Buy
126474.12,179.57,19.09.2014 03:49:58,sl 179.570,0.0,-404.8700000002573,0.0,0.0,178.77,19.09.2014 01:00:00,10809,-0.1866801390029776,-169.15,IS,0.23,0.0,Phase3-EA-S4v1-GBPJPY-M5-194,GBPJPYMT4,2496,2h 49m,Sell
126626.88,179373,19.09.2014 03:59:58,tp 179.373,-0.3,-252.11000000024796,0.0,0.0,177523,18.09.2014 14:00:00,10810,-0.11624454724740552,152.76,IS,0.09,0.0,Phase3-EA-B1v1-GBPJPY-M30-1,GBPJPYMT4,1018,13h 59m,Buy
126458.37,180235,19.09.2014 04:19:59,sl 180.235,0.0,-420.6200000002573,0.0,0.0,179435,19.09.2014 03:55:00,10811,-0.193942253235435,-168.51,IS,0.23,0.0,Phase3-EA-S4v1-GBPJPY-M5-194,GBPJPYMT4,2498,24m 59s,Sell
126393.54,140656,19.09.2014 04:29:58,sl 140.656,-0.29,-485.4500000002445,0.0,0.0,139876,18.09.2014 11:30:00,10812,-0.2238344986760776,-64.83,IS,0.09,0.0,Phase3-EA-TR1v1-EURJPY-M30-91,EURJPYMT4,1874,16h 59m,Sell
126396.0,1.20681,19.09.2014 07:50:00,,-1.05,-482.9900000002526,0.0,0.0,1.20673,18.09.2014 23:30:00,10813,-0.2227002255959642,2.46,IS,0.41,0.0,Phase3-EA-SA2v2-EURCHF-M5-43,EURCHFMT4,5506,8h 20m,Buy
126477.54,177958,22.09.2014 02:09:57,tp 177.958,-0.76,-401.4500000002445,0.0,0.0,177568,19.09.2014 23:20:00,10814,-0.18510322276963811,81.54,IS,0.23,0.0,Phase3-EA-S4v1-GBPJPY-M5-194,GBPJPYMT4,2500,2d 2h 49m,Buy
126450.66,108964,22.09.2014 02:30:00,,-1.11,-428.33000000024913,0.0,0.0,108.86,19.09.2014 17:00:00,10815,-0.19749723105970088,-26.88,IS,0.27,0.0,Phase3-EA-S1v2-USDJPY-M15-0,USDJPYMT4,3070,2d 9h 30m,Sell
126317.76,0.93829,22.09.2014 06:45:00,,0.0,-561.2300000002433,0.0,0.0,0.94044,22.09.2014 02:30:00,10816,-0.25877564258310065,-132.9,IS,0.58,0.0,Phase3-EA-SA2v2-USDCHF-M15-107,USDCHFMT4,2108,4h 15m,Buy
126318.89,1.20719,22.09.2014 07:10:00,,-1.05,-560.1000000002387,0.0,0.0,1.20714,19.09.2014 22:50:00,10817,-0.25825461470483335,1.13,IS,0.41,0.0,Phase3-EA-SA2v2-EURCHF-M5-43,EURCHFMT4,5508,2d 8h 20m,Buy
126305.35,177852,22.09.2014 07:40:00,,0.0,-573.6400000002468,0.0,0.0,177788,22.09.2014 02:15:00,10818,-0.2644977275116608,-13.54,IS,0.23,0.0,Phase3-EA-S4v1-GBPJPY-M5-194,GBPJPYMT4,2502,5h 25m,Sell
126269.41,140.04,22.09.2014 08:59:58,sl 140.040,0.0,-609.5800000002491,0.0,0.0,139.81,22.09.2014 06:30:00,10819,-0.28106918056020275,-35.94,IS,0.17,0.0,Phase3-EA-T1v2-EURJPY-M15-322,EURJPYMT4,1966,2h 29m,Sell
126255.71,0.93984,23.09.2014 03:15:00,,-0.74,-623.2800000002608,0.0,0.0,0.94005,22.09.2014 23:00:00,10820,-0.2873860672259012,-13.7,IS,0.58,0.0,Phase3-EA-SA2v2-USDCHF-M15-107,USDCHFMT4,2110,4h 15m,Buy
126264.44,1.2074,23.09.2014 05:10:00,,-2.18,-614.5500000002503,0.0,0.0,1.20765,22.09.2014 20:50:00,10821,-0.2833607810513343,8.73,IS,0.41,0.0,Phase3-EA-SA2v2-EURCHF-M5-43,EURCHFMT4,5510,8h 20m,Sell
126203.62,139605,23.09.2014 09:59:58,sl 139.605,-1.22,-675.3700000002573,0.0,0.0,140325,18.09.2014 17:30:00,10822,-0.31140406915407143,-60.82,IS,0.09,0.0,Phase3-EA-TR1v1-EURJPY-M30-91,EURJPYMT4,1875,4d 16h 29m,Buy
126161.09,1.63285,23.09.2014 10:59:58,sl 1.63285,-0.53,-717.9000000002561,0.0,0.0,1.63585,22.09.2014 22:30:00,10823,-0.33101408301479557,-42.53,IS,0.14,0.0,Phase3-EA-B1v1-GBPUSD-M30-14,GBPUSDMT4,714,12h 29m,Buy
126125.03,139956,23.09.2014 15:14:57,sl 139.956,0.0,-753.9600000002538,0.0,0.0,139726,23.09.2014 08:30:00,10824,-0.34764086645748743,-36.06,IS,0.17,0.0,Phase3-EA-T1v2-EURJPY-M15-322,EURJPYMT4,1968,6h 44m,Sell
126031.61,108646,23.09.2014 16:00:00,,-0.72,-847.3800000002666,0.0,0.0,109019,22.09.2014 17:15:00,10825,-0.39071557830486925,-93.42,IS,0.27,0.0,Phase3-EA-S1v2-USDJPY-M15-0,USDJPYMT4,3072,22h 45m,Buy
125989.61,1.63595,23.09.2014 17:29:58,sl 1.63595,0.0,-889.3800000002666,0.0,0.0,1.63895,23.09.2014 13:00:00,10826,-0.410081216258089,-42.0,IS,0.14,0.0,Phase3-EA-B1v1-GBPUSD-M30-14,GBPUSDMT4,716,4h 29m,Buy
125933.24,178486,23.09.2014 21:59:58,sl 178.486,-0.96,-945.7500000002619,0.0,0.0,177816,19.09.2014 17:00:00,10827,-0.43607266891101537,-56.37,IS,0.09,0.0,Phase3-EA-B1v1-GBPJPY-M30-1,GBPJPYMT4,1020,4d 4h 59m,Sell
125969.06,0.93923,24.09.2014 06:15:00,,0.0,-909.930000000255,0.0,0.0,0.93981,24.09.2014 02:00:00,10828,-0.4195565462566233,35.82,IS,0.58,0.0,Phase3-EA-SA2v2-USDCHF-M15-107,USDCHFMT4,2112,4h 15m,Sell
126051.66,178301,24.09.2014 06:54:58,tp 178.301,0.0,-827.3300000002491,0.0,0.0,177911,24.09.2014 02:55:00,10829,-0.38147079161528846,82.6,IS,0.23,0.0,Phase3-EA-S4v1-GBPJPY-M5-194,GBPJPYMT4,2504,3h 59m,Buy
126099.65,1.20834,24.09.2014 10:19:57,tp 1.20834,0.0,-779.3400000002584,0.0,0.0,1.20724,24.09.2014 02:35:00,10830,-0.3593432448206495,47.99,IS,0.41,0.0,Phase3-EA-SA2v2-EURCHF-M5-43,EURCHFMT4,5512,7h 44m,Buy
126097.84,1.2076,24.09.2014 12:15:00,,0.0,-781.1500000002561,0.0,0.0,1.20755,24.09.2014 03:30:00,10831,-0.3601778115991086,-1.81,IS,0.34,0.0,Phase3-EA-S4v1-EURCHF-M15-221,EURCHFMT4,2882,8h 45m,Sell
126041.7,108639,24.09.2014 12:15:00,,-0.72,-837.2900000002701,0.0,0.0,108862,23.09.2014 23:15:00,10832,-0.3860632143299188,-56.14,IS,0.27,0.0,Phase3-EA-S1v2-USDJPY-M15-0,USDJPYMT4,3074,13h 0m,Buy
126048.2,1.20801,25.09.2014 07:15:00,,-6.5,-830.7900000002701,0.0,0.0,1.20831,24.09.2014 22:55:00,10833,-0.3830661513133491,6.5,IS,0.41,0.0,Phase3-EA-SA2v2-EURCHF-M5-43,EURCHFMT4,5514,8h 20m,Sell
126072.42,178258,25.09.2014 08:30:00,,0.0,-806.5700000002689,0.0,0.0,178373,25.09.2014 03:05:00,10834,-0.3718986334269918,24.22,IS,0.23,0.0,Phase3-EA-S4v1-GBPJPY-M5-194,GBPJPYMT4,2506,5h 25m,Sell
126106.78,1.20776,25.09.2014 11:15:00,,0.0,-772.2100000002829,0.0,0.0,1.20872,25.09.2014 02:30:00,10835,-0.3560556972347928,34.36,IS,0.34,0.0,Phase3-EA-S4v1-EURCHF-M15-221,EURCHFMT4,2884,8h 45m,Sell
126041.06,138443,25.09.2014 17:59:58,sl 138.443,-1.21,-837.930000000284,0.0,0.0,139223,24.09.2014 19:30:00,10836,-0.38635830976540286,-65.72,IS,0.09,0.0,Phase3-EA-TR1v1-EURJPY-M30-91,EURJPYMT4,1878,22h 29m,Buy
126057.83,108646,26.09.2014 02:00:00,,-1.12,-821.1600000002945,0.0,0.0,108718,25.09.2014 23:15:00,10837,-0.3786258871826578,16.77,IS,0.27,0.0,Phase3-EA-S1v2-USDJPY-M15-0,USDJPYMT4,3076,2h 45m,Sell
126061.73,1.20712,26.09.2014 04:25:00,,-2.17,-817.2600000003004,0.0,0.0,1.20726,25.09.2014 20:05:00,10838,-0.3768276493727187,3.9,IS,0.41,0.0,Phase3-EA-SA2v2-EURCHF-M5-43,EURCHFMT4,5516,8h 20m,Sell
126010.63,177642,26.09.2014 05:30:00,,0.0,-868.3600000003062,0.0,0.0,177.4,26.09.2014 00:05:00,10839,-0.4003891755491387,-51.1,IS,0.23,0.0,Phase3-EA-S4v1-GBPJPY-M5-194,GBPJPYMT4,2508,5h 25m,Sell
126023.19,1.20695,26.09.2014 10:15:00,,0.0,-855.8000000003085,0.0,0.0,1.2073,26.09.2014 01:30:00,10840,-0.3945979276278912,12.56,IS,0.34,0.0,Phase3-EA-S4v1-EURCHF-M15-221,EURCHFMT4,2886,8h 45m,Sell
126037.66,1.20704,29.09.2014 06:20:00,,-1.03,-841.3300000003073,0.0,0.0,1.20668,26.09.2014 22:00:00,10841,-0.3879260042663885,14.47,IS,0.41,0.0,Phase3-EA-SA2v2-EURCHF-M5-43,EURCHFMT4,5518,2d 8h 20m,Buy
126021.75,109423,30.09.2014 02:15:00,,-1.11,-857.2400000003108,0.0,0.0,109363,29.09.2014 18:30:00,10842,-0.39526189235771697,-15.91,IS,0.27,0.0,Phase3-EA-S1v2-USDJPY-M15-0,USDJPYMT4,3078,7h 45m,Sell
126025.2,1.20678,30.09.2014 05:30:00,,-2.15,-853.7900000002992,0.0,0.0,1.20691,29.09.2014 21:10:00,10843,-0.39367114352584,3.45,IS,0.41,0.0,Phase3-EA-SA2v2-EURCHF-M5-43,EURCHFMT4,5520,8h 20m,Sell
126080.49,177825,30.09.2014 08:55:00,,0.0,-798.500000000291,0.0,0.0,177562,30.09.2014 03:30:00,10844,-0.3681776644202762,55.29,IS,0.23,0.0,Phase3-EA-S4v1-GBPJPY-M5-194,GBPJPYMT4,2510,5h 25m,Buy
126095.01,109682,30.09.2014 22:45:00,,0.0,-783.9800000003015,0.0,0.0,109623,30.09.2014 17:00:00,10845,-0.36148268672788225,14.52,IS,0.27,0.0,Phase3-EA-S1v2-USDJPY-M15-0,USDJPYMT4,3080,5h 45m,Buy
126106.42,1.20602,01.10.2014 04:25:00,,-1.03,-772.570000000298,0.0,0.0,1.20573,30.09.2014 20:05:00,10846,-0.35622168841725593,11.41,IS,0.41,0.0,Phase3-EA-SA2v2-EURCHF-M5-43,EURCHFMT4,5522,8h 20m,Buy
126041.13,137892,01.10.2014 18:59:58,sl 137.892,-1.2,-837.8600000003062,0.0,0.0,138672,26.09.2014 01:00:00,10847,-0.3863260337021577,-65.29,IS,0.09,0.0,Phase3-EA-TR1v1-EURJPY-M30-91,EURJPYMT4,1880,5d 17h 59m,Buy
126303.53,137622,01.10.2014 21:59:57,tp 137.622,-2.17,-575.460000000312,0.0,0.0,139322,25.09.2014 07:00:00,10848,-0.26533690515633035,262.4,IS,0.17,0.0,Phase3-EA-T1v2-EURJPY-M15-322,EURJPYMT4,1970,6d 14h 59m,Sell
126304.82,1.20693,02.10.2014 04:20:00,,-6.43,-574.1700000003038,0.0,0.0,1.20711,01.10.2014 20:00:00,10849,-0.264742103419192,1.29,IS,0.41,0.0,Phase3-EA-SA2v2-EURCHF-M5-43,EURCHFMT4,5524,8h 20m,Sell
126252.59,1.20868,02.10.2014 15:15:00,,0.0,-626.4000000003143,0.0,0.0,1.20721,02.10.2014 06:30:00,10850,-0.28882465747387936,-52.23,IS,0.34,0.0,Phase3-EA-S4v1-EURCHF-M15-221,EURCHFMT4,2888,8h 45m,Sell
126216.61,137642,02.10.2014 16:14:57,sl 137.642,0.0,-662.3800000003248,0.0,0.0,137412,02.10.2014 09:00:00,10851,-0.30541455398714246,-35.98,IS,0.17,0.0,Phase3-EA-T1v2-EURJPY-M15-322,EURJPYMT4,1972,7h 14m,Sell
126241.25,108495,02.10.2014 18:00:00,,0.0,-637.7400000003108,0.0,0.0,108594,02.10.2014 17:00:00,10852,-0.2940533797212471,24.64,IS,0.27,0.0,Phase3-EA-S1v2-USDJPY-M15-0,USDJPYMT4,3082,1h 0m,Sell
126394.68,174402,02.10.2014 18:59:58,tp 174.402,0.0,-484.3100000003178,0.0,0.0,176252,02.10.2014 05:30:00,10853,-0.22330885993166688,153.43,IS,0.09,0.0,Phase3-EA-B1v1-GBPJPY-M30-1,GBPJPYMT4,1022,13h 29m,Sell
126358.08,137505,03.10.2014 02:59:57,sl 137.505,-0.55,-520.9100000003236,0.0,0.0,137275,02.10.2014 18:00:00,10854,-0.24018463014804675,-36.6,IS,0.17,0.0,Phase3-EA-T1v2-EURJPY-M15-322,EURJPYMT4,1974,8h 59m,Sell
126340.88,0.95437,03.10.2014 03:30:00,,-3.22,-538.1100000003353,0.0,0.0,0.95414,02.10.2014 23:15:00,10855,-0.24811531997651354,-17.2,IS,0.58,0.0,Phase3-EA-SA2v2-USDCHF-M15-107,USDCHFMT4,2114,4h 15m,Sell
126319.41,1.20877,03.10.2014 04:50:00,,-2.15,-559.5800000003364,0.0,0.0,1.20832,02.10.2014 20:30:00,10856,-0.25801484966355287,-21.47,IS,0.41,0.0,Phase3-EA-SA2v2-EURCHF-M5-43,EURCHFMT4,5526,8h 20m,Sell
126256.86,175619,03.10.2014 08:25:00,,0.0,-622.1300000003248,0.0,0.0,175323,03.10.2014 03:00:00,10857,-0.2868558176153069,-62.55,IS,0.23,0.0,Phase3-EA-S4v1-GBPJPY-M5-194,GBPJPYMT4,2512,5h 25m,Sell
126161.42,108777,03.10.2014 10:30:00,,-1.12,-717.5700000003271,0.0,0.0,108397,02.10.2014 22:00:00,10858,-0.33086192443091017,-95.44,IS,0.27,0.0,Phase3-EA-S1v2-USDJPY-M15-0,USDJPYMT4,3084,12h 30m,Sell
126157.52,1.20886,03.10.2014 14:15:00,,0.0,-721.4700000003213,0.0,0.0,1.20875,03.10.2014 05:30:00,10859,-0.3326601622408493,-3.9,IS,0.34,0.0,Phase3-EA-S4v1-EURCHF-M15-221,EURCHFMT4,2890,8h 45m,Sell
126188.66,109.68,06.10.2014 03:15:00,,-1.11,-690.3300000003073,0.0,0.0,109811,03.10.2014 21:45:00,10860,-0.3183019249583842,31.14,IS,0.27,0.0,Phase3-EA-S1v2-USDJPY-M15-0,USDJPYMT4,3086,2d 5h 30m,Sell
126248.64,0.96702,06.10.2014 04:29:58,tp 0.96702,0.0,-630.3500000002969,0.0,0.0,0.96802,06.10.2014 02:15:00,10861,-0.29064594961470985,59.98,IS,0.58,0.0,Phase3-EA-SA2v2-USDCHF-M15-107,USDCHFMT4,2116,2h 14m,Sell
126256.94,1.21075,06.10.2014 06:40:00,,-1.02,-622.0500000003085,0.0,0.0,1.21053,03.10.2014 22:20:00,10862,-0.28681893068586467,8.3,IS,0.41,0.0,Phase3-EA-SA2v2-EURCHF-M5-43,EURCHFMT4,5528,2d 8h 20m,Buy
126223.88,1.21195,06.10.2014 11:00:00,,0.0,-655.1100000003062,0.0,0.0,1.21101,06.10.2014 02:15:00,10863,-0.30206245427475514,-33.06,IS,0.34,0.0,Phase3-EA-S4v1-EURCHF-M15-221,EURCHFMT4,2892,8h 45m,Sell
126188.02,137555,06.10.2014 21:44:58,sl 137.555,0.0,-690.9700000002922,0.0,0.0,137325,06.10.2014 04:00:00,10864,-0.3185970203938549,-35.86,IS,0.17,0.0,Phase3-EA-T1v2-EURJPY-M15-322,EURJPYMT4,1976,17h 44m,Sell
126195.27,1.21268,07.10.2014 05:00:00,,-2.14,-683.7200000002922,0.0,0.0,1.2129,06.10.2014 20:40:00,10865,-0.3152541424138348,7.25,IS,0.41,0.0,Phase3-EA-SA2v2-EURCHF-M5-43,EURCHFMT4,5530,8h 20m,Sell
126277.6,174683,07.10.2014 07:44:58,tp 174.683,0.0,-601.390000000305,0.0,0.0,175073,07.10.2014 02:45:00,10866,-0.2772928811593507,82.33,IS,0.23,0.0,Phase3-EA-S4v1-GBPJPY-M5-194,GBPJPYMT4,2514,4h 59m,Sell
126328.79,108124,07.10.2014 21:30:00,,0.0,-550.2000000003027,0.0,0.0,108329,07.10.2014 20:30:00,10867,-0.2536898571873182,51.19,IS,0.27,0.0,Phase3-EA-S1v2-USDJPY-M15-0,USDJPYMT4,3088,1h 0m,Sell
126389.36,0.95754,08.10.2014 03:14:58,tp 0.95754,0.0,-489.6300000002957,0.0,0.0,0.95654,08.10.2014 02:45:00,10868,-0.2257618407390645,60.57,IS,0.58,0.0,Phase3-EA-SA2v2-USDCHF-M15-107,USDCHFMT4,2118,29m 58s,Buy
126472.2,174155,08.10.2014 04:09:57,tp 174.155,0.0,-406.7900000002992,0.0,0.0,173765,08.10.2014 02:25:00,10869,-0.18756542530942985,82.84,IS,0.23,0.0,Phase3-EA-S4v1-GBPJPY-M5-194,GBPJPYMT4,2516,1h 44m,Buy
126451.92,1.2118,08.10.2014 05:35:00,,-1.03,-427.070000000298,0.0,0.0,1.21225,07.10.2014 21:15:00,10870,-0.19691626192112685,-20.28,IS,0.41,0.0,Phase3-EA-SA2v2-EURCHF-M5-43,EURCHFMT4,5532,8h 20m,Buy
126396.35,174292,08.10.2014 08:59:57,sl 174.292,0.0,-482.640000000305,0.0,0.0,173622,08.10.2014 02:30:00,10871,-0.22253884527971152,-55.57,IS,0.09,0.0,Phase3-EA-B1v1-GBPJPY-M30-1,GBPJPYMT4,1024,6h 29m,Sell
126360.18,137003,08.10.2014 13:14:58,sl 137.003,0.0,-518.8100000003178,0.0,0.0,136773,08.10.2014 10:00:00,10872,-0.2392163482503831,-36.17,IS,0.17,0.0,Phase3-EA-T1v2-EURJPY-M15-322,EURJPYMT4,1978,3h 14m,Sell
126324.09,136934,08.10.2014 15:29:57,sl 136.934,0.0,-554.9000000003143,0.0,0.0,137164,08.10.2014 14:00:00,10873,-0.2558569642916124,-36.09,IS,0.17,0.0,Phase3-EA-T1v2-EURJPY-M15-322,EURJPYMT4,1980,1h 29m,Buy
126378.34,1.21333,08.10.2014 15:30:00,,0.0,-500.6500000003143,0.0,0.0,1.2118,08.10.2014 06:45:00,10874,-0.2308430152687036,54.25,IS,0.34,0.0,Phase3-EA-S4v1-EURCHF-M15-221,EURCHFMT4,2894,8h 45m,Buy
126351.99,1.21198,09.10.2014 06:00:00,,-3.1,-527.0000000003201,0.0,0.0,1.21252,08.10.2014 21:40:00,10875,-0.24299264765126202,-26.35,IS,0.41,0.0,Phase3-EA-SA2v2-EURCHF-M5-43,EURCHFMT4,5534,8h 20m,Buy
126315.7,137488,09.10.2014 13:29:59,sl 137.488,0.0,-563.2900000003283,0.0,0.0,137718,09.10.2014 12:00:00,10876,-0.2597254810160835,-36.29,IS,0.17,0.0,Phase3-EA-T1v2-EURJPY-M15-322,EURJPYMT4,1982,1h 29m,Buy
126337.98,107951,10.10.2014 01:45:00,,-0.73,-541.0100000003295,0.0,0.0,107859,09.10.2014 21:00:00,10877,-0.2494524711685189,22.28,IS,0.27,0.0,Phase3-EA-S1v2-USDJPY-M15-0,USDJPYMT4,3090,4h 45m,Buy
126305.28,1.21141,10.10.2014 04:30:00,,-2.15,-573.7100000003411,0.0,0.0,1.2107,09.10.2014 20:10:00,10878,-0.26453000357495965,-32.7,IS,0.41,0.0,Phase3-EA-SA2v2-EURCHF-M5-43,EURCHFMT4,5536,8h 20m,Sell
126320.22,173744,10.10.2014 08:45:00,,0.0,-558.7700000003388,0.0,0.0,173674,10.10.2014 03:20:00,10879,-0.2576413695030275,14.94,IS,0.23,0.0,Phase3-EA-S4v1-GBPJPY-M5-194,GBPJPYMT4,2518,5h 25m,Buy
126422.22,136358,10.10.2014 13:29:58,tp 136.358,-3.19,-456.77000000033877,0.0,0.0,137618,01.10.2014 22:30:00,10880,-0.2106105344737796,102.0,IS,0.09,0.0,Phase3-EA-TR1v1-EURJPY-M30-91,EURJPYMT4,1882,8d 14h 59m,Sell
126490.2,1.20951,10.10.2014 13:45:00,,0.0,-388.7900000003283,0.0,0.0,1.21142,10.10.2014 05:00:00,10881,-0.17926586618663481,67.98,IS,0.34,0.0,Phase3-EA-S4v1-EURCHF-M15-221,EURCHFMT4,2896,8h 45m,Sell
126522.51,107805,10.10.2014 22:15:00,,0.0,-356.4800000003306,0.0,0.0,107934,10.10.2014 17:45:00,10882,-0.1643681575611947,32.31,IS,0.27,0.0,Phase3-EA-S1v2-USDJPY-M15-0,USDJPYMT4,3092,4h 30m,Sell
126790.73,135.69,13.10.2014 01:14:58,tp 135.690,-1.1,-88.26000000032946,0.0,0.0,137.39,09.10.2014 13:45:00,10883,-0.0406955048989894,268.22,IS,0.17,0.0,Phase3-EA-T1v2-EURJPY-M15-322,EURJPYMT4,1984,3d 11h 29m,Sell
126784.12,1.20894,13.10.2014 04:20:00,,-1.03,-94.87000000031549,0.0,0.0,1.20907,10.10.2014 20:00:00,10884,-0.043743287443525396,-6.61,IS,0.41,0.0,Phase3-EA-SA2v2-EURCHF-M5-43,EURCHFMT4,5538,2d 8h 20m,Buy
126546.58,0.95227,13.10.2014 05:44:57,sl 0.95227,0.0,-332.41000000032363,0.0,0.0,0.95617,13.10.2014 02:15:00,10885,-0.15326980266752482,-237.54,IS,0.58,0.0,Phase3-EA-SA2v2-USDCHF-M15-107,USDCHFMT4,2120,3h 29m,Buy
126519.5,1.20795,13.10.2014 10:00:00,,0.0,-359.49000000031083,0.0,0.0,1.20871,13.10.2014 01:15:00,10886,-0.1657560282811663,-27.08,IS,0.34,0.0,Phase3-EA-S4v1-EURCHF-M15-221,EURCHFMT4,2898,8h 45m,Buy
126281.07,0.94871,13.10.2014 23:44:58,sl 0.94871,0.0,-597.9200000003038,0.0,0.0,0.95261,13.10.2014 23:00:00,10887,-0.27569291059511986,-238.43,IS,0.58,0.0,Phase3-EA-SA2v2-USDCHF-M15-107,USDCHFMT4,2122,44m 58s,Buy
126341.43,0.94941,14.10.2014 02:44:57,tp 0.94941,-0.73,-537.5600000003178,0.0,0.0,0.94841,13.10.2014 23:45:00,10888,-0.24786172233664192,60.36,IS,0.58,0.0,Phase3-EA-SA2v2-USDCHF-M15-107,USDCHFMT4,2124,2h 59m,Buy
126372.41,172301,14.10.2014 04:35:00,,-0.78,-506.58000000030734,0.0,0.0,172153,13.10.2014 23:10:00,10889,-0.23357725891304784,30.98,IS,0.23,0.0,Phase3-EA-S4v1-GBPJPY-M5-194,GBPJPYMT4,2520,5h 25m,Buy
126356.01,1.2089,14.10.2014 05:25:00,,-2.16,-522.9800000003015,0.0,0.0,1.20857,13.10.2014 21:05:00,10890,-0.24113907944715954,-16.4,IS,0.41,0.0,Phase3-EA-SA2v2-EURCHF-M5-43,EURCHFMT4,5540,8h 20m,Sell
126327.13,136133,14.10.2014 10:00:00,,0.0,-551.8600000003062,0.0,0.0,136315,14.10.2014 00:15:00,10891,-0.2544552609730899,-28.88,IS,0.17,0.0,Phase3-EA-T1v2-EURJPY-M15-322,EURJPYMT4,1986,9h 45m,Buy
126482.3,170722,14.10.2014 12:29:58,tp 170.722,-0.49,-396.69000000029337,0.0,0.0,172572,13.10.2014 04:30:00,10892,-0.18290845046829574,155.17,IS,0.09,0.0,Phase3-EA-B1v1-GBPJPY-M30-1,GBPJPYMT4,1026,1d 7h 59m,Sell
126484.07,107.05,14.10.2014 21:45:00,,0.0,-394.92000000030384,0.0,0.0,107057,14.10.2014 18:00:00,10893,-0.18209232715455775,1.77,IS,0.27,0.0,Phase3-EA-S1v2-USDJPY-M15-0,USDJPYMT4,3094,3h 45m,Sell
126447.01,135614,15.10.2014 00:29:58,sl 135.614,-0.56,-431.9800000003015,0.0,0.0,135384,14.10.2014 21:30:00,10894,-0.19918019721518343,-37.06,IS,0.17,0.0,Phase3-EA-T1v2-EURJPY-M15-322,EURJPYMT4,1988,2h 59m,Sell
126507.04,0.9545,15.10.2014 01:14:57,tp 0.95450,-0.73,-371.9500000003027,0.0,0.0,0.9535,14.10.2014 23:45:00,10895,-0.17150116754061775,60.03,IS,0.58,0.0,Phase3-EA-SA2v2-USDCHF-M15-107,USDCHFMT4,2126,1h 29m,Buy
126473.04,0.95519,15.10.2014 05:45:00,,0.0,-405.9500000003027,0.0,0.0,0.95463,15.10.2014 01:30:00,10896,-0.18717811255036707,-34.0,IS,0.58,0.0,Phase3-EA-SA2v2-USDCHF-M15-107,USDCHFMT4,2128,4h 15m,Sell
126472.01,1.20709,15.10.2014 06:20:00,,-1.03,-406.9800000003015,0.0,0.0,1.20709,14.10.2014 22:00:00,10897,-0.18765303176683834,-1.03,IS,0.41,0.0,Phase3-EA-SA2v2-EURCHF-M5-43,EURCHFMT4,5542,8h 20m,Buy
126435.53,135577,15.10.2014 06:44:58,sl 135.577,0.0,-443.460000000312,0.0,0.0,135347,15.10.2014 04:30:00,10898,-0.2044734715890683,-36.48,IS,0.17,0.0,Phase3-EA-T1v2-EURJPY-M15-322,EURJPYMT4,1990,2h 14m,Sell
126398.75,135621,15.10.2014 16:29:58,sl 135.621,0.0,-480.24000000031083,0.0,0.0,135391,15.10.2014 14:30:00,10899,-0.22143223739667306,-36.78,IS,0.17,0.0,Phase3-EA-T1v2-EURJPY-M15-322,EURJPYMT4,1992,1h 59m,Sell
126414.69,105896,16.10.2014 03:15:00,,-3.44,-464.3000000003085,0.0,0.0,105972,15.10.2014 21:45:00,10900,-0.21408251670680717,15.94,IS,0.27,0.0,Phase3-EA-S1v2-USDJPY-M15-0,USDJPYMT4,3096,5h 30m,Sell
126459.47,1.20747,16.10.2014 03:24:57,tp 1.20747,-3.14,-419.52000000030966,0.0,0.0,1.20637,15.10.2014 22:10:00,10901,-0.193435057955732,44.78,IS,0.41,0.0,Phase3-EA-SA2v2-EURCHF-M5-43,EURCHFMT4,5544,5h 14m,Buy
126544.18,169713,16.10.2014 03:59:58,tp 169.713,0.0,-334.8100000003178,0.0,0.0,169323,16.10.2014 03:10:00,10902,-0.15437641055056325,84.71,IS,0.23,0.0,Phase3-EA-S4v1-GBPJPY-M5-194,GBPJPYMT4,2522,49m 58s,Buy
126547.42,1.2068,16.10.2014 10:00:00,,0.0,-331.5700000003271,0.0,0.0,1.20689,16.10.2014 01:15:00,10903,-0.15288248990846204,3.24,IS,0.34,0.0,Phase3-EA-S4v1-EURCHF-M15-221,EURCHFMT4,2900,8h 45m,Sell
126505.42,1.59797,16.10.2014 12:59:58,sl 1.59797,0.0,-373.5700000003271,0.0,0.0,1.60097,16.10.2014 11:30:00,10904,-0.17224812786168178,-42.0,IS,0.14,0.0,Phase3-EA-B1v1-GBPUSD-M30-14,GBPUSDMT4,718,1h 29m,Buy
126610.84,134885,16.10.2014 13:29:58,tp 134.885,-1.76,-268.1500000003143,0.0,0.0,136145,10.10.2014 15:30:00,10905,-0.12364037659909431,105.42,IS,0.09,0.0,Phase3-EA-TR1v1-EURJPY-M30-91,EURJPYMT4,1884,5d 21h 59m,Sell
126549.79,135387,16.10.2014 17:29:58,sl 135.387,0.0,-329.2000000003027,0.0,0.0,134667,16.10.2014 14:00:00,10906,-0.15178971462394764,-61.05,IS,0.09,0.0,Phase3-EA-TR1v1-EURJPY-M30-91,EURJPYMT4,1886,3h 29m,Sell
126634.23,170978,17.10.2014 03:24:58,tp 170.978,0.0,-244.76000000030035,0.0,0.0,171368,17.10.2014 02:25:00,10907,-0.11285556060561622,84.44,IS,0.23,0.0,Phase3-EA-S4v1-GBPJPY-M5-194,GBPJPYMT4,2524,59m 58s,Sell
126561.49,106337,17.10.2014 04:15:00,,-1.14,-317.50000000029104,0.0,0.0,106055,16.10.2014 17:00:00,10908,-0.14639500119411678,-72.74,IS,0.27,0.0,Phase3-EA-S1v2-USDJPY-M15-0,USDJPYMT4,3098,11h 15m,Sell
126561.32,1.20732,17.10.2014 08:05:00,,-1.04,-317.67000000030384,0.0,0.0,1.2073,16.10.2014 23:45:00,10909,-0.14647338591917142,-0.17,IS,0.41,0.0,Phase3-EA-SA2v2-EURCHF-M5-43,EURCHFMT4,5546,8h 20m,Buy
126614.62,106884,17.10.2014 22:30:00,,0.0,-264.3700000003155,0.0,0.0,106673,17.10.2014 21:45:00,10910,-0.12189746918330507,53.3,IS,0.27,0.0,Phase3-EA-S1v2-USDJPY-M15-0,USDJPYMT4,3100,45m 0s,Buy
126552.58,0.94706,20.10.2014 03:00:00,,-3.25,-326.41000000032363,0.0,0.0,0.9461,17.10.2014 22:45:00,10911,-0.150503282959922,-62.04,IS,0.58,0.0,Phase3-EA-SA2v2-USDCHF-M15-107,USDCHFMT4,2130,2d 4h 15m,Sell
126545.64,1.20775,20.10.2014 04:50:00,,-2.17,-333.35000000032596,0.0,0.0,1.20764,17.10.2014 20:30:00,10912,-0.15370322408838366,-6.94,IS,0.41,0.0,Phase3-EA-SA2v2-EURCHF-M5-43,EURCHFMT4,5548,2d 8h 20m,Sell
126479.83,136758,20.10.2014 04:59:58,sl 136.758,-0.29,-399.16000000032363,0.0,0.0,135978,17.10.2014 08:00:00,10913,-0.1840473344146062,-65.81,IS,0.09,0.0,Phase3-EA-TR1v1-EURJPY-M30-91,EURJPYMT4,1888,2d 20h 59m,Sell
126359.22,172935,20.10.2014 07:00:00,,0.0,-519.7700000003097,0.0,0.0,172372,20.10.2014 01:35:00,10914,-0.23965899140359578,-120.61,IS,0.23,0.0,Phase3-EA-S4v1-GBPJPY-M5-194,GBPJPYMT4,2526,5h 25m,Sell
126389.08,136609,20.10.2014 11:45:00,,-0.78,-489.91000000032363,0.0,0.0,136416,17.10.2014 23:15:00,10915,-0.22589094499209886,29.86,IS,0.17,0.0,Phase3-EA-T1v2-EURJPY-M15-322,EURJPYMT4,1994,2d 12h 30m,Buy
126442.0,1.20616,20.10.2014 14:00:00,,0.0,-436.99000000031083,0.0,0.0,1.20763,20.10.2014 05:15:00,10916,-0.2014902411710361,52.92,IS,0.34,0.0,Phase3-EA-S4v1-EURCHF-M15-221,EURCHFMT4,2902,8h 45m,Sell
126444.18,1.20645,21.10.2014 05:10:00,,-2.17,-434.8100000003178,0.0,0.0,1.20655,20.10.2014 20:50:00,10917,-0.2004850723439436,2.18,IS,0.41,0.0,Phase3-EA-SA2v2-EURCHF-M5-43,EURCHFMT4,5550,8h 20m,Sell
126382.83,136265,21.10.2014 08:29:57,sl 136.265,-0.41,-496.16000000032363,0.0,0.0,136985,20.10.2014 07:00:00,10918,-0.22877273635418513,-61.35,IS,0.09,0.0,Phase3-EA-TR1v1-EURJPY-M30-91,EURJPYMT4,1890,1d 1h 29m,Buy
126401.17,1.20695,21.10.2014 13:45:00,,0.0,-477.8200000003271,0.0,0.0,1.20644,21.10.2014 05:00:00,10919,-0.22031640778128078,18.34,IS,0.34,0.0,Phase3-EA-S4v1-EURCHF-M15-221,EURCHFMT4,2904,8h 45m,Buy
126419.63,106785,21.10.2014 21:30:00,,0.0,-459.3600000003353,0.0,0.0,106712,21.10.2014 17:00:00,10920,-0.21180474881422653,18.46,IS,0.27,0.0,Phase3-EA-S1v2-USDJPY-M15-0,USDJPYMT4,3102,4h 30m,Buy
126372.4,0.94936,22.10.2014 03:30:00,,-3.24,-506.59000000034575,0.0,0.0,0.94864,21.10.2014 23:15:00,10921,-0.2335818697792449,-47.23,IS,0.58,0.0,Phase3-EA-SA2v2-USDCHF-M15-107,USDCHFMT4,2132,4h 15m,Sell
126456.35,172233,22.10.2014 04:39:58,tp 172.233,0.0,-422.6400000003341,0.0,0.0,172623,22.10.2014 00:45:00,10922,-0.19487364820369674,83.95,IS,0.23,0.0,Phase3-EA-S4v1-GBPJPY-M5-194,GBPJPYMT4,2528,3h 54m,Sell
126473.22,1.20702,22.10.2014 10:00:00,,0.0,-405.77000000033877,0.0,0.0,1.20663,22.10.2014 01:40:00,10923,-0.18709511695915562,16.87,IS,0.41,0.0,Phase3-EA-SA2v2-EURCHF-M5-43,EURCHFMT4,5552,8h 20m,Buy
126480.38,1.20675,22.10.2014 11:00:00,,0.0,-398.6100000003353,0.0,0.0,1.20655,22.10.2014 02:15:00,10924,-0.18379373677474797,7.16,IS,0.34,0.0,Phase3-EA-S4v1-EURCHF-M15-221,EURCHFMT4,2906,8h 45m,Buy
126477.69,107.18,23.10.2014 04:00:00,,-2.19,-401.3000000003376,0.0,0.0,107182,22.10.2014 20:45:00,10925,-0.18503405977699097,-2.69,IS,0.27,0.0,Phase3-EA-S1v2-USDJPY-M15-0,USDJPYMT4,3104,7h 15m,Buy
126487.05,1.20631,23.10.2014 05:15:00,,-3.1,-391.9400000003516,0.0,0.0,1.20602,22.10.2014 20:55:00,10926,-0.18071828903313703,9.36,IS,0.41,0.0,Phase3-EA-SA2v2-EURCHF-M5-43,EURCHFMT4,5554,8h 20m,Buy
126449.0,136166,23.10.2014 11:29:58,sl 136.166,-1.67,-429.99000000033993,0.0,0.0,135936,22.10.2014 10:30:00,10927,-0.19826263484551288,-38.05,IS,0.17,0.0,Phase3-EA-T1v2-EURJPY-M15-322,EURJPYMT4,1996,1d 0h 59m,Sell
126435.44,1.20658,23.10.2014 12:45:00,,0.0,-443.5500000003376,0.0,0.0,1.2062,23.10.2014 04:00:00,10928,-0.20451496938469418,-13.56,IS,0.34,0.0,Phase3-EA-S4v1-EURCHF-M15-221,EURCHFMT4,2908,8h 45m,Sell
126374.05,136486,23.10.2014 15:29:58,sl 136.486,-1.17,-504.9400000003516,0.0,0.0,135766,21.10.2014 19:00:00,10929,-0.2328210768596568,-61.39,IS,0.09,0.0,Phase3-EA-TR1v1-EURJPY-M30-91,EURJPYMT4,1892,1d 20h 29m,Sell
126455.8,173173,24.10.2014 03:34:57,tp 173.173,-1.23,-423.1900000003516,0.0,0.0,173563,23.10.2014 23:45:00,10930,-0.1951272458435684,81.75,IS,0.23,0.0,Phase3-EA-S4v1-GBPJPY-M5-194,GBPJPYMT4,2530,3h 49m,Sell
126446.6,1.20632,24.10.2014 05:30:00,,-1.03,-432.3900000003632,0.0,0.0,1.20651,23.10.2014 21:10:00,10931,-0.19936924272856474,-9.2,IS,0.41,0.0,Phase3-EA-SA2v2-EURCHF-M5-43,EURCHFMT4,5556,8h 20m,Buy
126471.53,173176,24.10.2014 09:15:00,,0.0,-407.4600000003702,0.0,0.0,173059,24.10.2014 03:50:00,10932,-0.18787435334347824,24.93,IS,0.23,0.0,Phase3-EA-S4v1-GBPJPY-M5-194,GBPJPYMT4,2532,5h 25m,Buy
126468.06,108094,24.10.2014 10:00:00,,-0.72,-410.93000000037136,0.0,0.0,108105,23.10.2014 22:15:00,10933,-0.18947432390770907,-3.47,IS,0.27,0.0,Phase3-EA-S1v2-USDJPY-M15-0,USDJPYMT4,3106,11h 45m,Buy
126460.93,1.20616,24.10.2014 13:15:00,,0.0,-418.060000000376,0.0,0.0,1.20636,24.10.2014 04:30:00,10934,-0.19276187149357923,-7.13,IS,0.34,0.0,Phase3-EA-S4v1-EURCHF-M15-221,EURCHFMT4,2910,8h 45m,Buy
126424.73,136.6,24.10.2014 15:14:58,sl 136.600,0.0,-454.26000000038766,0.0,0.0,136.83,24.10.2014 11:00:00,10935,-0.20945320706278828,-36.2,IS,0.17,0.0,Phase3-EA-T1v2-EURJPY-M15-322,EURJPYMT4,1998,4h 14m,Buy
126507.87,173712,27.10.2014 05:44:58,tp 173.712,0.0,-371.1200000003737,0.0,0.0,174102,27.10.2014 02:30:00,10936,-0.17111846564776542,83.14,IS,0.23,0.0,Phase3-EA-S4v1-GBPJPY-M5-194,GBPJPYMT4,2534,3h 14m,Sell
126487.14,1.20653,27.10.2014 06:20:00,,-2.16,-391.85000000038417,0.0,0.0,1.2061,24.10.2014 22:00:00,10937,-0.180676791237538,-20.73,IS,0.41,0.0,Phase3-EA-SA2v2-EURCHF-M5-43,EURCHFMT4,5558,2d 8h 20m,Sell
126380.25,0.94959,27.10.2014 07:00:00,,0.0,-498.74000000039814,0.0,0.0,0.95134,27.10.2014 02:45:00,10938,-0.22996233982848868,-106.89,IS,0.58,0.0,Phase3-EA-SA2v2-USDCHF-M15-107,USDCHFMT4,2134,4h 15m,Buy
126405.56,1.20591,28.10.2014 04:35:00,,-1.04,-473.43000000040047,0.0,0.0,1.2053,27.10.2014 20:15:00,10939,-0.2182922375285852,25.31,IS,0.41,0.0,Phase3-EA-SA2v2-EURCHF-M5-43,EURCHFMT4,5560,8h 20m,Buy
126466.71,0.9485,28.10.2014 04:59:58,tp 0.94850,0.0,-412.2800000004063,0.0,0.0,0.9495,28.10.2014 01:00:00,10940,-0.19009679084193581,61.15,IS,0.58,0.0,Phase3-EA-SA2v2-USDCHF-M15-107,USDCHFMT4,2136,3h 59m,Sell
126454.56,173.96,28.10.2014 08:05:00,,0.0,-424.43000000040047,0.0,0.0,173903,28.10.2014 02:40:00,10941,-0.19569899324982884,-12.15,IS,0.23,0.0,Phase3-EA-S4v1-GBPJPY-M5-194,GBPJPYMT4,2536,5h 25m,Sell
126450.98,1.20583,28.10.2014 10:30:00,,0.0,-428.01000000038766,0.0,0.0,1.20573,28.10.2014 01:45:00,10942,-0.19734968334202596,-3.58,IS,0.34,0.0,Phase3-EA-S4v1-EURCHF-M15-221,EURCHFMT4,2912,8h 45m,Sell
126446.91,1.20594,29.10.2014 05:25:00,,-1.04,-432.08000000039465,0.0,0.0,1.20601,28.10.2014 21:05:00,10943,-0.19922630587701975,-4.07,IS,0.41,0.0,Phase3-EA-SA2v2-EURCHF-M5-43,EURCHFMT4,5562,8h 20m,Buy
126423.01,0.9465,29.10.2014 06:15:00,,0.0,-455.9800000003888,0.0,0.0,0.94689,29.10.2014 02:00:00,10944,-0.21024627604563498,-23.9,IS,0.58,0.0,Phase3-EA-SA2v2-USDCHF-M15-107,USDCHFMT4,2138,4h 15m,Buy
126423.86,174517,29.10.2014 08:20:00,,0.0,-455.130000000383,0.0,0.0,174521,29.10.2014 02:55:00,10945,-0.20985435242038855,0.85,IS,0.23,0.0,Phase3-EA-S4v1-GBPJPY-M5-194,GBPJPYMT4,2538,5h 25m,Sell
126504.76,137646,29.10.2014 09:45:00,,-0.77,-374.2300000003888,0.0,0.0,137127,28.10.2014 10:30:00,10946,-0.17255244502954653,80.9,IS,0.17,0.0,Phase3-EA-T1v2-EURJPY-M15-322,EURJPYMT4,2000,23h 15m,Buy
126505.84,1.20592,29.10.2014 12:15:00,,0.0,-373.15000000040163,0.0,0.0,1.20589,29.10.2014 03:30:00,10947,-0.17205447148218395,1.08,IS,0.34,0.0,Phase3-EA-S4v1-EURCHF-M15-221,EURCHFMT4,2914,8h 45m,Buy
126456.4,1.59875,30.10.2014 03:29:58,sl 1.59875,-7.44,-422.59000000040396,0.0,0.0,1.60175,16.10.2014 16:30:00,10948,-0.19485059387283224,-49.44,IS,0.14,0.0,Phase3-EA-B1v1-GBPUSD-M30-14,GBPUSDMT4,720,13d 10h 59m,Buy
126475.2,1.20602,30.10.2014 05:20:00,,-3.09,-403.7900000004156,0.0,0.0,1.20551,29.10.2014 21:00:00,10949,-0.1861821654556821,18.8,IS,0.41,0.0,Phase3-EA-SA2v2-EURCHF-M5-43,EURCHFMT4,5564,8h 20m,Buy
126491.43,174222,30.10.2014 08:05:00,,0.0,-387.5600000004051,0.0,0.0,174145,30.10.2014 02:40:00,10950,-0.17869872964661165,16.23,IS,0.23,0.0,Phase3-EA-S4v1-GBPJPY-M5-194,GBPJPYMT4,2540,5h 25m,Buy
126515.23,108897,30.10.2014 19:15:00,,0.0,-363.76000000041677,0.0,0.0,108993,30.10.2014 18:15:00,10951,-0.1677248681397925,23.8,IS,0.27,0.0,Phase3-EA-S1v2-USDJPY-M15-0,USDJPYMT4,3108,1h 0m,Sell
126479.39,137.72,30.10.2014 20:29:58,sl 137.720,0.0,-399.6000000004133,0.0,0.0,137.49,30.10.2014 08:00:00,10952,-0.1842502125265384,-35.84,IS,0.17,0.0,Phase3-EA-T1v2-EURJPY-M15-322,EURJPYMT4,2002,12h 29m,Sell
126528.5,109416,31.10.2014 05:15:00,,0.0,-350.49000000042724,0.0,0.0,109217,31.10.2014 00:45:00,10953,-0.16160624871981577,49.11,IS,0.27,0.0,Phase3-EA-S1v2-USDJPY-M15-0,USDJPYMT4,3110,4h 30m,Buy
126525.5,1.20567,31.10.2014 06:05:00,,-2.14,-353.49000000042724,0.0,0.0,1.20565,30.10.2014 21:45:00,10954,-0.16298950857361716,-3.0,IS,0.41,0.0,Phase3-EA-SA2v2-EURCHF-M5-43,EURCHFMT4,5566,8h 20m,Sell
126535.17,174.92,31.10.2014 06:50:00,,0.0,-343.82000000041444,0.0,0.0,174966,31.10.2014 01:25:00,10955,-0.1585308009781914,9.67,IS,0.23,0.0,Phase3-EA-S4v1-GBPJPY-M5-194,GBPJPYMT4,2542,5h 25m,Sell
126685.06,175442,31.10.2014 07:59:58,tp 175.442,-2.39,-193.93000000040047,0.0,0.0,173592,23.10.2014 21:30:00,10956,-0.08941852781608715,149.89,IS,0.09,0.0,Phase3-EA-B1v1-GBPJPY-M30-1,GBPJPYMT4,1028,7d 10h 29m,Buy
126785.51,138163,31.10.2014 07:59:58,tp 138.163,-3.26,-93.48000000038883,0.0,0.0,136903,23.10.2014 19:30:00,10957,-0.04310237704463123,100.45,IS,0.09,0.0,Phase3-EA-TR1v1-EURJPY-M30-91,EURJPYMT4,1894,7d 12h 29m,Buy
127045.47,139547,31.10.2014 09:44:58,tp 139.547,0.0,-0.0,0.0,0.0,137847,31.10.2014 06:45:00,10958,-0.0,259.96,IS,0.17,0.0,Phase3-EA-T1v2-EURJPY-M15-322,EURJPYMT4,2004,2h 59m,Buy
127014.7,1.20668,31.10.2014 10:30:00,,0.0,-30.769999999989523,0.0,0.0,1.20581,31.10.2014 01:45:00,10959,-0.014176752917252466,-30.77,IS,0.34,0.0,Phase3-EA-S4v1-EURCHF-M15-221,EURCHFMT4,2916,8h 45m,Sell
127115.27,141106,03.11.2014 02:00:00,tp 141.106,-0.39,-0.0,0.0,0.0,139846,31.10.2014 10:30:00,10960,-0.0,100.57,IS,0.09,0.0,Phase3-EA-TR1v1-EURJPY-M30-91,EURJPYMT4,1896,2d 15h 30m,Buy
127210.66,112393,03.11.2014 02:00:00,tp 112.393,-0.7,-0.0,0.0,0.0,111993,31.10.2014 19:45:00,10961,-0.0,95.39,IS,0.27,0.0,Phase3-EA-S1v2-USDJPY-M15-0,USDJPYMT4,3112,2d 6h 15m,Buy
127290.27,179927,03.11.2014 03:14:58,tp 179.927,0.0,-0.0,0.0,0.0,180317,03.11.2014 02:15:00,10962,-0.0,79.61,IS,0.23,0.0,Phase3-EA-S4v1-GBPJPY-M5-194,GBPJPYMT4,2544,59m 58s,Sell
127301.56,1.20599,03.11.2014 07:20:00,,-1.02,-0.0,0.0,0.0,1.2057,31.10.2014 23:00:00,10963,-0.0,11.29,IS,0.41,0.0,Phase3-EA-SA2v2-EURCHF-M5-43,EURCHFMT4,5568,2d 8h 20m,Buy
127299.75,140699,03.11.2014 07:30:00,,0.0,-1.8099999999976717,0.0,0.0,140711,03.11.2014 06:30:00,10964,-8.3294385921466E-4,-1.81,IS,0.17,0.0,Phase3-EA-T1v2-EURJPY-M15-322,EURJPYMT4,2006,1h 0m,Buy
127447.08,180649,03.11.2014 12:59:57,tp 180.649,-0.29,-0.0,0.0,0.0,178799,31.10.2014 15:30:00,10965,-0.0,147.33,IS,0.09,0.0,Phase3-EA-B1v1-GBPJPY-M30-1,GBPJPYMT4,1030,2d 21h 29m,Buy
127384.89,141369,03.11.2014 13:29:59,sl 141.369,0.0,-62.19000000000233,0.0,0.0,140589,03.11.2014 04:00:00,10966,-0.02860006213925794,-62.19,IS,0.09,0.0,Phase3-EA-TR1v1-EURJPY-M30-91,EURJPYMT4,1898,9h 29m,Sell
127331.92,181758,03.11.2014 19:59:57,sl 181.758,0.0,-115.16000000000349,0.0,0.0,182428,03.11.2014 19:00:00,10967,-0.052960012155602525,-52.97,IS,0.09,0.0,Phase3-EA-B1v1-GBPJPY-M30-1,GBPJPYMT4,1032,59m 57s,Buy
127322.52,142186,04.11.2014 00:45:00,,0.0,-124.55999999999767,0.0,0.0,142249,04.11.2014 00:30:00,10968,-0.05728290304013135,-9.4,IS,0.17,0.0,Phase3-EA-T1v2-EURJPY-M15-322,EURJPYMT4,2008,15m 0s,Buy
127372.74,114.03,04.11.2014 01:00:00,,-0.69,-74.33999999999651,0.0,0.0,113815,03.11.2014 22:00:00,10969,-0.03418762854851674,50.22,IS,0.27,0.0,Phase3-EA-S1v2-USDJPY-M15-0,USDJPYMT4,3114,3h 0m,Buy
127380.65,1.20566,04.11.2014 05:30:00,,-1.02,-66.42999999999302,0.0,0.0,1.20545,03.11.2014 21:10:00,10970,-0.030549961857382762,7.91,IS,0.41,0.0,Phase3-EA-SA2v2-EURCHF-M5-43,EURCHFMT4,5570,8h 20m,Buy
127346.19,141994,04.11.2014 08:59:58,sl 141.994,0.0,-100.88999999998487,0.0,0.0,142224,04.11.2014 06:30:00,10971,-0.04639749588726793,-34.46,IS,0.17,0.0,Phase3-EA-T1v2-EURJPY-M15-322,EURJPYMT4,2010,2h 29m,Buy
127348.31,1.20553,04.11.2014 10:45:00,,0.0,-98.76999999998952,0.0,0.0,1.20559,04.11.2014 02:00:00,10972,-0.04542254602820552,2.12,IS,0.34,0.0,Phase3-EA-S4v1-EURCHF-M15-221,EURCHFMT4,2918,8h 45m,Sell
127313.88,141931,04.11.2014 12:59:58,sl 141.931,0.0,-133.19999999998254,0.0,0.0,142161,04.11.2014 11:30:00,10973,-0.06125628359782144,-34.43,IS,0.17,0.0,Phase3-EA-T1v2-EURJPY-M15-322,EURJPYMT4,2012,1h 29m,Buy
127285.49,1.2041,05.11.2014 04:20:00,,-1.02,-161.5899999999965,0.0,0.0,1.20474,04.11.2014 20:00:00,10974,-0.07431233383313102,-28.39,IS,0.41,0.0,Phase3-EA-SA2v2-EURCHF-M5-43,EURCHFMT4,5572,8h 20m,Buy
127124.03,182675,05.11.2014 07:44:58,sl 182.675,0.0,-323.04999999998836,0.0,0.0,181875,05.11.2014 03:30:00,10975,-0.14856488300509083,-161.46,IS,0.23,0.0,Phase3-EA-S4v1-GBPJPY-M5-194,GBPJPYMT4,2546,4h 14m,Sell
127222.74,143266,05.11.2014 08:59:57,tp 143.266,-0.78,-224.3399999999965,0.0,0.0,142006,03.11.2014 15:00:00,10976,-0.1031699298974238,98.71,IS,0.09,0.0,Phase3-EA-TR1v1-EURJPY-M30-91,EURJPYMT4,1900,1d 17h 59m,Buy
127180.21,1597,05.11.2014 09:29:58,sl 1.59700,-0.53,-266.86999999999534,0.0,0.0,1.6,04.11.2014 08:30:00,10977,-0.12272871173988338,-42.53,IS,0.14,0.0,Phase3-EA-B1v1-GBPUSD-M30-14,GBPUSDMT4,722,1d 0h 59m,Buy
127169.59,1.20402,05.11.2014 10:00:00,,0.0,-277.4899999999907,0.0,0.0,1.20432,05.11.2014 01:15:00,10978,-0.12761265867538385,-10.62,IS,0.34,0.0,Phase3-EA-S4v1-EURCHF-M15-221,EURCHFMT4,2920,8h 45m,Buy
127135.48,142934,05.11.2014 18:14:58,sl 142.934,0.0,-311.5999999999767,0.0,0.0,143164,05.11.2014 16:15:00,10979,-0.1432992340021189,-34.11,IS,0.17,0.0,Phase3-EA-T1v2-EURJPY-M15-322,EURJPYMT4,2014,1h 59m,Buy
127099.21,142978,06.11.2014 03:59:58,sl 142.978,-2.18,-347.86999999996624,0.0,0.0,143208,05.11.2014 21:00:00,10980,-0.15997915446827982,-36.27,IS,0.17,0.0,Phase3-EA-T1v2-EURJPY-M15-322,EURJPYMT4,2016,6h 59m,Buy
127110.27,1.20352,06.11.2014 04:20:00,,-6.38,-336.80999999996857,0.0,0.0,1.20393,05.11.2014 20:00:00,10981,-0.15489285944882147,11.06,IS,0.41,0.0,Phase3-EA-SA2v2-EURCHF-M5-43,EURCHFMT4,5574,8h 20m,Sell
127048.45,143.85,06.11.2014 06:29:58,sl 143.850,-0.82,-398.62999999997555,0.0,0.0,143.07,05.11.2014 12:00:00,10982,-0.18332276524475424,-61.82,IS,0.09,0.0,Phase3-EA-TR1v1-EURJPY-M30-91,EURJPYMT4,1902,18h 29m,Sell
127014.52,143108,06.11.2014 07:14:58,sl 143.108,0.0,-432.55999999996857,0.0,0.0,143338,06.11.2014 04:30:00,10983,-0.1989265618098738,-33.93,IS,0.17,0.0,Phase3-EA-T1v2-EURJPY-M15-322,EURJPYMT4,2018,2h 44m,Buy
126972.52,1.59415,06.11.2014 15:29:58,sl 1.59415,0.0,-474.55999999996857,0.0,0.0,1.59715,06.11.2014 03:30:00,10984,-0.2182416061875678,-42.0,IS,0.14,0.0,Phase3-EA-B1v1-GBPUSD-M30-14,GBPUSDMT4,724,11h 59m,Buy
126938.53,143169,06.11.2014 16:44:58,sl 143.169,0.0,-508.54999999995925,0.0,0.0,143399,06.11.2014 14:00:00,10985,-0.23387299567322584,-33.99,IS,0.17,0.0,Phase3-EA-T1v2-EURJPY-M15-322,EURJPYMT4,2020,2h 44m,Buy
126900.79,0.9729,07.11.2014 03:00:00,,-3.16,-546.2899999999499,0.0,0.0,0.97232,06.11.2014 22:45:00,10986,-0.2512289426926066,-37.74,IS,0.58,0.0,Phase3-EA-SA2v2-USDCHF-M15-107,USDCHFMT4,2140,4h 15m,Sell
126862.29,182459,07.11.2014 05:10:00,,-1.16,-584.7899999999499,0.0,0.0,182272,06.11.2014 23:45:00,10987,-0.26893440003882607,-38.5,IS,0.23,0.0,Phase3-EA-S4v1-GBPJPY-M5-194,GBPJPYMT4,2548,5h 25m,Sell
126880.83,1.20404,07.11.2014 08:15:00,,-2.11,-566.2499999999418,0.0,0.0,1.20453,06.11.2014 23:55:00,10988,-0.2604081875920974,18.54,IS,0.41,0.0,Phase3-EA-SA2v2-EURCHF-M5-43,EURCHFMT4,5576,8h 20m,Sell
126874.29,1.20289,10.11.2014 04:20:00,,-1.02,-572.7899999999499,0.0,0.0,1.20302,07.11.2014 20:00:00,10989,-0.2634158159309135,-6.54,IS,0.41,0.0,Phase3-EA-SA2v2-EURCHF-M5-43,EURCHFMT4,5578,2d 8h 20m,Buy
126869.7,1.20276,10.11.2014 12:45:00,,0.0,-577.3799999999464,0.0,0.0,1.20289,10.11.2014 04:00:00,10990,-0.26552667435218846,-4.59,IS,0.34,0.0,Phase3-EA-S4v1-EURCHF-M15-221,EURCHFMT4,2922,8h 45m,Buy
126835.48,142677,10.11.2014 16:44:58,sl 142.677,0.0,-611.5999999999476,0.0,0.0,142447,10.11.2014 04:00:00,10991,-0.28126383669991967,-34.22,IS,0.17,0.0,Phase3-EA-T1v2-EURJPY-M15-322,EURJPYMT4,2022,12h 44m,Sell
126877.76,114961,11.11.2014 03:15:00,,0.0,-569.3199999999488,0.0,0.0,114781,11.11.2014 00:30:00,10992,-0.2618200253597082,42.28,IS,0.27,0.0,Phase3-EA-S1v2-USDJPY-M15-0,USDJPYMT4,3116,2h 45m,Buy
126884.58,181889,11.11.2014 06:05:00,,0.0,-562.4999999999418,0.0,0.0,181855,11.11.2014 00:40:00,10993,-0.25868363005837475,6.82,IS,0.23,0.0,Phase3-EA-S4v1-GBPJPY-M5-194,GBPJPYMT4,2550,5h 25m,Buy
126883.31,1.20292,11.11.2014 06:50:00,,-2.12,-563.7699999999313,0.0,0.0,1.20294,10.11.2014 22:30:00,10994,-0.25926768020979063,-1.27,IS,0.41,0.0,Phase3-EA-SA2v2-EURCHF-M5-43,EURCHFMT4,5580,8h 20m,Sell
126906.82,1.2022,11.11.2014 13:45:00,,0.0,-540.259999999922,0.0,0.0,1.20287,11.11.2014 05:00:00,10995,-0.24845585417836766,23.51,IS,0.34,0.0,Phase3-EA-S4v1-EURCHF-M15-221,EURCHFMT4,2924,8h 45m,Sell
127006.11,143965,11.11.2014 13:59:58,tp 143.965,-0.76,-440.96999999991385,0.0,0.0,142675,07.11.2014 02:30:00,10996,-0.20279416950547738,99.29,IS,0.09,0.0,Phase3-EA-TR1v1-EURJPY-M30-91,EURJPYMT4,1904,4d 11h 29m,Buy
127083.6,183883,12.11.2014 04:49:57,tp 183.883,0.0,-363.47999999992317,0.0,0.0,184273,12.11.2014 01:00:00,10997,-0.16715791262863627,77.49,IS,0.23,0.0,Phase3-EA-S4v1-GBPJPY-M5-194,GBPJPYMT4,2552,3h 49m,Sell
127011.53,0.96569,12.11.2014 05:15:00,,0.0,-435.54999999993015,0.0,0.0,0.96449,12.11.2014 01:00:00,10998,-0.20030160901674435,-72.07,IS,0.58,0.0,Phase3-EA-SA2v2-USDCHF-M15-107,USDCHFMT4,2142,4h 15m,Sell
127005.15,1.20338,12.11.2014 07:25:00,,-2.13,-441.9299999999348,0.0,0.0,1.20328,11.11.2014 23:05:00,10999,-0.20323565623412002,-6.38,IS,0.41,0.0,Phase3-EA-SA2v2-EURCHF-M5-43,EURCHFMT4,5582,8h 20m,Sell
126971.39,144088,12.11.2014 07:59:58,sl 144.088,0.0,-475.6899999999441,0.0,0.0,144318,12.11.2014 07:45:00,11000,-0.21876127285771832,-33.76,IS,0.17,0.0,Phase3-EA-T1v2-EURJPY-M15-322,EURJPYMT4,2024,14m 58s,Buy
126918.83,183252,12.11.2014 12:59:57,sl 183.252,-0.28,-528.2499999999418,0.0,0.0,183922,11.11.2014 15:00:00,11001,-0.24293267125037427,-52.56,IS,0.09,0.0,Phase3-EA-B1v1-GBPJPY-M30-1,GBPJPYMT4,1034,21h 59m,Buy
126949.66,115615,13.11.2014 04:45:00,,0.0,-497.4199999999546,0.0,0.0,115483,13.11.2014 01:00:00,11002,-0.2287545089131348,30.83,IS,0.27,0.0,Phase3-EA-S1v2-USDJPY-M15-0,USDJPYMT4,3118,3h 45m,Buy
126895.59,0.96549,13.11.2014 05:15:00,,0.0,-551.4899999999616,0.0,0.0,0.96639,13.11.2014 01:00:00,11003,-0.25362032913937405,-54.07,IS,0.58,0.0,Phase3-EA-SA2v2-USDCHF-M15-107,USDCHFMT4,2144,4h 15m,Buy
126925.43,182345,13.11.2014 06:25:00,,0.0,-521.6499999999651,0.0,0.0,182195,13.11.2014 01:00:00,11004,-0.23989744999103307,29.84,IS,0.23,0.0,Phase3-EA-S4v1-GBPJPY-M5-194,GBPJPYMT4,2554,5h 25m,Buy
126919.82,115524,13.11.2014 17:15:00,,0.0,-527.2599999999511,0.0,0.0,115.5,13.11.2014 17:00:00,11005,-0.24247738806147578,-5.61,IS,0.27,0.0,Phase3-EA-S1v2-USDJPY-M15-0,USDJPYMT4,3120,15m 0s,Sell
126997.18,181635,14.11.2014 04:39:58,tp 181.635,0.0,-449.8999999999651,0.0,0.0,182025,14.11.2014 03:30:00,11006,-0.20690091584580586,77.36,IS,0.23,0.0,Phase3-EA-S4v1-GBPJPY-M5-194,GBPJPYMT4,2556,1h 9m,Sell
127001.43,1.20198,14.11.2014 04:55:00,,-2.13,-445.6499999999651,0.0,0.0,1.20213,13.11.2014 20:35:00,11007,-0.20494641730758684,4.25,IS,0.41,0.0,Phase3-EA-SA2v2-EURCHF-M5-43,EURCHFMT4,5584,8h 20m,Sell
127020.63,144392,14.11.2014 08:15:00,,-0.72,-426.44999999995343,0.0,0.0,144256,13.11.2014 18:15:00,11008,-0.19611668273492136,19.2,IS,0.17,0.0,Phase3-EA-T1v2-EURJPY-M15-322,EURJPYMT4,2026,14h 0m,Buy
126826.91,116311,14.11.2014 10:14:57,sl 116.311,-1.05,-620.1699999999546,0.0,0.0,115481,13.11.2014 17:30:00,11009,-0.2852050255169904,-193.72,IS,0.27,0.0,Phase3-EA-S1v2-USDJPY-M15-0,USDJPYMT4,3122,16h 44m,Sell
126831.13,1.20202,14.11.2014 10:45:00,,0.0,-615.9499999999534,0.0,0.0,1.20214,14.11.2014 02:00:00,11010,-0.2832643234390406,4.22,IS,0.34,0.0,Phase3-EA-S4v1-EURCHF-M15-221,EURCHFMT4,2926,8h 45m,Sell
126926.44,145096,14.11.2014 18:29:58,tp 145.096,-1.9,-520.6399999999558,0.0,0.0,143836,11.11.2014 13:30:00,11011,-0.23943296916194615,95.31,IS,0.09,0.0,Phase3-EA-TR1v1-EURJPY-M30-91,EURJPYMT4,1905,3d 4h 59m,Buy
127173.54,146.22,17.11.2014 02:59:58,tp 146.220,-0.72,-273.53999999994994,0.0,0.0,144.52,14.11.2014 09:45:00,11012,-0.1257961247398439,247.1,IS,0.17,0.0,Phase3-EA-T1v2-EURJPY-M15-322,EURJPYMT4,2028,2d 17h 14m,Buy
127250.39,182645,17.11.2014 03:09:58,tp 182.645,0.0,-196.68999999994412,0.0,0.0,183035,17.11.2014 03:00:00,11013,-0.09045419234875117,76.85,IS,0.23,0.0,Phase3-EA-S4v1-GBPJPY-M5-194,GBPJPYMT4,2558,9m 58s,Sell
127249.79,1.20127,17.11.2014 04:30:00,,-1.03,-197.28999999994994,0.0,0.0,1.20126,14.11.2014 20:10:00,11014,-0.09073012155414947,-0.6,IS,0.41,0.0,Phase3-EA-SA2v2-EURCHF-M5-43,EURCHFMT4,5586,2d 8h 20m,Buy
127193.44,144926,17.11.2014 08:59:58,sl 144.926,-0.38,-253.63999999995576,0.0,0.0,145646,14.11.2014 23:30:00,11015,-0.11664447276089157,-56.35,IS,0.09,0.0,Phase3-EA-TR1v1-EURJPY-M30-91,EURJPYMT4,1908,2d 9h 29m,Buy
127150.91,1.56542,17.11.2014 12:29:58,sl 1.56542,-0.53,-296.1699999999546,0.0,0.0,1.56842,14.11.2014 22:00:00,11016,-0.13620325460335114,-42.53,IS,0.14,0.0,Phase3-EA-B1v1-GBPUSD-M30-14,GBPUSDMT4,726,2d 14h 29m,Buy
127153.39,1.20133,17.11.2014 14:30:00,,0.0,-293.6899999999441,0.0,0.0,1.2014,17.11.2014 05:45:00,11017,-0.13506274722104442,2.48,IS,0.34,0.0,Phase3-EA-S4v1-EURCHF-M15-221,EURCHFMT4,2928,8h 45m,Sell
127177.96,116491,17.11.2014 21:00:00,,0.0,-269.11999999993714,0.0,0.0,116385,17.11.2014 19:45:00,11018,-0.12376344626009021,24.57,IS,0.27,0.0,Phase3-EA-S1v2-USDJPY-M15-0,USDJPYMT4,3124,1h 15m,Buy
127211.33,116601,18.11.2014 00:45:00,,-0.67,-235.7499999999418,0.0,0.0,116454,17.11.2014 23:45:00,11019,-0.1084171836200055,33.37,IS,0.27,0.0,Phase3-EA-S1v2-USDJPY-M15-0,USDJPYMT4,3126,1h 0m,Buy
127177.31,145324,18.11.2014 02:29:58,sl 145.324,-0.51,-269.7699999999313,0.0,0.0,145094,17.11.2014 18:30:00,11020,-0.1240623695659328,-34.02,IS,0.17,0.0,Phase3-EA-T1v2-EURJPY-M15-322,EURJPYMT4,2030,7h 59m,Sell
127164.09,182405,18.11.2014 06:15:00,,0.0,-282.9899999999325,0.0,0.0,182338,18.11.2014 00:50:00,11021,-0.13014200972481701,-13.22,IS,0.23,0.0,Phase3-EA-S4v1-GBPJPY-M5-194,GBPJPYMT4,2560,5h 25m,Sell
127162.22,1.20132,18.11.2014 07:05:00,,-1.02,-284.8599999999278,0.0,0.0,1.20134,17.11.2014 22:45:00,11022,-0.13100198908163124,-1.87,IS,0.41,0.0,Phase3-EA-SA2v2-EURCHF-M5-43,EURCHFMT4,5588,8h 20m,Buy
127162.57,1.20126,18.11.2014 11:00:00,,0.0,-284.509999999922,0.0,0.0,1.20125,18.11.2014 02:15:00,11023,-0.13084103037848113,0.35,IS,0.34,0.0,Phase3-EA-S4v1-EURCHF-M15-221,EURCHFMT4,2930,8h 45m,Buy
127102.51,146623,18.11.2014 23:29:58,sl 146.623,0.0,-344.5699999999197,0.0,0.0,145843,18.11.2014 16:00:00,11024,-0.15846154383858244,-60.06,IS,0.09,0.0,Phase3-EA-TR1v1-EURJPY-M30-91,EURJPYMT4,1910,7h 29m,Sell
127059.98,1.56232,19.11.2014 01:59:58,sl 1.56232,-0.53,-387.0999999999185,0.0,0.0,1.56532,18.11.2014 07:30:00,11025,-0.17802032568104204,-42.53,IS,0.14,0.0,Phase3-EA-B1v1-GBPUSD-M30-14,GBPUSDMT4,728,18h 29m,Buy
127067.29,182756,19.11.2014 04:45:00,,-1.14,-379.78999999992084,0.0,0.0,182799,18.11.2014 23:20:00,11026,-0.17465858819530636,7.31,IS,0.23,0.0,Phase3-EA-S4v1-GBPJPY-M5-194,GBPJPYMT4,2562,5h 25m,Sell
127076.69,1.20132,19.11.2014 09:25:00,,0.0,-370.38999999992666,0.0,0.0,1.2011,19.11.2014 01:05:00,11027,-0.17033569731077752,9.4,IS,0.41,0.0,Phase3-EA-SA2v2-EURCHF-M5-43,EURCHFMT4,5590,8h 20m,Buy
126884.88,117474,19.11.2014 12:29:58,sl 117.474,-1.04,-562.1999999999243,0.0,0.0,116644,18.11.2014 19:15:00,11028,-0.25854566545566887,-191.81,IS,0.27,0.0,Phase3-EA-S1v2-USDJPY-M15-0,USDJPYMT4,3128,17h 14m,Sell
126979.89,148201,20.11.2014 01:59:58,tp 148.201,-1.12,-467.189999999915,0.0,0.0,146941,19.11.2014 09:30:00,11029,-0.21485227578126687,95.01,IS,0.09,0.0,Phase3-EA-TR1v1-EURJPY-M30-91,EURJPYMT4,1912,16h 29m,Buy
126974.67,1.20122,20.11.2014 04:20:00,,-3.08,-472.4099999999162,0.0,0.0,1.20127,19.11.2014 20:00:00,11030,-0.21725285986820936,-5.22,IS,0.41,0.0,Phase3-EA-SA2v2-EURCHF-M5-43,EURCHFMT4,5592,8h 20m,Buy
126916.62,185588,20.11.2014 07:15:00,,0.0,-530.4599999999045,0.0,0.0,185289,20.11.2014 01:50:00,11031,-0.24394901049023104,-58.05,IS,0.23,0.0,Phase3-EA-S4v1-GBPJPY-M5-194,GBPJPYMT4,2564,5h 25m,Sell
126945.91,118006,20.11.2014 18:30:00,,0.0,-501.1699999998964,0.0,0.0,118134,20.11.2014 18:15:00,11032,-0.23047906644683072,29.29,IS,0.27,0.0,Phase3-EA-S1v2-USDJPY-M15-0,USDJPYMT4,3130,15m 0s,Sell
126982.1,117887,20.11.2014 21:30:00,,0.0,-464.97999999989406,0.0,0.0,118045,20.11.2014 19:15:00,11033,-0.21383593654138333,36.19,IS,0.27,0.0,Phase3-EA-S1v2-USDJPY-M15-0,USDJPYMT4,3132,2h 15m,Sell
126926.82,147522,21.11.2014 04:59:58,sl 147.522,-0.37,-520.2599999998929,0.0,0.0,148242,20.11.2014 02:00:00,11034,-0.2392582139985,-55.28,IS,0.09,0.0,Phase3-EA-TR1v1-EURJPY-M30-91,EURJPYMT4,1914,1d 2h 59m,Buy
126953.34,1.20231,21.11.2014 09:15:00,,0.0,-493.7399999999034,0.0,0.0,1.20169,21.11.2014 00:55:00,11035,-0.22706214312001805,26.52,IS,0.41,0.0,Phase3-EA-SA2v2-EURCHF-M5-43,EURCHFMT4,5594,8h 20m,Buy
126915.64,1.20317,21.11.2014 12:00:00,,0.0,-531.439999999915,0.0,0.0,1.2021,21.11.2014 03:15:00,11036,-0.24439969485904872,-37.7,IS,0.34,0.0,Phase3-EA-S4v1-EURCHF-M15-221,EURCHFMT4,2932,8h 45m,Sell
126863.34,184006,21.11.2014 13:29:57,sl 184.006,-1.09,-583.7399999999034,0.0,0.0,184676,19.11.2014 21:00:00,11037,-0.2684515239293623,-52.3,IS,0.09,0.0,Phase3-EA-B1v1-GBPJPY-M30-1,GBPJPYMT4,1036,1d 16h 29m,Buy
126908.7,1.20262,24.11.2014 02:09:58,tp 1.20262,-1.01,-538.3799999999173,0.0,0.0,1.20152,21.11.2014 21:45:00,11038,-0.24759127600145922,45.36,IS,0.41,0.0,Phase3-EA-SA2v2-EURCHF-M5-43,EURCHFMT4,5596,2d 4h 24m,Buy
126925.53,1.20262,24.11.2014 10:45:00,,0.0,-521.5499999999302,0.0,0.0,1.20214,24.11.2014 02:00:00,11039,-0.23985146179011774,16.83,IS,0.34,0.0,Phase3-EA-S4v1-EURCHF-M15-221,EURCHFMT4,2934,8h 45m,Buy
126925.95,1.2026,24.11.2014 10:50:00,,0.0,-521.1299999999173,0.0,0.0,1.20261,24.11.2014 02:30:00,11040,-0.23965831134633492,0.42,IS,0.41,0.0,Phase3-EA-SA2v2-EURCHF-M5-43,EURCHFMT4,5598,8h 20m,Sell
126870.87,146.54,24.11.2014 13:29:57,sl 146.540,-0.27,-576.2099999999045,0.0,0.0,145.82,21.11.2014 20:30:00,11041,-0.26498861240164767,-55.08,IS,0.09,0.0,Phase3-EA-TR1v1-EURJPY-M30-91,EURJPYMT4,1916,2d 16h 59m,Sell
126913.5,118444,24.11.2014 18:45:00,,0.0,-533.5799999998999,0.0,0.0,118257,24.11.2014 17:45:00,11042,-0.24538384235828617,42.63,IS,0.27,0.0,Phase3-EA-S1v2-USDJPY-M15-0,USDJPYMT4,3134,1h 0m,Buy
126973.45,0.96745,25.11.2014 03:59:58,tp 0.96745,0.0,-473.62999999988824,0.0,0.0,0.96645,25.11.2014 02:15:00,11043,-0.21781391591916763,59.95,IS,0.58,0.0,Phase3-EA-SA2v2-USDCHF-M15-107,USDCHFMT4,2146,1h 44m,Buy
126971.58,1.20251,25.11.2014 04:50:00,,-1.02,-475.4999999998836,0.0,0.0,1.20253,24.11.2014 20:30:00,11044,-0.21867389527598186,-1.87,IS,0.41,0.0,Phase3-EA-SA2v2-EURCHF-M5-43,EURCHFMT4,5600,8h 20m,Buy
126975.1,1.20241,25.11.2014 12:45:00,,0.0,-471.97999999989406,0.0,0.0,1.20251,25.11.2014 04:00:00,11045,-0.21705511060433233,3.52,IS,0.34,0.0,Phase3-EA-S4v1-EURCHF-M15-221,EURCHFMT4,2936,8h 45m,Sell
127035.27,0.96393,25.11.2014 23:14:58,tp 0.96393,0.0,-411.80999999988126,0.0,0.0,0.96493,25.11.2014 22:15:00,11046,-0.18938401012323486,60.17,IS,0.58,0.0,Phase3-EA-SA2v2-USDCHF-M15-107,USDCHFMT4,2148,59m 58s,Sell
127095.38,0.96496,25.11.2014 23:59:58,tp 0.96496,0.0,-351.6999999998952,0.0,0.0,0.96396,25.11.2014 23:15:00,11047,-0.16174050256268924,60.11,IS,0.58,0.0,Phase3-EA-SA2v2-USDCHF-M15-107,USDCHFMT4,2150,44m 58s,Buy
127110.96,117866,26.11.2014 03:30:00,,0.0,-336.11999999990803,0.0,0.0,117934,26.11.2014 00:30:00,11048,-0.15457554086258865,15.58,IS,0.27,0.0,Phase3-EA-S1v2-USDJPY-M15-0,USDJPYMT4,3136,3h 0m,Sell
127126.27,1.20249,26.11.2014 04:25:00,,-2.13,-320.80999999991036,0.0,0.0,1.2029,25.11.2014 20:05:00,11049,-0.14753474730491128,15.31,IS,0.41,0.0,Phase3-EA-SA2v2-EURCHF-M5-43,EURCHFMT4,5602,8h 20m,Sell
127119.57,1.20249,26.11.2014 09:45:00,,0.0,-327.509999999922,0.0,0.0,1.20268,26.11.2014 01:00:00,11050,-0.1506159567651678,-6.7,IS,0.34,0.0,Phase3-EA-S4v1-EURCHF-M15-221,EURCHFMT4,2938,8h 45m,Buy
127086.36,146991,26.11.2014 17:29:58,sl 146.991,0.0,-360.71999999991385,0.0,0.0,146761,26.11.2014 14:00:00,11051,-0.1658886382838121,-33.21,IS,0.17,0.0,Phase3-EA-T1v2-EURJPY-M15-322,EURJPYMT4,2032,3h 29m,Sell
127081.16,1.20204,27.11.2014 05:30:00,,-3.07,-365.9199999999255,0.0,0.0,1.20209,26.11.2014 21:10:00,11052,-0.16828002473057957,-5.2,IS,0.41,0.0,Phase3-EA-SA2v2-EURCHF-M5-43,EURCHFMT4,5604,8h 20m,Buy
127061.12,0.96395,28.11.2014 02:15:00,,-3.19,-385.95999999993364,0.0,0.0,0.96367,27.11.2014 22:00:00,11053,-0.17749606019079728,-20.04,IS,0.58,0.0,Phase3-EA-SA2v2-USDCHF-M15-107,USDCHFMT4,2152,4h 15m,Sell
127111.03,117937,28.11.2014 02:45:00,,0.0,-336.04999999993015,0.0,0.0,117719,28.11.2014 00:15:00,11054,-0.15454334912196935,49.91,IS,0.27,0.0,Phase3-EA-S1v2-USDJPY-M15-0,USDJPYMT4,3138,2h 30m,Buy
127111.87,1.20201,28.11.2014 07:05:00,,-2.13,-335.20999999993364,0.0,0.0,1.20208,27.11.2014 22:45:00,11055,-0.15415704823441706,0.84,IS,0.41,0.0,Phase3-EA-SA2v2-EURCHF-M5-43,EURCHFMT4,5606,8h 20m,Sell
127205.39,147868,28.11.2014 18:29:57,tp 147.868,-2.23,-241.68999999994412,0.0,0.0,146608,24.11.2014 14:00:00,11056,-0.11114888275342329,93.52,IS,0.09,0.0,Phase3-EA-TR1v1-EURJPY-M30-91,EURJPYMT4,1918,4d 4h 29m,Buy
127160.73,1.56723,28.11.2014 18:59:58,sl 1.56723,-2.66,-286.3499999999476,0.0,0.0,1.57023,25.11.2014 19:00:00,11057,-0.1316872132750395,-44.66,IS,0.14,0.0,Phase3-EA-B1v1-GBPUSD-M30-14,GBPUSDMT4,730,2d 23h 59m,Buy
127206.42,1.20231,01.12.2014 02:00:00,tp 1.20231,-1.02,-240.65999999994528,0.0,0.0,1.20121,28.11.2014 20:00:00,11058,-0.11067520428416133,45.69,IS,0.41,0.0,Phase3-EA-SA2v2-EURCHF-M5-43,EURCHFMT4,5608,2d 6h 0m,Buy
127213.63,1.20333,01.12.2014 10:25:00,,0.0,-233.44999999995343,0.0,0.0,1.2035,01.12.2014 02:05:00,11059,-0.10735945499932761,7.21,IS,0.41,0.0,Phase3-EA-SA2v2-EURCHF-M5-43,EURCHFMT4,5610,8h 20m,Sell
127244.98,1.20269,01.12.2014 12:45:00,,0.0,-202.0999999999476,0.0,0.0,1.20358,01.12.2014 04:00:00,11060,-0.09294215401740336,31.35,IS,0.34,0.0,Phase3-EA-S4v1-EURCHF-M15-221,EURCHFMT4,2940,8h 45m,Sell
127211.21,147117,01.12.2014 13:29:57,sl 147.117,-0.7,-235.86999999993714,0.0,0.0,147347,28.11.2014 15:45:00,11061,-0.10847236946108249,-33.77,IS,0.17,0.0,Phase3-EA-T1v2-EURJPY-M15-322,EURJPYMT4,2034,2d 21h 44m,Buy
127185.07,118267,02.12.2014 04:30:00,,-1.03,-262.0099999999511,0.0,0.0,118157,01.12.2014 22:15:00,11062,-0.12049368517615845,-26.14,IS,0.27,0.0,Phase3-EA-S1v2-USDJPY-M15-0,USDJPYMT4,3140,6h 15m,Sell
127152.05,147792,02.12.2014 10:59:58,sl 147.792,0.0,-295.0299999999406,0.0,0.0,147562,02.12.2014 02:15:00,11063,-0.13567898911309303,-33.02,IS,0.17,0.0,Phase3-EA-T1v2-EURJPY-M15-322,EURJPYMT4,2036,8h 44m,Sell
127128.14,1.20361,02.12.2014 12:30:00,,0.0,-318.9399999999441,0.0,0.0,1.20293,02.12.2014 03:45:00,11064,-0.14667476794811043,-23.91,IS,0.34,0.0,Phase3-EA-S4v1-EURCHF-M15-221,EURCHFMT4,2942,8h 45m,Sell
127265.86,186874,02.12.2014 14:29:58,tp 186.874,-2.19,-181.21999999994296,0.0,0.0,185024,24.11.2014 14:30:00,11065,-0.08333981766963336,137.72,IS,0.09,0.0,Phase3-EA-B1v1-GBPJPY-M30-1,GBPJPYMT4,1038,7d 23h 59m,Buy
127288.96,119238,02.12.2014 23:00:00,,0.0,-158.11999999993714,0.0,0.0,119136,02.12.2014 21:15:00,11066,-0.072716543261899,23.1,IS,0.27,0.0,Phase3-EA-S1v2-USDJPY-M15-0,USDJPYMT4,3142,1h 45m,Buy
127312.05,0.97215,03.12.2014 03:30:00,,-3.16,-135.02999999994063,0.0,0.0,0.97259,02.12.2014 23:15:00,11067,-0.06209786767425884,23.09,IS,0.58,0.0,Phase3-EA-SA2v2-USDCHF-M15-107,USDCHFMT4,2154,4h 15m,Sell
127339.05,1.20385,03.12.2014 06:20:00,,-2.11,-108.02999999994063,0.0,0.0,1.20454,02.12.2014 22:00:00,11068,-0.04968105343145556,27.0,IS,0.41,0.0,Phase3-EA-SA2v2-EURCHF-M5-43,EURCHFMT4,5612,8h 20m,Sell
127323.66,1.20339,03.12.2014 11:15:00,,0.0,-123.4199999999546,0.0,0.0,1.20383,03.12.2014 02:30:00,11069,-0.05675863754985985,-15.39,IS,0.34,0.0,Phase3-EA-S4v1-EURCHF-M15-221,EURCHFMT4,2944,8h 45m,Buy
127323.66,1.2033,04.12.2014 07:45:00,,-6.29,-123.4199999999546,0.0,0.0,1.20345,03.12.2014 23:25:00,11070,-0.05675863754985985,0.0,IS,0.41,0.0,Phase3-EA-SA2v2-EURCHF-M5-43,EURCHFMT4,5614,8h 20m,Sell
127289.57,147817,04.12.2014 13:29:57,sl 147.817,-1.49,-157.5099999999511,0.0,0.0,147587,03.12.2014 09:15:00,11071,-0.07243601523641986,-34.09,IS,0.17,0.0,Phase3-EA-T1v2-EURJPY-M15-322,EURJPYMT4,2038,1d 4h 14m,Sell
127229.45,148383,04.12.2014 17:59:58,sl 148.383,-1.59,-217.62999999994645,0.0,0.0,147603,28.11.2014 22:00:00,11072,-0.10008412161705967,-60.12,IS,0.09,0.0,Phase3-EA-TR1v1-EURJPY-M30-91,EURJPYMT4,1920,5d 19h 59m,Sell
127239.0,1.20238,05.12.2014 04:25:00,,-1.01,-208.0799999999581,0.0,0.0,1.20213,04.12.2014 20:05:00,11073,-0.09569224843118461,9.55,IS,0.41,0.0,Phase3-EA-SA2v2-EURCHF-M5-43,EURCHFMT4,5616,8h 20m,Buy
127188.36,187405,05.12.2014 04:59:58,sl 187.405,-0.27,-258.71999999997206,0.0,0.0,188075,04.12.2014 04:00:00,11074,-0.11898067336658205,-50.64,IS,0.09,0.0,Phase3-EA-B1v1-GBPJPY-M30-1,GBPJPYMT4,1040,1d 0h 59m,Buy
127129.9,149098,05.12.2014 16:59:58,sl 149.098,-0.26,-317.1799999999639,0.0,0.0,148318,04.12.2014 22:30:00,11075,-0.14586537561229235,-58.46,IS,0.09,0.0,Phase3-EA-TR1v1-EURJPY-M30-91,EURJPYMT4,1922,18h 29m,Sell
127219.23,120906,05.12.2014 17:44:57,tp 120.906,0.0,-227.84999999997672,0.0,0.0,120506,05.12.2014 17:30:00,11076,-0.10478411574897913,89.33,IS,0.27,0.0,Phase3-EA-S1v2-USDJPY-M15-0,USDJPYMT4,3144,14m 57s,Buy
127267.23,121566,08.12.2014 02:00:00,,-0.64,-179.84999999997672,0.0,0.0,121347,05.12.2014 23:45:00,11077,-0.08270977931732887,48.0,IS,0.27,0.0,Phase3-EA-S1v2-USDJPY-M15-0,USDJPYMT4,3146,2d 2h 15m,Buy
127278.38,1.20252,08.12.2014 06:00:00,,-1.01,-168.69999999998254,0.0,0.0,1.20223,05.12.2014 21:40:00,11078,-0.07758209491706278,11.15,IS,0.41,0.0,Phase3-EA-SA2v2-EURCHF-M5-43,EURCHFMT4,5618,2d 8h 20m,Buy
127299.94,189278,08.12.2014 07:35:00,,0.0,-147.13999999998487,0.0,0.0,189392,08.12.2014 02:10:00,11079,-0.06766703880318094,21.56,IS,0.23,0.0,Phase3-EA-S4v1-GBPJPY-M5-194,GBPJPYMT4,2566,5h 25m,Sell
127300.63,1.20261,08.12.2014 13:00:00,,0.0,-146.44999999998254,0.0,0.0,1.20263,08.12.2014 04:15:00,11080,-0.0673497202169749,0.69,IS,0.34,0.0,Phase3-EA-S4v1-EURCHF-M15-221,EURCHFMT4,2946,8h 45m,Sell
127329.45,120836,08.12.2014 19:15:00,,0.0,-117.62999999997555,0.0,0.0,120965,08.12.2014 19:00:00,11081,-0.05409592071780168,28.82,IS,0.27,0.0,Phase3-EA-S1v2-USDJPY-M15-0,USDJPYMT4,3148,15m 0s,Sell
127388.15,0.97631,09.12.2014 00:59:59,tp 0.97631,-0.71,-58.92999999996391,0.0,0.0,0.97531,08.12.2014 22:45:00,11082,-0.027100846789924027,58.7,IS,0.58,0.0,Phase3-EA-SA2v2-USDCHF-M15-107,USDCHFMT4,2156,2h 14m,Buy
127394.69,1.20222,09.12.2014 04:35:00,,-1.01,-52.38999999995576,0.0,0.0,1.20204,08.12.2014 20:15:00,11083,-0.02409321845110793,6.54,IS,0.41,0.0,Phase3-EA-SA2v2-EURCHF-M5-43,EURCHFMT4,5620,8h 20m,Buy
127381.63,0.97669,09.12.2014 05:30:00,,0.0,-65.44999999995343,0.0,0.0,0.97647,09.12.2014 01:15:00,11084,-0.0300992774885517,-13.06,IS,0.58,0.0,Phase3-EA-SA2v2-USDCHF-M15-107,USDCHFMT4,2158,4h 15m,Sell
127327.29,148126,09.12.2014 07:59:57,sl 148.126,-0.73,-119.78999999994994,0.0,0.0,148846,05.12.2014 14:00:00,11085,-0.05508926585721416,-54.34,IS,0.09,0.0,Phase3-EA-TR1v1-EURJPY-M30-91,EURJPYMT4,1923,3d 17h 59m,Buy
127333.93,1.20224,09.12.2014 15:00:00,,0.0,-113.14999999993597,0.0,0.0,1.20205,09.12.2014 06:15:00,11086,-0.052035649317496116,6.64,IS,0.34,0.0,Phase3-EA-S4v1-EURCHF-M15-221,EURCHFMT4,2948,8h 45m,Buy
127275.08,147503,09.12.2014 19:29:58,sl 147.503,0.0,-171.9999999999418,0.0,0.0,148283,09.12.2014 14:30:00,11087,-0.07909970554672,-58.85,IS,0.09,0.0,Phase3-EA-TR1v1-EURJPY-M30-91,EURJPYMT4,1926,4h 59m,Buy
127350.25,187029,10.12.2014 03:39:58,tp 187.029,0.0,-96.82999999992899,0.0,0.0,187419,10.12.2014 00:35:00,11088,-0.044530374930731816,75.17,IS,0.23,0.0,Phase3-EA-S4v1-GBPJPY-M5-194,GBPJPYMT4,2568,3h 4m,Sell
127343.35,119321,10.12.2014 03:45:00,,-1.02,-103.72999999992317,0.0,0.0,119295,09.12.2014 21:45:00,11089,-0.04770356079277886,-6.9,IS,0.27,0.0,Phase3-EA-S1v2-USDJPY-M15-0,USDJPYMT4,3150,6h 0m,Sell
127292.83,186.82,10.12.2014 08:29:58,sl 186.820,0.0,-154.2499999999127,0.0,0.0,187.49,10.12.2014 00:30:00,11090,-0.07093679988708594,-50.52,IS,0.09,0.0,Phase3-EA-B1v1-GBPJPY-M30-1,GBPJPYMT4,1042,7h 59m,Buy
127304.24,1.20172,10.12.2014 09:20:00,,0.0,-142.8399999999092,0.0,0.0,1.20199,10.12.2014 01:00:00,11091,-0.06568954616447747,11.41,IS,0.41,0.0,Phase3-EA-SA2v2-EURCHF-M5-43,EURCHFMT4,5622,8h 20m,Sell
127309.85,1.20178,10.12.2014 10:00:00,,0.0,-137.22999999992317,0.0,0.0,1.20194,10.12.2014 01:15:00,11092,-0.06310960809403478,5.61,IS,0.34,0.0,Phase3-EA-S4v1-EURCHF-M15-221,EURCHFMT4,2950,8h 45m,Sell
127151.57,185059,11.12.2014 00:09:57,sl 185.059,-2.1,-295.509999999922,0.0,0.0,185859,10.12.2014 23:05:00,11093,-0.13589973247740098,-158.28,IS,0.23,0.0,Phase3-EA-S4v1-GBPJPY-M5-194,GBPJPYMT4,2570,1h 4m,Buy
127127.76,1.20319,11.12.2014 04:25:00,,-6.36,-319.3199999999197,0.0,0.0,1.20278,10.12.2014 20:05:00,11094,-0.14684952311151642,-23.81,IS,0.41,0.0,Phase3-EA-SA2v2-EURCHF-M5-43,EURCHFMT4,5624,8h 20m,Sell
127076.68,185711,11.12.2014 05:59:58,sl 185.711,0.0,-370.39999999990687,0.0,0.0,185041,11.12.2014 02:00:00,11095,-0.17034029613085835,-51.08,IS,0.09,0.0,Phase3-EA-B1v1-GBPJPY-M30-1,GBPJPYMT4,1044,3h 59m,Sell
127021.79,147285,11.12.2014 05:59:58,sl 147.285,0.0,-425.28999999992084,0.0,0.0,146565,11.12.2014 02:00:00,11096,-0.19558321960447483,-54.89,IS,0.09,0.0,Phase3-EA-TR1v1-EURJPY-M30-91,EURJPYMT4,1928,3h 59m,Sell
126988.17,0.96601,11.12.2014 06:30:00,,0.0,-458.9099999999162,0.0,0.0,0.96657,11.12.2014 02:15:00,11097,-0.21104445274680772,-33.62,IS,0.58,0.0,Phase3-EA-SA2v2-USDCHF-M15-107,USDCHFMT4,2160,4h 15m,Buy
126944.57,1.56783,11.12.2014 12:59:58,sl 1.56783,-1.6,-502.509999999922,0.0,0.0,1.57083,10.12.2014 22:00:00,11098,-0.23109530833889272,-43.6,IS,0.14,0.0,Phase3-EA-B1v1-GBPUSD-M30-14,GBPUSDMT4,732,14h 59m,Buy
127008.25,1.20156,11.12.2014 14:30:00,,0.0,-438.829999999929,0.0,0.0,1.20337,11.12.2014 05:45:00,11099,-0.20181002200623993,63.68,IS,0.34,0.0,Phase3-EA-S4v1-EURCHF-M15-221,EURCHFMT4,2952,8h 45m,Sell
127058.48,118796,11.12.2014 18:00:00,,0.0,-388.5999999999185,0.0,0.0,118575,11.12.2014 17:45:00,11100,-0.17871014869453108,50.23,IS,0.27,0.0,Phase3-EA-S1v2-USDJPY-M15-0,USDJPYMT4,3152,15m 0s,Buy
127133.66,187492,12.12.2014 00:34:57,tp 187.492,0.0,-313.4199999999255,0.0,0.0,187102,12.12.2014 00:05:00,11101,-0.1441362192584621,75.18,IS,0.23,0.0,Phase3-EA-S4v1-GBPJPY-M5-194,GBPJPYMT4,2572,29m 57s,Buy
127133.07,1.20116,12.12.2014 04:45:00,,-1.01,-314.009999999922,0.0,0.0,1.20115,11.12.2014 20:25:00,11102,-0.14440754964376618,-0.59,IS,0.41,0.0,Phase3-EA-SA2v2-EURCHF-M5-43,EURCHFMT4,5626,8h 20m,Buy
127208.41,187349,12.12.2014 05:39:58,tp 187.349,0.0,-238.6699999999255,0.0,0.0,186959,12.12.2014 01:10:00,11103,-0.10976003908625673,75.34,IS,0.23,0.0,Phase3-EA-S4v1-GBPJPY-M5-194,GBPJPYMT4,2574,4h 29m,Buy
127219.78,0.96911,12.12.2014 05:45:00,,0.0,-227.29999999993015,0.0,0.0,0.96892,12.12.2014 01:30:00,11104,-0.10453118064401172,11.37,IS,0.58,0.0,Phase3-EA-SA2v2-USDCHF-M15-107,USDCHFMT4,2162,4h 15m,Buy
127220.83,1.20113,12.12.2014 10:30:00,,0.0,-226.2499999999418,0.0,0.0,1.2011,12.12.2014 01:45:00,11105,-0.10404830453457473,1.05,IS,0.34,0.0,Phase3-EA-S4v1-EURCHF-M15-221,EURCHFMT4,2954,8h 45m,Buy
127030.85,118371,12.12.2014 13:14:57,sl 118.371,-0.66,-416.22999999995227,0.0,0.0,119201,11.12.2014 23:45:00,11106,-0.1914166886030153,-189.98,IS,0.27,0.0,Phase3-EA-S1v2-USDJPY-M15-0,USDJPYMT4,3154,13h 29m,Buy
127000.66,118488,15.12.2014 02:15:00,,-1.02,-446.4199999999546,0.0,0.0,118.36,12.12.2014 17:00:00,11107,-0.2053005264545064,-30.19,IS,0.27,0.0,Phase3-EA-S1v2-USDJPY-M15-0,USDJPYMT4,3156,2d 9h 15m,Sell
126993.0,1.20115,15.12.2014 05:15:00,,-2.13,-454.0799999999581,0.0,0.0,1.20102,12.12.2014 20:55:00,11108,-0.2088232226433922,-7.66,IS,0.41,0.0,Phase3-EA-SA2v2-EURCHF-M5-43,EURCHFMT4,5628,2d 8h 20m,Sell
126960.1,147768,15.12.2014 06:14:58,sl 147.768,0.0,-486.97999999995227,0.0,0.0,147998,15.12.2014 06:00:00,11109,-0.2239533407392498,-32.9,IS,0.17,0.0,Phase3-EA-T1v2-EURJPY-M15-322,EURJPYMT4,2040,14m 58s,Buy
126956.93,1.20111,15.12.2014 12:00:00,,0.0,-490.1499999999651,0.0,0.0,1.20102,15.12.2014 03:15:00,11110,-0.2254111667077626,-3.17,IS,0.34,0.0,Phase3-EA-S4v1-EURCHF-M15-221,EURCHFMT4,2956,8h 45m,Sell
126914.93,1.57118,15.12.2014 12:29:58,sl 1.57118,0.0,-532.1499999999651,0.0,0.0,1.57418,15.12.2014 11:00:00,11111,-0.24472621108545656,-42.0,IS,0.14,0.0,Phase3-EA-B1v1-GBPUSD-M30-14,GBPUSDMT4,734,1h 29m,Buy
126724.69,117798,15.12.2014 20:44:58,sl 117.798,0.0,-722.3899999999558,0.0,0.0,118628,15.12.2014 18:00:00,11112,-0.33221416447622615,-190.24,IS,0.27,0.0,Phase3-EA-S1v2-USDJPY-M15-0,USDJPYMT4,3158,2h 44m,Buy
126716.87,1.20086,16.12.2014 07:10:00,,-1.02,-730.2099999999627,0.0,0.0,1.20102,15.12.2014 22:50:00,11113,-0.3358104417865524,-7.82,IS,0.41,0.0,Phase3-EA-SA2v2-EURCHF-M5-43,EURCHFMT4,5630,8h 20m,Buy
126715.46,1.20087,16.12.2014 11:00:00,,0.0,-731.6199999999662,0.0,0.0,1.20091,16.12.2014 02:15:00,11114,-0.3364588754192337,-1.41,IS,0.34,0.0,Phase3-EA-S4v1-EURCHF-M15-221,EURCHFMT4,2958,8h 45m,Buy
126655.66,145885,16.12.2014 12:29:58,sl 145.885,0.0,-791.4199999999546,0.0,0.0,146665,16.12.2014 05:30:00,11115,-0.36395981955699264,-59.8,IS,0.09,0.0,Phase3-EA-TR1v1-EURJPY-M30-91,EURJPYMT4,1930,6h 59m,Buy
126798.67,181846,16.12.2014 13:30:00,tp 181.846,0.0,-648.4099999999453,0.0,0.0,183696,16.12.2014 09:30:00,11116,-0.2981920934509404,143.01,IS,0.09,0.0,Phase3-EA-B1v1-GBPJPY-M30-1,GBPJPYMT4,1046,4h 0m,Sell
126738.03,145143,16.12.2014 16:29:57,sl 145.143,0.0,-709.0499999999593,0.0,0.0,145923,16.12.2014 15:00:00,11117,-0.32607933847626497,-60.64,IS,0.09,0.0,Phase3-EA-TR1v1-EURJPY-M30-91,EURJPYMT4,1932,1h 29m,Buy
126831.1,116044,16.12.2014 18:29:58,tp 116.044,0.0,-615.9799999999523,0.0,0.0,116444,16.12.2014 17:30:00,11118,-0.2832781198993099,93.07,IS,0.27,0.0,Phase3-EA-S1v2-USDJPY-M15-0,USDJPYMT4,3160,59m 58s,Sell
126930.27,146625,16.12.2014 20:29:58,tp 146.625,0.0,-516.8099999999395,0.0,0.0,145335,16.12.2014 16:30:00,11119,-0.23767162106749656,99.17,IS,0.09,0.0,Phase3-EA-TR1v1-EURJPY-M30-91,EURJPYMT4,1934,3h 59m,Buy
126739.25,117319,16.12.2014 20:29:58,sl 117.319,0.0,-707.829999999929,0.0,0.0,116489,16.12.2014 19:00:00,11120,-0.3255182824252799,-191.02,IS,0.27,0.0,Phase3-EA-S1v2-USDJPY-M15-0,USDJPYMT4,3162,1h 29m,Sell
126687.31,183241,17.12.2014 01:29:58,sl 183.241,-0.28,-759.7699999999313,0.0,0.0,183911,16.12.2014 19:30:00,11121,-0.34940455397236253,-51.94,IS,0.09,0.0,Phase3-EA-B1v1-GBPJPY-M30-1,GBPJPYMT4,1048,5h 59m,Buy
126653.82,146041,17.12.2014 03:59:57,sl 146.041,0.0,-793.259999999922,0.0,0.0,145811,17.12.2014 01:45:00,11122,-0.36480600245352424,-33.49,IS,0.17,0.0,Phase3-EA-T1v2-EURJPY-M15-322,EURJPYMT4,2042,2h 14m,Sell
126730.67,183918,17.12.2014 04:09:58,tp 183.918,0.0,-716.4099999999162,0.0,0.0,183528,17.12.2014 01:20:00,11123,-0.3294640700624315,76.85,IS,0.23,0.0,Phase3-EA-S4v1-GBPJPY-M5-194,GBPJPYMT4,2576,2h 49m,Buy
126716.36,116961,17.12.2014 08:00:00,,0.0,-730.7199999999139,0.0,0.0,117023,17.12.2014 00:45:00,11124,-0.3360449816111162,-14.31,IS,0.27,0.0,Phase3-EA-S1v2-USDJPY-M15-0,USDJPYMT4,3164,7h 15m,Buy
126720.62,1.20093,17.12.2014 10:25:00,,0.0,-726.4599999999045,0.0,0.0,1.20083,17.12.2014 02:05:00,11125,-0.33408588425280294,4.26,IS,0.41,0.0,Phase3-EA-SA2v2-EURCHF-M5-43,EURCHFMT4,5632,8h 20m,Buy
126687.23,146114,17.12.2014 14:29:58,sl 146.114,0.0,-759.8499999999185,0.0,0.0,145884,17.12.2014 14:00:00,11126,-0.34944134453307607,-33.39,IS,0.17,0.0,Phase3-EA-T1v2-EURJPY-M15-322,EURJPYMT4,2044,29m 58s,Sell
126653.82,145959,17.12.2014 23:14:58,sl 145.959,0.0,-793.259999999922,0.0,0.0,145729,17.12.2014 23:00:00,11127,-0.36480600245352424,-33.41,IS,0.17,0.0,Phase3-EA-T1v2-EURJPY-M15-322,EURJPYMT4,2046,14m 58s,Sell
126648.26,1.20084,18.12.2014 07:25:00,,-3.03,-798.8199999999197,0.0,0.0,1.2009,17.12.2014 23:05:00,11128,-0.3673629464235227,-5.56,IS,0.41,0.0,Phase3-EA-SA2v2-EURCHF-M5-43,EURCHFMT4,5634,8h 20m,Buy
126615.3,145.94,18.12.2014 20:44:58,sl 145.940,0.0,-831.7799999999115,0.0,0.0,145.71,18.12.2014 20:15:00,11129,-0.38252065743991875,-32.96,IS,0.17,0.0,Phase3-EA-T1v2-EURJPY-M15-322,EURJPYMT4,2048,29m 58s,Sell
126671.16,118941,19.12.2014 03:00:00,,-0.66,-775.9199999999255,0.0,0.0,118692,18.12.2014 20:15:00,11130,-0.3568316484175922,55.86,IS,0.27,0.0,Phase3-EA-S1v2-USDJPY-M15-0,USDJPYMT4,3166,6h 45m,Buy
126678.1,1.20402,19.12.2014 04:30:00,,-1.0,-768.9799999999232,0.0,0.0,1.20383,18.12.2014 20:10:00,11131,-0.3536400672751817,6.94,IS,0.41,0.0,Phase3-EA-SA2v2-EURCHF-M5-43,EURCHFMT4,5636,8h 20m,Buy
126737.25,0.98063,19.12.2014 04:44:58,tp 0.98063,0.0,-709.829999999929,0.0,0.0,0.97963,19.12.2014 01:45:00,11132,-0.32643804644326535,59.15,IS,0.58,0.0,Phase3-EA-SA2v2-USDCHF-M15-107,USDCHFMT4,2164,2h 59m,Buy
126737.94,1.20412,19.12.2014 12:45:00,,0.0,-709.1399999999267,0.0,0.0,1.20414,19.12.2014 04:00:00,11133,-0.3261207278570593,0.69,IS,0.34,0.0,Phase3-EA-S4v1-EURCHF-M15-221,EURCHFMT4,2960,8h 45m,Sell
126707.72,0.98445,22.12.2014 03:30:00,,-3.12,-739.3599999999278,0.0,0.0,0.98399,19.12.2014 23:15:00,11134,-0.34001836216881964,-30.22,IS,0.58,0.0,Phase3-EA-SA2v2-USDCHF-M15-107,USDCHFMT4,2166,2d 4h 15m,Sell
126715.89,1.20327,22.12.2014 04:25:00,,-1.0,-731.189999999915,0.0,0.0,1.20305,19.12.2014 20:05:00,11135,-0.3362611261553433,8.17,IS,0.41,0.0,Phase3-EA-SA2v2-EURCHF-M5-43,EURCHFMT4,5638,2d 8h 20m,Buy
126629.11,0.98448,23.12.2014 03:30:00,,-3.12,-817.9699999999139,0.0,0.0,0.98306,22.12.2014 23:15:00,11136,-0.37616968689573044,-86.78,IS,0.58,0.0,Phase3-EA-SA2v2-USDCHF-M15-107,USDCHFMT4,2168,4h 15m,Sell
126643.11,1.20318,23.12.2014 04:25:00,,-1.0,-803.9699999999139,0.0,0.0,1.20282,22.12.2014 20:05:00,11137,-0.36973133876983244,14.0,IS,0.41,0.0,Phase3-EA-SA2v2-EURCHF-M5-43,EURCHFMT4,5640,8h 20m,Buy
126630.32,1.2027,23.12.2014 15:30:00,,0.0,-816.759999999922,0.0,0.0,1.20307,23.12.2014 06:45:00,11138,-0.375613229664853,-12.79,IS,0.34,0.0,Phase3-EA-S4v1-EURCHF-M15-221,EURCHFMT4,2962,8h 45m,Buy
126890.79,1.55201,23.12.2014 17:29:58,tp 1.55201,-4.13,-556.2899999999208,0.0,0.0,1.57091,17.12.2014 12:00:00,11139,-0.25582776278252034,260.47,IS,0.14,0.0,Phase3-EA-B1v1-GBPUSD-M30-14,GBPUSDMT4,736,6d 5h 29m,Sell
126858.37,146815,23.12.2014 22:14:57,sl 146.815,0.0,-588.7099999999336,0.0,0.0,147045,23.12.2014 18:45:00,11140,-0.27073713751407,-32.42,IS,0.17,0.0,Phase3-EA-T1v2-EURJPY-M15-322,EURJPYMT4,2050,3h 29m,Buy
126881.42,120653,24.12.2014 04:15:00,,0.0,-565.6599999999453,0.0,0.0,120756,24.12.2014 00:15:00,11141,-0.2601368572067933,23.05,IS,0.27,0.0,Phase3-EA-S1v2-USDJPY-M15-0,USDJPYMT4,3168,4h 0m,Sell
126892.46,1.20248,24.12.2014 04:20:00,,-1.0,-554.6199999999371,0.0,0.0,1.20219,23.12.2014 20:00:00,11142,-0.25505975982751,11.04,IS,0.41,0.0,Phase3-EA-SA2v2-EURCHF-M5-43,EURCHFMT4,5642,8h 20m,Buy
126891.77,1.20235,24.12.2014 09:45:00,,0.0,-555.3099999999395,0.0,0.0,1.20237,24.12.2014 01:00:00,11143,-0.25537707841371604,-0.69,IS,0.34,0.0,Phase3-EA-S4v1-EURCHF-M15-221,EURCHFMT4,2964,8h 45m,Buy
126950.47,0.98812,29.12.2014 03:59:57,tp 0.98812,0.0,-496.6099999999278,0.0,0.0,0.98712,29.12.2014 02:15:00,11144,-0.2283820044858384,58.7,IS,0.58,0.0,Phase3-EA-SA2v2-USDCHF-M15-107,USDCHFMT4,2170,1h 44m,Buy
126917.99,146763,29.12.2014 04:44:58,sl 146.763,0.0,-529.0899999999383,0.0,0.0,146533,29.12.2014 04:00:00,11145,-0.24331897213792655,-32.48,IS,0.17,0.0,Phase3-EA-T1v2-EURJPY-M15-322,EURJPYMT4,2052,44m 58s,Sell
126921.44,1.20284,29.12.2014 15:15:00,,0.0,-525.6399999999267,0.0,0.0,1.20294,29.12.2014 06:30:00,11146,-0.24173237920689633,3.45,IS,0.34,0.0,Phase3-EA-S4v1-EURCHF-M15-221,EURCHFMT4,2966,8h 45m,Sell
126889.02,146761,29.12.2014 22:14:58,sl 146.761,0.0,-558.0599999999395,0.0,0.0,146991,29.12.2014 13:30:00,11147,-0.256641753938446,-32.42,IS,0.17,0.0,Phase3-EA-T1v2-EURJPY-M15-322,EURJPYMT4,2054,8h 44m,Buy
126926.95,0.98927,30.12.2014 02:45:00,,-3.11,-520.1299999999464,0.0,0.0,0.98997,29.12.2014 22:30:00,11148,-0.23919842933735558,37.93,IS,0.58,0.0,Phase3-EA-SA2v2-USDCHF-M15-107,USDCHFMT4,2172,4h 15m,Sell
126939.38,1.20295,30.12.2014 05:55:00,,-2.07,-507.69999999995343,0.0,0.0,1.2033,29.12.2014 21:35:00,11149,-0.23348209596557937,12.43,IS,0.41,0.0,Phase3-EA-SA2v2-EURCHF-M5-43,EURCHFMT4,5644,8h 20m,Sell
126882.64,146217,30.12.2014 06:29:58,sl 146.217,-2.94,-564.4399999999441,0.0,0.0,146.44,19.12.2014 17:30:00,11150,-0.2595758011558217,-56.74,IS,0.09,0.0,Phase3-EA-TR1v1-EURJPY-M30-91,EURJPYMT4,1936,10d 12h 59m,Sell
126876.13,1.20277,30.12.2014 10:15:00,,0.0,-570.9499999999534,0.0,0.0,1.20296,30.12.2014 01:30:00,11151,-0.26256963303436853,-6.51,IS,0.34,0.0,Phase3-EA-S4v1-EURCHF-M15-221,EURCHFMT4,2968,8h 45m,Buy
126823.54,186095,30.12.2014 11:59:58,sl 186.095,-2.43,-623.5399999999499,0.0,0.0,186765,19.12.2014 09:30:00,11152,-0.28675482788729373,-52.59,IS,0.09,0.0,Phase3-EA-B1v1-GBPJPY-M30-1,GBPJPYMT4,1050,11d 2h 29m,Buy
126918.1,145.15,30.12.2014 12:29:58,tp 145.150,-2.34,-528.9799999999523,0.0,0.0,146937,22.12.2014 13:00:00,11153,-0.24326838511694376,94.56,IS,0.09,0.0,Phase3-EA-TR1v1-EURJPY-M30-91,EURJPYMT4,1937,7d 23h 29m,Buy
126964.03,119323,30.12.2014 18:15:00,,0.0,-483.04999999995925,0.0,0.0,119526,30.12.2014 17:30:00,11154,-0.22214600444391164,45.93,IS,0.27,0.0,Phase3-EA-S1v2-USDJPY-M15-0,USDJPYMT4,3170,45m 0s,Sell
127058.95,144967,30.12.2014 18:29:58,tp 144.967,0.0,-388.12999999994645,0.0,0.0,146227,30.12.2014 07:30:00,11155,-0.17849400415031735,94.92,IS,0.09,0.0,Phase3-EA-TR1v1-EURJPY-M30-91,EURJPYMT4,1939,10h 59m,Sell
127008.44,185956,30.12.2014 20:59:57,sl 185.956,0.0,-438.63999999995576,0.0,0.0,185286,30.12.2014 19:00:00,11156,-0.20172264442454363,-50.51,IS,0.09,0.0,Phase3-EA-B1v1-GBPJPY-M30-1,GBPJPYMT4,1052,1h 59m,Sell
127064.02,0.9883,31.12.2014 02:00:00,tp 0.98830,-3.11,-383.05999999996857,0.0,0.0,0.9893,30.12.2014 22:30:00,11157,-0.1761624023647345,55.58,IS,0.58,0.0,Phase3-EA-SA2v2-USDCHF-M15-107,USDCHFMT4,2174,3h 30m,Sell
127049.89,119411,31.12.2014 03:30:00,,-1.02,-397.1899999999732,0.0,0.0,119353,30.12.2014 21:30:00,11158,-0.18266053515180367,-14.13,IS,0.27,0.0,Phase3-EA-S1v2-USDJPY-M15-0,USDJPYMT4,3172,6h 0m,Sell
127043.09,1.20235,31.12.2014 04:25:00,,-0.99,-403.9899999999616,0.0,0.0,1.20249,30.12.2014 20:05:00,11159,-0.18578773281294877,-6.8,IS,0.41,0.0,Phase3-EA-SA2v2-EURCHF-M5-43,EURCHFMT4,5646,8h 20m,Buy
127010.37,145384,31.12.2014 09:14:58,sl 145.384,0.0,-436.70999999996275,0.0,0.0,145154,31.12.2014 01:45:00,11160,-0.2008350721471909,-32.72,IS,0.17,0.0,Phase3-EA-T1v2-EURJPY-M15-322,EURJPYMT4,2056,7h 29m,Sell
127023.09,1.20259,31.12.2014 11:15:00,,0.0,-423.9899999999616,0.0,0.0,1.20222,31.12.2014 02:30:00,11161,-0.19498537299280305,12.72,IS,0.34,0.0,Phase3-EA-S4v1-EURCHF-M15-221,EURCHFMT4,2970,8h 45m,Buy
127260.27,143492,05.01.2015 02:14:58,tp 143.492,-2.48,-186.80999999996857,0.0,0.0,145192,31.12.2014 14:00:00,11162,-0.08591055809991441,237.18,IS,0.17,0.0,Phase3-EA-T1v2-EURJPY-M15-322,EURJPYMT4,2058,4d 12h 14m,Sell
127036.36,1.01022,05.01.2015 02:14:58,sl 1.01022,0.0,-410.71999999997206,0.0,0.0,1.00632,05.01.2015 02:00:00,11163,-0.18888273873347455,-223.91,IS,0.58,0.0,Phase3-EA-SA2v2-USDCHF-M15-107,USDCHFMT4,2176,14m 58s,Sell
127128.83,143721,05.01.2015 02:29:58,tp 143.721,-1.57,-318.2499999999709,0.0,0.0,144981,30.12.2014 19:30:00,11164,-0.14635744936191777,92.47,IS,0.09,0.0,Phase3-EA-TR1v1-EURJPY-M30-91,EURJPYMT4,1942,5d 6h 59m,Sell
127203.3,184023,05.01.2015 02:39:58,tp 184.023,0.0,-243.77999999996973,0.0,0.0,183633,05.01.2015 02:15:00,11165,-0.11211003615222984,74.47,IS,0.23,0.0,Phase3-EA-S4v1-GBPJPY-M5-194,GBPJPYMT4,2578,24m 58s,Buy
127229.13,120212,05.01.2015 04:15:00,,-2.02,-217.94999999998254,0.0,0.0,120336,02.01.2015 23:30:00,11166,-0.10023128385995393,25.83,IS,0.27,0.0,Phase3-EA-S1v2-USDJPY-M15-0,USDJPYMT4,3174,2d 4h 45m,Sell
127170.84,143137,05.01.2015 15:59:58,sl 143.137,0.0,-276.2399999999907,0.0,0.0,143917,05.01.2015 12:00:00,11167,-0.12703780616414298,-58.29,IS,0.09,0.0,Phase3-EA-TR1v1-EURJPY-M30-91,EURJPYMT4,1944,3h 59m,Buy
127227.73,1.00727,06.01.2015 02:44:58,tp 1.00727,-0.69,-219.34999999997672,0.0,0.0,1.00627,05.01.2015 23:30:00,11168,-0.10087511867254105,56.89,IS,0.58,0.0,Phase3-EA-SA2v2-USDCHF-M15-107,USDCHFMT4,2178,3h 14m,Buy
127317.2,119351,06.01.2015 02:44:58,tp 119.351,-1.02,-129.87999999997555,0.0,0.0,119751,05.01.2015 22:45:00,11169,-0.05972947532796242,89.47,IS,0.27,0.0,Phase3-EA-S1v2-USDJPY-M15-0,USDJPYMT4,3176,3h 59m,Sell
127273.58,181773,06.01.2015 08:15:00,,0.0,-173.4999999999709,0.0,0.0,181999,06.01.2015 02:50:00,11170,-0.07978952856022245,-43.62,IS,0.23,0.0,Phase3-EA-S4v1-GBPJPY-M5-194,GBPJPYMT4,2580,5h 25m,Buy
127516.41,142038,06.01.2015 10:59:57,tp 142.038,-0.5,-0.0,0.0,0.0,143738,05.01.2015 13:45:00,11171,-0.0,242.83,IS,0.17,0.0,Phase3-EA-T1v2-EURJPY-M15-322,EURJPYMT4,2060,21h 14m,Sell
127474.41,1.5229,06.01.2015 12:29:58,sl 1.52290,0.0,-42.0,0.0,0.0,1.5259,06.01.2015 08:30:00,11172,-0.019308888005277264,-42.0,IS,0.14,0.0,Phase3-EA-B1v1-GBPUSD-M30-14,GBPUSDMT4,738,3h 59m,Buy
127569.46,141.48,06.01.2015 13:59:57,tp 141.480,-0.26,-0.0,0.0,0.0,142.74,05.01.2015 18:00:00,11173,-0.0,95.05,IS,0.09,0.0,Phase3-EA-TR1v1-EURJPY-M30-91,EURJPYMT4,1946,19h 59m,Sell
127709.3,180053,06.01.2015 19:59:58,tp 180.053,0.0,-0.0,0.0,0.0,181903,06.01.2015 03:00:00,11174,-0.0,139.84,IS,0.09,0.0,Phase3-EA-B1v1-GBPJPY-M30-1,GBPJPYMT4,1054,16h 59m,Sell
127800.56,118349,07.01.2015 01:59:59,tp 118.349,0.0,-0.0,0.0,0.0,118749,07.01.2015 00:15:00,11175,-0.0,91.26,IS,0.27,0.0,Phase3-EA-S1v2-USDJPY-M15-0,USDJPYMT4,3178,1h 44m,Sell
127876.1,179759,07.01.2015 04:14:58,tp 179.759,0.0,-0.0,0.0,0.0,179369,07.01.2015 02:05:00,11176,-0.0,75.54,IS,0.23,0.0,Phase3-EA-S4v1-GBPJPY-M5-194,GBPJPYMT4,2582,2h 9m,Buy
127843.18,141218,07.01.2015 14:14:58,sl 141.218,0.0,-32.920000000012806,0.0,0.0,140988,07.01.2015 13:45:00,11177,-0.01510950489751404,-32.92,IS,0.17,0.0,Phase3-EA-T1v2-EURJPY-M15-322,EURJPYMT4,2062,29m 58s,Sell
127810.41,141101,07.01.2015 22:59:58,sl 141.101,0.0,-65.69000000000233,0.0,0.0,141331,07.01.2015 21:45:00,11178,-0.030150163326772367,-32.77,IS,0.17,0.0,Phase3-EA-T1v2-EURJPY-M15-322,EURJPYMT4,2064,1h 14m,Buy
127867.49,1.01616,07.01.2015 23:14:57,tp 1.01616,0.0,-8.610000000015134,0.0,0.0,1.01516,07.01.2015 22:00:00,11179,-0.003951787277271384,57.08,IS,0.58,0.0,Phase3-EA-SA2v2-USDCHF-M15-107,USDCHFMT4,2180,1h 14m,Buy
127862.35,119353,08.01.2015 04:45:00,,-1.97,-13.750000000029104,0.0,0.0,119367,07.01.2015 22:30:00,11180,-0.00631092625580732,-5.14,IS,0.27,0.0,Phase3-EA-S1v2-USDJPY-M15-0,USDJPYMT4,3180,6h 15m,Buy
127810.21,180735,08.01.2015 07:29:58,sl 180.735,-1.76,-65.89000000004307,0.0,0.0,180065,06.01.2015 20:00:00,11181,-0.030241958617784434,-52.14,IS,0.09,0.0,Phase3-EA-B1v1-GBPJPY-M30-1,GBPJPYMT4,1056,1d 11h 29m,Sell
127740.28,180614,08.01.2015 08:20:00,,0.0,-135.8200000000361,0.0,0.0,180.25,08.01.2015 02:55:00,11182,-0.062338182113611904,-69.93,IS,0.23,0.0,Phase3-EA-S4v1-GBPJPY-M5-194,GBPJPYMT4,2584,5h 25m,Sell
127761.84,119572,09.01.2015 05:15:00,,-1.02,-114.26000000003842,0.0,0.0,119672,08.01.2015 22:45:00,11183,-0.05244264974452804,21.56,IS,0.27,0.0,Phase3-EA-S1v2-USDJPY-M15-0,USDJPYMT4,3182,6h 30m,Sell
127856.28,140243,09.01.2015 20:29:58,tp 140.243,-1.32,-19.82000000003609,0.0,0.0,141503,06.01.2015 14:00:00,11184,-0.009096913337459206,94.44,IS,0.09,0.0,Phase3-EA-TR1v1-EURJPY-M30-91,EURJPYMT4,1948,3d 6h 29m,Sell
127832.36,179384,12.01.2015 07:35:00,,0.0,-43.740000000048894,0.0,0.0,179507,12.01.2015 02:10:00,11185,-0.020075630140271743,-23.92,IS,0.23,0.0,Phase3-EA-S4v1-GBPJPY-M5-194,GBPJPYMT4,2586,5h 25m,Buy
127789.83,1.51303,12.01.2015 12:29:58,sl 1.51303,-0.53,-86.27000000004773,0.0,0.0,1.51603,09.01.2015 19:30:00,11186,-0.03959589877001064,-42.53,IS,0.14,0.0,Phase3-EA-B1v1-GBPUSD-M30-14,GBPUSDMT4,740,2d 16h 59m,Buy
127667.79,118337,13.01.2015 02:45:00,,-0.66,-208.31000000005588,0.0,0.0,118869,12.01.2015 17:30:00,11187,-0.09560938533416675,-122.04,IS,0.27,0.0,Phase3-EA-S1v2-USDJPY-M15-0,USDJPYMT4,3184,9h 15m,Buy
127724.24,1.01506,13.01.2015 02:59:57,tp 1.01506,-0.69,-151.86000000004424,0.0,0.0,1.01406,12.01.2015 23:00:00,11188,-0.06970016445128366,56.45,IS,0.58,0.0,Phase3-EA-SA2v2-USDCHF-M15-107,USDCHFMT4,2182,3h 59m,Buy
127664.54,139655,13.01.2015 04:59:58,sl 139.655,-0.37,-211.56000000005588,0.0,0.0,140435,12.01.2015 06:30:00,11189,-0.09710105881280896,-59.7,IS,0.09,0.0,Phase3-EA-TR1v1-EURJPY-M30-91,EURJPYMT4,1950,22h 29m,Buy
127907.55,139366,13.01.2015 17:44:58,tp 139.366,-1.0,-0.0,0.0,0.0,141066,09.01.2015 06:45:00,11190,-0.0,243.01,IS,0.17,0.0,Phase3-EA-T1v2-EURJPY-M15-322,EURJPYMT4,2066,4d 10h 59m,Sell
127865.55,1.51427,13.01.2015 18:59:58,sl 1.51427,0.0,-42.0,0.0,0.0,1.51727,13.01.2015 17:00:00,11191,-0.01927422891037953,-42.0,IS,0.14,0.0,Phase3-EA-B1v1-GBPUSD-M30-14,GBPUSDMT4,742,1h 59m,Buy
127862.59,118458,13.01.2015 19:30:00,,0.0,-44.95999999999185,0.0,0.0,118445,13.01.2015 17:15:00,11192,-0.020632603138345397,-2.96,IS,0.27,0.0,Phase3-EA-S1v2-USDJPY-M15-0,USDJPYMT4,3186,2h 15m,Sell
127803.16,139.31,13.01.2015 20:59:59,sl 139.310,0.0,-104.38999999998487,0.0,0.0,140.09,13.01.2015 09:00:00,11193,-0.047905637046529226,-59.43,IS,0.09,0.0,Phase3-EA-TR1v1-EURJPY-M30-91,EURJPYMT4,1952,11h 59m,Buy
127900.31,137348,14.01.2015 13:59:58,tp 137.348,0.0,-7.239999999990687,0.0,0.0,138608,14.01.2015 00:30:00,11194,-0.0033225099359754356,97.15,IS,0.09,0.0,Phase3-EA-TR1v1-EURJPY-M30-91,EURJPYMT4,1954,13h 29m,Sell
127848.75,178583,14.01.2015 23:29:58,sl 178.583,0.0,-58.79999999998836,0.0,0.0,177913,14.01.2015 08:30:00,11195,-0.026983920474526,-51.56,IS,0.09,0.0,Phase3-EA-B1v1-GBPJPY-M30-1,GBPJPYMT4,1058,14h 59m,Sell
127896.65,1.01859,15.01.2015 00:44:58,tp 1.01859,-9.04,-10.89999999999418,0.0,0.0,1.01959,14.01.2015 23:30:00,11196,-0.005002121312452969,47.9,IS,0.58,0.0,Phase3-EA-SA2v2-USDCHF-M15-107,USDCHFMT4,2184,1h 14m,Sell
127973.07,178.83,15.01.2015 03:54:58,tp 178.830,0.0,-0.0,0.0,0.0,178.44,15.01.2015 02:40:00,11197,-0.0,76.42,IS,0.23,0.0,Phase3-EA-S4v1-GBPJPY-M5-194,GBPJPYMT4,2588,1h 14m,Buy
127779.39,117594,15.01.2015 04:14:58,sl 117.594,-3.11,-193.67999999999302,0.0,0.0,116764,14.01.2015 21:15:00,11198,-0.0888550131445099,-193.68,IS,0.27,0.0,Phase3-EA-S1v2-USDJPY-M15-0,USDJPYMT4,3188,6h 59m,Sell
127876.92,138.71,15.01.2015 06:29:58,tp 138.710,-1.13,-96.14999999999418,0.0,0.0,137.42,14.01.2015 17:00:00,11199,-0.044110953706342514,97.53,IS,0.09,0.0,Phase3-EA-TR1v1-EURJPY-M30-91,EURJPYMT4,1956,13h 29m,Buy
127975.69,136975,15.01.2015 13:59:58,tp 136.975,0.0,-0.0,0.0,0.0,138265,15.01.2015 13:00:00,11200,-0.0,98.77,IS,0.09,0.0,Phase3-EA-TR1v1-EURJPY-M30-91,EURJPYMT4,1958,59m 58s,Sell
128068.21,116.73,15.01.2015 19:14:57,tp 116.730,0.0,-0.0,0.0,0.0,117.13,15.01.2015 18:15:00,11201,-0.0,92.52,IS,0.27,0.0,Phase3-EA-S1v2-USDJPY-M15-0,USDJPYMT4,3190,59m 57s,Sell
128036.82,116975,15.01.2015 19:45:00,,0.0,-31.39000000001397,0.0,0.0,117111,15.01.2015 19:30:00,11202,-0.014394578650420329,-31.39,IS,0.27,0.0,Phase3-EA-S1v2-USDJPY-M15-0,USDJPYMT4,3192,15m 0s,Buy
128129.36,116709,15.01.2015 21:44:58,tp 116.709,0.0,-0.0,0.0,0.0,117109,15.01.2015 19:30:00,11203,-0.0,92.54,IS,0.27,0.0,Phase3-EA-S1v2-USDJPY-M15-0,USDJPYMT4,3193,2h 14m,Sell
128206.47,176.47,16.01.2015 03:04:59,tp 176.470,0.0,-0.0,0.0,0.0,176.08,16.01.2015 02:25:00,11204,-0.0,77.11,IS,0.23,0.0,Phase3-EA-S4v1-GBPJPY-M5-194,GBPJPYMT4,2590,39m 59s,Buy
128158.48,116406,16.01.2015 05:15:00,,-0.67,-47.98999999999069,0.0,0.0,116.61,15.01.2015 22:15:00,11205,-0.021992931740287255,-47.99,IS,0.27,0.0,Phase3-EA-S1v2-USDJPY-M15-0,USDJPYMT4,3196,7h 0m,Buy
128102.83,135748,16.01.2015 10:29:57,sl 135.748,0.0,-103.63999999998487,0.0,0.0,135028,16.01.2015 01:30:00,11206,-0.04749630017844302,-55.65,IS,0.09,0.0,Phase3-EA-TR1v1-EURJPY-M30-91,EURJPYMT4,1960,8h 59m,Sell
128069.45,135445,16.01.2015 19:29:58,sl 135.445,0.0,-137.01999999998952,0.0,0.0,135215,16.01.2015 15:00:00,11207,-0.06279373842580775,-33.38,IS,0.17,0.0,Phase3-EA-T1v2-EURJPY-M15-322,EURJPYMT4,2068,4h 29m,Sell
128145.78,178043,19.01.2015 03:54:58,tp 178.043,0.0,-60.69000000000233,0.0,0.0,177653,19.01.2015 02:30:00,11208,-0.02781310746652102,76.33,IS,0.23,0.0,Phase3-EA-S4v1-GBPJPY-M5-194,GBPJPYMT4,2592,1h 24m,Buy
128197.21,1.01725,19.01.2015 20:49:58,tp 1.01725,0.0,-9.260000000009313,0.0,0.0,1.01835,19.01.2015 20:15:00,11209,-0.004243687183065312,51.43,IS,0.41,0.0,Phase3-EA-SA2v2-EURCHF-M5-43,EURCHFMT4,5648,34m 58s,Sell
128248.56,1.01948,19.01.2015 23:44:58,tp 1.01948,0.0,-0.0,0.0,0.0,1.02058,19.01.2015 22:25:00,11210,-0.0,51.35,IS,0.41,0.0,Phase3-EA-SA2v2-EURCHF-M5-43,EURCHFMT4,5650,1h 19m,Sell
128194.07,0.87924,20.01.2015 02:45:00,,-6.99,-54.48999999999069,0.0,0.0,0.87852,19.01.2015 22:30:00,11211,-0.024966945944564466,-54.49,IS,0.58,0.0,Phase3-EA-SA2v2-USDCHF-M15-107,USDCHFMT4,2186,4h 15m,Sell
128134.71,137.29,20.01.2015 14:29:58,sl 137.290,0.0,-113.84999999997672,0.0,0.0,136.51,20.01.2015 04:00:00,11212,-0.05216529263697135,-59.36,IS,0.09,0.0,Phase3-EA-TR1v1-EURJPY-M30-91,EURJPYMT4,1962,10h 29m,Sell
128186.11,1.01421,20.01.2015 20:09:59,tp 1.01421,0.0,-62.44999999998254,0.0,0.0,1.01531,20.01.2015 20:05:00,11213,-0.028614163594015075,51.4,IS,0.41,0.0,Phase3-EA-SA2v2-EURCHF-M5-43,EURCHFMT4,5652,4m 59s,Sell
128258.11,137.03,20.01.2015 21:15:00,,0.0,-0.0,0.0,0.0,136528,20.01.2015 04:30:00,11214,-0.0,72.0,IS,0.17,0.0,Phase3-EA-T1v2-EURJPY-M15-322,EURJPYMT4,2070,16h 45m,Buy
128313.35,118764,20.01.2015 22:30:00,,0.0,-0.0,0.0,0.0,118521,20.01.2015 19:15:00,11215,-0.0,55.24,IS,0.27,0.0,Phase3-EA-S1v2-USDJPY-M15-0,USDJPYMT4,3198,3h 15m,Buy
128362.47,1.01189,21.01.2015 00:19:57,tp 1.01189,-2.34,-0.0,0.0,0.0,1.01299,20.01.2015 23:25:00,11216,-0.0,49.12,IS,0.41,0.0,Phase3-EA-SA2v2-EURCHF-M5-43,EURCHFMT4,5654,54m 57s,Sell
128460.78,135.89,21.01.2015 10:59:58,tp 135.890,-0.27,-0.0,0.0,0.0,137.18,20.01.2015 19:30:00,11217,-0.0,98.31,IS,0.09,0.0,Phase3-EA-TR1v1-EURJPY-M30-91,EURJPYMT4,1964,15h 29m,Sell
128616.5,1.01269,21.01.2015 11:59:59,tp 1.01269,0.0,-0.0,0.0,0.0,1.00869,21.01.2015 04:00:00,11218,-0.0,155.72,IS,0.34,0.0,Phase3-EA-S4v1-EURCHF-M15-221,EURCHFMT4,2972,7h 59m,Buy
128668.78,0.99841,21.01.2015 23:14:58,tp 0.99841,0.0,-0.0,0.0,0.0,0.99731,21.01.2015 23:05:00,11219,-0.0,52.28,IS,0.41,0.0,Phase3-EA-SA2v2-EURCHF-M5-43,EURCHFMT4,5656,9m 58s,Buy
128601.32,117858,22.01.2015 03:45:00,,-3.09,-67.45999999999185,0.0,0.0,117577,21.01.2015 19:45:00,11220,-0.030850311599118732,-67.46,IS,0.27,0.0,Phase3-EA-S1v2-USDJPY-M15-0,USDJPYMT4,3200,8h 0m,Sell
128548.81,178.83,22.01.2015 04:29:58,sl 178.830,-1.33,-119.97000000000116,0.0,0.0,178.16,21.01.2015 11:00:00,11221,-0.05486379902974737,-52.51,IS,0.09,0.0,Phase3-EA-B1v1-GBPJPY-M30-1,GBPJPYMT4,1060,17h 29m,Sell
128493.25,137.16,22.01.2015 07:29:58,sl 137.160,-0.8,-175.52999999999884,0.0,0.0,136.44,21.01.2015 07:30:00,11222,-0.08027209005327497,-55.56,IS,0.09,0.0,Phase3-EA-TR1v1-EURJPY-M30-91,EURJPYMT4,1965,23h 59m,Sell
128651.4,0.99524,22.01.2015 10:14:58,tp 0.99524,0.0,-17.380000000004657,0.0,0.0,0.99924,22.01.2015 06:30:00,11223,-0.007948093916289535,158.15,IS,0.34,0.0,Phase3-EA-S4v1-EURCHF-M15-221,EURCHFMT4,2974,3h 44m,Sell
128633.52,117781,22.01.2015 17:45:00,,0.0,-35.26000000000931,0.0,0.0,117703,22.01.2015 17:30:00,11224,-0.016124844159284692,-17.88,IS,0.27,0.0,Phase3-EA-S1v2-USDJPY-M15-0,USDJPYMT4,3202,15m 0s,Sell
128732.17,135571,22.01.2015 18:29:58,tp 135.571,0.0,-0.0,0.0,0.0,136861,22.01.2015 11:00:00,11225,-0.0,98.65,IS,0.09,0.0,Phase3-EA-TR1v1-EURJPY-M30-91,EURJPYMT4,1968,7h 29m,Sell
128824.18,117379,22.01.2015 18:44:58,tp 117.379,0.0,-0.0,0.0,0.0,117779,22.01.2015 17:45:00,11226,-0.0,92.01,IS,0.27,0.0,Phase3-EA-S1v2-USDJPY-M15-0,USDJPYMT4,3204,59m 58s,Sell
128819.81,117417,22.01.2015 19:00:00,,0.0,-4.369999999995343,0.0,0.0,117398,22.01.2015 18:45:00,11227,-0.0019970370733231203,-4.37,IS,0.27,0.0,Phase3-EA-S1v2-USDJPY-M15-0,USDJPYMT4,3206,15m 0s,Sell
128895.36,178016,23.01.2015 04:04:58,tp 178.016,0.0,-0.0,0.0,0.0,178406,23.01.2015 03:35:00,11228,-0.0,75.55,IS,0.23,0.0,Phase3-EA-S4v1-GBPJPY-M5-194,GBPJPYMT4,2594,29m 58s,Sell
128761.8,0.98697,23.01.2015 09:40:00,,0.0,-133.55999999999767,0.0,0.0,0.98981,23.01.2015 01:20:00,11229,-0.06101545505578412,-133.56,IS,0.41,0.0,Phase3-EA-SA2v2-EURCHF-M5-43,EURCHFMT4,5658,8h 20m,Buy
128695.93,0.98771,23.01.2015 10:45:00,,0.0,-199.42999999999302,0.0,0.0,0.9894,23.01.2015 02:00:00,11230,-0.09110745883329449,-65.87,IS,0.34,0.0,Phase3-EA-S4v1-EURCHF-M15-221,EURCHFMT4,2976,8h 45m,Buy
128791.64,133.38,23.01.2015 12:59:58,tp 133.380,-0.27,-103.72000000000116,0.0,0.0,134.64,22.01.2015 20:00:00,11231,-0.047383370757607894,95.71,IS,0.09,0.0,Phase3-EA-TR1v1-EURJPY-M30-91,EURJPYMT4,1970,16h 59m,Sell
128887.94,131736,23.01.2015 16:29:58,tp 131.736,0.0,-7.420000000012806,0.0,0.0,132996,23.01.2015 14:30:00,11232,-0.003389747503105027,96.3,IS,0.09,0.0,Phase3-EA-TR1v1-EURJPY-M30-91,EURJPYMT4,1972,1h 59m,Sell
128833.12,132462,23.01.2015 17:59:58,sl 132.462,0.0,-62.24000000001979,0.0,0.0,131742,23.01.2015 16:30:00,11233,-0.028433677168862515,-54.82,IS,0.09,0.0,Phase3-EA-TR1v1-EURJPY-M30-91,EURJPYMT4,1974,1h 29m,Sell
128884.55,0.98807,23.01.2015 20:44:58,tp 0.98807,0.0,-10.810000000026776,0.0,0.0,0.98917,23.01.2015 20:40:00,11234,-0.004938432683098769,51.43,IS,0.41,0.0,Phase3-EA-SA2v2-EURCHF-M5-43,EURCHFMT4,5660,4m 58s,Sell
128950.64,0.87763,23.01.2015 22:44:58,tp 0.87763,0.0,-0.0,0.0,0.0,0.87863,23.01.2015 22:30:00,11235,-0.0,66.09,IS,0.58,0.0,Phase3-EA-SA2v2-USDCHF-M15-107,USDCHFMT4,2188,14m 58s,Sell
129037.38,117508,26.01.2015 02:00:00,,-1.03,-0.0,0.0,0.0,117.89,23.01.2015 21:15:00,11236,-0.0,86.74,IS,0.27,0.0,Phase3-EA-S1v2-USDJPY-M15-0,USDJPYMT4,3208,2d 4h 45m,Sell
128994.85,1.49867,26.01.2015 03:59:58,sl 1.49867,-0.53,-42.529999999998836,0.0,0.0,1.50167,23.01.2015 22:00:00,11237,-0.019416777172918422,-42.53,IS,0.14,0.0,Phase3-EA-B1v1-GBPUSD-M30-14,GBPUSDMT4,744,2d 5h 59m,Buy
129046.03,0.98256,26.01.2015 04:04:58,tp 0.98256,0.0,-0.0,0.0,0.0,0.98146,26.01.2015 02:05:00,11238,-0.0,51.18,IS,0.41,0.0,Phase3-EA-SA2v2-EURCHF-M5-43,EURCHFMT4,5662,1h 59m,Buy
128994.65,176685,26.01.2015 04:29:58,sl 176.685,0.0,-51.38000000000466,0.0,0.0,176015,26.01.2015 03:30:00,11239,-0.023456257116371546,-51.38,IS,0.09,0.0,Phase3-EA-B1v1-GBPJPY-M30-1,GBPJPYMT4,1062,59m 58s,Sell
128939.44,131805,26.01.2015 04:29:58,sl 131.805,0.0,-106.58999999999651,0.0,0.0,131085,26.01.2015 03:00:00,11240,-0.048661005177768286,-55.21,IS,0.09,0.0,Phase3-EA-TR1v1-EURJPY-M30-91,EURJPYMT4,1976,1h 29m,Sell
129093.79,0.98521,26.01.2015 10:44:59,tp 0.98521,0.0,-0.0,0.0,0.0,0.98121,26.01.2015 04:00:00,11241,-0.0,154.35,IS,0.34,0.0,Phase3-EA-S4v1-EURCHF-M15-221,EURCHFMT4,2978,6h 44m,Buy
129038.79,132153,26.01.2015 10:59:58,sl 132.153,0.0,-55.0,0.0,0.0,131433,26.01.2015 07:30:00,11242,-0.025103404345691256,-55.0,IS,0.09,0.0,Phase3-EA-TR1v1-EURJPY-M30-91,EURJPYMT4,1978,3h 29m,Sell
128996.79,1.50094,26.01.2015 12:59:58,sl 1.50094,0.0,-97.0,0.0,0.0,1.50394,26.01.2015 12:00:00,11243,-0.04427327675512821,-42.0,IS,0.14,0.0,Phase3-EA-B1v1-GBPUSD-M30-14,GBPUSDMT4,746,59m 58s,Buy
129046.92,1.01199,26.01.2015 21:39:58,tp 1.01199,0.0,-46.86999999999534,0.0,0.0,1.01309,26.01.2015 20:25:00,11244,-0.021392664757862404,50.13,IS,0.41,0.0,Phase3-EA-SA2v2-EURCHF-M5-43,EURCHFMT4,5664,1h 14m,Sell
129187.47,178751,26.01.2015 22:59:58,tp 178.751,0.0,-0.0,0.0,0.0,176901,26.01.2015 10:30:00,11245,-0.0,140.55,IS,0.09,0.0,Phase3-EA-B1v1-GBPJPY-M30-1,GBPJPYMT4,1064,12h 29m,Buy
129237.37,1.01497,27.01.2015 01:24:58,tp 1.01497,0.0,-0.0,0.0,0.0,1.01607,27.01.2015 01:05:00,11246,-0.0,49.9,IS,0.41,0.0,Phase3-EA-SA2v2-EURCHF-M5-43,EURCHFMT4,5666,19m 58s,Sell
129301.68,0.90194,27.01.2015 02:29:57,tp 0.90194,0.0,-0.0,0.0,0.0,0.90294,27.01.2015 01:30:00,11247,-0.0,64.31,IS,0.58,0.0,Phase3-EA-SA2v2-USDCHF-M15-107,USDCHFMT4,2190,59m 57s,Sell
129321.31,178671,27.01.2015 06:30:00,,0.0,-0.0,0.0,0.0,178772,27.01.2015 01:05:00,11248,-0.0,19.63,IS,0.23,0.0,Phase3-EA-S4v1-GBPJPY-M5-194,GBPJPYMT4,2596,5h 25m,Sell
129270.17,178171,27.01.2015 10:59:59,sl 178.171,0.0,-51.14000000001397,0.0,0.0,178841,27.01.2015 01:00:00,11249,-0.023317387626406966,-51.14,IS,0.09,0.0,Phase3-EA-B1v1-GBPJPY-M30-1,GBPJPYMT4,1066,9h 59m,Buy
129237.07,133364,27.01.2015 14:29:58,sl 133.364,0.0,-84.24000000001979,0.0,0.0,133594,27.01.2015 12:45:00,11250,-0.03840940034510066,-33.1,IS,0.17,0.0,Phase3-EA-T1v2-EURJPY-M15-322,EURJPYMT4,2072,1h 44m,Buy
129287.06,1.02623,27.01.2015 20:19:57,tp 1.02623,0.0,-34.250000000029104,0.0,0.0,1.02733,27.01.2015 20:05:00,11251,-0.0156163575714685,49.99,IS,0.41,0.0,Phase3-EA-SA2v2-EURCHF-M5-43,EURCHFMT4,5668,14m 57s,Sell
129336.99,1.02745,27.01.2015 21:09:58,tp 1.02745,0.0,-0.0,0.0,0.0,1.02855,27.01.2015 20:55:00,11252,-0.0,49.93,IS,0.41,0.0,Phase3-EA-SA2v2-EURCHF-M5-43,EURCHFMT4,5670,14m 58s,Sell
129386.95,1.02594,27.01.2015 21:19:57,tp 1.02594,0.0,-0.0,0.0,0.0,1.02704,27.01.2015 21:10:00,11253,-0.0,49.96,IS,0.41,0.0,Phase3-EA-SA2v2-EURCHF-M5-43,EURCHFMT4,5672,9m 57s,Sell
129436.98,1.02564,27.01.2015 22:59:58,tp 1.02564,0.0,-0.0,0.0,0.0,1.02454,27.01.2015 22:40:00,11254,-0.0,50.03,IS,0.41,0.0,Phase3-EA-SA2v2-EURCHF-M5-43,EURCHFMT4,5674,19m 58s,Buy
129501.29,0.90186,27.01.2015 23:44:57,tp 0.90186,0.0,-0.0,0.0,0.0,0.90086,27.01.2015 23:30:00,11255,-0.0,64.31,IS,0.58,0.0,Phase3-EA-SA2v2-USDCHF-M15-107,USDCHFMT4,2192,14m 57s,Buy
129596.78,134154,28.01.2015 01:59:57,tp 134.154,-0.74,-0.0,0.0,0.0,132894,26.01.2015 13:00:00,11256,-0.0,95.49,IS,0.09,0.0,Phase3-EA-TR1v1-EURJPY-M30-91,EURJPYMT4,1980,1d 12h 59m,Buy
129567.09,117751,28.01.2015 03:15:00,,-1.03,-29.69000000000233,0.0,0.0,117626,27.01.2015 21:00:00,11257,-0.013520234677394704,-29.69,IS,0.27,0.0,Phase3-EA-S1v2-USDJPY-M15-0,USDJPYMT4,3210,6h 15m,Sell
129617.1,1.02466,28.01.2015 03:19:58,tp 1.02466,0.0,-0.0,0.0,0.0,1.02576,28.01.2015 01:15:00,11258,-0.0,50.01,IS,0.41,0.0,Phase3-EA-SA2v2-EURCHF-M5-43,EURCHFMT4,5676,2h 4m,Sell
129767.7,1.02569,28.01.2015 04:44:58,tp 1.02569,0.0,-0.0,0.0,0.0,1.02169,28.01.2015 04:00:00,11259,-0.0,150.6,IS,0.34,0.0,Phase3-EA-S4v1-EURCHF-M15-221,EURCHFMT4,2980,44m 58s,Buy
129734.59,133705,28.01.2015 12:29:58,sl 133.705,0.0,-33.10999999998603,0.0,0.0,133935,28.01.2015 08:45:00,11260,-0.01506590822945585,-33.11,IS,0.17,0.0,Phase3-EA-T1v2-EURJPY-M15-322,EURJPYMT4,2074,3h 44m,Buy
129692.59,1.51792,28.01.2015 18:59:58,sl 1.51792,0.0,-75.10999999998603,0.0,0.0,1.52092,28.01.2015 16:30:00,11261,-0.034176996892621436,-42.0,IS,0.14,0.0,Phase3-EA-B1v1-GBPUSD-M30-14,GBPUSDMT4,748,2h 29m,Buy
129691.44,117767,28.01.2015 20:30:00,,0.0,-76.25999999998021,0.0,0.0,117762,28.01.2015 18:00:00,11262,-0.034700276701253085,-1.15,IS,0.27,0.0,Phase3-EA-S1v2-USDJPY-M15-0,USDJPYMT4,3212,2h 30m,Sell
129741.31,1.02632,28.01.2015 21:39:57,tp 1.02632,0.0,-26.389999999984866,0.0,0.0,1.02742,28.01.2015 21:10:00,11263,-0.012008134043348826,49.87,IS,0.41,0.0,Phase3-EA-SA2v2-EURCHF-M5-43,EURCHFMT4,5678,29m 57s,Sell
129791.18,1.0268,28.01.2015 22:04:58,tp 1.02680,0.0,-0.0,0.0,0.0,1.0279,28.01.2015 22:00:00,11264,-0.0,49.87,IS,0.41,0.0,Phase3-EA-SA2v2-EURCHF-M5-43,EURCHFMT4,5680,4m 58s,Sell
129889.09,132618,29.01.2015 00:59:58,tp 132.618,-0.8,-0.0,0.0,0.0,133908,28.01.2015 06:00:00,11265,-0.0,97.91,IS,0.09,0.0,Phase3-EA-TR1v1-EURJPY-M30-91,EURJPYMT4,1982,18h 59m,Sell
129953.16,0.90525,29.01.2015 01:44:57,tp 0.90525,0.0,-0.0,0.0,0.0,0.90625,29.01.2015 00:45:00,11266,-0.0,64.07,IS,0.58,0.0,Phase3-EA-SA2v2-USDCHF-M15-107,USDCHFMT4,2194,59m 57s,Sell
130002.98,1.02123,29.01.2015 03:14:58,tp 1.02123,0.0,-0.0,0.0,0.0,1.02013,29.01.2015 02:50:00,11267,-0.0,49.82,IS,0.41,0.0,Phase3-EA-SA2v2-EURCHF-M5-43,EURCHFMT4,5682,24m 58s,Buy
130153.18,1.02467,29.01.2015 04:59:58,tp 1.02467,0.0,-0.0,0.0,0.0,1.02067,29.01.2015 03:00:00,11268,-0.0,150.2,IS,0.34,0.0,Phase3-EA-S4v1-EURCHF-M15-221,EURCHFMT4,2982,1h 59m,Buy
130137.59,178316,29.01.2015 05:05:00,,-2.11,-15.589999999996508,0.0,0.0,178385,28.01.2015 23:40:00,11269,-0.007081433027674829,-15.59,IS,0.23,0.0,Phase3-EA-S4v1-GBPJPY-M5-194,GBPJPYMT4,2598,5h 25m,Buy
129991.94,1.02999,29.01.2015 13:14:57,sl 1.02999,0.0,-161.2399999999907,0.0,0.0,1.02609,29.01.2015 05:45:00,11270,-0.07323991413614363,-145.65,IS,0.34,0.0,Phase3-EA-S4v1-EURCHF-M15-221,EURCHFMT4,2984,7h 29m,Sell
130022.26,118425,30.01.2015 03:30:00,,0.0,-130.9199999999837,0.0,0.0,118292,30.01.2015 01:00:00,11271,-0.05946768518173707,30.32,IS,0.27,0.0,Phase3-EA-S1v2-USDJPY-M15-0,USDJPYMT4,3214,2h 30m,Buy
130012.48,1.04376,30.01.2015 05:10:00,,-2.22,-140.69999999998254,0.0,0.0,1.04359,29.01.2015 20:50:00,11272,-0.0639100466320685,-9.78,IS,0.41,0.0,Phase3-EA-SA2v2-EURCHF-M5-43,EURCHFMT4,5684,8h 20m,Sell
129957.07,133248,30.01.2015 13:29:58,sl 133.248,-0.37,-196.10999999998603,0.0,0.0,133968,29.01.2015 19:30:00,11273,-0.08907888589207973,-55.41,IS,0.09,0.0,Phase3-EA-TR1v1-EURJPY-M30-91,EURJPYMT4,1984,17h 59m,Buy
129986.0,117574,30.01.2015 19:15:00,,0.0,-167.17999999999302,0.0,0.0,117.7,30.01.2015 18:45:00,11274,-0.0759380355078187,28.93,IS,0.27,0.0,Phase3-EA-S1v2-USDJPY-M15-0,USDJPYMT4,3216,30m 0s,Sell
129987.84,117564,30.01.2015 19:45:00,,0.0,-165.3399999999965,0.0,0.0,117572,30.01.2015 19:15:00,11275,-0.07510225380346336,1.84,IS,0.27,0.0,Phase3-EA-S1v2-USDJPY-M15-0,USDJPYMT4,3218,30m 0s,Sell
130036.8,1.04125,30.01.2015 20:09:57,tp 1.04125,0.0,-116.38000000000466,0.0,0.0,1.04015,30.01.2015 20:05:00,11276,-0.052863192800578204,48.96,IS,0.41,0.0,Phase3-EA-SA2v2-EURCHF-M5-43,EURCHFMT4,5686,4m 57s,Buy
130085.84,1.04009,30.01.2015 22:44:58,tp 1.04009,0.0,-67.33999999999651,0.0,0.0,1.03899,30.01.2015 22:05:00,11277,-0.030587793462713602,49.04,IS,0.41,0.0,Phase3-EA-SA2v2-EURCHF-M5-43,EURCHFMT4,5688,39m 58s,Buy
130134.71,1.03996,30.01.2015 23:44:58,tp 1.03996,0.0,-18.470000000001164,0.0,0.0,1.04106,30.01.2015 23:35:00,11278,-0.008389613086670406,48.87,IS,0.41,0.0,Phase3-EA-SA2v2-EURCHF-M5-43,EURCHFMT4,5690,9m 58s,Sell
129886.57,0.92407,02.02.2015 02:00:00,sl 0.92407,-3.35,-266.61000000001513,0.0,0.0,0.92017,30.01.2015 23:45:00,11279,-0.12110204358620373,-248.14,IS,0.58,0.0,Phase3-EA-SA2v2-USDCHF-M15-107,USDCHFMT4,2196,2d 2h 15m,Sell
129935.46,1.04497,02.02.2015 02:49:58,tp 1.04497,0.0,-217.72000000000116,0.0,0.0,1.04607,02.02.2015 02:10:00,11280,-0.09889477862640907,48.89,IS,0.41,0.0,Phase3-EA-SA2v2-EURCHF-M5-43,EURCHFMT4,5692,39m 58s,Sell
130083.1,1.04001,02.02.2015 03:44:58,tp 1.04001,0.0,-70.0799999999872,0.0,0.0,1.04401,02.02.2015 03:00:00,11281,-0.031832381435501766,147.64,IS,0.34,0.0,Phase3-EA-S4v1-EURCHF-M15-221,EURCHFMT4,2986,44m 58s,Sell
130060.98,176866,02.02.2015 04:25:00,,-1.14,-92.19999999998254,0.0,0.0,176759,30.01.2015 23:00:00,11282,-0.04187993105526888,-22.12,IS,0.23,0.0,Phase3-EA-S4v1-GBPJPY-M5-194,GBPJPYMT4,2600,2d 5h 25m,Sell
129917.93,1.04958,02.02.2015 11:14:58,sl 1.04958,0.0,-235.2499999999709,0.0,0.0,1.04568,02.02.2015 06:15:00,11283,-0.10685741627714372,-143.05,IS,0.34,0.0,Phase3-EA-S4v1-EURCHF-M15-221,EURCHFMT4,2988,4h 59m,Sell
129966.63,1.04914,02.02.2015 20:09:58,tp 1.04914,0.0,-186.54999999995925,0.0,0.0,1.04804,02.02.2015 20:05:00,11284,-0.0847364548629087,48.7,IS,0.41,0.0,Phase3-EA-SA2v2-EURCHF-M5-43,EURCHFMT4,5694,4m 58s,Buy
130015.37,1.0491,02.02.2015 20:59:58,tp 1.04910,0.0,-137.80999999996857,0.0,0.0,1048,02.02.2015 20:20:00,11285,-0.06259732428119719,48.74,IS,0.41,0.0,Phase3-EA-SA2v2-EURCHF-M5-43,EURCHFMT4,5696,39m 58s,Buy
130063.97,1.05113,03.02.2015 00:39:58,tp 1.05113,0.0,-89.20999999996275,0.0,0.0,1.05223,03.02.2015 00:20:00,11286,-0.04052178578567987,48.6,IS,0.41,0.0,Phase3-EA-SA2v2-EURCHF-M5-43,EURCHFMT4,5698,19m 58s,Sell
130081.7,117278,03.02.2015 05:45:00,,0.0,-71.47999999995227,0.0,0.0,117355,03.02.2015 00:30:00,11287,-0.03246830229749661,17.73,IS,0.27,0.0,Phase3-EA-S1v2-USDJPY-M15-0,USDJPYMT4,3220,5h 15m,Sell
130118.0,176326,03.02.2015 06:20:00,,0.0,-35.17999999996391,0.0,0.0,176511,03.02.2015 00:55:00,11288,-0.01597978280393847,36.3,IS,0.23,0.0,Phase3-EA-S4v1-GBPJPY-M5-194,GBPJPYMT4,2602,5h 25m,Sell
130265.28,1.04854,03.02.2015 08:29:58,tp 1.04854,0.0,-0.0,0.0,0.0,1.05254,03.02.2015 06:30:00,11289,-0.0,147.28,IS,0.34,0.0,Phase3-EA-S4v1-EURCHF-M15-221,EURCHFMT4,2990,1h 59m,Sell
130223.28,1.50436,03.02.2015 14:29:58,sl 1.50436,0.0,-42.0,0.0,0.0,1.50136,03.02.2015 10:30:00,11290,-0.019067916650322623,-42.0,IS,0.14,0.0,Phase3-EA-B1v1-GBPUSD-M30-14,GBPUSDMT4,750,3h 59m,Sell
130168.05,133158,03.02.2015 14:29:58,sl 133.158,0.0,-97.23000000001048,0.0,0.0,133082,02.02.2015 06:00:00,11291,-0.04414222704550162,-55.23,IS,0.09,0.0,Phase3-EA-TR1v1-EURJPY-M30-91,EURJPYMT4,1986,1d 8h 29m,Buy
130266.56,134372,03.02.2015 17:59:58,tp 134.372,-0.38,-0.0,0.0,0.0,132438,03.02.2015 09:30:00,11292,-0.0,98.51,IS,0.09,0.0,Phase3-EA-TR1v1-EURJPY-M30-91,EURJPYMT4,1987,8h 29m,Sell
130346.85,117696,03.02.2015 18:00:00,,0.0,-0.0,0.0,0.0,117346,03.02.2015 17:00:00,11293,-0.0,80.29,IS,0.27,0.0,Phase3-EA-S1v2-USDJPY-M15-0,USDJPYMT4,3222,1h 0m,Buy
130409.91,0.91975,03.02.2015 22:44:59,tp 0.91975,0.0,-0.0,0.0,0.0,0.91875,03.02.2015 22:30:00,11294,-0.0,63.06,IS,0.58,0.0,Phase3-EA-SA2v2-USDCHF-M15-107,USDCHFMT4,2198,14m 59s,Buy
130190.13,1.06137,04.02.2015 00:54:59,sl 1.06137,-2.22,-219.77999999999884,0.0,0.0,1.05647,03.02.2015 20:00:00,11295,-0.09971420976488647,-219.78,IS,0.41,0.0,Phase3-EA-SA2v2-EURCHF-M5-43,EURCHFMT4,5700,4h 54m,Sell
130238.95,1.06012,04.02.2015 01:14:57,tp 1.06012,0.0,-170.95999999999185,0.0,0.0,1.06122,04.02.2015 01:00:00,11296,-0.07756457048595991,48.82,IS,0.41,0.0,Phase3-EA-SA2v2-EURCHF-M5-43,EURCHFMT4,5702,14m 57s,Sell
130178.32,1.06202,04.02.2015 10:00:00,,0.0,-231.5899999999965,0.0,0.0,1.06037,04.02.2015 01:15:00,11297,-0.10507240804190478,-60.63,IS,0.34,0.0,Phase3-EA-S4v1-EURCHF-M15-221,EURCHFMT4,2992,8h 45m,Sell
130122.79,134.01,04.02.2015 18:59:58,sl 134.010,-0.38,-287.11999999999534,0.0,0.0,134.73,03.02.2015 21:30:00,11298,-0.13026637504638225,-55.53,IS,0.09,0.0,Phase3-EA-TR1v1-EURJPY-M30-91,EURJPYMT4,1990,21h 29m,Buy
130123.94,117403,04.02.2015 22:15:00,,0.0,-285.97000000000116,0.0,0.0,117408,04.02.2015 17:00:00,11299,-0.129744619922035,1.15,IS,0.27,0.0,Phase3-EA-S1v2-USDJPY-M15-0,USDJPYMT4,3224,5h 15m,Sell
130172.82,1.05412,04.02.2015 22:59:57,tp 1.05412,0.0,-237.0899999999965,0.0,0.0,1.05302,04.02.2015 21:35:00,11300,-0.10756775863662167,48.88,IS,0.41,0.0,Phase3-EA-SA2v2-EURCHF-M5-43,EURCHFMT4,5704,1h 24m,Buy
130235.64,0.92324,04.02.2015 22:59:58,tp 0.92324,0.0,-174.26999999998952,0.0,0.0,0.92224,04.02.2015 22:45:00,11301,-0.07906631784387029,62.82,IS,0.58,0.0,Phase3-EA-SA2v2-USDCHF-M15-107,USDCHFMT4,2200,14m 58s,Buy
129991.54,0.92666,05.02.2015 01:44:58,sl 0.92666,0.0,-418.36999999999534,0.0,0.0,0.92276,05.02.2015 01:00:00,11302,-0.1898145142384899,-244.1,IS,0.58,0.0,Phase3-EA-SA2v2-USDCHF-M15-107,USDCHFMT4,2202,44m 58s,Sell
130067.99,178163,05.02.2015 04:09:58,tp 178.163,0.0,-341.9199999999837,0.0,0.0,177773,05.02.2015 01:40:00,11303,-0.15512914097191982,76.45,IS,0.23,0.0,Phase3-EA-S4v1-GBPJPY-M5-194,GBPJPYMT4,2604,2h 29m,Buy
129898.66,1.04693,05.02.2015 09:20:00,,0.0,-511.2499999999709,0.0,0.0,1.05074,05.02.2015 01:00:00,11304,-0.23195418028162515,-169.33,IS,0.41,0.0,Phase3-EA-SA2v2-EURCHF-M5-43,EURCHFMT4,5706,8h 20m,Buy
129787.11,1.04732,05.02.2015 10:45:00,,0.0,-622.7999999999593,0.0,0.0,1.05035,05.02.2015 02:00:00,11305,-0.28256442734355974,-111.55,IS,0.34,0.0,Phase3-EA-S4v1-EURCHF-M15-221,EURCHFMT4,2994,8h 45m,Buy
129753.75,133118,05.02.2015 11:29:58,sl 133.118,0.0,-656.1599999999453,0.0,0.0,132888,05.02.2015 09:45:00,11306,-0.29769986295078166,-33.36,IS,0.17,0.0,Phase3-EA-T1v2-EURJPY-M15-322,EURJPYMT4,2076,1h 44m,Sell
129852.7,134447,05.02.2015 14:59:58,tp 134.447,0.0,-557.2099999999336,0.0,0.0,133157,05.02.2015 07:30:00,11307,-0.2528062372512789,98.95,IS,0.09,0.0,Phase3-EA-TR1v1-EURJPY-M30-91,EURJPYMT4,1992,7h 29m,Buy
129901.47,1.05721,05.02.2015 21:04:57,tp 1.05721,0.0,-508.4399999999441,0.0,0.0,1.05611,05.02.2015 20:50:00,11308,-0.23067928297776674,48.77,IS,0.41,0.0,Phase3-EA-SA2v2-EURCHF-M5-43,EURCHFMT4,5708,14m 57s,Buy
129964.32,0.92277,05.02.2015 23:14:58,tp 0.92277,0.0,-445.5899999999383,0.0,0.0,0.92177,05.02.2015 22:15:00,11309,-0.202164231181772,62.85,IS,0.58,0.0,Phase3-EA-SA2v2-USDCHF-M15-107,USDCHFMT4,2204,59m 58s,Buy
130011.04,1.05739,06.02.2015 00:49:58,tp 1.05739,-2.22,-398.86999999993714,0.0,0.0,1.05849,05.02.2015 23:05:00,11310,-0.1809673621299218,46.72,IS,0.41,0.0,Phase3-EA-SA2v2-EURCHF-M5-43,EURCHFMT4,5710,1h 44m,Sell
130059.94,1.05768,06.02.2015 04:19:57,tp 1.05768,0.0,-349.96999999994296,0.0,0.0,1.05658,06.02.2015 01:50:00,11311,-0.1587814268423506,48.9,IS,0.41,0.0,Phase3-EA-SA2v2-EURCHF-M5-43,EURCHFMT4,5712,2h 29m,Buy
129916.3,1.05228,06.02.2015 12:14:57,sl 1.05228,0.0,-493.6099999999569,0.0,0.0,1.05618,06.02.2015 03:30:00,11312,-0.22395091037419956,-143.64,IS,0.34,0.0,Phase3-EA-S4v1-EURCHF-M15-221,EURCHFMT4,2996,8h 44m,Buy
129965.0,1.05046,06.02.2015 20:09:57,tp 1.05046,0.0,-444.9099999999453,0.0,0.0,1.04936,06.02.2015 20:05:00,11313,-0.20185571510824651,48.7,IS,0.41,0.0,Phase3-EA-SA2v2-EURCHF-M5-43,EURCHFMT4,5714,4m 57s,Buy
130027.66,0.92564,06.02.2015 23:14:57,tp 0.92564,0.0,-382.2499999999418,0.0,0.0,0.92664,06.02.2015 22:45:00,11314,-0.17342686633279758,62.66,IS,0.58,0.0,Phase3-EA-SA2v2-USDCHF-M15-107,USDCHFMT4,2206,29m 57s,Sell
129949.93,1.04716,09.02.2015 04:35:00,,-1.06,-459.97999999995227,0.0,0.0,1.04889,06.02.2015 20:15:00,11315,-0.20869297573777396,-77.73,IS,0.41,0.0,Phase3-EA-SA2v2-EURCHF-M5-43,EURCHFMT4,5716,2d 8h 20m,Buy
129998.76,1.04671,09.02.2015 20:14:58,tp 1.04671,0.0,-411.1499999999651,0.0,0.0,1.04781,09.02.2015 20:05:00,11316,-0.18653879945777507,48.83,IS,0.41,0.0,Phase3-EA-SA2v2-EURCHF-M5-43,EURCHFMT4,5718,9m 58s,Sell
130006.96,118571,09.02.2015 22:45:00,,0.0,-402.94999999995343,0.0,0.0,118607,09.02.2015 18:00:00,11317,-0.182818458571101,8.2,IS,0.27,0.0,Phase3-EA-S1v2-USDJPY-M15-0,USDJPYMT4,3226,4h 45m,Sell
130055.89,1.04581,09.02.2015 23:49:57,tp 1.04581,0.0,-354.0199999999604,0.0,0.0,1.04471,09.02.2015 22:05:00,11318,-0.1606189122802864,48.93,IS,0.41,0.0,Phase3-EA-SA2v2-EURCHF-M5-43,EURCHFMT4,5720,1h 44m,Buy
130063.46,180542,10.02.2015 09:00:00,,0.0,-346.44999999995343,0.0,0.0,180581,10.02.2015 03:35:00,11319,-0.15718440246173654,7.57,IS,0.23,0.0,Phase3-EA-S4v1-GBPJPY-M5-194,GBPJPYMT4,2606,5h 25m,Sell
130095.47,1.04579,10.02.2015 12:30:00,,0.0,-314.4399999999441,0.0,0.0,1.04666,10.02.2015 03:45:00,11320,-0.14266146200048002,32.01,IS,0.34,0.0,Phase3-EA-S4v1-EURCHF-M15-221,EURCHFMT4,2998,8h 45m,Sell
130053.47,1.52116,10.02.2015 13:59:58,sl 1.52116,0.0,-356.4399999999441,0.0,0.0,1.52416,10.02.2015 12:00:00,11321,-0.16171686654195447,-42.0,IS,0.14,0.0,Phase3-EA-B1v1-GBPUSD-M30-14,GBPUSDMT4,752,1h 59m,Buy
130116.12,0.92581,10.02.2015 22:29:58,tp 0.92581,0.0,-293.78999999994994,0.0,0.0,0.92681,10.02.2015 22:15:00,11322,-0.13329255476759105,62.65,IS,0.58,0.0,Phase3-EA-SA2v2-USDCHF-M15-107,USDCHFMT4,2208,14m 58s,Sell
130136.72,119392,11.02.2015 01:00:00,,-0.66,-273.1899999999441,0.0,0.0,119298,10.02.2015 21:15:00,11323,-0.12394633254010332,20.6,IS,0.27,0.0,Phase3-EA-S1v2-USDJPY-M15-0,USDJPYMT4,3228,3h 45m,Buy
130089.81,1.04819,11.02.2015 04:25:00,,-2.21,-320.0999999999476,0.0,0.0,1.04718,10.02.2015 20:05:00,11324,-0.14522940461249934,-46.91,IS,0.41,0.0,Phase3-EA-SA2v2-EURCHF-M5-43,EURCHFMT4,5722,8h 20m,Sell
130030.34,135.53,11.02.2015 12:29:58,sl 135.530,-0.79,-379.5699999999488,0.0,0.0,134.75,06.02.2015 05:00:00,11325,-0.17221095004301143,-59.47,IS,0.09,0.0,Phase3-EA-TR1v1-EURJPY-M30-91,EURJPYMT4,1994,5d 7h 29m,Sell
130109.24,120.11,11.02.2015 18:45:00,,0.0,-300.6699999999546,0.0,0.0,119759,11.02.2015 17:00:00,11326,-0.13641401151152993,78.9,IS,0.27,0.0,Phase3-EA-S1v2-USDJPY-M15-0,USDJPYMT4,3230,1h 45m,Buy
130067.24,1.52279,11.02.2015 20:59:58,sl 1.52279,0.0,-342.6699999999546,0.0,0.0,1.52579,11.02.2015 04:00:00,11327,-0.15546941605300438,-42.0,IS,0.14,0.0,Phase3-EA-B1v1-GBPUSD-M30-14,GBPUSDMT4,754,16h 59m,Buy
130115.83,1.04759,11.02.2015 22:39:58,tp 1.04759,0.0,-294.0799999999581,0.0,0.0,1.04869,11.02.2015 22:25:00,11328,-0.13342412779895255,48.59,IS,0.41,0.0,Phase3-EA-SA2v2-EURCHF-M5-43,EURCHFMT4,5724,14m 58s,Sell
130164.42,1.04846,11.02.2015 23:39:59,tp 1.04846,0.0,-245.48999999996158,0.0,0.0,1.04956,11.02.2015 23:05:00,11329,-0.11137883954490072,48.59,IS,0.41,0.0,Phase3-EA-SA2v2-EURCHF-M5-43,EURCHFMT4,5726,34m 59s,Sell
130209.54,120449,12.02.2015 01:45:00,,-1.95,-200.36999999996624,0.0,0.0,120239,11.02.2015 23:00:00,11330,-0.09090789066606171,45.12,IS,0.27,0.0,Phase3-EA-S1v2-USDJPY-M15-0,USDJPYMT4,3232,2h 45m,Buy
130150.37,136232,12.02.2015 01:59:58,sl 136.232,-0.79,-259.53999999997905,0.0,0.0,135452,11.02.2015 14:30:00,11331,-0.11775332606413998,-59.17,IS,0.09,0.0,Phase3-EA-TR1v1-EURJPY-M30-91,EURJPYMT4,1996,11h 29m,Sell
130131.63,183075,12.02.2015 08:50:00,,0.0,-278.27999999996973,0.0,0.0,183173,12.02.2015 03:25:00,11332,-0.1262556660904984,-18.74,IS,0.23,0.0,Phase3-EA-S4v1-GBPJPY-M5-194,GBPJPYMT4,2608,5h 25m,Buy
130164.98,1.05,12.02.2015 11:30:00,,0.0,-244.9299999999639,0.0,0.0,1.05091,12.02.2015 02:45:00,11333,-0.11112476748434878,33.35,IS,0.34,0.0,Phase3-EA-S4v1-EURCHF-M15-221,EURCHFMT4,3000,8h 45m,Sell
130132.49,135822,12.02.2015 12:29:58,sl 135.822,0.0,-277.4199999999546,0.0,0.0,136052,12.02.2015 08:00:00,11334,-0.12586548399749942,-32.49,IS,0.17,0.0,Phase3-EA-T1v2-EURJPY-M15-322,EURJPYMT4,2078,4h 29m,Buy
130081.12,181737,12.02.2015 12:59:57,sl 181.737,-0.81,-328.78999999994994,0.0,0.0,182407,11.02.2015 05:30:00,11335,-0.1491720585521531,-51.37,IS,0.09,0.0,Phase3-EA-B1v1-GBPJPY-M30-1,GBPJPYMT4,1068,1d 7h 29m,Buy
130048.38,135451,12.02.2015 12:59:57,sl 135.451,0.0,-361.5299999999406,0.0,0.0,135221,12.02.2015 12:30:00,11336,-0.16402620009233632,-32.74,IS,0.17,0.0,Phase3-EA-T1v2-EURJPY-M15-322,EURJPYMT4,2080,29m 57s,Sell
130138.83,119407,12.02.2015 17:44:57,tp 119.407,0.0,-271.079999999929,0.0,0.0,119807,12.02.2015 17:00:00,11337,-0.12298902531194143,90.45,IS,0.27,0.0,Phase3-EA-S1v2-USDJPY-M15-0,USDJPYMT4,3234,44m 57s,Sell
130185.3,119101,13.02.2015 02:00:00,,0.0,-224.60999999992782,0.0,0.0,118896,13.02.2015 00:30:00,11338,-0.10190558128712382,46.47,IS,0.27,0.0,Phase3-EA-S1v2-USDJPY-M15-0,USDJPYMT4,3236,1h 30m,Buy
130231.66,1.05799,13.02.2015 05:54:58,tp 1.05799,-2.2,-178.2499999999418,0.0,0.0,1.05909,12.02.2015 22:05:00,11339,-0.08087204427420741,46.36,IS,0.41,0.0,Phase3-EA-SA2v2-EURCHF-M5-43,EURCHFMT4,5728,7h 49m,Sell
130309.55,118552,13.02.2015 08:00:00,,0.0,-100.35999999992782,0.0,0.0,118894,13.02.2015 00:30:00,11340,-0.045533342851928574,77.89,IS,0.27,0.0,Phase3-EA-S1v2-USDJPY-M15-0,USDJPYMT4,3237,7h 30m,Sell
130355.71,1.0592,13.02.2015 15:30:00,,0.0,-54.19999999992433,0.0,0.0,1.05794,13.02.2015 06:45:00,11341,-0.024590545860630312,46.16,IS,0.34,0.0,Phase3-EA-S4v1-EURCHF-M15-221,EURCHFMT4,3002,8h 45m,Buy
130322.84,135688,13.02.2015 18:59:58,sl 135.688,0.0,-87.06999999991967,0.0,0.0,135458,13.02.2015 17:15:00,11342,-0.03950366841487261,-32.87,IS,0.17,0.0,Phase3-EA-T1v2-EURJPY-M15-322,EURJPYMT4,2082,1h 44m,Sell
130371.23,1.06153,13.02.2015 20:49:59,tp 1.06153,0.0,-38.679999999905704,0.0,0.0,1.06263,13.02.2015 20:45:00,11343,-0.017549120182438923,48.39,IS,0.41,0.0,Phase3-EA-SA2v2-EURCHF-M5-43,EURCHFMT4,5730,4m 59s,Sell
130353.62,0.93191,16.02.2015 03:15:00,,-3.3,-56.289999999891734,0.0,0.0,0.93168,13.02.2015 23:00:00,11344,-0.02553877908660794,-17.61,IS,0.58,0.0,Phase3-EA-SA2v2-USDCHF-M15-107,USDCHFMT4,2210,2d 4h 15m,Sell
130320.66,135476,16.02.2015 11:59:58,sl 135.476,0.0,-89.24999999988358,0.0,0.0,135246,16.02.2015 06:15:00,11345,-0.040492734650580384,-32.96,IS,0.17,0.0,Phase3-EA-T1v2-EURJPY-M15-322,EURJPYMT4,2084,5h 44m,Sell
130433.8,1.06319,16.02.2015 15:30:00,,0.0,-0.0,0.0,0.0,1.06009,16.02.2015 06:45:00,11346,-0.0,113.14,IS,0.34,0.0,Phase3-EA-S4v1-EURCHF-M15-221,EURCHFMT4,3004,8h 45m,Buy
130531.26,134587,16.02.2015 20:59:58,tp 134.587,-0.53,-0.0,0.0,0.0,135877,12.02.2015 03:30:00,11347,-0.0,97.46,IS,0.09,0.0,Phase3-EA-TR1v1-EURJPY-M30-91,EURJPYMT4,1998,4d 17h 29m,Sell
130579.71,1.05948,16.02.2015 21:19:58,tp 1.05948,0.0,-0.0,0.0,0.0,1.05838,16.02.2015 21:15:00,11348,-0.0,48.45,IS,0.41,0.0,Phase3-EA-SA2v2-EURCHF-M5-43,EURCHFMT4,5732,4m 58s,Buy
130628.19,1.05758,16.02.2015 21:44:58,tp 1.05758,0.0,-0.0,0.0,0.0,1.05648,16.02.2015 21:40:00,11349,-0.0,48.48,IS,0.41,0.0,Phase3-EA-SA2v2-EURCHF-M5-43,EURCHFMT4,5734,4m 58s,Buy
130676.6,1.05744,16.02.2015 23:59:58,tp 1.05744,0.0,-0.0,0.0,0.0,1.05634,16.02.2015 22:15:00,11350,-0.0,48.41,IS,0.41,0.0,Phase3-EA-SA2v2-EURCHF-M5-43,EURCHFMT4,5736,1h 44m,Buy
130621.79,135151,17.02.2015 13:29:58,sl 135.151,-0.27,-54.80999999999767,0.0,0.0,134431,16.02.2015 22:00:00,11351,-0.024837250528600356,-54.81,IS,0.09,0.0,Phase3-EA-TR1v1-EURJPY-M30-91,EURJPYMT4,2000,15h 29m,Sell
130588.37,135494,17.02.2015 14:59:58,sl 135.494,-0.5,-88.23000000001048,0.0,0.0,135264,16.02.2015 14:30:00,11352,-0.039981583910577684,-33.42,IS,0.17,0.0,Phase3-EA-T1v2-EURJPY-M15-322,EURJPYMT4,2086,1d 0h 29m,Sell
130624.94,118858,17.02.2015 18:30:00,,0.0,-51.66000000000349,0.0,0.0,118697,17.02.2015 17:45:00,11353,-0.023409822337304063,36.57,IS,0.27,0.0,Phase3-EA-S1v2-USDJPY-M15-0,USDJPYMT4,3240,45m 0s,Buy
130605.65,1.0666,18.02.2015 06:20:00,,-2.19,-70.95000000001164,0.0,0.0,1.06621,17.02.2015 22:00:00,11354,-0.032151120689738355,-19.29,IS,0.41,0.0,Phase3-EA-SA2v2-EURCHF-M5-43,EURCHFMT4,5738,8h 20m,Sell
130463.49,1.06324,18.02.2015 06:44:57,sl 1.06324,0.0,-213.11000000001513,0.0,0.0,1.06714,18.02.2015 05:15:00,11355,-0.09657118153896412,-142.16,IS,0.34,0.0,Phase3-EA-S4v1-EURCHF-M15-221,EURCHFMT4,3006,1h 29m,Buy
130511.24,1.07106,18.02.2015 20:54:58,tp 1.07106,0.0,-165.36000000001513,0.0,0.0,1.07216,18.02.2015 20:35:00,11356,-0.07493318276609935,47.75,IS,0.41,0.0,Phase3-EA-SA2v2-EURCHF-M5-43,EURCHFMT4,5740,19m 58s,Sell
130476.79,183222,19.02.2015 05:10:00,,-2.09,-199.81000000002678,0.0,0.0,183389,18.02.2015 23:45:00,11357,-0.09054426250904056,-34.45,IS,0.23,0.0,Phase3-EA-S4v1-GBPJPY-M5-194,GBPJPYMT4,2610,5h 25m,Buy
130429.74,1.07444,19.02.2015 08:50:00,,0.0,-246.86000000001513,0.0,0.0,1.07336,19.02.2015 00:30:00,11358,-0.11186505501716695,-47.05,IS,0.41,0.0,Phase3-EA-SA2v2-EURCHF-M5-43,EURCHFMT4,5742,8h 20m,Sell
130389.3,1.07457,19.02.2015 11:00:00,,0.0,-287.30000000001746,0.0,0.0,1.07345,19.02.2015 02:15:00,11359,-0.13019051408260573,-40.44,IS,0.34,0.0,Phase3-EA-S4v1-EURCHF-M15-221,EURCHFMT4,3008,8h 45m,Sell
130356.47,135346,19.02.2015 16:14:58,sl 135.346,0.0,-320.13000000000466,0.0,0.0,135576,19.02.2015 16:00:00,11360,-0.14506748789858212,-32.83,IS,0.17,0.0,Phase3-EA-T1v2-EURJPY-M15-322,EURJPYMT4,2088,14m 58s,Buy
130373.28,119032,20.02.2015 03:00:00,,-0.66,-303.320000000007,0.0,0.0,118955,19.02.2015 19:15:00,11361,-0.13745000602692126,16.81,IS,0.27,0.0,Phase3-EA-S1v2-USDJPY-M15-0,USDJPYMT4,3242,7h 45m,Buy
130363.32,0.94922,20.02.2015 03:15:00,,-3.24,-313.27999999999884,0.0,0.0,0.94911,19.02.2015 23:00:00,11362,-0.14196339802226277,-9.96,IS,0.58,0.0,Phase3-EA-SA2v2-USDCHF-M15-107,USDCHFMT4,2212,4h 15m,Sell
130459.95,134732,20.02.2015 12:29:58,tp 134.732,-1.06,-216.64999999999418,0.0,0.0,136022,18.02.2015 05:30:00,11363,-0.09817533893489055,96.63,IS,0.09,0.0,Phase3-EA-TR1v1-EURJPY-M30-91,EURJPYMT4,2002,2d 6h 59m,Sell
130444.58,1.07736,20.02.2015 14:00:00,,0.0,-232.01999999998952,0.0,0.0,1.07779,20.02.2015 05:15:00,11364,-0.10514028220481371,-15.37,IS,0.34,0.0,Phase3-EA-S4v1-EURCHF-M15-221,EURCHFMT4,3010,8h 45m,Buy
130540.28,133603,20.02.2015 18:59:58,tp 133.603,0.0,-136.31999999997788,0.0,0.0,134863,20.02.2015 11:30:00,11365,-0.061773654297726605,95.7,IS,0.09,0.0,Phase3-EA-TR1v1-EURJPY-M30-91,EURJPYMT4,2003,7h 29m,Sell
130485.51,134354,20.02.2015 19:29:58,sl 134.354,0.0,-191.0899999999674,0.0,0.0,133634,20.02.2015 19:00:00,11366,-0.0865927787540528,-54.77,IS,0.09,0.0,Phase3-EA-TR1v1-EURJPY-M30-91,EURJPYMT4,2006,29m 58s,Sell
130434.61,182676,20.02.2015 19:59:58,sl 182.676,0.0,-241.98999999996158,0.0,0.0,182006,20.02.2015 18:30:00,11367,-0.10965820571821386,-50.9,IS,0.09,0.0,Phase3-EA-B1v1-GBPJPY-M30-1,GBPJPYMT4,1070,1h 29m,Sell
130462.35,0.94101,23.02.2015 06:15:00,,0.0,-214.2499999999709,0.0,0.0,0.94056,23.02.2015 02:00:00,11368,-0.09708777459865225,27.74,IS,0.58,0.0,Phase3-EA-SA2v2-USDCHF-M15-107,USDCHFMT4,2214,4h 15m,Buy
130510.25,1.07265,23.02.2015 06:34:58,tp 1.07265,0.0,-166.34999999997672,0.0,0.0,1.07155,23.02.2015 02:00:00,11369,-0.07538180305477589,47.9,IS,0.41,0.0,Phase3-EA-SA2v2-EURCHF-M5-43,EURCHFMT4,5744,4h 34m,Buy
130524.22,118885,24.02.2015 00:15:00,,-1.02,-152.37999999997555,0.0,0.0,118951,23.02.2015 23:30:00,11370,-0.06905127231431629,13.97,IS,0.27,0.0,Phase3-EA-S1v2-USDJPY-M15-0,USDJPYMT4,3244,45m 0s,Sell
130585.25,0.95031,24.02.2015 03:59:58,tp 0.95031,0.0,-91.34999999997672,0.0,0.0,0.94931,24.02.2015 02:00:00,11371,-0.04139541754765847,61.03,IS,0.58,0.0,Phase3-EA-SA2v2-USDCHF-M15-107,USDCHFMT4,2216,1h 59m,Buy
130557.2,1.0771,24.02.2015 04:35:00,,-2.16,-119.39999999996508,0.0,0.0,1.0765,23.02.2015 20:15:00,11372,-0.054106325727315115,-28.05,IS,0.41,0.0,Phase3-EA-SA2v2-EURCHF-M5-43,EURCHFMT4,5746,8h 20m,Sell
130524.33,134.89,24.02.2015 05:59:59,sl 134.890,0.0,-152.26999999996042,0.0,0.0,134.66,24.02.2015 01:00:00,11373,-0.06900142561556566,-32.87,IS,0.17,0.0,Phase3-EA-T1v2-EURJPY-M15-322,EURJPYMT4,2090,4h 59m,Sell
130515.64,183835,24.02.2015 09:10:00,,0.0,-160.95999999996275,0.0,0.0,183.79,24.02.2015 03:45:00,11374,-0.07293931481632472,-8.69,IS,0.23,0.0,Phase3-EA-S4v1-GBPJPY-M5-194,GBPJPYMT4,2612,5h 25m,Sell
130461.15,135356,24.02.2015 15:29:57,sl 135.356,-0.26,-215.44999999995343,0.0,0.0,135.39,23.02.2015 12:00:00,11375,-0.09763155676675822,-54.49,IS,0.09,0.0,Phase3-EA-TR1v1-EURJPY-M30-91,EURJPYMT4,2008,1d 3h 29m,Sell
130271.64,118665,25.02.2015 04:59:58,sl 118.665,-0.66,-404.95999999996275,0.0,0.0,119495,24.02.2015 19:15:00,11376,-0.18350835566614673,-189.51,IS,0.27,0.0,Phase3-EA-S1v2-USDJPY-M15-0,USDJPYMT4,3246,9h 44m,Buy
130219.41,1.07767,25.02.2015 08:25:00,,0.0,-457.1899999999732,0.0,0.0,1.07646,25.02.2015 00:05:00,11377,-0.20717647453330806,-52.23,IS,0.41,0.0,Phase3-EA-SA2v2-EURCHF-M5-43,EURCHFMT4,5748,8h 20m,Sell
130210.46,1.07775,25.02.2015 10:15:00,,0.0,-466.13999999998487,0.0,0.0,1.0775,25.02.2015 01:30:00,11378,-0.21123218320382936,-8.95,IS,0.34,0.0,Phase3-EA-S4v1-EURCHF-M15-221,EURCHFMT4,3012,8h 45m,Sell
130469.22,1.55105,25.02.2015 11:29:58,tp 1.55105,-5.84,-207.37999999997555,0.0,0.0,1.53215,12.02.2015 15:00:00,11379,-0.09397462168620241,258.76,IS,0.14,0.0,Phase3-EA-B1v1-GBPUSD-M30-14,GBPUSDMT4,756,12d 20h 29m,Buy
130474.93,135034,25.02.2015 18:30:00,,0.0,-201.6699999999837,0.0,0.0,134994,25.02.2015 17:30:00,11380,-0.09138712486959756,5.71,IS,0.17,0.0,Phase3-EA-T1v2-EURJPY-M15-322,EURJPYMT4,2092,1h 0m,Buy
130522.47,1.07657,25.02.2015 21:44:58,tp 1.07657,0.0,-154.12999999997555,0.0,0.0,1.07767,25.02.2015 20:10:00,11381,-0.06984428797614903,47.54,IS,0.41,0.0,Phase3-EA-SA2v2-EURCHF-M5-43,EURCHFMT4,5750,1h 34m,Sell
130566.91,1.07789,26.02.2015 03:34:58,tp 1.07789,-3.12,-109.68999999997322,0.0,0.0,1.07679,25.02.2015 22:50:00,11382,-0.049706221683664,44.44,IS,0.41,0.0,Phase3-EA-SA2v2-EURCHF-M5-43,EURCHFMT4,5752,4h 44m,Buy
130516.19,0.94918,26.02.2015 06:00:00,,0.0,-160.4099999999744,0.0,0.0,0.94835,26.02.2015 01:45:00,11383,-0.07269008132261114,-50.72,IS,0.58,0.0,Phase3-EA-SA2v2-USDCHF-M15-107,USDCHFMT4,2218,4h 15m,Sell
130556.7,1.07673,26.02.2015 12:45:00,,0.0,-119.89999999996508,0.0,0.0,1.07786,26.02.2015 04:00:00,11384,-0.054332901630695894,40.51,IS,0.34,0.0,Phase3-EA-S4v1-EURCHF-M15-221,EURCHFMT4,3014,8h 45m,Sell
130653.16,134.1,26.02.2015 17:59:58,tp 134.100,-1.32,-23.439999999973224,0.0,0.0,134636,23.02.2015 15:30:00,11385,-0.010621878350478965,96.46,IS,0.09,0.0,Phase3-EA-TR1v1-EURJPY-M30-91,EURJPYMT4,2009,3d 2h 29m,Sell
130699.45,1.06876,27.02.2015 04:49:58,tp 1.06876,-1.03,-0.0,0.0,0.0,1.06766,26.02.2015 21:45:00,11386,-0.0,46.29,IS,0.41,0.0,Phase3-EA-SA2v2-EURCHF-M5-43,EURCHFMT4,5754,7h 4m,Buy
130630.34,1.0645,27.02.2015 10:45:00,,0.0,-69.10999999998603,0.0,0.0,1.06643,27.02.2015 02:00:00,11387,-0.031314078943099115,-69.11,IS,0.34,0.0,Phase3-EA-S4v1-EURCHF-M15-221,EURCHFMT4,3016,8h 45m,Buy
130605.67,119306,27.02.2015 11:30:00,,0.0,-93.77999999999884,0.0,0.0,119415,27.02.2015 01:45:00,11388,-0.042492176577693413,-24.67,IS,0.27,0.0,Phase3-EA-S1v2-USDJPY-M15-0,USDJPYMT4,3248,9h 45m,Buy
130563.67,1.54185,27.02.2015 15:59:58,sl 1.54185,0.0,-135.77999999999884,0.0,0.0,1.53885,27.02.2015 13:00:00,11389,-0.06152258195477963,-42.0,IS,0.14,0.0,Phase3-EA-B1v1-GBPUSD-M30-14,GBPUSDMT4,758,2h 59m,Sell
130521.67,1.54089,27.02.2015 18:29:58,sl 1.54089,0.0,-177.77999999999884,0.0,0.0,1.54389,27.02.2015 16:30:00,11390,-0.08055298733186585,-42.0,IS,0.14,0.0,Phase3-EA-B1v1-GBPUSD-M30-14,GBPUSDMT4,760,1h 59m,Buy
130488.91,133757,27.02.2015 19:14:58,sl 133.757,0.0,-210.54000000000815,0.0,0.0,133527,27.02.2015 19:00:00,11391,-0.09539670352599731,-32.76,IS,0.17,0.0,Phase3-EA-T1v2-EURJPY-M15-322,EURJPYMT4,2094,14m 58s,Sell
130536.34,1.0645,27.02.2015 20:54:58,tp 1.06450,0.0,-163.11000000001513,0.0,0.0,1.0656,27.02.2015 20:25:00,11392,-0.07390593859659098,47.43,IS,0.41,0.0,Phase3-EA-SA2v2-EURCHF-M5-43,EURCHFMT4,5756,29m 58s,Sell
130517.03,134.04,27.02.2015 21:30:00,,0.0,-182.4200000000128,0.0,0.0,134176,27.02.2015 20:30:00,11393,-0.08265539402115028,-19.31,IS,0.17,0.0,Phase3-EA-T1v2-EURJPY-M15-322,EURJPYMT4,2096,1h 0m,Buy
130564.48,1.06466,27.02.2015 22:34:58,tp 1.06466,0.0,-134.97000000000116,0.0,0.0,1.06576,27.02.2015 22:05:00,11394,-0.06115556699393688,47.45,IS,0.41,0.0,Phase3-EA-SA2v2-EURCHF-M5-43,EURCHFMT4,5758,29m 58s,Sell
130609.64,1.06599,02.03.2015 02:04:58,tp 1.06599,-2.15,-89.80999999999767,0.0,0.0,1.06709,27.02.2015 23:40:00,11395,-0.04069335016466831,45.16,IS,0.41,0.0,Phase3-EA-SA2v2-EURCHF-M5-43,EURCHFMT4,5760,2d 2h 24m,Sell
130555.03,134563,02.03.2015 16:29:58,sl 134.563,-0.52,-144.4199999999837,0.0,0.0,133843,26.02.2015 20:00:00,11396,-0.06543740820377336,-54.61,IS,0.09,0.0,Phase3-EA-TR1v1-EURJPY-M30-91,EURJPYMT4,2012,3d 20h 29m,Sell
130602.08,1.07197,02.03.2015 22:04:58,tp 1.07197,0.0,-97.36999999999534,0.0,0.0,1.07087,02.03.2015 20:05:00,11397,-0.04411882313254277,47.05,IS,0.41,0.0,Phase3-EA-SA2v2-EURCHF-M5-43,EURCHFMT4,5762,1h 59m,Buy
130646.96,1.07161,03.03.2015 00:59:58,tp 1.07161,-2.14,-52.48999999999069,0.0,0.0,1.07271,02.03.2015 22:35:00,11398,-0.023783475672454247,44.88,IS,0.41,0.0,Phase3-EA-SA2v2-EURCHF-M5-43,EURCHFMT4,5764,2h 24m,Sell
130788.9,1.07398,03.03.2015 12:14:58,tp 1.07398,0.0,-0.0,0.0,0.0,1.06998,03.03.2015 05:15:00,11399,-0.0,141.94,IS,0.34,0.0,Phase3-EA-S4v1-EURCHF-M15-221,EURCHFMT4,3018,6h 59m,Buy
130833.69,1.07357,04.03.2015 00:09:58,tp 1.07357,-2.13,-0.0,0.0,0.0,1.07467,03.03.2015 21:00:00,11400,-0.0,44.79,IS,0.41,0.0,Phase3-EA-SA2v2-EURCHF-M5-43,EURCHFMT4,5766,3h 9m,Sell
130831.09,0.96063,04.03.2015 04:00:00,,-3.2,-2.6000000000058208,0.0,0.0,0.96064,03.03.2015 23:45:00,11401,-0.0011773565890267027,-2.6,IS,0.58,0.0,Phase3-EA-SA2v2-USDCHF-M15-107,USDCHFMT4,2220,4h 15m,Sell
130849.05,119523,04.03.2015 05:00:00,,-1.02,-0.0,0.0,0.0,119607,03.03.2015 23:15:00,11402,-0.0,17.96,IS,0.27,0.0,Phase3-EA-S1v2-USDJPY-M15-0,USDJPYMT4,3250,5h 45m,Sell
130860.98,1.07403,04.03.2015 09:15:00,,0.0,-0.0,0.0,0.0,1.07375,04.03.2015 00:55:00,11403,-0.0,11.93,IS,0.41,0.0,Phase3-EA-SA2v2-EURCHF-M5-43,EURCHFMT4,5768,8h 20m,Buy
130723.11,1.0697,04.03.2015 13:14:58,sl 1.06970,0.0,-137.86999999999534,0.0,0.0,1.0736,04.03.2015 04:30:00,11404,-0.06242388311416276,-137.87,IS,0.34,0.0,Phase3-EA-S4v1-EURCHF-M15-221,EURCHFMT4,3020,8h 44m,Buy
130819.63,132995,04.03.2015 13:29:57,tp 132.995,-0.52,-41.35000000000582,0.0,0.0,134285,02.03.2015 21:30:00,11405,-0.01872218442569871,96.52,IS,0.09,0.0,Phase3-EA-TR1v1-EURJPY-M30-91,EURJPYMT4,2014,1d 15h 59m,Sell
130914.27,132763,04.03.2015 18:59:58,tp 132.763,-0.26,-0.0,0.0,0.0,134023,03.03.2015 09:00:00,11406,-0.0,94.64,IS,0.09,0.0,Phase3-EA-TR1v1-EURJPY-M30-91,EURJPYMT4,2015,1d 9h 59m,Sell
130917.43,119725,05.03.2015 04:30:00,,0.0,-0.0,0.0,0.0,119711,05.03.2015 01:00:00,11407,-0.0,3.16,IS,0.27,0.0,Phase3-EA-S1v2-USDJPY-M15-0,USDJPYMT4,3252,3h 30m,Buy
130938.68,1.06649,05.03.2015 10:00:00,,0.0,-0.0,0.0,0.0,1.06699,05.03.2015 01:40:00,11408,-0.0,21.25,IS,0.41,0.0,Phase3-EA-SA2v2-EURCHF-M5-43,EURCHFMT4,5770,8h 20m,Sell
130887.17,183239,05.03.2015 14:59:58,sl 183.239,-1.31,-51.51000000000931,0.0,0.0,182569,04.03.2015 23:00:00,11409,-0.02331416119622375,-51.51,IS,0.09,0.0,Phase3-EA-B1v1-GBPJPY-M30-1,GBPJPYMT4,1072,15h 59m,Sell
130833.25,132946,05.03.2015 17:29:58,sl 132.946,0.0,-105.43000000002212,0.0,0.0,132557,04.03.2015 23:30:00,11410,-0.047719122790097865,-53.92,IS,0.09,0.0,Phase3-EA-TR1v1-EURJPY-M30-91,EURJPYMT4,2018,17h 59m,Buy
130879.61,1.07084,05.03.2015 20:44:57,tp 1.07084,0.0,-59.07000000003609,0.0,0.0,1.07194,05.03.2015 20:10:00,11411,-0.026735925099233726,46.36,IS,0.41,0.0,Phase3-EA-SA2v2-EURCHF-M5-43,EURCHFMT4,5772,34m 57s,Sell
131118.51,132118,05.03.2015 21:14:57,tp 132.118,-1.49,-0.0,0.0,0.0,133818,04.03.2015 00:15:00,11412,-0.0,238.9,IS,0.17,0.0,Phase3-EA-T1v2-EURJPY-M15-322,EURJPYMT4,2098,1d 20h 59m,Sell
131142.57,120183,06.03.2015 04:45:00,,-0.65,-0.0,0.0,0.0,120073,05.03.2015 18:15:00,11413,-0.0,24.06,IS,0.27,0.0,Phase3-EA-S1v2-USDJPY-M15-0,USDJPYMT4,3254,10h 30m,Buy
131186.77,1.07272,06.03.2015 04:54:58,tp 1.07272,-2.1,-0.0,0.0,0.0,1.07382,05.03.2015 23:15:00,11414,-0.0,44.2,IS,0.41,0.0,Phase3-EA-SA2v2-EURCHF-M5-43,EURCHFMT4,5774,5h 39m,Sell
131127.12,0.97235,06.03.2015 06:30:00,,0.0,-59.64999999999418,0.0,0.0,0.97335,06.03.2015 02:15:00,11415,-0.026968159081121247,-59.65,IS,0.58,0.0,Phase3-EA-SA2v2-USDCHF-M15-107,USDCHFMT4,2222,4h 15m,Buy
131067.17,131777,06.03.2015 13:29:58,sl 131.777,-1.48,-119.60000000000582,0.0,0.0,132226,05.03.2015 11:00:00,11416,-0.054071950144217486,-59.95,IS,0.09,0.0,Phase3-EA-TR1v1-EURJPY-M30-91,EURJPYMT4,2019,1d 2h 29m,Sell
131006.24,1.0705,06.03.2015 14:00:00,,0.0,-180.52999999999884,0.0,0.0,1.07225,06.03.2015 05:15:00,11417,-0.08161880568173115,-60.93,IS,0.34,0.0,Phase3-EA-S4v1-EURCHF-M15-221,EURCHFMT4,3022,8h 45m,Buy
131052.08,1.06747,06.03.2015 22:24:58,tp 1.06747,0.0,-134.69000000000233,0.0,0.0,1.06637,06.03.2015 22:00:00,11418,-0.06089423883716074,45.84,IS,0.41,0.0,Phase3-EA-SA2v2-EURCHF-M5-43,EURCHFMT4,5776,24m 58s,Buy
131042.05,181725,09.03.2015 04:25:00,,-0.69,-144.72000000000116,0.0,0.0,181774,06.03.2015 23:00:00,11419,-0.06542886810092673,-10.03,IS,0.23,0.0,Phase3-EA-S4v1-GBPJPY-M5-194,GBPJPYMT4,2614,2d 5h 25m,Buy
131087.82,1.06893,09.03.2015 04:49:58,tp 1.06893,0.0,-98.95000000001164,0.0,0.0,1.06783,09.03.2015 02:55:00,11420,-0.044735948718818475,45.77,IS,0.41,0.0,Phase3-EA-SA2v2-EURCHF-M5-43,EURCHFMT4,5778,1h 54m,Buy
131101.25,120.8,09.03.2015 05:15:00,,-0.65,-85.52000000001863,0.0,0.0,120737,06.03.2015 22:45:00,11421,-0.038664156992761385,13.43,IS,0.27,0.0,Phase3-EA-S1v2-USDJPY-M15-0,USDJPYMT4,3256,2d 6h 30m,Buy
131047.6,131.55,09.03.2015 12:29:58,sl 131.550,0.0,-139.1700000000128,0.0,0.0,131458,06.03.2015 19:00:00,11422,-0.06291967643454074,-53.65,IS,0.09,0.0,Phase3-EA-TR1v1-EURJPY-M30-91,EURJPYMT4,2022,2d 17h 29m,Buy
131093.4,1.06866,09.03.2015 21:59:58,tp 1.06866,0.0,-93.37000000002445,0.0,0.0,1.06976,09.03.2015 20:05:00,11423,-0.04221319385423631,45.8,IS,0.41,0.0,Phase3-EA-SA2v2-EURCHF-M5-43,EURCHFMT4,5780,1h 54m,Sell
131152.25,0.98552,09.03.2015 23:59:58,tp 0.98552,0.0,-34.52000000001863,0.0,0.0,0.98452,09.03.2015 22:00:00,11424,-0.015606720058355384,58.85,IS,0.58,0.0,Phase3-EA-SA2v2-USDCHF-M15-107,USDCHFMT4,2224,1h 59m,Buy
131191.43,121.33,10.03.2015 03:15:00,,-0.65,-0.0,0.0,0.0,121151,09.03.2015 23:45:00,11425,-0.0,39.18,IS,0.27,0.0,Phase3-EA-S1v2-USDJPY-M15-0,USDJPYMT4,3258,3h 30m,Buy
131191.02,131479,10.03.2015 10:15:00,,-0.69,-0.41000000000349246,0.0,0.0,131477,09.03.2015 20:30:00,11426,-1.8535980349848532E-4,-0.41,IS,0.17,0.0,Phase3-EA-T1v2-EURJPY-M15-322,EURJPYMT4,2100,13h 45m,Buy
131148.49,1.50653,10.03.2015 12:29:58,sl 1.50653,-0.53,-42.94000000000233,0.0,0.0,1.50953,09.03.2015 12:30:00,11427,-0.019413048688189247,-42.53,IS,0.14,0.0,Phase3-EA-B1v1-GBPUSD-M30-14,GBPUSDMT4,762,23h 59m,Buy
131170.02,1.06925,10.03.2015 13:45:00,,0.0,-21.410000000003492,0.0,0.0,1.06862,10.03.2015 05:00:00,11428,-0.00967939851919369,21.53,IS,0.34,0.0,Phase3-EA-S4v1-EURCHF-M15-221,EURCHFMT4,3024,8h 45m,Buy
131111.6,130678,10.03.2015 15:29:58,sl 130.678,-0.73,-79.8300000000163,0.0,0.0,130.83,09.03.2015 02:00:00,11429,-0.03609091003210014,-58.42,IS,0.09,0.0,Phase3-EA-TR1v1-EURJPY-M30-91,EURJPYMT4,2023,1d 13h 29m,Sell
131061.96,182869,10.03.2015 15:59:57,sl 182.869,0.0,-129.47000000003027,0.0,0.0,183539,10.03.2015 05:30:00,11430,-0.05853300916768312,-49.64,IS,0.09,0.0,Phase3-EA-B1v1-GBPJPY-M30-1,GBPJPYMT4,1074,10h 29m,Buy
131116.99,0.99805,11.03.2015 03:29:58,tp 0.99805,-3.08,-74.44000000003143,0.0,0.0,0.99905,10.03.2015 23:45:00,11431,-0.03365410676174521,55.03,IS,0.58,0.0,Phase3-EA-SA2v2-USDCHF-M15-107,USDCHFMT4,2226,3h 44m,Sell
131072.88,1.06776,11.03.2015 04:50:00,,-0.99,-118.55000000001746,0.0,0.0,1.06881,10.03.2015 20:30:00,11432,-0.05359610903551582,-44.11,IS,0.41,0.0,Phase3-EA-SA2v2-EURCHF-M5-43,EURCHFMT4,5782,8h 20m,Buy
131071.86,1.06719,11.03.2015 10:30:00,,0.0,-119.57000000000698,0.0,0.0,1.06722,11.03.2015 01:45:00,11433,-0.054057248058844855,-1.02,IS,0.34,0.0,Phase3-EA-S4v1-EURCHF-M15-221,EURCHFMT4,3026,8h 45m,Buy
131014.07,128978,11.03.2015 13:29:58,sl 128.978,0.0,-177.36000000001513,0.0,0.0,129758,11.03.2015 05:00:00,11434,-0.08018393841027835,-57.79,IS,0.09,0.0,Phase3-EA-TR1v1-EURJPY-M30-91,EURJPYMT4,2026,8h 29m,Buy
130960.74,129149,11.03.2015 16:59:57,sl 129.149,0.0,-230.69000000000233,0.0,0.0,128429,11.03.2015 15:30:00,11435,-0.10429427577732138,-53.33,IS,0.09,0.0,Phase3-EA-TR1v1-EURJPY-M30-91,EURJPYMT4,2028,1h 29m,Sell
131198.64,127845,11.03.2015 21:44:58,tp 127.845,0.0,-0.0,0.0,0.0,129545,11.03.2015 11:30:00,11436,-0.0,237.9,IS,0.17,0.0,Phase3-EA-T1v2-EURJPY-M15-322,EURJPYMT4,2102,10h 14m,Sell
131240.42,1.06442,12.03.2015 00:04:58,tp 1.06442,-2.92,-0.0,0.0,0.0,1.06332,11.03.2015 21:35:00,11437,-0.0,41.78,IS,0.41,0.0,Phase3-EA-SA2v2-EURCHF-M5-43,EURCHFMT4,5784,2h 29m,Buy
131285.1,1.06308,12.03.2015 04:34:57,tp 1.06308,0.0,-0.0,0.0,0.0,1.06418,12.03.2015 02:15:00,11438,-0.0,44.68,IS,0.41,0.0,Phase3-EA-SA2v2-EURCHF-M5-43,EURCHFMT4,5786,2h 19m,Sell
131252.87,128103,12.03.2015 10:59:58,sl 128.103,0.0,-32.23000000001048,0.0,0.0,127873,12.03.2015 06:30:00,11439,-0.014564921000108125,-32.23,IS,0.17,0.0,Phase3-EA-T1v2-EURJPY-M15-322,EURJPYMT4,2104,4h 29m,Sell
131318.07,1.06434,12.03.2015 15:30:00,,0.0,-0.0,0.0,0.0,1.06242,12.03.2015 06:45:00,11440,-0.0,65.2,IS,0.34,0.0,Phase3-EA-S4v1-EURCHF-M15-221,EURCHFMT4,3028,8h 45m,Buy
131375.9,1.00292,13.03.2015 01:29:58,tp 1.00292,0.0,-0.0,0.0,0.0,1.00192,13.03.2015 00:30:00,11441,-0.0,57.83,IS,0.58,0.0,Phase3-EA-SA2v2-USDCHF-M15-107,USDCHFMT4,2228,59m 58s,Buy
131385.92,121306,13.03.2015 02:15:00,,0.0,-0.0,0.0,0.0,121261,13.03.2015 00:30:00,11442,-0.0,10.02,IS,0.27,0.0,Phase3-EA-S1v2-USDJPY-M15-0,USDJPYMT4,3260,1h 45m,Buy
131378.16,1.06476,13.03.2015 04:20:00,,-2.04,-7.760000000009313,0.0,0.0,1.06462,12.03.2015 20:00:00,11443,-0.003505191296722602,-7.76,IS,0.41,0.0,Phase3-EA-SA2v2-EURCHF-M5-43,EURCHFMT4,5788,8h 20m,Sell
131383.65,180589,13.03.2015 05:45:00,,0.0,-2.2700000000186265,0.0,0.0,180618,13.03.2015 00:20:00,11444,-0.0010253587942804184,5.49,IS,0.23,0.0,Phase3-EA-S4v1-GBPJPY-M5-194,GBPJPYMT4,2616,5h 25m,Sell
131439.44,1.06584,13.03.2015 14:15:00,,0.0,-0.0,0.0,0.0,1.06419,13.03.2015 05:30:00,11445,-0.0,55.79,IS,0.34,0.0,Phase3-EA-S4v1-EURCHF-M15-221,EURCHFMT4,3030,8h 45m,Buy
131381.17,127317,13.03.2015 19:29:59,sl 127.317,-0.36,-58.26999999998952,0.0,0.0,128097,12.03.2015 02:30:00,11446,-0.026314192268544912,-58.27,IS,0.09,0.0,Phase3-EA-TR1v1-EURJPY-M30-91,EURJPYMT4,2030,1d 16h 59m,Buy
131181.24,1.05255,13.03.2015 21:29:57,sl 1.05255,0.0,-258.19999999998254,0.0,0.0,1.05745,13.03.2015 20:00:00,11447,-0.11660072839778717,-199.93,IS,0.41,0.0,Phase3-EA-SA2v2-EURCHF-M5-43,EURCHFMT4,5790,1h 29m,Buy
131226.16,1.05375,13.03.2015 21:54:58,tp 1.05375,0.0,-213.27999999996973,0.0,0.0,1.05265,13.03.2015 21:40:00,11448,-0.09631527247357939,44.92,IS,0.41,0.0,Phase3-EA-SA2v2-EURCHF-M5-43,EURCHFMT4,5792,14m 58s,Buy
131283.8,1.00623,13.03.2015 23:14:58,tp 1.00623,0.0,-155.63999999995576,0.0,0.0,1.00723,13.03.2015 23:00:00,11449,-0.07028558236958816,57.64,IS,0.58,0.0,Phase3-EA-SA2v2-USDCHF-M15-107,USDCHFMT4,2230,14m 58s,Sell
131233.69,178969,16.03.2015 02:29:57,sl 178.969,-0.43,-205.7499999999418,0.0,0.0,178299,13.03.2015 21:30:00,11450,-0.09291479422091226,-50.11,IS,0.09,0.0,Phase3-EA-B1v1-GBPJPY-M30-1,GBPJPYMT4,1076,2d 4h 59m,Sell
131033.78,1.06007,16.03.2015 10:09:58,sl 1.06007,0.0,-405.6599999999453,0.0,0.0,1.05517,16.03.2015 02:15:00,11451,-0.18319229853541116,-199.91,IS,0.41,0.0,Phase3-EA-SA2v2-EURCHF-M5-43,EURCHFMT4,5794,7h 54m,Sell
130980.01,128232,16.03.2015 17:59:58,sl 128.232,-0.26,-459.4299999999348,0.0,0.0,127512,13.03.2015 20:00:00,11452,-0.20747433248563665,-53.77,IS,0.09,0.0,Phase3-EA-TR1v1-EURJPY-M30-91,EURJPYMT4,2032,2d 21h 59m,Sell
131024.89,1.06404,16.03.2015 20:34:57,tp 1.06404,0.0,-414.54999999993015,0.0,0.0,1.06514,16.03.2015 20:05:00,11453,-0.1872069401909287,44.88,IS,0.41,0.0,Phase3-EA-SA2v2-EURCHF-M5-43,EURCHFMT4,5796,29m 57s,Sell
131067.62,1.06489,17.03.2015 00:29:58,tp 1.06489,-2.03,-371.8199999999197,0.0,0.0,1.06599,16.03.2015 21:05:00,11454,-0.16791046798163745,42.73,IS,0.41,0.0,Phase3-EA-SA2v2-EURCHF-M5-43,EURCHFMT4,5798,3h 24m,Sell
131063.55,1.06486,17.03.2015 08:50:00,,0.0,-375.88999999992666,0.0,0.0,1.06496,17.03.2015 00:30:00,11455,-0.1697484422828762,-4.07,IS,0.41,0.0,Phase3-EA-SA2v2-EURCHF-M5-43,EURCHFMT4,5800,8h 20m,Buy
131013.88,179423,17.03.2015 12:29:57,sl 179.423,0.0,-425.55999999993946,0.0,0.0,180093,17.03.2015 07:00:00,11456,-0.19217895420975448,-49.67,IS,0.09,0.0,Phase3-EA-B1v1-GBPJPY-M30-1,GBPJPYMT4,1078,5h 29m,Buy
130987.74,1.06369,17.03.2015 14:30:00,,0.0,-451.69999999995343,0.0,0.0,1.06446,17.03.2015 05:45:00,11457,-0.20398353608550968,-26.14,IS,0.34,0.0,Phase3-EA-S4v1-EURCHF-M15-221,EURCHFMT4,3032,8h 45m,Buy
130929.84,129044,17.03.2015 18:29:57,sl 129.044,0.0,-509.5999999999476,0.0,0.0,128264,17.03.2015 00:30:00,11458,-0.2301306397812171,-57.9,IS,0.09,0.0,Phase3-EA-TR1v1-EURJPY-M30-91,EURJPYMT4,2034,17h 59m,Sell
130974.71,1.06547,17.03.2015 20:34:57,tp 1.06547,0.0,-464.72999999995227,0.0,0.0,1.06437,17.03.2015 20:15:00,11459,-0.2098677633938874,44.87,IS,0.41,0.0,Phase3-EA-SA2v2-EURCHF-M5-43,EURCHFMT4,5802,19m 57s,Buy
131017.51,1.06525,18.03.2015 02:24:58,tp 1.06525,-2.04,-421.9299999999639,0.0,0.0,1.06635,17.03.2015 22:50:00,11460,-0.19053967983298783,42.8,IS,0.41,0.0,Phase3-EA-SA2v2-EURCHF-M5-43,EURCHFMT4,5804,3h 34m,Sell
131062.36,1.06633,18.03.2015 04:54:58,tp 1.06633,0.0,-377.0799999999581,0.0,0.0,1.06523,18.03.2015 02:25:00,11461,-0.17028583526040153,44.85,IS,0.41,0.0,Phase3-EA-SA2v2-EURCHF-M5-43,EURCHFMT4,5806,2h 29m,Buy
131101.04,179069,18.03.2015 05:55:00,,0.0,-338.3999999999651,0.0,0.0,178865,18.03.2015 00:30:00,11462,-0.15281830553760564,38.68,IS,0.23,0.0,Phase3-EA-S4v1-GBPJPY-M5-194,GBPJPYMT4,2618,5h 25m,Buy
131068.83,128447,18.03.2015 09:59:58,sl 128.447,0.0,-370.6099999999569,0.0,0.0,128677,18.03.2015 05:00:00,11463,-0.16736404318939505,-32.21,IS,0.17,0.0,Phase3-EA-T1v2-EURJPY-M15-322,EURJPYMT4,2106,4h 59m,Buy
131164.9,1.06356,18.03.2015 14:15:00,,0.0,-274.53999999994994,0.0,0.0,1.06639,18.03.2015 05:30:00,11464,-0.12397972104695901,96.07,IS,0.34,0.0,Phase3-EA-S4v1-EURCHF-M15-221,EURCHFMT4,3034,8h 45m,Sell
131301.89,177544,18.03.2015 15:59:58,tp 177.544,-0.43,-137.54999999995925,0.0,0.0,179394,17.03.2015 12:30:00,11465,-0.06211630592994562,136.99,IS,0.09,0.0,Phase3-EA-B1v1-GBPJPY-M30-1,GBPJPYMT4,1080,1d 3h 29m,Sell
131269.55,128784,18.03.2015 20:44:58,sl 128.784,0.0,-169.88999999995576,0.0,0.0,128554,18.03.2015 16:15:00,11466,-0.0767207503775997,-32.34,IS,0.17,0.0,Phase3-EA-T1v2-EURJPY-M15-322,EURJPYMT4,2108,4h 29m,Sell
131314.94,1.0593,18.03.2015 21:09:58,tp 1.05930,0.0,-124.49999999994179,0.0,0.0,1.0582,18.03.2015 20:40:00,11467,-0.05622304680681137,45.39,IS,0.41,0.0,Phase3-EA-SA2v2-EURCHF-M5-43,EURCHFMT4,5808,29m 58s,Buy
131081.33,0.97721,19.03.2015 00:14:58,sl 0.97721,-2.13,-358.1099999999278,0.0,0.0,0.98111,18.03.2015 23:30:00,11468,-0.16171915897182793,-233.61,IS,0.58,0.0,Phase3-EA-SA2v2-USDCHF-M15-107,USDCHFMT4,2232,44m 58s,Buy
131127.62,1.06405,19.03.2015 00:19:58,tp 1.06405,0.0,-311.8199999999197,0.0,0.0,1.06515,19.03.2015 00:15:00,11469,-0.14081502373737834,46.29,IS,0.41,0.0,Phase3-EA-SA2v2-EURCHF-M5-43,EURCHFMT4,5810,4m 58s,Sell
131202.48,179747,19.03.2015 00:24:57,tp 179.747,0.0,-236.95999999993364,0.0,0.0,180137,19.03.2015 00:10:00,11470,-0.10700894113529737,74.86,IS,0.23,0.0,Phase3-EA-S4v1-GBPJPY-M5-194,GBPJPYMT4,2620,14m 57s,Sell
131465.48,1.50294,19.03.2015 00:29:58,tp 1.50294,-1.6,-0.0,0.0,0.0,1.48404,18.03.2015 22:30:00,11471,-0.0,263.0,IS,0.14,0.0,Phase3-EA-B1v1-GBPUSD-M30-14,GBPUSDMT4,764,1h 59m,Buy
131511.33,1.06502,19.03.2015 02:39:57,tp 1.06502,0.0,-0.0,0.0,0.0,1.06612,19.03.2015 02:25:00,11472,-0.0,45.85,IS,0.41,0.0,Phase3-EA-SA2v2-EURCHF-M5-43,EURCHFMT4,5812,14m 57s,Sell
131570.34,0.98291,19.03.2015 02:59:58,tp 0.98291,0.0,-0.0,0.0,0.0,0.98391,19.03.2015 02:30:00,11473,-0.0,59.01,IS,0.58,0.0,Phase3-EA-SA2v2-USDCHF-M15-107,USDCHFMT4,2234,29m 58s,Sell
131534.71,1.06692,19.03.2015 11:15:00,,0.0,-35.63000000000466,0.0,0.0,1.06588,19.03.2015 02:30:00,11474,-0.01608067216939073,-35.63,IS,0.34,0.0,Phase3-EA-S4v1-EURCHF-M15-221,EURCHFMT4,3036,8h 45m,Sell
131481.31,0.98847,20.03.2015 05:15:00,,0.0,-89.02999999999884,0.0,0.0,0.98938,20.03.2015 01:00:00,11475,-0.04018137084593463,-53.4,IS,0.58,0.0,Phase3-EA-SA2v2-USDCHF-M15-107,USDCHFMT4,2236,4h 15m,Buy
131412.45,1.05652,20.03.2015 10:30:00,,0.0,-157.88999999998487,0.0,0.0,1.05486,20.03.2015 02:10:00,11476,-0.07125953771609675,-68.86,IS,0.41,0.0,Phase3-EA-SA2v2-EURCHF-M5-43,EURCHFMT4,5814,8h 20m,Sell
131424.15,1.05501,20.03.2015 12:45:00,,0.0,-146.18999999997322,0.0,0.0,1.05535,20.03.2015 04:00:00,11477,-0.06597904755662344,11.7,IS,0.34,0.0,Phase3-EA-S4v1-EURCHF-M15-221,EURCHFMT4,3038,8h 45m,Sell
131520.12,130137,20.03.2015 16:59:58,tp 130.137,0.0,-50.21999999997206,0.0,0.0,128847,20.03.2015 02:30:00,11478,-0.022665488530627213,95.97,IS,0.09,0.0,Phase3-EA-TR1v1-EURJPY-M30-91,EURJPYMT4,2036,14h 29m,Buy
131333.53,120101,20.03.2015 20:44:58,sl 120.101,0.0,-236.80999999996857,0.0,0.0,120931,20.03.2015 17:00:00,11479,-0.10687802347550984,-186.59,IS,0.27,0.0,Phase3-EA-S1v2-USDJPY-M15-0,USDJPYMT4,3262,3h 44m,Buy
131379.75,1.05474,20.03.2015 22:44:58,tp 1.05474,0.0,-190.5899999999674,0.0,0.0,1.05584,20.03.2015 20:45:00,11480,-0.08601783072588422,46.22,IS,0.41,0.0,Phase3-EA-SA2v2-EURCHF-M5-43,EURCHFMT4,5816,1h 59m,Sell
131436.08,0.97504,23.03.2015 02:00:00,tp 0.97504,-3.15,-134.2599999999802,0.0,0.0,0.97604,20.03.2015 23:30:00,11481,-0.060594752889750185,56.33,IS,0.58,0.0,Phase3-EA-SA2v2-USDCHF-M15-107,USDCHFMT4,2238,2d 2h 30m,Sell
131481.39,1.0562,23.03.2015 02:00:00,tp 1.05620,-1.01,-88.94999999998254,0.0,0.0,1.0551,20.03.2015 23:35:00,11482,-0.040145264930306984,45.31,IS,0.41,0.0,Phase3-EA-SA2v2-EURCHF-M5-43,EURCHFMT4,5818,2d 2h 25m,Buy
131527.53,1.0586,23.03.2015 03:19:58,tp 1.05860,0.0,-42.80999999996857,0.0,0.0,1.0597,23.03.2015 02:35:00,11483,-0.01932117809629587,46.14,IS,0.41,0.0,Phase3-EA-SA2v2-EURCHF-M5-43,EURCHFMT4,5820,44m 58s,Sell
131473.21,129554,23.03.2015 06:29:58,sl 129.554,-0.37,-97.12999999997555,0.0,0.0,130274,20.03.2015 18:00:00,11484,-0.04383709480247893,-54.32,IS,0.09,0.0,Phase3-EA-TR1v1-EURJPY-M30-91,EURJPYMT4,2038,2d 12h 29m,Buy
131371.34,0.97927,23.03.2015 07:00:00,,0.0,-198.9999999999709,0.0,0.0,0.97755,23.03.2015 02:45:00,11485,-0.08981346510546924,-101.87,IS,0.58,0.0,Phase3-EA-SA2v2-USDCHF-M15-107,USDCHFMT4,2240,4h 15m,Sell
131470.69,1.0559,23.03.2015 12:00:00,,0.0,-99.64999999996508,0.0,0.0,1.05876,23.03.2015 03:15:00,11486,-0.04497443114451348,99.35,IS,0.34,0.0,Phase3-EA-S4v1-EURCHF-M15-221,EURCHFMT4,3040,8h 45m,Sell
131501.37,119677,23.03.2015 20:30:00,,0.0,-68.96999999997206,0.0,0.0,119813,23.03.2015 19:15:00,11487,-0.03112781250413372,30.68,IS,0.27,0.0,Phase3-EA-S1v2-USDJPY-M15-0,USDJPYMT4,3264,1h 15m,Sell
131459.37,1.49213,24.03.2015 06:59:58,sl 1.49213,0.0,-110.96999999997206,0.0,0.0,1.49513,24.03.2015 04:30:00,11488,-0.050083418204788295,-42.0,IS,0.14,0.0,Phase3-EA-B1v1-GBPUSD-M30-14,GBPUSDMT4,766,2h 29m,Buy
131426.66,130.92,24.03.2015 13:59:57,sl 130.920,0.0,-143.6799999999639,0.0,0.0,131.15,24.03.2015 12:30:00,11489,-0.0648462244540325,-32.71,IS,0.17,0.0,Phase3-EA-T1v2-EURJPY-M15-322,EURJPYMT4,2110,1h 29m,Buy
131321.28,0.95936,25.03.2015 03:45:00,,-3.21,-249.05999999996857,0.0,0.0,0.95767,24.03.2015 23:30:00,11490,-0.11240674180486743,-105.38,IS,0.58,0.0,Phase3-EA-SA2v2-USDCHF-M15-107,USDCHFMT4,2242,4h 15m,Sell
131344.98,119771,25.03.2015 04:00:00,,-0.65,-225.35999999995693,0.0,0.0,119663,24.03.2015 22:00:00,11491,-0.10171036430234995,23.7,IS,0.27,0.0,Phase3-EA-S1v2-USDJPY-M15-0,USDJPYMT4,3266,6h 0m,Buy
131419.85,178027,25.03.2015 04:55:00,tp 178.027,0.0,-150.48999999996158,0.0,0.0,177637,25.03.2015 02:25:00,11492,-0.06791974052120901,74.87,IS,0.23,0.0,Phase3-EA-S4v1-GBPJPY-M5-194,GBPJPYMT4,2622,2h 30m,Buy
131462.61,1.05668,25.03.2015 05:05:00,tp 1.05668,-4.27,-107.72999999995227,0.0,0.0,1.05778,23.03.2015 22:00:00,11493,-0.048621128622157436,42.76,IS,0.41,0.0,Phase3-EA-SA2v2-EURCHF-M5-43,EURCHFMT4,5822,1d 7h 5m,Sell
131429.95,130913,25.03.2015 11:29:58,sl 130.913,0.0,-140.38999999995576,0.0,0.0,130683,25.03.2015 09:00:00,11494,-0.06336136867414421,-32.66,IS,0.17,0.0,Phase3-EA-T1v2-EURJPY-M15-322,EURJPYMT4,2112,2h 29m,Sell
131379.1,178237,25.03.2015 15:29:58,sl 178.237,-0.44,-191.23999999996158,0.0,0.0,177567,24.03.2015 22:30:00,11495,-0.08631119129029648,-50.85,IS,0.09,0.0,Phase3-EA-B1v1-GBPJPY-M30-1,GBPJPYMT4,1082,16h 59m,Sell
131426.08,1.05307,25.03.2015 23:49:57,tp 1.05307,0.0,-144.2599999999511,0.0,0.0,1.05417,25.03.2015 21:45:00,11496,-0.06510799234227385,46.98,IS,0.41,0.0,Phase3-EA-SA2v2-EURCHF-M5-43,EURCHFMT4,5824,2h 4m,Sell
131486.49,0.96016,26.03.2015 03:59:58,tp 0.96016,0.0,-83.84999999994761,0.0,0.0,0.95916,26.03.2015 01:00:00,11497,-0.03784351280949745,60.41,IS,0.58,0.0,Phase3-EA-SA2v2-USDCHF-M15-107,USDCHFMT4,2244,2h 59m,Buy
131509.42,177703,26.03.2015 05:30:00,,0.0,-60.9199999999546,0.0,0.0,177584,26.03.2015 00:05:00,11498,-0.027494654744833712,22.93,IS,0.23,0.0,Phase3-EA-S4v1-GBPJPY-M5-194,GBPJPYMT4,2624,5h 25m,Buy
131556.43,1.05409,26.03.2015 08:34:57,tp 1.05409,0.0,-13.909999999945285,0.0,0.0,1.05299,26.03.2015 00:50:00,11499,-0.006277916078453998,47.01,IS,0.41,0.0,Phase3-EA-SA2v2-EURCHF-M5-43,EURCHFMT4,5826,7h 44m,Buy
131603.32,1.04856,26.03.2015 21:04:58,tp 1.04856,0.0,-0.0,0.0,0.0,1.04966,26.03.2015 20:35:00,11500,-0.0,46.89,IS,0.41,0.0,Phase3-EA-SA2v2-EURCHF-M5-43,EURCHFMT4,5828,29m 58s,Sell
131665.59,119242,26.03.2015 21:45:00,,0.0,-0.0,0.0,0.0,118967,26.03.2015 20:30:00,11501,-0.0,62.27,IS,0.27,0.0,Phase3-EA-S1v2-USDJPY-M15-0,USDJPYMT4,3268,1h 15m,Buy
131762.01,129582,26.03.2015 21:59:57,tp 129.582,-1.05,-0.0,0.0,0.0,130872,24.03.2015 06:00:00,11502,-0.0,96.42,IS,0.09,0.0,Phase3-EA-TR1v1-EURJPY-M30-91,EURJPYMT4,2040,2d 15h 59m,Sell
131764.39,1.04858,27.03.2015 06:35:00,,-1.02,-0.0,0.0,0.0,1.0485,26.03.2015 22:15:00,11503,-0.0,2.38,IS,0.41,0.0,Phase3-EA-SA2v2-EURCHF-M5-43,EURCHFMT4,5830,8h 20m,Buy
131811.5,1.04452,27.03.2015 20:14:57,tp 1.04452,0.0,-0.0,0.0,0.0,1.04342,27.03.2015 20:05:00,11504,-0.0,47.11,IS,0.41,0.0,Phase3-EA-SA2v2-EURCHF-M5-43,EURCHFMT4,5832,9m 57s,Buy
131778.69,129917,27.03.2015 20:14:58,sl 129.917,0.0,-32.80999999999767,0.0,0.0,129687,27.03.2015 09:45:00,11505,-0.014791839016461021,-32.81,IS,0.17,0.0,Phase3-EA-T1v2-EURJPY-M15-322,EURJPYMT4,2114,10h 29m,Sell
131724.01,130353,27.03.2015 20:29:58,sl 130.353,-0.26,-87.48999999999069,0.0,0.0,129633,26.03.2015 23:00:00,11506,-0.03944340126638613,-54.68,IS,0.09,0.0,Phase3-EA-TR1v1-EURJPY-M30-91,EURJPYMT4,2042,21h 29m,Sell
131738.13,177221,30.03.2015 05:10:00,,-1.12,-73.36999999999534,0.0,0.0,177.3,27.03.2015 23:45:00,11507,-0.033077635740254595,14.12,IS,0.23,0.0,Phase3-EA-S4v1-GBPJPY-M5-194,GBPJPYMT4,2626,2d 5h 25m,Sell
131696.53,0.96195,30.03.2015 06:15:00,,0.0,-114.97000000000116,0.0,0.0,0.96126,30.03.2015 02:00:00,11508,-0.05183229904671324,-41.6,IS,0.58,0.0,Phase3-EA-SA2v2-USDCHF-M15-107,USDCHFMT4,2246,4h 15m,Sell
131693.25,119206,30.03.2015 09:00:00,,-1.02,-118.25,0.0,0.0,119196,27.03.2015 19:45:00,11509,-0.05331103211510637,-3.28,IS,0.27,0.0,Phase3-EA-S1v2-USDJPY-M15-0,USDJPYMT4,3270,2d 13h 15m,Sell
131739.87,1.04666,30.03.2015 20:39:58,tp 1.04666,0.0,-71.63000000000466,0.0,0.0,1.04776,30.03.2015 20:00:00,11510,-0.03229318588080607,46.62,IS,0.41,0.0,Phase3-EA-SA2v2-EURCHF-M5-43,EURCHFMT4,5834,39m 58s,Sell
131786.47,1.04709,30.03.2015 23:19:57,tp 1.04709,0.0,-25.029999999998836,0.0,0.0,1.04819,30.03.2015 22:00:00,11511,-0.011284356311552222,46.6,IS,0.41,0.0,Phase3-EA-SA2v2-EURCHF-M5-43,EURCHFMT4,5836,1h 19m,Sell
131843.3,0.96653,31.03.2015 01:14:57,tp 0.96653,-3.18,-0.0,0.0,0.0,0.96753,30.03.2015 22:15:00,11512,-0.0,56.83,IS,0.58,0.0,Phase3-EA-SA2v2-USDCHF-M15-107,USDCHFMT4,2248,2h 59m,Sell
131875.62,120312,31.03.2015 05:15:00,,0.0,-0.0,0.0,0.0,120168,31.03.2015 01:45:00,11513,-0.0,32.32,IS,0.27,0.0,Phase3-EA-S1v2-USDJPY-M15-0,USDJPYMT4,3272,3h 30m,Buy
131922.2,1.04818,31.03.2015 05:34:58,tp 1.04818,0.0,-0.0,0.0,0.0,1.04708,31.03.2015 01:15:00,11514,-0.0,46.58,IS,0.41,0.0,Phase3-EA-SA2v2-EURCHF-M5-43,EURCHFMT4,5838,4h 19m,Buy
131924.11,177819,31.03.2015 06:00:00,,0.0,-0.0,0.0,0.0,177809,31.03.2015 00:35:00,11515,-0.0,1.91,IS,0.23,0.0,Phase3-EA-S4v1-GBPJPY-M5-194,GBPJPYMT4,2628,5h 25m,Buy
131890.91,129674,31.03.2015 08:14:57,sl 129.674,-0.69,-33.20000000001164,0.0,0.0,129904,30.03.2015 13:30:00,11516,-0.014960069007378876,-33.2,IS,0.17,0.0,Phase3-EA-T1v2-EURJPY-M15-322,EURJPYMT4,2116,18h 44m,Buy
132030.96,1.04389,31.03.2015 14:29:58,tp 1.04389,0.0,-0.0,0.0,0.0,1.04789,31.03.2015 06:00:00,11517,-0.0,140.05,IS,0.34,0.0,Phase3-EA-S4v1-EURCHF-M15-221,EURCHFMT4,3042,8h 29m,Sell
132043.57,119903,31.03.2015 19:00:00,,0.0,-0.0,0.0,0.0,119959,31.03.2015 18:30:00,11518,-0.0,12.61,IS,0.27,0.0,Phase3-EA-S1v2-USDJPY-M15-0,USDJPYMT4,3274,30m 0s,Sell
132140.36,128642,31.03.2015 20:59:58,tp 128.642,0.0,-0.0,0.0,0.0,129932,31.03.2015 07:00:00,11519,-0.0,96.79,IS,0.09,0.0,Phase3-EA-TR1v1-EURJPY-M30-91,EURJPYMT4,2044,13h 59m,Sell
132167.83,119892,31.03.2015 23:30:00,,0.0,-0.0,0.0,0.0,120014,31.03.2015 19:15:00,11520,-0.0,27.47,IS,0.27,0.0,Phase3-EA-S1v2-USDJPY-M15-0,USDJPYMT4,3276,4h 15m,Sell
132227.57,0.97086,01.04.2015 02:29:58,tp 0.97086,0.0,-0.0,0.0,0.0,0.97186,01.04.2015 00:45:00,11521,-0.0,59.74,IS,0.58,0.0,Phase3-EA-SA2v2-USDCHF-M15-107,USDCHFMT4,2250,1h 44m,Sell
132273.08,1.04511,01.04.2015 05:54:58,tp 1.04511,-1.01,-0.0,0.0,0.0,1.04401,31.03.2015 22:45:00,11522,-0.0,45.51,IS,0.41,0.0,Phase3-EA-SA2v2-EURCHF-M5-43,EURCHFMT4,5840,7h 9m,Buy
132240.39,128964,01.04.2015 08:14:58,sl 128.964,0.0,-32.69000000000233,0.0,0.0,128734,01.04.2015 05:15:00,11523,-0.014707134125285034,-32.69,IS,0.17,0.0,Phase3-EA-T1v2-EURJPY-M15-322,EURJPYMT4,2118,2h 59m,Sell
132207.67,128883,01.04.2015 18:44:57,sl 128.883,0.0,-65.41000000000349,0.0,0.0,128653,01.04.2015 18:00:00,11524,-0.02942776516166647,-32.72,IS,0.17,0.0,Phase3-EA-T1v2-EURJPY-M15-322,EURJPYMT4,2120,44m 57s,Sell
132225.62,119579,02.04.2015 03:45:00,,-3.05,-47.45999999999185,0.0,0.0,119672,01.04.2015 22:15:00,11525,-0.021352113355333685,17.95,IS,0.27,0.0,Phase3-EA-S1v2-USDJPY-M15-0,USDJPYMT4,3278,5h 30m,Sell
132198.34,1.03957,02.04.2015 07:10:00,,-3.06,-74.73999999999069,0.0,0.0,1.04014,01.04.2015 22:50:00,11526,-0.03362530451280478,-27.28,IS,0.41,0.0,Phase3-EA-SA2v2-EURCHF-M5-43,EURCHFMT4,5842,8h 20m,Buy
132165.63,128998,02.04.2015 10:14:58,sl 128.998,0.0,-107.44999999998254,0.0,0.0,128768,02.04.2015 04:30:00,11527,-0.04834143657881638,-32.71,IS,0.17,0.0,Phase3-EA-T1v2-EURJPY-M15-322,EURJPYMT4,2122,5h 44m,Sell
132110.53,129943,02.04.2015 16:59:58,sl 129.943,-1.05,-162.54999999998836,0.0,0.0,129223,31.03.2015 12:00:00,11528,-0.0731307632935069,-55.1,IS,0.09,0.0,Phase3-EA-TR1v1-EURJPY-M30-91,EURJPYMT4,2045,2d 4h 59m,Sell
132157.64,1043,02.04.2015 22:14:57,tp 1.04300,0.0,-115.44000000000233,0.0,0.0,1.0441,02.04.2015 21:15:00,11529,-0.051936113900973316,47.11,IS,0.41,0.0,Phase3-EA-SA2v2-EURCHF-M5-43,EURCHFMT4,5844,59m 57s,Sell
132163.75,119748,03.04.2015 00:45:00,,-0.65,-109.3300000000163,0.0,0.0,119718,02.04.2015 22:45:00,11530,-0.04918724300757228,6.11,IS,0.27,0.0,Phase3-EA-S1v2-USDJPY-M15-0,USDJPYMT4,3280,2h 0m,Buy
132208.6,1.04347,03.04.2015 04:44:57,tp 1.04347,-2.14,-64.48000000001048,0.0,0.0,1.04457,02.04.2015 23:00:00,11531,-0.029009360917664897,44.85,IS,0.41,0.0,Phase3-EA-SA2v2-EURCHF-M5-43,EURCHFMT4,5846,5h 44m,Sell
132209.66,1.0436,03.04.2015 12:45:00,,0.0,-63.420000000012806,0.0,0.0,1.04357,03.04.2015 04:00:00,11532,-0.028532470058907886,1.06,IS,0.34,0.0,Phase3-EA-S4v1-EURCHF-M15-221,EURCHFMT4,3044,8h 45m,Buy
132257.02,1.04511,03.04.2015 21:09:58,tp 1.04511,0.0,-16.060000000026776,0.0,0.0,1.04401,03.04.2015 20:35:00,11533,-0.00722534640723324,47.36,IS,0.41,0.0,Phase3-EA-SA2v2-EURCHF-M5-43,EURCHFMT4,5848,34m 58s,Buy
132302.37,1.04423,06.04.2015 01:00:00,tp 1.04423,-2.15,-0.0,0.0,0.0,1.04533,03.04.2015 22:15:00,11534,-0.0,45.35,IS,0.41,0.0,Phase3-EA-SA2v2-EURCHF-M5-43,EURCHFMT4,5850,2d 2h 45m,Sell
132349.77,1.04448,06.04.2015 01:04:57,tp 1.04448,0.0,-0.0,0.0,0.0,1.04338,06.04.2015 01:00:00,11535,-0.0,47.4,IS,0.41,0.0,Phase3-EA-SA2v2-EURCHF-M5-43,EURCHFMT4,5852,4m 57s,Buy
132371.92,118847,06.04.2015 01:15:00,,-1.02,-0.0,0.0,0.0,118949,03.04.2015 22:45:00,11536,-0.0,22.15,IS,0.27,0.0,Phase3-EA-S1v2-USDJPY-M15-0,USDJPYMT4,3282,2d 2h 30m,Sell
132432.85,0.95199,06.04.2015 02:14:57,tp 0.95199,0.0,-0.0,0.0,0.0,0.95099,06.04.2015 01:15:00,11537,-0.0,60.93,IS,0.58,0.0,Phase3-EA-SA2v2-USDCHF-M15-107,USDCHFMT4,2252,59m 57s,Buy
132494.13,130637,06.04.2015 10:30:00,,-0.7,-0.0,0.0,0.0,130203,03.04.2015 10:00:00,11538,-0.0,61.28,IS,0.17,0.0,Phase3-EA-T1v2-EURJPY-M15-322,EURJPYMT4,2124,3d 0h 30m,Buy
132528.98,1.04535,06.04.2015 10:45:00,,0.0,-0.0,0.0,0.0,1.04616,06.04.2015 02:25:00,11539,-0.0,34.85,IS,0.41,0.0,Phase3-EA-SA2v2-EURCHF-M5-43,EURCHFMT4,5854,8h 20m,Sell
132611.16,1.04495,06.04.2015 12:45:00,,0.0,-0.0,0.0,0.0,1.04725,06.04.2015 04:00:00,11540,-0.0,82.18,IS,0.34,0.0,Phase3-EA-S4v1-EURCHF-M15-221,EURCHFMT4,3046,8h 45m,Sell
132578.4,130.54,06.04.2015 23:14:58,sl 130.540,0.0,-32.76000000000931,0.0,0.0,130.77,06.04.2015 13:30:00,11541,-0.014716243336591524,-32.76,IS,0.17,0.0,Phase3-EA-T1v2-EURJPY-M15-322,EURJPYMT4,2126,9h 44m,Buy
132624.47,1.04821,07.04.2015 00:04:58,tp 1.04821,-1.03,-0.0,0.0,0.0,1.04711,06.04.2015 23:45:00,11542,-0.0,46.07,IS,0.41,0.0,Phase3-EA-SA2v2-EURCHF-M5-43,EURCHFMT4,5856,19m 58s,Buy
132521.31,0.95578,07.04.2015 06:45:00,,0.0,-103.16000000000349,0.0,0.0,0.95748,07.04.2015 02:30:00,11543,-0.04633812266908611,-103.16,IS,0.58,0.0,Phase3-EA-SA2v2-USDCHF-M15-107,USDCHFMT4,2254,4h 15m,Buy
132447.1,1.0455,07.04.2015 09:25:00,,0.0,-177.36999999999534,0.0,0.0,1.04723,07.04.2015 01:05:00,11544,-0.07967228400363813,-74.21,IS,0.41,0.0,Phase3-EA-SA2v2-EURCHF-M5-43,EURCHFMT4,5858,8h 20m,Buy
132414.41,130769,07.04.2015 11:14:58,sl 130.769,0.0,-210.05999999999767,0.0,0.0,130539,07.04.2015 10:15:00,11545,-0.09435620441903636,-32.69,IS,0.17,0.0,Phase3-EA-T1v2-EURJPY-M15-322,EURJPYMT4,2128,59m 58s,Sell
132381.89,130636,07.04.2015 17:44:58,sl 130.636,0.0,-242.5799999999872,0.0,0.0,130406,07.04.2015 12:30:00,11546,-0.10896376305802574,-32.52,IS,0.17,0.0,Phase3-EA-T1v2-EURJPY-M15-322,EURJPYMT4,2130,5h 14m,Sell
132331.53,178209,08.04.2015 00:59:58,sl 178.209,-0.27,-292.9399999999732,0.0,0.0,178879,07.04.2015 16:30:00,11547,-0.13158481635013944,-50.36,IS,0.09,0.0,Phase3-EA-B1v1-GBPJPY-M30-1,GBPJPYMT4,1084,8h 29m,Buy
132391.61,0.96543,08.04.2015 02:14:58,tp 0.96543,0.0,-232.85999999998603,0.0,0.0,0.96643,08.04.2015 00:30:00,11548,-0.10459766619544765,60.08,IS,0.58,0.0,Phase3-EA-SA2v2-USDCHF-M15-107,USDCHFMT4,2256,1h 44m,Sell
132395.44,178159,08.04.2015 06:30:00,,0.0,-229.02999999999884,0.0,0.0,178139,08.04.2015 01:05:00,11549,-0.10287728029178343,3.83,IS,0.23,0.0,Phase3-EA-S4v1-GBPJPY-M5-194,GBPJPYMT4,2630,5h 25m,Buy
132446.42,1.04433,08.04.2015 15:00:00,,0.0,-178.04999999998836,0.0,0.0,1.04577,08.04.2015 06:15:00,11550,-0.07997773110924741,50.98,IS,0.34,0.0,Phase3-EA-S4v1-EURCHF-M15-221,EURCHFMT4,3048,8h 45m,Sell
132351.4,119914,08.04.2015 18:15:00,,0.0,-273.0699999999779,0.0,0.0,120336,08.04.2015 00:30:00,11551,-0.12265947224937855,-95.02,IS,0.27,0.0,Phase3-EA-S1v2-USDJPY-M15-0,USDJPYMT4,3284,17h 45m,Buy
132295.91,129442,08.04.2015 19:29:57,sl 129.442,-1.48,-328.55999999996857,0.0,0.0,130162,02.04.2015 17:30:00,11552,-0.14758485444118807,-55.49,IS,0.09,0.0,Phase3-EA-TR1v1-EURJPY-M30-91,EURJPYMT4,2048,6d 1h 59m,Buy
132342.69,1.0429,08.04.2015 21:34:58,tp 1.04290,0.0,-281.77999999996973,0.0,0.0,1.0418,08.04.2015 20:25:00,11553,-0.126571890322734,46.78,IS,0.41,0.0,Phase3-EA-SA2v2-EURCHF-M5-43,EURCHFMT4,5860,1h 9m,Buy
132292.37,178.56,08.04.2015 22:29:57,sl 178.560,0.0,-332.0999999999767,0.0,0.0,179.23,08.04.2015 18:00:00,11554,-0.1491749761380564,-50.32,IS,0.09,0.0,Phase3-EA-B1v1-GBPJPY-M30-1,GBPJPYMT4,1086,4h 29m,Buy
132233.89,128887,09.04.2015 17:59:58,sl 128.887,0.0,-390.5799999999872,0.0,0.0,129667,09.04.2015 07:30:00,11555,-0.17544342722072942,-58.48,IS,0.09,0.0,Phase3-EA-TR1v1-EURJPY-M30-91,EURJPYMT4,2050,10h 29m,Buy
132472.26,128568,09.04.2015 18:44:58,tp 128.568,-1.98,-152.20999999999185,0.0,0.0,130268,07.04.2015 22:15:00,11556,-0.06837074109597693,238.37,IS,0.17,0.0,Phase3-EA-T1v2-EURJPY-M15-322,EURJPYMT4,2132,1d 20h 29m,Sell
132518.43,1.04181,09.04.2015 21:34:58,tp 1.04181,0.0,-106.03999999997905,0.0,0.0,1.04071,09.04.2015 20:30:00,11557,-0.047631780998727745,46.17,IS,0.41,0.0,Phase3-EA-SA2v2-EURCHF-M5-43,EURCHFMT4,5862,1h 4m,Buy
132574.66,977,10.04.2015 00:44:57,tp 0.97700,-3.14,-49.80999999996857,0.0,0.0,978,09.04.2015 22:15:00,11558,-0.022374000486095818,56.23,IS,0.58,0.0,Phase3-EA-SA2v2-USDCHF-M15-107,USDCHFMT4,2258,2h 29m,Sell
132567.53,0.97666,10.04.2015 05:00:00,,0.0,-56.939999999973224,0.0,0.0,0.97678,10.04.2015 00:45:00,11559,-0.02557670322582816,-7.13,IS,0.58,0.0,Phase3-EA-SA2v2-USDCHF-M15-107,USDCHFMT4,2260,4h 15m,Buy
132569.77,120558,10.04.2015 11:15:00,,0.0,-54.69999999998254,0.0,0.0,120548,10.04.2015 01:45:00,11560,-0.024570524524991425,2.24,IS,0.27,0.0,Phase3-EA-S1v2-USDJPY-M15-0,USDJPYMT4,3286,9h 30m,Buy
132700.75,1.03824,10.04.2015 13:00:00,,0.0,-0.0,0.0,0.0,1.04201,10.04.2015 04:15:00,11561,-0.0,130.98,IS,0.34,0.0,Phase3-EA-S4v1-EURCHF-M15-221,EURCHFMT4,3050,8h 45m,Sell
132721.43,120133,10.04.2015 23:30:00,,0.0,-0.0,0.0,0.0,120225,10.04.2015 22:30:00,11562,-0.0,20.68,IS,0.27,0.0,Phase3-EA-S1v2-USDJPY-M15-0,USDJPYMT4,3288,1h 0m,Sell
132779.88,0.98033,13.04.2015 01:14:57,tp 0.98033,-0.71,-0.0,0.0,0.0,0.97933,10.04.2015 22:30:00,11563,-0.0,58.45,IS,0.58,0.0,Phase3-EA-SA2v2-USDCHF-M15-107,USDCHFMT4,2262,2d 2h 44m,Buy
132790.19,1.03846,13.04.2015 04:55:00,,-1.01,-0.0,0.0,0.0,1.03819,10.04.2015 20:35:00,11564,-0.0,10.31,IS,0.41,0.0,Phase3-EA-SA2v2-EURCHF-M5-43,EURCHFMT4,5864,2d 8h 20m,Buy
132740.29,176431,13.04.2015 13:29:58,sl 176.431,0.0,-49.89999999999418,0.0,0.0,175761,13.04.2015 09:30:00,11565,-0.022397754586947403,-49.9,IS,0.09,0.0,Phase3-EA-B1v1-GBPJPY-M30-1,GBPJPYMT4,1088,3h 59m,Sell
132715.43,1.03697,13.04.2015 15:30:00,,0.0,-74.75999999998021,0.0,0.0,1.03769,13.04.2015 06:45:00,11566,-0.03355623512865611,-24.86,IS,0.34,0.0,Phase3-EA-S4v1-EURCHF-M15-221,EURCHFMT4,3052,8h 45m,Buy
132954.73,126797,13.04.2015 16:44:58,tp 126.797,-0.5,-0.0,0.0,0.0,128497,10.04.2015 10:30:00,11567,-0.0,239.3,IS,0.17,0.0,Phase3-EA-T1v2-EURJPY-M15-322,EURJPYMT4,2134,3d 6h 14m,Sell
132894.11,1.03334,14.04.2015 04:20:00,,-1.01,-60.61999999999534,0.0,0.0,1.03476,13.04.2015 20:00:00,11568,-0.027189376067507036,-60.62,IS,0.41,0.0,Phase3-EA-SA2v2-EURCHF-M5-43,EURCHFMT4,5866,8h 20m,Buy
132988.21,126.23,14.04.2015 09:59:58,tp 126.230,-0.52,-0.0,0.0,0.0,127.49,10.04.2015 13:30:00,11569,-0.0,94.1,IS,0.09,0.0,Phase3-EA-TR1v1-EURJPY-M30-91,EURJPYMT4,2052,3d 20h 29m,Sell
133127.54,1.02982,14.04.2015 11:44:57,tp 1.02982,0.0,-0.0,0.0,0.0,1.03382,14.04.2015 05:15:00,11570,-0.0,139.33,IS,0.34,0.0,Phase3-EA-S4v1-EURCHF-M15-221,EURCHFMT4,3054,6h 29m,Sell
133077.07,176162,14.04.2015 16:59:58,sl 176.162,0.0,-50.470000000001164,0.0,0.0,175492,14.04.2015 11:30:00,11571,-0.022619350350028877,-50.47,IS,0.09,0.0,Phase3-EA-B1v1-GBPJPY-M30-1,GBPJPYMT4,1090,5h 29m,Sell
133022.83,127056,14.04.2015 16:59:58,sl 127.056,0.0,-104.70999999999185,0.0,0.0,126336,14.04.2015 11:00:00,11572,-0.04692831732021567,-54.24,IS,0.09,0.0,Phase3-EA-TR1v1-EURJPY-M30-91,EURJPYMT4,2054,5h 59m,Sell
133043.63,119443,14.04.2015 23:45:00,,0.0,-83.91000000000349,0.0,0.0,119351,14.04.2015 22:45:00,11573,-0.03760629458828925,20.8,IS,0.27,0.0,Phase3-EA-S1v2-USDJPY-M15-0,USDJPYMT4,3290,1h 0m,Buy
133087.89,1.03503,15.04.2015 04:04:57,tp 1.03503,-2.11,-39.64999999999418,0.0,0.0,1.03613,14.04.2015 23:05:00,11574,-0.017770105832742078,44.26,IS,0.41,0.0,Phase3-EA-SA2v2-EURCHF-M5-43,EURCHFMT4,5868,4h 59m,Sell
133037.87,119566,15.04.2015 10:30:00,,-1.02,-89.6699999999837,0.0,0.0,119349,14.04.2015 22:45:00,11575,-0.040187777806353756,-50.02,IS,0.27,0.0,Phase3-EA-S1v2-USDJPY-M15-0,USDJPYMT4,3291,11h 45m,Sell
133005.17,126954,15.04.2015 11:29:58,sl 126.954,0.0,-122.36999999999534,0.0,0.0,127184,15.04.2015 07:45:00,11576,-0.05484307315896304,-32.7,IS,0.17,0.0,Phase3-EA-T1v2-EURJPY-M15-322,EURJPYMT4,2136,3h 44m,Buy
132869.07,1.03137,15.04.2015 12:44:57,sl 1.03137,0.0,-258.47000000000116,0.0,0.0,1.03527,15.04.2015 04:30:00,11577,-0.11583957766934527,-136.1,IS,0.34,0.0,Phase3-EA-S4v1-EURCHF-M15-221,EURCHFMT4,3056,8h 14m,Buy
132827.07,1.47567,15.04.2015 15:29:57,sl 1.47567,0.0,-300.47000000000116,0.0,0.0,1.47267,15.04.2015 11:30:00,11578,-0.1346628928011303,-42.0,IS,0.14,0.0,Phase3-EA-B1v1-GBPUSD-M30-14,GBPUSDMT4,768,3h 59m,Sell
132794.28,127107,15.04.2015 17:44:58,sl 127.107,0.0,-333.2600000000093,0.0,0.0,126877,15.04.2015 11:45:00,11579,-0.14935852382902043,-32.79,IS,0.17,0.0,Phase3-EA-T1v2-EURJPY-M15-322,EURJPYMT4,2138,5h 59m,Sell
132840.77,1.03172,15.04.2015 21:09:58,tp 1.03172,0.0,-286.7700000000186,0.0,0.0,1.03062,15.04.2015 20:15:00,11580,-0.12852290667481778,46.49,IS,0.41,0.0,Phase3-EA-SA2v2-EURCHF-M5-43,EURCHFMT4,5870,54m 58s,Buy
132884.59,1.0319,16.04.2015 04:14:58,tp 1.03190,-3.06,-242.95000000001164,0.0,0.0,1.0308,15.04.2015 22:10:00,11581,-0.10888391455398559,43.82,IS,0.41,0.0,Phase3-EA-SA2v2-EURCHF-M5-43,EURCHFMT4,5872,6h 4m,Buy
132933.06,118932,16.04.2015 04:30:00,,-3.06,-194.48000000001048,0.0,0.0,119159,15.04.2015 23:30:00,11582,-0.08716091254356552,48.47,IS,0.27,0.0,Phase3-EA-S1v2-USDJPY-M15-0,USDJPYMT4,3294,5h 0m,Sell
132920.23,176.9,16.04.2015 05:00:00,,-3.36,-207.30999999999767,0.0,0.0,176851,15.04.2015 23:35:00,11583,-0.0929109871421503,-12.83,IS,0.23,0.0,Phase3-EA-S4v1-GBPJPY-M5-194,GBPJPYMT4,2632,5h 25m,Sell
133061.35,1.02776,16.04.2015 11:29:58,tp 1.02776,0.0,-66.19000000000233,0.0,0.0,1.03176,16.04.2015 04:30:00,11584,-0.029664648299354657,141.12,IS,0.34,0.0,Phase3-EA-S4v1-EURCHF-M15-221,EURCHFMT4,3058,6h 59m,Sell
133002.35,127691,16.04.2015 15:29:57,sl 127.691,0.0,-125.19000000000233,0.0,0.0,126911,16.04.2015 12:00:00,11585,-0.0561069243178146,-59.0,IS,0.09,0.0,Phase3-EA-TR1v1-EURJPY-M30-91,EURJPYMT4,2056,3h 29m,Sell
133042.73,119022,16.04.2015 21:45:00,,0.0,-84.80999999999767,0.0,0.0,119.2,16.04.2015 18:15:00,11586,-0.038009651341110604,40.38,IS,0.27,0.0,Phase3-EA-S1v2-USDJPY-M15-0,USDJPYMT4,3296,3h 30m,Sell
133305.73,1.49618,16.04.2015 22:29:57,tp 1.49618,-1.6,-0.0,0.0,0.0,1.47728,15.04.2015 17:00:00,11587,-0.0,263.0,IS,0.14,0.0,Phase3-EA-B1v1-GBPUSD-M30-14,GBPUSDMT4,770,1d 5h 29m,Buy
133444.64,177997,16.04.2015 23:59:58,tp 177.997,-1.09,-0.0,0.0,0.0,176147,14.04.2015 17:00:00,11588,-0.0,138.91,IS,0.09,0.0,Phase3-EA-B1v1-GBPJPY-M30-1,GBPJPYMT4,1092,2d 6h 59m,Buy
133489.68,1.02888,17.04.2015 00:44:58,tp 1.02888,-2.14,-0.0,0.0,0.0,1.02998,16.04.2015 22:00:00,11589,-0.0,45.04,IS,0.41,0.0,Phase3-EA-SA2v2-EURCHF-M5-43,EURCHFMT4,5874,2h 44m,Sell
133550.41,0.95512,17.04.2015 04:14:57,tp 0.95512,0.0,-0.0,0.0,0.0,0.95612,17.04.2015 00:45:00,11590,-0.0,60.73,IS,0.58,0.0,Phase3-EA-SA2v2-USDCHF-M15-107,USDCHFMT4,2264,3h 29m,Sell
133597.63,1.02979,17.04.2015 04:44:58,tp 1.02979,0.0,-0.0,0.0,0.0,1.02869,17.04.2015 00:55:00,11591,-0.0,47.22,IS,0.41,0.0,Phase3-EA-SA2v2-EURCHF-M5-43,EURCHFMT4,5876,3h 49m,Buy
133632.52,127866,17.04.2015 11:00:00,,-0.7,-0.0,0.0,0.0,127617,16.04.2015 15:15:00,11592,-0.0,34.89,IS,0.17,0.0,Phase3-EA-T1v2-EURJPY-M15-322,EURJPYMT4,2140,19h 45m,Buy
133693.1,1.03039,17.04.2015 11:45:00,,0.0,-0.0,0.0,0.0,1.02869,17.04.2015 03:00:00,11593,-0.0,60.58,IS,0.34,0.0,Phase3-EA-S4v1-EURCHF-M15-221,EURCHFMT4,3060,8h 45m,Buy
133660.31,128036,17.04.2015 17:29:58,sl 128.036,0.0,-32.79000000000815,0.0,0.0,128266,17.04.2015 12:30:00,11594,-0.014658476278440382,-32.79,IS,0.17,0.0,Phase3-EA-T1v2-EURJPY-M15-322,EURJPYMT4,2142,4h 59m,Buy
133705.6,1.02756,20.04.2015 01:54:57,tp 1.02756,-2.16,-0.0,0.0,0.0,1.02866,17.04.2015 21:50:00,11595,-0.0,45.29,IS,0.41,0.0,Phase3-EA-SA2v2-EURCHF-M5-43,EURCHFMT4,5878,2d 4h 4m,Sell
133766.54,0.95169,20.04.2015 02:14:59,tp 0.95169,0.0,-0.0,0.0,0.0,0.95069,20.04.2015 01:30:00,11596,-0.0,60.94,IS,0.58,0.0,Phase3-EA-SA2v2-USDCHF-M15-107,USDCHFMT4,2266,44m 59s,Buy
133767.7,118953,20.04.2015 03:15:00,,-0.66,-0.0,0.0,0.0,118945,17.04.2015 21:00:00,11597,-0.0,1.16,IS,0.27,0.0,Phase3-EA-S1v2-USDJPY-M15-0,USDJPYMT4,3298,2d 6h 15m,Buy
133734.1,128333,20.04.2015 04:14:57,sl 128.333,-0.7,-33.60000000000582,0.0,0.0,128563,17.04.2015 23:45:00,11598,-0.015015571952522901,-33.6,IS,0.17,0.0,Phase3-EA-T1v2-EURJPY-M15-322,EURJPYMT4,2144,2d 4h 29m,Buy
133781.49,1.02888,20.04.2015 05:04:57,tp 1.02888,0.0,-0.0,0.0,0.0,1.02778,20.04.2015 01:55:00,11599,-0.0,47.39,IS,0.41,0.0,Phase3-EA-SA2v2-EURCHF-M5-43,EURCHFMT4,5880,3h 9m,Buy
133748.27,178085,20.04.2015 05:05:00,,-1.12,-33.220000000001164,0.0,0.0,177919,17.04.2015 23:40:00,11600,-0.014844838149929616,-33.22,IS,0.23,0.0,Phase3-EA-S4v1-GBPJPY-M5-194,GBPJPYMT4,2634,2d 5h 25m,Sell
133795.55,1.02635,20.04.2015 20:39:58,tp 1.02635,0.0,-0.0,0.0,0.0,1.02745,20.04.2015 20:15:00,11601,-0.0,47.28,IS,0.41,0.0,Phase3-EA-SA2v2-EURCHF-M5-43,EURCHFMT4,5882,24m 58s,Sell
133842.71,1.02642,20.04.2015 22:04:57,tp 1.02642,0.0,-0.0,0.0,0.0,1.02532,20.04.2015 21:40:00,11602,-0.0,47.16,IS,0.41,0.0,Phase3-EA-SA2v2-EURCHF-M5-43,EURCHFMT4,5884,24m 57s,Buy
133872.26,0.95562,21.04.2015 02:30:00,,-3.22,-0.0,0.0,0.0,0.95616,20.04.2015 22:15:00,11603,-0.0,29.55,IS,0.58,0.0,Phase3-EA-SA2v2-USDCHF-M15-107,USDCHFMT4,2268,4h 15m,Sell
133875.45,119315,21.04.2015 04:15:00,,-0.66,-0.0,0.0,0.0,119298,20.04.2015 23:00:00,11604,-0.0,3.19,IS,0.27,0.0,Phase3-EA-S1v2-USDJPY-M15-0,USDJPYMT4,3300,5h 15m,Buy
133886.59,1.02652,21.04.2015 08:55:00,,0.0,-0.0,0.0,0.0,1.02678,21.04.2015 00:35:00,11605,-0.0,11.14,IS,0.41,0.0,Phase3-EA-SA2v2-EURCHF-M5-43,EURCHFMT4,5886,8h 20m,Sell
133853.85,127857,21.04.2015 10:14:58,sl 127.857,0.0,-32.73999999999069,0.0,0.0,128087,21.04.2015 07:45:00,11606,-0.014623475215728847,-32.74,IS,0.17,0.0,Phase3-EA-T1v2-EURJPY-M15-322,EURJPYMT4,2146,2h 29m,Buy
133821.19,128115,21.04.2015 18:29:58,sl 128.115,0.0,-65.39999999999418,0.0,0.0,127885,21.04.2015 10:15:00,11607,-0.029211218054638163,-32.66,IS,0.17,0.0,Phase3-EA-T1v2-EURJPY-M15-322,EURJPYMT4,2148,8h 14m,Sell
133867.39,1.02587,22.04.2015 01:49:58,tp 1.02587,-1.03,-19.199999999982538,0.0,0.0,1.02477,21.04.2015 20:20:00,11608,-0.008575770438051874,46.2,IS,0.41,0.0,Phase3-EA-SA2v2-EURCHF-M5-43,EURCHFMT4,5888,5h 29m,Buy
133808.92,0.95534,22.04.2015 02:30:00,,-3.22,-77.6699999999837,0.0,0.0,0.95443,21.04.2015 22:15:00,11609,-0.034691671350205996,-58.47,IS,0.58,0.0,Phase3-EA-SA2v2-USDCHF-M15-107,USDCHFMT4,2270,4h 15m,Sell
133792.86,1.02587,22.04.2015 11:00:00,,0.0,-93.72999999998137,0.0,0.0,1.02542,22.04.2015 02:15:00,11610,-0.04186494599787362,-16.06,IS,0.34,0.0,Phase3-EA-S4v1-EURCHF-M15-221,EURCHFMT4,3062,8h 45m,Sell
133733.36,128885,22.04.2015 12:59:58,sl 128.885,-0.79,-153.22999999998137,0.0,0.0,128105,17.04.2015 02:30:00,11611,-0.0684409012616523,-59.5,IS,0.09,0.0,Phase3-EA-TR1v1-EURJPY-M30-91,EURJPYMT4,2058,5d 10h 29m,Sell
133700.65,128375,22.04.2015 16:29:58,sl 128.375,0.0,-185.93999999997322,0.0,0.0,128605,22.04.2015 10:45:00,11612,-0.0830509768360722,-32.71,IS,0.17,0.0,Phase3-EA-T1v2-EURJPY-M15-322,EURJPYMT4,2150,5h 44m,Buy
133722.94,119924,22.04.2015 23:45:00,,0.0,-163.64999999996508,0.0,0.0,119825,22.04.2015 22:30:00,11613,-0.07309504334313364,22.29,IS,0.27,0.0,Phase3-EA-S1v2-USDJPY-M15-0,USDJPYMT4,3302,1h 15m,Buy
133605.76,0.96964,23.04.2015 02:30:00,,-9.51,-280.8299999999581,0.0,0.0,0.96784,22.04.2015 22:15:00,11614,-0.12543404229791347,-117.18,IS,0.58,0.0,Phase3-EA-SA2v2-USDCHF-M15-107,USDCHFMT4,2272,4h 15m,Sell
133571.11,128472,23.04.2015 05:14:58,sl 128.472,-2.08,-315.47999999995227,0.0,0.0,128702,22.04.2015 21:45:00,11615,-0.1409106280103467,-34.65,IS,0.17,0.0,Phase3-EA-T1v2-EURJPY-M15-322,EURJPYMT4,2152,7h 29m,Buy
133558.44,1.03864,23.04.2015 05:50:00,,-6.34,-328.1499999999651,0.0,0.0,1.03849,22.04.2015 21:30:00,11616,-0.14656974319005117,-12.67,IS,0.41,0.0,Phase3-EA-SA2v2-EURCHF-M5-43,EURCHFMT4,5890,8h 20m,Sell
133651.72,1.03812,23.04.2015 10:00:00,,0.0,-234.86999999996624,0.0,0.0,1.04078,23.04.2015 01:15:00,11617,-0.10490579181181177,93.28,IS,0.34,0.0,Phase3-EA-S4v1-EURCHF-M15-221,EURCHFMT4,3064,8h 45m,Sell
133698.98,1.03304,23.04.2015 22:04:58,tp 1.03304,0.0,-187.60999999995693,0.0,0.0,1.03414,23.04.2015 21:45:00,11618,-0.08379689020229197,47.26,IS,0.41,0.0,Phase3-EA-SA2v2-EURCHF-M5-43,EURCHFMT4,5892,19m 58s,Sell
133723.84,119.47,24.04.2015 04:45:00,,0.0,-162.7499999999709,0.0,0.0,119.58,24.04.2015 01:00:00,11619,-0.0726930541038522,24.86,IS,0.27,0.0,Phase3-EA-S1v2-USDJPY-M15-0,USDJPYMT4,3304,3h 45m,Sell
133703.69,1.03258,24.04.2015 08:30:00,,0.0,-182.89999999996508,0.0,0.0,1.03305,24.04.2015 00:10:00,11620,-0.0816931465167091,-20.15,IS,0.41,0.0,Phase3-EA-SA2v2-EURCHF-M5-43,EURCHFMT4,5894,8h 20m,Buy
133796.93,129834,24.04.2015 11:29:58,tp 129.834,-1.84,-89.65999999997439,0.0,0.0,128574,21.04.2015 20:30:00,11621,-0.04004706132688597,93.24,IS,0.09,0.0,Phase3-EA-TR1v1-EURJPY-M30-91,EURJPYMT4,2059,2d 14h 59m,Buy
133814.2,118801,27.04.2015 04:15:00,,0.0,-72.38999999998487,0.0,0.0,118877,27.04.2015 01:00:00,11622,-0.0323333344797401,17.27,IS,0.27,0.0,Phase3-EA-S1v2-USDJPY-M15-0,USDJPYMT4,3306,3h 15m,Sell
133812.05,1.0366,27.04.2015 04:40:00,,-2.15,-74.53999999997905,0.0,0.0,1.0366,24.04.2015 20:20:00,11623,-0.03329364210691606,-2.15,IS,0.41,0.0,Phase3-EA-SA2v2-EURCHF-M5-43,EURCHFMT4,5896,2d 8h 20m,Sell
133779.18,129379,27.04.2015 09:59:58,sl 129.379,0.0,-107.40999999997439,0.0,0.0,129149,27.04.2015 07:00:00,11624,-0.047975182434988016,-32.87,IS,0.17,0.0,Phase3-EA-T1v2-EURJPY-M15-322,EURJPYMT4,2154,2h 59m,Sell
134043.25,1.52604,27.04.2015 20:29:58,tp 1.52604,-0.53,-0.0,0.0,0.0,1.50714,24.04.2015 10:30:00,11625,-0.0,264.07,IS,0.14,0.0,Phase3-EA-B1v1-GBPUSD-M30-14,GBPUSDMT4,772,3d 9h 59m,Buy
134069.24,129547,28.04.2015 02:45:00,,-0.7,-0.0,0.0,0.0,129.36,27.04.2015 15:30:00,11626,-0.0,25.99,IS,0.17,0.0,Phase3-EA-T1v2-EURJPY-M15-322,EURJPYMT4,2156,11h 15m,Buy
134075.7,119069,28.04.2015 05:30:00,,-1.02,-0.0,0.0,0.0,119102,27.04.2015 23:30:00,11627,-0.0,6.46,IS,0.27,0.0,Phase3-EA-S1v2-USDJPY-M15-0,USDJPYMT4,3308,6h 0m,Sell
134105.34,1.03863,28.04.2015 06:05:00,,-2.14,-0.0,0.0,0.0,1.03937,27.04.2015 21:45:00,11628,-0.0,29.64,IS,0.41,0.0,Phase3-EA-SA2v2-EURCHF-M5-43,EURCHFMT4,5898,8h 20m,Sell
134072.5,129.37,28.04.2015 11:14:57,sl 129.370,0.0,-32.83999999999651,0.0,0.0,129.6,28.04.2015 10:15:00,11629,-0.014653823063741484,-32.84,IS,0.17,0.0,Phase3-EA-T1v2-EURJPY-M15-322,EURJPYMT4,2158,59m 57s,Buy
134030.5,1.5211,28.04.2015 12:59:57,sl 1.52110,0.0,-74.83999999999651,0.0,0.0,1.5241,28.04.2015 10:30:00,11630,-0.03339500968606816,-42.0,IS,0.14,0.0,Phase3-EA-B1v1-GBPUSD-M30-14,GBPUSDMT4,774,2h 29m,Buy
134152.84,1.0425,28.04.2015 13:00:00,,0.0,-0.0,0.0,0.0,1.03906,28.04.2015 04:15:00,11631,-0.0,122.34,IS,0.34,0.0,Phase3-EA-S4v1-EURCHF-M15-221,EURCHFMT4,3066,8h 45m,Buy
134155.91,118873,29.04.2015 02:15:00,,-1.02,-0.0,0.0,0.0,118891,28.04.2015 23:45:00,11632,-0.0,3.07,IS,0.27,0.0,Phase3-EA-S1v2-USDJPY-M15-0,USDJPYMT4,3310,2h 30m,Sell
134114.29,1.04838,29.04.2015 06:05:00,,-2.14,-41.61999999999534,0.0,0.0,1.04746,28.04.2015 21:45:00,11633,-0.01856743371164965,-41.62,IS,0.41,0.0,Phase3-EA-SA2v2-EURCHF-M5-43,EURCHFMT4,5900,8h 20m,Sell
134124.25,1.04884,29.04.2015 10:00:00,,0.0,-31.660000000003492,0.0,0.0,1.04912,29.04.2015 01:15:00,11634,-0.01412409782102255,9.96,IS,0.34,0.0,Phase3-EA-S4v1-EURCHF-M15-221,EURCHFMT4,3068,8h 45m,Sell
134218.92,131328,29.04.2015 14:29:57,tp 131.328,-0.37,-0.0,0.0,0.0,130068,28.04.2015 17:00:00,11635,-0.0,94.67,IS,0.09,0.0,Phase3-EA-TR1v1-EURJPY-M30-91,EURJPYMT4,2062,21h 29m,Buy
134314.19,132483,29.04.2015 18:29:58,tp 132.483,0.0,-0.0,0.0,0.0,131223,29.04.2015 14:30:00,11636,-0.0,95.27,IS,0.09,0.0,Phase3-EA-TR1v1-EURJPY-M30-91,EURJPYMT4,2064,3h 59m,Buy
134557.53,132239,29.04.2015 18:29:58,tp 132.239,0.0,-0.0,0.0,0.0,130539,29.04.2015 11:00:00,11637,-0.0,243.34,IS,0.17,0.0,Phase3-EA-T1v2-EURJPY-M15-322,EURJPYMT4,2160,7h 29m,Buy
134605.71,1.04652,29.04.2015 20:29:58,tp 1.04652,0.0,-0.0,0.0,0.0,1.04542,29.04.2015 20:20:00,11638,-0.0,48.18,IS,0.41,0.0,Phase3-EA-SA2v2-EURCHF-M5-43,EURCHFMT4,5902,9m 58s,Buy
134585.83,119.12,30.04.2015 01:45:00,,-1.97,-19.880000000004657,0.0,0.0,119199,29.04.2015 17:00:00,11639,-0.008851066163903187,-19.88,IS,0.27,0.0,Phase3-EA-S1v2-USDJPY-M15-0,USDJPYMT4,3312,8h 45m,Buy
134633.81,1.04436,30.04.2015 04:54:59,tp 1.04436,0.0,-0.0,0.0,0.0,1.04546,30.04.2015 01:55:00,11640,-0.0,47.98,IS,0.41,0.0,Phase3-EA-SA2v2-EURCHF-M5-43,EURCHFMT4,5904,2h 59m,Sell
134578.1,131726,30.04.2015 08:59:57,sl 131.726,-1.11,-55.70999999999185,0.0,0.0,132446,29.04.2015 18:30:00,11641,-0.0248003628661204,-55.71,IS,0.09,0.0,Phase3-EA-TR1v1-EURJPY-M30-91,EURJPYMT4,2066,14h 29m,Buy
134819.81,134.47,30.04.2015 22:59:58,tp 134.470,0.0,-0.0,0.0,0.0,132.77,30.04.2015 11:45:00,11642,-0.0,241.71,IS,0.17,0.0,Phase3-EA-T1v2-EURJPY-M15-322,EURJPYMT4,2162,11h 14m,Buy
134868.25,1.04912,30.04.2015 23:04:57,tp 1.04912,0.0,-0.0,0.0,0.0,1.04802,30.04.2015 22:25:00,11643,-0.0,48.44,IS,0.41,0.0,Phase3-EA-SA2v2-EURCHF-M5-43,EURCHFMT4,5906,39m 57s,Buy
134870.98,119561,01.05.2015 04:15:00,,-0.66,-0.0,0.0,0.0,119546,30.04.2015 22:45:00,11644,-0.0,2.73,IS,0.27,0.0,Phase3-EA-S1v2-USDJPY-M15-0,USDJPYMT4,3314,5h 30m,Buy
134876.44,1.04674,01.05.2015 10:15:00,,0.0,-0.0,0.0,0.0,1.04659,01.05.2015 01:30:00,11645,-0.0,5.46,IS,0.34,0.0,Phase3-EA-S4v1-EURCHF-M15-221,EURCHFMT4,3070,8h 45m,Buy
134817.82,134777,01.05.2015 11:29:58,sl 134.777,0.0,-58.61999999999534,0.0,0.0,133997,01.05.2015 02:30:00,11646,-0.02606764852734014,-58.62,IS,0.09,0.0,Phase3-EA-TR1v1-EURJPY-M30-91,EURJPYMT4,2068,8h 59m,Sell
134955.65,184147,01.05.2015 11:59:58,tp 184.147,-1.09,-0.0,0.0,0.0,182297,29.04.2015 01:00:00,11647,-0.0,137.83,IS,0.09,0.0,Phase3-EA-B1v1-GBPJPY-M30-1,GBPJPYMT4,1094,2d 10h 59m,Buy
134963.99,1045,04.05.2015 09:30:00,,0.0,-0.0,0.0,0.0,1.04481,04.05.2015 01:10:00,11648,-0.0,8.34,IS,0.41,0.0,Phase3-EA-SA2v2-EURCHF-M5-43,EURCHFMT4,5908,8h 20m,Buy
134990.95,1.04545,04.05.2015 10:00:00,,0.0,-0.0,0.0,0.0,1.04471,04.05.2015 01:15:00,11649,-0.0,26.96,IS,0.34,0.0,Phase3-EA-S4v1-EURCHF-M15-221,EURCHFMT4,3072,8h 45m,Buy
134983.78,120.18,04.05.2015 11:15:00,,-0.65,-7.170000000012806,0.0,0.0,120209,01.05.2015 23:30:00,11650,-0.003186794846642834,-7.17,IS,0.27,0.0,Phase3-EA-S1v2-USDJPY-M15-0,USDJPYMT4,3316,2d 11h 45m,Buy
135032.04,1.04194,04.05.2015 21:54:57,tp 1.04194,0.0,-0.0,0.0,0.0,1.04304,04.05.2015 21:05:00,11651,-0.0,48.26,IS,0.41,0.0,Phase3-EA-SA2v2-EURCHF-M5-43,EURCHFMT4,5910,49m 57s,Sell
135094.12,0.93427,05.05.2015 02:44:57,tp 0.93427,0.0,-0.0,0.0,0.0,0.93327,05.05.2015 01:15:00,11652,-0.0,62.08,IS,0.58,0.0,Phase3-EA-SA2v2-USDCHF-M15-107,USDCHFMT4,2274,1h 29m,Buy
135091.75,1.04161,05.05.2015 06:20:00,,-1.05,-2.3699999999953434,0.0,0.0,1.04164,04.05.2015 22:00:00,11653,-0.0010528928965338263,-2.37,IS,0.41,0.0,Phase3-EA-SA2v2-EURCHF-M5-43,EURCHFMT4,5912,8h 20m,Buy
135187.94,133399,05.05.2015 10:29:58,tp 133.399,-0.52,-0.0,0.0,0.0,134689,01.05.2015 19:30:00,11654,-0.0,96.19,IS,0.09,0.0,Phase3-EA-TR1v1-EURJPY-M30-91,EURJPYMT4,2070,3d 14h 59m,Sell
135178.14,1.04026,05.05.2015 10:30:00,,0.0,-9.799999999988358,0.0,0.0,1.04053,05.05.2015 01:45:00,11655,-0.004351920444757517,-9.8,IS,0.34,0.0,Phase3-EA-S4v1-EURCHF-M15-221,EURCHFMT4,3074,8h 45m,Buy
135124.31,133903,05.05.2015 14:59:58,sl 133.903,0.0,-63.62999999997555,0.0,0.0,133183,05.05.2015 12:00:00,11656,-0.028256397744912586,-53.83,IS,0.09,0.0,Phase3-EA-TR1v1-EURJPY-M30-91,EURJPYMT4,2072,2h 59m,Sell
135091.34,134065,05.05.2015 15:14:58,sl 134.065,-0.5,-96.59999999997672,0.0,0.0,133835,04.05.2015 22:30:00,11657,-0.042897501526936145,-32.97,IS,0.17,0.0,Phase3-EA-T1v2-EURJPY-M15-322,EURJPYMT4,2164,16h 44m,Sell
135140.06,1.03626,05.05.2015 20:49:57,tp 1.03626,0.0,-47.87999999997555,0.0,0.0,1.03516,05.05.2015 20:00:00,11658,-0.02126223988725827,48.72,IS,0.41,0.0,Phase3-EA-SA2v2-EURCHF-M5-43,EURCHFMT4,5914,49m 57s,Buy
135186.56,1.0359,06.05.2015 01:09:59,tp 1.03590,-2.21,-1.3799999999755528,0.0,0.0,1037,05.05.2015 22:15:00,11659,-6.128214503740933E-4,46.5,IS,0.41,0.0,Phase3-EA-SA2v2-EURCHF-M5-43,EURCHFMT4,5916,2h 54m,Sell
135214.63,181957,06.05.2015 04:55:00,,-0.69,-0.0,0.0,0.0,181807,05.05.2015 23:30:00,11660,-0.0,28.07,IS,0.23,0.0,Phase3-EA-S4v1-GBPJPY-M5-194,GBPJPYMT4,2636,5h 25m,Buy
135263.3,1.03755,06.05.2015 06:44:59,tp 1.03755,0.0,-0.0,0.0,0.0,1.03645,06.05.2015 01:15:00,11661,-0.0,48.67,IS,0.41,0.0,Phase3-EA-SA2v2-EURCHF-M5-43,EURCHFMT4,5918,5h 29m,Buy
135243.49,119914,06.05.2015 09:00:00,,0.0,-19.80999999999767,0.0,0.0,119826,06.05.2015 01:00:00,11662,-0.008794153330790026,-19.81,IS,0.27,0.0,Phase3-EA-S1v2-USDJPY-M15-0,USDJPYMT4,3318,8h 0m,Sell
135320.23,119266,06.05.2015 22:45:00,,0.0,-0.0,0.0,0.0,119605,06.05.2015 20:45:00,11663,-0.0,76.74,IS,0.27,0.0,Phase3-EA-S1v2-USDJPY-M15-0,USDJPYMT4,3320,2h 0m,Sell
135383.61,0.91506,06.05.2015 22:59:58,tp 0.91506,0.0,-0.0,0.0,0.0,0.91406,06.05.2015 22:45:00,11664,-0.0,63.38,IS,0.58,0.0,Phase3-EA-SA2v2-USDCHF-M15-107,USDCHFMT4,2276,14m 58s,Buy
135469.07,135418,07.05.2015 04:30:00,,-2.09,-0.0,0.0,0.0,134803,06.05.2015 16:30:00,11665,-0.0,85.46,IS,0.17,0.0,Phase3-EA-T1v2-EURJPY-M15-322,EURJPYMT4,2166,12h 0m,Buy
135486.06,1.03853,07.05.2015 05:15:00,,-6.71,-0.0,0.0,0.0,1.03906,06.05.2015 20:55:00,11666,-0.0,16.99,IS,0.41,0.0,Phase3-EA-SA2v2-EURCHF-M5-43,EURCHFMT4,5920,8h 20m,Sell
135507.81,182106,07.05.2015 08:55:00,,0.0,-0.0,0.0,0.0,181993,07.05.2015 03:30:00,11667,-0.0,21.75,IS,0.23,0.0,Phase3-EA-S4v1-GBPJPY-M5-194,GBPJPYMT4,2638,5h 25m,Buy
135475.07,135339,07.05.2015 12:29:58,sl 135.339,0.0,-32.73999999999069,0.0,0.0,135569,07.05.2015 07:00:00,11668,-0.014518344176190818,-32.74,IS,0.17,0.0,Phase3-EA-T1v2-EURJPY-M15-322,EURJPYMT4,2168,5h 29m,Buy
135568.93,135887,07.05.2015 13:29:58,tp 135.887,-1.11,-0.0,0.0,0.0,134627,06.05.2015 08:30:00,11669,-0.0,93.86,IS,0.09,0.0,Phase3-EA-TR1v1-EURJPY-M30-91,EURJPYMT4,2074,1d 4h 59m,Buy
135643.87,183858,08.05.2015 01:14:58,tp 183.858,0.0,-0.0,0.0,0.0,184248,08.05.2015 01:10:00,11670,-0.0,74.94,IS,0.23,0.0,Phase3-EA-S4v1-GBPJPY-M5-194,GBPJPYMT4,2640,4m 58s,Sell
135554.88,119.68,08.05.2015 01:15:00,,-1.01,-88.98999999999069,0.0,0.0,119.29,07.05.2015 17:15:00,11671,-0.03943825285392865,-88.99,IS,0.27,0.0,Phase3-EA-S1v2-USDJPY-M15-0,USDJPYMT4,3322,8h 0m,Sell
135601.55,1.03651,08.05.2015 01:44:58,tp 1.03651,-2.22,-42.31999999997788,0.0,0.0,1.03761,07.05.2015 20:00:00,11672,-0.01875521812313252,46.67,IS,0.41,0.0,Phase3-EA-SA2v2-EURCHF-M5-43,EURCHFMT4,5922,5h 44m,Sell
135568.9,134835,08.05.2015 04:44:58,sl 134.835,0.0,-74.96999999997206,0.0,0.0,134605,08.05.2015 01:45:00,11673,-0.033224922086282034,-32.65,IS,0.17,0.0,Phase3-EA-T1v2-EURJPY-M15-322,EURJPYMT4,2170,2h 59m,Sell
135597.52,119807,08.05.2015 04:45:00,,0.0,-46.34999999997672,0.0,0.0,119.68,08.05.2015 01:15:00,11674,-0.020541218336654298,28.62,IS,0.27,0.0,Phase3-EA-S1v2-USDJPY-M15-0,USDJPYMT4,3324,3h 30m,Buy
135573.23,1036,08.05.2015 11:45:00,,0.0,-70.63999999998487,0.0,0.0,1.03666,08.05.2015 03:00:00,11675,-0.03130596900327244,-24.29,IS,0.34,0.0,Phase3-EA-S4v1-EURCHF-M15-221,EURCHFMT4,3076,8h 45m,Buy
135540.59,134536,08.05.2015 19:29:58,sl 134.536,0.0,-103.27999999999884,0.0,0.0,134306,08.05.2015 18:15:00,11676,-0.0457712412041143,-32.64,IS,0.17,0.0,Phase3-EA-T1v2-EURJPY-M15-322,EURJPYMT4,2172,1h 14m,Sell
135565.97,119692,11.05.2015 01:15:00,,-1.01,-77.89999999999418,0.0,0.0,119809,08.05.2015 22:30:00,11677,-0.03452342844500656,25.38,IS,0.27,0.0,Phase3-EA-S1v2-USDJPY-M15-0,USDJPYMT4,3326,2d 2h 45m,Sell
135537.76,0.93151,11.05.2015 02:45:00,,-3.3,-106.10999999998603,0.0,0.0,0.93111,08.05.2015 22:30:00,11678,-0.04702542993965902,-28.21,IS,0.58,0.0,Phase3-EA-SA2v2-USDCHF-M15-107,USDCHFMT4,2278,2d 4h 15m,Sell
135583.96,1.04146,11.05.2015 04:54:58,tp 1.04146,-2.2,-59.90999999997439,0.0,0.0,1.04256,08.05.2015 20:35:00,11679,-0.02655068803773573,46.2,IS,0.41,0.0,Phase3-EA-SA2v2-EURCHF-M5-43,EURCHFMT4,5924,2d 8h 19m,Sell
135524.98,134014,11.05.2015 04:59:58,sl 134.014,-0.37,-118.88999999998487,0.0,0.0,134794,08.05.2015 12:30:00,11680,-0.05268922218005923,-58.98,IS,0.09,0.0,Phase3-EA-TR1v1-EURJPY-M30-91,EURJPYMT4,2076,2d 16h 29m,Buy
135437.02,1.03958,11.05.2015 14:15:00,,0.0,-206.84999999997672,0.0,0.0,1.04199,11.05.2015 05:30:00,11681,-0.09167100351539585,-87.96,IS,0.34,0.0,Phase3-EA-S4v1-EURCHF-M15-221,EURCHFMT4,3078,8h 45m,Buy
135404.4,133929,11.05.2015 17:44:58,sl 133.929,0.0,-239.46999999997206,0.0,0.0,133699,11.05.2015 15:00:00,11682,-0.10612741219159659,-32.62,IS,0.17,0.0,Phase3-EA-T1v2-EURJPY-M15-322,EURJPYMT4,2174,2h 44m,Sell
135377.57,0.93396,12.05.2015 02:45:00,,-0.75,-266.29999999995925,0.0,0.0,0.93438,11.05.2015 22:30:00,11683,-0.1180178304865793,-26.83,IS,0.58,0.0,Phase3-EA-SA2v2-USDCHF-M15-107,USDCHFMT4,2280,4h 15m,Buy
135439.07,186981,12.05.2015 04:55:00,,-1.11,-204.79999999995925,0.0,0.0,187308,11.05.2015 23:30:00,11684,-0.09076249224051945,61.5,IS,0.23,0.0,Phase3-EA-S4v1-GBPJPY-M5-194,GBPJPYMT4,2642,5h 25m,Sell
135445.21,1.04189,12.05.2015 05:10:00,,-2.19,-198.65999999994528,0.0,0.0,1.04208,11.05.2015 20:50:00,11685,-0.08804139017822371,6.14,IS,0.41,0.0,Phase3-EA-SA2v2-EURCHF-M5-43,EURCHFMT4,5926,8h 20m,Sell
135491.54,1.04117,13.05.2015 01:09:58,tp 1.04117,-2.21,-152.3299999999581,0.0,0.0,1.04227,12.05.2015 20:20:00,11686,-0.06750903536619764,46.33,IS,0.41,0.0,Phase3-EA-SA2v2-EURCHF-M5-43,EURCHFMT4,5928,4h 49m,Sell
135520.39,119784,13.05.2015 01:15:00,,0.0,-123.47999999995227,0.0,0.0,119912,13.05.2015 00:30:00,11687,-0.0547234010832873,28.85,IS,0.27,0.0,Phase3-EA-S1v2-USDJPY-M15-0,USDJPYMT4,3328,45m 0s,Sell
135466.03,134.32,13.05.2015 01:29:58,sl 134.320,-0.37,-177.8399999999383,0.0,0.0,134141,11.05.2015 11:00:00,11688,-0.07881446103540815,-54.36,IS,0.09,0.0,Phase3-EA-TR1v1-EURJPY-M30-91,EURJPYMT4,2078,1d 14h 29m,Buy
135507.84,1.04109,13.05.2015 13:30:00,,0.0,-136.02999999994063,0.0,0.0,1.04223,13.05.2015 04:45:00,11689,-0.06028526279040492,41.81,IS,0.34,0.0,Phase3-EA-S4v1-EURCHF-M15-221,EURCHFMT4,3080,8h 45m,Sell
135543.05,134414,13.05.2015 14:15:00,,-0.7,-100.81999999994878,0.0,0.0,134161,12.05.2015 06:45:00,11690,-0.04468102767424972,35.21,IS,0.17,0.0,Phase3-EA-T1v2-EURJPY-M15-322,EURJPYMT4,2176,1d 7h 30m,Buy
135639.76,135431,13.05.2015 19:59:58,tp 135.431,-0.74,-4.109999999956926,0.0,0.0,135.04,12.05.2015 12:30:00,11691,-0.0018214543120346665,96.71,IS,0.09,0.0,Phase3-EA-TR1v1-EURJPY-M30-91,EURJPYMT4,2079,1d 7h 29m,Buy
135688.42,135288,14.05.2015 03:30:00,,-2.1,-0.0,0.0,0.0,134932,13.05.2015 17:15:00,11692,-0.0,48.66,IS,0.17,0.0,Phase3-EA-T1v2-EURJPY-M15-322,EURJPYMT4,2178,10h 15m,Buy
135640.48,1.04059,14.05.2015 07:05:00,,-3.22,-47.94000000000233,0.0,0.0,1.04159,13.05.2015 22:45:00,11693,-0.021241674694697222,-47.94,IS,0.41,0.0,Phase3-EA-SA2v2-EURCHF-M5-43,EURCHFMT4,5930,8h 20m,Buy
135635.83,119143,14.05.2015 08:00:00,,-3.06,-52.58999999999651,0.0,0.0,119136,13.05.2015 23:30:00,11694,-0.0233020373841051,-4.65,IS,0.27,0.0,Phase3-EA-S1v2-USDJPY-M15-0,USDJPYMT4,3330,8h 30m,Sell
135581.48,135421,14.05.2015 19:29:58,sl 135.421,0.0,-106.94000000000233,0.0,0.0,136141,14.05.2015 15:30:00,11695,-0.04738391096893742,-54.35,IS,0.09,0.0,Phase3-EA-TR1v1-EURJPY-M30-91,EURJPYMT4,2082,3h 59m,Buy
135592.8,119229,15.05.2015 03:45:00,,0.0,-95.61999999999534,0.0,0.0,119179,15.05.2015 00:15:00,11696,-0.04236814631428349,11.32,IS,0.27,0.0,Phase3-EA-S1v2-USDJPY-M15-0,USDJPYMT4,3332,3h 30m,Buy
135548.78,1.04132,15.05.2015 06:55:00,,-2.25,-139.63999999998487,0.0,0.0,1.04039,14.05.2015 22:35:00,11697,-0.06187291310736451,-44.02,IS,0.41,0.0,Phase3-EA-SA2v2-EURCHF-M5-43,EURCHFMT4,5932,8h 20m,Sell
135498.8,1.04246,15.05.2015 13:30:00,,0.0,-189.61999999999534,0.0,0.0,1.04111,15.05.2015 04:45:00,11698,-0.08401848885290347,-49.98,IS,0.34,0.0,Phase3-EA-S4v1-EURCHF-M15-221,EURCHFMT4,3082,8h 45m,Sell
135466.17,135923,15.05.2015 15:59:58,sl 135.923,0.0,-222.25,0.0,0.0,136153,15.05.2015 15:30:00,11699,-0.09847647477881159,-32.63,IS,0.17,0.0,Phase3-EA-T1v2-EURJPY-M15-322,EURJPYMT4,2180,29m 58s,Buy
135424.17,1.57683,15.05.2015 20:29:58,sl 1.57683,0.0,-264.25,0.0,0.0,1.57983,15.05.2015 18:30:00,11700,-0.11708620229606734,-42.0,IS,0.14,0.0,Phase3-EA-B1v1-GBPUSD-M30-14,GBPUSDMT4,776,1h 59m,Buy
135473.43,1.04786,15.05.2015 22:44:59,tp 1.04786,0.0,-214.9899999999907,0.0,0.0,1.04896,15.05.2015 21:40:00,11701,-0.0952596504508247,49.26,IS,0.41,0.0,Phase3-EA-SA2v2-EURCHF-M5-43,EURCHFMT4,5934,1h 4m,Sell
135536.81,0.91507,15.05.2015 23:44:58,tp 0.91507,0.0,-151.60999999998603,0.0,0.0,0.91407,15.05.2015 23:00:00,11702,-0.0671766854497829,63.38,IS,0.58,0.0,Phase3-EA-SA2v2-USDCHF-M15-107,USDCHFMT4,2282,44m 58s,Buy
135439.26,119269,18.05.2015 01:00:00,,-0.66,-249.1599999999744,0.0,0.0,119697,15.05.2015 17:30:00,11703,-0.11039999305235625,-97.55,IS,0.27,0.0,Phase3-EA-S1v2-USDJPY-M15-0,USDJPYMT4,3334,2d 7h 30m,Buy
135487.32,1.04931,18.05.2015 05:29:58,tp 1.04931,-1.07,-201.09999999997672,0.0,0.0,1.04821,15.05.2015 22:55:00,11704,-0.08910514770761178,48.06,IS,0.41,0.0,Phase3-EA-SA2v2-EURCHF-M5-43,EURCHFMT4,5936,2d 6h 34m,Buy
135535.84,1.04869,18.05.2015 10:45:00,,0.0,-152.5799999999872,0.0,0.0,1.04738,18.05.2015 02:00:00,11705,-0.06760648153768195,48.52,IS,0.34,0.0,Phase3-EA-S4v1-EURCHF-M15-221,EURCHFMT4,3084,8h 45m,Buy
135545.36,136402,18.05.2015 12:00:00,,-0.7,-143.05999999999767,0.0,0.0,136.33,15.05.2015 18:45:00,11706,-0.06338827663377529,9.52,IS,0.17,0.0,Phase3-EA-T1v2-EURJPY-M15-322,EURJPYMT4,2182,2d 17h 15m,Buy
135594.16,1.04692,18.05.2015 21:59:58,tp 1.04692,0.0,-94.26000000000931,0.0,0.0,1.04802,18.05.2015 20:05:00,11707,-0.04176554561373093,48.8,IS,0.41,0.0,Phase3-EA-SA2v2-EURCHF-M5-43,EURCHFMT4,5938,1h 54m,Sell
135641.82,1.04777,19.05.2015 00:34:58,tp 1.04777,-1.06,-46.60000000000582,0.0,0.0,1.04667,18.05.2015 22:10:00,11708,-0.020647935769148227,47.66,IS,0.41,0.0,Phase3-EA-SA2v2-EURCHF-M5-43,EURCHFMT4,5940,2h 24m,Buy
135690.46,1.04656,19.05.2015 05:54:58,tp 1.04656,0.0,-0.0,0.0,0.0,1.04766,19.05.2015 00:50:00,11709,-0.0,48.64,IS,0.41,0.0,Phase3-EA-SA2v2-EURCHF-M5-43,EURCHFMT4,5942,5h 4m,Sell
135837.46,1.0442,19.05.2015 11:14:58,tp 1.04420,0.0,-0.0,0.0,0.0,1.0482,19.05.2015 04:30:00,11710,-0.0,147.0,IS,0.34,0.0,Phase3-EA-S4v1-EURCHF-M15-221,EURCHFMT4,3086,6h 44m,Sell
135933.96,135089,19.05.2015 11:29:58,tp 135.089,-0.26,-0.0,0.0,0.0,136379,18.05.2015 11:30:00,11711,-0.0,96.5,IS,0.09,0.0,Phase3-EA-TR1v1-EURJPY-M30-91,EURJPYMT4,2084,23h 59m,Sell
135982.09,1.04431,19.05.2015 21:34:57,tp 1.04431,0.0,-0.0,0.0,0.0,1.04321,19.05.2015 21:15:00,11712,-0.0,48.13,IS,0.41,0.0,Phase3-EA-SA2v2-EURCHF-M5-43,EURCHFMT4,5944,19m 57s,Buy
135988.13,120704,20.05.2015 04:15:00,,0.0,-0.0,0.0,0.0,120677,20.05.2015 01:00:00,11713,-0.0,6.04,IS,0.27,0.0,Phase3-EA-S1v2-USDJPY-M15-0,USDJPYMT4,3336,3h 15m,Buy
136034.03,1.04366,20.05.2015 04:44:58,tp 1.04366,-2.19,-0.0,0.0,0.0,1.04476,19.05.2015 22:10:00,11714,-0.0,45.9,IS,0.41,0.0,Phase3-EA-SA2v2-EURCHF-M5-43,EURCHFMT4,5946,6h 34m,Sell
136001.7,134618,20.05.2015 05:29:57,sl 134.618,0.0,-32.329999999987194,0.0,0.0,134388,20.05.2015 04:15:00,11715,-0.014303156033623326,-32.33,IS,0.17,0.0,Phase3-EA-T1v2-EURJPY-M15-322,EURJPYMT4,2184,1h 14m,Sell
135860.6,1.04027,20.05.2015 10:59:57,sl 1.04027,0.0,-173.42999999999302,0.0,0.0,1.04417,20.05.2015 04:30:00,11716,-0.07672738481015082,-141.1,IS,0.34,0.0,Phase3-EA-S4v1-EURCHF-M15-221,EURCHFMT4,3088,6h 29m,Buy
135828.28,134419,20.05.2015 12:14:58,sl 134.419,0.0,-205.75,0.0,0.0,134189,20.05.2015 10:15:00,11717,-0.09102611673118356,-32.32,IS,0.17,0.0,Phase3-EA-T1v2-EURJPY-M15-322,EURJPYMT4,2186,1h 59m,Sell
135858.61,121306,21.05.2015 01:00:00,,-1.94,-175.4200000000128,0.0,0.0,121161,20.05.2015 23:00:00,11718,-0.07760778321742594,30.33,IS,0.27,0.0,Phase3-EA-S1v2-USDJPY-M15-0,USDJPYMT4,3338,2h 0m,Buy
135807.24,1.03927,21.05.2015 04:40:00,,-3.15,-226.79000000000815,0.0,0.0,1.04037,20.05.2015 20:20:00,11719,-0.10033444964017431,-51.37,IS,0.41,0.0,Phase3-EA-SA2v2-EURCHF-M5-43,EURCHFMT4,5948,8h 20m,Buy
135774.94,134391,21.05.2015 10:14:57,sl 134.391,0.0,-259.0899999999965,0.0,0.0,134621,21.05.2015 04:45:00,11720,-0.11462433333600015,-32.3,IS,0.17,0.0,Phase3-EA-T1v2-EURJPY-M15-322,EURJPYMT4,2188,5h 29m,Buy
135742.67,134614,21.05.2015 17:29:58,sl 134.614,0.0,-291.35999999998603,0.0,0.0,134844,21.05.2015 12:15:00,11721,-0.12890094469402855,-32.27,IS,0.17,0.0,Phase3-EA-T1v2-EURJPY-M15-322,EURJPYMT4,2190,5h 14m,Buy
135752.06,121066,22.05.2015 02:00:00,,-0.65,-281.96999999997206,0.0,0.0,121021,21.05.2015 19:45:00,11722,-0.12474670296325291,9.39,IS,0.27,0.0,Phase3-EA-S1v2-USDJPY-M15-0,USDJPYMT4,3340,6h 15m,Buy
135621.26,0.93693,22.05.2015 03:00:00,,-3.28,-412.7699999999604,0.0,0.0,0.93487,21.05.2015 22:45:00,11723,-0.18261409576246435,-130.8,IS,0.58,0.0,Phase3-EA-SA2v2-USDCHF-M15-107,USDCHFMT4,2284,4h 15m,Sell
135613.93,189458,22.05.2015 04:50:00,,-0.68,-420.0999999999476,0.0,0.0,189493,21.05.2015 23:25:00,11724,-0.18585697029776646,-7.33,IS,0.23,0.0,Phase3-EA-S4v1-GBPJPY-M5-194,GBPJPYMT4,2644,5h 25m,Buy
135577.56,1.04171,22.05.2015 07:25:00,,-2.19,-456.46999999994296,0.0,0.0,1.04093,21.05.2015 23:05:00,11725,-0.2019474678215221,-36.37,IS,0.41,0.0,Phase3-EA-SA2v2-EURCHF-M5-43,EURCHFMT4,5950,8h 20m,Sell
135592.88,1.04096,22.05.2015 13:15:00,,0.0,-441.14999999993597,0.0,0.0,1.04138,22.05.2015 04:30:00,11726,-0.19516972731934776,15.32,IS,0.34,0.0,Phase3-EA-S4v1-EURCHF-M15-221,EURCHFMT4,3090,8h 45m,Sell
135539.54,134475,22.05.2015 17:29:57,sl 134.475,0.0,-494.4899999999325,0.0,0.0,134636,19.05.2015 15:00:00,11727,-0.21876794392416435,-53.34,IS,0.09,0.0,Phase3-EA-TR1v1-EURJPY-M30-91,EURJPYMT4,2086,3d 2h 29m,Buy
135479.94,133856,22.05.2015 17:59:57,sl 133.856,-1.82,-554.0899999999383,0.0,0.0,135195,22.05.2015 15:00:00,11728,-0.2451356550161647,-59.6,IS,0.09,0.0,Phase3-EA-TR1v1-EURJPY-M30-91,EURJPYMT4,2087,2h 59m,Buy
135342.77,1.03601,25.05.2015 07:05:00,,-1.04,-691.2599999999511,0.0,0.0,1.03914,22.05.2015 22:45:00,11729,-0.30582120754115916,-137.17,IS,0.41,0.0,Phase3-EA-SA2v2-EURCHF-M5-43,EURCHFMT4,5952,2d 8h 20m,Buy
135270.86,1.03519,25.05.2015 11:00:00,,0.0,-763.1699999999546,0.0,0.0,1.03718,25.05.2015 02:15:00,11730,-0.33763500124293183,-71.91,IS,0.34,0.0,Phase3-EA-S4v1-EURCHF-M15-221,EURCHFMT4,3092,8h 45m,Buy
135316.36,1.03676,26.05.2015 04:44:58,tp 1.03676,-2.17,-717.6699999999546,0.0,0.0,1.03786,25.05.2015 21:05:00,11731,-0.3175052889159872,45.5,IS,0.41,0.0,Phase3-EA-SA2v2-EURCHF-M5-43,EURCHFMT4,5954,7h 39m,Sell
135307.49,188184,26.05.2015 09:20:00,,0.0,-726.5399999999499,0.0,0.0,188137,26.05.2015 03:55:00,11732,-0.32142947679158956,-8.87,IS,0.23,0.0,Phase3-EA-S4v1-GBPJPY-M5-194,GBPJPYMT4,2646,5h 25m,Sell
135257.58,188596,26.05.2015 10:29:58,sl 188.596,-0.43,-776.4499999999534,0.0,0.0,187926,25.05.2015 02:00:00,11733,-0.34351022277483956,-49.91,IS,0.09,0.0,Phase3-EA-B1v1-GBPJPY-M30-1,GBPJPYMT4,1096,1d 8h 29m,Sell
135225.14,133.7,26.05.2015 10:44:58,sl 133.700,-0.49,-808.8899999999558,0.0,0.0,133.47,25.05.2015 12:00:00,11734,-0.3578620440470622,-32.44,IS,0.17,0.0,Phase3-EA-T1v2-EURJPY-M15-322,EURJPYMT4,2192,22h 44m,Sell
135272.64,1.03478,26.05.2015 21:04:58,tp 1.03478,0.0,-761.3899999999558,0.0,0.0,1.03368,26.05.2015 20:00:00,11735,-0.3368475092002519,47.5,IS,0.41,0.0,Phase3-EA-SA2v2-EURCHF-M5-43,EURCHFMT4,5956,1h 4m,Buy
135304.91,123058,27.05.2015 01:00:00,,-0.64,-729.1199999999662,0.0,0.0,122908,26.05.2015 21:00:00,11736,-0.32257089784222354,32.27,IS,0.27,0.0,Phase3-EA-S1v2-USDJPY-M15-0,USDJPYMT4,3342,4h 0m,Buy
135333.96,0.95232,27.05.2015 03:30:00,,-3.23,-700.0699999999779,0.0,0.0,0.95285,26.05.2015 23:15:00,11737,-0.30971885074117944,29.05,IS,0.58,0.0,Phase3-EA-SA2v2-USDCHF-M15-107,USDCHFMT4,2286,4h 15m,Sell
135343.44,1.0357,27.05.2015 07:15:00,,-2.15,-690.5899999999674,0.0,0.0,1.03597,26.05.2015 22:55:00,11738,-0.3055247919970114,9.48,IS,0.41,0.0,Phase3-EA-SA2v2-EURCHF-M5-43,EURCHFMT4,5958,8h 20m,Sell
135358.12,1036,27.05.2015 10:15:00,,0.0,-675.9099999999744,0.0,0.0,1.03641,27.05.2015 01:30:00,11739,-0.29903019470120024,14.68,IS,0.34,0.0,Phase3-EA-S4v1-EURCHF-M15-221,EURCHFMT4,3094,8h 45m,Sell
135400.64,123824,27.05.2015 19:15:00,,0.0,-633.3899999999849,0.0,0.0,123629,27.05.2015 18:30:00,11740,-0.2802188679288602,42.52,IS,0.27,0.0,Phase3-EA-S1v2-USDJPY-M15-0,USDJPYMT4,3344,45m 0s,Buy
135493.75,134846,27.05.2015 19:59:57,tp 134.846,-0.72,-540.2799999999988,0.0,0.0,133556,25.05.2015 09:30:00,11741,-0.23902595551651884,93.11,IS,0.09,0.0,Phase3-EA-TR1v1-EURJPY-M30-91,EURJPYMT4,2090,2d 10h 29m,Buy
135534.8,1.03488,28.05.2015 01:04:58,tp 1.03488,-6.47,-499.2300000000105,0.0,0.0,1.03598,27.05.2015 22:45:00,11742,-0.22086497329628058,41.05,IS,0.41,0.0,Phase3-EA-SA2v2-EURCHF-M5-43,EURCHFMT4,5960,2h 19m,Sell
135498.74,0.94894,28.05.2015 05:00:00,,0.0,-535.2900000000081,0.0,0.0,0.94953,28.05.2015 00:45:00,11743,-0.23681832332945804,-36.06,IS,0.58,0.0,Phase3-EA-SA2v2-USDCHF-M15-107,USDCHFMT4,2288,4h 15m,Buy
135496.58,1.03491,28.05.2015 09:25:00,,0.0,-537.4500000000116,0.0,0.0,1.03496,28.05.2015 01:05:00,11744,-0.23777393165091454,-2.16,IS,0.41,0.0,Phase3-EA-SA2v2-EURCHF-M5-43,EURCHFMT4,5962,8h 20m,Buy
135727.9,135625,28.05.2015 12:59:57,tp 135.625,-2.02,-306.13000000000466,0.0,0.0,133925,27.05.2015 04:15:00,11745,-0.13543535900324497,231.32,IS,0.17,0.0,Phase3-EA-T1v2-EURJPY-M15-322,EURJPYMT4,2194,1d 8h 44m,Buy
135817.93,135608,28.05.2015 12:59:58,tp 135.608,-1.43,-216.10000000000582,0.0,0.0,134348,26.05.2015 18:00:00,11746,-0.09560507327149112,90.03,IS,0.09,0.0,Phase3-EA-TR1v1-EURJPY-M30-91,EURJPYMT4,2091,1d 18h 59m,Buy
135865.76,1.03289,28.05.2015 23:04:58,tp 1.03289,0.0,-168.27000000001863,0.0,0.0,1.03179,28.05.2015 20:15:00,11747,-0.07444454270890864,47.83,IS,0.41,0.0,Phase3-EA-SA2v2-EURCHF-M5-43,EURCHFMT4,5964,2h 49m,Buy
135907.23,189626,29.05.2015 04:45:00,,-1.08,-126.80000000001746,0.0,0.0,189855,28.05.2015 23:20:00,11748,-0.05609774775949291,41.47,IS,0.23,0.0,Phase3-EA-S4v1-GBPJPY-M5-194,GBPJPYMT4,2648,5h 25m,Sell
135874.93,135.46,29.05.2015 06:44:58,sl 135.460,-0.67,-159.10000000000582,0.0,0.0,135.69,28.05.2015 23:00:00,11749,-0.07038763145531876,-32.3,IS,0.17,0.0,Phase3-EA-T1v2-EURJPY-M15-322,EURJPYMT4,2196,7h 44m,Buy
135922.86,1.03153,29.05.2015 08:24:58,tp 1.03153,0.0,-111.1700000000128,0.0,0.0,1.03263,29.05.2015 00:05:00,11750,-0.049182859766740424,47.93,IS,0.41,0.0,Phase3-EA-SA2v2-EURCHF-M5-43,EURCHFMT4,5966,8h 19m,Sell
135835.43,123802,29.05.2015 09:15:00,,-0.63,-198.60000000000582,0.0,0.0,124.2,28.05.2015 18:15:00,11751,-0.08786287622266628,-87.43,IS,0.27,0.0,Phase3-EA-S1v2-USDJPY-M15-0,USDJPYMT4,3346,15h 0m,Buy
135836.87,1.03254,29.05.2015 09:45:00,,0.0,-197.1600000000035,0.0,0.0,1.03258,29.05.2015 01:00:00,11752,-0.08722580400836194,1.44,IS,0.34,0.0,Phase3-EA-S4v1-EURCHF-M15-221,EURCHFMT4,3096,8h 45m,Sell
135794.87,1.5301,29.05.2015 10:59:57,sl 1.53010,0.0,-239.1600000000035,0.0,0.0,1.5331,29.05.2015 10:00:00,11753,-0.10580707692554157,-42.0,IS,0.14,0.0,Phase3-EA-B1v1-GBPUSD-M30-14,GBPUSDMT4,778,59m 57s,Buy
135744.83,188813,29.05.2015 14:59:58,sl 188.813,-1.31,-289.20000000001164,0.0,0.0,189483,26.05.2015 17:00:00,11754,-0.12794533637258493,-50.04,IS,0.09,0.0,Phase3-EA-B1v1-GBPJPY-M30-1,GBPJPYMT4,1098,2d 21h 59m,Buy
135687.9,136048,29.05.2015 16:29:58,sl 136.048,-0.25,-346.13000000000466,0.0,0.0,135268,28.05.2015 16:00:00,11755,-0.1531318094005589,-56.93,IS,0.09,0.0,Phase3-EA-TR1v1-EURJPY-M30-91,EURJPYMT4,2094,1d 0h 29m,Sell
135731.4,136013,01.06.2015 04:45:00,,-0.67,-302.63000000000466,0.0,0.0,135.69,29.05.2015 13:00:00,11756,-0.13388691959347998,43.5,IS,0.17,0.0,Phase3-EA-T1v2-EURJPY-M15-322,EURJPYMT4,2198,2d 15h 45m,Buy
135694.25,1.03152,01.06.2015 06:20:00,,-1.05,-339.77999999999884,0.0,0.0,1.03235,29.05.2015 22:00:00,11757,-0.15032249789998273,-37.15,IS,0.41,0.0,Phase3-EA-SA2v2-EURCHF-M5-43,EURCHFMT4,5968,2d 8h 20m,Buy
135739.75,1.03205,02.06.2015 01:09:58,tp 1.03205,-2.17,-294.27999999999884,0.0,0.0,1.03315,01.06.2015 20:15:00,11758,-0.13019278557303812,45.5,IS,0.41,0.0,Phase3-EA-SA2v2-EURCHF-M5-43,EURCHFMT4,5970,4h 54m,Sell
135742.08,0.94597,02.06.2015 02:15:00,,-0.74,-291.95000000001164,0.0,0.0,0.94592,01.06.2015 22:00:00,11759,-0.12916196733740026,2.33,IS,0.58,0.0,Phase3-EA-SA2v2-USDCHF-M15-107,USDCHFMT4,2290,4h 15m,Buy
135747.49,124783,02.06.2015 02:15:00,,0.0,-286.54000000000815,0.0,0.0,124808,02.06.2015 00:30:00,11760,-0.126768522421162,5.41,IS,0.27,0.0,Phase3-EA-S1v2-USDJPY-M15-0,USDJPYMT4,3348,1h 45m,Sell
135690.85,136877,02.06.2015 13:29:58,sl 136.877,-0.25,-343.1800000000221,0.0,0.0,136097,01.06.2015 03:30:00,11761,-0.1518266961837647,-56.64,IS,0.09,0.0,Phase3-EA-TR1v1-EURJPY-M30-91,EURJPYMT4,2096,1d 9h 59m,Sell
135781.47,137662,02.06.2015 14:29:58,tp 137.662,-0.35,-252.56000000002678,0.0,0.0,136402,01.06.2015 23:30:00,11762,-0.11173538780865205,90.62,IS,0.09,0.0,Phase3-EA-TR1v1-EURJPY-M30-91,EURJPYMT4,2097,14h 59m,Buy
135925.9,1.03669,02.06.2015 14:29:58,tp 1.03669,0.0,-108.13000000003376,0.0,0.0,1.03269,02.06.2015 06:00:00,11763,-0.04783792953655384,144.43,IS,0.34,0.0,Phase3-EA-S4v1-EURCHF-M15-221,EURCHFMT4,3098,8h 29m,Buy
135974.28,1.04104,02.06.2015 22:49:57,tp 1.04104,0.0,-59.750000000029104,0.0,0.0,1.04214,02.06.2015 21:10:00,11764,-0.02643407278100057,48.38,IS,0.41,0.0,Phase3-EA-SA2v2-EURCHF-M5-43,EURCHFMT4,5972,1h 39m,Sell
136036.46,0.93285,02.06.2015 23:14:59,tp 0.93285,0.0,-0.0,0.0,0.0,0.93185,02.06.2015 22:15:00,11765,-0.0,62.18,IS,0.58,0.0,Phase3-EA-SA2v2-USDCHF-M15-107,USDCHFMT4,2292,59m 59s,Buy
136083.78,1.04151,03.06.2015 05:44:58,tp 1.04151,-1.05,-0.0,0.0,0.0,1.04041,02.06.2015 23:35:00,11766,-0.0,47.32,IS,0.41,0.0,Phase3-EA-SA2v2-EURCHF-M5-43,EURCHFMT4,5974,6h 9m,Buy
136113.95,123942,03.06.2015 05:45:00,,-0.98,-0.0,0.0,0.0,124085,02.06.2015 23:15:00,11767,-0.0,30.17,IS,0.27,0.0,Phase3-EA-S1v2-USDJPY-M15-0,USDJPYMT4,3350,6h 30m,Sell
136082.45,138222,03.06.2015 11:14:58,sl 138.222,0.0,-31.5,0.0,0.0,138452,03.06.2015 08:30:00,11768,-0.013931029023198156,-31.5,IS,0.17,0.0,Phase3-EA-T1v2-EURJPY-M15-322,EURJPYMT4,2200,2h 44m,Buy
136092.25,1.04131,03.06.2015 15:00:00,,0.0,-21.70000000001164,0.0,0.0,1.04158,03.06.2015 06:15:00,11769,-0.00959693110487499,9.8,IS,0.34,0.0,Phase3-EA-S4v1-EURCHF-M15-221,EURCHFMT4,3100,8h 45m,Sell
136060.86,138168,03.06.2015 16:59:57,sl 138.168,0.0,-53.09000000002561,0.0,0.0,138398,03.06.2015 15:00:00,11770,-0.023479312090220538,-31.39,IS,0.17,0.0,Phase3-EA-T1v2-EURJPY-M15-322,EURJPYMT4,2202,1h 59m,Buy
136151.76,139848,03.06.2015 18:59:58,tp 139.848,-0.36,-0.0,0.0,0.0,138588,02.06.2015 21:00:00,11771,-0.0,90.9,IS,0.09,0.0,Phase3-EA-TR1v1-EURJPY-M30-91,EURJPYMT4,2100,21h 59m,Buy
136193.49,1.05242,04.06.2015 00:54:57,tp 1.05242,-6.58,-0.0,0.0,0.0,1.05352,03.06.2015 23:40:00,11772,-0.0,41.73,IS,0.41,0.0,Phase3-EA-SA2v2-EURCHF-M5-43,EURCHFMT4,5976,1h 14m,Sell
136195.29,124373,04.06.2015 04:15:00,,-1.89,-0.0,0.0,0.0,124356,03.06.2015 17:45:00,11773,-0.0,1.8,IS,0.27,0.0,Phase3-EA-S1v2-USDJPY-M15-0,USDJPYMT4,3352,10h 30m,Buy
136163.75,140541,04.06.2015 13:14:58,sl 140.541,0.0,-31.54000000000815,0.0,0.0,140771,04.06.2015 12:45:00,11774,-0.013943703248643207,-31.54,IS,0.17,0.0,Phase3-EA-T1v2-EURJPY-M15-322,EURJPYMT4,2204,29m 58s,Buy
135947.99,1047,05.06.2015 03:05:00,sl 1.04700,-1.05,-247.30000000001746,0.0,0.0,1.0519,04.06.2015 21:35:00,11775,-0.10933030479989911,-215.76,IS,0.41,0.0,Phase3-EA-SA2v2-EURCHF-M5-43,EURCHFMT4,5978,5h 30m,Buy
135894.5,139.26,05.06.2015 03:29:57,sl 139.260,-1.42,-300.79000000000815,0.0,0.0,139.98,03.06.2015 21:00:00,11776,-0.1329780120532156,-53.49,IS,0.09,0.0,Phase3-EA-TR1v1-EURJPY-M30-91,EURJPYMT4,2102,1d 6h 29m,Buy
135923.8,124488,05.06.2015 04:15:00,,-0.63,-271.4900000000198,0.0,0.0,124.35,04.06.2015 22:00:00,11777,-0.12002460351849849,29.3,IS,0.27,0.0,Phase3-EA-S1v2-USDJPY-M15-0,USDJPYMT4,3354,6h 15m,Buy
135766.41,0.93602,05.06.2015 05:30:00,,0.0,-428.88000000003376,0.0,0.0,0.93348,05.06.2015 01:15:00,11778,-0.1896060700468302,-157.39,IS,0.58,0.0,Phase3-EA-SA2v2-USDCHF-M15-107,USDCHFMT4,2294,4h 15m,Sell
135828.13,0.93977,05.06.2015 23:14:58,tp 0.93977,0.0,-367.1600000000326,0.0,0.0,0.93877,05.06.2015 22:45:00,11779,-0.16231991391157172,61.72,IS,0.58,0.0,Phase3-EA-SA2v2-USDCHF-M15-107,USDCHFMT4,2296,29m 58s,Buy
135843.41,125.64,08.06.2015 02:15:00,,-0.62,-351.88000000003376,0.0,0.0,125566,05.06.2015 22:45:00,11780,-0.15556468925592185,15.28,IS,0.27,0.0,Phase3-EA-S1v2-USDJPY-M15-0,USDJPYMT4,3356,2d 3h 30m,Buy
135674.45,1.04425,08.06.2015 04:20:00,,-1.05,-520.8400000000256,0.0,0.0,1.0481,05.06.2015 20:00:00,11781,-0.23026120481996856,-168.96,IS,0.41,0.0,Phase3-EA-SA2v2-EURCHF-M5-43,EURCHFMT4,5980,2d 8h 20m,Buy
135677.78,125544,08.06.2015 04:30:00,,-0.97,-517.5100000000384,0.0,0.0,125564,05.06.2015 22:45:00,11782,-0.22878902562473105,3.33,IS,0.27,0.0,Phase3-EA-S1v2-USDJPY-M15-0,USDJPYMT4,3357,2d 5h 45m,Sell
135646.62,139689,08.06.2015 10:59:58,sl 139.689,0.0,-548.6700000000419,0.0,0.0,139459,08.06.2015 04:15:00,11783,-0.2425647324486898,-31.16,IS,0.17,0.0,Phase3-EA-T1v2-EURJPY-M15-322,EURJPYMT4,2206,6h 44m,Sell
135695.28,1.04776,09.06.2015 05:44:57,tp 1.04776,0.0,-500.0100000000384,0.0,0.0,1.04666,09.06.2015 02:05:00,11784,-0.2210523481722519,48.66,IS,0.41,0.0,Phase3-EA-SA2v2-EURCHF-M5-43,EURCHFMT4,5982,3h 39m,Buy
135747.78,1.04823,09.06.2015 10:15:00,,0.0,-447.5100000000384,0.0,0.0,1.0468,09.06.2015 01:30:00,11785,-0.19784231581481437,52.5,IS,0.34,0.0,Phase3-EA-S4v1-EURCHF-M15-221,EURCHFMT4,3102,8h 45m,Buy
135695.23,139797,09.06.2015 14:29:58,sl 139.797,-0.35,-500.0600000000268,0.0,0.0,139715,05.06.2015 10:30:00,11786,-0.2210744529649681,-52.55,IS,0.09,0.0,Phase3-EA-TR1v1-EURJPY-M30-91,EURJPYMT4,2104,4d 3h 59m,Buy
135652.7,1.52638,09.06.2015 18:29:58,sl 1.52638,-0.53,-542.5900000000256,0.0,0.0,1.52938,08.06.2015 20:30:00,11787,-0.2398767896537641,-42.53,IS,0.14,0.0,Phase3-EA-B1v1-GBPUSD-M30-14,GBPUSDMT4,780,21h 59m,Buy
135600.36,140.45,10.06.2015 03:59:58,sl 140.450,-0.25,-594.9300000000221,0.0,0.0,140517,08.06.2015 22:00:00,11788,-0.2630160866744917,-52.34,IS,0.09,0.0,Phase3-EA-TR1v1-EURJPY-M30-91,EURJPYMT4,2105,1d 5h 59m,Buy
135504.71,1.05085,10.06.2015 04:20:00,,-2.2,-690.5800000000163,0.0,0.0,1.04873,09.06.2015 20:00:00,11789,-0.30530255515046817,-95.65,IS,0.41,0.0,Phase3-EA-SA2v2-EURCHF-M5-43,EURCHFMT4,5984,8h 20m,Sell
135525.45,124309,10.06.2015 04:30:00,,-0.98,-669.8400000000256,0.0,0.0,124409,09.06.2015 18:15:00,11790,-0.2961334871296484,20.74,IS,0.27,0.0,Phase3-EA-S1v2-USDJPY-M15-0,USDJPYMT4,3360,10h 15m,Sell
135468.05,138935,10.06.2015 08:29:58,sl 138.935,-1.05,-727.2400000000198,0.0,0.0,139.73,09.06.2015 14:30:00,11791,-0.3215097891737775,-57.4,IS,0.09,0.0,Phase3-EA-TR1v1-EURJPY-M30-91,EURJPYMT4,2107,17h 59m,Sell
135514.99,1.04931,10.06.2015 12:45:00,,0.0,-680.3000000000175,0.0,0.0,1.05059,10.06.2015 04:00:00,11792,-0.3007578097669552,46.94,IS,0.34,0.0,Phase3-EA-S4v1-EURCHF-M15-221,EURCHFMT4,3104,8h 45m,Sell
135416.87,1.05378,11.06.2015 04:50:00,,-6.61,-778.4200000000128,0.0,0.0,1.0517,10.06.2015 20:30:00,11793,-0.34413625500336775,-98.12,IS,0.41,0.0,Phase3-EA-SA2v2-EURCHF-M5-43,EURCHFMT4,5986,8h 20m,Sell
135447.51,1.05346,11.06.2015 09:45:00,,0.0,-747.7799999999988,0.0,0.0,1.0543,11.06.2015 01:00:00,11794,-0.33059043802370663,30.64,IS,0.34,0.0,Phase3-EA-S4v1-EURCHF-M15-221,EURCHFMT4,3106,8h 45m,Sell
135393.97,0.93395,12.06.2015 03:00:00,,-0.75,-801.320000000007,0.0,0.0,0.9348,11.06.2015 22:45:00,11795,-0.35426025006975226,-53.54,IS,0.58,0.0,Phase3-EA-SA2v2-USDCHF-M15-107,USDCHFMT4,2298,4h 15m,Buy
135413.44,123586,12.06.2015 03:45:00,,-0.63,-781.8500000000058,0.0,0.0,123494,11.06.2015 17:00:00,11796,-0.3456526437840506,19.47,IS,0.27,0.0,Phase3-EA-S1v2-USDJPY-M15-0,USDJPYMT4,3362,10h 45m,Buy
135363.61,1.05058,12.06.2015 07:40:00,,-1.05,-831.679999999993,0.0,0.0,1.05169,11.06.2015 23:20:00,11797,-0.36768228021016136,-49.83,IS,0.41,0.0,Phase3-EA-SA2v2-EURCHF-M5-43,EURCHFMT4,5988,8h 20m,Buy
135331.96,138882,12.06.2015 11:14:57,sl 138.882,0.0,-863.3299999999872,0.0,0.0,138652,12.06.2015 08:45:00,11798,-0.3816746140027854,-31.65,IS,0.17,0.0,Phase3-EA-T1v2-EURJPY-M15-322,EURJPYMT4,2208,2h 29m,Sell
135275.93,1.04832,12.06.2015 12:00:00,,0.0,-919.359999999986,0.0,0.0,1.04986,12.06.2015 03:15:00,11799,-0.4064452447263511,-56.03,IS,0.34,0.0,Phase3-EA-S4v1-EURCHF-M15-221,EURCHFMT4,3108,8h 45m,Buy
135218.84,138164,12.06.2015 12:59:57,sl 138.164,-0.36,-976.4499999999825,0.0,0.0,138944,11.06.2015 00:30:00,11800,-0.4316844970556087,-57.09,IS,0.09,0.0,Phase3-EA-TR1v1-EURJPY-M30-91,EURJPYMT4,2110,1d 12h 29m,Buy
135481.31,1.55859,12.06.2015 19:29:58,tp 1.55859,-2.13,-713.9799999999814,0.0,0.0,1.53969,10.06.2015 08:30:00,11801,-0.3156475981440534,262.47,IS,0.14,0.0,Phase3-EA-B1v1-GBPUSD-M30-14,GBPUSDMT4,782,2d 10h 59m,Buy
135527.67,1.04398,15.06.2015 01:05:00,tp 1.04398,-2.21,-667.6199999999953,0.0,0.0,1.04508,12.06.2015 21:50:00,11802,-0.29515203433280623,46.36,IS,0.41,0.0,Phase3-EA-SA2v2-EURCHF-M5-43,EURCHFMT4,5990,2d 3h 15m,Sell
135576.19,1.04372,15.06.2015 04:04:57,tp 1.04372,0.0,-619.1000000000058,0.0,0.0,1.04262,15.06.2015 01:15:00,11803,-0.2737015434759943,48.52,IS,0.41,0.0,Phase3-EA-SA2v2-EURCHF-M5-43,EURCHFMT4,5992,2h 49m,Buy
135648.91,192002,15.06.2015 04:09:57,tp 192.002,0.0,-546.3800000000047,0.0,0.0,191612,15.06.2015 01:15:00,11804,-0.24155233294203463,72.72,IS,0.23,0.0,Phase3-EA-S4v1-GBPJPY-M5-194,GBPJPYMT4,2650,2h 54m,Buy
135599.08,123468,15.06.2015 05:00:00,,-0.63,-596.2099999999919,0.0,0.0,123693,12.06.2015 17:00:00,11805,-0.2635819693681454,-49.83,IS,0.27,0.0,Phase3-EA-S1v2-USDJPY-M15-0,USDJPYMT4,3364,2d 12h 0m,Buy
135745.22,1.04664,15.06.2015 11:14:57,tp 1.04664,0.0,-450.0699999999779,0.0,0.0,1.04264,15.06.2015 02:30:00,11806,-0.1989740812021217,146.14,IS,0.34,0.0,Phase3-EA-S4v1-EURCHF-M15-221,EURCHFMT4,3110,8h 44m,Buy
135793.53,1.05241,15.06.2015 21:29:57,tp 1.05241,0.0,-401.7599999999802,0.0,0.0,1.05351,15.06.2015 20:05:00,11807,-0.17761643047473594,48.31,IS,0.41,0.0,Phase3-EA-SA2v2-EURCHF-M5-43,EURCHFMT4,5994,1h 24m,Sell
135811.69,123389,15.06.2015 23:00:00,,0.0,-383.5999999999767,0.0,0.0,123472,15.06.2015 22:00:00,11808,-0.16958796975833315,18.16,IS,0.27,0.0,Phase3-EA-S1v2-USDJPY-M15-0,USDJPYMT4,3366,1h 0m,Sell
135736.16,1.04853,16.06.2015 06:55:00,,-1.06,-459.12999999997555,0.0,0.0,1.05022,15.06.2015 22:35:00,11809,-0.20297946964323274,-75.53,IS,0.41,0.0,Phase3-EA-SA2v2-EURCHF-M5-43,EURCHFMT4,5996,8h 20m,Buy
135721.54,1.04817,16.06.2015 10:30:00,,0.0,-473.7499999999709,0.0,0.0,1.04857,16.06.2015 01:45:00,11810,-0.209442911034959,-14.62,IS,0.34,0.0,Phase3-EA-S4v1-EURCHF-M15-221,EURCHFMT4,3112,8h 45m,Buy
135769.9,1.04752,16.06.2015 22:04:57,tp 1.04752,0.0,-425.38999999998487,0.0,0.0,1.04862,16.06.2015 21:05:00,11811,-0.18806315551485703,48.36,IS,0.41,0.0,Phase3-EA-SA2v2-EURCHF-M5-43,EURCHFMT4,5998,59m 57s,Sell
135818.31,1.04751,17.06.2015 03:29:58,tp 1.04751,0.0,-376.9799999999814,0.0,0.0,1.04861,17.06.2015 00:40:00,11812,-0.16666129520202594,48.41,IS,0.41,0.0,Phase3-EA-SA2v2-EURCHF-M5-43,EURCHFMT4,6000,2h 49m,Sell
135675.45,1.04379,17.06.2015 11:29:58,sl 1.04379,0.0,-519.8399999999674,0.0,0.0,1.04769,17.06.2015 03:45:00,11813,-0.22981910896551547,-142.86,IS,0.34,0.0,Phase3-EA-S4v1-EURCHF-M15-221,EURCHFMT4,3114,7h 44m,Buy
135938.99,1.57418,17.06.2015 13:29:58,tp 1.57418,-1.06,-256.29999999995925,0.0,0.0,1.55528,15.06.2015 19:30:00,11814,-0.1133091674897198,263.54,IS,0.14,0.0,Phase3-EA-B1v1-GBPUSD-M30-14,GBPUSDMT4,784,1d 17h 59m,Buy
135987.64,1.04381,17.06.2015 21:04:58,tp 1.04381,0.0,-207.64999999996508,0.0,0.0,1.04271,17.06.2015 20:15:00,11815,-0.09180120417183028,48.65,IS,0.41,0.0,Phase3-EA-SA2v2-EURCHF-M5-43,EURCHFMT4,6002,49m 58s,Buy
136036.46,1.04375,17.06.2015 22:14:58,tp 1.04375,0.0,-158.8299999999581,0.0,0.0,1.04265,17.06.2015 22:05:00,11816,-0.07021808455868243,48.82,IS,0.41,0.0,Phase3-EA-SA2v2-EURCHF-M5-43,EURCHFMT4,6004,9m 58s,Buy
136085.35,1.04421,17.06.2015 22:59:58,tp 1.04421,0.0,-109.93999999994412,0.0,0.0,1.04531,17.06.2015 22:35:00,11817,-0.048604018235721594,48.89,IS,0.41,0.0,Phase3-EA-SA2v2-EURCHF-M5-43,EURCHFMT4,6006,24m 58s,Sell
136219.42,195683,18.06.2015 03:29:58,tp 195.683,-0.79,-0.0,0.0,0.0,193833,17.06.2015 12:30:00,11818,-0.0,134.07,IS,0.09,0.0,Phase3-EA-B1v1-GBPJPY-M30-1,GBPJPYMT4,1100,14h 59m,Buy
136161.53,140208,18.06.2015 03:29:58,sl 140.208,-1.03,-57.89000000001397,0.0,0.0,139428,16.06.2015 12:00:00,11819,-0.025590199108464492,-57.89,IS,0.09,0.0,Phase3-EA-TR1v1-EURJPY-M30-91,EURJPYMT4,2112,1d 15h 29m,Sell
136252.2,140324,18.06.2015 03:59:58,tp 140.324,-1.07,-0.0,0.0,0.0,139064,17.06.2015 09:30:00,11820,-0.0,90.67,IS,0.09,0.0,Phase3-EA-TR1v1-EURJPY-M30-91,EURJPYMT4,2113,18h 29m,Buy
136324.95,195282,18.06.2015 05:24:58,tp 195.282,0.0,-0.0,0.0,0.0,195672,18.06.2015 03:40:00,11821,-0.0,72.75,IS,0.23,0.0,Phase3-EA-S4v1-GBPJPY-M5-194,GBPJPYMT4,2652,1h 44m,Sell
136276.04,195016,18.06.2015 06:59:58,sl 195.016,0.0,-48.91000000000349,0.0,0.0,195686,18.06.2015 03:30:00,11822,-0.021610520625323513,-48.91,IS,0.09,0.0,Phase3-EA-B1v1-GBPJPY-M30-1,GBPJPYMT4,1102,3h 29m,Buy
136325.0,1.04849,18.06.2015 20:39:58,tp 1.04849,0.0,-0.0,0.0,0.0,1.04959,18.06.2015 20:15:00,11823,-0.0,48.96,IS,0.41,0.0,Phase3-EA-SA2v2-EURCHF-M5-43,EURCHFMT4,6008,24m 58s,Sell
136293.25,139664,18.06.2015 20:44:58,sl 139.664,0.0,-31.75,0.0,0.0,139894,18.06.2015 16:00:00,11824,-0.01402849884016338,-31.75,IS,0.17,0.0,Phase3-EA-T1v2-EURJPY-M15-322,EURJPYMT4,2210,4h 44m,Buy
136245.68,122877,19.06.2015 05:00:00,,-0.99,-79.32000000000698,0.0,0.0,122665,18.06.2015 17:15:00,11825,-0.035046945763838024,-47.57,IS,0.27,0.0,Phase3-EA-S1v2-USDJPY-M15-0,USDJPYMT4,3368,11h 45m,Sell
136221.91,1.0478,19.06.2015 07:10:00,,-1.07,-103.08999999999651,0.0,0.0,1.04831,18.06.2015 22:50:00,11826,-0.04554954158842185,-23.77,IS,0.41,0.0,Phase3-EA-SA2v2-EURCHF-M5-43,EURCHFMT4,6010,8h 20m,Buy
136214.62,195366,19.06.2015 09:10:00,,0.0,-110.38000000000466,0.0,0.0,195327,19.06.2015 03:45:00,11827,-0.0487705732906236,-7.29,IS,0.23,0.0,Phase3-EA-S4v1-GBPJPY-M5-194,GBPJPYMT4,2654,5h 25m,Sell
136182.16,1.04627,19.06.2015 10:15:00,,0.0,-142.8399999999965,0.0,0.0,1.04715,19.06.2015 01:30:00,11828,-0.06311278029382325,-32.46,IS,0.34,0.0,Phase3-EA-S4v1-EURCHF-M15-221,EURCHFMT4,3116,8h 45m,Buy
136231.15,1.04441,19.06.2015 21:19:57,tp 1.04441,0.0,-93.85000000000582,0.0,0.0,1.04331,19.06.2015 20:30:00,11829,-0.04146691704407606,48.99,IS,0.41,0.0,Phase3-EA-SA2v2-EURCHF-M5-43,EURCHFMT4,6012,49m 57s,Buy
136288.28,122927,22.06.2015 01:15:00,,-0.64,-36.720000000001164,0.0,0.0,122664,19.06.2015 23:30:00,11830,-0.016224455981443012,57.13,IS,0.27,0.0,Phase3-EA-S1v2-USDJPY-M15-0,USDJPYMT4,3370,2d 1h 45m,Buy
136336.39,1.04269,22.06.2015 02:09:58,tp 1.04269,-1.07,-0.0,0.0,0.0,1.04159,19.06.2015 22:20:00,11831,-0.0,48.11,IS,0.41,0.0,Phase3-EA-SA2v2-EURCHF-M5-43,EURCHFMT4,6014,2d 3h 49m,Buy
136409.55,194725,22.06.2015 05:14:57,tp 194.725,0.0,-0.0,0.0,0.0,195115,22.06.2015 01:40:00,11832,-0.0,73.16,IS,0.23,0.0,Phase3-EA-S4v1-GBPJPY-M5-194,GBPJPYMT4,2656,3h 34m,Sell
136428.61,122571,22.06.2015 05:15:00,,-0.99,-0.0,0.0,0.0,122662,19.06.2015 23:30:00,11833,-0.0,19.06,IS,0.27,0.0,Phase3-EA-S1v2-USDJPY-M15-0,USDJPYMT4,3371,2d 5h 45m,Sell
136396.28,139925,22.06.2015 08:59:58,sl 139.925,-0.48,-32.329999999987194,0.0,0.0,139695,19.06.2015 09:00:00,11834,-0.014278231006226182,-32.33,IS,0.17,0.0,Phase3-EA-T1v2-EURJPY-M15-322,EURJPYMT4,2212,2d 23h 59m,Sell
136310.0,1.04471,22.06.2015 10:50:00,,0.0,-118.60999999998603,0.0,0.0,1.04278,22.06.2015 02:30:00,11835,-0.05238295637639835,-86.28,IS,0.41,0.0,Phase3-EA-SA2v2-EURCHF-M5-43,EURCHFMT4,6016,8h 20m,Sell
136256.95,140.03,22.06.2015 10:59:58,sl 140.030,-0.26,-171.6599999999744,0.0,0.0,140031,18.06.2015 05:30:00,11836,-0.07581197446734894,-53.05,IS,0.09,0.0,Phase3-EA-TR1v1-EURJPY-M30-91,EURJPYMT4,2116,4d 5h 29m,Sell
136214.42,1.5854,22.06.2015 11:59:58,sl 1.58540,-0.53,-214.18999999997322,0.0,0.0,1.5884,19.06.2015 18:00:00,11837,-0.09459493656741154,-42.53,IS,0.14,0.0,Phase3-EA-B1v1-GBPUSD-M30-14,GBPUSDMT4,786,2d 17h 59m,Buy
136189.3,1.04407,22.06.2015 13:45:00,,0.0,-239.30999999996857,0.0,0.0,1.04339,22.06.2015 05:00:00,11838,-0.10568894098672725,-25.12,IS,0.34,0.0,Phase3-EA-S4v1-EURCHF-M15-221,EURCHFMT4,3118,8h 45m,Sell
136157.59,139753,22.06.2015 14:59:58,sl 139.753,0.0,-271.0199999999604,0.0,0.0,139983,22.06.2015 14:15:00,11839,-0.11969335500489908,-31.71,IS,0.17,0.0,Phase3-EA-T1v2-EURJPY-M15-322,EURJPYMT4,2214,44m 58s,Buy
136226.09,123374,22.06.2015 20:15:00,,0.0,-202.51999999996042,0.0,0.0,123061,22.06.2015 17:00:00,11840,-0.08944099422769894,68.5,IS,0.27,0.0,Phase3-EA-S1v2-USDJPY-M15-0,USDJPYMT4,3374,3h 15m,Buy
136285.73,0.92102,23.06.2015 01:44:58,tp 0.92102,-3.33,-142.87999999994645,0.0,0.0,0.92202,22.06.2015 23:45:00,11841,-0.06310156653787938,59.64,IS,0.58,0.0,Phase3-EA-SA2v2-USDCHF-M15-107,USDCHFMT4,2300,1h 59m,Sell
136292.3,123378,23.06.2015 03:30:00,,0.0,-136.30999999993946,0.0,0.0,123348,23.06.2015 01:00:00,11842,-0.06019998974508498,6.57,IS,0.27,0.0,Phase3-EA-S1v2-USDJPY-M15-0,USDJPYMT4,3376,2h 30m,Buy
136340.15,1.04569,23.06.2015 03:59:58,tp 1.04569,-1.07,-88.45999999993364,0.0,0.0,1.04459,22.06.2015 22:55:00,11843,-0.03906750123137398,47.85,IS,0.41,0.0,Phase3-EA-SA2v2-EURCHF-M5-43,EURCHFMT4,6018,5h 4m,Buy
136309.39,1.0439,23.06.2015 10:30:00,,0.0,-119.21999999994296,0.0,0.0,1.04474,23.06.2015 01:45:00,11844,-0.05265235696140257,-30.76,IS,0.34,0.0,Phase3-EA-S4v1-EURCHF-M15-221,EURCHFMT4,3120,8h 45m,Buy
136402.54,138741,23.06.2015 14:29:58,tp 138.741,-0.78,-26.069999999948777,0.0,0.0,139.31,19.06.2015 13:30:00,11845,-0.011513562707446107,93.15,IS,0.09,0.0,Phase3-EA-TR1v1-EURJPY-M30-91,EURJPYMT4,2117,4d 0h 59m,Sell
136450.75,1.0447,23.06.2015 22:59:58,tp 1.04470,0.0,-0.0,0.0,0.0,1.0436,23.06.2015 21:30:00,11846,-0.0,48.21,IS,0.41,0.0,Phase3-EA-SA2v2-EURCHF-M5-43,EURCHFMT4,6020,1h 29m,Buy
136455.55,123875,24.06.2015 04:00:00,,0.0,-0.0,0.0,0.0,123897,24.06.2015 00:15:00,11847,-0.0,4.8,IS,0.27,0.0,Phase3-EA-S1v2-USDJPY-M15-0,USDJPYMT4,3378,3h 45m,Sell
136423.27,194932,24.06.2015 04:25:00,,-1.08,-32.279999999998836,0.0,0.0,194764,23.06.2015 23:00:00,11848,-0.014254453026211368,-32.28,IS,0.23,0.0,Phase3-EA-S4v1-GBPJPY-M5-194,GBPJPYMT4,2658,5h 25m,Sell
136471.58,1.04367,24.06.2015 06:44:58,tp 1.04367,0.0,-0.0,0.0,0.0,1.04257,24.06.2015 01:20:00,11849,-0.0,48.31,IS,0.41,0.0,Phase3-EA-SA2v2-EURCHF-M5-43,EURCHFMT4,6022,5h 24m,Buy
136547.07,1.04477,24.06.2015 10:15:00,,0.0,-0.0,0.0,0.0,1.0427,24.06.2015 01:30:00,11850,-0.0,75.49,IS,0.34,0.0,Phase3-EA-S4v1-EURCHF-M15-221,EURCHFMT4,3122,8h 45m,Buy
136595.28,1.04607,24.06.2015 21:04:57,tp 1.04607,0.0,-0.0,0.0,0.0,1.04717,24.06.2015 20:40:00,11851,-0.0,48.21,IS,0.41,0.0,Phase3-EA-SA2v2-EURCHF-M5-43,EURCHFMT4,6024,24m 57s,Sell
136549.57,123867,25.06.2015 04:15:00,,-1.9,-45.70999999999185,0.0,0.0,124068,24.06.2015 20:45:00,11852,-0.020172529630798807,-45.71,IS,0.27,0.0,Phase3-EA-S1v2-USDJPY-M15-0,USDJPYMT4,3380,7h 30m,Buy
136597.84,1.04689,25.06.2015 06:29:57,tp 1.04689,0.0,-0.0,0.0,0.0,1.04579,25.06.2015 00:25:00,11853,-0.0,48.27,IS,0.41,0.0,Phase3-EA-SA2v2-EURCHF-M5-43,EURCHFMT4,6026,6h 4m,Buy
136577.35,138664,25.06.2015 07:45:00,,0.0,-20.489999999990687,0.0,0.0,138813,25.06.2015 05:30:00,11854,-0.0090424515961805,-20.49,IS,0.17,0.0,Phase3-EA-T1v2-EURJPY-M15-322,EURJPYMT4,2216,2h 15m,Buy
136436.32,1.05059,25.06.2015 14:29:58,sl 1.05059,0.0,-161.51999999998952,0.0,0.0,1.04669,25.06.2015 06:45:00,11855,-0.07128046763375519,-141.03,IS,0.34,0.0,Phase3-EA-S4v1-EURCHF-M15-221,EURCHFMT4,3124,7h 44m,Sell
136508.97,194289,26.06.2015 05:34:58,tp 194.289,0.0,-88.86999999999534,0.0,0.0,194679,26.06.2015 01:15:00,11856,-0.03921926175465516,72.65,IS,0.23,0.0,Phase3-EA-S4v1-GBPJPY-M5-194,GBPJPYMT4,2660,4h 19m,Sell
136504.16,1.04854,26.06.2015 10:05:00,,0.0,-93.67999999999302,0.0,0.0,1.04865,26.06.2015 01:45:00,11857,-0.04134196513082046,-4.81,IS,0.41,0.0,Phase3-EA-SA2v2-EURCHF-M5-43,EURCHFMT4,6028,8h 20m,Buy
136649.84,1.04538,26.06.2015 12:14:57,tp 1.04538,0.0,-0.0,0.0,0.0,1.04938,26.06.2015 03:45:00,11858,-0.0,145.68,IS,0.34,0.0,Phase3-EA-S4v1-EURCHF-M15-221,EURCHFMT4,3126,8h 29m,Sell
136617.8,138657,26.06.2015 18:44:58,sl 138.657,-0.48,-32.04000000000815,0.0,0.0,138427,25.06.2015 18:00:00,11859,-0.01413634353327049,-32.04,IS,0.17,0.0,Phase3-EA-T1v2-EURJPY-M15-322,EURJPYMT4,2218,1d 0h 44m,Sell
136435.02,123031,29.06.2015 01:00:00,sl 123.031,-0.63,-214.82000000000698,0.0,0.0,123861,26.06.2015 22:00:00,11860,-0.09478056547492175,-182.78,IS,0.27,0.0,Phase3-EA-S1v2-USDJPY-M15-0,USDJPYMT4,3382,2d 3h 0m,Buy
136481.14,1.04298,29.06.2015 01:05:00,tp 1.04298,-2.19,-168.70000000001164,0.0,0.0,1.04408,26.06.2015 22:35:00,11861,-0.07443199606935985,46.12,IS,0.41,0.0,Phase3-EA-SA2v2-EURCHF-M5-43,EURCHFMT4,6030,2d 2h 30m,Sell
136740.92,1.56652,29.06.2015 01:59:57,tp 1.56652,-4.82,-0.0,0.0,0.0,1.58542,22.06.2015 12:00:00,11862,-0.0,259.78,IS,0.14,0.0,Phase3-EA-B1v1-GBPUSD-M30-14,GBPUSDMT4,788,6d 13h 59m,Sell
136802.7,0.93888,29.06.2015 01:59:58,tp 0.93888,0.0,-0.0,0.0,0.0,0.93988,29.06.2015 01:30:00,11863,-0.0,61.78,IS,0.58,0.0,Phase3-EA-SA2v2-USDCHF-M15-107,USDCHFMT4,2302,29m 58s,Sell
136652.78,191343,29.06.2015 02:04:58,sl 191.343,0.0,-149.9200000000128,0.0,0.0,192143,29.06.2015 01:50:00,11864,-0.06610150584627596,-149.92,IS,0.23,0.0,Phase3-EA-S4v1-GBPJPY-M5-194,GBPJPYMT4,2662,14m 58s,Buy
136743.78,137318,29.06.2015 04:00:00,tp 137.318,-1.51,-58.920000000012806,0.0,0.0,138578,23.06.2015 17:00:00,11865,-0.02597852671066631,91.0,IS,0.09,0.0,Phase3-EA-TR1v1-EURJPY-M30-91,EURJPYMT4,2120,5d 11h 0m,Sell
136791.84,1.03374,29.06.2015 04:24:57,tp 1.03374,0.0,-10.860000000015134,0.0,0.0,1.03264,29.06.2015 01:05:00,11866,-0.004788302784761846,48.06,IS,0.41,0.0,Phase3-EA-SA2v2-EURCHF-M5-43,EURCHFMT4,6032,3h 19m,Buy
136803.93,122868,29.06.2015 18:15:00,,0.0,-0.0,0.0,0.0,122813,29.06.2015 17:00:00,11867,-0.0,12.09,IS,0.27,0.0,Phase3-EA-S1v2-USDJPY-M15-0,USDJPYMT4,3384,1h 15m,Buy
136898.77,137434,29.06.2015 21:29:58,tp 137.434,0.0,-0.0,0.0,0.0,136144,29.06.2015 12:30:00,11868,-0.0,94.84,IS,0.09,0.0,Phase3-EA-TR1v1-EURJPY-M30-91,EURJPYMT4,2122,8h 59m,Buy
136947.49,1.04073,29.06.2015 21:49:58,tp 1.04073,0.0,-0.0,0.0,0.0,1.04183,29.06.2015 21:40:00,11869,-0.0,48.72,IS,0.41,0.0,Phase3-EA-SA2v2-EURCHF-M5-43,EURCHFMT4,6034,9m 58s,Sell
136963.48,122473,30.06.2015 04:45:00,,-0.99,-0.0,0.0,0.0,122.55,29.06.2015 23:30:00,11870,-0.0,15.99,IS,0.27,0.0,Phase3-EA-S1v2-USDJPY-M15-0,USDJPYMT4,3386,5h 15m,Sell
137036.76,192.52,30.06.2015 06:14:57,tp 192.520,0.0,-0.0,0.0,0.0,192.91,30.06.2015 03:55:00,11871,-0.0,73.28,IS,0.23,0.0,Phase3-EA-S4v1-GBPJPY-M5-194,GBPJPYMT4,2664,2h 19m,Sell
137085.3,1.04037,30.06.2015 07:59:58,tp 1.04037,0.0,-0.0,0.0,0.0,1.03927,30.06.2015 01:05:00,11872,-0.0,48.54,IS,0.41,0.0,Phase3-EA-SA2v2-EURCHF-M5-43,EURCHFMT4,6036,6h 54m,Buy
137231.53,1.04179,30.06.2015 09:14:59,tp 1.04179,0.0,-0.0,0.0,0.0,1.03779,30.06.2015 05:45:00,11873,-0.0,146.23,IS,0.34,0.0,Phase3-EA-S4v1-EURCHF-M15-221,EURCHFMT4,3128,3h 29m,Buy
137178.08,136426,30.06.2015 11:59:58,sl 136.426,-0.36,-53.45000000001164,0.0,0.0,137146,29.06.2015 19:30:00,11874,-0.023522263833725566,-53.45,IS,0.09,0.0,Phase3-EA-TR1v1-EURJPY-M30-91,EURJPYMT4,2123,16h 29m,Buy
137226.21,1.04351,30.06.2015 20:34:58,tp 1.04351,0.0,-5.320000000006985,0.0,0.0,1.04461,30.06.2015 20:20:00,11875,-0.0023412243890656138,48.13,IS,0.41,0.0,Phase3-EA-SA2v2-EURCHF-M5-43,EURCHFMT4,6038,14m 58s,Sell
137299.39,192428,01.07.2015 04:59:57,tp 192.428,0.0,-0.0,0.0,0.0,192038,01.07.2015 03:10:00,11876,-0.0,73.18,IS,0.23,0.0,Phase3-EA-S4v1-GBPJPY-M5-194,GBPJPYMT4,2666,1h 49m,Buy
137316.13,0.93567,01.07.2015 06:30:00,,0.0,-0.0,0.0,0.0,0.9354,01.07.2015 02:15:00,11877,-0.0,16.74,IS,0.58,0.0,Phase3-EA-SA2v2-USDCHF-M15-107,USDCHFMT4,2304,4h 15m,Buy
137348.99,1.04234,01.07.2015 08:55:00,,0.0,-0.0,0.0,0.0,1.04159,01.07.2015 00:35:00,11878,-0.0,32.86,IS,0.41,0.0,Phase3-EA-SA2v2-EURCHF-M5-43,EURCHFMT4,6040,8h 20m,Buy
137316.59,136553,01.07.2015 09:29:58,sl 136.553,-0.49,-32.39999999999418,0.0,0.0,136323,30.06.2015 19:00:00,11879,-0.01425121791831754,-32.4,IS,0.17,0.0,Phase3-EA-T1v2-EURJPY-M15-322,EURJPYMT4,2220,14h 29m,Sell
137284.75,136439,01.07.2015 12:59:58,sl 136.439,0.0,-64.23999999999069,0.0,0.0,136209,01.07.2015 12:15:00,11880,-0.028256118489899708,-31.84,IS,0.17,0.0,Phase3-EA-T1v2-EURJPY-M15-322,EURJPYMT4,2222,44m 58s,Sell
137252.95,136678,01.07.2015 13:44:58,sl 136.678,0.0,-96.03999999997905,0.0,0.0,136908,01.07.2015 13:00:00,11881,-0.042243424965282834,-31.8,IS,0.17,0.0,Phase3-EA-T1v2-EURJPY-M15-322,EURJPYMT4,2224,44m 58s,Buy
137282.77,123119,01.07.2015 21:30:00,,0.0,-66.21999999997206,0.0,0.0,122983,01.07.2015 18:45:00,11882,-0.029127026251566632,29.82,IS,0.27,0.0,Phase3-EA-S1v2-USDJPY-M15-0,USDJPYMT4,3388,2h 45m,Buy
137334.27,0.94732,02.07.2015 01:59:57,tp 0.94732,-9.73,-14.71999999997206,0.0,0.0,0.94832,01.07.2015 22:45:00,11883,-0.006474627399915855,51.5,IS,0.58,0.0,Phase3-EA-SA2v2-USDCHF-M15-107,USDCHFMT4,2306,3h 14m,Sell
137284.41,192518,02.07.2015 04:55:00,,-3.25,-64.57999999995809,0.0,0.0,192268,01.07.2015 23:30:00,11884,-0.028405668307546754,-49.86,IS,0.23,0.0,Phase3-EA-S4v1-GBPJPY-M5-194,GBPJPYMT4,2668,5h 25m,Sell
137242.41,1.56134,02.07.2015 12:59:57,sl 1.56134,0.0,-106.57999999995809,0.0,0.0,1.55834,02.07.2015 11:30:00,11885,-0.04687946931277651,-42.0,IS,0.14,0.0,Phase3-EA-B1v1-GBPUSD-M30-14,GBPUSDMT4,790,1h 29m,Sell
137385.93,1.05113,02.07.2015 13:44:58,tp 1.05113,0.0,-0.0,0.0,0.0,1.04713,02.07.2015 06:30:00,11886,-0.0,143.52,IS,0.34,0.0,Phase3-EA-S4v1-EURCHF-M15-221,EURCHFMT4,3130,7h 14m,Buy
137337.14,192151,02.07.2015 16:59:58,sl 192.151,0.0,-48.79000000000815,0.0,0.0,192821,02.07.2015 13:30:00,11887,-0.021456912483550673,-48.79,IS,0.09,0.0,Phase3-EA-B1v1-GBPJPY-M30-1,GBPJPYMT4,1104,3h 29m,Buy
137349.32,123034,03.07.2015 00:15:00,,-0.99,-36.610000000015134,0.0,0.0,123094,02.07.2015 22:45:00,11888,-0.016100380529267957,12.18,IS,0.27,0.0,Phase3-EA-S1v2-USDJPY-M15-0,USDJPYMT4,3390,1h 30m,Sell
137307.99,0.9432,03.07.2015 03:30:00,,-0.74,-77.94000000000233,0.0,0.0,0.94386,02.07.2015 23:15:00,11889,-0.03427652713604653,-41.33,IS,0.58,0.0,Phase3-EA-SA2v2-USDCHF-M15-107,USDCHFMT4,2308,4h 15m,Buy
137289.91,191864,03.07.2015 04:50:00,,-0.67,-96.01999999998952,0.0,0.0,191957,02.07.2015 23:25:00,11890,-0.04222776668723031,-18.08,IS,0.23,0.0,Phase3-EA-S4v1-GBPJPY-M5-194,GBPJPYMT4,2670,5h 25m,Buy
137270.61,1.04592,03.07.2015 06:45:00,,-1.04,-115.31999999997788,0.0,0.0,1.04634,02.07.2015 22:25:00,11891,-0.05071553899574043,-19.3,IS,0.41,0.0,Phase3-EA-SA2v2-EURCHF-M5-43,EURCHFMT4,6042,8h 20m,Buy
137243.9,1.04501,03.07.2015 10:15:00,,0.0,-142.02999999996973,0.0,0.0,1.04575,03.07.2015 01:30:00,11892,-0.062462088133583595,-26.71,IS,0.34,0.0,Phase3-EA-S4v1-EURCHF-M15-221,EURCHFMT4,3132,8h 45m,Buy
137250.5,122731,03.07.2015 23:45:00,,0.0,-135.4299999999639,0.0,0.0,122761,03.07.2015 22:00:00,11893,-0.059559533872638,6.6,IS,0.27,0.0,Phase3-EA-S1v2-USDJPY-M15-0,USDJPYMT4,3392,1h 45m,Sell
137192.65,135631,06.07.2015 01:00:00,sl 135.631,-0.72,-193.27999999996973,0.0,0.0,136411,02.07.2015 06:00:00,11894,-0.08500086175075491,-57.85,IS,0.09,0.0,Phase3-EA-TR1v1-EURJPY-M30-91,EURJPYMT4,2126,3d 19h 0m,Buy
136977.83,1.03909,06.07.2015 01:05:00,sl 1.03909,-1.05,-408.0999999999767,0.0,0.0,1.04399,03.07.2015 22:20:00,11895,-0.17947460513496757,-214.82,IS,0.41,0.0,Phase3-EA-SA2v2-EURCHF-M5-43,EURCHFMT4,6044,2d 2h 45m,Buy
136945.78,134.18,06.07.2015 01:29:57,sl 134.180,0.0,-440.1499999999651,0.0,0.0,133.95,06.07.2015 01:00:00,11896,-0.1935695845384813,-32.05,IS,0.17,0.0,Phase3-EA-T1v2-EURJPY-M15-322,EURJPYMT4,2226,29m 57s,Sell
136993.7,1.03789,06.07.2015 02:04:58,tp 1.03789,0.0,-392.22999999995227,0.0,0.0,1.03679,06.07.2015 01:15:00,11897,-0.17249528148023469,47.92,IS,0.41,0.0,Phase3-EA-SA2v2-EURCHF-M5-43,EURCHFMT4,6046,49m 58s,Buy
137055.22,0.94275,06.07.2015 02:14:57,tp 0.94275,0.0,-330.70999999996275,0.0,0.0,0.94375,06.07.2015 01:45:00,11898,-0.14543995752066116,61.52,IS,0.58,0.0,Phase3-EA-SA2v2-USDCHF-M15-107,USDCHFMT4,2310,29m 57s,Sell
137199.49,1.04355,06.07.2015 10:44:58,tp 1.04355,0.0,-186.43999999997322,0.0,0.0,1.03955,06.07.2015 02:15:00,11899,-0.08199276006214275,144.27,IS,0.34,0.0,Phase3-EA-S4v1-EURCHF-M15-221,EURCHFMT4,3134,8h 29m,Buy
137167.63,135405,07.07.2015 05:59:57,sl 135.405,0.0,-218.29999999995925,0.0,0.0,135635,07.07.2015 04:45:00,11900,-0.09600418108541618,-31.86,IS,0.17,0.0,Phase3-EA-T1v2-EURJPY-M15-322,EURJPYMT4,2228,1h 14m,Buy
137128.34,1.04108,07.07.2015 06:35:00,,-1.04,-257.5899999999674,0.0,0.0,1.04196,06.07.2015 22:15:00,11901,-0.11328317455700339,-39.29,IS,0.41,0.0,Phase3-EA-SA2v2-EURCHF-M5-43,EURCHFMT4,6048,8h 20m,Buy
137116.01,122616,07.07.2015 08:30:00,,0.0,-269.9199999999546,0.0,0.0,122.56,07.07.2015 01:00:00,11902,-0.1187056736535777,-12.33,IS,0.27,0.0,Phase3-EA-S1v2-USDJPY-M15-0,USDJPYMT4,3394,7h 30m,Sell
137352.45,133.66,07.07.2015 18:29:58,tp 133.660,0.0,-33.47999999995227,0.0,0.0,135.36,07.07.2015 06:15:00,11903,-0.014723866160035508,236.44,IS,0.17,0.0,Phase3-EA-T1v2-EURJPY-M15-322,EURJPYMT4,2230,12h 14m,Sell
137400.01,1.03818,07.07.2015 20:39:58,tp 1.03818,0.0,-0.0,0.0,0.0,1.03928,07.07.2015 20:20:00,11904,-0.0,47.56,IS,0.41,0.0,Phase3-EA-SA2v2-EURCHF-M5-43,EURCHFMT4,6050,19m 58s,Sell
137347.08,134482,07.07.2015 23:29:57,sl 134.482,0.0,-52.929999999993015,0.0,0.0,133762,07.07.2015 16:30:00,11905,-0.023276164323824185,-52.93,IS,0.09,0.0,Phase3-EA-TR1v1-EURJPY-M30-91,EURJPYMT4,2128,6h 59m,Sell
137297.82,189621,07.07.2015 23:29:58,sl 189.621,0.0,-102.19000000000233,0.0,0.0,188951,07.07.2015 18:00:00,11906,-0.044938432500509384,-49.26,IS,0.09,0.0,Phase3-EA-B1v1-GBPJPY-M30-1,GBPJPYMT4,1106,5h 29m,Sell
137369.97,189233,08.07.2015 01:24:58,tp 189.233,-1.09,-30.04000000000815,0.0,0.0,189623,07.07.2015 23:45:00,11907,-0.013210201705799366,72.15,IS,0.23,0.0,Phase3-EA-S4v1-GBPJPY-M5-194,GBPJPYMT4,2672,1h 39m,Sell
137366.78,0.94653,08.07.2015 03:15:00,,-0.74,-33.23000000001048,0.0,0.0,0.94657,07.07.2015 23:00:00,11908,-0.014613016068033698,-3.19,IS,0.58,0.0,Phase3-EA-SA2v2-USDCHF-M15-107,USDCHFMT4,2312,4h 15m,Buy
137440.08,189039,08.07.2015 04:59:58,tp 189.039,0.0,-0.0,0.0,0.0,189429,08.07.2015 03:25:00,11909,-0.0,73.3,IS,0.23,0.0,Phase3-EA-S4v1-GBPJPY-M5-194,GBPJPYMT4,2674,1h 34m,Sell
137408.07,134393,08.07.2015 06:29:58,sl 134.393,0.0,-32.01000000000931,0.0,0.0,134163,08.07.2015 05:45:00,11910,-0.01407403655503862,-32.01,IS,0.17,0.0,Phase3-EA-T1v2-EURJPY-M15-322,EURJPYMT4,2232,44m 58s,Sell
137455.64,1.04774,08.07.2015 21:29:57,tp 1.04774,0.0,-0.0,0.0,0.0,1.04664,08.07.2015 21:15:00,11911,-0.0,47.57,IS,0.41,0.0,Phase3-EA-SA2v2-EURCHF-M5-43,EURCHFMT4,6052,14m 57s,Buy
137500.22,1.04738,09.07.2015 00:34:57,tp 1.04738,-3.12,-0.0,0.0,0.0,1.04628,08.07.2015 23:05:00,11912,-0.0,44.58,IS,0.41,0.0,Phase3-EA-SA2v2-EURCHF-M5-43,EURCHFMT4,6054,1h 29m,Buy
137552.43,120493,09.07.2015 02:15:00,,0.0,-0.0,0.0,0.0,120726,09.07.2015 00:45:00,11913,-0.0,52.21,IS,0.27,0.0,Phase3-EA-S1v2-USDJPY-M15-0,USDJPYMT4,3396,1h 30m,Sell
137561.88,0.94549,09.07.2015 03:30:00,,-2.21,-0.0,0.0,0.0,0.9453,08.07.2015 23:15:00,11914,-0.0,9.45,IS,0.58,0.0,Phase3-EA-SA2v2-USDCHF-M15-107,USDCHFMT4,2314,4h 15m,Buy
137409.99,186376,09.07.2015 06:14:58,sl 186.376,0.0,-151.89000000001397,0.0,0.0,185576,09.07.2015 03:20:00,11915,-0.06674668006786236,-151.89,IS,0.23,0.0,Phase3-EA-S4v1-GBPJPY-M5-194,GBPJPYMT4,2676,2h 54m,Sell
137505.68,134943,09.07.2015 09:29:58,tp 134.943,0.0,-56.20000000001164,0.0,0.0,133653,09.07.2015 01:30:00,11916,-0.02469657923375006,95.69,IS,0.09,0.0,Phase3-EA-TR1v1-EURJPY-M30-91,EURJPYMT4,2130,7h 59m,Buy
137607.2,1.04924,09.07.2015 14:00:00,,0.0,-0.0,0.0,0.0,1.0464,09.07.2015 05:15:00,11917,-0.0,101.52,IS,0.34,0.0,Phase3-EA-S4v1-EURCHF-M15-221,EURCHFMT4,3136,8h 45m,Buy
137653.75,1.04712,10.07.2015 01:09:58,tp 1.04712,-1.04,-0.0,0.0,0.0,1.04602,09.07.2015 20:20:00,11918,-0.0,46.55,IS,0.41,0.0,Phase3-EA-SA2v2-EURCHF-M5-43,EURCHFMT4,6056,4h 49m,Buy
137563.26,187063,10.07.2015 05:00:00,,-1.1,-90.48999999999069,0.0,0.0,186.59,09.07.2015 23:35:00,11919,-0.03974896086710193,-90.49,IS,0.23,0.0,Phase3-EA-S4v1-GBPJPY-M5-194,GBPJPYMT4,2678,5h 25m,Sell
137511.97,187377,10.07.2015 05:59:58,sl 187.377,-1.73,-141.77999999999884,0.0,0.0,186707,08.07.2015 16:00:00,11920,-0.0622787896092192,-51.29,IS,0.09,0.0,Phase3-EA-B1v1-GBPJPY-M30-1,GBPJPYMT4,1108,1d 13h 59m,Sell
137371.87,1.05055,10.07.2015 09:14:58,sl 1.05055,0.0,-281.88000000000466,0.0,0.0,1.04665,10.07.2015 01:45:00,11921,-0.12381961641308466,-140.1,IS,0.34,0.0,Phase3-EA-S4v1-EURCHF-M15-221,EURCHFMT4,3138,7h 29m,Sell
137159.57,1.05067,10.07.2015 09:24:57,sl 1.05067,0.0,-494.179999999993,0.0,0.0,1.04577,10.07.2015 01:15:00,11922,-0.21707527330430076,-212.3,IS,0.41,0.0,Phase3-EA-SA2v2-EURCHF-M5-43,EURCHFMT4,6058,8h 9m,Sell
137252.34,136581,10.07.2015 13:59:58,tp 136.581,0.0,-401.4100000000035,0.0,0.0,135321,10.07.2015 08:00:00,11923,-0.17632479148707222,92.77,IS,0.09,0.0,Phase3-EA-TR1v1-EURJPY-M30-91,EURJPYMT4,2132,5h 59m,Buy
137300.34,1.04853,10.07.2015 20:34:57,tp 1.04853,0.0,-353.4100000000035,0.0,0.0,1.04963,10.07.2015 20:15:00,11924,-0.15524013990544897,48.0,IS,0.41,0.0,Phase3-EA-SA2v2-EURCHF-M5-43,EURCHFMT4,6060,19m 57s,Sell
137250.96,189856,13.07.2015 01:00:00,sl 189.856,-0.26,-402.79000000000815,0.0,0.0,190526,10.07.2015 23:30:00,11925,-0.17693097522004594,-49.38,IS,0.09,0.0,Phase3-EA-B1v1-GBPJPY-M30-1,GBPJPYMT4,1110,2d 1h 30m,Buy
137197.81,136325,13.07.2015 01:00:00,sl 136.325,-0.36,-455.9400000000023,0.0,0.0,137045,10.07.2015 19:00:00,11926,-0.20027783421094497,-53.15,IS,0.09,0.0,Phase3-EA-TR1v1-EURJPY-M30-91,EURJPYMT4,2134,2d 6h 0m,Buy
137269.79,190149,13.07.2015 01:05:00,tp 190.149,-1.09,-383.95999999999185,0.0,0.0,190539,10.07.2015 23:15:00,11927,-0.16865964210999781,71.98,IS,0.23,0.0,Phase3-EA-S4v1-GBPJPY-M5-194,GBPJPYMT4,2680,2d 1h 50m,Sell
137357.8,122707,13.07.2015 02:29:57,tp 122.707,0.0,-295.94999999998254,0.0,0.0,122307,13.07.2015 01:00:00,11928,-0.13000005490793826,88.01,IS,0.27,0.0,Phase3-EA-S1v2-USDJPY-M15-0,USDJPYMT4,3398,1h 29m,Buy
137321.43,1.04684,13.07.2015 07:35:00,,-1.05,-332.3199999999779,0.0,0.0,1.04765,10.07.2015 23:15:00,11929,-0.145976071116762,-36.37,IS,0.41,0.0,Phase3-EA-SA2v2-EURCHF-M5-43,EURCHFMT4,6062,2d 8h 20m,Buy
137422.63,1.0478,13.07.2015 09:45:00,,0.0,-231.11999999996624,0.0,0.0,1045,13.07.2015 01:00:00,11930,-0.10152259736550118,101.2,IS,0.34,0.0,Phase3-EA-S4v1-EURCHF-M15-221,EURCHFMT4,3140,8h 45m,Buy
137390.74,136367,13.07.2015 10:44:57,sl 136.367,0.0,-263.0099999999802,0.0,0.0,136597,13.07.2015 08:15:00,11931,-0.11553071276004827,-31.89,IS,0.17,0.0,Phase3-EA-T1v2-EURJPY-M15-322,EURJPYMT4,2234,2h 29m,Buy
137403.87,123353,13.07.2015 20:00:00,,0.0,-249.87999999997555,0.0,0.0,123413,13.07.2015 17:00:00,11932,-0.10976318202532302,13.13,IS,0.27,0.0,Phase3-EA-S1v2-USDJPY-M15-0,USDJPYMT4,3400,3h 0m,Sell
137386.58,0.94979,14.07.2015 03:30:00,,-3.24,-267.1699999999837,0.0,0.0,0.94956,13.07.2015 23:15:00,11933,-0.11735804923045715,-17.29,IS,0.58,0.0,Phase3-EA-SA2v2-USDCHF-M15-107,USDCHFMT4,2316,4h 15m,Sell
137432.94,1.04614,14.07.2015 04:39:58,tp 1.04614,-1.04,-220.80999999999767,0.0,0.0,1.04504,13.07.2015 21:15:00,11934,-0.09699378991121216,46.36,IS,0.41,0.0,Phase3-EA-SA2v2-EURCHF-M5-43,EURCHFMT4,6064,7h 24m,Buy
137462.38,191177,14.07.2015 08:30:00,,0.0,-191.36999999999534,0.0,0.0,191335,14.07.2015 03:05:00,11935,-0.0840618702744822,29.44,IS,0.23,0.0,Phase3-EA-S4v1-GBPJPY-M5-194,GBPJPYMT4,2682,5h 25m,Sell
137322.66,1.04065,14.07.2015 11:44:58,sl 1.04065,0.0,-331.0899999999965,0.0,0.0,1.04455,14.07.2015 04:15:00,11936,-0.14543577691999107,-139.72,IS,0.34,0.0,Phase3-EA-S4v1-EURCHF-M15-221,EURCHFMT4,3142,7h 29m,Buy
137290.97,135894,14.07.2015 12:29:58,sl 135.894,0.0,-362.77999999999884,0.0,0.0,135664,14.07.2015 09:30:00,11937,-0.15935603959960964,-31.69,IS,0.17,0.0,Phase3-EA-T1v2-EURJPY-M15-322,EURJPYMT4,2236,2h 59m,Sell
137352.3,0.94567,15.07.2015 04:14:58,tp 0.94567,0.0,-301.45000000001164,0.0,0.0,0.94467,15.07.2015 01:15:00,11938,-0.13241600456834537,61.33,IS,0.58,0.0,Phase3-EA-SA2v2-USDCHF-M15-107,USDCHFMT4,2318,2h 59m,Buy
137365.21,123416,15.07.2015 05:45:00,,0.0,-288.54000000000815,0.0,0.0,123357,15.07.2015 00:15:00,11939,-0.12674511182003642,12.91,IS,0.27,0.0,Phase3-EA-S1v2-USDJPY-M15-0,USDJPYMT4,3402,5h 30m,Buy
137354.2,1.04,15.07.2015 06:50:00,,-1.04,-299.55000000001746,0.0,0.0,1.04023,14.07.2015 22:30:00,11940,-0.13158140377657535,-11.01,IS,0.41,0.0,Phase3-EA-SA2v2-EURCHF-M5-43,EURCHFMT4,6066,8h 20m,Buy
137322.52,135.88,15.07.2015 10:14:58,sl 135.880,0.0,-331.2300000000105,0.0,0.0,135.65,15.07.2015 09:30:00,11941,-0.1454972738204436,-31.68,IS,0.17,0.0,Phase3-EA-T1v2-EURJPY-M15-322,EURJPYMT4,2238,44m 58s,Sell
137353.51,123948,16.07.2015 03:00:00,,-1.9,-300.2400000000198,0.0,0.0,123797,15.07.2015 21:45:00,11942,-0.1318844956430622,30.99,IS,0.27,0.0,Phase3-EA-S1v2-USDJPY-M15-0,USDJPYMT4,3404,5h 15m,Buy
137304.35,1.04149,16.07.2015 05:20:00,,-3.1,-349.4000000000233,0.0,0.0,1.04256,15.07.2015 21:00:00,11943,-0.1534786929712429,-49.16,IS,0.41,0.0,Phase3-EA-SA2v2-EURCHF-M5-43,EURCHFMT4,6068,8h 20m,Buy
137328.31,193478,16.07.2015 07:50:00,,0.0,-325.44000000003143,0.0,0.0,193607,16.07.2015 02:25:00,11944,-0.14295393772341952,23.96,IS,0.23,0.0,Phase3-EA-S4v1-GBPJPY-M5-194,GBPJPYMT4,2684,5h 25m,Sell
137334.71,1.04148,16.07.2015 15:00:00,,0.0,-319.04000000003725,0.0,0.0,1.0413,16.07.2015 06:15:00,11945,-0.14014265084587232,6.4,IS,0.34,0.0,Phase3-EA-S4v1-EURCHF-M15-221,EURCHFMT4,3144,8h 45m,Buy
137380.77,1.04241,17.07.2015 05:39:58,tp 1.04241,-1.03,-272.9800000000396,0.0,0.0,1.04131,16.07.2015 23:15:00,11946,-0.11991017059900734,46.06,IS,0.41,0.0,Phase3-EA-SA2v2-EURCHF-M5-43,EURCHFMT4,6070,6h 24m,Buy
137332.19,193601,17.07.2015 14:59:59,sl 193.601,0.0,-321.5600000000268,0.0,0.0,194271,17.07.2015 11:00:00,11947,-0.14124959505390294,-48.58,IS,0.09,0.0,Phase3-EA-B1v1-GBPJPY-M30-1,GBPJPYMT4,1112,3h 59m,Buy
137422.06,134577,17.07.2015 17:59:57,tp 134.577,-1.53,-231.69000000003143,0.0,0.0,135837,13.07.2015 21:30:00,11948,-0.10177297760306159,89.87,IS,0.09,0.0,Phase3-EA-TR1v1-EURJPY-M30-91,EURJPYMT4,2136,3d 20h 29m,Sell
137377.4,1.5553,17.07.2015 17:59:58,sl 1.55530,-2.66,-276.3500000000349,0.0,0.0,1.5583,14.07.2015 14:00:00,11949,-0.1213904888454651,-44.66,IS,0.14,0.0,Phase3-EA-B1v1-GBPUSD-M30-14,GBPUSDMT4,792,3d 3h 59m,Buy
137422.18,1.04113,20.07.2015 01:29:57,tp 1.04113,-2.13,-231.5700000000361,0.0,0.0,1.04223,17.07.2015 22:40:00,11950,-0.10172026597410957,44.78,IS,0.41,0.0,Phase3-EA-SA2v2-EURCHF-M5-43,EURCHFMT4,6072,2d 2h 49m,Sell
137469.1,1.04233,20.07.2015 02:04:57,tp 1.04233,0.0,-184.65000000002328,0.0,0.0,1.04123,20.07.2015 01:40:00,11951,-0.08111001905306721,46.92,IS,0.41,0.0,Phase3-EA-SA2v2-EURCHF-M5-43,EURCHFMT4,6074,24m 57s,Buy
137500.52,1.04256,20.07.2015 09:45:00,,0.0,-153.23000000001048,0.0,0.0,1.04167,20.07.2015 01:00:00,11952,-0.0673083575385907,31.42,IS,0.34,0.0,Phase3-EA-S4v1-EURCHF-M15-221,EURCHFMT4,3146,8h 45m,Buy
137539.26,1.04339,20.07.2015 10:25:00,,0.0,-114.49000000001979,0.0,0.0,1.04248,20.07.2015 02:05:00,11953,-0.05029128665792634,38.74,IS,0.41,0.0,Phase3-EA-SA2v2-EURCHF-M5-43,EURCHFMT4,6076,8h 20m,Buy
137496.53,1.04315,21.07.2015 06:40:00,,-1.02,-157.22000000003027,0.0,0.0,1.04413,20.07.2015 22:20:00,11954,-0.06906101920132182,-42.73,IS,0.41,0.0,Phase3-EA-SA2v2-EURCHF-M5-43,EURCHFMT4,6078,8h 20m,Buy
137465.51,1.04308,21.07.2015 09:45:00,,0.0,-188.2400000000198,0.0,0.0,1.04396,21.07.2015 01:00:00,11955,-0.08268697528594125,-31.02,IS,0.34,0.0,Phase3-EA-S4v1-EURCHF-M15-221,EURCHFMT4,3148,8h 45m,Buy
137432.48,135744,21.07.2015 21:14:57,sl 135.744,-1.44,-221.27000000001863,0.0,0.0,135514,16.07.2015 04:45:00,11956,-0.09719585115554524,-33.03,IS,0.17,0.0,Phase3-EA-T1v2-EURJPY-M15-322,EURJPYMT4,2240,5d 16h 29m,Sell
137525.91,135738,21.07.2015 21:29:57,tp 135.738,-0.35,-127.84000000002561,0.0,0.0,134448,20.07.2015 10:00:00,11957,-0.05615545537906787,93.43,IS,0.09,0.0,Phase3-EA-TR1v1-EURJPY-M30-91,EURJPYMT4,2138,1d 11h 29m,Buy
137583.26,0.95772,22.07.2015 01:14:58,tp 0.95772,-3.21,-70.49000000001979,0.0,0.0,0.95872,21.07.2015 23:30:00,11958,-0.03096368937477169,57.35,IS,0.58,0.0,Phase3-EA-SA2v2-USDCHF-M15-107,USDCHFMT4,2320,1h 44m,Sell
137621.55,123766,22.07.2015 04:45:00,,-0.98,-32.20000000001164,0.0,0.0,123946,21.07.2015 23:15:00,11959,-0.014144287102677386,38.29,IS,0.27,0.0,Phase3-EA-S1v2-USDJPY-M15-0,USDJPYMT4,3406,5h 30m,Sell
137597.14,1.04841,22.07.2015 04:45:00,,-2.14,-56.610000000015134,0.0,0.0,1.04789,21.07.2015 20:25:00,11960,-0.024866710959083584,-24.41,IS,0.41,0.0,Phase3-EA-SA2v2-EURCHF-M5-43,EURCHFMT4,6080,8h 20m,Sell
137565.52,135.33,22.07.2015 05:59:58,sl 135.330,0.0,-88.23000000001048,0.0,0.0,135.56,22.07.2015 05:00:00,11961,-0.03875622518847586,-31.62,IS,0.17,0.0,Phase3-EA-T1v2-EURJPY-M15-322,EURJPYMT4,2242,59m 58s,Buy
137560.07,0.95813,22.07.2015 06:15:00,,0.0,-93.68000000002212,0.0,0.0,0.95822,22.07.2015 02:00:00,11962,-0.041150211670144446,-5.45,IS,0.58,0.0,Phase3-EA-SA2v2-USDCHF-M15-107,USDCHFMT4,2322,4h 15m,Buy
137511.28,193106,22.07.2015 10:59:58,sl 193.106,0.0,-142.47000000003027,0.0,0.0,192436,22.07.2015 06:00:00,11963,-0.06258188147571885,-48.79,IS,0.09,0.0,Phase3-EA-B1v1-GBPJPY-M30-1,GBPJPYMT4,1114,4h 59m,Sell
137544.61,1.0484,22.07.2015 15:30:00,,0.0,-109.14000000004307,0.0,0.0,1.04746,22.07.2015 06:45:00,11964,-0.04794122653373481,33.33,IS,0.34,0.0,Phase3-EA-S4v1-EURCHF-M15-221,EURCHFMT4,3150,8h 45m,Buy
137556.64,124108,23.07.2015 04:15:00,,-1.89,-97.11000000004424,0.0,0.0,124044,22.07.2015 23:15:00,11965,-0.04265688573109099,12.03,IS,0.27,0.0,Phase3-EA-S1v2-USDJPY-M15-0,USDJPYMT4,3408,5h 0m,Buy
137539.11,0.9594,23.07.2015 05:45:00,,0.0,-114.64000000004307,0.0,0.0,0.95969,23.07.2015 01:30:00,11966,-0.05035717619412915,-17.53,IS,0.58,0.0,Phase3-EA-SA2v2-USDCHF-M15-107,USDCHFMT4,2324,4h 15m,Buy
137516.3,193709,23.07.2015 08:35:00,,0.0,-137.45000000004075,0.0,0.0,193586,23.07.2015 03:10:00,11967,-0.06037677833114534,-22.81,IS,0.23,0.0,Phase3-EA-S4v1-GBPJPY-M5-194,GBPJPYMT4,2686,5h 25m,Sell
137486.52,1.04939,23.07.2015 10:00:00,,0.0,-167.23000000003958,0.0,0.0,1.04855,23.07.2015 01:15:00,11968,-0.07345804758324359,-29.78,IS,0.34,0.0,Phase3-EA-S4v1-EURCHF-M15-221,EURCHFMT4,3152,8h 45m,Sell
137489.13,136147,23.07.2015 23:00:00,,0.0,-164.62000000005355,0.0,0.0,136128,23.07.2015 21:30:00,11969,-0.07231156965349897,2.61,IS,0.17,0.0,Phase3-EA-T1v2-EURJPY-M15-322,EURJPYMT4,2244,1h 30m,Buy
137549.61,0.95899,24.07.2015 01:00:00,tp 0.95899,0.0,-104.14000000004307,0.0,0.0,0.95999,24.07.2015 00:45:00,11970,-0.04574490866064906,60.48,IS,0.58,0.0,Phase3-EA-SA2v2-USDCHF-M15-107,USDCHFMT4,2326,15m 0s,Sell
137594.52,1.05249,24.07.2015 01:04:57,tp 1.05249,-2.14,-59.23000000003958,0.0,0.0,1.05359,23.07.2015 22:00:00,11971,-0.026017581524591257,44.91,IS,0.41,0.0,Phase3-EA-SA2v2-EURCHF-M5-43,EURCHFMT4,6082,3h 4m,Sell
137562.96,136012,24.07.2015 06:14:58,sl 136.012,0.0,-90.79000000003725,0.0,0.0,136242,24.07.2015 04:15:00,11972,-0.03988073993950753,-31.56,IS,0.17,0.0,Phase3-EA-T1v2-EURJPY-M15-322,EURJPYMT4,2246,1h 59m,Buy
137554.68,123925,24.07.2015 07:45:00,,0.0,-99.07000000003609,0.0,0.0,123887,24.07.2015 01:30:00,11973,-0.04351784233733703,-8.28,IS,0.27,0.0,Phase3-EA-S1v2-USDJPY-M15-0,USDJPYMT4,3410,6h 15m,Sell
137517.86,1.05387,24.07.2015 09:45:00,,0.0,-135.89000000004307,0.0,0.0,1.05283,24.07.2015 01:00:00,11974,-0.05969152715474361,-36.82,IS,0.34,0.0,Phase3-EA-S4v1-EURCHF-M15-221,EURCHFMT4,3154,8h 45m,Sell
137578.14,0.96222,24.07.2015 23:29:58,tp 0.96222,0.0,-75.61000000004424,0.0,0.0,0.96322,24.07.2015 22:00:00,11975,-0.03321271887682224,60.28,IS,0.58,0.0,Phase3-EA-SA2v2-USDCHF-M15-107,USDCHFMT4,2328,1h 29m,Sell
137586.98,123.73,27.07.2015 01:30:00,,-0.98,-66.77000000004773,0.0,0.0,123775,24.07.2015 23:15:00,11976,-0.029329628877208157,8.84,IS,0.27,0.0,Phase3-EA-S1v2-USDJPY-M15-0,USDJPYMT4,3412,2d 2h 15m,Sell
137606.61,1.05598,27.07.2015 04:55:00,,-2.13,-47.140000000043074,0.0,0.0,1.05649,24.07.2015 20:35:00,11977,-0.020706884907471433,19.63,IS,0.41,0.0,Phase3-EA-SA2v2-EURCHF-M5-43,EURCHFMT4,6084,2d 8h 20m,Sell
137490.12,0.96091,27.07.2015 06:15:00,,0.0,-163.63000000003376,0.0,0.0,0.96284,27.07.2015 02:00:00,11978,-0.0718766987146193,-116.49,IS,0.58,0.0,Phase3-EA-SA2v2-USDCHF-M15-107,USDCHFMT4,2330,4h 15m,Buy
137562.74,191719,27.07.2015 06:44:59,tp 191.719,0.0,-91.01000000003842,0.0,0.0,192109,27.07.2015 03:00:00,11979,-0.03997737792592381,72.62,IS,0.23,0.0,Phase3-EA-S4v1-GBPJPY-M5-194,GBPJPYMT4,2688,3h 44m,Sell
137531.09,136014,27.07.2015 10:14:59,sl 136.014,0.0,-122.6600000000326,0.0,0.0,135784,27.07.2015 04:30:00,11980,-0.053880070062554096,-31.65,IS,0.17,0.0,Phase3-EA-T1v2-EURJPY-M15-322,EURJPYMT4,2248,5h 44m,Sell
137489.09,1.54956,27.07.2015 11:29:58,sl 1.54956,0.0,-164.6600000000326,0.0,0.0,1.55256,27.07.2015 08:00:00,11981,-0.07232914019647445,-42.0,IS,0.14,0.0,Phase3-EA-B1v1-GBPUSD-M30-14,GBPUSDMT4,794,3h 29m,Buy
137578.81,136623,27.07.2015 11:29:58,tp 136.623,-2.15,-74.94000000003143,0.0,0.0,135363,21.07.2015 19:30:00,11982,-0.03291841228182312,89.72,IS,0.09,0.0,Phase3-EA-TR1v1-EURJPY-M30-91,EURJPYMT4,2139,5d 15h 59m,Buy
137623.54,1.0653,28.07.2015 01:00:00,tp 1.06530,-2.13,-30.210000000020955,0.0,0.0,1.0664,27.07.2015 20:00:00,11983,-0.013270152589193345,44.73,IS,0.41,0.0,Phase3-EA-SA2v2-EURCHF-M5-43,EURCHFMT4,6086,5h 0m,Sell
137680.66,0.96173,28.07.2015 01:14:57,tp 0.96173,-3.19,-0.0,0.0,0.0,0.96273,27.07.2015 22:30:00,11984,-0.0,57.12,IS,0.58,0.0,Phase3-EA-SA2v2-USDCHF-M15-107,USDCHFMT4,2332,2h 44m,Sell
137685.37,123178,28.07.2015 04:30:00,,-0.99,-0.0,0.0,0.0,123204,27.07.2015 19:30:00,11985,-0.0,4.71,IS,0.27,0.0,Phase3-EA-S1v2-USDJPY-M15-0,USDJPYMT4,3414,9h 0m,Sell
137758.24,191441,28.07.2015 05:34:57,tp 191.441,0.0,-0.0,0.0,0.0,191831,28.07.2015 03:20:00,11986,-0.0,72.87,IS,0.23,0.0,Phase3-EA-S4v1-GBPJPY-M5-194,GBPJPYMT4,2690,2h 14m,Sell
137721.17,1.06635,28.07.2015 09:25:00,,0.0,-37.070000000006985,0.0,0.0,1.06722,28.07.2015 01:05:00,11987,-0.016276030232762043,-37.07,IS,0.41,0.0,Phase3-EA-SA2v2-EURCHF-M5-43,EURCHFMT4,6088,8h 20m,Buy
137729.98,1.0669,28.07.2015 12:15:00,,0.0,-28.260000000009313,0.0,0.0,1.06665,28.07.2015 03:30:00,11988,-0.012407893562932835,8.81,IS,0.34,0.0,Phase3-EA-S4v1-EURCHF-M15-221,EURCHFMT4,3156,8h 45m,Buy
137698.37,136533,28.07.2015 14:14:57,sl 136.533,0.0,-59.86999999999534,0.0,0.0,136763,28.07.2015 07:45:00,11989,-0.026286644996903266,-31.61,IS,0.17,0.0,Phase3-EA-T1v2-EURJPY-M15-322,EURJPYMT4,2250,6h 29m,Buy
137743.11,1.06345,29.07.2015 01:04:58,tp 1.06345,-2.13,-15.130000000004657,0.0,0.0,1.06455,28.07.2015 23:25:00,11990,-0.0066430088325254676,44.74,IS,0.41,0.0,Phase3-EA-SA2v2-EURCHF-M5-43,EURCHFMT4,6090,1h 39m,Sell
137756.33,123564,29.07.2015 04:30:00,,-0.98,-1.9100000000034925,0.0,0.0,123629,28.07.2015 23:15:00,11991,-8.386085175243184E-4,13.22,IS,0.27,0.0,Phase3-EA-S1v2-USDJPY-M15-0,USDJPYMT4,3416,5h 15m,Sell
137724.71,136533,29.07.2015 15:59:58,sl 136.533,0.0,-33.529999999998836,0.0,0.0,136763,29.07.2015 13:15:00,11992,-0.014721750572009428,-31.62,IS,0.17,0.0,Phase3-EA-T1v2-EURJPY-M15-322,EURJPYMT4,2252,2h 44m,Buy
137693.13,136724,29.07.2015 21:14:58,sl 136.724,0.0,-65.10999999998603,0.0,0.0,136494,29.07.2015 16:00:00,11993,-0.028587330144448597,-31.58,IS,0.17,0.0,Phase3-EA-T1v2-EURJPY-M15-322,EURJPYMT4,2254,5h 14m,Sell
137733.4,1.06179,30.07.2015 01:04:58,tp 1.06179,-6.35,-24.839999999996508,0.0,0.0,1.06289,29.07.2015 21:15:00,11994,-0.010906301348305263,40.27,IS,0.41,0.0,Phase3-EA-SA2v2-EURCHF-M5-43,EURCHFMT4,6092,3h 49m,Sell
137740.78,124.38,30.07.2015 20:00:00,,0.0,-17.45999999999185,0.0,0.0,124346,30.07.2015 19:15:00,11995,-0.007666023411487431,7.38,IS,0.27,0.0,Phase3-EA-S1v2-USDJPY-M15-0,USDJPYMT4,3418,45m 0s,Buy
137787.23,1.05887,30.07.2015 20:39:58,tp 1.05887,0.0,-0.0,0.0,0.0,1.05777,30.07.2015 20:15:00,11996,-0.0,46.45,IS,0.41,0.0,Phase3-EA-SA2v2-EURCHF-M5-43,EURCHFMT4,6094,24m 58s,Buy
137833.78,1.05838,31.07.2015 01:04:58,tp 1.05838,0.0,-0.0,0.0,0.0,1.05948,31.07.2015 00:20:00,11997,-0.0,46.55,IS,0.41,0.0,Phase3-EA-SA2v2-EURCHF-M5-43,EURCHFMT4,6096,44m 58s,Sell
137758.27,124038,31.07.2015 10:15:00,,-0.63,-75.51000000000931,0.0,0.0,124382,30.07.2015 20:00:00,11998,-0.03314258315865575,-75.51,IS,0.27,0.0,Phase3-EA-S1v2-USDJPY-M15-0,USDJPYMT4,3420,14h 15m,Buy
137620.88,1.05479,31.07.2015 12:29:58,sl 1.05479,0.0,-212.90000000002328,0.0,0.0,1.05869,31.07.2015 05:30:00,11999,-0.09344531789799643,-137.39,IS,0.34,0.0,Phase3-EA-S4v1-EURCHF-M15-221,EURCHFMT4,3158,6h 59m,Buy
137568.49,136406,31.07.2015 13:59:57,sl 136.406,-0.25,-265.29000000003725,0.0,0.0,136334,27.07.2015 16:00:00,12000,-0.11644015211442106,-52.39,IS,0.09,0.0,Phase3-EA-TR1v1-EURJPY-M30-91,EURJPYMT4,2142,3d 21h 59m,Sell
137535.13,136728,31.07.2015 16:44:58,sl 136.728,-1.92,-298.6500000000233,0.0,0.0,136498,29.07.2015 22:30:00,12001,-0.13108240577846764,-33.36,IS,0.17,0.0,Phase3-EA-T1v2-EURJPY-M15-322,EURJPYMT4,2256,1d 18h 14m,Sell
137477.16,137114,31.07.2015 16:59:58,sl 137.114,-1.52,-356.62000000002445,0.0,0.0,135686,30.07.2015 21:00:00,12002,-0.1565263939350969,-57.97,IS,0.09,0.0,Phase3-EA-TR1v1-EURJPY-M30-91,EURJPYMT4,2143,19h 59m,Sell
137523.95,1.06316,31.07.2015 20:44:57,tp 1.06316,0.0,-309.8300000000163,0.0,0.0,1.06426,31.07.2015 20:20:00,12003,-0.13598949198841986,46.79,IS,0.41,0.0,Phase3-EA-SA2v2-EURCHF-M5-43,EURCHFMT4,6098,24m 57s,Sell
137580.85,0.9654,03.08.2015 01:00:00,tp 0.96540,-3.18,-252.93000000002212,0.0,0.0,0.9664,31.07.2015 23:15:00,12004,-0.11101514446190568,56.9,IS,0.58,0.0,Phase3-EA-SA2v2-USDCHF-M15-107,USDCHFMT4,2334,2d 1h 45m,Sell
137640.91,0.96572,03.08.2015 05:14:58,tp 0.96572,0.0,-192.87000000002445,0.0,0.0,0.96672,03.08.2015 02:30:00,12005,-0.08465382086889096,60.06,IS,0.58,0.0,Phase3-EA-SA2v2-USDCHF-M15-107,USDCHFMT4,2336,2h 44m,Sell
137587.27,1.06035,03.08.2015 06:40:00,,-1.02,-246.51000000003842,0.0,0.0,1.06159,31.07.2015 22:20:00,12006,-0.10819730068124082,-53.64,IS,0.41,0.0,Phase3-EA-SA2v2-EURCHF-M5-43,EURCHFMT4,6100,2d 8h 20m,Buy
137601.55,193774,03.08.2015 09:20:00,,0.0,-232.23000000003958,0.0,0.0,193851,03.08.2015 03:55:00,12007,-0.10192957339339144,14.28,IS,0.23,0.0,Phase3-EA-S4v1-GBPJPY-M5-194,GBPJPYMT4,2692,5h 25m,Sell
137599.09,1.06028,03.08.2015 14:00:00,,0.0,-234.69000000003143,0.0,0.0,1.06035,03.08.2015 05:15:00,12008,-0.10300930792616872,-2.46,IS,0.34,0.0,Phase3-EA-S4v1-EURCHF-M15-221,EURCHFMT4,3160,8h 45m,Buy
137564.83,124125,03.08.2015 17:30:00,,-0.98,-268.95000000004075,0.0,0.0,123972,31.07.2015 21:00:00,12009,-0.11804658641929168,-34.26,IS,0.27,0.0,Phase3-EA-S1v2-USDJPY-M15-0,USDJPYMT4,3422,2d 20h 30m,Sell
137611.33,1.06158,03.08.2015 22:29:58,tp 1.06158,0.0,-222.45000000004075,0.0,0.0,1.06048,03.08.2015 20:45:00,12010,-0.0976369702508729,46.5,IS,0.41,0.0,Phase3-EA-SA2v2-EURCHF-M5-43,EURCHFMT4,6102,1h 44m,Buy
137655.78,1.06065,04.08.2015 01:04:58,tp 1.06065,-2.11,-178.0000000000291,0.0,0.0,1.06175,03.08.2015 23:50:00,12011,-0.0781271328597664,44.45,IS,0.41,0.0,Phase3-EA-SA2v2-EURCHF-M5-43,EURCHFMT4,6104,1h 14m,Sell
137656.54,123973,04.08.2015 04:15:00,,-0.98,-177.2400000000198,0.0,0.0,123981,03.08.2015 23:30:00,12012,-0.07779355633743977,0.76,IS,0.27,0.0,Phase3-EA-S1v2-USDJPY-M15-0,USDJPYMT4,3424,4h 45m,Sell
137666.45,0.97792,05.08.2015 03:45:00,,-3.14,-167.3300000000163,0.0,0.0,0.97814,04.08.2015 23:30:00,12013,-0.07344389405294297,9.91,IS,0.58,0.0,Phase3-EA-SA2v2-USDCHF-M15-107,USDCHFMT4,2338,4h 15m,Sell
137566.17,1.06286,05.08.2015 06:05:00,,-1.01,-267.61000000001513,0.0,0.0,1.06523,04.08.2015 21:45:00,12014,-0.11745843834044858,-100.28,IS,0.41,0.0,Phase3-EA-SA2v2-EURCHF-M5-43,EURCHFMT4,6106,8h 20m,Buy
137619.26,1.06425,05.08.2015 15:30:00,,0.0,-214.52000000001863,0.0,0.0,1.06272,05.08.2015 06:45:00,12015,-0.0941563625903135,53.09,IS,0.34,0.0,Phase3-EA-S4v1-EURCHF-M15-221,EURCHFMT4,3162,8h 45m,Buy
137626.61,0.97916,06.08.2015 02:15:00,,-2.13,-207.1700000000128,0.0,0.0,979,05.08.2015 22:00:00,12016,-0.09093032648627056,7.35,IS,0.58,0.0,Phase3-EA-SA2v2-USDCHF-M15-107,USDCHFMT4,2340,4h 15m,Buy
137635.37,124783,06.08.2015 03:15:00,,-2.92,-198.4100000000035,0.0,0.0,124839,05.08.2015 23:45:00,12017,-0.08708541815002241,8.76,IS,0.27,0.0,Phase3-EA-S1v2-USDJPY-M15-0,USDJPYMT4,3426,3h 30m,Buy
137601.65,136367,06.08.2015 04:29:58,sl 136.367,-2.39,-232.13000000000466,0.0,0.0,136137,03.08.2015 15:15:00,12018,-0.10188568174570209,-33.72,IS,0.17,0.0,Phase3-EA-T1v2-EURJPY-M15-322,EURJPYMT4,2258,2d 13h 14m,Sell
137577.35,1.06786,06.08.2015 07:35:00,,-6.28,-256.429999999993,0.0,0.0,1.06743,05.08.2015 23:15:00,12019,-0.11255135213048358,-24.3,IS,0.41,0.0,Phase3-EA-SA2v2-EURCHF-M5-43,EURCHFMT4,6108,8h 20m,Sell
137570.49,124816,06.08.2015 11:00:00,,-1.88,-263.28999999997905,0.0,0.0,124837,05.08.2015 23:45:00,12020,-0.11556231916091514,-6.86,IS,0.27,0.0,Phase3-EA-S1v2-USDJPY-M15-0,USDJPYMT4,3427,11h 15m,Sell
137539.17,135.93,06.08.2015 12:59:59,sl 135.930,0.0,-294.60999999998603,0.0,0.0,136.16,06.08.2015 09:15:00,12021,-0.1293091832124209,-31.32,IS,0.17,0.0,Phase3-EA-T1v2-EURJPY-M15-322,EURJPYMT4,2260,3h 44m,Buy
137507.8,135976,06.08.2015 19:44:58,sl 135.976,0.0,-325.9799999999814,0.0,0.0,136206,06.08.2015 18:30:00,12022,-0.1430779930877586,-31.37,IS,0.17,0.0,Phase3-EA-T1v2-EURJPY-M15-322,EURJPYMT4,2262,1h 14m,Buy
137551.71,1.0706,07.08.2015 01:00:00,tp 1.07060,-2.09,-282.0699999999779,0.0,0.0,1.0717,06.08.2015 23:10:00,12023,-0.12380517059409538,43.91,IS,0.41,0.0,Phase3-EA-SA2v2-EURCHF-M5-43,EURCHFMT4,6110,1h 50m,Sell
137552.91,124679,07.08.2015 03:30:00,,-0.97,-280.86999999996624,0.0,0.0,124689,06.08.2015 23:45:00,12024,-0.12327847082200204,1.2,IS,0.27,0.0,Phase3-EA-S1v2-USDJPY-M15-0,USDJPYMT4,3430,3h 45m,Sell
137499.45,136716,07.08.2015 16:29:58,sl 136.716,-1.51,-334.3299999999581,0.0,0.0,135996,03.08.2015 01:30:00,12025,-0.14674294566852894,-53.46,IS,0.09,0.0,Phase3-EA-TR1v1-EURJPY-M30-91,EURJPYMT4,2146,4d 14h 59m,Sell
137468.0,136097,07.08.2015 16:44:58,sl 136.097,0.0,-365.77999999996973,0.0,0.0,136327,07.08.2015 16:00:00,12026,-0.160546868862013,-31.45,IS,0.17,0.0,Phase3-EA-T1v2-EURJPY-M15-322,EURJPYMT4,2264,44m 58s,Buy
137495.81,124275,10.08.2015 02:15:00,,0.0,-337.96999999997206,0.0,0.0,124147,10.08.2015 01:00:00,12027,-0.14834060164386936,27.81,IS,0.27,0.0,Phase3-EA-S1v2-USDJPY-M15-0,USDJPYMT4,3432,1h 15m,Buy
137412.92,1.07816,10.08.2015 04:35:00,,-2.08,-420.85999999998603,0.0,0.0,1.07622,07.08.2015 20:15:00,12028,-0.18472238840086977,-82.89,IS,0.41,0.0,Phase3-EA-SA2v2-EURCHF-M5-43,EURCHFMT4,6112,2d 8h 20m,Sell
137394.61,192585,10.08.2015 07:45:00,,0.0,-439.1699999999837,0.0,0.0,192486,10.08.2015 02:20:00,12029,-0.1927589490899816,-18.31,IS,0.23,0.0,Phase3-EA-S4v1-GBPJPY-M5-194,GBPJPYMT4,2694,5h 25m,Sell
137440.14,1.07723,10.08.2015 15:15:00,,0.0,-393.63999999998487,0.0,0.0,1.07855,10.08.2015 06:30:00,12030,-0.17277508190400132,45.53,IS,0.34,0.0,Phase3-EA-S4v1-EURCHF-M15-221,EURCHFMT4,3164,8h 45m,Sell
137349.75,124562,10.08.2015 18:45:00,,0.0,-484.02999999999884,0.0,0.0,124145,10.08.2015 01:00:00,12031,-0.2124487422365531,-90.39,IS,0.27,0.0,Phase3-EA-S1v2-USDJPY-M15-0,USDJPYMT4,3433,17h 45m,Sell
137293.41,137148,10.08.2015 20:59:57,sl 137.148,0.0,-540.3699999999953,0.0,0.0,136368,10.08.2015 15:00:00,12032,-0.23717729653609382,-56.34,IS,0.09,0.0,Phase3-EA-TR1v1-EURJPY-M30-91,EURJPYMT4,2148,5h 59m,Sell
137302.53,124607,11.08.2015 01:00:00,,-0.63,-531.25,0.0,0.0,124562,10.08.2015 18:45:00,12033,-0.23317437826822535,9.12,IS,0.27,0.0,Phase3-EA-S1v2-USDJPY-M15-0,USDJPYMT4,3436,6h 15m,Buy
137299.2,1.08331,11.08.2015 05:15:00,,-2.08,-534.5799999999872,0.0,0.0,1.08328,10.08.2015 20:55:00,12034,-0.23463597013576454,-3.33,IS,0.41,0.0,Phase3-EA-SA2v2-EURCHF-M5-43,EURCHFMT4,6114,8h 20m,Sell
137342.97,136938,11.08.2015 06:30:00,,-0.67,-490.8099999999977,0.0,0.0,136612,10.08.2015 16:00:00,12035,-0.21542459594885108,43.77,IS,0.17,0.0,Phase3-EA-T1v2-EURJPY-M15-322,EURJPYMT4,2266,14h 30m,Buy
137286.78,138017,11.08.2015 16:29:58,sl 138.017,0.0,-547.0,0.0,0.0,137237,11.08.2015 02:30:00,12036,-0.2400873127768833,-56.19,IS,0.09,0.0,Phase3-EA-TR1v1-EURJPY-M30-91,EURJPYMT4,2150,13h 59m,Sell
137332.42,1.09009,11.08.2015 20:29:57,tp 1.09009,0.0,-501.35999999998603,0.0,0.0,1.09119,11.08.2015 20:10:00,12037,-0.22005516477845496,45.64,IS,0.41,0.0,Phase3-EA-SA2v2-EURCHF-M5-43,EURCHFMT4,6116,19m 57s,Sell
137378.08,1.0904,12.08.2015 04:59:57,tp 1.09040,0.0,-455.69999999998254,0.0,0.0,1.0915,12.08.2015 02:50:00,12038,-0.2000142384504964,45.66,IS,0.41,0.0,Phase3-EA-SA2v2-EURCHF-M5-43,EURCHFMT4,6118,2h 9m,Sell
137393.34,0.98843,12.08.2015 05:30:00,,0.0,-440.4399999999732,0.0,0.0,0.98817,12.08.2015 01:15:00,12039,-0.19331637301543703,15.26,IS,0.58,0.0,Phase3-EA-SA2v2-USDCHF-M15-107,USDCHFMT4,2342,4h 15m,Buy
137406.71,125.16,12.08.2015 05:30:00,,0.0,-427.0699999999779,0.0,0.0,125098,12.08.2015 01:00:00,12040,-0.18744805972142276,13.37,IS,0.27,0.0,Phase3-EA-S1v2-USDJPY-M15-0,USDJPYMT4,3438,4h 30m,Buy
137544.87,1.0947,12.08.2015 12:14:57,tp 1.09470,0.0,-288.9099999999744,0.0,0.0,1.0907,12.08.2015 05:30:00,12041,-0.12680735929499673,138.16,IS,0.34,0.0,Phase3-EA-S4v1-EURCHF-M15-221,EURCHFMT4,3166,6h 44m,Buy
137496.17,193685,12.08.2015 12:59:57,sl 193.685,-0.26,-337.60999999998603,0.0,0.0,194355,11.08.2015 05:00:00,12042,-0.14818259171224904,-48.7,IS,0.09,0.0,Phase3-EA-B1v1-GBPJPY-M30-1,GBPJPYMT4,1116,1d 7h 59m,Buy
137634.37,138574,12.08.2015 18:00:00,,-0.67,-199.4099999999744,0.0,0.0,137561,11.08.2015 11:30:00,12043,-0.08752433462674983,138.2,IS,0.17,0.0,Phase3-EA-T1v2-EURJPY-M15-322,EURJPYMT4,2268,1d 6h 30m,Buy
137577.47,138787,12.08.2015 19:29:58,sl 138.787,-0.25,-256.30999999996857,0.0,0.0,138007,11.08.2015 20:30:00,12044,-0.11249868215326402,-56.9,IS,0.09,0.0,Phase3-EA-TR1v1-EURJPY-M30-91,EURJPYMT4,2152,22h 59m,Sell
137471.03,0.97482,13.08.2015 02:45:00,,-9.46,-362.7499999999709,0.0,0.0,0.97319,12.08.2015 22:30:00,12045,-0.15921695193749075,-106.44,IS,0.58,0.0,Phase3-EA-SA2v2-USDCHF-M15-107,USDCHFMT4,2344,4h 15m,Sell
137450.47,124094,13.08.2015 05:45:00,,-2.94,-383.30999999996857,0.0,0.0,124013,12.08.2015 21:15:00,12046,-0.168241074699268,-20.56,IS,0.27,0.0,Phase3-EA-S1v2-USDJPY-M15-0,USDJPYMT4,3440,8h 30m,Sell
137407.62,1.08775,13.08.2015 06:20:00,,-6.31,-426.1599999999744,0.0,0.0,1.08688,12.08.2015 22:00:00,12047,-0.18704864572758764,-42.85,IS,0.41,0.0,Phase3-EA-SA2v2-EURCHF-M5-43,EURCHFMT4,6120,8h 20m,Sell
137398.74,138616,13.08.2015 09:00:00,,0.0,-435.03999999997905,0.0,0.0,138681,13.08.2015 05:00:00,12048,-0.19094622404104258,-8.88,IS,0.17,0.0,Phase3-EA-T1v2-EURJPY-M15-322,EURJPYMT4,2270,4h 0m,Buy
137367.34,138494,13.08.2015 10:44:58,sl 138.494,0.0,-466.4399999999732,0.0,0.0,138724,13.08.2015 10:15:00,12049,-0.20472820141068196,-31.4,IS,0.17,0.0,Phase3-EA-T1v2-EURJPY-M15-322,EURJPYMT4,2272,29m 58s,Buy
137318.93,193786,13.08.2015 17:59:58,sl 193.786,0.0,-514.8499999999767,0.0,0.0,194456,13.08.2015 10:30:00,12050,-0.22597614804967603,-48.41,IS,0.09,0.0,Phase3-EA-B1v1-GBPJPY-M30-1,GBPJPYMT4,1118,7h 29m,Buy
137301.28,1.0881,14.08.2015 04:20:00,,-2.1,-532.4999999999709,0.0,0.0,1.08773,13.08.2015 20:00:00,12051,-0.23372302386413782,-17.65,IS,0.41,0.0,Phase3-EA-SA2v2-EURCHF-M5-43,EURCHFMT4,6122,8h 20m,Sell
137310.93,194213,14.08.2015 04:35:00,,-1.07,-522.8499999999767,0.0,0.0,194271,13.08.2015 23:10:00,12052,-0.22948747986359755,9.65,IS,0.23,0.0,Phase3-EA-S4v1-GBPJPY-M5-194,GBPJPYMT4,2696,5h 25m,Sell
137312.57,138771,14.08.2015 09:00:00,,0.0,-521.2099999999627,0.0,0.0,138759,14.08.2015 08:15:00,12053,-0.2287676568417375,1.64,IS,0.17,0.0,Phase3-EA-T1v2-EURJPY-M15-322,EURJPYMT4,2274,45m 0s,Buy
137281.08,138533,14.08.2015 16:44:58,sl 138.533,0.0,-552.6999999999534,0.0,0.0,138763,14.08.2015 15:30:00,12054,-0.24258913669428195,-31.49,IS,0.17,0.0,Phase3-EA-T1v2-EURJPY-M15-322,EURJPYMT4,2276,1h 14m,Buy
137228.95,138028,14.08.2015 19:29:58,sl 138.028,0.0,-604.8299999999581,0.0,0.0,138669,12.08.2015 23:00:00,12055,-0.26546985262675005,-52.13,IS,0.09,0.0,Phase3-EA-TR1v1-EURJPY-M30-91,EURJPYMT4,2154,1d 20h 29m,Sell
137218.3,1.0844,17.08.2015 08:00:00,,-1.01,-615.4799999999523,0.0,0.0,1.08463,14.08.2015 23:40:00,12056,-0.2701443131040305,-10.65,IS,0.41,0.0,Phase3-EA-SA2v2-EURCHF-M5-43,EURCHFMT4,6124,2d 8h 20m,Buy
137199.86,1.08437,17.08.2015 09:45:00,,0.0,-633.9199999999546,0.0,0.0,1.0849,17.08.2015 01:00:00,12057,-0.2782379329351206,-18.44,IS,0.34,0.0,Phase3-EA-S4v1-EURCHF-M15-221,EURCHFMT4,3168,8h 45m,Buy
137151.34,194409,17.08.2015 16:59:58,sl 194.409,0.0,-682.4399999999441,0.0,0.0,195079,17.08.2015 10:30:00,12058,-0.29953416038654995,-48.52,IS,0.09,0.0,Phase3-EA-B1v1-GBPJPY-M30-1,GBPJPYMT4,1120,6h 29m,Buy
137197.5,1.08274,17.08.2015 22:59:57,tp 1.08274,0.0,-636.2799999999406,0.0,0.0,1.08164,17.08.2015 20:25:00,12059,-0.27927377582022134,46.16,IS,0.41,0.0,Phase3-EA-SA2v2-EURCHF-M5-43,EURCHFMT4,6126,2h 34m,Buy
137200.46,0.97889,18.08.2015 05:45:00,,0.0,-633.3199999999488,0.0,0.0,0.97894,18.08.2015 01:30:00,12060,-0.27797458304907396,2.96,IS,0.58,0.0,Phase3-EA-SA2v2-USDCHF-M15-107,USDCHFMT4,2346,4h 15m,Sell
137194.92,124381,18.08.2015 05:45:00,,-0.98,-638.8599999999569,0.0,0.0,124.36,17.08.2015 22:00:00,12061,-0.28040618033021814,-5.54,IS,0.27,0.0,Phase3-EA-S1v2-USDJPY-M15-0,USDJPYMT4,3442,7h 45m,Sell
137218.39,193916,18.08.2015 06:30:00,,0.0,-615.3899999999558,0.0,0.0,193789,18.08.2015 01:05:00,12062,-0.2701048106211254,23.47,IS,0.23,0.0,Phase3-EA-S4v1-GBPJPY-M5-194,GBPJPYMT4,2698,5h 25m,Buy
137187.37,1.08345,18.08.2015 07:20:00,,-2.1,-646.4099999999453,0.0,0.0,1.08276,17.08.2015 23:00:00,12063,-0.2837199997296015,-31.02,IS,0.41,0.0,Phase3-EA-SA2v2-EURCHF-M5-43,EURCHFMT4,6128,8h 20m,Sell
137229.44,1.08259,18.08.2015 10:45:00,,0.0,-604.3399999999383,0.0,0.0,1.0838,18.08.2015 02:00:00,12064,-0.26525478355313864,42.07,IS,0.34,0.0,Phase3-EA-S4v1-EURCHF-M15-221,EURCHFMT4,3170,8h 45m,Sell
137180.9,194427,18.08.2015 12:59:57,sl 194.427,0.0,-652.8799999999464,0.0,0.0,193757,18.08.2015 01:00:00,12065,-0.286559789334111,-48.54,IS,0.09,0.0,Phase3-EA-B1v1-GBPJPY-M30-1,GBPJPYMT4,1122,11h 59m,Sell
137272.86,137379,18.08.2015 16:59:58,tp 137.379,-1.51,-560.9199999999546,0.0,0.0,138748,14.08.2015 03:30:00,12066,-0.24619703013308683,91.96,IS,0.09,0.0,Phase3-EA-TR1v1-EURJPY-M30-91,EURJPYMT4,2155,4d 13h 29m,Buy
137319.01,1.07768,18.08.2015 21:59:57,tp 1.07768,0.0,-514.7699999999604,0.0,0.0,1.07658,18.08.2015 20:10:00,12067,-0.22594103473152966,46.15,IS,0.41,0.0,Phase3-EA-SA2v2-EURCHF-M5-43,EURCHFMT4,6130,1h 49m,Buy
137363.09,1.07658,19.08.2015 01:00:00,tp 1.07658,-2.1,-470.6899999999732,0.0,0.0,1.07768,18.08.2015 22:55:00,12068,-0.20659359643682776,44.08,IS,0.41,0.0,Phase3-EA-SA2v2-EURCHF-M5-43,EURCHFMT4,6132,2h 5m,Sell
137475.52,1.07511,19.08.2015 14:15:00,,0.0,-358.2599999999802,0.0,0.0,1.07833,19.08.2015 05:30:00,12069,-0.1572462169569314,112.43,IS,0.34,0.0,Phase3-EA-S4v1-EURCHF-M15-221,EURCHFMT4,3172,8h 45m,Sell
137522.15,1.07332,19.08.2015 21:54:58,tp 1.07332,0.0,-311.62999999997555,0.0,0.0,1.07222,19.08.2015 20:15:00,12070,-0.13677954164653433,46.63,IS,0.41,0.0,Phase3-EA-SA2v2-EURCHF-M5-43,EURCHFMT4,6134,1h 39m,Buy
137582.15,0.96669,19.08.2015 22:14:57,tp 0.96669,0.0,-251.62999999997555,0.0,0.0,0.96569,19.08.2015 22:00:00,12071,-0.110444553042123,60.0,IS,0.58,0.0,Phase3-EA-SA2v2-USDCHF-M15-107,USDCHFMT4,2348,14m 57s,Buy
137604.4,1.07355,20.08.2015 13:30:00,,0.0,-229.37999999997555,0.0,0.0,1.07418,20.08.2015 04:45:00,12072,-0.1006786614346538,22.25,IS,0.34,0.0,Phase3-EA-S4v1-EURCHF-M15-221,EURCHFMT4,3174,8h 45m,Sell
137697.02,138442,20.08.2015 14:29:57,tp 138.442,-1.07,-136.7599999999802,0.0,0.0,137152,19.08.2015 02:30:00,12073,-0.06002621735897955,92.62,IS,0.09,0.0,Phase3-EA-TR1v1-EURJPY-M30-91,EURJPYMT4,2158,1d 11h 59m,Buy
137742.96,1.07733,21.08.2015 00:04:58,tp 1.07733,-1.03,-90.81999999997788,0.0,0.0,1.07623,20.08.2015 22:20:00,12074,-0.039862394417534246,45.94,IS,0.41,0.0,Phase3-EA-SA2v2-EURCHF-M5-43,EURCHFMT4,6136,1h 44m,Buy
137627.33,0.95912,21.08.2015 03:45:00,,-0.73,-206.44999999998254,0.0,0.0,0.96102,20.08.2015 23:30:00,12075,-0.09061430662300433,-115.63,IS,0.58,0.0,Phase3-EA-SA2v2-USDCHF-M15-107,USDCHFMT4,2350,4h 15m,Buy
137592.28,138762,21.08.2015 04:59:58,sl 138.762,-3.36,-241.4999999999709,0.0,0.0,138532,14.08.2015 17:15:00,12076,-0.10599832913274285,-35.05,IS,0.17,0.0,Phase3-EA-T1v2-EURJPY-M15-322,EURJPYMT4,2278,6d 11h 44m,Sell
137609.46,193665,21.08.2015 05:00:00,,-1.08,-224.31999999997788,0.0,0.0,193763,20.08.2015 23:35:00,12077,-0.09845774406234946,17.18,IS,0.23,0.0,Phase3-EA-S4v1-GBPJPY-M5-194,GBPJPYMT4,2700,5h 25m,Sell
137610.88,1078,21.08.2015 14:15:00,,0.0,-222.89999999996508,0.0,0.0,1.07804,21.08.2015 05:30:00,12078,-0.09783448266537277,1.42,IS,0.34,0.0,Phase3-EA-S4v1-EURCHF-M15-221,EURCHFMT4,3176,8h 45m,Sell
137578.86,138469,21.08.2015 19:44:57,sl 138.469,0.0,-254.9199999999546,0.0,0.0,138699,21.08.2015 19:15:00,12079,-0.11188858825058902,-32.02,IS,0.17,0.0,Phase3-EA-T1v2-EURJPY-M15-322,EURJPYMT4,2280,29m 57s,Buy
137626.41,1.07756,21.08.2015 21:24:59,tp 1.07756,0.0,-207.36999999996624,0.0,0.0,1.07646,21.08.2015 21:10:00,12080,-0.09101810978159815,47.55,IS,0.41,0.0,Phase3-EA-SA2v2-EURCHF-M5-43,EURCHFMT4,6138,14m 59s,Buy
137713.97,121945,24.08.2015 01:00:00,tp 121.945,-1.0,-119.80999999996857,0.0,0.0,122345,21.08.2015 22:15:00,12081,-0.052586583078228236,87.56,IS,0.27,0.0,Phase3-EA-S1v2-USDJPY-M15-0,USDJPYMT4,3444,2d 2h 45m,Sell
137775.23,0.94684,24.08.2015 01:44:57,tp 0.94684,0.0,-58.549999999959255,0.0,0.0,0.94584,24.08.2015 01:00:00,12082,-0.025698559713120177,61.26,IS,0.58,0.0,Phase3-EA-SA2v2-USDCHF-M15-107,USDCHFMT4,2352,44m 57s,Buy
137911.4,190896,24.08.2015 02:59:58,tp 190.896,-0.43,-0.0,0.0,0.0,192746,21.08.2015 14:30:00,12083,-0.0,136.17,IS,0.09,0.0,Phase3-EA-B1v1-GBPJPY-M30-1,GBPJPYMT4,1124,2d 12h 29m,Sell
137759.95,190413,24.08.2015 03:09:58,sl 190.413,0.0,-151.45000000001164,0.0,0.0,191213,24.08.2015 01:10:00,12084,-0.06645126132348383,-151.45,IS,0.23,0.0,Phase3-EA-S4v1-GBPJPY-M5-194,GBPJPYMT4,2702,1h 59m,Buy
137833.81,190576,24.08.2015 03:29:58,tp 190.576,0.0,-77.59000000002561,0.0,0.0,190186,24.08.2015 03:20:00,12085,-0.03404393110657258,73.86,IS,0.23,0.0,Phase3-EA-S4v1-GBPJPY-M5-194,GBPJPYMT4,2704,9m 58s,Buy
137801.53,138594,24.08.2015 07:59:58,sl 138.594,0.0,-109.87000000002445,0.0,0.0,138824,24.08.2015 06:45:00,12086,-0.04820732969040761,-32.28,IS,0.17,0.0,Phase3-EA-T1v2-EURJPY-M15-322,EURJPYMT4,2282,1h 14m,Buy
137751.68,189755,24.08.2015 11:29:58,sl 189.755,0.0,-159.72000000003027,0.0,0.0,189085,24.08.2015 11:00:00,12087,-0.07007986436835942,-49.85,IS,0.09,0.0,Phase3-EA-B1v1-GBPJPY-M30-1,GBPJPYMT4,1126,29m 58s,Sell
137719.25,138638,24.08.2015 11:44:59,sl 138.638,0.0,-192.15000000002328,0.0,0.0,138868,24.08.2015 11:30:00,12088,-0.0843090780013733,-32.43,IS,0.17,0.0,Phase3-EA-T1v2-EURJPY-M15-322,EURJPYMT4,2284,14m 59s,Buy
137578.37,1.0834,24.08.2015 11:59:58,sl 1.08340,0.0,-333.03000000002794,0.0,0.0,1.0795,24.08.2015 06:00:00,12089,-0.14612257219253866,-140.88,IS,0.34,0.0,Phase3-EA-S4v1-EURCHF-M15-221,EURCHFMT4,3178,5h 59m,Sell
137528.27,189.32,24.08.2015 12:59:58,sl 189.320,0.0,-383.13000000003376,0.0,0.0,188.65,24.08.2015 12:00:00,12090,-0.1681047986191261,-50.1,IS,0.09,0.0,Phase3-EA-B1v1-GBPJPY-M30-1,GBPJPYMT4,1128,59m 58s,Sell
137627.72,137037,24.08.2015 17:29:58,tp 137.037,-0.52,-283.6800000000221,0.0,0.0,138327,20.08.2015 17:30:00,12091,-0.12446942101185815,99.45,IS,0.09,0.0,Phase3-EA-TR1v1-EURJPY-M30-91,EURJPYMT4,2160,3d 23h 59m,Sell
137718.67,118748,24.08.2015 22:29:57,tp 118.748,0.0,-192.73000000001048,0.0,0.0,119148,24.08.2015 20:45:00,12092,-0.08456356285820239,90.95,IS,0.27,0.0,Phase3-EA-S1v2-USDJPY-M15-0,USDJPYMT4,3446,1h 44m,Sell
137809.71,118623,24.08.2015 22:59:58,tp 118.623,0.0,-101.69000000000233,0.0,0.0,119023,24.08.2015 22:30:00,12093,-0.04461821567503933,91.04,IS,0.27,0.0,Phase3-EA-S1v2-USDJPY-M15-0,USDJPYMT4,3448,29m 58s,Sell
137871.93,0.93215,25.08.2015 01:44:58,tp 0.93215,0.0,-39.470000000001164,0.0,0.0,0.93115,25.08.2015 01:15:00,12094,-0.017318133274597445,62.22,IS,0.58,0.0,Phase3-EA-SA2v2-USDCHF-M15-107,USDCHFMT4,2354,29m 58s,Buy
137873.18,118349,25.08.2015 02:30:00,,-1.03,-38.220000000001164,0.0,0.0,118359,24.08.2015 23:00:00,12095,-0.016769674531419178,1.25,IS,0.27,0.0,Phase3-EA-S1v2-USDJPY-M15-0,USDJPYMT4,3450,3h 30m,Sell
137718.89,188136,25.08.2015 05:19:58,sl 188.136,0.0,-192.5100000000093,0.0,0.0,187336,25.08.2015 03:55:00,12096,-0.08446703411940251,-154.29,IS,0.23,0.0,Phase3-EA-S4v1-GBPJPY-M5-194,GBPJPYMT4,2706,1h 24m,Sell
137770.02,1.08143,25.08.2015 11:30:00,,0.0,-141.38000000000466,0.0,0.0,1.08002,25.08.2015 02:45:00,12097,-0.06203287768843666,51.13,IS,0.34,0.0,Phase3-EA-S4v1-EURCHF-M15-221,EURCHFMT4,3180,8h 45m,Buy
137581.42,118821,25.08.2015 23:59:58,sl 118.821,0.0,-329.9800000000105,0.0,0.0,119651,25.08.2015 17:30:00,12098,-0.14478433285917602,-188.6,IS,0.27,0.0,Phase3-EA-S1v2-USDJPY-M15-0,USDJPYMT4,3452,6h 29m,Buy
137628.32,1.08152,26.08.2015 00:09:57,tp 1.08152,-1.05,-283.0800000000163,0.0,0.0,1.08042,25.08.2015 21:30:00,12099,-0.12420616081513003,46.9,IS,0.41,0.0,Phase3-EA-SA2v2-EURCHF-M5-43,EURCHFMT4,6140,2h 39m,Buy
137472.48,186.08,26.08.2015 00:39:58,sl 186.080,-0.7,-438.9200000000128,0.0,0.0,186.88,25.08.2015 23:45:00,12100,-0.1925836092446493,-155.84,IS,0.23,0.0,Phase3-EA-S4v1-GBPJPY-M5-194,GBPJPYMT4,2708,54m 58s,Buy
137520.56,1.08037,26.08.2015 01:00:00,tp 1.08037,0.0,-390.8400000000256,0.0,0.0,1.08147,26.08.2015 00:15:00,12101,-0.1714876921470461,48.08,IS,0.41,0.0,Phase3-EA-SA2v2-EURCHF-M5-43,EURCHFMT4,6142,45m 0s,Sell
137582.26,0.94002,26.08.2015 01:44:58,tp 0.94002,0.0,-329.14000000001397,0.0,0.0,0.93902,26.08.2015 00:45:00,12102,-0.14441576858376176,61.7,IS,0.58,0.0,Phase3-EA-SA2v2-USDCHF-M15-107,USDCHFMT4,2356,59m 58s,Buy
137673.91,1.0809,26.08.2015 13:15:00,,0.0,-237.4900000000198,0.0,0.0,1.08344,26.08.2015 04:30:00,12103,-0.10420277353393384,91.65,IS,0.34,0.0,Phase3-EA-S4v1-EURCHF-M15-221,EURCHFMT4,3182,8h 45m,Sell
137768.67,135.62,26.08.2015 19:59:58,tp 135.620,-0.27,-142.73000000001048,0.0,0.0,136.88,25.08.2015 22:30:00,12104,-0.06262521313107175,94.76,IS,0.09,0.0,Phase3-EA-TR1v1-EURJPY-M30-91,EURJPYMT4,2162,21h 29m,Sell
137829.74,0.94969,26.08.2015 22:29:58,tp 0.94969,0.0,-81.66000000000349,0.0,0.0,0.95069,26.08.2015 22:15:00,12105,-0.035829712774351305,61.07,IS,0.58,0.0,Phase3-EA-SA2v2-USDCHF-M15-107,USDCHFMT4,2358,14m 58s,Sell
137877.12,1.08023,26.08.2015 23:04:57,tp 1.08023,0.0,-34.279999999998836,0.0,0.0,1.08133,26.08.2015 22:50:00,12106,-0.015040932572920261,47.38,IS,0.41,0.0,Phase3-EA-SA2v2-EURCHF-M5-43,EURCHFMT4,6144,14m 57s,Sell
137822.42,136349,27.08.2015 02:59:58,sl 136.349,-0.79,-88.98000000001048,0.0,0.0,135629,26.08.2015 20:00:00,12107,-0.0390414871744063,-54.7,IS,0.09,0.0,Phase3-EA-TR1v1-EURJPY-M30-91,EURJPYMT4,2164,6h 59m,Sell
137799.28,0.95237,27.08.2015 06:45:00,,0.0,-112.12000000002445,0.0,0.0,0.95275,27.08.2015 02:30:00,12108,-0.04919455542812849,-23.14,IS,0.58,0.0,Phase3-EA-SA2v2-USDCHF-M15-107,USDCHFMT4,2360,4h 15m,Buy
137846.63,1.07988,27.08.2015 06:54:58,tp 1.07988,0.0,-64.77000000001863,0.0,0.0,1.07878,27.08.2015 02:20:00,12109,-0.028418938236533214,47.35,IS,0.41,0.0,Phase3-EA-SA2v2-EURCHF-M5-43,EURCHFMT4,6146,4h 34m,Buy
137780.32,1.07677,27.08.2015 14:00:00,,0.0,-131.0800000000163,0.0,0.0,1.07863,27.08.2015 05:15:00,12110,-0.057513577644652855,-66.31,IS,0.34,0.0,Phase3-EA-S4v1-EURCHF-M15-221,EURCHFMT4,3184,8h 45m,Buy
137721.94,135569,27.08.2015 16:29:58,sl 135.569,0.0,-189.46000000002095,0.0,0.0,136349,27.08.2015 03:00:00,12111,-0.08312879478605265,-58.38,IS,0.09,0.0,Phase3-EA-TR1v1-EURJPY-M30-91,EURJPYMT4,2166,13h 29m,Buy
137960.12,135318,27.08.2015 17:14:58,tp 135.318,-1.49,-0.0,0.0,0.0,137018,26.08.2015 13:15:00,12112,-0.0,238.18,IS,0.17,0.0,Phase3-EA-T1v2-EURJPY-M15-322,EURJPYMT4,2286,1d 3h 59m,Sell
137819.59,1.08566,28.08.2015 04:35:00,,-2.12,-140.52999999999884,0.0,0.0,1.0824,27.08.2015 20:15:00,12113,-0.06164674768551528,-140.53,IS,0.41,0.0,Phase3-EA-SA2v2-EURCHF-M5-43,EURCHFMT4,6148,8h 20m,Sell
137908.02,121236,28.08.2015 05:14:58,tp 121.236,-0.65,-52.10000000000582,0.0,0.0,120836,27.08.2015 22:45:00,12114,-0.022854874791259742,88.43,IS,0.27,0.0,Phase3-EA-S1v2-USDJPY-M15-0,USDJPYMT4,3454,6h 29m,Buy
137952.76,1.07522,31.08.2015 01:00:00,tp 1.07522,-2.13,-7.360000000015134,0.0,0.0,1.07632,28.08.2015 22:55:00,12115,-0.003228634903339708,44.74,IS,0.41,0.0,Phase3-EA-SA2v2-EURCHF-M5-43,EURCHFMT4,6150,2d 2h 5m,Sell
137851.83,121316,31.08.2015 02:45:00,,-1.0,-108.29000000000815,0.0,0.0,120867,28.08.2015 17:15:00,12116,-0.047503923054614726,-100.93,IS,0.27,0.0,Phase3-EA-S1v2-USDJPY-M15-0,USDJPYMT4,3456,2d 9h 30m,Sell
137798.08,136248,31.08.2015 06:29:58,sl 136.248,-0.26,-162.04000000000815,0.0,0.0,136335,28.08.2015 14:00:00,12117,-0.07108260865979849,-53.75,IS,0.09,0.0,Phase3-EA-TR1v1-EURJPY-M30-91,EURJPYMT4,2168,2d 16h 29m,Sell
137722.19,1.07941,31.08.2015 11:10:00,,0.0,-237.93000000002212,0.0,0.0,1.07763,31.08.2015 02:50:00,12118,-0.10437351936822127,-75.89,IS,0.41,0.0,Phase3-EA-SA2v2-EURCHF-M5-43,EURCHFMT4,6152,8h 20m,Sell
137641.65,1.07918,31.08.2015 11:45:00,,0.0,-318.47000000003027,0.0,0.0,1.0769,31.08.2015 03:00:00,12119,-0.13970426055225274,-80.54,IS,0.34,0.0,Phase3-EA-S4v1-EURCHF-M15-221,EURCHFMT4,3186,8h 45m,Sell
137609.37,135977,31.08.2015 18:29:58,sl 135.977,0.0,-350.7500000000291,0.0,0.0,136207,31.08.2015 16:45:00,12120,-0.15386463211197934,-32.28,IS,0.17,0.0,Phase3-EA-T1v2-EURJPY-M15-322,EURJPYMT4,2288,1h 44m,Buy
137577.11,136009,31.08.2015 21:59:58,sl 136.009,0.0,-383.0100000000384,0.0,0.0,135779,31.08.2015 19:00:00,12121,-0.1680162302072993,-32.26,IS,0.17,0.0,Phase3-EA-T1v2-EURJPY-M15-322,EURJPYMT4,2290,2h 59m,Sell
137621.63,1.08422,01.09.2015 00:04:58,tp 1.08422,-2.12,-338.4900000000489,0.0,0.0,1.08532,31.08.2015 23:00:00,12122,-0.14848649842790332,44.52,IS,0.41,0.0,Phase3-EA-SA2v2-EURCHF-M5-43,EURCHFMT4,6154,1h 4m,Sell
137589.31,136073,01.09.2015 05:29:57,sl 136.073,0.0,-370.8100000000559,0.0,0.0,135843,01.09.2015 01:00:00,12123,-0.16266441691645595,-32.32,IS,0.17,0.0,Phase3-EA-T1v2-EURJPY-M15-322,EURJPYMT4,2292,4h 29m,Sell
137663.64,185726,01.09.2015 06:14:58,tp 185.726,0.0,-296.4800000000687,0.0,0.0,186116,01.09.2015 03:25:00,12124,-0.13005783643212093,74.33,IS,0.23,0.0,Phase3-EA-S4v1-GBPJPY-M5-194,GBPJPYMT4,2710,2h 49m,Sell
137760.02,135045,01.09.2015 12:59:57,tp 135.045,-0.52,-200.10000000006403,0.0,0.0,135528,28.08.2015 20:00:00,12125,-0.08777851143439591,96.38,IS,0.09,0.0,Phase3-EA-TR1v1-EURJPY-M30-91,EURJPYMT4,2169,3d 16h 59m,Sell
137709.74,183961,01.09.2015 17:59:58,sl 183.961,0.0,-250.38000000006286,0.0,0.0,183291,01.09.2015 17:00:00,12126,-0.10983500096423054,-50.28,IS,0.09,0.0,Phase3-EA-B1v1-GBPJPY-M30-1,GBPJPYMT4,1130,59m 58s,Sell
137774.5,119665,01.09.2015 21:15:00,,0.0,-185.62000000005355,0.0,0.0,119952,01.09.2015 17:30:00,12127,-0.08142652320065995,64.76,IS,0.27,0.0,Phase3-EA-S1v2-USDJPY-M15-0,USDJPYMT4,3458,3h 45m,Sell
137819.34,1.08447,02.09.2015 00:09:57,tp 1.08447,-2.13,-140.78000000005704,0.0,0.0,1.08557,01.09.2015 21:15:00,12128,-0.0617564159906812,44.84,IS,0.41,0.0,Phase3-EA-SA2v2-EURCHF-M5-43,EURCHFMT4,6156,2h 54m,Sell
137894.38,182999,02.09.2015 02:54:57,tp 182.999,0.0,-65.7400000000489,0.0,0.0,182609,02.09.2015 01:00:00,12129,-0.028838377519738292,75.04,IS,0.23,0.0,Phase3-EA-S4v1-GBPJPY-M5-194,GBPJPYMT4,2712,1h 54m,Buy
137843.98,183277,02.09.2015 03:59:58,sl 183.277,0.0,-116.14000000004307,0.0,0.0,182607,02.09.2015 01:00:00,12130,-0.050947507836038276,-50.4,IS,0.09,0.0,Phase3-EA-B1v1-GBPJPY-M30-1,GBPJPYMT4,1132,2h 59m,Sell
137811.3,135241,02.09.2015 03:59:58,sl 135.241,0.0,-148.8200000000361,0.0,0.0,135011,02.09.2015 02:00:00,12131,-0.06528334868398694,-32.68,IS,0.17,0.0,Phase3-EA-T1v2-EURJPY-M15-322,EURJPYMT4,2294,1h 59m,Sell
137793.06,0.96011,02.09.2015 04:00:00,,-0.72,-167.06000000002678,0.0,0.0,0.9604,01.09.2015 23:45:00,12132,-0.07328474822702567,-18.24,IS,0.58,0.0,Phase3-EA-SA2v2-USDCHF-M15-107,USDCHFMT4,2362,4h 15m,Buy
137901.3,1.08694,02.09.2015 13:45:00,,0.0,-58.82000000003609,0.0,0.0,1.08387,02.09.2015 05:00:00,12133,-0.025802758833446692,108.24,IS,0.34,0.0,Phase3-EA-S4v1-EURCHF-M15-221,EURCHFMT4,3188,8h 45m,Buy
137939.47,120267,02.09.2015 22:30:00,,0.0,-20.650000000023283,0.0,0.0,120097,02.09.2015 19:45:00,12134,-0.009058602004606392,38.17,IS,0.27,0.0,Phase3-EA-S1v2-USDJPY-M15-0,USDJPYMT4,3460,2h 45m,Buy
137985.98,1.0881,02.09.2015 23:44:58,tp 1.08810,0.0,-0.0,0.0,0.0,1.0892,02.09.2015 20:05:00,12135,-0.0,46.51,IS,0.41,0.0,Phase3-EA-SA2v2-EURCHF-M5-43,EURCHFMT4,6158,3h 39m,Sell
138029.47,1089,03.09.2015 00:24:58,tp 1.08900,-3.04,-0.0,0.0,0.0,1.0879,02.09.2015 23:50:00,12136,-0.0,43.49,IS,0.41,0.0,Phase3-EA-SA2v2-EURCHF-M5-43,EURCHFMT4,6160,34m 58s,Buy
138068.03,184288,03.09.2015 08:00:00,,0.0,-0.0,0.0,0.0,184.49,03.09.2015 02:35:00,12137,-0.0,38.56,IS,0.23,0.0,Phase3-EA-S4v1-GBPJPY-M5-194,GBPJPYMT4,2714,5h 25m,Sell
138024.43,1.52847,03.09.2015 10:29:58,sl 1.52847,-1.6,-43.60000000000582,0.0,0.0,1.53147,02.09.2015 21:30:00,12138,-0.019117102910042025,-43.6,IS,0.14,0.0,Phase3-EA-B1v1-GBPUSD-M30-14,GBPUSDMT4,796,12h 59m,Buy
138110.3,1.09,03.09.2015 13:15:00,,0.0,-0.0,0.0,0.0,1.08755,03.09.2015 04:30:00,12139,-0.0,85.87,IS,0.34,0.0,Phase3-EA-S4v1-EURCHF-M15-221,EURCHFMT4,3190,8h 45m,Buy
138155.58,1.08363,04.09.2015 04:09:57,tp 1.08363,-1.01,-0.0,0.0,0.0,1.08253,03.09.2015 23:05:00,12140,-0.0,45.28,IS,0.41,0.0,Phase3-EA-SA2v2-EURCHF-M5-43,EURCHFMT4,6162,5h 4m,Buy
138176.96,119953,04.09.2015 04:15:00,,0.0,-0.0,0.0,0.0,120048,04.09.2015 01:45:00,12141,-0.0,21.38,IS,0.27,0.0,Phase3-EA-S1v2-USDJPY-M15-0,USDJPYMT4,3462,2h 30m,Sell
138126.29,181.99,04.09.2015 16:59:57,sl 181.990,0.0,-50.670000000012806,0.0,0.0,181.32,04.09.2015 12:30:00,12142,-0.02220644888949895,-50.67,IS,0.09,0.0,Phase3-EA-B1v1-GBPJPY-M30-1,GBPJPYMT4,1134,4h 29m,Sell
138093.67,119206,04.09.2015 17:15:00,,0.0,-83.29000000000815,0.0,0.0,119062,04.09.2015 17:00:00,12143,-0.03650237079151531,-32.62,IS,0.27,0.0,Phase3-EA-S1v2-USDJPY-M15-0,USDJPYMT4,3464,15m 0s,Sell
138119.29,119091,04.09.2015 19:15:00,,0.0,-57.670000000012806,0.0,0.0,119204,04.09.2015 17:15:00,12144,-0.025274243289073715,25.62,IS,0.27,0.0,Phase3-EA-S1v2-USDJPY-M15-0,USDJPYMT4,3466,2h 0m,Sell
138165.65,1.0843,04.09.2015 23:29:58,tp 1.08430,0.0,-11.310000000026776,0.0,0.0,1.0854,04.09.2015 21:10:00,12145,-0.0049566792370389625,46.36,IS,0.41,0.0,Phase3-EA-SA2v2-EURCHF-M5-43,EURCHFMT4,6164,2h 19m,Sell
138170.42,118871,07.09.2015 04:45:00,,0.0,-6.540000000037253,0.0,0.0,118892,07.09.2015 01:00:00,12146,-0.0028661964819047497,4.77,IS,0.27,0.0,Phase3-EA-S1v2-USDJPY-M15-0,USDJPYMT4,3468,3h 45m,Sell
138016.34,181557,07.09.2015 05:39:58,sl 181.557,0.0,-160.62000000002445,0.0,0.0,180757,07.09.2015 02:30:00,12147,-0.07039273377996769,-154.08,IS,0.23,0.0,Phase3-EA-S4v1-GBPJPY-M5-194,GBPJPYMT4,2716,3h 9m,Sell
138061.68,1.08492,07.09.2015 05:49:57,tp 1.08492,-1.01,-115.28000000002794,0.0,0.0,1.08382,04.09.2015 23:50:00,12148,-0.05052219119758067,45.34,IS,0.41,0.0,Phase3-EA-SA2v2-EURCHF-M5-43,EURCHFMT4,6166,2d 5h 59m,Buy
138010.64,181477,07.09.2015 05:59:58,sl 181.477,-0.44,-166.3200000000361,0.0,0.0,180807,04.09.2015 19:00:00,12149,-0.07289079493391223,-51.04,IS,0.09,0.0,Phase3-EA-B1v1-GBPJPY-M30-1,GBPJPYMT4,1136,2d 10h 59m,Sell
137955.49,1.08613,07.09.2015 15:00:00,,0.0,-221.47000000003027,0.0,0.0,1.08455,07.09.2015 06:15:00,12150,-0.09706063223913088,-55.15,IS,0.34,0.0,Phase3-EA-S4v1-EURCHF-M15-221,EURCHFMT4,3192,8h 45m,Sell
137999.7,1.08804,08.09.2015 01:04:58,tp 1.08804,-2.1,-177.26000000003842,0.0,0.0,1.08914,07.09.2015 20:10:00,12151,-0.07768531932410581,44.21,IS,0.41,0.0,Phase3-EA-SA2v2-EURCHF-M5-43,EURCHFMT4,6168,4h 54m,Sell
138024.56,0.97519,08.09.2015 03:15:00,,-0.71,-152.4000000000524,0.0,0.0,0.97476,07.09.2015 23:00:00,12152,-0.06679026664219356,24.86,IS,0.58,0.0,Phase3-EA-SA2v2-USDCHF-M15-107,USDCHFMT4,2364,4h 15m,Buy
138056.81,182397,08.09.2015 05:05:00,,-0.69,-120.15000000005239,0.0,0.0,182226,07.09.2015 23:40:00,12153,-0.052656499587009825,32.25,IS,0.23,0.0,Phase3-EA-S4v1-GBPJPY-M5-194,GBPJPYMT4,2718,5h 25m,Buy
138002.02,133372,08.09.2015 05:29:57,sl 133.372,-0.52,-174.94000000006054,0.0,0.0,132652,04.09.2015 09:30:00,12154,-0.07666856460882787,-54.79,IS,0.09,0.0,Phase3-EA-TR1v1-EURJPY-M30-91,EURJPYMT4,2172,3d 19h 59m,Sell
138048.31,1.08794,08.09.2015 05:59:58,tp 1.08794,0.0,-128.6500000000524,0.0,0.0,1.08904,08.09.2015 02:40:00,12155,-0.05638167850077918,46.29,IS,0.41,0.0,Phase3-EA-SA2v2-EURCHF-M5-43,EURCHFMT4,6170,3h 19m,Sell
138014.42,133533,08.09.2015 08:29:58,sl 133.533,-1.0,-162.54000000006636,0.0,0.0,133303,04.09.2015 05:00:00,12156,-0.07123418595815513,-33.89,IS,0.17,0.0,Phase3-EA-T1v2-EURJPY-M15-322,EURJPYMT4,2296,4d 3h 29m,Sell
138056.33,119822,08.09.2015 18:15:00,,0.0,-120.63000000006286,0.0,0.0,120008,08.09.2015 17:00:00,12157,-0.05286686263155668,41.91,IS,0.27,0.0,Phase3-EA-S1v2-USDJPY-M15-0,USDJPYMT4,3470,1h 15m,Sell
138124.33,133915,08.09.2015 19:15:00,,0.0,-52.630000000062864,0.0,0.0,133436,08.09.2015 08:45:00,12158,-0.023065431321401823,68.0,IS,0.17,0.0,Phase3-EA-T1v2-EURJPY-M15-322,EURJPYMT4,2298,10h 30m,Buy
138183.53,0.97974,08.09.2015 23:29:58,tp 0.97974,0.0,-0.0,0.0,0.0,0.98074,08.09.2015 22:15:00,12159,-0.0,59.2,IS,0.58,0.0,Phase3-EA-SA2v2-USDCHF-M15-107,USDCHFMT4,2366,1h 14m,Sell
138242.74,0.97961,09.09.2015 00:44:58,tp 0.97961,0.0,-0.0,0.0,0.0,0.97861,09.09.2015 00:30:00,12160,-0.0,59.21,IS,0.58,0.0,Phase3-EA-SA2v2-USDCHF-M15-107,USDCHFMT4,2368,14m 58s,Buy
138220.96,1.09564,09.09.2015 04:45:00,,-2.09,-21.779999999998836,0.0,0.0,1.09517,08.09.2015 20:25:00,12161,-0.009542472194295727,-21.78,IS,0.41,0.0,Phase3-EA-SA2v2-EURCHF-M5-43,EURCHFMT4,6172,8h 20m,Sell
138162.27,134721,09.09.2015 05:59:58,sl 134.721,-0.26,-80.47000000000116,0.0,0.0,133941,08.09.2015 15:30:00,12162,-0.03525632403466618,-58.69,IS,0.09,0.0,Phase3-EA-TR1v1-EURJPY-M30-91,EURJPYMT4,2174,14h 29m,Sell
137975.54,120667,09.09.2015 11:29:58,sl 120.667,-1.01,-267.20000000001164,0.0,0.0,119837,08.09.2015 20:45:00,12163,-0.1170683457445393,-186.73,IS,0.27,0.0,Phase3-EA-S1v2-USDJPY-M15-0,USDJPYMT4,3472,14h 44m,Sell
137925.57,185108,09.09.2015 12:59:57,sl 185.108,0.0,-317.1700000000128,0.0,0.0,185778,09.09.2015 11:30:00,12164,-0.13896170366689897,-49.97,IS,0.09,0.0,Phase3-EA-B1v1-GBPJPY-M30-1,GBPJPYMT4,1138,1h 29m,Buy
137893.14,134426,09.09.2015 14:44:58,sl 134.426,0.0,-349.6000000000058,0.0,0.0,134656,09.09.2015 11:15:00,12165,-0.1531702607495877,-32.43,IS,0.17,0.0,Phase3-EA-T1v2-EURJPY-M15-322,EURJPYMT4,2300,3h 29m,Buy
137843.14,185238,09.09.2015 23:29:57,sl 185.238,0.0,-399.6000000000058,0.0,0.0,185908,09.09.2015 17:00:00,12166,-0.17507676257304097,-50.0,IS,0.09,0.0,Phase3-EA-B1v1-GBPJPY-M30-1,GBPJPYMT4,1140,6h 29m,Buy
137889.43,1.09175,09.09.2015 23:44:58,tp 1.09175,0.0,-353.3099999999977,0.0,0.0,1.09065,09.09.2015 20:10:00,12167,-0.15479572318488435,46.29,IS,0.41,0.0,Phase3-EA-SA2v2-EURCHF-M5-43,EURCHFMT4,6174,3h 34m,Buy
137929.4,1.09084,10.09.2015 01:04:57,tp 1.09084,-6.31,-313.3399999999965,0.0,0.0,1.09194,09.09.2015 23:50:00,12168,-0.13728366562721533,39.97,IS,0.41,0.0,Phase3-EA-SA2v2-EURCHF-M5-43,EURCHFMT4,6176,1h 14m,Sell
137975.62,1.09312,10.09.2015 02:04:58,tp 1.09312,0.0,-267.11999999999534,0.0,0.0,1.09422,10.09.2015 01:55:00,12169,-0.11703329534161462,46.22,IS,0.41,0.0,Phase3-EA-SA2v2-EURCHF-M5-43,EURCHFMT4,6178,9m 58s,Sell
137787.09,120109,10.09.2015 04:14:58,sl 120.109,-1.95,-455.6499999999942,0.0,0.0,120939,09.09.2015 21:45:00,12170,-0.19963395111712695,-188.53,IS,0.27,0.0,Phase3-EA-S1v2-USDJPY-M15-0,USDJPYMT4,3474,6h 29m,Buy
137737.04,184.91,10.09.2015 06:59:58,sl 184.910,0.0,-505.69999999998254,0.0,0.0,184.24,10.09.2015 05:30:00,12171,-0.22156235944239858,-50.05,IS,0.09,0.0,Phase3-EA-B1v1-GBPJPY-M30-1,GBPJPYMT4,1142,1h 29m,Sell
137705.89,184766,10.09.2015 07:25:00,,0.0,-536.8499999999767,0.0,0.0,184929,10.09.2015 02:00:00,12172,-0.2352101100784074,-31.15,IS,0.23,0.0,Phase3-EA-S4v1-GBPJPY-M5-194,GBPJPYMT4,2720,5h 25m,Buy
137570.28,1.09677,10.09.2015 07:44:57,sl 1.09677,0.0,-672.4599999999627,0.0,0.0,1.09287,10.09.2015 02:15:00,12173,-0.2946249243239712,-135.61,IS,0.34,0.0,Phase3-EA-S4v1-EURCHF-M15-221,EURCHFMT4,3194,5h 29m,Sell
137832.75,1.54708,10.09.2015 19:29:58,tp 1.54708,-2.13,-409.9899999999616,0.0,0.0,1.52818,08.09.2015 06:00:00,12174,-0.17962893365193516,262.47,IS,0.14,0.0,Phase3-EA-B1v1-GBPUSD-M30-14,GBPUSDMT4,798,2d 13h 29m,Buy
137925.5,135885,10.09.2015 19:29:58,tp 135.885,-1.1,-317.2399999999616,0.0,0.0,134625,09.09.2015 05:00:00,12175,-0.13899237276942938,92.75,IS,0.09,0.0,Phase3-EA-TR1v1-EURJPY-M30-91,EURJPYMT4,2175,1d 14h 29m,Buy
137971.88,1.09483,10.09.2015 20:54:58,tp 1.09483,0.0,-270.8599999999569,0.0,0.0,1.09593,10.09.2015 20:05:00,12176,-0.1186719016779921,46.38,IS,0.41,0.0,Phase3-EA-SA2v2-EURCHF-M5-43,EURCHFMT4,6180,49m 58s,Sell
138016.13,1.09624,11.09.2015 01:00:00,tp 1.09624,-2.11,-226.60999999995693,0.0,0.0,1.09734,10.09.2015 23:05:00,12177,-0.09928464756423597,44.25,IS,0.41,0.0,Phase3-EA-SA2v2-EURCHF-M5-43,EURCHFMT4,6182,1h 55m,Sell
138089.69,186624,11.09.2015 04:14:58,tp 186.624,-0.69,-153.04999999995925,0.0,0.0,186234,10.09.2015 23:45:00,12178,-0.06705580208157257,73.56,IS,0.23,0.0,Phase3-EA-S4v1-GBPJPY-M5-194,GBPJPYMT4,2722,4h 29m,Buy
138136.06,1.09708,11.09.2015 04:59:57,tp 1.09708,0.0,-106.67999999996391,0.0,0.0,1.09818,11.09.2015 02:50:00,12179,-0.046739712290504054,46.37,IS,0.41,0.0,Phase3-EA-SA2v2-EURCHF-M5-43,EURCHFMT4,6184,2h 9m,Sell
138154.26,1.09767,11.09.2015 11:45:00,,0.0,-88.47999999995227,0.0,0.0,1.09819,11.09.2015 03:00:00,12180,-0.038765745626761966,18.2,IS,0.34,0.0,Phase3-EA-S4v1-EURCHF-M15-221,EURCHFMT4,3196,8h 45m,Sell
138309.29,136173,11.09.2015 12:15:00,,-0.69,-0.0,0.0,0.0,135069,10.09.2015 07:45:00,12181,-0.0,155.03,IS,0.17,0.0,Phase3-EA-T1v2-EURJPY-M15-322,EURJPYMT4,2302,1d 4h 30m,Buy
138276.89,136051,11.09.2015 18:59:58,sl 136.051,0.0,-32.39999999999418,0.0,0.0,136281,11.09.2015 17:45:00,12182,-0.014191275352831222,-32.4,IS,0.17,0.0,Phase3-EA-T1v2-EURJPY-M15-322,EURJPYMT4,2304,1h 14m,Buy
138323.26,1.10273,11.09.2015 21:24:58,tp 1.10273,0.0,-0.0,0.0,0.0,1.10383,11.09.2015 20:20:00,12183,-0.0,46.37,IS,0.41,0.0,Phase3-EA-SA2v2-EURCHF-M5-43,EURCHFMT4,6186,1h 4m,Sell
138383.1,0.9692,14.09.2015 03:14:58,tp 0.96920,0.0,-0.0,0.0,0.0,0.9682,14.09.2015 02:45:00,12184,-0.0,59.84,IS,0.58,0.0,Phase3-EA-SA2v2-USDCHF-M15-107,USDCHFMT4,2370,29m 58s,Buy
138324.64,136963,14.09.2015 03:59:58,sl 136.963,-0.26,-58.45999999999185,0.0,0.0,136183,11.09.2015 11:30:00,12185,-0.025597340608824144,-58.46,IS,0.09,0.0,Phase3-EA-TR1v1-EURJPY-M30-91,EURJPYMT4,2178,2d 16h 29m,Sell
138237.71,1.09897,14.09.2015 06:15:00,,-1.02,-145.38999999998487,0.0,0.0,1101,11.09.2015 21:55:00,12186,-0.06366057733693249,-86.93,IS,0.41,0.0,Phase3-EA-SA2v2-EURCHF-M5-43,EURCHFMT4,6188,2d 8h 20m,Buy
138195.71,1.54181,14.09.2015 15:29:58,sl 1.54181,0.0,-187.38999999998487,0.0,0.0,1.54481,14.09.2015 10:30:00,12187,-0.08205072967307282,-42.0,IS,0.14,0.0,Phase3-EA-B1v1-GBPUSD-M30-14,GBPUSDMT4,800,4h 59m,Buy
138242.3,1.09556,14.09.2015 21:29:58,tp 1.09556,0.0,-140.79999999998836,0.0,0.0,1.09446,14.09.2015 20:45:00,12188,-0.06165079640305583,46.59,IS,0.41,0.0,Phase3-EA-SA2v2-EURCHF-M5-43,EURCHFMT4,6190,44m 58s,Buy
138286.74,1.09451,15.09.2015 04:59:57,tp 1.09451,-2.12,-96.35999999998603,0.0,0.0,1.09561,14.09.2015 22:00:00,12189,-0.04219226378833871,44.44,IS,0.41,0.0,Phase3-EA-SA2v2-EURCHF-M5-43,EURCHFMT4,6192,6h 59m,Sell
138265.28,120143,15.09.2015 07:15:00,,-1.01,-117.81999999997788,0.0,0.0,120052,14.09.2015 22:30:00,12190,-0.05158875591056303,-21.46,IS,0.27,0.0,Phase3-EA-S1v2-USDJPY-M15-0,USDJPYMT4,3476,8h 45m,Sell
138361.87,135369,15.09.2015 10:59:58,tp 135.369,-0.26,-21.229999999981374,0.0,0.0,136659,14.09.2015 07:30:00,12191,-0.009295784145140875,96.59,IS,0.09,0.0,Phase3-EA-TR1v1-EURJPY-M30-91,EURJPYMT4,2180,1d 3h 29m,Sell
138386.43,1.09565,15.09.2015 12:45:00,,0.0,-0.0,0.0,0.0,1.09495,15.09.2015 04:00:00,12192,-0.0,24.56,IS,0.34,0.0,Phase3-EA-S4v1-EURCHF-M15-221,EURCHFMT4,3198,8h 45m,Buy
138430.64,1.09748,16.09.2015 00:34:57,tp 1.09748,-2.1,-0.0,0.0,0.0,1.09858,15.09.2015 20:20:00,12193,-0.0,44.21,IS,0.41,0.0,Phase3-EA-SA2v2-EURCHF-M5-43,EURCHFMT4,6194,4h 14m,Sell
138443.42,120457,16.09.2015 03:45:00,,0.0,-0.0,0.0,0.0,120.4,16.09.2015 01:30:00,12194,-0.0,12.78,IS,0.27,0.0,Phase3-EA-S1v2-USDJPY-M15-0,USDJPYMT4,3478,2h 15m,Buy
138489.68,1.09899,16.09.2015 04:54:58,tp 1.09899,0.0,-0.0,0.0,0.0,1.09789,16.09.2015 00:45:00,12195,-0.0,46.26,IS,0.41,0.0,Phase3-EA-SA2v2-EURCHF-M5-43,EURCHFMT4,6196,4h 9m,Buy
138494.23,1.09727,16.09.2015 10:15:00,,0.0,-0.0,0.0,0.0,1.09714,16.09.2015 01:30:00,12196,-0.0,4.55,IS,0.34,0.0,Phase3-EA-S4v1-EURCHF-M15-221,EURCHFMT4,3200,8h 45m,Buy
138440.25,135944,16.09.2015 17:59:58,sl 135.944,-0.26,-53.98000000001048,0.0,0.0,135224,15.09.2015 12:00:00,12197,-0.023624228935676016,-53.98,IS,0.09,0.0,Phase3-EA-TR1v1-EURJPY-M30-91,EURJPYMT4,2182,1d 5h 59m,Sell
138475.61,120642,16.09.2015 20:15:00,,0.0,-18.620000000024447,0.0,0.0,120484,16.09.2015 19:00:00,12198,-0.008149002274597621,35.36,IS,0.27,0.0,Phase3-EA-S1v2-USDJPY-M15-0,USDJPYMT4,3480,1h 15m,Buy
138440.55,1.09642,17.09.2015 08:25:00,,0.0,-53.68000000002212,0.0,0.0,1.09559,17.09.2015 00:05:00,12199,-0.02349293459183707,-35.06,IS,0.41,0.0,Phase3-EA-SA2v2-EURCHF-M5-43,EURCHFMT4,6198,8h 20m,Sell
138487.07,1.09703,17.09.2015 21:49:57,tp 1.09703,0.0,-7.160000000032596,0.0,0.0,1.09813,17.09.2015 20:30:00,12200,-0.0031335583397587535,46.52,IS,0.41,0.0,Phase3-EA-SA2v2-EURCHF-M5-43,EURCHFMT4,6200,1h 19m,Sell
138454.56,136864,17.09.2015 22:29:58,sl 136.864,0.0,-39.67000000004191,0.0,0.0,137094,17.09.2015 22:00:00,12201,-0.017361488734328932,-32.51,IS,0.17,0.0,Phase3-EA-T1v2-EURJPY-M15-322,EURJPYMT4,2306,29m 58s,Buy
138514.78,0.9632,17.09.2015 22:29:58,tp 0.96320,0.0,-0.0,0.0,0.0,0.9622,17.09.2015 22:15:00,12202,-0.0,60.22,IS,0.58,0.0,Phase3-EA-SA2v2-USDCHF-M15-107,USDCHFMT4,2372,14m 58s,Buy
138561.78,1.09753,17.09.2015 23:59:57,tp 1.09753,0.0,-0.0,0.0,0.0,1.09643,17.09.2015 22:45:00,12203,-0.0,47.0,IS,0.41,0.0,Phase3-EA-SA2v2-EURCHF-M5-43,EURCHFMT4,6202,1h 14m,Buy
138622.11,0.9613,18.09.2015 01:59:58,tp 0.96130,0.0,-0.0,0.0,0.0,0.9603,18.09.2015 00:15:00,12204,-0.0,60.33,IS,0.58,0.0,Phase3-EA-SA2v2-USDCHF-M15-107,USDCHFMT4,2374,1h 44m,Buy
138571.55,186301,18.09.2015 04:59:58,sl 186.301,-0.27,-50.55999999999767,0.0,0.0,186971,17.09.2015 04:00:00,12205,-0.02211509639203196,-50.56,IS,0.09,0.0,Phase3-EA-B1v1-GBPJPY-M30-1,GBPJPYMT4,1144,1d 0h 59m,Buy
138432.37,1.09137,18.09.2015 14:29:58,sl 1.09137,0.0,-189.7399999999907,0.0,0.0,1.09527,18.09.2015 06:00:00,12206,-0.0829928478920912,-139.18,IS,0.34,0.0,Phase3-EA-S4v1-EURCHF-M15-221,EURCHFMT4,3202,8h 29m,Buy
138376.81,135711,18.09.2015 23:29:58,sl 135.711,-1.47,-245.29999999998836,0.0,0.0,136431,16.09.2015 20:30:00,12207,-0.10729495935453781,-55.56,IS,0.09,0.0,Phase3-EA-TR1v1-EURJPY-M30-91,EURJPYMT4,2184,2d 2h 59m,Buy
138433.57,0.96783,21.09.2015 01:14:57,tp 0.96783,-3.17,-188.53999999997905,0.0,0.0,0.96883,18.09.2015 23:45:00,12208,-0.08246796427518659,56.76,IS,0.58,0.0,Phase3-EA-SA2v2-USDCHF-M15-107,USDCHFMT4,2376,2d 1h 29m,Sell
138325.09,119835,21.09.2015 04:30:00,,-1.01,-297.0199999999895,0.0,0.0,119358,18.09.2015 17:00:00,12209,-0.1299174432429075,-108.48,IS,0.27,0.0,Phase3-EA-S1v2-USDJPY-M15-0,USDJPYMT4,3482,2d 11h 30m,Sell
138251.42,1.09458,21.09.2015 04:45:00,,-2.11,-370.6900000000023,0.0,0.0,1.09289,18.09.2015 20:25:00,12210,-0.1621409232904026,-73.67,IS,0.41,0.0,Phase3-EA-SA2v2-EURCHF-M5-43,EURCHFMT4,6204,2d 8h 20m,Sell
138392.03,1.09105,21.09.2015 13:59:58,tp 1.09105,0.0,-230.0800000000163,0.0,0.0,1.09505,21.09.2015 06:30:00,12211,-0.10063768548020782,140.61,IS,0.34,0.0,Phase3-EA-S4v1-EURCHF-M15-221,EURCHFMT4,3204,7h 29m,Sell
138435.93,120541,21.09.2015 18:45:00,,0.0,-186.18000000002212,0.0,0.0,120345,21.09.2015 18:00:00,12212,-0.08143569316196972,43.9,IS,0.27,0.0,Phase3-EA-S1v2-USDJPY-M15-0,USDJPYMT4,3484,45m 0s,Buy
138482.41,1086,21.09.2015 22:34:59,tp 1.08600,0.0,-139.70000000001164,0.0,0.0,1.0849,21.09.2015 21:15:00,12213,-0.061105201067390515,46.48,IS,0.41,0.0,Phase3-EA-SA2v2-EURCHF-M5-43,EURCHFMT4,6206,1h 19m,Buy
138526.73,1.08605,22.09.2015 01:04:58,tp 1.08605,-2.11,-95.38000000000466,0.0,0.0,1.08715,21.09.2015 23:25:00,12214,-0.04171949948323197,44.32,IS,0.41,0.0,Phase3-EA-SA2v2-EURCHF-M5-43,EURCHFMT4,6208,1h 39m,Sell
138541.66,186826,22.09.2015 04:30:00,,-1.11,-80.45000000001164,0.0,0.0,186.91,21.09.2015 23:05:00,12215,-0.03518907248297687,14.93,IS,0.23,0.0,Phase3-EA-S4v1-GBPJPY-M5-194,GBPJPYMT4,2724,5h 25m,Sell
138503.47,0.97207,22.09.2015 05:15:00,,0.0,-118.64000000001397,0.0,0.0,0.97143,22.09.2015 01:00:00,12216,-0.05189349359080501,-38.19,IS,0.58,0.0,Phase3-EA-SA2v2-USDCHF-M15-107,USDCHFMT4,2378,4h 15m,Sell
138597.64,134255,22.09.2015 11:29:58,tp 134.255,-0.26,-24.470000000001164,0.0,0.0,135515,21.09.2015 01:00:00,12217,-0.010703251754609823,94.17,IS,0.09,0.0,Phase3-EA-TR1v1-EURJPY-M30-91,EURJPYMT4,2186,1d 10h 29m,Sell
138838.33,133787,22.09.2015 14:14:58,tp 133.787,-0.49,-0.0,0.0,0.0,135487,21.09.2015 16:15:00,12218,-0.0,240.69,IS,0.17,0.0,Phase3-EA-T1v2-EURJPY-M15-322,EURJPYMT4,2308,21h 59m,Sell
138854.04,1.08788,22.09.2015 15:15:00,,0.0,-0.0,0.0,0.0,1.08833,22.09.2015 06:30:00,12219,-0.0,15.71,IS,0.34,0.0,Phase3-EA-S4v1-EURCHF-M15-221,EURCHFMT4,3206,8h 45m,Sell
138900.35,1.0838,22.09.2015 21:59:58,tp 1.08380,0.0,-0.0,0.0,0.0,1.0827,22.09.2015 20:30:00,12220,-0.0,46.31,IS,0.41,0.0,Phase3-EA-SA2v2-EURCHF-M5-43,EURCHFMT4,6210,1h 29m,Buy
138953.87,119823,23.09.2015 06:00:00,,-1.01,-0.0,0.0,0.0,120065,22.09.2015 17:45:00,12221,-0.0,53.52,IS,0.27,0.0,Phase3-EA-S1v2-USDJPY-M15-0,USDJPYMT4,3486,12h 15m,Sell
138946.3,1.08501,23.09.2015 07:05:00,,-2.1,-7.570000000006985,0.0,0.0,1.08488,22.09.2015 22:45:00,12222,-0.0033063428890749637,-7.57,IS,0.41,0.0,Phase3-EA-SA2v2-EURCHF-M5-43,EURCHFMT4,6212,8h 20m,Sell
138870.68,183.91,23.09.2015 08:05:00,,0.0,-83.19000000000233,0.0,0.0,184304,23.09.2015 02:40:00,12223,-0.036334830243315734,-75.62,IS,0.23,0.0,Phase3-EA-S4v1-GBPJPY-M5-194,GBPJPYMT4,2726,5h 25m,Buy
138838.11,133806,23.09.2015 11:14:58,sl 133.806,0.0,-115.76000000000931,0.0,0.0,133576,23.09.2015 02:30:00,12224,-0.05056040328124114,-32.57,IS,0.17,0.0,Phase3-EA-T1v2-EURJPY-M15-322,EURJPYMT4,2310,8h 44m,Sell
138976.14,182919,23.09.2015 19:59:58,tp 182.919,-0.43,-0.0,0.0,0.0,184769,22.09.2015 17:30:00,12225,-0.0,138.03,IS,0.09,0.0,Phase3-EA-B1v1-GBPJPY-M30-1,GBPJPYMT4,1146,1d 2h 29m,Sell
139035.43,0.9783,23.09.2015 23:14:58,tp 0.97830,0.0,-0.0,0.0,0.0,0.9773,23.09.2015 22:30:00,12226,-0.0,59.29,IS,0.58,0.0,Phase3-EA-SA2v2-USDCHF-M15-107,USDCHFMT4,2380,44m 58s,Buy
139075.19,1.09174,24.09.2015 01:04:57,tp 1.09174,-6.28,-0.0,0.0,0.0,1.09284,23.09.2015 20:30:00,12227,-0.0,39.76,IS,0.41,0.0,Phase3-EA-SA2v2-EURCHF-M5-43,EURCHFMT4,6214,4h 34m,Sell
139090.02,120152,24.09.2015 05:00:00,,0.0,-0.0,0.0,0.0,120218,24.09.2015 01:30:00,12228,-0.0,14.83,IS,0.27,0.0,Phase3-EA-S1v2-USDJPY-M15-0,USDJPYMT4,3488,3h 30m,Sell
139093.79,1.09494,24.09.2015 09:25:00,,0.0,-0.0,0.0,0.0,1.09503,24.09.2015 01:05:00,12229,-0.0,3.77,IS,0.41,0.0,Phase3-EA-SA2v2-EURCHF-M5-43,EURCHFMT4,6216,8h 20m,Sell
139067.68,1.09382,24.09.2015 14:00:00,,0.0,-26.10999999998603,0.0,0.0,1.09457,24.09.2015 05:15:00,12230,-0.011397078899426242,-26.11,IS,0.34,0.0,Phase3-EA-S4v1-EURCHF-M15-221,EURCHFMT4,3208,8h 45m,Buy
139035.02,134278,24.09.2015 14:44:58,sl 134.278,0.0,-58.76999999998952,0.0,0.0,134508,24.09.2015 11:00:00,12231,-0.02565324882878281,-32.66,IS,0.17,0.0,Phase3-EA-T1v2-EURJPY-M15-322,EURJPYMT4,2312,3h 44m,Buy
138993.02,1.52396,24.09.2015 15:29:58,sl 1.52396,0.0,-100.76999999998952,0.0,0.0,1.52696,24.09.2015 10:30:00,12232,-0.043986351616073435,-42.0,IS,0.14,0.0,Phase3-EA-B1v1-GBPUSD-M30-14,GBPUSDMT4,802,4h 59m,Buy
138951.02,1.52598,24.09.2015 17:59:58,sl 1.52598,0.0,-142.76999999998952,0.0,0.0,1.52298,24.09.2015 15:30:00,12233,-0.06231945440336406,-42.0,IS,0.14,0.0,Phase3-EA-B1v1-GBPUSD-M30-14,GBPUSDMT4,804,2h 29m,Sell
138909.02,1.5253,24.09.2015 19:59:58,sl 1.52530,0.0,-184.76999999998952,0.0,0.0,1.5283,24.09.2015 19:00:00,12234,-0.08065255719065469,-42.0,IS,0.14,0.0,Phase3-EA-B1v1-GBPUSD-M30-14,GBPUSDMT4,806,59m 58s,Buy
138953.18,1.09334,25.09.2015 01:04:57,tp 1.09334,-2.1,-140.60999999998603,0.0,0.0,1.09444,24.09.2015 21:25:00,12235,-0.061376609117159024,44.16,IS,0.41,0.0,Phase3-EA-SA2v2-EURCHF-M5-43,EURCHFMT4,6218,3h 39m,Sell
138758.48,978,25.09.2015 02:15:00,,-3.15,-335.3099999999977,0.0,0.0,0.97477,24.09.2015 22:00:00,12236,-0.14636363560967566,-194.7,IS,0.58,0.0,Phase3-EA-SA2v2-USDCHF-M15-107,USDCHFMT4,2382,4h 15m,Sell
138571.29,120366,25.09.2015 04:14:58,sl 120.366,-1.01,-522.5,0.0,0.0,119536,24.09.2015 20:00:00,12237,-0.22807252872284173,-187.19,IS,0.27,0.0,Phase3-EA-S1v2-USDJPY-M15-0,USDJPYMT4,3490,8h 14m,Sell
138568.17,1.09294,25.09.2015 10:45:00,,0.0,-525.6199999999953,0.0,0.0,1.09303,25.09.2015 02:00:00,12238,-0.229434416358467,-3.12,IS,0.34,0.0,Phase3-EA-S4v1-EURCHF-M15-221,EURCHFMT4,3210,8h 45m,Buy
138513.25,135.01,25.09.2015 14:29:58,sl 135.010,-1.31,-580.5400000000081,0.0,0.0,134.29,22.09.2015 13:00:00,12239,-0.25340713076509164,-54.92,IS,0.09,0.0,Phase3-EA-TR1v1-EURJPY-M30-91,EURJPYMT4,2188,3d 1h 29m,Sell
138557.35,1.09255,28.09.2015 01:04:58,tp 1.09255,-2.09,-536.4400000000023,0.0,0.0,1.09365,25.09.2015 20:35:00,12240,-0.23415737283843396,44.1,IS,0.41,0.0,Phase3-EA-SA2v2-EURCHF-M5-43,EURCHFMT4,6220,2d 4h 29m,Sell
138429.07,120368,28.09.2015 11:45:00,,-0.65,-664.7200000000012,0.0,0.0,120937,25.09.2015 17:15:00,12241,-0.2901519067801868,-128.28,IS,0.27,0.0,Phase3-EA-S1v2-USDJPY-M15-0,USDJPYMT4,3492,2d 18h 30m,Buy
138387.07,1.51879,28.09.2015 18:29:58,sl 1.51879,0.0,-706.7200000000012,0.0,0.0,1.51579,28.09.2015 17:30:00,12242,-0.30848500956747743,-42.0,IS,0.14,0.0,Phase3-EA-B1v1-GBPUSD-M30-14,GBPUSDMT4,808,59m 58s,Sell
138425.1,119641,29.09.2015 04:15:00,,-1.01,-668.6900000000023,0.0,0.0,119814,28.09.2015 23:00:00,12243,-0.2918848214960336,38.03,IS,0.27,0.0,Phase3-EA-S1v2-USDJPY-M15-0,USDJPYMT4,3494,5h 15m,Sell
138409.09,1.0945,29.09.2015 06:15:00,,-2.1,-684.7000000000116,0.0,0.0,1.09417,28.09.2015 21:55:00,12244,-0.29887322567757396,-16.01,IS,0.41,0.0,Phase3-EA-SA2v2-EURCHF-M5-43,EURCHFMT4,6222,8h 20m,Sell
138376.36,134486,29.09.2015 09:29:58,sl 134.486,0.0,-717.4300000000221,0.0,0.0,134716,29.09.2015 06:30:00,12245,-0.3131599507782457,-32.73,IS,0.17,0.0,Phase3-EA-T1v2-EURJPY-M15-322,EURJPYMT4,2314,2h 59m,Buy
138325.97,181832,29.09.2015 11:59:58,sl 181.832,0.0,-767.8200000000361,0.0,0.0,181162,29.09.2015 09:30:00,12246,-0.3351553090985274,-50.39,IS,0.09,0.0,Phase3-EA-B1v1-GBPJPY-M30-1,GBPJPYMT4,1148,2h 29m,Sell
138293.33,134726,29.09.2015 12:29:58,sl 134.726,0.0,-800.4600000000501,0.0,0.0,134956,29.09.2015 12:00:00,12247,-0.3494027489789422,-32.64,IS,0.17,0.0,Phase3-EA-T1v2-EURJPY-M15-322,EURJPYMT4,2316,29m 58s,Buy
138346.38,120106,29.09.2015 18:30:00,,0.0,-747.4100000000617,0.0,0.0,119.87,29.09.2015 17:15:00,12248,-0.32624629414880996,53.05,IS,0.27,0.0,Phase3-EA-S1v2-USDJPY-M15-0,USDJPYMT4,3496,1h 15m,Buy
138406.1,0.97112,29.09.2015 22:59:58,tp 0.97112,0.0,-687.6900000000605,0.0,0.0,0.97212,29.09.2015 22:15:00,12249,-0.30017836799507147,59.72,IS,0.58,0.0,Phase3-EA-SA2v2-USDCHF-M15-107,USDCHFMT4,2384,44m 58s,Sell
138450.39,1.09105,30.09.2015 01:04:57,tp 1.09105,-2.11,-643.4000000000524,0.0,0.0,1.09215,29.09.2015 20:05:00,12250,-0.28084567460342263,44.29,IS,0.41,0.0,Phase3-EA-SA2v2-EURCHF-M5-43,EURCHFMT4,6224,4h 59m,Sell
138395.85,135079,30.09.2015 04:59:57,sl 135.079,-0.52,-697.9400000000605,0.0,0.0,134359,28.09.2015 10:30:00,12251,-0.304652518080065,-54.54,IS,0.09,0.0,Phase3-EA-TR1v1-EURJPY-M30-91,EURJPYMT4,2190,1d 18h 29m,Sell
138384.13,119827,30.09.2015 07:15:00,,0.0,-709.6600000000617,0.0,0.0,119775,30.09.2015 01:15:00,12252,-0.30976832676261423,-11.72,IS,0.27,0.0,Phase3-EA-S1v2-USDJPY-M15-0,USDJPYMT4,3498,6h 0m,Sell
138342.13,1.51372,30.09.2015 11:29:57,sl 1.51372,0.0,-751.6600000000617,0.0,0.0,1.51672,30.09.2015 09:00:00,12253,-0.32810142954990484,-42.0,IS,0.14,0.0,Phase3-EA-B1v1-GBPUSD-M30-14,GBPUSDMT4,810,2h 29m,Buy
138309.61,134755,30.09.2015 14:14:58,sl 134.755,0.0,-784.1800000000512,0.0,0.0,134985,30.09.2015 13:00:00,12254,-0.342296489136631,-32.52,IS,0.17,0.0,Phase3-EA-T1v2-EURJPY-M15-322,EURJPYMT4,2318,1h 14m,Buy
138369.14,0.97422,01.10.2015 01:59:57,tp 0.97422,0.0,-724.6500000000524,0.0,0.0,0.97322,01.10.2015 01:15:00,12255,-0.31631149844788364,59.53,IS,0.58,0.0,Phase3-EA-SA2v2-USDCHF-M15-107,USDCHFMT4,2386,44m 57s,Buy
138312.22,119873,01.10.2015 04:00:00,,-1.96,-781.5700000000652,0.0,0.0,120117,30.09.2015 17:00:00,12256,-0.3411572177491412,-56.92,IS,0.27,0.0,Phase3-EA-S1v2-USDJPY-M15-0,USDJPYMT4,3500,11h 0m,Buy
138280.6,1.08839,01.10.2015 06:35:00,,-3.03,-813.1900000000605,0.0,0.0,1.08907,30.09.2015 22:15:00,12257,-0.3549594251332851,-31.62,IS,0.41,0.0,Phase3-EA-SA2v2-EURCHF-M5-43,EURCHFMT4,6226,8h 20m,Buy
138287.91,1.08827,01.10.2015 10:15:00,,0.0,-805.8800000000629,0.0,0.0,1.08806,01.10.2015 01:30:00,12258,-0.3517685922434029,7.31,IS,0.34,0.0,Phase3-EA-S4v1-EURCHF-M15-221,EURCHFMT4,3212,8h 45m,Buy
138331.97,1.09236,02.10.2015 01:00:00,tp 1.09236,-2.1,-761.8200000000652,0.0,0.0,1.09346,01.10.2015 21:00:00,12259,-0.33253629441464144,44.06,IS,0.41,0.0,Phase3-EA-SA2v2-EURCHF-M5-43,EURCHFMT4,6228,4h 0m,Sell
138388.21,0.97665,02.10.2015 03:14:57,tp 0.97665,-3.15,-705.5800000000745,0.0,0.0,0.97765,01.10.2015 23:15:00,12260,-0.3079873967775687,56.24,IS,0.58,0.0,Phase3-EA-SA2v2-USDCHF-M15-107,USDCHFMT4,2388,3h 59m,Sell
138366.7,119831,02.10.2015 04:00:00,,-1.01,-727.0900000000838,0.0,0.0,119.74,01.10.2015 21:00:00,12261,-0.31737656441934947,-21.51,IS,0.27,0.0,Phase3-EA-S1v2-USDJPY-M15-0,USDJPYMT4,3502,7h 0m,Sell
138362.09,1.09324,02.10.2015 09:25:00,,0.0,-731.7000000000698,0.0,0.0,1.09313,02.10.2015 01:05:00,12262,-0.3193888407014722,-4.61,IS,0.41,0.0,Phase3-EA-SA2v2-EURCHF-M5-43,EURCHFMT4,6230,8h 20m,Sell
138306.56,134447,02.10.2015 16:59:58,sl 134.447,-1.05,-787.2300000000687,0.0,0.0,133727,30.09.2015 20:00:00,12263,-0.3436278216009538,-55.53,IS,0.09,0.0,Phase3-EA-TR1v1-EURJPY-M30-91,EURJPYMT4,2192,1d 20h 59m,Sell
138243.19,119.93,05.10.2015 05:15:00,,-1.01,-850.600000000064,0.0,0.0,119653,02.10.2015 20:30:00,12264,-0.37128898168739477,-63.37,IS,0.27,0.0,Phase3-EA-S1v2-USDJPY-M15-0,USDJPYMT4,3504,2d 8h 45m,Sell
138215.97,1.08971,05.10.2015 05:55:00,,-1.01,-877.8200000000652,0.0,0.0,1.09033,02.10.2015 21:35:00,12265,-0.3831705783033489,-27.22,IS,0.41,0.0,Phase3-EA-SA2v2-EURCHF-M5-43,EURCHFMT4,6232,2d 8h 20m,Buy
138254.7,182488,05.10.2015 06:25:00,,0.0,-839.0900000000547,0.0,0.0,182286,05.10.2015 01:00:00,12266,-0.36626483851877845,38.73,IS,0.23,0.0,Phase3-EA-S4v1-GBPJPY-M5-194,GBPJPYMT4,2728,5h 25m,Buy
138200.78,134801,05.10.2015 16:59:58,sl 134.801,0.0,-893.0100000000675,0.0,0.0,135521,05.10.2015 14:30:00,12267,-0.38980105047808666,-53.92,IS,0.09,0.0,Phase3-EA-TR1v1-EURJPY-M30-91,EURJPYMT4,2194,2h 29m,Buy
138220.85,134811,05.10.2015 18:15:00,,0.0,-872.9400000000605,0.0,0.0,134669,05.10.2015 04:00:00,12268,-0.3810404463604426,20.07,IS,0.17,0.0,Phase3-EA-T1v2-EURJPY-M15-322,EURJPYMT4,2320,14h 15m,Buy
138222.2,120275,05.10.2015 18:30:00,,0.0,-871.5900000000547,0.0,0.0,120269,05.10.2015 18:00:00,12269,-0.38045116805656287,1.35,IS,0.27,0.0,Phase3-EA-S1v2-USDJPY-M15-0,USDJPYMT4,3506,30m 0s,Buy
138234.08,120472,06.10.2015 04:15:00,,0.0,-859.7100000000501,0.0,0.0,120419,06.10.2015 01:15:00,12270,-0.3752655189824415,11.88,IS,0.27,0.0,Phase3-EA-S1v2-USDJPY-M15-0,USDJPYMT4,3508,3h 0m,Buy
138262.07,1.09174,06.10.2015 04:40:00,,-1.01,-831.7200000000594,0.0,0.0,1.09105,05.10.2015 20:20:00,12271,-0.3630478154820583,27.99,IS,0.41,0.0,Phase3-EA-SA2v2-EURCHF-M5-43,EURCHFMT4,6234,8h 20m,Buy
138284.79,182457,06.10.2015 05:50:00,,0.0,-809.0000000000582,0.0,0.0,182338,06.10.2015 00:25:00,12272,-0.3531304798790282,22.72,IS,0.23,0.0,Phase3-EA-S4v1-GBPJPY-M5-194,GBPJPYMT4,2730,5h 25m,Buy
138273.27,1.09191,06.10.2015 11:30:00,,0.0,-820.5200000000477,0.0,0.0,1.09158,06.10.2015 02:45:00,12273,-0.35815898807210905,-11.52,IS,0.34,0.0,Phase3-EA-S4v1-EURCHF-M15-221,EURCHFMT4,3214,8h 45m,Sell
138240.79,134912,06.10.2015 13:14:58,sl 134.912,0.0,-853.0000000000582,0.0,0.0,134682,06.10.2015 07:15:00,12274,-0.3723365875609517,-32.48,IS,0.17,0.0,Phase3-EA-T1v2-EURJPY-M15-322,EURJPYMT4,2322,5h 59m,Sell
138258.66,0.9674,07.10.2015 03:30:00,,-0.72,-835.1300000000629,0.0,0.0,0.96709,06.10.2015 23:15:00,12275,-0.3645362888274089,17.87,IS,0.58,0.0,Phase3-EA-SA2v2-USDCHF-M15-107,USDCHFMT4,2390,4h 15m,Buy
138245.77,1.08999,07.10.2015 05:45:00,,-1.02,-848.0200000000768,0.0,0.0,1.09027,06.10.2015 21:25:00,12276,-0.37016280537332397,-12.89,IS,0.41,0.0,Phase3-EA-SA2v2-EURCHF-M5-43,EURCHFMT4,6236,8h 20m,Buy
138191.4,134736,07.10.2015 17:59:58,sl 134.736,-0.37,-902.3900000000722,0.0,0.0,134822,06.10.2015 11:30:00,12277,-0.39389544343391697,-54.37,IS,0.09,0.0,Phase3-EA-TR1v1-EURJPY-M30-91,EURJPYMT4,2196,1d 6h 29m,Buy
138237.75,1.09291,07.10.2015 22:24:58,tp 1.09291,0.0,-856.0400000000664,0.0,0.0,1.09401,07.10.2015 20:45:00,12278,-0.37366355500079723,46.35,IS,0.41,0.0,Phase3-EA-SA2v2-EURCHF-M5-43,EURCHFMT4,6238,1h 39m,Sell
138277.77,1.0935,08.10.2015 01:04:57,tp 1.09350,-6.32,-816.0200000000768,0.0,0.0,1.0946,07.10.2015 23:50:00,12279,-0.35619472705919775,40.02,IS,0.41,0.0,Phase3-EA-SA2v2-EURCHF-M5-43,EURCHFMT4,6240,1h 14m,Sell
138243.63,135049,08.10.2015 11:29:58,sl 135.049,-1.49,-850.1600000000908,0.0,0.0,134819,07.10.2015 17:45:00,12280,-0.37109692061058724,-34.14,IS,0.17,0.0,Phase3-EA-T1v2-EURJPY-M15-322,EURJPYMT4,2324,17h 44m,Sell
138201.63,1.53195,08.10.2015 20:29:58,sl 1.53195,0.0,-892.1600000000908,0.0,0.0,1.52895,08.10.2015 16:00:00,12281,-0.38943002339787786,-42.0,IS,0.14,0.0,Phase3-EA-B1v1-GBPUSD-M30-14,GBPUSDMT4,812,4h 29m,Sell
138248.28,1.09082,08.10.2015 22:44:57,tp 1.09082,0.0,-845.5100000000966,0.0,0.0,1.08972,08.10.2015 22:10:00,12282,-0.36906718423056833,46.65,IS,0.41,0.0,Phase3-EA-SA2v2-EURCHF-M5-43,EURCHFMT4,6242,34m 57s,Buy
138294.95,1.0905,09.10.2015 03:59:57,tp 1.09050,0.0,-798.8400000000838,0.0,0.0,1.0894,09.10.2015 00:10:00,12283,-0.3486956150143043,46.67,IS,0.41,0.0,Phase3-EA-SA2v2-EURCHF-M5-43,EURCHFMT4,6244,3h 49m,Buy
138432.13,184278,09.10.2015 06:29:57,tp 184.278,-1.62,-661.6600000000908,0.0,0.0,182428,05.10.2015 06:00:00,12284,-0.28881620929143764,137.18,IS,0.09,0.0,Phase3-EA-B1v1-GBPJPY-M30-1,GBPJPYMT4,1150,4d 0h 29m,Buy
138526.89,136112,09.10.2015 11:59:58,tp 136.112,-1.84,-566.9000000000815,0.0,0.0,135456,06.10.2015 22:00:00,12285,-0.24745323738372738,94.76,IS,0.09,0.0,Phase3-EA-TR1v1-EURJPY-M30-91,EURJPYMT4,2197,2d 13h 59m,Buy
138484.36,1.53207,09.10.2015 17:59:58,sl 1.53207,-0.53,-609.4300000000803,0.0,0.0,1.53507,08.10.2015 22:30:00,12286,-0.2660176864680952,-42.53,IS,0.14,0.0,Phase3-EA-B1v1-GBPUSD-M30-14,GBPUSDMT4,814,19h 29m,Buy
138724.02,136945,09.10.2015 20:59:58,tp 136.945,-0.69,-369.77000000007683,0.0,0.0,135245,08.10.2015 19:45:00,12287,-0.16140550994423486,239.66,IS,0.17,0.0,Phase3-EA-T1v2-EURJPY-M15-322,EURJPYMT4,2326,1d 1h 14m,Buy
138770.95,1.09222,12.10.2015 02:09:58,tp 1.09222,0.0,-322.8400000000838,0.0,0.0,1.09112,12.10.2015 02:00:00,12288,-0.1409204500916772,46.93,IS,0.41,0.0,Phase3-EA-SA2v2-EURCHF-M5-43,EURCHFMT4,6246,9m 58s,Buy
138793.88,0.96137,12.10.2015 06:00:00,,0.0,-299.9100000000908,0.0,0.0,0.96099,12.10.2015 01:45:00,12289,-0.1309114489747142,22.93,IS,0.58,0.0,Phase3-EA-SA2v2-USDCHF-M15-107,USDCHFMT4,2392,4h 15m,Buy
138870.22,1.09354,12.10.2015 10:30:00,,0.0,-223.5700000000943,0.0,0.0,1.09138,12.10.2015 01:45:00,12290,-0.09758885214657843,76.34,IS,0.34,0.0,Phase3-EA-S4v1-EURCHF-M15-221,EURCHFMT4,3216,8h 45m,Buy
138858.76,136615,12.10.2015 17:30:00,,0.0,-235.03000000008615,0.0,0.0,136696,12.10.2015 07:15:00,12291,-0.10259117019282132,-11.46,IS,0.17,0.0,Phase3-EA-T1v2-EURJPY-M15-322,EURJPYMT4,2328,10h 15m,Buy
138866.86,119973,13.10.2015 04:15:00,,0.0,-226.93000000008033,0.0,0.0,120009,13.10.2015 00:15:00,12292,-0.09905550036955559,8.1,IS,0.27,0.0,Phase3-EA-S1v2-USDJPY-M15-0,USDJPYMT4,3510,4h 0m,Sell
138824.33,1.53137,13.10.2015 04:59:58,sl 1.53137,-0.53,-269.46000000007916,0.0,0.0,1.53437,12.10.2015 10:30:00,12293,-0.11761994945392341,-42.53,IS,0.14,0.0,Phase3-EA-B1v1-GBPUSD-M30-14,GBPUSDMT4,816,18h 29m,Buy
138777.98,1.09442,13.10.2015 05:30:00,,-2.13,-315.810000000085,0.0,0.0,1.09338,12.10.2015 21:10:00,12294,-0.1378518378870431,-46.35,IS,0.41,0.0,Phase3-EA-SA2v2-EURCHF-M5-43,EURCHFMT4,6248,8h 20m,Sell
138735.98,1.53346,13.10.2015 12:29:58,sl 1.53346,0.0,-357.810000000085,0.0,0.0,1.53646,13.10.2015 10:30:00,12295,-0.15618494067433375,-42.0,IS,0.14,0.0,Phase3-EA-B1v1-GBPUSD-M30-14,GBPUSDMT4,818,1h 59m,Buy
138815.71,1.09193,13.10.2015 15:00:00,,0.0,-278.0800000000745,0.0,0.0,1.09418,13.10.2015 06:15:00,12296,-0.12138260054978912,79.73,IS,0.34,0.0,Phase3-EA-S4v1-EURCHF-M15-221,EURCHFMT4,3218,8h 45m,Sell
138783.09,136372,13.10.2015 19:14:57,sl 136.372,0.0,-310.70000000006985,0.0,0.0,136142,13.10.2015 16:15:00,12297,-0.13562131038124947,-32.62,IS,0.17,0.0,Phase3-EA-T1v2-EURJPY-M15-322,EURJPYMT4,2330,2h 59m,Sell
138789.77,1.09111,14.10.2015 05:20:00,,-1.03,-304.02000000007683,0.0,0.0,1.09093,13.10.2015 21:00:00,12298,-0.1327054740331787,6.68,IS,0.41,0.0,Phase3-EA-SA2v2-EURCHF-M5-43,EURCHFMT4,6250,8h 20m,Buy
138805.15,182618,14.10.2015 06:25:00,,0.0,-288.6400000000722,0.0,0.0,182538,14.10.2015 01:00:00,12299,-0.12599206639344976,15.38,IS,0.23,0.0,Phase3-EA-S4v1-GBPJPY-M5-194,GBPJPYMT4,2732,5h 25m,Buy
138794.8,119704,14.10.2015 10:45:00,,-0.65,-298.990000000078,0.0,0.0,119747,13.10.2015 23:30:00,12300,-0.1305098667231775,-10.35,IS,0.27,0.0,Phase3-EA-S1v2-USDJPY-M15-0,USDJPYMT4,3512,11h 15m,Buy
138752.11,1.53133,14.10.2015 11:59:58,sl 1.53133,-0.69,-341.6800000000803,0.0,0.0,1.52833,13.10.2015 12:30:00,12301,-0.14914415619911747,-42.69,IS,0.14,0.0,Phase3-EA-B1v1-GBPUSD-M30-14,GBPUSDMT4,820,23h 29m,Sell
138753.53,1.09103,14.10.2015 14:00:00,,0.0,-340.2600000000675,0.0,0.0,1.09107,14.10.2015 05:15:00,12302,-0.14852432272392255,1.42,IS,0.34,0.0,Phase3-EA-S4v1-EURCHF-M15-221,EURCHFMT4,3220,8h 45m,Sell
138765.34,136448,14.10.2015 16:30:00,,-0.7,-328.45000000006985,0.0,0.0,136.36,13.10.2015 19:45:00,12303,-0.14336922882111636,11.81,IS,0.17,0.0,Phase3-EA-T1v2-EURJPY-M15-322,EURJPYMT4,2332,20h 45m,Buy
138812.89,1.08953,14.10.2015 23:24:58,tp 1.08953,0.0,-280.9000000000815,0.0,0.0,1.08843,14.10.2015 20:00:00,12304,-0.12261353745122455,47.55,IS,0.41,0.0,Phase3-EA-SA2v2-EURCHF-M5-43,EURCHFMT4,6252,3h 24m,Buy
138873.95,0.94981,14.10.2015 23:59:57,tp 0.94981,0.0,-219.84000000008382,0.0,0.0,0.94881,14.10.2015 22:45:00,12305,-0.09596069801808352,61.06,IS,0.58,0.0,Phase3-EA-SA2v2-USDCHF-M15-107,USDCHFMT4,2394,1h 14m,Buy
138914.98,1.08865,15.10.2015 01:00:00,tp 1.08865,-6.48,-178.81000000008498,0.0,0.0,1.08975,14.10.2015 23:35:00,12306,-0.07805100260469036,41.03,IS,0.41,0.0,Phase3-EA-SA2v2-EURCHF-M5-43,EURCHFMT4,6254,1h 25m,Sell
138857.98,135159,15.10.2015 15:29:58,sl 135.159,-2.22,-235.81000000008498,0.0,0.0,135879,09.10.2015 11:30:00,12307,-0.10293164210172763,-57.0,IS,0.09,0.0,Phase3-EA-TR1v1-EURJPY-M30-91,EURJPYMT4,2199,6d 3h 59m,Buy
138815.45,1.54696,16.10.2015 00:59:58,sl 1.54696,-0.53,-278.3400000000838,0.0,0.0,1.54996,15.10.2015 20:30:00,12308,-0.12149609118609547,-42.53,IS,0.14,0.0,Phase3-EA-B1v1-GBPUSD-M30-14,GBPUSDMT4,822,4h 29m,Buy
138890.76,184354,16.10.2015 05:14:58,tp 184.354,0.0,-203.03000000008615,0.0,0.0,183964,16.10.2015 01:20:00,12309,-0.08862309187869513,75.31,IS,0.23,0.0,Phase3-EA-S4v1-GBPJPY-M5-194,GBPJPYMT4,2734,3h 54m,Buy
138880.68,1.0824,16.10.2015 07:05:00,,-1.03,-213.11000000007334,0.0,0.0,1.08261,15.10.2015 22:45:00,12310,-0.09302303654763928,-10.08,IS,0.41,0.0,Phase3-EA-SA2v2-EURCHF-M5-43,EURCHFMT4,6256,8h 20m,Buy
138988.86,1.08409,16.10.2015 09:45:00,,0.0,-104.93000000008033,0.0,0.0,1.08106,16.10.2015 01:00:00,12311,-0.04580220179694948,108.18,IS,0.34,0.0,Phase3-EA-S4v1-EURCHF-M15-221,EURCHFMT4,3222,8h 45m,Buy
139036.21,1.08178,16.10.2015 23:49:58,tp 1.08178,0.0,-57.580000000074506,0.0,0.0,1.08288,16.10.2015 20:05:00,12312,-0.025133810916513337,47.35,IS,0.41,0.0,Phase3-EA-SA2v2-EURCHF-M5-43,EURCHFMT4,6258,3h 44m,Sell
139082.54,1.08295,19.10.2015 01:09:57,tp 1.08295,-1.03,-11.250000000087311,0.0,0.0,1.08185,16.10.2015 23:50:00,12313,-0.004910652532348101,46.33,IS,0.41,0.0,Phase3-EA-SA2v2-EURCHF-M5-43,EURCHFMT4,6260,2d 1h 19m,Buy
139099.75,119393,19.10.2015 06:15:00,,-0.66,-0.0,0.0,0.0,119314,16.10.2015 22:15:00,12314,-0.0,17.21,IS,0.27,0.0,Phase3-EA-S1v2-USDJPY-M15-0,USDJPYMT4,3514,2d 8h 0m,Buy
139066.99,135.49,19.10.2015 11:44:58,sl 135.490,0.0,-32.76000000000931,0.0,0.0,135.72,19.10.2015 07:15:00,12315,-0.01429944816614122,-32.76,IS,0.17,0.0,Phase3-EA-T1v2-EURJPY-M15-322,EURJPYMT4,2334,4h 29m,Buy
139060.59,1.08333,19.10.2015 13:45:00,,0.0,-39.16000000000349,0.0,0.0,1.08315,19.10.2015 05:00:00,12316,-0.01709299115341822,-6.4,IS,0.34,0.0,Phase3-EA-S4v1-EURCHF-M15-221,EURCHFMT4,3224,8h 45m,Sell
139005.94,135128,19.10.2015 14:29:58,sl 135.128,-0.37,-93.80999999999767,0.0,0.0,135301,16.10.2015 00:30:00,12317,-0.040947229318232393,-54.65,IS,0.09,0.0,Phase3-EA-TR1v1-EURJPY-M30-91,EURJPYMT4,2202,3d 13h 59m,Buy
138979.78,1.08322,20.10.2015 06:10:00,,-2.14,-119.97000000000116,0.0,0.0,1.08266,19.10.2015 21:50:00,12318,-0.052365836278739045,-26.16,IS,0.41,0.0,Phase3-EA-SA2v2-EURCHF-M5-43,EURCHFMT4,6262,8h 20m,Sell
138880.72,1.08568,21.10.2015 04:20:00,,-2.14,-219.02999999999884,0.0,0.0,1.08342,20.10.2015 20:00:00,12319,-0.09560464382872419,-99.06,IS,0.41,0.0,Phase3-EA-SA2v2-EURCHF-M5-43,EURCHFMT4,6264,8h 20m,Sell
138867.98,0.95571,21.10.2015 05:30:00,,0.0,-231.76999999998952,0.0,0.0,0.95592,21.10.2015 01:15:00,12320,-0.10116554033777346,-12.74,IS,0.58,0.0,Phase3-EA-SA2v2-USDCHF-M15-107,USDCHFMT4,2396,4h 15m,Buy
138824.92,1.54322,21.10.2015 09:59:58,sl 1.54322,-1.06,-274.8299999999872,0.0,0.0,1.54622,19.10.2015 12:00:00,12321,-0.11996084674906261,-43.06,IS,0.14,0.0,Phase3-EA-B1v1-GBPUSD-M30-14,GBPUSDMT4,824,1d 21h 59m,Buy
138787.98,1.08662,21.10.2015 14:00:00,,0.0,-311.7699999999895,0.0,0.0,1.08558,21.10.2015 05:15:00,12322,-0.13608482767876773,-36.94,IS,0.34,0.0,Phase3-EA-S4v1-EURCHF-M15-221,EURCHFMT4,3226,8h 45m,Sell
138710.21,1.08847,22.10.2015 07:05:00,,-6.41,-389.53999999997905,0.0,0.0,1.0868,21.10.2015 22:45:00,12323,-0.1700307398851272,-77.77,IS,0.41,0.0,Phase3-EA-SA2v2-EURCHF-M5-43,EURCHFMT4,6266,8h 20m,Sell
138735.38,1.08702,22.10.2015 10:15:00,,0.0,-364.36999999996624,0.0,0.0,1.08773,22.10.2015 01:30:00,12324,-0.1590442591054613,25.17,IS,0.34,0.0,Phase3-EA-S4v1-EURCHF-M15-221,EURCHFMT4,3228,8h 45m,Sell
138674.54,134521,22.10.2015 16:59:58,sl 134.521,-2.21,-425.20999999996275,0.0,0.0,135848,16.10.2015 21:30:00,12325,-0.18560037712828592,-60.84,IS,0.09,0.0,Phase3-EA-TR1v1-EURJPY-M30-91,EURJPYMT4,2203,5d 19h 29m,Buy
138720.95,1.08233,22.10.2015 21:19:58,tp 1.08233,0.0,-378.79999999995925,0.0,0.0,1.08123,22.10.2015 20:15:00,12326,-0.1653428255595901,46.41,IS,0.41,0.0,Phase3-EA-SA2v2-EURCHF-M5-43,EURCHFMT4,6268,1h 4m,Buy
138730.31,0.97292,23.10.2015 02:15:00,,-3.16,-369.4399999999732,0.0,0.0,0.97313,22.10.2015 22:00:00,12327,-0.16125726894069986,9.36,IS,0.58,0.0,Phase3-EA-SA2v2-USDCHF-M15-107,USDCHFMT4,2398,4h 15m,Sell
138776.66,1.0815,23.10.2015 07:54:58,tp 1.08150,0.0,-323.0899999999674,0.0,0.0,1.0804,23.10.2015 00:10:00,12328,-0.14102590683750876,46.35,IS,0.41,0.0,Phase3-EA-SA2v2-EURCHF-M5-43,EURCHFMT4,6270,7h 44m,Buy
138794.83,1.08126,23.10.2015 10:45:00,,0.0,-304.9199999999546,0.0,0.0,1.08074,23.10.2015 02:00:00,12329,-0.13309486370017984,18.17,IS,0.34,0.0,Phase3-EA-S4v1-EURCHF-M15-221,EURCHFMT4,3230,8h 45m,Buy
138762.44,134.24,23.10.2015 12:14:57,sl 134.240,0.0,-337.30999999996857,0.0,0.0,134.01,23.10.2015 11:15:00,12330,-0.147232810162371,-32.39,IS,0.17,0.0,Phase3-EA-T1v2-EURJPY-M15-322,EURJPYMT4,2336,59m 57s,Sell
138729.95,133997,23.10.2015 13:59:57,sl 133.997,0.0,-369.79999999995925,0.0,0.0,133767,23.10.2015 12:15:00,12331,-0.16141440573372823,-32.49,IS,0.17,0.0,Phase3-EA-T1v2-EURJPY-M15-322,EURJPYMT4,2338,1h 44m,Sell
138776.07,1.07741,23.10.2015 21:59:58,tp 1.07741,0.0,-323.6799999999639,0.0,0.0,1.07631,23.10.2015 20:15:00,12332,-0.14128343658164708,46.12,IS,0.41,0.0,Phase3-EA-SA2v2-EURCHF-M5-43,EURCHFMT4,6272,1h 44m,Buy
138832.19,0.97873,26.10.2015 02:14:58,tp 0.97873,-3.14,-267.55999999996857,0.0,0.0,0.97973,23.10.2015 23:00:00,12333,-0.11678755651194163,56.12,IS,0.58,0.0,Phase3-EA-SA2v2-USDCHF-M15-107,USDCHFMT4,2400,2d 3h 14m,Sell
138841.85,1.07772,26.10.2015 06:35:00,,-2.09,-257.8999999999651,0.0,0.0,1078,23.10.2015 22:15:00,12334,-0.11257105256551504,9.66,IS,0.41,0.0,Phase3-EA-SA2v2-EURCHF-M5-43,EURCHFMT4,6274,2d 8h 20m,Sell
138836.64,1.07907,26.10.2015 13:30:00,,0.0,-263.1099999999569,0.0,0.0,1.07892,26.10.2015 04:45:00,12335,-0.11484517115359373,-5.21,IS,0.34,0.0,Phase3-EA-S4v1-EURCHF-M15-221,EURCHFMT4,3232,8h 45m,Sell
138804.3,133748,26.10.2015 21:14:58,sl 133.748,0.0,-295.44999999995343,0.0,0.0,133518,26.10.2015 05:15:00,12336,-0.12896129306118914,-32.34,IS,0.17,0.0,Phase3-EA-T1v2-EURJPY-M15-322,EURJPYMT4,2340,15h 59m,Sell
138878.55,185446,27.10.2015 04:44:57,tp 185.446,0.0,-221.19999999995343,0.0,0.0,185836,27.10.2015 03:25:00,12337,-0.09655182949782884,74.25,IS,0.23,0.0,Phase3-EA-S4v1-GBPJPY-M5-194,GBPJPYMT4,2736,1h 19m,Sell
138788.86,1.08608,27.10.2015 04:55:00,,-2.09,-310.88999999995576,0.0,0.0,1.08398,26.10.2015 20:35:00,12338,-0.13570071551800206,-89.69,IS,0.41,0.0,Phase3-EA-SA2v2-EURCHF-M5-43,EURCHFMT4,6276,8h 20m,Sell
138856.81,1.08517,27.10.2015 10:00:00,,0.0,-242.93999999994412,0.0,0.0,1.08713,27.10.2015 01:15:00,12339,-0.10604114583273996,67.95,IS,0.34,0.0,Phase3-EA-S4v1-EURCHF-M15-221,EURCHFMT4,3234,8h 45m,Sell
138814.81,1.53529,27.10.2015 16:59:57,sl 1.53529,0.0,-284.9399999999441,0.0,0.0,1.53229,27.10.2015 13:30:00,12340,-0.12437377168676196,-42.0,IS,0.14,0.0,Phase3-EA-B1v1-GBPUSD-M30-14,GBPUSDMT4,826,3h 29m,Sell
138842.87,120289,27.10.2015 17:15:00,,0.0,-256.87999999994645,0.0,0.0,120414,27.10.2015 17:00:00,12341,-0.11212583165190923,28.06,IS,0.27,0.0,Phase3-EA-S1v2-USDJPY-M15-0,USDJPYMT4,3516,15m 0s,Sell
138855.45,120231,27.10.2015 17:30:00,,0.0,-244.29999999995925,0.0,0.0,120287,27.10.2015 17:15:00,12342,-0.10663477371754347,12.58,IS,0.27,0.0,Phase3-EA-S1v2-USDJPY-M15-0,USDJPYMT4,3518,15m 0s,Sell
138874.53,120302,27.10.2015 18:30:00,,0.0,-225.21999999997206,0.0,0.0,120387,27.10.2015 18:00:00,12343,-0.09830652368672194,19.08,IS,0.27,0.0,Phase3-EA-S1v2-USDJPY-M15-0,USDJPYMT4,3520,30m 0s,Sell
138920.3,1.08759,27.10.2015 22:29:58,tp 1.08759,0.0,-179.44999999998254,0.0,0.0,1.08869,27.10.2015 20:45:00,12344,-0.07832832641676016,45.77,IS,0.41,0.0,Phase3-EA-SA2v2-EURCHF-M5-43,EURCHFMT4,6278,1h 44m,Sell
138963.93,1.08827,28.10.2015 05:59:57,tp 1.08827,-2.08,-135.81999999997788,0.0,0.0,1.08937,27.10.2015 23:30:00,12345,-0.05928422008316337,43.63,IS,0.41,0.0,Phase3-EA-SA2v2-EURCHF-M5-43,EURCHFMT4,6280,6h 29m,Sell
138989.72,184244,28.10.2015 08:25:00,,0.0,-110.02999999996973,0.0,0.0,184379,28.10.2015 03:00:00,12346,-0.048027114826606786,25.79,IS,0.23,0.0,Phase3-EA-S4v1-GBPJPY-M5-194,GBPJPYMT4,2738,5h 25m,Sell
139035.52,1.08937,28.10.2015 21:04:58,tp 1.08937,0.0,-64.22999999998137,0.0,0.0,1.09047,28.10.2015 20:25:00,12347,-0.028035822823892647,45.8,IS,0.41,0.0,Phase3-EA-SA2v2-EURCHF-M5-43,EURCHFMT4,6282,39m 58s,Sell
139080.92,1.08647,28.10.2015 22:24:58,tp 1.08647,0.0,-18.829999999987194,0.0,0.0,1.08537,28.10.2015 22:05:00,12348,-0.008219127257880937,45.4,IS,0.41,0.0,Phase3-EA-SA2v2-EURCHF-M5-43,EURCHFMT4,6284,19m 58s,Buy
139174.26,132625,28.10.2015 22:29:57,tp 132.625,-0.78,-0.0,0.0,0.0,133885,23.10.2015 04:30:00,12349,-0.0,93.34,IS,0.09,0.0,Phase3-EA-TR1v1-EURJPY-M30-91,EURJPYMT4,2206,5d 17h 59m,Sell
139132.26,1.52939,28.10.2015 22:29:58,sl 1.52939,0.0,-42.0,0.0,0.0,1.53239,28.10.2015 19:00:00,12350,-0.01832666548154219,-42.0,IS,0.14,0.0,Phase3-EA-B1v1-GBPUSD-M30-14,GBPUSDMT4,828,3h 29m,Buy
139082.1,184941,28.10.2015 23:29:58,sl 184.941,-0.43,-92.16000000000349,0.0,0.0,184271,27.10.2015 17:30:00,12351,-0.04021394025664267,-50.16,IS,0.09,0.0,Phase3-EA-B1v1-GBPJPY-M30-1,GBPJPYMT4,1152,1d 5h 59m,Sell
139127.6,1.08594,29.10.2015 21:29:57,tp 1.08594,0.0,-46.66000000000349,0.0,0.0,1.08704,29.10.2015 20:40:00,12352,-0.020360052651638632,45.5,IS,0.41,0.0,Phase3-EA-SA2v2-EURCHF-M5-43,EURCHFMT4,6286,49m 57s,Sell
139173.19,1.08704,30.10.2015 03:34:57,tp 1.08704,0.0,-1.070000000006985,0.0,0.0,1.08594,30.10.2015 01:05:00,12353,-4.6689362060424173E-4,45.59,IS,0.41,0.0,Phase3-EA-SA2v2-EURCHF-M5-43,EURCHFMT4,6288,2h 29m,Buy
139231.78,0.98994,30.10.2015 06:14:57,tp 0.98994,0.0,-0.0,0.0,0.0,0.98894,30.10.2015 02:00:00,12354,-0.0,58.59,IS,0.58,0.0,Phase3-EA-SA2v2-USDCHF-M15-107,USDCHFMT4,2402,4h 14m,Buy
139181.65,184764,30.10.2015 07:29:58,sl 184.764,-0.27,-50.13000000000466,0.0,0.0,185434,29.10.2015 22:30:00,12355,-0.02186869551857267,-50.13,IS,0.09,0.0,Phase3-EA-B1v1-GBPJPY-M30-1,GBPJPYMT4,1154,8h 59m,Buy
139128.07,132274,30.10.2015 07:29:58,sl 132.274,0.0,-103.70999999999185,0.0,0.0,132273,29.10.2015 13:30:00,12356,-0.04524241795792505,-53.58,IS,0.09,0.0,Phase3-EA-TR1v1-EURJPY-M30-91,EURJPYMT4,2208,17h 59m,Buy
139095.81,132915,30.10.2015 09:59:58,sl 132.915,0.0,-135.97000000000116,0.0,0.0,133145,30.10.2015 09:15:00,12357,-0.05931551026650858,-32.26,IS,0.17,0.0,Phase3-EA-T1v2-EURJPY-M15-322,EURJPYMT4,2342,44m 58s,Buy
139093.75,1.08692,30.10.2015 12:30:00,,0.0,-138.02999999999884,0.0,0.0,1.08686,30.10.2015 03:45:00,12358,-0.060214164022108115,-2.06,IS,0.34,0.0,Phase3-EA-S4v1-EURCHF-M15-221,EURCHFMT4,3236,8h 45m,Sell
139149.39,0.98725,02.11.2015 02:00:00,tp 0.98725,-3.11,-82.38999999998487,0.0,0.0,0.98825,30.10.2015 23:15:00,12359,-0.03594178782714351,55.64,IS,0.58,0.0,Phase3-EA-SA2v2-USDCHF-M15-107,USDCHFMT4,2404,2d 2h 45m,Sell
139185.12,120523,02.11.2015 02:15:00,,-1.01,-46.65999999997439,0.0,0.0,120687,30.10.2015 17:00:00,12360,-0.020354943804028445,35.73,IS,0.27,0.0,Phase3-EA-S1v2-USDJPY-M15-0,USDJPYMT4,3522,2d 9h 15m,Sell
139143.41,1.0877,02.11.2015 04:25:00,,-1.0,-88.36999999996624,0.0,0.0,1.08868,30.10.2015 20:05:00,12361,-0.03855050115650008,-41.71,IS,0.41,0.0,Phase3-EA-SA2v2-EURCHF-M5-43,EURCHFMT4,6290,2d 8h 20m,Buy
139128.96,1.08822,02.11.2015 13:45:00,,0.0,-102.81999999997788,0.0,0.0,1.0878,02.11.2015 05:00:00,12362,-0.044854164636324544,-14.45,IS,0.34,0.0,Phase3-EA-S4v1-EURCHF-M15-221,EURCHFMT4,3238,8h 45m,Sell
139142.16,120638,02.11.2015 19:45:00,,0.0,-89.61999999996624,0.0,0.0,120579,02.11.2015 17:00:00,12363,-0.039095800765481,13.2,IS,0.27,0.0,Phase3-EA-S1v2-USDJPY-M15-0,USDJPYMT4,3524,2h 45m,Buy
139109.76,132846,03.11.2015 12:29:58,sl 132.846,0.0,-122.01999999996042,0.0,0.0,133076,03.11.2015 04:45:00,12364,-0.05322996663026379,-32.4,IS,0.17,0.0,Phase3-EA-T1v2-EURJPY-M15-322,EURJPYMT4,2344,7h 44m,Buy
139150.09,121233,04.11.2015 05:15:00,,-0.65,-81.68999999997322,0.0,0.0,121049,03.11.2015 22:00:00,12365,-0.03563642004610912,40.33,IS,0.27,0.0,Phase3-EA-S1v2-USDJPY-M15-0,USDJPYMT4,3526,7h 15m,Buy
139152.16,1.0859,04.11.2015 10:20:00,,0.0,-79.61999999996624,0.0,0.0,1.08595,04.11.2015 02:00:00,12366,-0.03473340389363367,2.07,IS,0.41,0.0,Phase3-EA-SA2v2-EURCHF-M5-43,EURCHFMT4,6292,8h 20m,Sell
139197.38,1.08513,04.11.2015 11:15:00,,0.0,-34.399999999965075,0.0,0.0,1.08645,04.11.2015 02:30:00,12367,-0.015006645239139561,45.22,IS,0.34,0.0,Phase3-EA-S4v1-EURCHF-M15-221,EURCHFMT4,3240,8h 45m,Sell
139155.38,1.53978,04.11.2015 17:29:58,sl 1.53978,0.0,-76.39999999996508,0.0,0.0,1.54278,04.11.2015 12:00:00,12368,-0.03332871210089833,-42.0,IS,0.14,0.0,Phase3-EA-B1v1-GBPUSD-M30-14,GBPUSDMT4,830,5h 29m,Buy
139194.6,1.07839,05.11.2015 02:00:00,tp 1.07839,-6.19,-37.17999999996391,0.0,0.0,1.07949,04.11.2015 22:05:00,12369,-0.01621939156951261,39.22,IS,0.41,0.0,Phase3-EA-SA2v2-EURCHF-M5-43,EURCHFMT4,6294,3h 55m,Sell
139146.13,0.99321,05.11.2015 04:45:00,,0.0,-85.64999999996508,0.0,0.0,0.99404,05.11.2015 00:30:00,12370,-0.0373639292073571,-48.47,IS,0.58,0.0,Phase3-EA-SA2v2-USDCHF-M15-107,USDCHFMT4,2406,4h 15m,Buy
139154.35,121562,05.11.2015 11:15:00,,0.0,-77.42999999996391,0.0,0.0,121525,05.11.2015 00:15:00,12371,-0.03377803897869809,8.22,IS,0.27,0.0,Phase3-EA-S1v2-USDJPY-M15-0,USDJPYMT4,3528,11h 0m,Buy
139122.25,132201,05.11.2015 12:14:58,sl 132.201,0.0,-109.52999999996973,0.0,0.0,131971,05.11.2015 05:00:00,12372,-0.04778133293733054,-32.1,IS,0.17,0.0,Phase3-EA-T1v2-EURJPY-M15-322,EURJPYMT4,2346,7h 14m,Sell
139165.49,1.08228,06.11.2015 01:59:59,tp 1.08228,-2.06,-66.28999999997905,0.0,0.0,1.08338,05.11.2015 22:30:00,12373,-0.028918328863466774,43.24,IS,0.41,0.0,Phase3-EA-SA2v2-EURCHF-M5-43,EURCHFMT4,6296,3h 29m,Sell
139141.11,121712,06.11.2015 08:30:00,,-0.64,-90.6699999999837,0.0,0.0,121819,05.11.2015 17:30:00,12374,-0.039553852437032584,-24.38,IS,0.27,0.0,Phase3-EA-S1v2-USDJPY-M15-0,USDJPYMT4,3530,15h 0m,Buy
139186.39,1.08379,06.11.2015 10:14:57,tp 1.08379,0.0,-45.389999999984866,0.0,0.0,1.08269,06.11.2015 02:05:00,12375,-0.019800919401308403,45.28,IS,0.41,0.0,Phase3-EA-SA2v2-EURCHF-M5-43,EURCHFMT4,6298,8h 9m,Buy
139154.65,132446,06.11.2015 20:44:57,sl 132.446,0.0,-77.12999999997555,0.0,0.0,132216,06.11.2015 17:30:00,12376,-0.03364716707254775,-31.74,IS,0.17,0.0,Phase3-EA-T1v2-EURJPY-M15-322,EURJPYMT4,2348,3h 14m,Sell
139209.27,1.00553,09.11.2015 02:00:00,tp 1.00553,-3.06,-22.50999999998021,0.0,0.0,1.00653,06.11.2015 22:30:00,12377,-0.009819755358519694,54.62,IS,0.58,0.0,Phase3-EA-SA2v2-USDCHF-M15-107,USDCHFMT4,2408,2d 3h 30m,Sell
139252.1,1.07901,09.11.2015 02:00:00,tp 1.07901,-2.04,-0.0,0.0,0.0,1.08011,06.11.2015 20:50:00,12378,-0.0,42.83,IS,0.41,0.0,Phase3-EA-SA2v2-EURCHF-M5-43,EURCHFMT4,6300,2d 5h 10m,Sell
139296.96,1.07919,09.11.2015 02:34:58,tp 1.07919,0.0,-0.0,0.0,0.0,1.07809,09.11.2015 02:05:00,12379,-0.0,44.86,IS,0.41,0.0,Phase3-EA-SA2v2-EURCHF-M5-43,EURCHFMT4,6302,29m 58s,Buy
139295.6,1.07879,09.11.2015 12:15:00,,0.0,-1.3599999999860302,0.0,0.0,1.07883,09.11.2015 03:30:00,12380,-5.931173269746019E-4,-1.36,IS,0.34,0.0,Phase3-EA-S4v1-EURCHF-M15-221,EURCHFMT4,3242,8h 45m,Buy
139338.51,1.07821,10.11.2015 02:00:00,tp 1.07821,-2.04,-0.0,0.0,0.0,1.07931,09.11.2015 23:25:00,12381,-0.0,42.91,IS,0.41,0.0,Phase3-EA-SA2v2-EURCHF-M5-43,EURCHFMT4,6304,2h 35m,Sell
139362.43,123053,10.11.2015 03:45:00,,0.0,-0.0,0.0,0.0,123162,10.11.2015 00:45:00,12382,-0.0,23.92,IS,0.27,0.0,Phase3-EA-S1v2-USDJPY-M15-0,USDJPYMT4,3532,3h 0m,Sell
139359.07,186067,10.11.2015 08:15:00,,0.0,-3.35999999998603,0.0,0.0,186085,10.11.2015 02:50:00,12383,-0.0014649304160171347,-3.36,IS,0.23,0.0,Phase3-EA-S4v1-GBPJPY-M5-194,GBPJPYMT4,2740,5h 25m,Buy
139357.38,1.07932,10.11.2015 12:45:00,,0.0,-5.0499999999883585,0.0,0.0,1.07927,10.11.2015 04:00:00,12384,-0.0022017555359822127,-1.69,IS,0.34,0.0,Phase3-EA-S4v1-EURCHF-M15-221,EURCHFMT4,3244,8h 45m,Sell
139266.7,1.00423,11.11.2015 06:00:00,,0.0,-95.72999999998137,0.0,0.0,1.0058,11.11.2015 01:45:00,12385,-0.04173743712079646,-90.68,IS,0.58,0.0,Phase3-EA-SA2v2-USDCHF-M15-107,USDCHFMT4,2410,4h 15m,Buy
139263.7,186282,11.11.2015 06:00:00,,0.0,-98.72999999998137,0.0,0.0,186266,11.11.2015 00:35:00,12386,-0.04304541070653148,-3.0,IS,0.23,0.0,Phase3-EA-S4v1-GBPJPY-M5-194,GBPJPYMT4,2742,5h 25m,Sell
139193.86,1.0794,11.11.2015 06:15:00,,-2.04,-168.56999999997788,0.0,0.0,1.07774,10.11.2015 21:55:00,12387,-0.07349503578244129,-69.84,IS,0.41,0.0,Phase3-EA-SA2v2-EURCHF-M5-43,EURCHFMT4,6306,8h 20m,Sell
139182.01,1.07911,11.11.2015 11:00:00,,0.0,-180.4199999999837,0.0,0.0,1.07876,11.11.2015 02:15:00,12388,-0.07866153144609717,-11.85,IS,0.34,0.0,Phase3-EA-S4v1-EURCHF-M15-221,EURCHFMT4,3246,8h 45m,Sell
139315.96,187123,12.11.2015 04:59:57,tp 187.123,-1.57,-46.46999999997206,0.0,0.0,185273,06.11.2015 19:30:00,12389,-0.02026051084302332,133.95,IS,0.09,0.0,Phase3-EA-B1v1-GBPJPY-M30-1,GBPJPYMT4,1156,5d 9h 29m,Buy
139282.22,132495,12.11.2015 05:59:58,sl 132.495,-1.93,-80.20999999996275,0.0,0.0,132265,10.11.2015 13:45:00,12390,-0.03497085377058582,-33.74,IS,0.17,0.0,Phase3-EA-T1v2-EURJPY-M15-322,EURJPYMT4,2350,1d 16h 14m,Sell
139240.11,1.07946,12.11.2015 07:15:00,,-6.12,-122.31999999994878,0.0,0.0,1.07858,11.11.2015 22:55:00,12391,-0.053330443002346996,-42.11,IS,0.41,0.0,Phase3-EA-SA2v2-EURCHF-M5-43,EURCHFMT4,6308,8h 20m,Sell
139227.59,1.08002,12.11.2015 12:15:00,,0.0,-134.8399999999383,0.0,0.0,1.07965,12.11.2015 03:30:00,12392,-0.05878905276680992,-12.52,IS,0.34,0.0,Phase3-EA-S4v1-EURCHF-M15-221,EURCHFMT4,3248,8h 45m,Sell
139165.42,131493,12.11.2015 12:59:58,sl 131.493,-5.07,-197.0099999999511,0.0,0.0,132994,30.10.2015 02:00:00,12393,-0.08589462537519763,-62.17,IS,0.09,0.0,Phase3-EA-TR1v1-EURJPY-M30-91,EURJPYMT4,2209,13d 10h 59m,Buy
139223.36,1.00097,12.11.2015 23:59:58,tp 1.00097,0.0,-139.06999999994878,0.0,0.0,1.00197,12.11.2015 23:15:00,12394,-0.06063329552270087,57.94,IS,0.58,0.0,Phase3-EA-SA2v2-USDCHF-M15-107,USDCHFMT4,2412,44m 58s,Sell
139198.79,1.08047,13.11.2015 07:55:00,,-2.05,-163.63999999995576,0.0,0.0,1.07992,12.11.2015 23:35:00,12395,-0.07134559918987375,-24.57,IS,0.41,0.0,Phase3-EA-SA2v2-EURCHF-M5-43,EURCHFMT4,6310,8h 20m,Sell
139244.92,1.08007,13.11.2015 10:30:00,,0.0,-117.5099999999511,0.0,0.0,1.08143,13.11.2015 01:45:00,12396,-0.051233325353219526,46.13,IS,0.34,0.0,Phase3-EA-S4v1-EURCHF-M15-221,EURCHFMT4,3250,8h 45m,Sell
139287.74,1.08037,16.11.2015 02:00:00,tp 1.08037,-2.03,-74.68999999994412,0.0,0.0,1.08147,13.11.2015 20:00:00,12397,-0.032564182372825254,42.82,IS,0.41,0.0,Phase3-EA-SA2v2-EURCHF-M5-43,EURCHFMT4,6312,2d 6h 0m,Sell
139380.12,130741,16.11.2015 03:29:58,tp 130.741,-0.26,-0.0,0.0,0.0,132001,13.11.2015 13:30:00,12398,-0.0,92.38,IS,0.09,0.0,Phase3-EA-TR1v1-EURJPY-M30-91,EURJPYMT4,2212,2d 13h 59m,Sell
139436.92,1.00879,16.11.2015 03:29:58,tp 1.00879,-0.69,-0.0,0.0,0.0,1.00779,13.11.2015 23:45:00,12399,-0.0,56.8,IS,0.58,0.0,Phase3-EA-SA2v2-USDCHF-M15-107,USDCHFMT4,2414,2d 3h 44m,Buy
139415.88,186.26,16.11.2015 07:40:00,,0.0,-21.04000000000815,0.0,0.0,186372,16.11.2015 02:15:00,12400,-0.009170276518708505,-21.04,IS,0.23,0.0,Phase3-EA-S4v1-GBPJPY-M5-194,GBPJPYMT4,2744,5h 25m,Buy
139426.01,1.07994,16.11.2015 13:15:00,,0.0,-10.910000000003492,0.0,0.0,1.07964,16.11.2015 04:30:00,12401,-0.004755119620679804,10.13,IS,0.34,0.0,Phase3-EA-S4v1-EURCHF-M15-221,EURCHFMT4,3252,8h 45m,Buy
139463.5,123158,16.11.2015 19:30:00,,0.0,-0.0,0.0,0.0,122987,16.11.2015 17:45:00,12402,-0.0,37.49,IS,0.27,0.0,Phase3-EA-S1v2-USDJPY-M15-0,USDJPYMT4,3534,1h 45m,Buy
139508.14,1.07851,16.11.2015 23:54:58,tp 1.07851,0.0,-0.0,0.0,0.0,1.07961,16.11.2015 21:45:00,12403,-0.0,44.64,IS,0.41,0.0,Phase3-EA-SA2v2-EURCHF-M5-43,EURCHFMT4,6314,2h 9m,Sell
139483.85,1.00968,17.11.2015 02:15:00,,-3.04,-24.29000000000815,0.0,0.0,1.00931,16.11.2015 22:00:00,12404,-0.01058350261564056,-24.29,IS,0.58,0.0,Phase3-EA-SA2v2-USDCHF-M15-107,USDCHFMT4,2416,4h 15m,Sell
139499.84,123259,17.11.2015 03:00:00,,0.0,-8.300000000017462,0.0,0.0,123186,17.11.2015 01:15:00,12405,-0.0036164294652108677,15.99,IS,0.27,0.0,Phase3-EA-S1v2-USDJPY-M15-0,USDJPYMT4,3536,1h 45m,Buy
139503.01,187264,17.11.2015 07:30:00,,0.0,-5.130000000004657,0.0,0.0,187247,17.11.2015 02:05:00,12406,-0.002235214838133682,3.17,IS,0.23,0.0,Phase3-EA-S4v1-GBPJPY-M5-194,GBPJPYMT4,2746,5h 25m,Buy
139461.08,1.07749,17.11.2015 08:15:00,,-0.97,-47.05999999999767,0.0,0.0,1.0785,16.11.2015 23:55:00,12407,-0.020504719353308068,-41.93,IS,0.41,0.0,Phase3-EA-SA2v2-EURCHF-M5-43,EURCHFMT4,6316,8h 20m,Buy
139471.5,1.07843,17.11.2015 14:30:00,,0.0,-36.639999999984866,0.0,0.0,1.07812,17.11.2015 05:45:00,12408,-0.015964575374095503,10.42,IS,0.34,0.0,Phase3-EA-S4v1-EURCHF-M15-221,EURCHFMT4,3254,8h 45m,Buy
139515.9,1.08082,18.11.2015 06:49:58,tp 1.08082,0.0,-0.0,0.0,0.0,1.07972,18.11.2015 00:40:00,12409,-0.0,44.4,IS,0.41,0.0,Phase3-EA-SA2v2-EURCHF-M5-43,EURCHFMT4,6318,6h 9m,Buy
139554.07,1.08102,18.11.2015 10:15:00,,0.0,-0.0,0.0,0.0,1.07988,18.11.2015 01:30:00,12410,-0.0,38.17,IS,0.34,0.0,Phase3-EA-S4v1-EURCHF-M15-221,EURCHFMT4,3256,8h 45m,Buy
139598.37,1.08553,18.11.2015 23:04:58,tp 1.08553,0.0,-0.0,0.0,0.0,1.08443,18.11.2015 22:05:00,12411,-0.0,44.3,IS,0.41,0.0,Phase3-EA-SA2v2-EURCHF-M5-43,EURCHFMT4,6320,59m 58s,Buy
139856.59,1.52756,19.11.2015 05:59:58,tp 1.52756,-6.38,-0.0,0.0,0.0,1.50866,09.11.2015 14:30:00,12412,-0.0,258.22,IS,0.14,0.0,Phase3-EA-B1v1-GBPUSD-M30-14,GBPUSDMT4,832,9d 15h 29m,Buy
139858.64,188289,19.11.2015 07:40:00,,0.0,-0.0,0.0,0.0,188.3,19.11.2015 02:15:00,12413,-0.0,2.05,IS,0.23,0.0,Phase3-EA-S4v1-GBPJPY-M5-194,GBPJPYMT4,2748,5h 25m,Sell
139817.47,1.08732,19.11.2015 09:55:00,,0.0,-41.170000000012806,0.0,0.0,1.0863,19.11.2015 01:35:00,12414,-0.01791100826143083,-41.17,IS,0.41,0.0,Phase3-EA-SA2v2-EURCHF-M5-43,EURCHFMT4,6322,8h 20m,Sell
139807.77,1.08675,19.11.2015 11:15:00,,0.0,-50.87000000002445,0.0,0.0,1.08646,19.11.2015 02:30:00,12415,-0.022130993205225668,-9.7,IS,0.34,0.0,Phase3-EA-S4v1-EURCHF-M15-221,EURCHFMT4,3258,8h 45m,Sell
139758.82,187783,19.11.2015 13:59:57,sl 187.783,0.0,-99.82000000003609,0.0,0.0,188453,19.11.2015 05:30:00,12416,-0.04342669042157191,-48.95,IS,0.09,0.0,Phase3-EA-B1v1-GBPJPY-M30-1,GBPJPYMT4,1158,8h 29m,Buy
139801.46,122856,19.11.2015 18:30:00,,0.0,-57.18000000002212,0.0,0.0,123.05,19.11.2015 18:15:00,12417,-0.024876158668659037,42.64,IS,0.27,0.0,Phase3-EA-S1v2-USDJPY-M15-0,USDJPYMT4,3538,15m 0s,Sell
139845.89,1.08837,19.11.2015 22:19:58,tp 1.08837,0.0,-12.750000000029104,0.0,0.0,1.08947,19.11.2015 20:30:00,12418,-0.005546887426128087,44.43,IS,0.41,0.0,Phase3-EA-SA2v2-EURCHF-M5-43,EURCHFMT4,6324,1h 49m,Sell
139874.38,1.01357,20.11.2015 04:00:00,,-0.69,-0.0,0.0,0.0,1.01306,19.11.2015 23:45:00,12419,-0.0,28.49,IS,0.58,0.0,Phase3-EA-SA2v2-USDCHF-M15-107,USDCHFMT4,2418,4h 15m,Buy
139795.32,1.08642,20.11.2015 07:00:00,,-0.97,-79.05999999999767,0.0,0.0,1.08835,19.11.2015 22:40:00,12420,-0.034392697437616665,-79.06,IS,0.41,0.0,Phase3-EA-SA2v2-EURCHF-M5-43,EURCHFMT4,6326,8h 20m,Buy
139787.41,122869,20.11.2015 08:45:00,,0.0,-86.97000000000116,0.0,0.0,122833,20.11.2015 00:15:00,12421,-0.037833707262201484,-7.91,IS,0.27,0.0,Phase3-EA-S1v2-USDJPY-M15-0,USDJPYMT4,3540,8h 30m,Sell
139742.77,1.0862,20.11.2015 10:00:00,,0.0,-131.61000000001513,0.0,0.0,1.08753,20.11.2015 01:15:00,12422,-0.05725300923052597,-44.64,IS,0.34,0.0,Phase3-EA-S4v1-EURCHF-M15-221,EURCHFMT4,3260,8h 45m,Buy
139785.06,1.08463,23.11.2015 02:00:00,tp 1.08463,-2.01,-89.32000000000698,0.0,0.0,1.08573,20.11.2015 23:20:00,12423,-0.03885600474485519,42.29,IS,0.41,0.0,Phase3-EA-SA2v2-EURCHF-M5-43,EURCHFMT4,6328,2d 2h 40m,Sell
139725.52,130608,23.11.2015 06:29:58,sl 130.608,-2.51,-148.86000000001513,0.0,0.0,131388,16.11.2015 05:30:00,12424,-0.06475710777339094,-59.54,IS,0.09,0.0,Phase3-EA-TR1v1-EURJPY-M30-91,EURJPYMT4,2214,7d 0h 59m,Buy
139773.89,186794,23.11.2015 07:30:00,,0.0,-100.49000000001979,0.0,0.0,186535,23.11.2015 02:05:00,12425,-0.043715180438994194,48.37,IS,0.23,0.0,Phase3-EA-S4v1-GBPJPY-M5-194,GBPJPYMT4,2750,5h 25m,Buy
139749.79,1.08387,23.11.2015 10:25:00,,0.0,-124.59000000002561,0.0,0.0,1.08447,23.11.2015 02:05:00,12426,-0.05419916738873852,-24.1,IS,0.41,0.0,Phase3-EA-SA2v2-EURCHF-M5-43,EURCHFMT4,6330,8h 20m,Buy
139734.13,1.08377,23.11.2015 11:00:00,,0.0,-140.2500000000291,0.0,0.0,1.08424,23.11.2015 02:15:00,12427,-0.06101158380504529,-15.66,IS,0.34,0.0,Phase3-EA-S4v1-EURCHF-M15-221,EURCHFMT4,3262,8h 45m,Buy
139965.15,130412,23.11.2015 20:44:58,tp 130.412,-3.84,-0.0,0.0,0.0,132112,13.11.2015 17:00:00,12428,-0.0,231.02,IS,0.17,0.0,Phase3-EA-T1v2-EURJPY-M15-322,EURJPYMT4,2352,10d 3h 44m,Sell
140055.76,130391,23.11.2015 20:59:58,tp 130.391,-1.54,-0.0,0.0,0.0,131651,17.11.2015 01:30:00,12429,-0.0,90.61,IS,0.09,0.0,Phase3-EA-TR1v1-EURJPY-M30-91,EURJPYMT4,2215,6d 19h 29m,Sell
140067.28,1.0826,24.11.2015 04:50:00,,-0.97,-0.0,0.0,0.0,1.08229,23.11.2015 20:30:00,12430,-0.0,11.52,IS,0.41,0.0,Phase3-EA-SA2v2-EURCHF-M5-43,EURCHFMT4,6332,8h 20m,Buy
140086.64,185791,24.11.2015 05:10:00,,-0.67,-0.0,0.0,0.0,185684,23.11.2015 23:45:00,12431,-0.0,19.36,IS,0.23,0.0,Phase3-EA-S4v1-GBPJPY-M5-194,GBPJPYMT4,2752,5h 25m,Buy
140068.98,1.01791,24.11.2015 06:30:00,,0.0,-17.660000000003492,0.0,0.0,1.01822,24.11.2015 02:15:00,12432,-0.007675369591212854,-17.66,IS,0.58,0.0,Phase3-EA-SA2v2-USDCHF-M15-107,USDCHFMT4,2420,4h 15m,Buy
140204.42,184658,24.11.2015 17:29:58,tp 184.658,-0.42,-0.0,0.0,0.0,186508,23.11.2015 02:00:00,12433,-0.0,135.44,IS,0.09,0.0,Phase3-EA-B1v1-GBPJPY-M30-1,GBPJPYMT4,1160,1d 15h 29m,Sell
140227.25,1.08275,25.11.2015 04:30:00,,-0.97,-0.0,0.0,0.0,1.08216,24.11.2015 20:10:00,12434,-0.0,22.83,IS,0.41,0.0,Phase3-EA-SA2v2-EURCHF-M5-43,EURCHFMT4,6334,8h 20m,Buy
140284.35,1.01581,25.11.2015 04:44:58,tp 1.01581,0.0,-0.0,0.0,0.0,1.01681,25.11.2015 01:45:00,12435,-0.0,57.1,IS,0.58,0.0,Phase3-EA-SA2v2-USDCHF-M15-107,USDCHFMT4,2422,2h 59m,Sell
140258.66,1.08331,25.11.2015 13:30:00,,0.0,-25.69000000000233,0.0,0.0,1.08254,25.11.2015 04:45:00,12436,-0.011155773286374945,-25.69,IS,0.34,0.0,Phase3-EA-S4v1-EURCHF-M15-221,EURCHFMT4,3264,8h 45m,Sell
140209.15,185242,25.11.2015 17:59:59,sl 185.242,-0.43,-75.20000000001164,0.0,0.0,184572,24.11.2015 19:30:00,12437,-0.03265528030889255,-49.51,IS,0.09,0.0,Phase3-EA-B1v1-GBPJPY-M30-1,GBPJPYMT4,1162,22h 29m,Sell
140253.34,1.08422,25.11.2015 22:14:59,tp 1.08422,0.0,-31.010000000009313,0.0,0.0,1.08532,25.11.2015 20:05:00,12438,-0.013465960669932255,44.19,IS,0.41,0.0,Phase3-EA-SA2v2-EURCHF-M5-43,EURCHFMT4,6336,2h 9m,Sell
140310.17,1.02057,26.11.2015 02:00:00,tp 1.02057,0.0,-0.0,0.0,0.0,1.02157,26.11.2015 01:15:00,12439,-0.0,56.83,IS,0.58,0.0,Phase3-EA-SA2v2-USDCHF-M15-107,USDCHFMT4,2424,45m 0s,Sell
140354.31,1.08412,26.11.2015 02:00:00,tp 1.08412,0.0,-0.0,0.0,0.0,1.08522,26.11.2015 01:35:00,12440,-0.0,44.14,IS,0.41,0.0,Phase3-EA-SA2v2-EURCHF-M5-43,EURCHFMT4,6338,25m 0s,Sell
140258.53,1.08579,26.11.2015 10:45:00,,0.0,-95.77999999999884,0.0,0.0,1.08291,26.11.2015 02:00:00,12441,-0.04157942605892562,-95.78,IS,0.34,0.0,Phase3-EA-S4v1-EURCHF-M15-221,EURCHFMT4,3266,8h 45m,Sell
140280.74,185143,27.11.2015 04:35:00,,-0.68,-73.57000000000698,0.0,0.0,185021,26.11.2015 23:10:00,12442,-0.031937757101226615,22.21,IS,0.23,0.0,Phase3-EA-S4v1-GBPJPY-M5-194,GBPJPYMT4,2754,5h 25m,Buy
140248.94,1.08554,27.11.2015 05:30:00,,-0.96,-105.36999999999534,0.0,0.0,1.08631,26.11.2015 21:10:00,12443,-0.045742578031205385,-31.8,IS,0.41,0.0,Phase3-EA-SA2v2-EURCHF-M5-43,EURCHFMT4,6340,8h 20m,Buy
140262.54,1.02386,27.11.2015 05:45:00,,0.0,-91.76999999998952,0.0,0.0,1.02362,27.11.2015 01:30:00,12444,-0.0398386294573733,13.6,IS,0.58,0.0,Phase3-EA-SA2v2-USDCHF-M15-107,USDCHFMT4,2426,4h 15m,Buy
140220.01,1.50889,27.11.2015 09:59:57,sl 1.50889,-0.53,-134.29999999998836,0.0,0.0,1.51189,26.11.2015 18:30:00,12445,-0.05830149216656185,-42.53,IS,0.14,0.0,Phase3-EA-B1v1-GBPUSD-M30-14,GBPUSDMT4,834,15h 29m,Buy
140263.51,1.08692,27.11.2015 10:30:00,,0.0,-90.79999999998836,0.0,0.0,1.08561,27.11.2015 01:45:00,12446,-0.03941753900762171,43.5,IS,0.34,0.0,Phase3-EA-S4v1-EURCHF-M15-221,EURCHFMT4,3268,8h 45m,Buy
140204.43,129671,27.11.2015 14:29:58,sl 129.671,-1.8,-149.87999999997555,0.0,0.0,130451,24.11.2015 14:30:00,12447,-0.06506498619451692,-59.08,IS,0.09,0.0,Phase3-EA-TR1v1-EURJPY-M30-91,EURJPYMT4,2218,2d 23h 59m,Buy
140248.25,1.09051,27.11.2015 22:59:58,tp 1.09051,0.0,-106.05999999996857,0.0,0.0,1.09161,27.11.2015 20:45:00,12448,-0.04604211659854247,43.82,IS,0.41,0.0,Phase3-EA-SA2v2-EURCHF-M5-43,EURCHFMT4,6342,2h 14m,Sell
140237.94,123044,30.11.2015 18:45:00,,0.0,-116.36999999996624,0.0,0.0,123091,30.11.2015 18:15:00,12449,-0.05051783055414313,-10.31,IS,0.27,0.0,Phase3-EA-S1v2-USDJPY-M15-0,USDJPYMT4,3542,30m 0s,Buy
140254.61,123122,30.11.2015 19:30:00,,0.0,-99.69999999995343,0.0,0.0,123046,30.11.2015 18:45:00,12450,-0.04328115241253913,16.67,IS,0.27,0.0,Phase3-EA-S1v2-USDJPY-M15-0,USDJPYMT4,3544,45m 0s,Buy
140298.48,1.08611,30.11.2015 20:29:57,tp 1.08611,0.0,-55.82999999995809,0.0,0.0,1.08501,30.11.2015 20:05:00,12451,-0.024236577123283594,43.87,IS,0.41,0.0,Phase3-EA-SA2v2-EURCHF-M5-43,EURCHFMT4,6344,24m 57s,Buy
140354.93,1.0274,30.11.2015 23:29:57,tp 1.02740,0.0,-0.0,0.0,0.0,1.0264,30.11.2015 23:15:00,12452,-0.0,56.45,IS,0.58,0.0,Phase3-EA-SA2v2-USDCHF-M15-107,USDCHFMT4,2428,14m 57s,Buy
140398.8,1.08591,30.11.2015 23:34:59,tp 1.08591,0.0,-0.0,0.0,0.0,1.08481,30.11.2015 22:35:00,12453,-0.0,43.87,IS,0.41,0.0,Phase3-EA-SA2v2-EURCHF-M5-43,EURCHFMT4,6346,59m 59s,Buy
140440.64,1.08519,01.12.2015 02:04:58,tp 1.08519,-1.99,-0.0,0.0,0.0,1.08629,30.11.2015 23:40:00,12454,-0.0,41.84,IS,0.41,0.0,Phase3-EA-SA2v2-EURCHF-M5-43,EURCHFMT4,6348,2h 24m,Sell
140401.49,185.58,01.12.2015 04:50:00,,-1.08,-39.14999999999418,0.0,0.0,185376,30.11.2015 23:25:00,12455,-0.016989190795509833,-39.15,IS,0.23,0.0,Phase3-EA-S4v1-GBPJPY-M5-194,GBPJPYMT4,2756,5h 25m,Sell
140391.34,1.02887,01.12.2015 05:15:00,,0.0,-49.29999999998836,0.0,0.0,1.02869,01.12.2015 01:00:00,12456,-0.021393795816566065,-10.15,IS,0.58,0.0,Phase3-EA-SA2v2-USDCHF-M15-107,USDCHFMT4,2430,4h 15m,Sell
140293.75,1.09015,01.12.2015 13:00:00,,0.0,-146.88999999998487,0.0,0.0,1.0872,01.12.2015 04:15:00,12457,-0.06374309670376892,-97.59,IS,0.34,0.0,Phase3-EA-S4v1-EURCHF-M15-221,EURCHFMT4,3270,8h 45m,Sell
140258.59,130802,01.12.2015 18:29:57,sl 130.802,-3.39,-182.04999999998836,0.0,0.0,130572,24.11.2015 07:30:00,12458,-0.07900082207721142,-35.16,IS,0.17,0.0,Phase3-EA-T1v2-EURJPY-M15-322,EURJPYMT4,2354,7d 10h 59m,Sell
140272.16,130579,01.12.2015 23:15:00,,0.0,-168.47999999998137,0.0,0.0,130481,01.12.2015 21:45:00,12459,-0.07311210383723131,13.57,IS,0.17,0.0,Phase3-EA-T1v2-EURJPY-M15-322,EURJPYMT4,2356,1h 30m,Buy
140314.08,1.09175,02.12.2015 00:54:58,tp 1.09175,-1.99,-126.55999999996857,0.0,0.0,1.09285,01.12.2015 20:30:00,12460,-0.05492086812463627,41.92,IS,0.41,0.0,Phase3-EA-SA2v2-EURCHF-M5-43,EURCHFMT4,6350,4h 24m,Sell
140276.32,122927,02.12.2015 03:15:00,,-0.64,-164.31999999997788,0.0,0.0,123096,01.12.2015 18:30:00,12461,-0.0713068667054461,-37.76,IS,0.27,0.0,Phase3-EA-S1v2-USDJPY-M15-0,USDJPYMT4,3546,8h 45m,Buy
140188.04,1.02625,02.12.2015 04:00:00,,-0.68,-252.59999999997672,0.0,0.0,1.0278,01.12.2015 23:45:00,12462,-0.10961608160781676,-88.28,IS,0.58,0.0,Phase3-EA-SA2v2-USDCHF-M15-107,USDCHFMT4,2432,4h 15m,Buy
140104.19,1.08987,02.12.2015 09:15:00,,0.0,-336.44999999998254,0.0,0.0,1.09197,02.12.2015 00:55:00,12463,-0.14600289254533427,-83.85,IS,0.41,0.0,Phase3-EA-SA2v2-EURCHF-M5-43,EURCHFMT4,6352,8h 20m,Buy
140073.03,1.08974,02.12.2015 12:00:00,,0.0,-367.60999999998603,0.0,0.0,1.09068,02.12.2015 03:15:00,12464,-0.15952481298436938,-31.16,IS,0.34,0.0,Phase3-EA-S4v1-EURCHF-M15-221,EURCHFMT4,3272,8h 45m,Buy
139876.16,1.08168,02.12.2015 23:04:58,sl 1.08168,0.0,-564.4799999999814,0.0,0.0,1.08658,02.12.2015 20:35:00,12465,-0.2449567923435632,-196.87,IS,0.41,0.0,Phase3-EA-SA2v2-EURCHF-M5-43,EURCHFMT4,6354,2h 29m,Buy
139797.24,1.01856,03.12.2015 03:30:00,,-2.05,-643.3999999999942,0.0,0.0,1.01991,02.12.2015 23:15:00,12466,-0.27920422369942666,-78.92,IS,0.58,0.0,Phase3-EA-SA2v2-USDCHF-M15-107,USDCHFMT4,2434,4h 15m,Buy
139822.64,184145,03.12.2015 05:15:00,,-2.02,-618.0,0.0,0.0,183998,02.12.2015 23:50:00,12467,-0.2681818623659422,25.4,IS,0.23,0.0,Phase3-EA-S4v1-GBPJPY-M5-194,GBPJPYMT4,2758,5h 25m,Buy
139803.65,123303,03.12.2015 05:15:00,,-1.91,-636.9899999999907,0.0,0.0,123381,02.12.2015 23:00:00,12468,-0.27642259629203725,-18.99,IS,0.27,0.0,Phase3-EA-S1v2-USDJPY-M15-0,USDJPYMT4,3548,6h 15m,Buy
139752.51,1.08067,03.12.2015 07:30:00,,-2.9,-688.1300000000047,0.0,0.0,1.08187,02.12.2015 23:10:00,12469,-0.29861486237844187,-51.14,IS,0.41,0.0,Phase3-EA-SA2v2-EURCHF-M5-43,EURCHFMT4,6356,8h 20m,Buy
139720.85,130521,03.12.2015 13:14:58,sl 130.521,0.0,-719.7900000000081,0.0,0.0,130751,03.12.2015 11:00:00,12470,-0.3123537584342779,-31.66,IS,0.17,0.0,Phase3-EA-T1v2-EURJPY-M15-322,EURJPYMT4,2358,2h 14m,Buy
139812.74,131205,03.12.2015 16:59:57,tp 131.205,-2.15,-627.8999999999942,0.0,0.0,129915,27.11.2015 19:30:00,12471,-0.272477979578598,91.89,IS,0.09,0.0,Phase3-EA-TR1v1-EURJPY-M30-91,EURJPYMT4,2220,5d 21h 29m,Buy
139762.48,184766,03.12.2015 17:29:58,sl 184.766,-1.27,-678.1600000000035,0.0,0.0,184096,02.12.2015 23:30:00,12472,-0.2942883685794309,-50.26,IS,0.09,0.0,Phase3-EA-B1v1-GBPJPY-M30-1,GBPJPYMT4,1164,17h 59m,Sell
139534.52,0.99228,03.12.2015 23:44:58,sl 0.99228,0.0,-906.1199999999953,0.0,0.0,0.99618,03.12.2015 22:45:00,12473,-0.3932118917913047,-227.96,IS,0.58,0.0,Phase3-EA-SA2v2-USDCHF-M15-107,USDCHFMT4,2436,59m 58s,Buy
139592.99,0.99198,04.12.2015 00:29:58,tp 0.99198,0.0,-847.6499999999942,0.0,0.0,0.99098,04.12.2015 00:15:00,12474,-0.36783876316260417,58.47,IS,0.58,0.0,Phase3-EA-SA2v2-USDCHF-M15-107,USDCHFMT4,2438,14m 58s,Buy
139389.79,1.08319,04.12.2015 05:49:57,sl 1.08319,-1.0,-1050.8500000000058,0.0,0.0,1.08809,03.12.2015 23:30:00,12475,-0.45601765383050474,-203.2,IS,0.41,0.0,Phase3-EA-SA2v2-EURCHF-M5-43,EURCHFMT4,6358,6h 19m,Buy
139357.92,133807,04.12.2015 11:14:59,sl 133.807,0.0,-1082.7200000000012,0.0,0.0,134037,04.12.2015 09:30:00,12476,-0.46984767964539365,-31.87,IS,0.17,0.0,Phase3-EA-T1v2-EURJPY-M15-322,EURJPYMT4,2360,1h 44m,Buy
139494.16,1.08776,04.12.2015 13:29:58,tp 1.08776,0.0,-946.4800000000105,0.0,0.0,1.08376,04.12.2015 06:00:00,12477,-0.4107261635794819,136.24,IS,0.34,0.0,Phase3-EA-S4v1-EURCHF-M15-221,EURCHFMT4,3274,7h 29m,Buy
139462.39,133842,04.12.2015 17:44:58,sl 133.842,0.0,-978.25,0.0,0.0,134072,04.12.2015 17:15:00,12478,-0.424512794271008,-31.77,IS,0.17,0.0,Phase3-EA-T1v2-EURJPY-M15-322,EURJPYMT4,2362,29m 58s,Buy
139507.43,1.08833,04.12.2015 21:54:57,tp 1.08833,0.0,-933.2099999999919,0.0,0.0,1.08723,04.12.2015 20:45:00,12479,-0.40496763070957725,45.04,IS,0.41,0.0,Phase3-EA-SA2v2-EURCHF-M5-43,EURCHFMT4,6360,1h 9m,Buy
139461.68,1.08439,07.12.2015 07:40:00,,-0.99,-978.9599999999919,0.0,0.0,1.08548,04.12.2015 23:20:00,12480,-0.4248208996468618,-45.75,IS,0.41,0.0,Phase3-EA-SA2v2-EURCHF-M5-43,EURCHFMT4,6362,2d 8h 20m,Buy
139506.75,1.08455,07.12.2015 23:24:58,tp 1.08455,0.0,-933.8899999999849,0.0,0.0,1.08565,07.12.2015 20:00:00,12481,-0.40526271754842347,45.07,IS,0.41,0.0,Phase3-EA-SA2v2-EURCHF-M5-43,EURCHFMT4,6364,3h 24m,Sell
139488.95,1.08421,08.12.2015 07:50:00,,-0.98,-951.6899999999732,0.0,0.0,1.08462,07.12.2015 23:30:00,12482,-0.4129870495065313,-17.8,IS,0.41,0.0,Phase3-EA-SA2v2-EURCHF-M5-43,EURCHFMT4,6366,8h 20m,Buy
139550.9,1.08535,08.12.2015 11:15:00,,0.0,-889.7399999999616,0.0,0.0,1.08353,08.12.2015 02:30:00,12483,-0.38610377058489176,61.95,IS,0.34,0.0,Phase3-EA-S4v1-EURCHF-M15-221,EURCHFMT4,3276,8h 45m,Buy
139519.08,133.77,08.12.2015 17:44:58,sl 133.770,0.0,-921.5599999999686,0.0,0.0,133.54,08.12.2015 14:30:00,12484,-0.39991209883810563,-31.82,IS,0.17,0.0,Phase3-EA-T1v2-EURJPY-M15-322,EURJPYMT4,2364,3h 14m,Sell
139564.5,1.08188,08.12.2015 22:24:58,tp 1.08188,0.0,-876.1399999999558,0.0,0.0,1.08078,08.12.2015 20:05:00,12485,-0.3802020338079041,45.42,IS,0.41,0.0,Phase3-EA-SA2v2-EURCHF-M5-43,EURCHFMT4,6368,2h 19m,Buy
139609.94,1.08072,08.12.2015 23:24:58,tp 1.08072,0.0,-830.6999999999534,0.0,0.0,1.08182,08.12.2015 22:30:00,12486,-0.3604832897530351,45.44,IS,0.41,0.0,Phase3-EA-SA2v2-EURCHF-M5-43,EURCHFMT4,6370,54m 58s,Sell
139618.39,122.93,09.12.2015 02:15:00,,-0.99,-822.2499999999418,0.0,0.0,122973,08.12.2015 21:30:00,12487,-0.35681640182909447,8.45,IS,0.27,0.0,Phase3-EA-S1v2-USDJPY-M15-0,USDJPYMT4,3550,4h 45m,Sell
139565.06,134.15,09.12.2015 12:29:58,sl 134.150,-0.52,-875.579999999929,0.0,0.0,133858,04.12.2015 11:00:00,12488,-0.37995902111707547,-53.33,IS,0.09,0.0,Phase3-EA-TR1v1-EURJPY-M30-91,EURJPYMT4,2222,5d 1h 29m,Sell
139473.19,1.08431,09.12.2015 13:30:00,,0.0,-967.4499999999243,0.0,0.0,1.08163,09.12.2015 04:45:00,12489,-0.41982612094807525,-91.87,IS,0.34,0.0,Phase3-EA-S4v1-EURCHF-M15-221,EURCHFMT4,3278,8h 45m,Sell
139441.17,133764,09.12.2015 18:14:58,sl 133.764,0.0,-999.4699999999139,0.0,0.0,133994,09.12.2015 10:30:00,12490,-0.4337212394480019,-32.02,IS,0.17,0.0,Phase3-EA-T1v2-EURJPY-M15-322,EURJPYMT4,2366,7h 44m,Buy
139499.99,0.98613,09.12.2015 22:29:57,tp 0.98613,0.0,-940.6499999999069,0.0,0.0,0.98513,09.12.2015 22:15:00,12491,-0.4081962278875381,58.82,IS,0.58,0.0,Phase3-EA-SA2v2-USDCHF-M15-107,USDCHFMT4,2440,14m 57s,Buy
139558.96,0.98359,09.12.2015 23:59:58,tp 0.98359,0.0,-881.6799999999057,0.0,0.0,0.98259,09.12.2015 23:45:00,12492,-0.38260612364203667,58.97,IS,0.58,0.0,Phase3-EA-SA2v2-USDCHF-M15-107,USDCHFMT4,2442,14m 58s,Buy
139563.13,1.0839,10.12.2015 05:35:00,,-6.25,-877.5099999998929,0.0,0.0,1.08415,09.12.2015 21:15:00,12493,-0.3807965469979114,4.17,IS,0.41,0.0,Phase3-EA-SA2v2-EURCHF-M5-43,EURCHFMT4,6372,8h 20m,Sell
139489.24,1.08109,10.12.2015 12:30:00,,0.0,-951.3999999999069,0.0,0.0,1.08323,10.12.2015 03:45:00,12494,-0.412861203648758,-73.89,IS,0.34,0.0,Phase3-EA-S4v1-EURCHF-M15-221,EURCHFMT4,3280,8h 45m,Buy
139436.03,133312,10.12.2015 14:29:58,sl 133.312,0.0,-1004.6099999998987,0.0,0.0,133.43,07.12.2015 15:00:00,12495,-0.4359517487887088,-53.21,IS,0.09,0.0,Phase3-EA-TR1v1-EURJPY-M30-91,EURJPYMT4,2223,2d 23h 29m,Sell
139479.57,1.08128,11.12.2015 00:44:59,tp 1.08128,-2.07,-961.0699999998906,0.0,0.0,1.08238,10.12.2015 21:00:00,12496,-0.4170575120776808,43.54,IS,0.41,0.0,Phase3-EA-SA2v2-EURCHF-M5-43,EURCHFMT4,6374,3h 44m,Sell
139419.6,184656,11.12.2015 04:50:00,,-1.1,-1021.0399999998917,0.0,0.0,184344,10.12.2015 23:25:00,12497,-0.44308156755678413,-59.97,IS,0.23,0.0,Phase3-EA-S4v1-GBPJPY-M5-194,GBPJPYMT4,2760,5h 25m,Sell
139437.79,0.98841,11.12.2015 05:30:00,,0.0,-1002.8499999998894,0.0,0.0,0.9881,11.12.2015 01:15:00,12498,-0.4351879946175655,18.19,IS,0.58,0.0,Phase3-EA-SA2v2-USDCHF-M15-107,USDCHFMT4,2444,4h 15m,Buy
139420.78,1.0809,11.12.2015 09:10:00,,0.0,-1019.8599999998987,0.0,0.0,1.08131,11.12.2015 00:50:00,12499,-0.442569505101137,-17.01,IS,0.41,0.0,Phase3-EA-SA2v2-EURCHF-M5-43,EURCHFMT4,6376,8h 20m,Buy
139418.37,1.08091,11.12.2015 10:15:00,,0.0,-1022.2699999999022,0.0,0.0,1.08098,11.12.2015 01:30:00,12500,-0.443615327574119,-2.41,IS,0.34,0.0,Phase3-EA-S4v1-EURCHF-M15-221,EURCHFMT4,3282,8h 45m,Buy
139314.65,121965,11.12.2015 10:30:00,,-1.0,-1125.9899999999034,0.0,0.0,121501,10.12.2015 19:30:00,12501,-0.48862474952330315,-103.72,IS,0.27,0.0,Phase3-EA-S1v2-USDJPY-M15-0,USDJPYMT4,3552,15h 0m,Sell
139261.23,133672,11.12.2015 12:29:58,sl 133.672,-0.26,-1179.4099999999162,0.0,0.0,134032,10.12.2015 04:30:00,12502,-0.5118064244223195,-53.42,IS,0.09,0.0,Phase3-EA-TR1v1-EURJPY-M30-91,EURJPYMT4,2225,1d 7h 59m,Buy
139306.11,1.08082,14.12.2015 02:09:57,tp 1.08082,-1.0,-1134.5299999999115,0.0,0.0,1.07972,11.12.2015 23:45:00,12503,-0.4923306930582665,44.88,IS,0.41,0.0,Phase3-EA-SA2v2-EURCHF-M5-43,EURCHFMT4,6378,2d 2h 24m,Buy
139379.22,183549,14.12.2015 03:39:58,tp 183.549,-1.1,-1061.4199999999255,0.0,0.0,183939,11.12.2015 23:35:00,12504,-0.46060451836964145,73.11,IS,0.23,0.0,Phase3-EA-S4v1-GBPJPY-M5-194,GBPJPYMT4,2762,2d 4h 4m,Sell
139473.11,132568,14.12.2015 03:59:57,tp 132.568,-2.08,-967.5299999999115,0.0,0.0,132952,10.12.2015 17:00:00,12505,-0.41986083704675786,93.89,IS,0.09,0.0,Phase3-EA-TR1v1-EURJPY-M30-91,EURJPYMT4,2227,3d 10h 59m,Sell
139547.22,183975,14.12.2015 06:49:58,tp 183.975,0.0,-893.4199999999255,0.0,0.0,183585,14.12.2015 03:45:00,12506,-0.3877007111245309,74.11,IS,0.23,0.0,Phase3-EA-S4v1-GBPJPY-M5-194,GBPJPYMT4,2764,3h 4m,Buy
139682.04,183294,14.12.2015 15:29:57,tp 183.294,-2.57,-758.5999999999185,0.0,0.0,185144,08.12.2015 10:00:00,12507,-0.3291954058103267,134.82,IS,0.09,0.0,Phase3-EA-B1v1-GBPJPY-M30-1,GBPJPYMT4,1166,6d 5h 29m,Sell
139741.45,120.43,14.12.2015 20:15:00,,0.0,-699.189999999915,0.0,0.0,120695,14.12.2015 19:30:00,12508,-0.3034143630220394,59.41,IS,0.27,0.0,Phase3-EA-S1v2-USDJPY-M15-0,USDJPYMT4,3554,45m 0s,Sell
139649.45,0.98533,15.12.2015 02:30:00,,-3.12,-791.189999999915,0.0,0.0,0.98382,14.12.2015 22:15:00,12509,-0.3433378765134094,-92.0,IS,0.58,0.0,Phase3-EA-SA2v2-USDCHF-M15-107,USDCHFMT4,2446,4h 15m,Sell
139594.94,1.08342,15.12.2015 04:35:00,,-2.08,-845.6999999999243,0.0,0.0,1.08216,14.12.2015 20:15:00,12510,-0.36699255825705024,-54.51,IS,0.41,0.0,Phase3-EA-SA2v2-EURCHF-M5-43,EURCHFMT4,6380,8h 20m,Sell
139499.6,183489,15.12.2015 04:50:00,,-1.1,-941.0399999999208,0.0,0.0,182993,14.12.2015 23:25:00,12511,-0.40836546886864894,-95.34,IS,0.23,0.0,Phase3-EA-S4v1-GBPJPY-M5-194,GBPJPYMT4,2766,5h 25m,Sell
139445.23,120937,15.12.2015 08:15:00,,-1.01,-995.4099999999162,0.0,0.0,120698,14.12.2015 22:00:00,12512,-0.4319593974395794,-54.37,IS,0.27,0.0,Phase3-EA-S1v2-USDJPY-M15-0,USDJPYMT4,3556,10h 15m,Sell
139481.91,1.08367,15.12.2015 14:15:00,,0.0,-958.7299999999232,0.0,0.0,1.08261,15.12.2015 05:30:00,12513,-0.41604206619106665,36.68,IS,0.34,0.0,Phase3-EA-S4v1-EURCHF-M15-221,EURCHFMT4,3284,8h 45m,Buy
139527.43,1.08166,15.12.2015 22:49:58,tp 1.08166,0.0,-913.2099999999336,0.0,0.0,1.08276,15.12.2015 22:05:00,12514,-0.39628860603751503,45.52,IS,0.41,0.0,Phase3-EA-SA2v2-EURCHF-M5-43,EURCHFMT4,6382,44m 58s,Sell
139585.25,0.99115,16.12.2015 00:14:58,tp 0.99115,-0.7,-855.3899999999267,0.0,0.0,0.99015,15.12.2015 23:45:00,12515,-0.37119754571065317,57.82,IS,0.58,0.0,Phase3-EA-SA2v2-USDCHF-M15-107,USDCHFMT4,2448,29m 58s,Buy
139629.76,1.08248,16.12.2015 00:34:59,tp 1.08248,-0.99,-810.8799999999173,0.0,0.0,1.08138,15.12.2015 23:20:00,12516,-0.3518823763030308,44.51,IS,0.41,0.0,Phase3-EA-SA2v2-EURCHF-M5-43,EURCHFMT4,6384,1h 14m,Buy
139653.92,121798,16.12.2015 04:15:00,,0.0,-786.7199999999139,0.0,0.0,121689,16.12.2015 01:30:00,12517,-0.34139811449920865,24.16,IS,0.27,0.0,Phase3-EA-S1v2-USDJPY-M15-0,USDJPYMT4,3558,2h 45m,Buy
139657.65,1.08306,16.12.2015 09:15:00,,0.0,-782.9899999999034,0.0,0.0,1.08315,16.12.2015 00:55:00,12518,-0.3397794763978692,3.73,IS,0.41,0.0,Phase3-EA-SA2v2-EURCHF-M5-43,EURCHFMT4,6386,8h 20m,Sell
139659.37,1.08306,16.12.2015 11:00:00,,0.0,-781.2699999999022,0.0,0.0,1.08311,16.12.2015 02:15:00,12519,-0.33903308027607354,1.72,IS,0.34,0.0,Phase3-EA-S4v1-EURCHF-M15-221,EURCHFMT4,3286,8h 45m,Sell
139704.96,1.07848,16.12.2015 23:04:58,tp 1.07848,0.0,-735.6799999999057,0.0,0.0,1.07738,16.12.2015 21:00:00,12520,-0.3192492435361668,45.59,IS,0.41,0.0,Phase3-EA-SA2v2-EURCHF-M5-43,EURCHFMT4,6388,2h 4m,Buy
139744.28,1.07918,17.12.2015 02:00:00,tp 1.07918,-6.25,-696.3599999998987,0.0,0.0,1.08028,16.12.2015 23:55:00,12521,-0.3021862810309391,39.32,IS,0.41,0.0,Phase3-EA-SA2v2-EURCHF-M5-43,EURCHFMT4,6390,2h 5m,Sell
139881.98,1.07668,17.12.2015 02:14:57,tp 1.07668,0.0,-558.6599999998871,0.0,0.0,1.08068,17.12.2015 01:30:00,12522,-0.24243119616395953,137.7,IS,0.34,0.0,Phase3-EA-S4v1-EURCHF-M15-221,EURCHFMT4,3288,44m 57s,Sell
139912.55,122.77,17.12.2015 23:00:00,,0.0,-528.0899999998801,0.0,0.0,122631,17.12.2015 22:00:00,12523,-0.229165306952748,30.57,IS,0.27,0.0,Phase3-EA-S1v2-USDJPY-M15-0,USDJPYMT4,3560,1h 0m,Buy
139956.86,1.07893,18.12.2015 02:19:59,tp 1.07893,-0.99,-483.7799999998824,0.0,0.0,1.07783,17.12.2015 23:15:00,12524,-0.2099369277918511,44.31,IS,0.41,0.0,Phase3-EA-SA2v2-EURCHF-M5-43,EURCHFMT4,6392,3h 4m,Buy
139901.48,995,18.12.2015 06:30:00,,0.0,-539.1599999998871,0.0,0.0,0.99595,18.12.2015 02:15:00,12525,-0.2339691471087235,-55.38,IS,0.58,0.0,Phase3-EA-SA2v2-USDCHF-M15-107,USDCHFMT4,2450,4h 15m,Buy
139941.07,182746,18.12.2015 07:50:00,,0.0,-499.56999999989057,0.0,0.0,182535,18.12.2015 02:25:00,12526,-0.21678901777042783,39.59,IS,0.23,0.0,Phase3-EA-S4v1-GBPJPY-M5-194,GBPJPYMT4,2768,5h 25m,Buy
139932.82,1.07876,18.12.2015 10:45:00,,0.0,-507.81999999989057,0.0,0.0,1.07856,18.12.2015 02:25:00,12527,-0.2203691154476431,-8.25,IS,0.41,0.0,Phase3-EA-SA2v2-EURCHF-M5-43,EURCHFMT4,6394,8h 20m,Sell
140166.2,132101,18.12.2015 12:14:57,tp 132.101,-3.91,-274.4399999998859,0.0,0.0,133801,10.12.2015 10:15:00,12528,-0.11909357654964173,233.38,IS,0.17,0.0,Phase3-EA-T1v2-EURJPY-M15-322,EURJPYMT4,2368,8d 1h 59m,Sell
140106.39,132009,18.12.2015 12:29:57,sl 132.009,-2.17,-334.2499999998836,0.0,0.0,132789,14.12.2015 09:00:00,12529,-0.14504819983136727,-59.81,IS,0.09,0.0,Phase3-EA-TR1v1-EURJPY-M30-91,EURJPYMT4,2230,4d 3h 29m,Buy
140155.84,121213,18.12.2015 21:00:00,,0.0,-284.79999999987194,0.0,0.0,121435,18.12.2015 17:15:00,12530,-0.1235893113297508,49.45,IS,0.27,0.0,Phase3-EA-S1v2-USDJPY-M15-0,USDJPYMT4,3562,3h 45m,Sell
140123.09,131739,21.12.2015 02:14:58,sl 131.739,-0.49,-317.54999999987194,0.0,0.0,131509,18.12.2015 21:15:00,12531,-0.13780121423021133,-32.75,IS,0.17,0.0,Phase3-EA-T1v2-EURJPY-M15-322,EURJPYMT4,2370,2d 4h 59m,Sell
140197.03,180.89,21.12.2015 03:04:57,tp 180.890,0.0,-243.60999999986961,0.0,0.0,180.5,21.12.2015 02:05:00,12532,-0.10571486001768966,73.94,IS,0.23,0.0,Phase3-EA-S4v1-GBPJPY-M5-194,GBPJPYMT4,2770,59m 57s,Buy
140168.96,0.99167,21.12.2015 06:30:00,,0.0,-271.6799999998766,0.0,0.0,0.99215,21.12.2015 02:15:00,12533,-0.11789587114489658,-28.07,IS,0.58,0.0,Phase3-EA-SA2v2-USDCHF-M15-107,USDCHFMT4,2452,4h 15m,Buy
140178.72,1.07786,21.12.2015 06:35:00,,-0.99,-261.9199999998673,0.0,0.0,1.0776,18.12.2015 22:15:00,12534,-0.1136605071049385,9.76,IS,0.41,0.0,Phase3-EA-SA2v2-EURCHF-M5-43,EURCHFMT4,6396,2d 8h 20m,Buy
140176.34,131846,21.12.2015 16:30:00,,0.0,-264.29999999987194,0.0,0.0,131863,21.12.2015 14:30:00,12535,-0.11469331104091292,-2.38,IS,0.17,0.0,Phase3-EA-T1v2-EURJPY-M15-322,EURJPYMT4,2372,2h 0m,Buy
140234.82,0.99185,21.12.2015 23:29:58,tp 0.99185,0.0,-205.81999999986147,0.0,0.0,0.99285,21.12.2015 23:15:00,12536,-0.0893158428998723,58.48,IS,0.58,0.0,Phase3-EA-SA2v2-USDCHF-M15-107,USDCHFMT4,2454,14m 58s,Sell
140278.22,1.08201,22.12.2015 02:04:57,tp 1.08201,-2.07,-162.4199999998673,0.0,0.0,1.08311,21.12.2015 20:10:00,12537,-0.0704823593615546,43.4,IS,0.41,0.0,Phase3-EA-SA2v2-EURCHF-M5-43,EURCHFMT4,6398,5h 54m,Sell
140323.66,1.08381,22.12.2015 07:29:57,tp 1.08381,0.0,-116.97999999986496,0.0,0.0,1.08271,22.12.2015 02:05:00,12538,-0.050763615306685606,45.44,IS,0.41,0.0,Phase3-EA-SA2v2-EURCHF-M5-43,EURCHFMT4,6400,5h 24m,Buy
140310.41,121199,22.12.2015 11:00:00,,-1.0,-130.22999999986496,0.0,0.0,121144,21.12.2015 23:00:00,12539,-0.05651346915191009,-13.25,IS,0.27,0.0,Phase3-EA-S1v2-USDJPY-M15-0,USDJPYMT4,3564,12h 0m,Sell
140326.94,120876,22.12.2015 19:00:00,,0.0,-113.69999999986612,0.0,0.0,120.95,22.12.2015 17:45:00,12540,-0.049340255260472046,16.53,IS,0.27,0.0,Phase3-EA-S1v2-USDJPY-M15-0,USDJPYMT4,3566,1h 15m,Sell
140362.76,132565,23.12.2015 03:15:00,,-0.69,-77.87999999985914,0.0,0.0,132305,22.12.2015 15:30:00,12541,-0.033796122072850814,35.82,IS,0.17,0.0,Phase3-EA-T1v2-EURJPY-M15-322,EURJPYMT4,2374,11h 45m,Buy
140315.69,1.08112,23.12.2015 06:05:00,,-1.0,-124.94999999986612,0.0,0.0,1.08223,22.12.2015 21:45:00,12542,-0.054222206638492844,-47.07,IS,0.41,0.0,Phase3-EA-SA2v2-EURCHF-M5-43,EURCHFMT4,6402,8h 20m,Buy
140300.56,1.08142,23.12.2015 10:00:00,,0.0,-140.07999999987078,0.0,0.0,1.08186,23.12.2015 01:15:00,12543,-0.06078788880289083,-15.13,IS,0.34,0.0,Phase3-EA-S4v1-EURCHF-M15-221,EURCHFMT4,3290,8h 45m,Buy
140359.1,0.99085,24.12.2015 02:00:00,tp 0.99085,0.0,-81.53999999986263,0.0,0.0,0.98985,24.12.2015 01:00:00,12544,-0.03538438358783509,58.54,IS,0.58,0.0,Phase3-EA-SA2v2-USDCHF-M15-107,USDCHFMT4,2456,1h 0m,Buy
140325.89,1.08041,24.12.2015 04:20:00,,-2.98,-114.74999999985448,0.0,0.0,1.08114,23.12.2015 20:00:00,12545,-0.049795904055748935,-33.21,IS,0.41,0.0,Phase3-EA-SA2v2-EURCHF-M5-43,EURCHFMT4,6404,8h 20m,Buy
140325.2,1.08064,24.12.2015 11:15:00,,0.0,-115.43999999985681,0.0,0.0,1.08066,24.12.2015 02:30:00,12546,-0.05009533040693522,-0.69,IS,0.34,0.0,Phase3-EA-S4v1-EURCHF-M15-221,EURCHFMT4,3292,8h 45m,Buy
140339.34,120332,24.12.2015 19:00:00,,0.0,-101.29999999984284,0.0,0.0,120395,24.12.2015 17:30:00,12547,-0.04395925996379903,14.14,IS,0.27,0.0,Phase3-EA-S1v2-USDJPY-M15-0,USDJPYMT4,3568,1h 30m,Sell
140306.35,132034,28.12.2015 04:59:58,sl 132.034,-0.49,-134.28999999983353,0.0,0.0,131804,24.12.2015 15:00:00,12548,-0.05827531116031996,-32.99,IS,0.17,0.0,Phase3-EA-T1v2-EURJPY-M15-322,EURJPYMT4,2376,3d 13h 59m,Sell
140251.54,132337,28.12.2015 12:59:58,sl 132.337,-1.04,-189.0999999998312,0.0,0.0,131794,18.12.2015 19:30:00,12549,-0.08206017827403625,-54.81,IS,0.09,0.0,Phase3-EA-TR1v1-EURJPY-M30-91,EURJPYMT4,2232,9d 17h 29m,Buy
140201.45,179162,28.12.2015 19:59:57,sl 179.162,0.0,-239.1899999998277,0.0,0.0,179832,28.12.2015 11:30:00,12550,-0.10379679556515131,-50.09,IS,0.09,0.0,Phase3-EA-B1v1-GBPJPY-M30-1,GBPJPYMT4,1168,8h 29m,Buy
140198.75,0.98785,29.12.2015 03:30:00,,-6.22,-241.88999999983935,0.0,0.0,0.98791,28.12.2015 23:15:00,12551,-0.10496846389588135,-2.7,IS,0.58,0.0,Phase3-EA-SA2v2-USDCHF-M15-107,USDCHFMT4,2458,4h 15m,Sell
140224.15,1.0847,29.12.2015 07:50:00,,-1.99,-216.48999999984517,0.0,0.0,1.08404,28.12.2015 23:30:00,12552,-0.09394610256239694,25.4,IS,0.41,0.0,Phase3-EA-SA2v2-EURCHF-M5-43,EURCHFMT4,6406,8h 20m,Buy
140244.11,1.08439,29.12.2015 10:30:00,,0.0,-196.52999999985332,0.0,0.0,1.08381,29.12.2015 01:45:00,12553,-0.08528443593970758,19.96,IS,0.34,0.0,Phase3-EA-S4v1-EURCHF-M15-221,EURCHFMT4,3294,8h 45m,Buy
140211.64,132.29,29.12.2015 12:59:58,sl 132.290,0.0,-228.99999999985448,0.0,0.0,132.06,29.12.2015 09:45:00,12554,-0.0993748324947601,-32.47,IS,0.17,0.0,Phase3-EA-T1v2-EURJPY-M15-322,EURJPYMT4,2378,3h 14m,Sell
140179.16,131938,29.12.2015 17:14:59,sl 131.938,0.0,-261.47999999986496,0.0,0.0,132168,29.12.2015 16:30:00,12555,-0.11346956856215268,-32.48,IS,0.17,0.0,Phase3-EA-T1v2-EURJPY-M15-322,EURJPYMT4,2380,44m 59s,Buy
140224.69,1.08424,29.12.2015 23:39:58,tp 1.08424,0.0,-215.94999999986612,0.0,0.0,1.08314,29.12.2015 20:05:00,12556,-0.09371176889626104,45.53,IS,0.41,0.0,Phase3-EA-SA2v2-EURCHF-M5-43,EURCHFMT4,6408,3h 34m,Buy
140270.12,1.08323,30.12.2015 02:04:57,tp 1.08323,0.0,-170.5199999998731,0.0,0.0,1.08433,30.12.2015 00:15:00,12557,-0.0739973643537321,45.43,IS,0.41,0.0,Phase3-EA-SA2v2-EURCHF-M5-43,EURCHFMT4,6410,1h 49m,Sell
140260.19,0.9926,30.12.2015 06:00:00,,0.0,-180.44999999986612,0.0,0.0,0.99243,30.12.2015 01:45:00,12558,-0.07830650010339542,-9.93,IS,0.58,0.0,Phase3-EA-SA2v2-USDCHF-M15-107,USDCHFMT4,2460,4h 15m,Sell
140247.59,178688,30.12.2015 08:55:00,,0.0,-193.04999999987194,0.0,0.0,178622,30.12.2015 03:30:00,12559,-0.08377428564678123,-12.6,IS,0.23,0.0,Phase3-EA-S4v1-GBPJPY-M5-194,GBPJPYMT4,2772,5h 25m,Sell
140243.04,1.08434,30.12.2015 10:55:00,,0.0,-197.5999999998603,0.0,0.0,1.08423,30.12.2015 02:35:00,12560,-0.08574876375966459,-4.55,IS,0.41,0.0,Phase3-EA-SA2v2-EURCHF-M5-43,EURCHFMT4,6412,8h 20m,Sell
140199.44,1.48138,31.12.2015 01:29:58,sl 1.48138,-1.6,-241.19999999986612,0.0,0.0,1.48438,30.12.2015 20:30:00,12561,-0.1046690375447077,-43.6,IS,0.14,0.0,Phase3-EA-B1v1-GBPUSD-M30-14,GBPUSDMT4,836,4h 59m,Buy
140206.13,0.98813,31.12.2015 04:00:00,,-2.11,-234.5099999998638,0.0,0.0,0.98798,30.12.2015 23:45:00,12562,-0.10176590379191032,6.69,IS,0.58,0.0,Phase3-EA-SA2v2-USDCHF-M15-107,USDCHFMT4,2462,4h 15m,Buy
140188.62,1.08031,31.12.2015 04:20:00,,-2.99,-252.0199999998731,0.0,0.0,1.08066,30.12.2015 20:00:00,12563,-0.10936438989228273,-17.51,IS,0.41,0.0,Phase3-EA-SA2v2-EURCHF-M5-43,EURCHFMT4,6414,8h 20m,Buy
140184.99,178499,31.12.2015 06:50:00,,0.0,-255.64999999987776,0.0,0.0,178518,31.12.2015 01:25:00,12564,-0.11093963287025946,-3.63,IS,0.23,0.0,Phase3-EA-S4v1-GBPJPY-M5-194,GBPJPYMT4,2774,5h 25m,Buy
140260.28,1.08057,31.12.2015 10:00:00,,0.0,-180.35999999986961,0.0,0.0,1.07838,31.12.2015 01:15:00,12565,-0.07826744449237277,75.29,IS,0.34,0.0,Phase3-EA-S4v1-EURCHF-M15-221,EURCHFMT4,3296,8h 45m,Buy
140197.25,131014,31.12.2015 17:29:57,sl 131.014,-4.74,-243.38999999986845,0.0,0.0,131617,23.12.2015 20:00:00,12566,-0.10561939074629675,-63.03,IS,0.09,0.0,Phase3-EA-TR1v1-EURJPY-M30-91,EURJPYMT4,2233,7d 21h 29m,Sell
140242.34,1.08615,31.12.2015 21:49:57,tp 1.08615,0.0,-198.29999999987194,0.0,0.0,1.08725,31.12.2015 20:05:00,12567,-0.08605252962319093,45.09,IS,0.41,0.0,Phase3-EA-SA2v2-EURCHF-M5-43,EURCHFMT4,6416,1h 44m,Sell
140300.29,1.00083,04.01.2016 04:44:59,tp 1.00083,0.0,-140.3499999998603,0.0,0.0,0.99983,04.01.2016 02:45:00,12568,-0.06090505563595878,57.95,IS,0.58,0.0,Phase3-EA-SA2v2-USDCHF-M15-107,USDCHFMT4,2464,1h 59m,Buy
140540.31,129868,04.01.2016 11:14:58,tp 129.868,-1.97,-0.0,0.0,0.0,131568,30.12.2015 20:00:00,12569,-0.0,240.02,IS,0.17,0.0,Phase3-EA-T1v2-EURJPY-M15-322,EURJPYMT4,2382,4d 15h 14m,Sell
140635.27,129437,04.01.2016 17:59:58,tp 129.437,-0.26,-0.0,0.0,0.0,130697,31.12.2015 20:00:00,12570,-0.0,94.96,IS,0.09,0.0,Phase3-EA-TR1v1-EURJPY-M30-91,EURJPYMT4,2236,3d 21h 59m,Sell
140572.59,119.33,05.01.2016 03:15:00,,-2.04,-62.679999999993015,0.0,0.0,119062,04.01.2016 17:00:00,12571,-0.02717710955483635,-62.68,IS,0.27,0.0,Phase3-EA-S1v2-USDJPY-M15-0,USDJPYMT4,3570,10h 15m,Sell
140566.13,1.08533,05.01.2016 04:25:00,,-1.96,-69.13999999998487,0.0,0.0,1.08544,04.01.2016 20:05:00,12572,-0.029978068835692137,-6.46,IS,0.41,0.0,Phase3-EA-SA2v2-EURCHF-M5-43,EURCHFMT4,6418,8h 20m,Buy
140641.33,175456,05.01.2016 04:54:58,tp 175.456,0.0,-0.0,0.0,0.0,175846,05.01.2016 01:15:00,12573,-0.0,75.2,IS,0.23,0.0,Phase3-EA-S4v1-GBPJPY-M5-194,GBPJPYMT4,2776,3h 39m,Sell
140736.08,127833,05.01.2016 16:29:58,tp 127.833,-0.53,-0.0,0.0,0.0,129093,04.01.2016 19:30:00,12574,-0.0,94.75,IS,0.09,0.0,Phase3-EA-TR1v1-EURJPY-M30-91,EURJPYMT4,2238,20h 59m,Sell
140793.77,118886,05.01.2016 21:15:00,,0.0,-0.0,0.0,0.0,119.14,05.01.2016 18:00:00,12575,-0.0,57.69,IS,0.27,0.0,Phase3-EA-S1v2-USDJPY-M15-0,USDJPYMT4,3572,3h 15m,Sell
140851.23,1.00938,06.01.2016 05:14:57,tp 1.00938,0.0,-0.0,0.0,0.0,1.00838,06.01.2016 02:00:00,12576,-0.0,57.46,IS,0.58,0.0,Phase3-EA-SA2v2-USDCHF-M15-107,USDCHFMT4,2466,3h 14m,Buy
140894.95,1.08508,06.01.2016 05:24:58,tp 1.08508,-0.98,-0.0,0.0,0.0,1.08398,05.01.2016 23:35:00,12577,-0.0,43.72,IS,0.41,0.0,Phase3-EA-SA2v2-EURCHF-M5-43,EURCHFMT4,6420,5h 49m,Buy
141033.39,173844,06.01.2016 05:29:58,tp 173.844,-1.32,-0.0,0.0,0.0,175694,04.01.2016 11:30:00,12578,-0.0,138.44,IS,0.09,0.0,Phase3-EA-B1v1-GBPJPY-M30-1,GBPJPYMT4,1170,1d 17h 59m,Sell
141070.43,1.08356,06.01.2016 14:30:00,,0.0,-0.0,0.0,0.0,1.08466,06.01.2016 05:45:00,12579,-0.0,37.04,IS,0.34,0.0,Phase3-EA-S4v1-EURCHF-M15-221,EURCHFMT4,3298,8h 45m,Sell
141332.28,1.4609,06.01.2016 17:29:58,tp 1.46090,-2.75,-0.0,0.0,0.0,1.4798,31.12.2015 19:00:00,12580,-0.0,261.85,IS,0.14,0.0,Phase3-EA-B1v1-GBPUSD-M30-14,GBPUSDMT4,838,5d 22h 29m,Sell
141376.95,1.08602,06.01.2016 21:59:58,tp 1.08602,0.0,-0.0,0.0,0.0,1.08492,06.01.2016 20:05:00,12581,-0.0,44.67,IS,0.41,0.0,Phase3-EA-SA2v2-EURCHF-M5-43,EURCHFMT4,6422,1h 54m,Buy
141344.01,127872,06.01.2016 23:14:58,sl 127.872,0.0,-32.94000000000233,0.0,0.0,127642,06.01.2016 05:45:00,12582,-0.014236508865728461,-32.94,IS,0.17,0.0,Phase3-EA-T1v2-EURJPY-M15-322,EURJPYMT4,2384,17h 29m,Sell
141401.52,1.00844,06.01.2016 23:14:58,tp 1.00844,0.0,-0.0,0.0,0.0,1.00944,06.01.2016 22:15:00,12583,-0.0,57.51,IS,0.58,0.0,Phase3-EA-SA2v2-USDCHF-M15-107,USDCHFMT4,2468,59m 58s,Sell
141440.2,1.08512,07.01.2016 02:04:57,tp 1.08512,-6.11,-0.0,0.0,0.0,1.08622,06.01.2016 22:05:00,12584,-0.0,38.68,IS,0.41,0.0,Phase3-EA-SA2v2-EURCHF-M5-43,EURCHFMT4,6424,3h 59m,Sell
141446.19,118.62,07.01.2016 04:00:00,,-1.98,-0.0,0.0,0.0,118585,06.01.2016 22:30:00,12585,-0.0,5.99,IS,0.27,0.0,Phase3-EA-S1v2-USDJPY-M15-0,USDJPYMT4,3574,5h 30m,Buy
141521.8,173.61,07.01.2016 04:34:57,tp 173.610,0.0,-0.0,0.0,0.0,173.22,07.01.2016 00:05:00,12586,-0.0,75.61,IS,0.23,0.0,Phase3-EA-S4v1-GBPJPY-M5-194,GBPJPYMT4,2778,4h 29m,Buy
141566.64,1.08657,07.01.2016 05:54:58,tp 1.08657,0.0,-0.0,0.0,0.0,1.08547,07.01.2016 02:05:00,12587,-0.0,44.84,IS,0.41,0.0,Phase3-EA-SA2v2-EURCHF-M5-43,EURCHFMT4,6426,3h 49m,Buy
141562.9,127861,07.01.2016 08:15:00,,0.0,-3.7399999999906868,0.0,0.0,127887,07.01.2016 08:00:00,12588,-0.0016150858344667705,-3.74,IS,0.17,0.0,Phase3-EA-T1v2-EURJPY-M15-322,EURJPYMT4,2386,15m 0s,Buy
141608.0,1.08694,07.01.2016 22:19:59,tp 1.08694,0.0,-0.0,0.0,0.0,1.08804,07.01.2016 21:05:00,12589,-0.0,45.1,IS,0.41,0.0,Phase3-EA-SA2v2-EURCHF-M5-43,EURCHFMT4,6428,1h 14m,Sell
141611.67,117613,07.01.2016 22:45:00,,0.0,-0.0,0.0,0.0,117629,07.01.2016 17:45:00,12590,-0.0,3.67,IS,0.27,0.0,Phase3-EA-S1v2-USDJPY-M15-0,USDJPYMT4,3576,5h 0m,Sell
141384.22,0.99452,07.01.2016 23:59:58,sl 0.99452,0.0,-227.45000000001164,0.0,0.0,0.99842,07.01.2016 22:30:00,12591,-0.09820316912356367,-227.45,IS,0.58,0.0,Phase3-EA-SA2v2-USDCHF-M15-107,USDCHFMT4,2470,1h 29m,Buy
141327.71,128555,08.01.2016 00:29:58,sl 128.555,-1.33,-283.96000000002095,0.0,0.0,127835,05.01.2016 16:30:00,12592,-0.12260176700078157,-56.51,IS,0.09,0.0,Phase3-EA-TR1v1-EURJPY-M30-91,EURJPYMT4,2240,2d 7h 59m,Sell
141347.23,117701,08.01.2016 04:30:00,,-0.67,-264.44000000003143,0.0,0.0,117613,07.01.2016 22:45:00,12593,-0.11417386697312347,19.52,IS,0.27,0.0,Phase3-EA-S1v2-USDJPY-M15-0,USDJPYMT4,3578,5h 45m,Buy
141287.41,1.08432,08.01.2016 07:40:00,,-0.99,-324.2600000000384,0.0,0.0,1.08575,07.01.2016 23:20:00,12594,-0.14000158109478522,-59.82,IS,0.41,0.0,Phase3-EA-SA2v2-EURCHF-M5-43,EURCHFMT4,6430,8h 20m,Buy
141360.56,1.08681,08.01.2016 15:30:00,,0.0,-251.11000000004424,0.0,0.0,1.08466,08.01.2016 06:45:00,12595,-0.10841854384973029,73.15,IS,0.34,0.0,Phase3-EA-S4v1-EURCHF-M15-221,EURCHFMT4,3300,8h 45m,Buy
141405.81,1.08566,08.01.2016 20:59:58,tp 1.08566,0.0,-205.86000000004424,0.0,0.0,1.08456,08.01.2016 20:25:00,12596,-0.08888153174667014,45.25,IS,0.41,0.0,Phase3-EA-SA2v2-EURCHF-M5-43,EURCHFMT4,6432,34m 58s,Buy
141449.1,1.0851,11.01.2016 02:00:00,tp 1.08510,-2.06,-162.5700000000361,0.0,0.0,1.0862,08.01.2016 21:35:00,12597,-0.07019076370376114,43.29,IS,0.41,0.0,Phase3-EA-SA2v2-EURCHF-M5-43,EURCHFMT4,6434,2d 4h 25m,Sell
141525.75,170123,11.01.2016 03:14:58,tp 170.123,0.0,-85.92000000004191,0.0,0.0,169733,11.01.2016 03:10:00,12598,-0.0370965763512872,76.65,IS,0.23,0.0,Phase3-EA-S4v1-GBPJPY-M5-194,GBPJPYMT4,2780,4m 58s,Buy
141521.99,1.08508,11.01.2016 10:45:00,,0.0,-89.68000000005122,0.0,0.0,1.08497,11.01.2016 02:00:00,12599,-0.03871998332383279,-3.76,IS,0.34,0.0,Phase3-EA-S4v1-EURCHF-M15-221,EURCHFMT4,3302,8h 45m,Sell
141470.59,170778,11.01.2016 12:29:57,sl 170.778,0.0,-141.0800000000454,0.0,0.0,170108,11.01.2016 02:00:00,12600,-0.060912302044212406,-51.4,IS,0.09,0.0,Phase3-EA-B1v1-GBPJPY-M30-1,GBPJPYMT4,1172,10h 29m,Sell
141419.33,170511,11.01.2016 19:59:58,sl 170.511,0.0,-192.34000000005472,0.0,0.0,171181,11.01.2016 12:30:00,12601,-0.08304417476030179,-51.26,IS,0.09,0.0,Phase3-EA-B1v1-GBPJPY-M30-1,GBPJPYMT4,1174,7h 29m,Buy
141517.76,127371,11.01.2016 19:59:58,tp 127.371,-0.27,-93.9100000000617,0.0,0.0,128661,08.01.2016 08:30:00,12602,-0.040546316167946586,98.43,IS,0.09,0.0,Phase3-EA-TR1v1-EURJPY-M30-91,EURJPYMT4,2242,3d 11h 29m,Sell
141521.68,117775,12.01.2016 00:45:00,,-0.67,-89.9900000000489,0.0,0.0,117755,11.01.2016 18:45:00,12603,-0.03885382804763176,3.92,IS,0.27,0.0,Phase3-EA-S1v2-USDJPY-M15-0,USDJPYMT4,3580,6h 0m,Buy
141564.67,1.08664,12.01.2016 02:00:00,tp 1.08664,-2.05,-47.00000000005821,0.0,0.0,1.08774,11.01.2016 20:50:00,12604,-0.020292587156794776,42.99,IS,0.41,0.0,Phase3-EA-SA2v2-EURCHF-M5-43,EURCHFMT4,6436,5h 10m,Sell
141622.63,1.00067,12.01.2016 02:14:57,tp 1.00067,0.0,-0.0,0.0,0.0,1.00167,12.01.2016 01:00:00,12605,-0.0,57.96,IS,0.58,0.0,Phase3-EA-SA2v2-USDCHF-M15-107,USDCHFMT4,2472,1h 14m,Sell
141531.33,171468,12.01.2016 05:10:00,,-1.14,-91.29999999998836,0.0,0.0,171006,11.01.2016 23:45:00,12606,-0.0394175646826857,-91.3,IS,0.23,0.0,Phase3-EA-S4v1-GBPJPY-M5-194,GBPJPYMT4,2782,5h 25m,Sell
141582.78,117551,12.01.2016 06:45:00,,0.0,-39.84999999997672,0.0,0.0,117775,12.01.2016 00:45:00,12607,-0.017204709228962844,51.45,IS,0.27,0.0,Phase3-EA-S1v2-USDJPY-M15-0,USDJPYMT4,3582,6h 0m,Sell
141555.28,1.08773,12.01.2016 10:50:00,,0.0,-67.34999999997672,0.0,0.0,1.08706,12.01.2016 02:30:00,12608,-0.029077469675556435,-27.5,IS,0.41,0.0,Phase3-EA-SA2v2-EURCHF-M5-43,EURCHFMT4,6438,8h 20m,Sell
141521.96,127905,12.01.2016 11:59:58,sl 127.905,0.0,-100.6699999999837,0.0,0.0,127675,12.01.2016 10:15:00,12609,-0.04346293796939576,-33.32,IS,0.17,0.0,Phase3-EA-T1v2-EURJPY-M15-322,EURJPYMT4,2388,1h 44m,Sell
141520.94,1.08675,12.01.2016 14:30:00,,0.0,-101.68999999997322,0.0,0.0,1.08678,12.01.2016 05:45:00,12610,-0.04390330944777398,-1.02,IS,0.34,0.0,Phase3-EA-S4v1-EURCHF-M15-221,EURCHFMT4,3304,8h 45m,Buy
141551.43,117791,12.01.2016 19:15:00,,0.0,-71.19999999998254,0.0,0.0,117658,12.01.2016 18:30:00,12611,-0.030739656138082053,30.49,IS,0.27,0.0,Phase3-EA-S1v2-USDJPY-M15-0,USDJPYMT4,3584,45m 0s,Buy
141588.51,117955,12.01.2016 19:45:00,,0.0,-34.11999999999534,0.0,0.0,117793,12.01.2016 19:15:00,12612,-0.014730857688644294,37.08,IS,0.27,0.0,Phase3-EA-S1v2-USDJPY-M15-0,USDJPYMT4,3586,30m 0s,Buy
141664.05,169845,13.01.2016 00:24:57,tp 169.845,-0.7,-0.0,0.0,0.0,169455,12.01.2016 23:10:00,12613,-0.0,75.54,IS,0.23,0.0,Phase3-EA-S4v1-GBPJPY-M5-194,GBPJPYMT4,2784,1h 14m,Buy
141631.38,1.08752,13.01.2016 05:20:00,,-2.05,-32.670000000012806,0.0,0.0,1.08677,12.01.2016 21:00:00,12614,-0.01410231755855628,-32.67,IS,0.41,0.0,Phase3-EA-SA2v2-EURCHF-M5-43,EURCHFMT4,6440,8h 20m,Sell
141637.13,1.08809,13.01.2016 11:15:00,,0.0,-26.920000000012806,0.0,0.0,1.08826,13.01.2016 02:30:00,12615,-0.0116202751354872,5.75,IS,0.34,0.0,Phase3-EA-S4v1-EURCHF-M15-221,EURCHFMT4,3306,8h 45m,Sell
141681.96,1.09392,13.01.2016 23:29:58,tp 1.09392,0.0,-0.0,0.0,0.0,1.09282,13.01.2016 21:40:00,12616,-0.0,44.83,IS,0.41,0.0,Phase3-EA-SA2v2-EURCHF-M5-43,EURCHFMT4,6442,1h 49m,Buy
141622.1,1.0957,14.01.2016 08:10:00,,-6.11,-59.85999999998603,0.0,0.0,1.09438,13.01.2016 23:50:00,12617,-0.02583714329764202,-59.86,IS,0.41,0.0,Phase3-EA-SA2v2-EURCHF-M5-43,EURCHFMT4,6444,8h 20m,Sell
141623.67,169196,14.01.2016 09:20:00,,0.0,-58.289999999979045,0.0,0.0,169188,14.01.2016 03:55:00,12618,-0.025159490190767846,1.57,IS,0.23,0.0,Phase3-EA-S4v1-GBPJPY-M5-194,GBPJPYMT4,2786,5h 25m,Buy
141563.57,1.09684,14.01.2016 12:45:00,,0.0,-118.38999999998487,0.0,0.0,1.09506,14.01.2016 04:00:00,12619,-0.05110022377227132,-60.1,IS,0.34,0.0,Phase3-EA-S4v1-EURCHF-M15-221,EURCHFMT4,3308,8h 45m,Sell
141591.34,117631,14.01.2016 18:45:00,,0.0,-90.61999999999534,0.0,0.0,117752,14.01.2016 18:15:00,12620,-0.03911396467812806,27.77,IS,0.27,0.0,Phase3-EA-S1v2-USDJPY-M15-0,USDJPYMT4,3588,30m 0s,Sell
141636.17,1.09287,14.01.2016 21:29:58,tp 1.09287,0.0,-45.79000000000815,0.0,0.0,1.09397,14.01.2016 21:15:00,12621,-0.019764162906774383,44.83,IS,0.41,0.0,Phase3-EA-SA2v2-EURCHF-M5-43,EURCHFMT4,6446,14m 58s,Sell
141680.92,1.09335,14.01.2016 22:24:58,tp 1.09335,0.0,-1.040000000008149,0.0,0.0,1.09225,14.01.2016 22:05:00,12622,-4.488912300328185E-4,44.75,IS,0.41,0.0,Phase3-EA-SA2v2-EURCHF-M5-43,EURCHFMT4,6448,19m 58s,Buy
141723.16,118243,15.01.2016 03:30:00,,0.0,-0.0,0.0,0.0,118058,15.01.2016 01:00:00,12623,-0.0,42.24,IS,0.27,0.0,Phase3-EA-S1v2-USDJPY-M15-0,USDJPYMT4,3590,2h 30m,Buy
141799.14,170074,15.01.2016 05:24:58,tp 170.074,0.0,-0.0,0.0,0.0,170464,15.01.2016 03:50:00,12624,-0.0,75.98,IS,0.23,0.0,Phase3-EA-S4v1-GBPJPY-M5-194,GBPJPYMT4,2788,1h 34m,Sell
141778.94,1.00479,15.01.2016 06:30:00,,0.0,-20.20000000001164,0.0,0.0,1.00514,15.01.2016 02:15:00,12625,-0.008714441304662094,-20.2,IS,0.58,0.0,Phase3-EA-SA2v2-USDCHF-M15-107,USDCHFMT4,2474,4h 15m,Buy
141789.15,1.09261,15.01.2016 08:25:00,,0.0,-9.99000000001979,0.0,0.0,1.09236,15.01.2016 00:05:00,12626,-0.0043097657739453775,10.21,IS,0.41,0.0,Phase3-EA-SA2v2-EURCHF-M5-43,EURCHFMT4,6450,8h 20m,Buy
141755.97,128119,15.01.2016 08:29:58,sl 128.119,0.0,-43.170000000012806,0.0,0.0,128349,15.01.2016 02:15:00,12627,-0.018623882728819673,-33.18,IS,0.17,0.0,Phase3-EA-T1v2-EURJPY-M15-322,EURJPYMT4,2390,6h 14m,Buy
141791.18,1.09318,15.01.2016 11:00:00,,0.0,-7.960000000020955,0.0,0.0,1.09214,15.01.2016 02:15:00,12628,-0.0034340075636263814,35.21,IS,0.34,0.0,Phase3-EA-S4v1-EURCHF-M15-221,EURCHFMT4,3310,8h 45m,Buy
141735.79,127806,15.01.2016 11:59:58,sl 127.806,-0.37,-63.350000000034925,0.0,0.0,128526,14.01.2016 14:00:00,12629,-0.027329695873778707,-55.39,IS,0.09,0.0,Phase3-EA-TR1v1-EURJPY-M30-91,EURJPYMT4,2244,21h 59m,Buy
141878.56,166269,15.01.2016 21:59:57,tp 166.269,0.0,-0.0,0.0,0.0,168119,15.01.2016 16:30:00,12630,-0.0,142.77,IS,0.09,0.0,Phase3-EA-B1v1-GBPJPY-M30-1,GBPJPYMT4,1176,5h 29m,Sell
141923.71,1.09336,15.01.2016 22:04:58,tp 1.09336,0.0,-0.0,0.0,0.0,1.09446,15.01.2016 21:05:00,12631,-0.0,45.15,IS,0.41,0.0,Phase3-EA-SA2v2-EURCHF-M5-43,EURCHFMT4,6452,59m 58s,Sell
141903.5,116871,18.01.2016 02:15:00,,-1.04,-20.20999999999185,0.0,0.0,116788,15.01.2016 23:30:00,12632,-0.00871407239906249,-20.21,IS,0.27,0.0,Phase3-EA-S1v2-USDJPY-M15-0,USDJPYMT4,3592,2d 2h 45m,Sell
141869.35,1.09512,18.01.2016 14:30:00,,0.0,-54.35999999998603,0.0,0.0,1.09411,18.01.2016 05:45:00,12633,-0.0234387419897628,-34.15,IS,0.34,0.0,Phase3-EA-S4v1-EURCHF-M15-221,EURCHFMT4,3312,8h 45m,Sell
141836.03,127913,18.01.2016 14:59:58,sl 127.913,0.0,-87.67999999999302,0.0,0.0,127683,18.01.2016 08:15:00,12634,-0.037805535277092836,-33.32,IS,0.17,0.0,Phase3-EA-T1v2-EURJPY-M15-322,EURJPYMT4,2392,6h 44m,Sell
141849.6,117389,18.01.2016 20:00:00,,0.0,-74.10999999998603,0.0,0.0,117.33,18.01.2016 18:15:00,12635,-0.03195447330503017,13.57,IS,0.27,0.0,Phase3-EA-S1v2-USDJPY-M15-0,USDJPYMT4,3594,1h 45m,Buy
141866.14,1.09492,19.01.2016 04:20:00,,-0.98,-57.56999999997788,0.0,0.0,1.09449,18.01.2016 20:00:00,12636,-0.024822817813658436,16.54,IS,0.41,0.0,Phase3-EA-SA2v2-EURCHF-M5-43,EURCHFMT4,6454,8h 20m,Buy
141932.36,167556,19.01.2016 04:35:00,,-0.71,-0.0,0.0,0.0,167214,18.01.2016 23:10:00,12637,-0.0,66.22,IS,0.23,0.0,Phase3-EA-S4v1-GBPJPY-M5-194,GBPJPYMT4,2790,5h 25m,Buy
141993.51,1.09364,19.01.2016 15:30:00,,0.0,-0.0,0.0,0.0,1.09545,19.01.2016 06:45:00,12638,-0.0,61.15,IS,0.34,0.0,Phase3-EA-S4v1-EURCHF-M15-221,EURCHFMT4,3314,8h 45m,Sell
142051.4,1.00185,19.01.2016 23:44:58,tp 1.00185,0.0,-0.0,0.0,0.0,1.00085,19.01.2016 22:00:00,12639,-0.0,57.89,IS,0.58,0.0,Phase3-EA-SA2v2-USDCHF-M15-107,USDCHFMT4,2476,1h 44m,Buy
142094.33,1.09253,20.01.2016 02:04:58,tp 1.09253,-2.05,-0.0,0.0,0.0,1.09363,19.01.2016 20:00:00,12640,-0.0,42.93,IS,0.41,0.0,Phase3-EA-SA2v2-EURCHF-M5-43,EURCHFMT4,6456,6h 4m,Sell
142139.28,1.09459,20.01.2016 02:34:58,tp 1.09459,0.0,-0.0,0.0,0.0,1.09349,20.01.2016 02:05:00,12641,-0.0,44.95,IS,0.41,0.0,Phase3-EA-SA2v2-EURCHF-M5-43,EURCHFMT4,6458,29m 58s,Buy
142215.62,166385,20.01.2016 04:14:58,tp 166.385,0.0,-0.0,0.0,0.0,166775,20.01.2016 03:30:00,12642,-0.0,76.34,IS,0.23,0.0,Phase3-EA-S4v1-GBPJPY-M5-194,GBPJPYMT4,2792,44m 58s,Sell
142197.97,128251,20.01.2016 04:15:00,,-0.71,-17.64999999999418,0.0,0.0,128368,19.01.2016 19:15:00,12643,-0.007600694561371054,-17.65,IS,0.17,0.0,Phase3-EA-T1v2-EURJPY-M15-322,EURJPYMT4,2394,9h 0m,Buy
142234.75,117453,20.01.2016 04:30:00,,0.0,-0.0,0.0,0.0,117613,20.01.2016 00:45:00,12644,-0.0,36.78,IS,0.27,0.0,Phase3-EA-S1v2-USDJPY-M15-0,USDJPYMT4,3596,3h 45m,Sell
142178.91,127514,20.01.2016 12:29:58,sl 127.514,-0.38,-55.83999999999651,0.0,0.0,127777,18.01.2016 05:00:00,12645,-0.024044635869522612,-55.84,IS,0.09,0.0,Phase3-EA-TR1v1-EURJPY-M30-91,EURJPYMT4,2246,2d 7h 29m,Buy
142203.7,1.09443,20.01.2016 13:45:00,,0.0,-31.04999999998836,0.0,0.0,1.09516,20.01.2016 05:00:00,12646,-0.013370092115838894,24.79,IS,0.34,0.0,Phase3-EA-S4v1-EURCHF-M15-221,EURCHFMT4,3316,8h 45m,Sell
142151.86,165118,20.01.2016 13:59:58,sl 165.118,0.0,-82.88999999998487,0.0,0.0,164448,20.01.2016 12:30:00,12647,-0.03569233286576809,-51.84,IS,0.09,0.0,Phase3-EA-B1v1-GBPJPY-M30-1,GBPJPYMT4,1178,1h 29m,Sell
142090.86,126997,20.01.2016 19:29:57,sl 126.997,-0.76,-143.88999999998487,0.0,0.0,128234,19.01.2016 13:00:00,12648,-0.06195885843956771,-61.0,IS,0.09,0.0,Phase3-EA-TR1v1-EURJPY-M30-91,EURJPYMT4,2247,1d 6h 29m,Buy
142110.11,116411,20.01.2016 19:45:00,,0.0,-124.63999999998487,0.0,0.0,116496,20.01.2016 19:30:00,12649,-0.053669831926524386,19.25,IS,0.27,0.0,Phase3-EA-S1v2-USDJPY-M15-0,USDJPYMT4,3598,15m 0s,Buy
142160.08,116712,20.01.2016 23:45:00,,0.0,-74.6699999999837,0.0,0.0,116494,20.01.2016 19:30:00,12650,-0.03215281089500311,49.97,IS,0.27,0.0,Phase3-EA-S1v2-USDJPY-M15-0,USDJPYMT4,3599,4h 15m,Sell
142198.9,1.09269,21.01.2016 02:04:57,tp 1.09269,-6.12,-35.84999999997672,0.0,0.0,1.09379,20.01.2016 20:35:00,12651,-0.015436966259345982,38.82,IS,0.41,0.0,Phase3-EA-SA2v2-EURCHF-M5-43,EURCHFMT4,6460,5h 29m,Sell
142041.99,166506,21.01.2016 04:09:57,sl 166.506,0.0,-192.7599999999802,0.0,0.0,165706,21.01.2016 00:45:00,12652,-0.08300222081319829,-156.91,IS,0.23,0.0,Phase3-EA-S4v1-GBPJPY-M5-194,GBPJPYMT4,2794,3h 24m,Sell
142137.94,1.09606,21.01.2016 14:30:00,,0.0,-96.80999999996857,0.0,0.0,1.09322,21.01.2016 05:45:00,12653,-0.04168626788194616,95.95,IS,0.34,0.0,Phase3-EA-S4v1-EURCHF-M15-221,EURCHFMT4,3318,8h 45m,Buy
142104.46,127265,21.01.2016 16:29:57,sl 127.265,0.0,-130.28999999997905,0.0,0.0,127495,21.01.2016 15:45:00,12654,-0.05610271503294758,-33.48,IS,0.17,0.0,Phase3-EA-T1v2-EURJPY-M15-322,EURJPYMT4,2396,44m 57s,Buy
142200.21,126234,21.01.2016 17:59:58,tp 126.234,-0.81,-34.539999999979045,0.0,0.0,127494,20.01.2016 12:30:00,12655,-0.014872881857680141,95.75,IS,0.09,0.0,Phase3-EA-TR1v1-EURJPY-M30-91,EURJPYMT4,2249,1d 5h 29m,Sell
142218.88,117152,21.01.2016 18:30:00,,0.0,-15.86999999996624,0.0,0.0,117071,21.01.2016 18:15:00,12656,-0.006833602636972348,18.67,IS,0.27,0.0,Phase3-EA-S1v2-USDJPY-M15-0,USDJPYMT4,3602,15m 0s,Buy
142261.62,1.0952,22.01.2016 00:04:57,tp 1.09520,-2.04,-0.0,0.0,0.0,1.0963,21.01.2016 22:40:00,12657,-0.0,42.74,IS,0.41,0.0,Phase3-EA-SA2v2-EURCHF-M5-43,EURCHFMT4,6462,1h 24m,Sell
142352.65,117774,22.01.2016 01:14:58,tp 117.774,-0.67,-0.0,0.0,0.0,117374,21.01.2016 23:15:00,12658,-0.0,91.03,IS,0.27,0.0,Phase3-EA-S1v2-USDJPY-M15-0,USDJPYMT4,3604,1h 59m,Buy
142365.72,117787,22.01.2016 01:30:00,,0.0,-0.0,0.0,0.0,117.73,22.01.2016 01:15:00,12659,-0.0,13.07,IS,0.27,0.0,Phase3-EA-S1v2-USDJPY-M15-0,USDJPYMT4,3606,15m 0s,Buy
142237.62,1.09229,22.01.2016 09:30:00,,0.0,-128.10000000000582,0.0,0.0,1.09544,22.01.2016 01:10:00,12660,-0.05512861363543857,-128.1,IS,0.41,0.0,Phase3-EA-SA2v2-EURCHF-M5-43,EURCHFMT4,6464,8h 20m,Buy
142204.55,127648,22.01.2016 17:59:57,sl 127.648,0.0,-161.1700000000128,0.0,0.0,127878,22.01.2016 10:30:00,12661,-0.06936048914616656,-33.07,IS,0.17,0.0,Phase3-EA-T1v2-EURJPY-M15-322,EURJPYMT4,2398,7h 29m,Buy
142258.66,1.01528,25.01.2016 02:00:00,tp 1.01528,-3.02,-107.06000000002678,0.0,0.0,1.01628,22.01.2016 23:15:00,12662,-0.04607392174716051,54.11,IS,0.58,0.0,Phase3-EA-SA2v2-USDCHF-M15-107,USDCHFMT4,2478,2d 2h 45m,Sell
142301.08,1.09646,25.01.2016 02:00:00,tp 1.09646,-2.02,-64.64000000001397,0.0,0.0,1.09756,22.01.2016 20:10:00,12663,-0.027818216903945023,42.42,IS,0.41,0.0,Phase3-EA-SA2v2-EURCHF-M5-43,EURCHFMT4,6466,2d 5h 50m,Sell
142267.37,127.91,25.01.2016 04:29:58,sl 127.910,-0.7,-98.35000000000582,0.0,0.0,128.14,22.01.2016 19:30:00,12664,-0.04232552030480451,-33.71,IS,0.17,0.0,Phase3-EA-T1v2-EURJPY-M15-322,EURJPYMT4,2400,2d 8h 59m,Buy
142324.51,1.0151,25.01.2016 05:29:58,tp 1.01510,0.0,-41.20999999999185,0.0,0.0,1.0161,25.01.2016 02:30:00,12665,-0.017734973988414292,57.14,IS,0.58,0.0,Phase3-EA-SA2v2-USDCHF-M15-107,USDCHFMT4,2480,2h 59m,Sell
142400.1,169587,25.01.2016 06:04:58,tp 169.587,0.0,-0.0,0.0,0.0,169197,25.01.2016 03:50:00,12666,-0.0,75.59,IS,0.23,0.0,Phase3-EA-S4v1-GBPJPY-M5-194,GBPJPYMT4,2796,2h 14m,Buy
142384.73,1.09629,25.01.2016 10:25:00,,0.0,-15.369999999995343,0.0,0.0,1.09667,25.01.2016 02:05:00,12667,-0.006613594400344598,-15.37,IS,0.41,0.0,Phase3-EA-SA2v2-EURCHF-M5-43,EURCHFMT4,6468,8h 20m,Buy
142351.75,128089,25.01.2016 12:14:57,sl 128.089,0.0,-48.35000000000582,0.0,0.0,128319,25.01.2016 06:30:00,12668,-0.020804638207989373,-32.98,IS,0.17,0.0,Phase3-EA-T1v2-EURJPY-M15-322,EURJPYMT4,2402,5h 44m,Buy
142401.0,1.09758,25.01.2016 15:15:00,,0.0,-0.0,0.0,0.0,1.09611,25.01.2016 06:30:00,12669,-0.0,49.25,IS,0.34,0.0,Phase3-EA-S4v1-EURCHF-M15-221,EURCHFMT4,3320,8h 45m,Buy
142439.19,118399,26.01.2016 00:30:00,,-1.03,-0.0,0.0,0.0,118571,25.01.2016 17:00:00,12670,-0.0,38.19,IS,0.27,0.0,Phase3-EA-S1v2-USDJPY-M15-0,USDJPYMT4,3608,7h 30m,Sell
142481.7,1.09845,26.01.2016 01:59:59,tp 1.09845,-2.02,-0.0,0.0,0.0,1.09955,25.01.2016 20:05:00,12671,-0.0,42.51,IS,0.41,0.0,Phase3-EA-SA2v2-EURCHF-M5-43,EURCHFMT4,6470,5h 54m,Sell
142325.96,167838,26.01.2016 04:19:58,sl 167.838,0.0,-155.7399999999907,0.0,0.0,168638,26.01.2016 00:50:00,12672,-0.06699021901508365,-155.74,IS,0.23,0.0,Phase3-EA-S4v1-GBPJPY-M5-194,GBPJPYMT4,2798,3h 29m,Buy
142274.43,168191,26.01.2016 04:29:58,sl 168.191,-0.54,-207.26999999998952,0.0,0.0,168861,22.01.2016 15:30:00,12673,-0.08915540448989671,-51.53,IS,0.09,0.0,Phase3-EA-B1v1-GBPJPY-M30-1,GBPJPYMT4,1180,3d 12h 59m,Buy
142293.89,1.01337,26.01.2016 05:00:00,,0.0,-187.80999999999767,0.0,0.0,1.01303,26.01.2016 00:45:00,12674,-0.08078485317338806,19.46,IS,0.58,0.0,Phase3-EA-SA2v2-USDCHF-M15-107,USDCHFMT4,2482,4h 15m,Buy
142338.41,1.09973,26.01.2016 05:54:57,tp 1.09973,0.0,-143.29000000000815,0.0,0.0,1.09863,26.01.2016 02:05:00,12675,-0.06163495879460932,44.52,IS,0.41,0.0,Phase3-EA-SA2v2-EURCHF-M5-43,EURCHFMT4,6472,3h 49m,Buy
142304.6,128068,26.01.2016 08:59:58,sl 128.068,-0.7,-177.10000000000582,0.0,0.0,128298,25.01.2016 18:30:00,12676,-0.07617803895962767,-33.81,IS,0.17,0.0,Phase3-EA-T1v2-EURJPY-M15-322,EURJPYMT4,2404,14h 29m,Buy
142351.28,1.10022,26.01.2016 11:30:00,,0.0,-130.4200000000128,0.0,0.0,1.09883,26.01.2016 02:45:00,12677,-0.056099039193197565,46.68,IS,0.34,0.0,Phase3-EA-S4v1-EURCHF-M15-221,EURCHFMT4,3322,8h 45m,Buy
142300.34,168221,26.01.2016 15:29:57,sl 168.221,0.0,-181.36000000001513,0.0,0.0,167551,26.01.2016 10:30:00,12678,-0.07801044125194112,-50.94,IS,0.09,0.0,Phase3-EA-B1v1-GBPJPY-M30-1,GBPJPYMT4,1182,4h 59m,Sell
142336.54,118582,26.01.2016 21:30:00,,0.0,-145.1600000000035,0.0,0.0,118423,26.01.2016 20:00:00,12679,-0.06243932318113752,36.2,IS,0.27,0.0,Phase3-EA-S1v2-USDJPY-M15-0,USDJPYMT4,3610,1h 30m,Buy
142301.88,1.10473,27.01.2016 04:25:00,,-2.01,-179.82000000000698,0.0,0.0,1.10392,26.01.2016 20:05:00,12680,-0.07734802352185392,-34.66,IS,0.41,0.0,Phase3-EA-SA2v2-EURCHF-M5-43,EURCHFMT4,6474,8h 20m,Sell
142291.04,1.01693,27.01.2016 06:30:00,,0.0,-190.6600000000035,0.0,0.0,1.01712,27.01.2016 02:15:00,12681,-0.08201075611542857,-10.84,IS,0.58,0.0,Phase3-EA-SA2v2-USDCHF-M15-107,USDCHFMT4,2484,4h 15m,Buy
142385.71,129185,27.01.2016 17:59:57,tp 129.185,-1.11,-95.98999999999069,0.0,0.0,127925,22.01.2016 01:00:00,12682,-0.04128927137060254,94.67,IS,0.09,0.0,Phase3-EA-TR1v1-EURJPY-M30-91,EURJPYMT4,2252,5d 16h 59m,Buy
142430.11,1.1055,27.01.2016 23:34:58,tp 1.10550,0.0,-51.58999999999651,0.0,0.0,1.1066,27.01.2016 22:15:00,12683,-0.02219099395780235,44.4,IS,0.41,0.0,Phase3-EA-SA2v2-EURCHF-M5-43,EURCHFMT4,6476,1h 19m,Sell
142448.14,118741,28.01.2016 05:15:00,,-1.98,-33.55999999999767,0.0,0.0,118653,27.01.2016 23:15:00,12684,-0.01443554481922554,18.03,IS,0.27,0.0,Phase3-EA-S1v2-USDJPY-M15-0,USDJPYMT4,3612,6h 0m,Buy
142473.9,1.10638,28.01.2016 08:00:00,,-2.91,-7.7999999999883585,0.0,0.0,1.10567,27.01.2016 23:40:00,12685,-0.003355102788730601,25.76,IS,0.41,0.0,Phase3-EA-SA2v2-EURCHF-M5-43,EURCHFMT4,6478,8h 20m,Buy
142440.95,129097,28.01.2016 09:59:57,sl 129.097,0.0,-40.75,0.0,0.0,129327,28.01.2016 05:30:00,12686,-0.0175282613642277,-32.95,IS,0.17,0.0,Phase3-EA-T1v2-EURJPY-M15-322,EURJPYMT4,2406,4h 29m,Buy
142418.15,1.10494,28.01.2016 14:45:00,,0.0,-63.54999999998836,0.0,0.0,1.10562,28.01.2016 06:00:00,12687,-0.02733548490052678,-22.8,IS,0.34,0.0,Phase3-EA-S4v1-EURCHF-M15-221,EURCHFMT4,3324,8h 45m,Buy
142679.03,1.43851,28.01.2016 19:29:58,tp 1.43851,-3.72,-0.0,0.0,0.0,1.41961,21.01.2016 21:00:00,12688,-0.0,260.88,IS,0.14,0.0,Phase3-EA-B1v1-GBPUSD-M30-14,GBPUSDMT4,840,6d 22h 29m,Buy
142721.49,1.10852,29.01.2016 04:04:58,tp 1.10852,-2.02,-0.0,0.0,0.0,1.10962,28.01.2016 20:20:00,12689,-0.0,42.46,IS,0.41,0.0,Phase3-EA-SA2v2-EURCHF-M5-43,EURCHFMT4,6480,7h 44m,Sell
142773.57,129914,29.01.2016 04:45:00,,-0.7,-0.0,0.0,0.0,129545,28.01.2016 12:45:00,12690,-0.0,52.08,IS,0.17,0.0,Phase3-EA-T1v2-EURJPY-M15-322,EURJPYMT4,2408,16h 0m,Buy
142849.16,170355,29.01.2016 05:29:57,tp 170.355,0.0,-0.0,0.0,0.0,170745,29.01.2016 03:55:00,12691,-0.0,75.59,IS,0.23,0.0,Phase3-EA-S4v1-GBPJPY-M5-194,GBPJPYMT4,2800,1h 34m,Sell
142943.34,130286,29.01.2016 07:29:58,tp 130.286,-1.48,-0.0,0.0,0.0,129026,27.01.2016 18:00:00,12692,-0.0,94.18,IS,0.09,0.0,Phase3-EA-TR1v1-EURJPY-M30-91,EURJPYMT4,2254,1d 13h 29m,Buy
142911.08,131671,29.01.2016 07:59:58,sl 131.671,0.0,-32.26000000000931,0.0,0.0,131901,29.01.2016 07:45:00,12693,-0.013848861272448963,-32.26,IS,0.17,0.0,Phase3-EA-T1v2-EURJPY-M15-322,EURJPYMT4,2410,14m 58s,Buy
142869.08,1.43622,29.01.2016 12:29:58,sl 1.43622,0.0,-74.26000000000931,0.0,0.0,1.43922,29.01.2016 10:00:00,12694,-0.03187899684103819,-42.0,IS,0.14,0.0,Phase3-EA-B1v1-GBPUSD-M30-14,GBPUSDMT4,842,2h 29m,Buy
142815.78,131307,29.01.2016 19:59:58,sl 131.307,0.0,-127.55999999999767,0.0,0.0,132027,29.01.2016 17:30:00,12695,-0.054760097455457145,-53.3,IS,0.09,0.0,Phase3-EA-TR1v1-EURJPY-M30-91,EURJPYMT4,2256,2h 29m,Buy
142851.88,121208,01.02.2016 02:15:00,,-0.65,-91.45999999999185,0.0,0.0,121043,29.01.2016 21:00:00,12696,-0.039262766645310095,36.1,IS,0.27,0.0,Phase3-EA-S1v2-USDJPY-M15-0,USDJPYMT4,3614,2d 5h 15m,Buy
142908.56,1.02333,01.02.2016 02:44:57,tp 1.02333,0.0,-34.779999999998836,0.0,0.0,1.02233,01.02.2016 02:15:00,12697,-0.014930669406559818,56.68,IS,0.58,0.0,Phase3-EA-SA2v2-USDCHF-M15-107,USDCHFMT4,2486,29m 57s,Buy
142902.79,1.10852,01.02.2016 04:20:00,,-0.96,-40.54999999998836,0.0,0.0,1.10864,29.01.2016 20:00:00,12698,-0.017407666602525792,-5.77,IS,0.41,0.0,Phase3-EA-SA2v2-EURCHF-M5-43,EURCHFMT4,6482,2d 8h 20m,Buy
142878.31,172801,01.02.2016 07:40:00,,0.0,-65.02999999999884,0.0,0.0,172672,01.02.2016 02:15:00,12699,-0.027916659905365154,-24.48,IS,0.23,0.0,Phase3-EA-S4v1-GBPJPY-M5-194,GBPJPYMT4,2802,5h 25m,Sell
142911.91,120964,02.02.2016 01:45:00,,-1.0,-31.429999999993015,0.0,0.0,121119,01.02.2016 22:30:00,12700,-0.013492551450491275,33.6,IS,0.27,0.0,Phase3-EA-S1v2-USDJPY-M15-0,USDJPYMT4,3616,3h 15m,Sell
142852.4,1.11108,02.02.2016 04:40:00,,-2.01,-90.94000000000233,0.0,0.0,1.10965,01.02.2016 20:20:00,12701,-0.039039536395417775,-59.51,IS,0.41,0.0,Phase3-EA-SA2v2-EURCHF-M5-43,EURCHFMT4,6484,8h 20m,Sell
142832.49,1.01945,02.02.2016 06:15:00,,0.0,-110.85000000000582,0.0,0.0,1.0191,02.02.2016 02:00:00,12702,-0.04758667923281478,-19.91,IS,0.58,0.0,Phase3-EA-SA2v2-USDCHF-M15-107,USDCHFMT4,2488,4h 15m,Sell
142786.46,1.1125,02.02.2016 13:30:00,,0.0,-156.88000000000466,0.0,0.0,1.11112,02.02.2016 04:45:00,12703,-0.06734684923810386,-46.03,IS,0.34,0.0,Phase3-EA-S4v1-EURCHF-M15-221,EURCHFMT4,3326,8h 45m,Sell
142744.46,1.43955,02.02.2016 17:29:58,sl 1.43955,0.0,-198.88000000000466,0.0,0.0,1.44255,02.02.2016 16:30:00,12704,-0.08537698480669309,-42.0,IS,0.14,0.0,Phase3-EA-B1v1-GBPUSD-M30-14,GBPUSDMT4,844,59m 58s,Buy
142788.7,1.11171,02.02.2016 22:09:58,tp 1.11171,0.0,-154.64000000001397,0.0,0.0,1.11061,02.02.2016 20:20:00,12705,-0.0663852420077831,44.24,IS,0.41,0.0,Phase3-EA-SA2v2-EURCHF-M5-43,EURCHFMT4,6486,1h 49m,Buy
142601.18,119926,03.02.2016 00:14:58,sl 119.926,-0.65,-342.1600000000035,0.0,0.0,120756,02.02.2016 17:00:00,12706,-0.1468855044321084,-187.52,IS,0.27,0.0,Phase3-EA-S1v2-USDJPY-M15-0,USDJPYMT4,3618,7h 14m,Buy
142643.47,1.11138,03.02.2016 01:59:59,tp 1.11138,-2.01,-299.86999999999534,0.0,0.0,1.11248,02.02.2016 23:10:00,12707,-0.128730875070304,42.29,IS,0.41,0.0,Phase3-EA-SA2v2-EURCHF-M5-43,EURCHFMT4,6488,2h 49m,Sell
142687.76,1.11266,03.02.2016 02:34:57,tp 1.11266,0.0,-255.5799999999872,0.0,0.0,1.11156,03.02.2016 02:05:00,12708,-0.10971766782428105,44.29,IS,0.41,0.0,Phase3-EA-SA2v2-EURCHF-M5-43,EURCHFMT4,6490,29m 57s,Buy
142784.37,130.52,03.02.2016 07:59:57,tp 130.520,-0.52,-158.97000000000116,0.0,0.0,131.81,01.02.2016 21:00:00,12709,-0.06824406312711073,96.61,IS,0.09,0.0,Phase3-EA-TR1v1-EURJPY-M30-91,EURJPYMT4,2258,1d 10h 59m,Sell
142842.2,1.00293,03.02.2016 23:29:58,tp 1.00293,0.0,-101.14000000001397,0.0,0.0,1.00193,03.02.2016 23:15:00,12710,-0.0434182836049373,57.83,IS,0.58,0.0,Phase3-EA-SA2v2-USDCHF-M15-107,USDCHFMT4,2490,14m 58s,Buy
142836.47,117899,04.02.2016 07:45:00,,0.0,-106.87000000002445,0.0,0.0,117874,04.02.2016 00:15:00,12711,-0.045878109243227896,-5.73,IS,0.27,0.0,Phase3-EA-S1v2-USDJPY-M15-0,USDJPYMT4,3620,7h 30m,Sell
142819.74,1.11453,04.02.2016 07:50:00,,-6.12,-123.60000000003492,0.0,0.0,1.11427,03.02.2016 23:30:00,12712,-0.05306011324472044,-16.73,IS,0.41,0.0,Phase3-EA-SA2v2-EURCHF-M5-43,EURCHFMT4,6492,8h 20m,Sell
142857.61,1.11448,04.02.2016 10:15:00,,0.0,-85.73000000003958,0.0,0.0,1.1156,04.02.2016 01:30:00,12713,-0.03680294100704448,37.87,IS,0.34,0.0,Phase3-EA-S4v1-EURCHF-M15-221,EURCHFMT4,3328,8h 45m,Sell
142801.76,131424,04.02.2016 14:29:57,sl 131.424,-0.8,-141.5800000000454,0.0,0.0,130704,03.02.2016 06:00:00,12714,-0.060778728423849564,-55.85,IS,0.09,0.0,Phase3-EA-TR1v1-EURJPY-M30-91,EURJPYMT4,2259,1d 8h 29m,Sell
142746.35,130713,04.02.2016 20:59:58,sl 130.713,0.0,-196.9900000000489,0.0,0.0,131433,04.02.2016 17:00:00,12715,-0.08456562870612556,-55.41,IS,0.09,0.0,Phase3-EA-TR1v1-EURJPY-M30-91,EURJPYMT4,2262,3h 59m,Buy
142791.66,1.11395,04.02.2016 21:39:58,tp 1.11395,0.0,-151.68000000005122,0.0,0.0,1.11285,04.02.2016 20:30:00,12716,-0.06511454673915566,45.31,IS,0.41,0.0,Phase3-EA-SA2v2-EURCHF-M5-43,EURCHFMT4,6494,1h 9m,Buy
142837.09,1.11371,04.02.2016 23:04:58,tp 1.11371,0.0,-106.25000000005821,0.0,0.0,1.11481,04.02.2016 22:25:00,12717,-0.04561195009913464,45.43,IS,0.41,0.0,Phase3-EA-SA2v2-EURCHF-M5-43,EURCHFMT4,6496,39m 58s,Sell
142841.21,1.11278,05.02.2016 08:55:00,,0.0,-102.13000000006286,0.0,0.0,1.11268,05.02.2016 00:35:00,12718,-0.043843279657646464,4.12,IS,0.41,0.0,Phase3-EA-SA2v2-EURCHF-M5-43,EURCHFMT4,6498,8h 20m,Buy
142863.78,1.11304,05.02.2016 10:15:00,,0.0,-79.56000000005588,0.0,0.0,1.11238,05.02.2016 01:30:00,12719,-0.0341542282342373,22.57,IS,0.34,0.0,Phase3-EA-S4v1-EURCHF-M15-221,EURCHFMT4,3330,8h 45m,Buy
142870.04,116922,08.02.2016 02:45:00,,-0.67,-73.30000000004657,0.0,0.0,116892,05.02.2016 23:45:00,12720,-0.031466879456629286,6.26,IS,0.27,0.0,Phase3-EA-S1v2-USDJPY-M15-0,USDJPYMT4,3622,2d 3h 0m,Buy
142928.45,0.99302,08.02.2016 04:14:58,tp 0.99302,0.0,-14.890000000043074,0.0,0.0,0.99202,08.02.2016 02:15:00,12721,-0.006392112348025482,58.41,IS,0.58,0.0,Phase3-EA-SA2v2-USDCHF-M15-107,USDCHFMT4,2492,1h 59m,Buy
142915.08,1.10644,08.02.2016 04:20:00,,-0.99,-28.260000000038417,0.0,0.0,1.10674,05.02.2016 20:00:00,12722,-0.012131705504024388,-13.37,IS,0.41,0.0,Phase3-EA-SA2v2-EURCHF-M5-43,EURCHFMT4,6500,2d 8h 20m,Buy
142886.94,1.10748,08.02.2016 14:15:00,,0.0,-56.40000000005239,0.0,0.0,1.10666,08.02.2016 05:30:00,12723,-0.024211896334985168,-28.14,IS,0.34,0.0,Phase3-EA-S4v1-EURCHF-M15-221,EURCHFMT4,3332,8h 45m,Sell
142826.41,130002,08.02.2016 15:29:58,sl 130.002,-0.38,-116.93000000005122,0.0,0.0,130782,05.02.2016 12:00:00,12724,-0.05019675600085862,-60.53,IS,0.09,0.0,Phase3-EA-TR1v1-EURJPY-M30-91,EURJPYMT4,2264,3d 3h 29m,Buy
143071.02,129736,08.02.2016 15:29:58,tp 129.736,-3.04,-0.0,0.0,0.0,131436,02.02.2016 19:15:00,12725,-0.0,244.61,IS,0.17,0.0,Phase3-EA-T1v2-EURJPY-M15-322,EURJPYMT4,2412,5d 20h 14m,Sell
143116.64,1.10445,08.02.2016 22:29:57,tp 1.10445,0.0,-0.0,0.0,0.0,1.10555,08.02.2016 21:50:00,12726,-0.0,45.62,IS,0.41,0.0,Phase3-EA-SA2v2-EURCHF-M5-43,EURCHFMT4,6502,39m 57s,Sell
143060.27,129585,09.02.2016 00:59:58,sl 129.585,-0.27,-56.36999999999534,0.0,0.0,128865,08.02.2016 19:30:00,12727,-0.024181028003833194,-56.37,IS,0.09,0.0,Phase3-EA-TR1v1-EURJPY-M30-91,EURJPYMT4,2266,5h 29m,Sell
143137.91,166466,09.02.2016 04:44:58,tp 166.466,0.0,-0.0,0.0,0.0,166856,09.02.2016 00:40:00,12728,-0.0,77.64,IS,0.23,0.0,Phase3-EA-S4v1-GBPJPY-M5-194,GBPJPYMT4,2804,4h 4m,Sell
143231.58,115299,09.02.2016 04:59:58,tp 115.299,0.0,-0.0,0.0,0.0,115699,09.02.2016 00:45:00,12729,-0.0,93.67,IS,0.27,0.0,Phase3-EA-S1v2-USDJPY-M15-0,USDJPYMT4,3624,4h 14m,Sell
143170.73,128879,09.02.2016 05:29:58,sl 128.879,0.0,-60.85000000000582,0.0,0.0,129659,09.02.2016 01:30:00,12730,-0.0260899488825679,-60.85,IS,0.09,0.0,Phase3-EA-TR1v1-EURJPY-M30-91,EURJPYMT4,2268,3h 59m,Buy
143136.82,129305,09.02.2016 14:44:58,sl 129.305,0.0,-94.76000000000931,0.0,0.0,129075,09.02.2016 05:15:00,12731,-0.0406291463617443,-33.91,IS,0.17,0.0,Phase3-EA-T1v2-EURJPY-M15-322,EURJPYMT4,2414,9h 29m,Sell
143080.62,129149,09.02.2016 14:59:58,sl 129.149,0.0,-150.96000000002095,0.0,0.0,128429,09.02.2016 09:30:00,12732,-0.06472536866577848,-56.2,IS,0.09,0.0,Phase3-EA-TR1v1-EURJPY-M30-91,EURJPYMT4,2270,5h 29m,Sell
143038.62,1.44174,09.02.2016 15:59:57,sl 1.44174,0.0,-192.96000000002095,0.0,0.0,1.44474,09.02.2016 12:30:00,12733,-0.08273322163320242,-42.0,IS,0.14,0.0,Phase3-EA-B1v1-GBPUSD-M30-14,GBPUSDMT4,846,3h 29m,Buy
143132.35,115.22,09.02.2016 19:14:58,tp 115.220,0.0,-99.23000000001048,0.0,0.0,114.82,09.02.2016 17:00:00,12734,-0.04254569642756349,93.73,IS,0.27,0.0,Phase3-EA-S1v2-USDJPY-M15-0,USDJPYMT4,3626,2h 14m,Buy
143226.52,114683,09.02.2016 19:59:58,tp 114.683,0.0,-5.059999999997672,0.0,0.0,115083,09.02.2016 19:30:00,12735,-0.0021695175241696007,94.17,IS,0.27,0.0,Phase3-EA-S1v2-USDJPY-M15-0,USDJPYMT4,3628,29m 58s,Sell
143320.69,114689,09.02.2016 21:29:58,tp 114.689,0.0,-0.0,0.0,0.0,115089,09.02.2016 20:30:00,12736,-0.0,94.17,IS,0.27,0.0,Phase3-EA-S1v2-USDJPY-M15-0,USDJPYMT4,3630,59m 58s,Sell
143380.36,0.97197,09.02.2016 23:29:58,tp 0.97197,0.0,-0.0,0.0,0.0,0.97297,09.02.2016 22:45:00,12737,-0.0,59.67,IS,0.58,0.0,Phase3-EA-SA2v2-USDCHF-M15-107,USDCHFMT4,2494,44m 58s,Sell
143426.78,1.09778,09.02.2016 23:34:58,tp 1.09778,0.0,-0.0,0.0,0.0,1.09888,09.02.2016 21:30:00,12738,-0.0,46.42,IS,0.41,0.0,Phase3-EA-SA2v2-EURCHF-M5-43,EURCHFMT4,6504,2h 4m,Sell
143472.14,1.09868,10.02.2016 02:19:58,tp 1.09868,-1.01,-0.0,0.0,0.0,1.09758,09.02.2016 23:40:00,12739,-0.0,45.36,IS,0.41,0.0,Phase3-EA-SA2v2-EURCHF-M5-43,EURCHFMT4,6506,2h 39m,Buy
143518.49,1.09839,10.02.2016 03:04:58,tp 1.09839,0.0,-0.0,0.0,0.0,1.09949,10.02.2016 02:30:00,12740,-0.0,46.35,IS,0.41,0.0,Phase3-EA-SA2v2-EURCHF-M5-43,EURCHFMT4,6508,34m 58s,Sell
143508.02,114786,10.02.2016 04:45:00,,-1.06,-10.470000000001164,0.0,0.0,114746,09.02.2016 21:30:00,12741,-0.004483585004339956,-10.47,IS,0.27,0.0,Phase3-EA-S1v2-USDJPY-M15-0,USDJPYMT4,3632,7h 15m,Sell
143547.85,1.09786,10.02.2016 11:30:00,,0.0,-0.0,0.0,0.0,1099,10.02.2016 02:45:00,12742,-0.0,39.83,IS,0.34,0.0,Phase3-EA-S4v1-EURCHF-M15-221,EURCHFMT4,3334,8h 45m,Sell
143510.92,114783,10.02.2016 19:45:00,,0.0,-36.929999999993015,0.0,0.0,114.94,10.02.2016 17:15:00,12743,-0.015812605425394748,-36.93,IS,0.27,0.0,Phase3-EA-S1v2-USDJPY-M15-0,USDJPYMT4,3634,2h 30m,Buy
143484.32,1.09795,11.02.2016 05:30:00,,-6.32,-63.529999999998836,0.0,0.0,1.09747,10.02.2016 21:10:00,12744,-0.02720213438059843,-26.6,IS,0.41,0.0,Phase3-EA-SA2v2-EURCHF-M5-43,EURCHFMT4,6510,8h 20m,Sell
143508.11,1.09714,11.02.2016 09:45:00,,0.0,-39.73999999999069,0.0,0.0,1.09782,11.02.2016 01:00:00,12745,-0.017015784987954478,23.79,IS,0.34,0.0,Phase3-EA-S4v1-EURCHF-M15-221,EURCHFMT4,3336,8h 45m,Sell
143604.71,111796,11.02.2016 19:44:58,tp 111.796,0.0,-0.0,0.0,0.0,112196,11.02.2016 17:00:00,12746,-0.0,96.6,IS,0.27,0.0,Phase3-EA-S1v2-USDJPY-M15-0,USDJPYMT4,3636,2h 44m,Sell
143651.2,1.10267,11.02.2016 20:59:58,tp 1.10267,0.0,-0.0,0.0,0.0,1.10377,11.02.2016 20:05:00,12747,-0.0,46.49,IS,0.41,0.0,Phase3-EA-SA2v2-EURCHF-M5-43,EURCHFMT4,6512,54m 58s,Sell
143747.39,112275,11.02.2016 22:14:58,tp 112.275,0.0,-0.0,0.0,0.0,111875,11.02.2016 20:00:00,12748,-0.0,96.19,IS,0.27,0.0,Phase3-EA-S1v2-USDJPY-M15-0,USDJPYMT4,3638,2h 14m,Buy
143843.33,112574,11.02.2016 23:59:58,tp 112.574,0.0,-0.0,0.0,0.0,112174,11.02.2016 22:15:00,12749,-0.0,95.94,IS,0.27,0.0,Phase3-EA-S1v2-USDJPY-M15-0,USDJPYMT4,3640,1h 44m,Buy
143923.36,162616,12.02.2016 04:09:58,tp 162.616,0.0,-0.0,0.0,0.0,163006,12.02.2016 02:55:00,12750,-0.0,80.03,IS,0.23,0.0,Phase3-EA-S4v1-GBPJPY-M5-194,GBPJPYMT4,2806,1h 14m,Sell
143878.56,1.10108,12.02.2016 06:45:00,,-1.01,-44.79999999998836,0.0,0.0,1.10212,11.02.2016 22:25:00,12751,-0.019151571694245535,-44.8,IS,0.41,0.0,Phase3-EA-SA2v2-EURCHF-M5-43,EURCHFMT4,6514,8h 20m,Buy
143843.95,127.37,12.02.2016 08:14:58,sl 127.370,0.0,-79.40999999997439,0.0,0.0,127.6,12.02.2016 08:00:00,12752,-0.03394701580892729,-34.61,IS,0.17,0.0,Phase3-EA-T1v2-EURJPY-M15-322,EURJPYMT4,2416,14m 58s,Buy
143809.26,127108,12.02.2016 09:29:58,sl 127.108,0.0,-114.09999999997672,0.0,0.0,127338,12.02.2016 08:15:00,12753,-0.04877665915878431,-34.69,IS,0.17,0.0,Phase3-EA-T1v2-EURJPY-M15-322,EURJPYMT4,2418,1h 14m,Buy
143800.53,1.10047,12.02.2016 10:45:00,,0.0,-122.8299999999872,0.0,0.0,1.10072,12.02.2016 02:00:00,12754,-0.05250865069653002,-8.73,IS,0.34,0.0,Phase3-EA-S4v1-EURCHF-M15-221,EURCHFMT4,3338,8h 45m,Buy
143765.94,127177,12.02.2016 21:59:58,sl 127.177,0.0,-157.4199999999837,0.0,0.0,126947,12.02.2016 18:00:00,12755,-0.06729554500242418,-34.59,IS,0.17,0.0,Phase3-EA-T1v2-EURJPY-M15-322,EURJPYMT4,2420,3h 59m,Sell
143723.94,1.44892,12.02.2016 22:29:58,sl 1.44892,0.0,-199.4199999999837,0.0,0.0,1.44592,12.02.2016 18:30:00,12756,-0.08525014346578404,-42.0,IS,0.14,0.0,Phase3-EA-B1v1-GBPUSD-M30-14,GBPUSDMT4,848,3h 59m,Sell
143769.07,1.09877,15.02.2016 02:09:58,tp 1.09877,-1.01,-154.28999999997905,0.0,0.0,1.09767,12.02.2016 20:40:00,12757,-0.06595749992646227,45.13,IS,0.41,0.0,Phase3-EA-SA2v2-EURCHF-M5-43,EURCHFMT4,6516,2d 5h 29m,Buy
143848.21,164477,15.02.2016 04:24:58,tp 164.477,0.0,-75.14999999996508,0.0,0.0,164867,15.02.2016 03:20:00,12758,-0.03212590653621109,79.14,IS,0.23,0.0,Phase3-EA-S4v1-GBPJPY-M5-194,GBPJPYMT4,2808,1h 4m,Sell
143893.94,1.10205,16.02.2016 03:59:58,tp 1.10205,0.0,-29.419999999954598,0.0,0.0,1.10095,16.02.2016 01:40:00,12759,-0.012576768733124565,45.73,IS,0.41,0.0,Phase3-EA-SA2v2-EURCHF-M5-43,EURCHFMT4,6518,2h 19m,Buy
143915.13,114665,16.02.2016 05:00:00,,0.0,-8.22999999995227,0.0,0.0,114575,16.02.2016 01:00:00,12760,-0.0035182463179189195,21.19,IS,0.27,0.0,Phase3-EA-S1v2-USDJPY-M15-0,USDJPYMT4,3642,4h 0m,Buy
143912.78,0.98652,16.02.2016 06:15:00,,0.0,-10.57999999995809,0.0,0.0,0.98656,16.02.2016 02:00:00,12761,-0.004522848850990352,-2.35,IS,0.58,0.0,Phase3-EA-SA2v2-USDCHF-M15-107,USDCHFMT4,2496,4h 15m,Buy
143948.28,165.54,16.02.2016 06:35:00,,0.0,-0.0,0.0,0.0,165363,16.02.2016 01:10:00,12762,-0.0,35.5,IS,0.23,0.0,Phase3-EA-S4v1-GBPJPY-M5-194,GBPJPYMT4,2810,5h 25m,Buy
143945.77,127765,16.02.2016 11:30:00,,-0.73,-2.5100000000093132,0.0,0.0,127777,15.02.2016 20:45:00,12763,-0.0010728867081259573,-2.51,IS,0.17,0.0,Phase3-EA-T1v2-EURJPY-M15-322,EURJPYMT4,2422,14h 45m,Buy
143927.83,1.10223,16.02.2016 13:15:00,,0.0,-20.45000000001164,0.0,0.0,1.10171,16.02.2016 04:30:00,12764,-0.008741248279325462,-17.94,IS,0.34,0.0,Phase3-EA-S4v1-EURCHF-M15-221,EURCHFMT4,3340,8h 45m,Sell
144022.86,113644,16.02.2016 20:14:58,tp 113.644,0.0,-0.0,0.0,0.0,114044,16.02.2016 18:45:00,12765,-0.0,95.03,IS,0.27,0.0,Phase3-EA-S1v2-USDJPY-M15-0,USDJPYMT4,3644,1h 29m,Sell
144081.55,0.98832,16.02.2016 23:14:58,tp 0.98832,0.0,-0.0,0.0,0.0,0.98932,16.02.2016 22:45:00,12766,-0.0,58.69,IS,0.58,0.0,Phase3-EA-SA2v2-USDCHF-M15-107,USDCHFMT4,2498,29m 58s,Sell
144062.31,1.10064,17.02.2016 04:55:00,,-1.0,-19.239999999990687,0.0,0.0,1.10108,16.02.2016 20:35:00,12767,-0.00821935774092002,-19.24,IS,0.41,0.0,Phase3-EA-SA2v2-EURCHF-M5-43,EURCHFMT4,6520,8h 20m,Buy
144039.52,163089,17.02.2016 07:00:00,,0.0,-42.029999999998836,0.0,0.0,162976,17.02.2016 01:35:00,12768,-0.01795528096938805,-22.79,IS,0.23,0.0,Phase3-EA-S4v1-GBPJPY-M5-194,GBPJPYMT4,2812,5h 25m,Sell
144083.86,1.10212,17.02.2016 13:30:00,,0.0,-0.0,0.0,0.0,1.10083,17.02.2016 04:45:00,12769,-0.0,44.34,IS,0.34,0.0,Phase3-EA-S4v1-EURCHF-M15-221,EURCHFMT4,3342,8h 45m,Buy
144129.37,1.10456,17.02.2016 23:19:58,tp 1.10456,0.0,-0.0,0.0,0.0,1.10566,17.02.2016 20:25:00,12770,-0.0,45.51,IS,0.41,0.0,Phase3-EA-SA2v2-EURCHF-M5-43,EURCHFMT4,6522,2h 54m,Sell
144093.53,126993,18.02.2016 02:59:57,sl 126.993,-1.57,-35.83999999999651,0.0,0.0,126763,17.02.2016 23:45:00,12771,-0.015307776209365053,-35.84,IS,0.17,0.0,Phase3-EA-T1v2-EURJPY-M15-322,EURJPYMT4,2424,3h 14m,Sell
144109.57,1.10439,18.02.2016 08:15:00,,-2.98,-19.79999999998836,0.0,0.0,1.10393,17.02.2016 23:55:00,12772,-0.008456862972803555,16.04,IS,0.41,0.0,Phase3-EA-SA2v2-EURCHF-M5-43,EURCHFMT4,6524,8h 20m,Buy
144207.95,126455,18.02.2016 15:59:58,tp 126.455,-1.11,-0.0,0.0,0.0,127073,11.02.2016 16:30:00,12773,-0.0,98.38,IS,0.09,0.0,Phase3-EA-TR1v1-EURJPY-M30-91,EURJPYMT4,2272,6d 23h 29m,Buy
144143.58,126293,18.02.2016 16:29:57,sl 126.293,-2.71,-64.36999999999534,0.0,0.0,127715,16.02.2016 12:30:00,12774,-0.02748412255006499,-64.37,IS,0.09,0.0,Phase3-EA-TR1v1-EURJPY-M30-91,EURJPYMT4,2273,2d 3h 59m,Sell
144189.02,1.10368,18.02.2016 22:09:58,tp 1.10368,0.0,-18.929999999993015,0.0,0.0,1.10258,18.02.2016 20:15:00,12775,-0.008082560818278328,45.44,IS,0.41,0.0,Phase3-EA-SA2v2-EURCHF-M5-43,EURCHFMT4,6526,1h 54m,Buy
144234.44,1.10341,19.02.2016 03:04:57,tp 1.10341,0.0,-0.0,0.0,0.0,1.10231,19.02.2016 00:50:00,12776,-0.0,45.42,IS,0.41,0.0,Phase3-EA-SA2v2-EURCHF-M5-43,EURCHFMT4,6528,2h 14m,Buy
144071.37,161361,19.02.2016 05:54:58,sl 161.361,0.0,-163.07000000000698,0.0,0.0,162161,19.02.2016 00:55:00,12777,-0.06961828499686294,-163.07,IS,0.23,0.0,Phase3-EA-S4v1-GBPJPY-M5-194,GBPJPYMT4,2814,4h 59m,Buy
143978.34,0.99127,19.02.2016 06:30:00,,0.0,-256.1000000000058,0.0,0.0,0.99286,19.02.2016 02:15:00,12778,-0.10933490395349385,-93.03,IS,0.58,0.0,Phase3-EA-SA2v2-USDCHF-M15-107,USDCHFMT4,2500,4h 15m,Buy
143989.31,1.10295,19.02.2016 10:30:00,,0.0,-245.13000000000466,0.0,0.0,1.10263,19.02.2016 01:45:00,12779,-0.10465156191378308,10.97,IS,0.34,0.0,Phase3-EA-S4v1-EURCHF-M15-221,EURCHFMT4,3344,8h 45m,Buy
143936.01,162236,19.02.2016 10:59:57,sl 162.236,0.0,-298.429999999993,0.0,0.0,161566,19.02.2016 07:30:00,12780,-0.12740654192440323,-53.3,IS,0.09,0.0,Phase3-EA-B1v1-GBPJPY-M30-1,GBPJPYMT4,1184,3h 29m,Sell
144191.24,125.14,19.02.2016 13:44:58,tp 125.140,-0.52,-43.19999999998254,0.0,0.0,126.84,18.02.2016 11:00:00,12781,-0.018443060721549855,255.23,IS,0.17,0.0,Phase3-EA-T1v2-EURJPY-M15-322,EURJPYMT4,2426,1d 2h 44m,Sell
144148.71,1.43027,22.02.2016 02:00:00,sl 1.43027,-0.53,-85.72999999998137,0.0,0.0,1.43327,19.02.2016 20:30:00,12782,-0.03660008323284177,-42.53,IS,0.14,0.0,Phase3-EA-B1v1-GBPUSD-M30-14,GBPUSDMT4,850,2d 5h 30m,Buy
144194.3,1.10071,22.02.2016 02:19:58,tp 1.10071,0.0,-40.139999999984866,0.0,0.0,1.09961,22.02.2016 02:00:00,12783,-0.017136677253773873,45.59,IS,0.41,0.0,Phase3-EA-SA2v2-EURCHF-M5-43,EURCHFMT4,6530,19m 58s,Buy
144273.84,161268,22.02.2016 04:54:58,tp 161.268,0.0,-0.0,0.0,0.0,160878,22.02.2016 02:10:00,12784,-0.0,79.54,IS,0.23,0.0,Phase3-EA-S4v1-GBPJPY-M5-194,GBPJPYMT4,2816,2h 44m,Buy
144239.13,125399,22.02.2016 04:59:58,sl 125.399,0.0,-34.70999999999185,0.0,0.0,125169,22.02.2016 02:45:00,12785,-0.014815994820416836,-34.71,IS,0.17,0.0,Phase3-EA-T1v2-EURJPY-M15-322,EURJPYMT4,2428,2h 14m,Sell
144255.94,1.1012,22.02.2016 11:15:00,,0.0,-17.89999999999418,0.0,0.0,1.10071,22.02.2016 02:30:00,12786,-0.007640631151986096,16.81,IS,0.34,0.0,Phase3-EA-S4v1-EURCHF-M15-221,EURCHFMT4,3346,8h 45m,Buy
144355.55,124787,22.02.2016 16:59:57,tp 124.787,-0.56,-0.0,0.0,0.0,126047,18.02.2016 21:00:00,12787,-0.0,99.61,IS,0.09,0.0,Phase3-EA-TR1v1-EURJPY-M30-91,EURJPYMT4,2276,3d 19h 59m,Sell
144155.3,112298,23.02.2016 05:59:58,sl 112.298,-0.69,-200.25,0.0,0.0,113128,22.02.2016 18:30:00,12788,-0.08544709096925535,-200.25,IS,0.27,0.0,Phase3-EA-S1v2-USDJPY-M15-0,USDJPYMT4,3646,11h 29m,Buy
144148.32,1.10114,23.02.2016 06:20:00,,-2.05,-207.23000000001048,0.0,0.0,1.10102,22.02.2016 22:00:00,12789,-0.08842547146846282,-6.98,IS,0.41,0.0,Phase3-EA-SA2v2-EURCHF-M5-43,EURCHFMT4,6532,8h 20m,Sell
144284.83,1.09792,23.02.2016 10:29:58,tp 1.09792,0.0,-70.72000000000116,0.0,0.0,1.10192,23.02.2016 02:45:00,12790,-0.03017637090310031,136.51,IS,0.34,0.0,Phase3-EA-S4v1-EURCHF-M15-221,EURCHFMT4,3348,7h 44m,Sell
144542.68,123529,23.02.2016 12:14:58,tp 123.529,-0.53,-0.0,0.0,0.0,125229,22.02.2016 11:45:00,12791,-0.0,257.85,IS,0.17,0.0,Phase3-EA-T1v2-EURJPY-M15-322,EURJPYMT4,2430,1d 0h 29m,Sell
144480.11,123279,23.02.2016 13:29:58,sl 123.279,0.0,-62.570000000006985,0.0,0.0,124059,23.02.2016 09:30:00,12792,-0.026677447362674706,-62.57,IS,0.09,0.0,Phase3-EA-TR1v1-EURJPY-M30-91,EURJPYMT4,2278,3h 59m,Buy
144482.28,112062,23.02.2016 20:00:00,,0.0,-60.39999999999418,0.0,0.0,112071,23.02.2016 17:45:00,12793,-0.02575224261954958,2.17,IS,0.27,0.0,Phase3-EA-S1v2-USDJPY-M15-0,USDJPYMT4,3648,2h 15m,Sell
144526.78,1.09292,24.02.2016 02:44:57,tp 1.09292,-0.99,-15.89999999999418,0.0,0.0,1.09182,23.02.2016 22:25:00,12794,-0.006779149961104766,44.5,IS,0.41,0.0,Phase3-EA-SA2v2-EURCHF-M5-43,EURCHFMT4,6534,4h 19m,Buy
144530.64,112032,24.02.2016 02:45:00,,0.0,-12.040000000008149,0.0,0.0,112048,24.02.2016 01:15:00,12795,-0.005133394058602925,3.86,IS,0.27,0.0,Phase3-EA-S1v2-USDJPY-M15-0,USDJPYMT4,3650,1h 30m,Sell
144589.09,0.99229,24.02.2016 05:44:58,tp 0.99229,0.0,-0.0,0.0,0.0,0.99129,24.02.2016 02:15:00,12796,-0.0,58.45,IS,0.58,0.0,Phase3-EA-SA2v2-USDCHF-M15-107,USDCHFMT4,2502,3h 29m,Buy
144554.18,123611,24.02.2016 11:29:58,sl 123.611,0.0,-34.91000000000349,0.0,0.0,123381,24.02.2016 00:15:00,12797,-0.014881339963424244,-34.91,IS,0.17,0.0,Phase3-EA-T1v2-EURJPY-M15-322,EURJPYMT4,2432,11h 14m,Sell
144702.6,155634,24.02.2016 13:59:58,tp 155.634,-0.47,-0.0,0.0,0.0,157484,23.02.2016 21:00:00,12798,-0.0,148.42,IS,0.09,0.0,Phase3-EA-B1v1-GBPJPY-M30-1,GBPJPYMT4,1186,16h 59m,Sell
144647.19,155649,25.02.2016 00:29:58,sl 155.649,-1.4,-55.41000000000349,0.0,0.0,154979,24.02.2016 19:30:00,12799,-0.0236086008420883,-55.41,IS,0.09,0.0,Phase3-EA-B1v1-GBPJPY-M30-1,GBPJPYMT4,1188,4h 59m,Sell
144610.62,123181,25.02.2016 00:29:58,sl 123.181,-1.6,-91.98000000001048,0.0,0.0,122951,24.02.2016 13:15:00,12800,-0.039190021755195675,-36.57,IS,0.17,0.0,Phase3-EA-T1v2-EURJPY-M15-322,EURJPYMT4,2434,11h 14m,Sell
144653.24,1.08904,25.02.2016 01:54:58,tp 1.08904,-2.99,-49.360000000015134,0.0,0.0,1.08794,24.02.2016 20:10:00,12801,-0.021030870557043176,42.62,IS,0.41,0.0,Phase3-EA-SA2v2-EURCHF-M5-43,EURCHFMT4,6536,5h 44m,Buy
144588.2,156106,25.02.2016 05:50:00,,0.0,-114.40000000002328,0.0,0.0,155789,25.02.2016 00:25:00,12802,-0.0487425362991388,-65.04,IS,0.23,0.0,Phase3-EA-S4v1-GBPJPY-M5-194,GBPJPYMT4,2818,5h 25m,Sell
144385.42,112319,25.02.2016 06:59:58,sl 112.319,-3.26,-317.1800000000221,0.0,0.0,111489,24.02.2016 22:15:00,12803,-0.13514123831607322,-202.78,IS,0.27,0.0,Phase3-EA-S1v2-USDJPY-M15-0,USDJPYMT4,3652,8h 44m,Sell
144326.75,123953,25.02.2016 08:59:58,sl 123.953,-1.13,-375.8500000000349,0.0,0.0,123233,23.02.2016 14:30:00,12804,-0.16013883101424206,-58.67,IS,0.09,0.0,Phase3-EA-TR1v1-EURJPY-M30-91,EURJPYMT4,2280,1d 18h 29m,Sell
144289.81,1.09002,25.02.2016 10:55:00,,0.0,-412.79000000003725,0.0,0.0,1.08913,25.02.2016 02:35:00,12805,-0.17587789824230093,-36.94,IS,0.41,0.0,Phase3-EA-SA2v2-EURCHF-M5-43,EURCHFMT4,6538,8h 20m,Sell
144212.2,1.09133,25.02.2016 12:00:00,,0.0,-490.4000000000233,0.0,0.0,1.08907,25.02.2016 03:15:00,12806,-0.20894527798159035,-77.61,IS,0.34,0.0,Phase3-EA-S4v1-EURCHF-M15-221,EURCHFMT4,3350,8h 45m,Sell
144149.84,124298,25.02.2016 19:59:58,sl 124.298,0.0,-552.7600000000093,0.0,0.0,123518,25.02.2016 12:30:00,12807,-0.2355150731180676,-62.36,IS,0.09,0.0,Phase3-EA-TR1v1-EURJPY-M30-91,EURJPYMT4,2282,7h 29m,Sell
144195.42,1.09177,25.02.2016 21:29:58,tp 1.09177,0.0,-507.1800000000221,0.0,0.0,1.09067,25.02.2016 21:15:00,12808,-0.21609475140029075,45.58,IS,0.41,0.0,Phase3-EA-SA2v2-EURCHF-M5-43,EURCHFMT4,6540,14m 58s,Buy
144257.14,112858,25.02.2016 22:30:00,,0.0,-445.46000000002095,0.0,0.0,112.6,25.02.2016 21:45:00,12809,-0.18979764178156444,61.72,IS,0.27,0.0,Phase3-EA-S1v2-USDJPY-M15-0,USDJPYMT4,3654,45m 0s,Buy
144300.61,1.09107,26.02.2016 01:59:59,tp 1.09107,-2.07,-401.9900000000198,0.0,0.0,1.09217,25.02.2016 23:25:00,12810,-0.17127633013013796,43.47,IS,0.41,0.0,Phase3-EA-SA2v2-EURCHF-M5-43,EURCHFMT4,6542,2h 34m,Sell
144212.39,158068,26.02.2016 04:25:00,,-1.18,-490.21000000002095,0.0,0.0,157.64,25.02.2016 23:00:00,12811,-0.20886432446850514,-88.22,IS,0.23,0.0,Phase3-EA-S4v1-GBPJPY-M5-194,GBPJPYMT4,2820,5h 25m,Sell
144258.02,1.09222,26.02.2016 05:04:57,tp 1.09222,0.0,-444.5800000000163,0.0,0.0,1.09112,26.02.2016 02:05:00,12812,-0.18942269919464608,45.63,IS,0.41,0.0,Phase3-EA-SA2v2-EURCHF-M5-43,EURCHFMT4,6544,2h 59m,Buy
144341.63,124455,26.02.2016 12:30:00,,-0.74,-360.97000000003027,0.0,0.0,123895,25.02.2016 16:00:00,12813,-0.15379889272638134,83.61,IS,0.17,0.0,Phase3-EA-T1v2-EURJPY-M15-322,EURJPYMT4,2436,20h 30m,Buy
144369.33,113052,26.02.2016 17:15:00,,0.0,-333.2700000000186,0.0,0.0,112936,26.02.2016 17:00:00,12814,-0.14199672266094046,27.7,IS,0.27,0.0,Phase3-EA-S1v2-USDJPY-M15-0,USDJPYMT4,3656,15m 0s,Buy
144286.91,1.08883,29.02.2016 04:25:00,,-0.99,-415.69000000003143,0.0,0.0,1.09081,26.02.2016 20:05:00,12815,-0.1771135044946365,-82.42,IS,0.41,0.0,Phase3-EA-SA2v2-EURCHF-M5-43,EURCHFMT4,6546,2d 8h 20m,Buy
144157.79,156957,29.02.2016 08:15:00,,0.0,-544.8100000000268,0.0,0.0,157593,29.02.2016 02:50:00,12816,-0.23212780770218278,-129.12,IS,0.23,0.0,Phase3-EA-S4v1-GBPJPY-M5-194,GBPJPYMT4,2822,5h 25m,Buy
144099.8,123734,29.02.2016 08:29:58,sl 123.734,-0.78,-602.8000000000175,0.0,0.0,124454,25.02.2016 22:30:00,12817,-0.256835672037725,-57.99,IS,0.09,0.0,Phase3-EA-TR1v1-EURJPY-M30-91,EURJPYMT4,2284,3d 9h 59m,Buy
144143.82,1.09033,29.02.2016 11:00:00,,0.0,-558.7800000000279,0.0,0.0,1.08904,29.02.2016 02:15:00,12818,-0.23808002126948075,44.02,IS,0.34,0.0,Phase3-EA-S4v1-EURCHF-M15-221,EURCHFMT4,3352,8h 45m,Buy
144399.5,122715,29.02.2016 19:14:57,tp 122.715,-0.52,-303.1000000000349,0.0,0.0,124415,26.02.2016 20:15:00,12819,-0.12914215692541667,255.68,IS,0.17,0.0,Phase3-EA-T1v2-EURJPY-M15-322,EURJPYMT4,2438,2d 22h 59m,Sell
144444.74,1.08319,29.02.2016 21:14:58,tp 1.08319,0.0,-257.86000000004424,0.0,0.0,1.08209,29.02.2016 20:05:00,12820,-0.10986669938894693,45.24,IS,0.41,0.0,Phase3-EA-SA2v2-EURCHF-M5-43,EURCHFMT4,6548,1h 9m,Buy
144487.87,1.08509,01.03.2016 01:59:58,tp 1.08509,-2.05,-214.73000000003958,0.0,0.0,1.08619,29.02.2016 23:05:00,12821,-0.09149025191882756,43.13,IS,0.41,0.0,Phase3-EA-SA2v2-EURCHF-M5-43,EURCHFMT4,6550,2h 54m,Sell
144533.05,1.08588,01.03.2016 02:09:57,tp 1.08588,0.0,-169.55000000004657,0.0,0.0,1.08478,01.03.2016 02:05:00,12822,-0.0722403586496466,45.18,IS,0.41,0.0,Phase3-EA-SA2v2-EURCHF-M5-43,EURCHFMT4,6552,4m 57s,Buy
144633.37,122226,01.03.2016 02:29:58,tp 122.226,-0.28,-69.23000000003958,0.0,0.0,123486,29.02.2016 10:30:00,12823,-0.02949690374117676,100.32,IS,0.09,0.0,Phase3-EA-TR1v1-EURJPY-M30-91,EURJPYMT4,2286,15h 59m,Sell
144688.45,0.99731,01.03.2016 02:59:58,tp 0.99731,-3.08,-14.150000000052387,0.0,0.0,0.99831,29.02.2016 23:15:00,12824,-0.006028906369189048,55.08,IS,0.58,0.0,Phase3-EA-SA2v2-USDCHF-M15-107,USDCHFMT4,2504,3h 44m,Sell
144768.22,156782,01.03.2016 07:54:58,tp 156.782,0.0,-0.0,0.0,0.0,156392,01.03.2016 02:40:00,12825,-0.0,79.77,IS,0.23,0.0,Phase3-EA-S4v1-GBPJPY-M5-194,GBPJPYMT4,2824,5h 14m,Buy
144863.41,113.46,01.03.2016 19:14:57,tp 113.460,0.0,-0.0,0.0,0.0,113.06,01.03.2016 17:00:00,12826,-0.0,95.19,IS,0.27,0.0,Phase3-EA-S1v2-USDJPY-M15-0,USDJPYMT4,3658,2h 14m,Buy
144965.41,123522,01.03.2016 19:59:58,tp 123.522,0.0,-0.0,0.0,0.0,122232,01.03.2016 05:00:00,12827,-0.0,102.0,IS,0.09,0.0,Phase3-EA-TR1v1-EURJPY-M30-91,EURJPYMT4,2288,14h 59m,Buy
145010.61,1.08374,01.03.2016 23:54:59,tp 1.08374,0.0,-0.0,0.0,0.0,1.08484,01.03.2016 21:30:00,12828,-0.0,45.2,IS,0.41,0.0,Phase3-EA-SA2v2-EURCHF-M5-43,EURCHFMT4,6554,2h 24m,Sell
145063.85,114096,02.03.2016 02:15:00,,0.0,-0.0,0.0,0.0,113871,02.03.2016 00:45:00,12829,-0.0,53.24,IS,0.27,0.0,Phase3-EA-S1v2-USDJPY-M15-0,USDJPYMT4,3660,1h 30m,Buy
145021.84,0.99685,02.03.2016 03:45:00,,-0.7,-42.01000000000931,0.0,0.0,0.99756,01.03.2016 23:30:00,12830,-0.017871739954913972,-42.01,IS,0.58,0.0,Phase3-EA-SA2v2-USDCHF-M15-107,USDCHFMT4,2506,4h 15m,Buy
145100.44,159321,02.03.2016 05:14:57,tp 159.321,0.0,-0.0,0.0,0.0,158931,02.03.2016 00:25:00,12831,-0.0,78.6,IS,0.23,0.0,Phase3-EA-S4v1-GBPJPY-M5-194,GBPJPYMT4,2826,4h 49m,Buy
145122.61,1.08421,02.03.2016 08:35:00,,0.0,-0.0,0.0,0.0,1.08367,02.03.2016 00:15:00,12832,-0.0,22.17,IS,0.41,0.0,Phase3-EA-SA2v2-EURCHF-M5-43,EURCHFMT4,6556,8h 20m,Buy
145181.49,1.08495,02.03.2016 10:00:00,,0.0,-0.0,0.0,0.0,1.08322,02.03.2016 01:15:00,12833,-0.0,58.88,IS,0.34,0.0,Phase3-EA-S4v1-EURCHF-M15-221,EURCHFMT4,3354,8h 45m,Buy
145191.88,114381,02.03.2016 17:30:00,,0.0,-0.0,0.0,0.0,114337,02.03.2016 17:00:00,12834,-0.0,10.39,IS,0.27,0.0,Phase3-EA-S1v2-USDJPY-M15-0,USDJPYMT4,3662,30m 0s,Buy
145157.7,123839,02.03.2016 17:44:58,sl 123.839,0.0,-34.179999999993015,0.0,0.0,124069,02.03.2016 11:00:00,12835,-0.014532814653291938,-34.18,IS,0.17,0.0,Phase3-EA-T1v2-EURJPY-M15-322,EURJPYMT4,2440,6h 44m,Buy
145303.58,160483,02.03.2016 20:29:57,tp 160.483,-0.28,-0.0,0.0,0.0,158633,01.03.2016 19:30:00,12836,-0.0,145.88,IS,0.09,0.0,Phase3-EA-B1v1-GBPJPY-M30-1,GBPJPYMT4,1190,1d 0h 59m,Buy
145345.87,1.08328,03.03.2016 01:29:58,tp 1.08328,-2.96,-0.0,0.0,0.0,1.08218,02.03.2016 22:05:00,12837,-0.0,42.29,IS,0.41,0.0,Phase3-EA-SA2v2-EURCHF-M5-43,EURCHFMT4,6558,3h 24m,Buy
145304.19,0.99637,03.03.2016 02:15:00,,-2.1,-41.679999999993015,0.0,0.0,0.99705,02.03.2016 22:00:00,12838,-0.017710104706741926,-41.68,IS,0.58,0.0,Phase3-EA-SA2v2-USDCHF-M15-107,USDCHFMT4,2508,4h 15m,Buy
145251.39,160258,03.03.2016 12:29:58,sl 160.258,0.0,-94.47999999998137,0.0,0.0,160928,03.03.2016 12:00:00,12839,-0.04014517017017581,-52.8,IS,0.09,0.0,Phase3-EA-B1v1-GBPJPY-M30-1,GBPJPYMT4,1192,29m 58s,Buy
145268.95,113797,03.03.2016 17:45:00,,0.0,-76.9199999999837,0.0,0.0,113871,03.03.2016 17:30:00,12840,-0.03268381127741192,17.56,IS,0.27,0.0,Phase3-EA-S1v2-USDJPY-M15-0,USDJPYMT4,3664,15m 0s,Sell
145531.42,1.41206,03.03.2016 18:59:58,tp 1.41206,-2.13,-0.0,0.0,0.0,1.39316,01.03.2016 09:00:00,12841,-0.0,262.47,IS,0.14,0.0,Phase3-EA-B1v1-GBPUSD-M30-14,GBPUSDMT4,852,2d 9h 59m,Buy
145629.72,124367,03.03.2016 22:29:58,tp 124.367,-1.56,-0.0,0.0,0.0,123107,01.03.2016 13:00:00,12842,-0.0,98.3,IS,0.09,0.0,Phase3-EA-TR1v1-EURJPY-M30-91,EURJPYMT4,2289,2d 9h 29m,Buy
145596.66,1.08596,04.03.2016 04:25:00,,-2.07,-33.05999999999767,0.0,0.0,1.08521,03.03.2016 20:05:00,12843,-0.014030488174410875,-33.06,IS,0.41,0.0,Phase3-EA-SA2v2-EURCHF-M5-43,EURCHFMT4,6560,8h 20m,Sell
145612.71,113551,04.03.2016 05:00:00,,-1.07,-17.010000000009313,0.0,0.0,113623,03.03.2016 23:45:00,12844,-0.007218953534388278,16.05,IS,0.27,0.0,Phase3-EA-S1v2-USDJPY-M15-0,USDJPYMT4,3666,5h 15m,Sell
145591.46,1.0866,04.03.2016 09:45:00,,0.0,-38.26000000000931,0.0,0.0,1.08598,04.03.2016 01:00:00,12845,-0.01623734051884841,-21.25,IS,0.34,0.0,Phase3-EA-S4v1-EURCHF-M15-221,EURCHFMT4,3356,8h 45m,Sell
145529.44,125134,04.03.2016 19:29:58,sl 125.134,0.0,-100.27999999999884,0.0,0.0,124354,04.03.2016 05:00:00,12846,-0.04255829867301891,-62.02,IS,0.09,0.0,Phase3-EA-TR1v1-EURJPY-M30-91,EURJPYMT4,2292,14h 29m,Sell
145574.89,1.09239,04.03.2016 20:19:59,tp 1.09239,0.0,-54.829999999987194,0.0,0.0,1.09349,04.03.2016 20:00:00,12847,-0.023269560393309824,45.45,IS,0.41,0.0,Phase3-EA-SA2v2-EURCHF-M5-43,EURCHFMT4,6562,19m 59s,Sell
145618.28,1.09303,07.03.2016 02:00:00,tp 1.09303,-2.06,-11.439999999973224,0.0,0.0,1.09413,04.03.2016 23:50:00,12848,-0.0048550751577403515,43.39,IS,0.41,0.0,Phase3-EA-SA2v2-EURCHF-M5-43,EURCHFMT4,6564,2d 2h 10m,Sell
145695.85,161883,07.03.2016 02:04:57,tp 161.883,-1.17,-0.0,0.0,0.0,162273,04.03.2016 23:15:00,12849,-0.0,77.57,IS,0.23,0.0,Phase3-EA-S4v1-GBPJPY-M5-194,GBPJPYMT4,2828,2d 2h 49m,Sell
145754.18,0.99442,07.03.2016 03:29:59,tp 0.99442,0.0,-0.0,0.0,0.0,0.99342,07.03.2016 02:15:00,12850,-0.0,58.33,IS,0.58,0.0,Phase3-EA-SA2v2-USDCHF-M15-107,USDCHFMT4,2510,1h 14m,Buy
145890.43,1096,07.03.2016 12:29:57,tp 1.09600,0.0,-0.0,0.0,0.0,1092,07.03.2016 05:30:00,12851,-0.0,136.25,IS,0.34,0.0,Phase3-EA-S4v1-EURCHF-M15-221,EURCHFMT4,3358,6h 59m,Buy
145833.36,125.01,07.03.2016 20:59:58,sl 125.010,0.0,-57.070000000006985,0.0,0.0,125178,07.03.2016 02:00:00,12852,-0.024193435910056463,-57.07,IS,0.09,0.0,Phase3-EA-TR1v1-EURJPY-M30-91,EURJPYMT4,2294,18h 59m,Sell
145834.79,113577,07.03.2016 21:15:00,,0.0,-55.64000000001397,0.0,0.0,113583,07.03.2016 18:45:00,12853,-0.023587222253998858,1.43,IS,0.27,0.0,Phase3-EA-S1v2-USDJPY-M15-0,USDJPYMT4,3668,2h 30m,Sell
145748.2,161.21,08.03.2016 04:50:00,,-0.73,-142.23000000001048,0.0,0.0,161632,07.03.2016 23:25:00,12854,-0.06029494286818229,-86.59,IS,0.23,0.0,Phase3-EA-S4v1-GBPJPY-M5-194,GBPJPYMT4,2830,5h 25m,Buy
145702.24,1.09509,08.03.2016 08:15:00,,-0.99,-188.19000000000233,0.0,0.0,1.09618,07.03.2016 23:55:00,12855,-0.07977856498883872,-45.96,IS,0.41,0.0,Phase3-EA-SA2v2-EURCHF-M5-43,EURCHFMT4,6566,8h 20m,Buy
145805.13,123888,08.03.2016 22:29:58,tp 123.888,-0.28,-85.29999999998836,0.0,0.0,124.29,07.03.2016 15:00:00,12856,-0.03616085654682464,102.89,IS,0.09,0.0,Phase3-EA-TR1v1-EURJPY-M30-91,EURJPYMT4,2295,1d 7h 29m,Sell
145850.43,1.09536,09.03.2016 02:04:58,tp 1.09536,0.0,-40.0,0.0,0.0,1.09646,09.03.2016 00:15:00,12857,-0.0169570253443515,45.3,IS,0.41,0.0,Phase3-EA-SA2v2-EURCHF-M5-43,EURCHFMT4,6568,1h 49m,Sell
145883.17,112552,09.03.2016 04:15:00,,-1.08,-7.260000000009313,0.0,0.0,112693,08.03.2016 23:15:00,12858,-0.0030777001000037454,32.74,IS,0.27,0.0,Phase3-EA-S1v2-USDJPY-M15-0,USDJPYMT4,3670,5h 0m,Sell
145867.49,1.09519,09.03.2016 11:30:00,,0.0,-22.94000000000233,0.0,0.0,1.09565,09.03.2016 02:45:00,12859,-0.009724854034986572,-15.68,IS,0.34,0.0,Phase3-EA-S4v1-EURCHF-M15-221,EURCHFMT4,3360,8h 45m,Buy
145810.11,124612,09.03.2016 20:59:58,sl 124.612,0.0,-80.32000000000698,0.0,0.0,123892,09.03.2016 00:30:00,12860,-0.03404970689146077,-57.38,IS,0.09,0.0,Phase3-EA-TR1v1-EURJPY-M30-91,EURJPYMT4,2298,20h 29m,Sell
145751.99,0.99802,10.03.2016 04:30:00,,0.0,-138.44000000000233,0.0,0.0,0.99702,10.03.2016 00:15:00,12861,-0.05868826471680153,-58.12,IS,0.58,0.0,Phase3-EA-SA2v2-USDCHF-M15-107,USDCHFMT4,2512,4h 15m,Sell
145717.56,124535,10.03.2016 11:29:58,sl 124.535,0.0,-172.86999999999534,0.0,0.0,124765,10.03.2016 06:30:00,12862,-0.07328402428194912,-34.43,IS,0.17,0.0,Phase3-EA-T1v2-EURJPY-M15-322,EURJPYMT4,2442,4h 59m,Buy
145631.99,1.09379,10.03.2016 14:30:00,,0.0,-258.4400000000023,0.0,0.0,1.0963,10.03.2016 05:45:00,12863,-0.10955934074985603,-85.57,IS,0.34,0.0,Phase3-EA-S4v1-EURCHF-M15-221,EURCHFMT4,3362,8h 45m,Buy
145573.74,123997,10.03.2016 16:59:58,sl 123.997,-1.17,-316.6900000000023,0.0,0.0,124717,09.03.2016 22:00:00,12864,-0.13425300890756792,-58.25,IS,0.09,0.0,Phase3-EA-TR1v1-EURJPY-M30-91,EURJPYMT4,2300,18h 59m,Buy
145619.42,1.10036,10.03.2016 20:19:58,tp 1.10036,0.0,-271.0100000000093,0.0,0.0,1.10146,10.03.2016 20:10:00,12865,-0.11488808596432146,45.68,IS,0.41,0.0,Phase3-EA-SA2v2-EURCHF-M5-43,EURCHFMT4,6570,9m 58s,Sell
145665.23,1.09988,10.03.2016 21:34:58,tp 1.09988,0.0,-225.20000000001164,0.0,0.0,1.10098,10.03.2016 20:45:00,12866,-0.09546805268870388,45.81,IS,0.41,0.0,Phase3-EA-SA2v2-EURCHF-M5-43,EURCHFMT4,6572,49m 58s,Sell
145711.0,1.09972,11.03.2016 02:44:57,tp 1.09972,0.0,-179.43000000002212,0.0,0.0,1.10082,11.03.2016 00:50:00,12867,-0.07606497643843411,45.77,IS,0.41,0.0,Phase3-EA-SA2v2-EURCHF-M5-43,EURCHFMT4,6574,1h 54m,Sell
145806.69,112.87,11.03.2016 03:44:58,tp 112.870,0.0,-83.74000000001979,0.0,0.0,113.27,11.03.2016 00:30:00,12868,-0.03549953255840826,95.69,IS,0.27,0.0,Phase3-EA-S1v2-USDJPY-M15-0,USDJPYMT4,3672,3h 14m,Sell
145885.9,161658,11.03.2016 04:34:58,tp 161.658,0.0,-4.53000000002794,0.0,0.0,161268,11.03.2016 03:40:00,12869,-0.0019203831202596517,79.21,IS,0.23,0.0,Phase3-EA-S4v1-GBPJPY-M5-194,GBPJPYMT4,2832,54m 58s,Buy
145944.86,0.98373,11.03.2016 04:59:58,tp 0.98373,0.0,-0.0,0.0,0.0,0.98473,11.03.2016 01:00:00,12870,-0.0,58.96,IS,0.58,0.0,Phase3-EA-SA2v2-USDCHF-M15-107,USDCHFMT4,2514,3h 59m,Sell
145914.51,1.10045,11.03.2016 11:10:00,,0.0,-30.35000000000582,0.0,0.0,1.09972,11.03.2016 02:50:00,12871,-0.012863174896035296,-30.35,IS,0.41,0.0,Phase3-EA-SA2v2-EURCHF-M5-43,EURCHFMT4,6576,8h 20m,Sell
146061.07,163092,11.03.2016 19:59:58,tp 163.092,-0.29,-0.0,0.0,0.0,161242,10.03.2016 01:00:00,12872,-0.0,146.56,IS,0.09,0.0,Phase3-EA-B1v1-GBPJPY-M30-1,GBPJPYMT4,1194,1d 18h 59m,Buy
146107.04,1.09644,11.03.2016 21:14:57,tp 1.09644,0.0,-0.0,0.0,0.0,1.09754,11.03.2016 20:10:00,12873,-0.0,45.97,IS,0.41,0.0,Phase3-EA-SA2v2-EURCHF-M5-43,EURCHFMT4,6578,1h 4m,Sell
146088.05,113741,11.03.2016 23:30:00,,0.0,-18.989999999990687,0.0,0.0,113821,11.03.2016 17:00:00,12874,-0.00804296220900087,-18.99,IS,0.27,0.0,Phase3-EA-S1v2-USDJPY-M15-0,USDJPYMT4,3674,6h 30m,Buy
146133.96,1.09706,14.03.2016 02:39:59,tp 1.09706,0.0,-0.0,0.0,0.0,1.09596,14.03.2016 02:05:00,12875,-0.0,45.91,IS,0.41,0.0,Phase3-EA-SA2v2-EURCHF-M5-43,EURCHFMT4,6580,34m 59s,Buy
146083.13,1.09794,14.03.2016 11:05:00,,0.0,-50.829999999987194,0.0,0.0,1.09672,14.03.2016 02:45:00,12876,-0.021525916899029208,-50.83,IS,0.41,0.0,Phase3-EA-SA2v2-EURCHF-M5-43,EURCHFMT4,6582,8h 20m,Sell
146048.03,126424,14.03.2016 12:29:58,sl 126.424,-0.73,-85.92999999999302,0.0,0.0,126654,11.03.2016 20:00:00,12877,-0.03639036079350571,-35.1,IS,0.17,0.0,Phase3-EA-T1v2-EURJPY-M15-322,EURJPYMT4,2444,2d 16h 29m,Buy
146038.39,1.0972,14.03.2016 12:30:00,,0.0,-95.57000000000698,0.0,0.0,1.09692,14.03.2016 03:45:00,12878,-0.040472789259116466,-9.64,IS,0.34,0.0,Phase3-EA-S4v1-EURCHF-M15-221,EURCHFMT4,3364,8h 45m,Sell
146084.06,1.09578,14.03.2016 23:44:58,tp 1.09578,0.0,-49.89999999999418,0.0,0.0,1.09468,14.03.2016 21:15:00,12879,-0.021132072659093108,45.67,IS,0.41,0.0,Phase3-EA-SA2v2-EURCHF-M5-43,EURCHFMT4,6584,2h 29m,Buy
146129.77,1.09487,15.03.2016 01:04:58,tp 1.09487,0.0,-4.190000000002328,0.0,0.0,1.09597,15.03.2016 00:40:00,12880,-0.001774416521876947,45.71,IS,0.41,0.0,Phase3-EA-SA2v2-EURCHF-M5-43,EURCHFMT4,6586,24m 58s,Sell
146121.46,1.0962,15.03.2016 10:15:00,,0.0,-12.5,0.0,0.0,1096,15.03.2016 01:55:00,12881,-0.0052936053755249434,-8.31,IS,0.41,0.0,Phase3-EA-SA2v2-EURCHF-M5-43,EURCHFMT4,6588,8h 20m,Sell
146106.65,1.09659,15.03.2016 11:45:00,,0.0,-27.30999999999767,0.0,0.0,1.09616,15.03.2016 03:00:00,12882,-0.01156546902444591,-14.81,IS,0.34,0.0,Phase3-EA-S4v1-EURCHF-M15-221,EURCHFMT4,3366,8h 45m,Sell
146254.02,160652,15.03.2016 12:59:57,tp 160.652,0.0,-0.0,0.0,0.0,162502,15.03.2016 03:30:00,12883,-0.0,147.37,IS,0.09,0.0,Phase3-EA-B1v1-GBPJPY-M30-1,GBPJPYMT4,1196,9h 29m,Sell
146356.3,125238,15.03.2016 16:29:57,tp 125.238,-0.56,-0.0,0.0,0.0,126528,11.03.2016 12:30:00,12884,-0.0,102.28,IS,0.09,0.0,Phase3-EA-TR1v1-EURJPY-M30-91,EURJPYMT4,2302,4d 3h 59m,Sell
146302.64,160337,16.03.2016 04:59:58,sl 160.337,-0.46,-53.66000000000349,0.0,0.0,159667,15.03.2016 18:00:00,12885,-0.022703012358884934,-53.66,IS,0.09,0.0,Phase3-EA-B1v1-GBPJPY-M30-1,GBPJPYMT4,1198,10h 59m,Sell
146281.04,1.09633,16.03.2016 05:00:00,,-2.08,-75.26000000000931,0.0,0.0,1.09586,15.03.2016 20:40:00,12886,-0.03184175754994,-21.6,IS,0.41,0.0,Phase3-EA-SA2v2-EURCHF-M5-43,EURCHFMT4,6590,8h 20m,Sell
146246.65,125789,16.03.2016 17:14:59,sl 125.789,0.0,-109.65000000002328,0.0,0.0,126019,16.03.2016 16:30:00,12887,-0.046391824546256046,-34.39,IS,0.17,0.0,Phase3-EA-T1v2-EURJPY-M15-322,EURJPYMT4,2446,44m 59s,Buy
146270.63,113703,16.03.2016 17:45:00,,0.0,-85.6700000000128,0.0,0.0,113602,16.03.2016 17:15:00,12888,-0.03624612502396266,23.98,IS,0.27,0.0,Phase3-EA-S1v2-USDJPY-M15-0,USDJPYMT4,3676,30m 0s,Buy
146039.18,0.9773,16.03.2016 23:29:58,sl 0.97730,0.0,-317.12000000002445,0.0,0.0,0.9812,16.03.2016 22:15:00,12889,-0.13417031828642706,-231.45,IS,0.58,0.0,Phase3-EA-SA2v2-USDCHF-M15-107,USDCHFMT4,2516,1h 14m,Buy
146085.39,1.09568,16.03.2016 23:44:57,tp 1.09568,0.0,-270.9100000000326,0.0,0.0,1.09678,16.03.2016 22:30:00,12890,-0.11461932683834992,46.21,IS,0.41,0.0,Phase3-EA-SA2v2-EURCHF-M5-43,EURCHFMT4,6592,1h 14m,Sell
146144.75,0.97702,16.03.2016 23:59:57,tp 0.97702,0.0,-211.55000000004657,0.0,0.0,0.97602,16.03.2016 23:45:00,12891,-0.08950470116516683,59.36,IS,0.58,0.0,Phase3-EA-SA2v2-USDCHF-M15-107,USDCHFMT4,2518,14m 57s,Buy
146152.05,1.09694,17.03.2016 10:15:00,,0.0,-204.2500000000582,0.0,0.0,1.09715,17.03.2016 01:30:00,12892,-0.08641614376264009,7.3,IS,0.34,0.0,Phase3-EA-S4v1-EURCHF-M15-221,EURCHFMT4,3368,8h 45m,Sell
146249.11,111274,17.03.2016 18:14:58,tp 111.274,0.0,-107.19000000006054,0.0,0.0,111674,17.03.2016 17:00:00,12893,-0.04535102301062415,97.06,IS,0.27,0.0,Phase3-EA-S1v2-USDJPY-M15-0,USDJPYMT4,3678,1h 14m,Sell
146314.01,111077,17.03.2016 21:00:00,,0.0,-42.29000000006636,0.0,0.0,111344,17.03.2016 18:15:00,12894,-0.017892478431954673,64.9,IS,0.27,0.0,Phase3-EA-S1v2-USDJPY-M15-0,USDJPYMT4,3680,2h 45m,Sell
146358.53,1.09354,18.03.2016 02:04:58,tp 1.09354,-2.12,-0.0,0.0,0.0,1.09464,17.03.2016 23:50:00,12895,-0.0,44.52,IS,0.41,0.0,Phase3-EA-SA2v2-EURCHF-M5-43,EURCHFMT4,6594,2h 14m,Sell
146386.55,111.31,18.03.2016 03:30:00,,-1.09,-0.0,0.0,0.0,111.43,17.03.2016 23:00:00,12896,-0.0,28.02,IS,0.27,0.0,Phase3-EA-S1v2-USDJPY-M15-0,USDJPYMT4,3682,4h 30m,Sell
146375.15,0.96692,18.03.2016 06:30:00,,0.0,-11.39999999999418,0.0,0.0,0.96711,18.03.2016 02:15:00,12897,-0.004822609408189302,-11.4,IS,0.58,0.0,Phase3-EA-SA2v2-USDCHF-M15-107,USDCHFMT4,2520,4h 15m,Buy
146377.95,1.09382,18.03.2016 13:45:00,,0.0,-8.60000000000582,0.0,0.0,1.09374,18.03.2016 05:00:00,12898,-0.00363810885179625,2.8,IS,0.34,0.0,Phase3-EA-S4v1-EURCHF-M15-221,EURCHFMT4,3370,8h 45m,Buy
146424.52,1.09187,18.03.2016 20:29:58,tp 1.09187,0.0,-0.0,0.0,0.0,1.09297,18.03.2016 20:15:00,12899,-0.0,46.57,IS,0.41,0.0,Phase3-EA-SA2v2-EURCHF-M5-43,EURCHFMT4,6596,14m 58s,Sell
146471.05,1.0925,18.03.2016 22:29:58,tp 1.09250,0.0,-0.0,0.0,0.0,1.0914,18.03.2016 20:40:00,12900,-0.0,46.53,IS,0.41,0.0,Phase3-EA-SA2v2-EURCHF-M5-43,EURCHFMT4,6598,1h 49m,Buy
146460.11,0.96978,21.03.2016 04:00:00,,-3.17,-10.940000000002328,0.0,0.0,0.96965,18.03.2016 23:45:00,12901,-0.004626359125145451,-10.94,IS,0.58,0.0,Phase3-EA-SA2v2-USDCHF-M15-107,USDCHFMT4,2522,2d 4h 15m,Sell
146397.32,160846,21.03.2016 07:40:00,,0.0,-73.73000000001048,0.0,0.0,161.15,21.03.2016 02:15:00,12902,-0.031179292348898536,-62.79,IS,0.23,0.0,Phase3-EA-S4v1-GBPJPY-M5-194,GBPJPYMT4,2834,5h 25m,Buy
146396.06,1.09286,21.03.2016 08:00:00,,-2.11,-74.99000000001979,0.0,0.0,1.09288,18.03.2016 23:40:00,12903,-0.031712127129312165,-1.26,IS,0.41,0.0,Phase3-EA-SA2v2-EURCHF-M5-43,EURCHFMT4,6600,2d 8h 20m,Sell
146413.61,1.09293,21.03.2016 15:00:00,,0.0,-57.44000000003143,0.0,0.0,1.09343,21.03.2016 06:15:00,12904,-0.024290499830753525,17.55,IS,0.34,0.0,Phase3-EA-S4v1-EURCHF-M15-221,EURCHFMT4,3372,8h 45m,Sell
146378.58,125878,21.03.2016 17:14:58,sl 125.878,0.0,-92.47000000003027,0.0,0.0,125648,21.03.2016 02:30:00,12905,-0.03910415249563518,-35.03,IS,0.17,0.0,Phase3-EA-T1v2-EURJPY-M15-322,EURJPYMT4,2448,14h 44m,Sell
146386.48,125791,21.03.2016 23:45:00,,0.0,-84.57000000003609,0.0,0.0,125739,21.03.2016 22:00:00,12906,-0.035763362999418145,7.9,IS,0.17,0.0,Phase3-EA-T1v2-EURJPY-M15-322,EURJPYMT4,2450,1h 45m,Buy
146430.88,1.08958,22.03.2016 01:04:57,tp 1.08958,-2.11,-40.17000000004191,0.0,0.0,1.09068,21.03.2016 22:50:00,12907,-0.016987280261174326,44.4,IS,0.41,0.0,Phase3-EA-SA2v2-EURCHF-M5-43,EURCHFMT4,6602,2h 14m,Sell
146478.79,160816,22.03.2016 08:10:00,,0.0,-0.0,0.0,0.0,161049,22.03.2016 02:45:00,12908,-0.0,47.91,IS,0.23,0.0,Phase3-EA-S4v1-GBPJPY-M5-194,GBPJPYMT4,2836,5h 25m,Sell
146436.79,1.43953,22.03.2016 10:29:58,sl 1.43953,0.0,-42.0,0.0,0.0,1.43653,22.03.2016 04:00:00,12909,-0.0177605780205488,-42.0,IS,0.14,0.0,Phase3-EA-B1v1-GBPUSD-M30-14,GBPUSDMT4,854,6h 29m,Sell
146448.36,1.09047,22.03.2016 12:00:00,,0.0,-30.429999999993015,0.0,0.0,1.0908,22.03.2016 03:15:00,12910,-0.012867961646789904,11.57,IS,0.34,0.0,Phase3-EA-S4v1-EURCHF-M15-221,EURCHFMT4,3374,8h 45m,Sell
146547.56,125041,22.03.2016 12:29:58,tp 125.041,-2.24,-0.0,0.0,0.0,126301,14.03.2016 16:00:00,12911,-0.0,99.2,IS,0.09,0.0,Phase3-EA-TR1v1-EURJPY-M30-91,EURJPYMT4,2303,7d 20h 29m,Sell
146553.12,111684,22.03.2016 18:00:00,,0.0,-0.0,0.0,0.0,111707,22.03.2016 17:00:00,12912,-0.0,5.56,IS,0.27,0.0,Phase3-EA-S1v2-USDJPY-M15-0,USDJPYMT4,3684,1h 0m,Sell
146572.23,111603,22.03.2016 18:30:00,,0.0,-0.0,0.0,0.0,111682,22.03.2016 18:00:00,12913,-0.0,19.11,IS,0.27,0.0,Phase3-EA-S1v2-USDJPY-M15-0,USDJPYMT4,3686,30m 0s,Sell
146553.37,111679,22.03.2016 18:45:00,,0.0,-18.85999999998603,0.0,0.0,111601,22.03.2016 18:30:00,12914,-0.007972195214960742,-18.86,IS,0.27,0.0,Phase3-EA-S1v2-USDJPY-M15-0,USDJPYMT4,3688,15m 0s,Sell
146506.63,1.09195,23.03.2016 07:10:00,,-2.11,-65.59999999997672,0.0,0.0,1.09089,22.03.2016 22:50:00,12915,-0.02772937466074371,-46.74,IS,0.41,0.0,Phase3-EA-SA2v2-EURCHF-M5-43,EURCHFMT4,6604,8h 20m,Sell
146527.29,159624,23.03.2016 08:50:00,,0.0,-44.939999999973224,0.0,0.0,159523,23.03.2016 03:25:00,12916,-0.01899631245813296,20.66,IS,0.23,0.0,Phase3-EA-S4v1-GBPJPY-M5-194,GBPJPYMT4,2838,5h 25m,Buy
146518.93,1.09169,23.03.2016 13:00:00,,0.0,-53.299999999959255,0.0,0.0,1.09145,23.03.2016 04:15:00,12917,-0.022530116911845036,-8.36,IS,0.34,0.0,Phase3-EA-S4v1-EURCHF-M15-221,EURCHFMT4,3376,8h 45m,Sell
146515.58,112751,23.03.2016 18:45:00,,0.0,-56.649999999965075,0.0,0.0,112765,23.03.2016 18:15:00,12918,-0.023946174916626834,-3.35,IS,0.27,0.0,Phase3-EA-S1v2-USDJPY-M15-0,USDJPYMT4,3690,30m 0s,Buy
146561.85,1.08865,23.03.2016 20:24:58,tp 1.08865,0.0,-10.379999999975553,0.0,0.0,1.08755,23.03.2016 20:05:00,12919,-0.004387666295395487,46.27,IS,0.41,0.0,Phase3-EA-SA2v2-EURCHF-M5-43,EURCHFMT4,6606,19m 58s,Buy
146549.48,125895,23.03.2016 21:15:00,,0.0,-22.749999999970896,0.0,0.0,125977,23.03.2016 13:30:00,12920,-0.009616513316026467,-12.37,IS,0.17,0.0,Phase3-EA-T1v2-EURJPY-M15-322,EURJPYMT4,2452,7h 45m,Buy
146595.76,1.08954,23.03.2016 23:44:58,tp 1.08954,0.0,-0.0,0.0,0.0,1.09064,23.03.2016 22:35:00,12921,-0.0,46.28,IS,0.41,0.0,Phase3-EA-SA2v2-EURCHF-M5-43,EURCHFMT4,6608,1h 9m,Sell
146516.1,112.43,24.03.2016 04:15:00,,-2.09,-79.66000000000349,0.0,0.0,112753,23.03.2016 18:45:00,12922,-0.03366924242429493,-79.66,IS,0.27,0.0,Phase3-EA-S1v2-USDJPY-M15-0,USDJPYMT4,3692,9h 30m,Buy
146514.42,1.09054,24.03.2016 10:45:00,,0.0,-81.33999999999651,0.0,0.0,1.0905,24.03.2016 02:25:00,12923,-0.03437931432076214,-1.68,IS,0.41,0.0,Phase3-EA-SA2v2-EURCHF-M5-43,EURCHFMT4,6610,8h 20m,Sell
146558.57,1.08943,25.03.2016 03:44:58,tp 1.08943,-2.1,-37.19000000000233,0.0,0.0,1.09053,24.03.2016 20:15:00,12924,-0.01571879394626603,44.15,IS,0.41,0.0,Phase3-EA-SA2v2-EURCHF-M5-43,EURCHFMT4,6612,7h 29m,Sell
146458.8,112994,25.03.2016 10:45:00,,-1.08,-136.95999999999185,0.0,0.0,112581,24.03.2016 19:45:00,12925,-0.05788776603604013,-99.77,IS,0.27,0.0,Phase3-EA-S1v2-USDJPY-M15-0,USDJPYMT4,3694,15h 0m,Sell
146502.89,1.08993,28.03.2016 02:04:57,tp 1.08993,-2.1,-92.86999999999534,0.0,0.0,1.09103,25.03.2016 23:40:00,12926,-0.03925260537213126,44.09,IS,0.41,0.0,Phase3-EA-SA2v2-EURCHF-M5-43,EURCHFMT4,6614,2d 2h 24m,Sell
146549.04,1.09213,28.03.2016 03:04:58,tp 1.09213,0.0,-46.720000000001164,0.0,0.0,1.09103,28.03.2016 02:05:00,12927,-0.01974676131136115,46.15,IS,0.41,0.0,Phase3-EA-SA2v2-EURCHF-M5-43,EURCHFMT4,6616,59m 58s,Buy
146581.54,0.97816,28.03.2016 03:45:00,,-0.71,-14.220000000001164,0.0,0.0,0.9776,25.03.2016 23:30:00,12928,-0.0060102514094086375,32.5,IS,0.58,0.0,Phase3-EA-SA2v2-USDCHF-M15-107,USDCHFMT4,2524,2d 4h 15m,Buy
146518.33,126758,28.03.2016 07:29:58,sl 126.758,-1.4,-77.42999999999302,0.0,0.0,125978,23.03.2016 19:30:00,12929,-0.03272670651409499,-63.21,IS,0.09,0.0,Phase3-EA-TR1v1-EURJPY-M30-91,EURJPYMT4,2306,4d 11h 59m,Sell
146472.89,1.42227,28.03.2016 17:59:57,sl 1.42227,-3.44,-122.86999999999534,0.0,0.0,1.41927,23.03.2016 09:30:00,12930,-0.05193246066624127,-45.44,IS,0.14,0.0,Phase3-EA-B1v1-GBPUSD-M30-14,GBPUSDMT4,856,5d 8h 29m,Sell
146478.25,0.97402,29.03.2016 05:45:00,,0.0,-117.51000000000931,0.0,0.0,0.97411,29.03.2016 01:30:00,12931,-0.049666993187032854,5.36,IS,0.58,0.0,Phase3-EA-SA2v2-USDCHF-M15-107,USDCHFMT4,2526,4h 15m,Sell
146487.42,113334,29.03.2016 05:45:00,,-1.07,-108.33999999999651,0.0,0.0,113377,28.03.2016 22:45:00,12932,-0.04579118408546115,9.17,IS,0.27,0.0,Phase3-EA-S1v2-USDJPY-M15-0,USDJPYMT4,3696,7h 0m,Sell
146509.98,1.09065,29.03.2016 06:50:00,,-1.01,-85.77999999999884,0.0,0.0,1.09009,28.03.2016 22:30:00,12933,-0.0362559329042914,22.56,IS,0.41,0.0,Phase3-EA-SA2v2-EURCHF-M5-43,EURCHFMT4,6618,8h 20m,Buy
146613.59,126925,29.03.2016 20:15:00,,-1.48,-0.0,0.0,0.0,126224,25.03.2016 15:30:00,12934,-0.0,103.61,IS,0.17,0.0,Phase3-EA-T1v2-EURJPY-M15-322,EURJPYMT4,2454,4d 4h 45m,Buy
146659.85,1.09227,29.03.2016 21:24:57,tp 1.09227,0.0,-0.0,0.0,0.0,1.09117,29.03.2016 20:30:00,12935,-0.0,46.26,IS,0.41,0.0,Phase3-EA-SA2v2-EURCHF-M5-43,EURCHFMT4,6620,54m 57s,Buy
146719.7,0.96904,29.03.2016 23:14:58,tp 0.96904,0.0,-0.0,0.0,0.0,0.96804,29.03.2016 22:45:00,12936,-0.0,59.85,IS,0.58,0.0,Phase3-EA-SA2v2-USDCHF-M15-107,USDCHFMT4,2528,29m 58s,Buy
146740.7,0.96671,30.03.2016 04:30:00,,0.0,-0.0,0.0,0.0,0.96636,30.03.2016 00:15:00,12937,-0.0,21.0,IS,0.58,0.0,Phase3-EA-SA2v2-USDCHF-M15-107,USDCHFMT4,2530,4h 15m,Buy
146753.68,1.09158,30.03.2016 08:05:00,,-1.02,-0.0,0.0,0.0,1.09125,29.03.2016 23:45:00,12938,-0.0,12.98,IS,0.41,0.0,Phase3-EA-SA2v2-EURCHF-M5-43,EURCHFMT4,6622,8h 20m,Buy
147017.75,1.44516,30.03.2016 19:29:58,tp 1.44516,-0.53,-0.0,0.0,0.0,1.42626,29.03.2016 14:30:00,12939,-0.0,264.07,IS,0.14,0.0,Phase3-EA-B1v1-GBPUSD-M30-14,GBPUSDMT4,858,1d 4h 59m,Buy
147028.54,112556,30.03.2016 20:45:00,,0.0,-0.0,0.0,0.0,112511,30.03.2016 20:15:00,12940,-0.0,10.79,IS,0.27,0.0,Phase3-EA-S1v2-USDJPY-M15-0,USDJPYMT4,3698,30m 0s,Buy
147075.34,1.09107,30.03.2016 21:34:58,tp 1.09107,0.0,-0.0,0.0,0.0,1.09217,30.03.2016 20:15:00,12941,-0.0,46.8,IS,0.41,0.0,Phase3-EA-SA2v2-EURCHF-M5-43,EURCHFMT4,6624,1h 19m,Sell
147135.55,0.96324,30.03.2016 23:59:57,tp 0.96324,0.0,-0.0,0.0,0.0,0.96424,30.03.2016 22:45:00,12942,-0.0,60.21,IS,0.58,0.0,Phase3-EA-SA2v2-USDCHF-M15-107,USDCHFMT4,2532,1h 14m,Sell
147139.22,112.56,31.03.2016 05:00:00,,-2.09,-0.0,0.0,0.0,112536,30.03.2016 22:45:00,12943,-0.0,3.67,IS,0.27,0.0,Phase3-EA-S1v2-USDJPY-M15-0,USDJPYMT4,3700,6h 15m,Buy
147101.0,1.09287,31.03.2016 08:05:00,,-6.38,-38.220000000001164,0.0,0.0,1.09212,30.03.2016 23:45:00,12944,-0.016117114663698785,-38.22,IS,0.41,0.0,Phase3-EA-SA2v2-EURCHF-M5-43,EURCHFMT4,6626,8h 20m,Sell
147144.0,1.09225,31.03.2016 11:00:00,,0.0,-0.0,0.0,0.0,1.09347,31.03.2016 02:15:00,12945,-0.0,43.0,IS,0.34,0.0,Phase3-EA-S4v1-EURCHF-M15-221,EURCHFMT4,3378,8h 45m,Sell
147243.1,128081,31.03.2016 18:29:58,tp 128.081,-1.96,-0.0,0.0,0.0,126821,28.03.2016 09:00:00,12946,-0.0,99.1,IS,0.09,0.0,Phase3-EA-TR1v1-EURJPY-M30-91,EURJPYMT4,2308,3d 9h 29m,Buy
147315.04,128023,01.04.2016 04:00:00,,-0.74,-0.0,0.0,0.0,127542,31.03.2016 12:00:00,12947,-0.0,71.94,IS,0.17,0.0,Phase3-EA-T1v2-EURJPY-M15-322,EURJPYMT4,2456,16h 0m,Buy
147316.32,1.09267,01.04.2016 06:45:00,,-2.13,-0.0,0.0,0.0,1.09275,31.03.2016 22:25:00,12948,-0.0,1.28,IS,0.41,0.0,Phase3-EA-SA2v2-EURCHF-M5-43,EURCHFMT4,6628,8h 20m,Sell
147334.38,1.09309,01.04.2016 09:45:00,,0.0,-0.0,0.0,0.0,1.0936,01.04.2016 01:00:00,12949,-0.0,18.06,IS,0.34,0.0,Phase3-EA-S4v1-EURCHF-M15-221,EURCHFMT4,3380,8h 45m,Sell
147278.94,160219,01.04.2016 14:59:58,sl 160.219,-1.73,-55.44000000000233,0.0,0.0,160889,28.03.2016 12:30:00,12950,-0.023359447544010262,-55.44,IS,0.09,0.0,Phase3-EA-B1v1-GBPJPY-M30-1,GBPJPYMT4,1200,4d 2h 29m,Buy
147323.9,1.09105,04.04.2016 01:00:00,tp 1.09105,-2.14,-10.480000000010477,0.0,0.0,1.09215,01.04.2016 22:05:00,12951,-0.004415710863301984,44.96,IS,0.41,0.0,Phase3-EA-SA2v2-EURCHF-M5-43,EURCHFMT4,6630,2d 2h 55m,Sell
147427.78,126614,04.04.2016 18:59:58,tp 126.614,-0.28,-0.0,0.0,0.0,127904,01.04.2016 04:30:00,12952,-0.0,103.88,IS,0.09,0.0,Phase3-EA-TR1v1-EURJPY-M30-91,EURJPYMT4,2310,3d 14h 29m,Sell
147472.67,1.09185,05.04.2016 00:59:58,tp 1.09185,-2.14,-0.0,0.0,0.0,1.09295,04.04.2016 22:00:00,12953,-0.0,44.89,IS,0.41,0.0,Phase3-EA-SA2v2-EURCHF-M5-43,EURCHFMT4,6632,2h 59m,Sell
147484.94,111189,05.04.2016 03:45:00,,-1.09,-0.0,0.0,0.0,111244,04.04.2016 23:00:00,12954,-0.0,12.27,IS,0.27,0.0,Phase3-EA-S1v2-USDJPY-M15-0,USDJPYMT4,3702,4h 45m,Sell
147460.12,0.95794,05.04.2016 05:30:00,,0.0,-24.820000000006985,0.0,0.0,0.95835,05.04.2016 01:15:00,12955,-0.010451189031189445,-24.82,IS,0.58,0.0,Phase3-EA-SA2v2-USDCHF-M15-107,USDCHFMT4,2534,4h 15m,Buy
147319.64,157907,05.04.2016 09:15:00,,0.0,-165.30000000001746,0.0,0.0,158584,05.04.2016 03:50:00,12956,-0.06960441365251054,-140.48,IS,0.23,0.0,Phase3-EA-S4v1-GBPJPY-M5-194,GBPJPYMT4,2840,5h 25m,Buy
147303.82,1.09187,05.04.2016 09:25:00,,0.0,-181.12000000002445,0.0,0.0,1.09224,05.04.2016 01:05:00,12957,-0.07626588869173065,-15.82,IS,0.41,0.0,Phase3-EA-SA2v2-EURCHF-M5-43,EURCHFMT4,6634,8h 20m,Buy
147453.15,157735,05.04.2016 09:59:57,tp 157.735,-0.94,-31.790000000037253,0.0,0.0,159585,01.04.2016 17:00:00,12958,-0.013386111978316207,149.33,IS,0.09,0.0,Phase3-EA-B1v1-GBPJPY-M30-1,GBPJPYMT4,1202,3d 16h 59m,Sell
147449.96,1.09192,05.04.2016 10:00:00,,0.0,-34.98000000003958,0.0,0.0,1.09201,05.04.2016 01:15:00,12959,-0.01472935504880409,-3.19,IS,0.34,0.0,Phase3-EA-S4v1-EURCHF-M15-221,EURCHFMT4,3382,8h 45m,Buy
147386.22,126.01,05.04.2016 10:29:58,sl 126.010,-0.4,-98.72000000003027,0.0,0.0,126.79,04.04.2016 23:00:00,12960,-0.041568951698591775,-63.74,IS,0.09,0.0,Phase3-EA-TR1v1-EURJPY-M30-91,EURJPYMT4,2312,11h 29m,Buy
147646.35,125808,05.04.2016 10:44:58,tp 125.808,-1.06,-0.0,0.0,0.0,127508,01.04.2016 17:30:00,12961,-0.0,260.13,IS,0.17,0.0,Phase3-EA-T1v2-EURJPY-M15-322,EURJPYMT4,2458,3d 17h 14m,Sell
147681.98,110277,06.04.2016 03:45:00,,-1.1,-0.0,0.0,0.0,110427,05.04.2016 22:45:00,12962,-0.0,35.63,IS,0.27,0.0,Phase3-EA-S1v2-USDJPY-M15-0,USDJPYMT4,3704,5h 0m,Sell
147669.98,1.08822,06.04.2016 09:15:00,,0.0,-12.0,0.0,0.0,1.0885,06.04.2016 00:55:00,12963,-0.005048763057258244,-12.0,IS,0.41,0.0,Phase3-EA-SA2v2-EURCHF-M5-43,EURCHFMT4,6636,8h 20m,Buy
147665.72,1.08825,06.04.2016 10:00:00,,0.0,-16.260000000009313,0.0,0.0,1.08837,06.04.2016 01:15:00,12964,-0.006841073942588839,-4.26,IS,0.34,0.0,Phase3-EA-S4v1-EURCHF-M15-221,EURCHFMT4,3384,8h 45m,Buy
147768.13,125115,06.04.2016 12:29:58,tp 125.115,-0.29,-0.0,0.0,0.0,126375,05.04.2016 06:00:00,12965,-0.0,102.41,IS,0.09,0.0,Phase3-EA-TR1v1-EURJPY-M30-91,EURJPYMT4,2313,1d 6h 29m,Sell
147918.64,155001,06.04.2016 15:29:58,tp 155.001,-0.47,-0.0,0.0,0.0,156851,05.04.2016 14:00:00,12966,-0.0,150.51,IS,0.09,0.0,Phase3-EA-B1v1-GBPJPY-M30-1,GBPJPYMT4,1204,1d 1h 29m,Sell
147876.64,1.41302,06.04.2016 20:59:58,sl 1.41302,0.0,-42.0,0.0,0.0,1.41602,06.04.2016 20:00:00,12967,-0.017653093511294342,-42.0,IS,0.14,0.0,Phase3-EA-B1v1-GBPUSD-M30-14,GBPUSDMT4,860,59m 58s,Buy
147917.41,1.08916,07.04.2016 00:59:58,tp 1.08916,-6.43,-1.2300000000104774,0.0,0.0,1.09026,06.04.2016 20:35:00,12968,-5.169834528351667E-4,40.77,IS,0.41,0.0,Phase3-EA-SA2v2-EURCHF-M5-43,EURCHFMT4,6638,4h 24m,Sell
147953.12,109631,07.04.2016 04:15:00,,0.0,-0.0,0.0,0.0,109776,07.04.2016 00:15:00,12969,-0.0,35.71,IS,0.27,0.0,Phase3-EA-S1v2-USDJPY-M15-0,USDJPYMT4,3706,4h 0m,Sell
147948.39,1.08926,07.04.2016 09:25:00,,0.0,-4.730000000010477,0.0,0.0,1.08937,07.04.2016 01:05:00,12970,-0.001987786501816177,-4.73,IS,0.41,0.0,Phase3-EA-SA2v2-EURCHF-M5-43,EURCHFMT4,6640,8h 20m,Buy
148212.41,123781,07.04.2016 11:44:58,tp 123.781,-1.63,-0.0,0.0,0.0,125481,06.04.2016 08:15:00,12971,-0.0,264.02,IS,0.17,0.0,Phase3-EA-T1v2-EURJPY-M15-322,EURJPYMT4,2460,1d 3h 29m,Sell
148365.46,152754,07.04.2016 11:59:58,tp 152.754,0.0,-0.0,0.0,0.0,154604,07.04.2016 06:00:00,12972,-0.0,153.05,IS,0.09,0.0,Phase3-EA-B1v1-GBPJPY-M30-1,GBPJPYMT4,1206,5h 59m,Sell
148309.39,152699,08.04.2016 04:29:58,sl 152.699,-0.48,-56.070000000006985,0.0,0.0,152029,07.04.2016 17:30:00,12973,-0.023522703331265635,-56.07,IS,0.09,0.0,Phase3-EA-B1v1-GBPJPY-M30-1,GBPJPYMT4,1208,10h 59m,Sell
148304.5,1.0867,08.04.2016 07:10:00,,-1.03,-60.960000000020955,0.0,0.0,1.08679,07.04.2016 22:50:00,12974,-0.025574175050370383,-4.89,IS,0.41,0.0,Phase3-EA-SA2v2-EURCHF-M5-43,EURCHFMT4,6642,8h 20m,Buy
148097.91,109067,08.04.2016 11:44:58,sl 109.067,-1.12,-267.55000000001746,0.0,0.0,108237,07.04.2016 23:00:00,12975,-0.11224361113393522,-206.59,IS,0.27,0.0,Phase3-EA-S1v2-USDJPY-M15-0,USDJPYMT4,3708,12h 44m,Sell
148038.08,123927,08.04.2016 11:59:58,sl 123.927,-0.29,-327.38000000000466,0.0,0.0,123207,07.04.2016 15:00:00,12976,-0.13734372421239333,-59.83,IS,0.09,0.0,Phase3-EA-TR1v1-EURJPY-M30-91,EURJPYMT4,2316,20h 59m,Sell
148065.09,1.08767,08.04.2016 15:30:00,,0.0,-300.36999999999534,0.0,0.0,1.08691,08.04.2016 06:45:00,12977,-0.12601238451241786,27.01,IS,0.34,0.0,Phase3-EA-S4v1-EURCHF-M15-221,EURCHFMT4,3386,8h 45m,Buy
148110.31,1.08672,11.04.2016 01:00:00,tp 1.08672,-2.15,-255.14999999999418,0.0,0.0,1.08782,08.04.2016 20:30:00,12978,-0.10704151515911436,45.22,IS,0.41,0.0,Phase3-EA-SA2v2-EURCHF-M5-43,EURCHFMT4,6644,2d 4h 30m,Sell
148193.25,152832,11.04.2016 02:44:57,tp 152.832,0.0,-172.20999999999185,0.0,0.0,152442,11.04.2016 01:10:00,12979,-0.07224620546953021,82.94,IS,0.23,0.0,Phase3-EA-S4v1-GBPJPY-M5-194,GBPJPYMT4,2842,1h 34m,Buy
148276.35,152526,11.04.2016 04:24:58,tp 152.526,0.0,-89.10999999998603,0.0,0.0,152916,11.04.2016 03:00:00,12980,-0.03738377196091477,83.1,IS,0.23,0.0,Phase3-EA-S4v1-GBPJPY-M5-194,GBPJPYMT4,2844,1h 24m,Sell
148299.59,1.08709,11.04.2016 09:25:00,,0.0,-65.86999999999534,0.0,0.0,1.08655,11.04.2016 01:05:00,12981,-0.027634037246837256,23.24,IS,0.41,0.0,Phase3-EA-SA2v2-EURCHF-M5-43,EURCHFMT4,6646,8h 20m,Buy
148375.28,1.08888,11.04.2016 14:00:00,,0.0,-0.0,0.0,0.0,1.08675,11.04.2016 05:15:00,12982,-0.0,75.69,IS,0.34,0.0,Phase3-EA-S4v1-EURCHF-M15-221,EURCHFMT4,3388,8h 45m,Buy
148339.14,123204,11.04.2016 14:14:58,sl 123.204,0.0,-36.14000000001397,0.0,0.0,122974,11.04.2016 14:00:00,12983,-0.015160968033268283,-36.14,IS,0.17,0.0,Phase3-EA-T1v2-EURJPY-M15-322,EURJPYMT4,2462,14m 58s,Sell
148377.52,108327,11.04.2016 17:30:00,,0.0,-0.0,0.0,0.0,108173,11.04.2016 17:00:00,12984,-0.0,38.38,IS,0.27,0.0,Phase3-EA-S1v2-USDJPY-M15-0,USDJPYMT4,3710,30m 0s,Buy
148422.64,1.08747,12.04.2016 01:00:00,tp 1.08747,-2.15,-0.0,0.0,0.0,1.08857,11.04.2016 20:35:00,12985,-0.0,45.12,IS,0.41,0.0,Phase3-EA-SA2v2-EURCHF-M5-43,EURCHFMT4,6648,4h 25m,Sell
148441.13,108168,12.04.2016 04:15:00,,-0.73,-0.0,0.0,0.0,108091,11.04.2016 18:00:00,12986,-0.0,18.49,IS,0.27,0.0,Phase3-EA-S1v2-USDJPY-M15-0,USDJPYMT4,3712,10h 15m,Buy
148404.94,123151,12.04.2016 05:14:57,sl 123.151,0.0,-36.19000000000233,0.0,0.0,123381,12.04.2016 04:30:00,12987,-0.015177750583551638,-36.19,IS,0.17,0.0,Phase3-EA-T1v2-EURJPY-M15-322,EURJPYMT4,2464,44m 57s,Buy
148420.74,0.95426,12.04.2016 06:15:00,,0.0,-20.39000000001397,0.0,0.0,0.95452,12.04.2016 02:00:00,12988,-0.008551377021243714,15.8,IS,0.58,0.0,Phase3-EA-SA2v2-USDCHF-M15-107,USDCHFMT4,2536,4h 15m,Sell
148468.09,1.0876,12.04.2016 10:14:58,tp 1.08760,0.0,-0.0,0.0,0.0,1.0887,12.04.2016 01:55:00,12989,-0.0,47.35,IS,0.41,0.0,Phase3-EA-SA2v2-EURCHF-M5-43,EURCHFMT4,6650,8h 19m,Sell
148478.1,1.08866,12.04.2016 12:15:00,,0.0,-0.0,0.0,0.0,1.08894,12.04.2016 03:30:00,12990,-0.0,10.01,IS,0.34,0.0,Phase3-EA-S4v1-EURCHF-M15-221,EURCHFMT4,3390,8h 45m,Sell
148508.94,108656,13.04.2016 03:45:00,,-0.72,-0.0,0.0,0.0,108529,12.04.2016 23:00:00,12991,-0.0,30.84,IS,0.27,0.0,Phase3-EA-S1v2-USDJPY-M15-0,USDJPYMT4,3714,4h 45m,Buy
148506.19,1.08763,13.04.2016 04:35:00,,-1.03,-2.75,0.0,0.0,1.08767,12.04.2016 20:15:00,12992,-0.0011529966130409974,-2.75,IS,0.41,0.0,Phase3-EA-SA2v2-EURCHF-M5-43,EURCHFMT4,6652,8h 20m,Buy
148514.71,1.0877,13.04.2016 10:00:00,,0.0,-0.0,0.0,0.0,1.08746,13.04.2016 01:15:00,12993,-0.0,8.52,IS,0.34,0.0,Phase3-EA-S4v1-EURCHF-M15-221,EURCHFMT4,3392,8h 45m,Buy
148549.8,109.25,13.04.2016 19:00:00,,0.0,-0.0,0.0,0.0,109108,13.04.2016 17:15:00,12994,-0.0,35.09,IS,0.27,0.0,Phase3-EA-S1v2-USDJPY-M15-0,USDJPYMT4,3716,1h 45m,Buy
148554.49,109271,13.04.2016 19:45:00,,0.0,-0.0,0.0,0.0,109252,13.04.2016 19:00:00,12995,-0.0,4.69,IS,0.27,0.0,Phase3-EA-S1v2-USDJPY-M15-0,USDJPYMT4,3718,45m 0s,Buy
148570.17,1.08932,14.04.2016 06:00:00,,-6.36,-0.0,0.0,0.0,1.08984,13.04.2016 21:40:00,12996,-0.0,15.68,IS,0.41,0.0,Phase3-EA-SA2v2-EURCHF-M5-43,EURCHFMT4,6654,8h 20m,Sell
148509.27,122975,14.04.2016 12:29:58,sl 122.975,-1.62,-60.89999999999418,0.0,0.0,123262,11.04.2016 15:00:00,12997,-0.02552708077459719,-60.9,IS,0.09,0.0,Phase3-EA-TR1v1-EURJPY-M30-91,EURJPYMT4,2318,2d 21h 29m,Buy
148467.05,1.08833,14.04.2016 14:15:00,,0.0,-103.11999999999534,0.0,0.0,1.08953,14.04.2016 05:30:00,12998,-0.04322418012276839,-42.22,IS,0.34,0.0,Phase3-EA-S4v1-EURCHF-M15-221,EURCHFMT4,3394,8h 45m,Buy
148411.92,154864,14.04.2016 16:59:58,sl 154.864,0.0,-158.25,0.0,0.0,154194,14.04.2016 12:30:00,12999,-0.06633268526404583,-55.13,IS,0.09,0.0,Phase3-EA-B1v1-GBPJPY-M30-1,GBPJPYMT4,1210,4h 29m,Sell
148376.03,122964,14.04.2016 17:44:58,sl 122.964,0.0,-194.14000000001397,0.0,0.0,122734,14.04.2016 17:30:00,13000,-0.08137647720166057,-35.89,IS,0.17,0.0,Phase3-EA-T1v2-EURJPY-M15-322,EURJPYMT4,2466,14m 58s,Sell
148339.75,123236,15.04.2016 00:59:57,sl 123.236,-0.54,-230.4200000000128,0.0,0.0,123006,14.04.2016 17:45:00,13001,-0.0965837430555595,-36.28,IS,0.17,0.0,Phase3-EA-T1v2-EURJPY-M15-322,EURJPYMT4,2468,7h 14m,Sell
148384.3,1.08817,15.04.2016 01:04:58,tp 1.08817,-2.12,-185.87000000002445,0.0,0.0,1.08927,14.04.2016 22:35:00,13002,-0.07790999184852967,44.55,IS,0.41,0.0,Phase3-EA-SA2v2-EURCHF-M5-43,EURCHFMT4,6656,2h 29m,Sell
148341.61,1.42214,15.04.2016 19:59:58,sl 1.42214,-0.69,-228.56000000002678,0.0,0.0,1.41914,14.04.2016 03:30:00,13003,-0.09580409822402586,-42.69,IS,0.14,0.0,Phase3-EA-B1v1-GBPUSD-M30-14,GBPUSDMT4,862,1d 16h 29m,Sell
148274.21,122482,18.04.2016 01:00:00,sl 122.482,-2.84,-295.96000000002095,0.0,0.0,123695,12.04.2016 10:30:00,13004,-0.12405574427013204,-67.4,IS,0.09,0.0,Phase3-EA-TR1v1-EURJPY-M30-91,EURJPYMT4,2319,5d 14h 30m,Buy
148214.2,122464,18.04.2016 01:00:00,sl 122.464,-0.41,-355.97000000003027,0.0,0.0,123184,15.04.2016 01:00:00,13005,-0.1492097691844828,-60.01,IS,0.09,0.0,Phase3-EA-TR1v1-EURJPY-M30-91,EURJPYMT4,2321,3d 0h 0m,Buy
148271.02,0.96672,18.04.2016 01:00:00,tp 0.96672,-3.18,-299.1500000000233,0.0,0.0,0.96772,15.04.2016 23:00:00,13006,-0.12539287707261204,56.82,IS,0.58,0.0,Phase3-EA-SA2v2-USDCHF-M15-107,USDCHFMT4,2538,2d 2h 0m,Sell
148369.59,108339,18.04.2016 01:00:00,tp 108.339,-1.12,-200.5800000000163,0.0,0.0,108739,15.04.2016 23:45:00,13007,-0.08407589263989507,98.57,IS,0.27,0.0,Phase3-EA-S1v2-USDJPY-M15-0,USDJPYMT4,3720,2d 1h 15m,Sell
148414.09,1.09109,18.04.2016 01:00:00,tp 1.09109,-2.12,-156.0800000000163,0.0,0.0,1.09219,15.04.2016 23:00:00,13008,-0.06542309962725658,44.5,IS,0.41,0.0,Phase3-EA-SA2v2-EURCHF-M5-43,EURCHFMT4,6658,2d 2h 0m,Sell
148243.65,152839,18.04.2016 06:04:58,sl 152.839,0.0,-326.5200000000186,0.0,0.0,153639,18.04.2016 01:15:00,13009,-0.13686539268510256,-170.44,IS,0.23,0.0,Phase3-EA-S4v1-GBPJPY-M5-194,GBPJPYMT4,2846,4h 49m,Buy
148229.23,1.09106,18.04.2016 10:30:00,,0.0,-340.94000000003143,0.0,0.0,1.09147,18.04.2016 01:45:00,13010,-0.14290973594897866,-14.42,IS,0.34,0.0,Phase3-EA-S4v1-EURCHF-M15-221,EURCHFMT4,3396,8h 45m,Buy
148173.42,153345,18.04.2016 11:59:58,sl 153.345,0.0,-396.7500000000291,0.0,0.0,152675,18.04.2016 11:00:00,13011,-0.16630327253404179,-55.81,IS,0.09,0.0,Phase3-EA-B1v1-GBPJPY-M30-1,GBPJPYMT4,1212,59m 58s,Sell
148280.14,123.19,18.04.2016 18:29:58,tp 123.190,0.0,-290.03000000002794,0.0,0.0,121.9,18.04.2016 11:00:00,13012,-0.1215701024147429,106.72,IS,0.09,0.0,Phase3-EA-TR1v1-EURJPY-M30-91,EURJPYMT4,2324,7h 29m,Buy
148290.07,108773,18.04.2016 23:45:00,,0.0,-280.1000000000349,0.0,0.0,108815,18.04.2016 23:00:00,13013,-0.11740780500765595,9.93,IS,0.27,0.0,Phase3-EA-S1v2-USDJPY-M15-0,USDJPYMT4,3722,45m 0s,Buy
148303.49,108872,19.04.2016 02:30:00,,-0.72,-266.6800000000221,0.0,0.0,108813,18.04.2016 23:00:00,13014,-0.11178262563170432,13.42,IS,0.27,0.0,Phase3-EA-S1v2-USDJPY-M15-0,USDJPYMT4,3723,3h 30m,Sell
148319.66,1.09077,19.04.2016 06:35:00,,-2.12,-250.5100000000093,0.0,0.0,1.0912,18.04.2016 22:15:00,13015,-0.10500474556396043,16.17,IS,0.41,0.0,Phase3-EA-SA2v2-EURCHF-M5-43,EURCHFMT4,6660,8h 20m,Sell
148330.28,109303,19.04.2016 19:00:00,,0.0,-239.89000000001397,0.0,0.0,109.26,19.04.2016 17:00:00,13016,-0.10055322507420462,10.62,IS,0.27,0.0,Phase3-EA-S1v2-USDJPY-M15-0,USDJPYMT4,3726,2h 0m,Buy
148367.69,0.96123,20.04.2016 06:00:00,,0.0,-202.48000000001048,0.0,0.0,0.96185,20.04.2016 01:45:00,13017,-0.0848723040269491,37.41,IS,0.58,0.0,Phase3-EA-SA2v2-USDCHF-M15-107,USDCHFMT4,2540,4h 15m,Sell
148360.01,1.09236,20.04.2016 06:20:00,,-2.13,-210.1600000000035,0.0,0.0,1.09223,19.04.2016 22:00:00,13018,-0.08809148268620602,-7.68,IS,0.41,0.0,Phase3-EA-SA2v2-EURCHF-M5-43,EURCHFMT4,6662,8h 20m,Sell
148371.68,1.09217,20.04.2016 10:15:00,,0.0,-198.4899999999907,0.0,0.0,1.0925,20.04.2016 01:30:00,13019,-0.08319984011412221,11.67,IS,0.34,0.0,Phase3-EA-S4v1-EURCHF-M15-221,EURCHFMT4,3398,8h 45m,Sell
148329.68,1.43739,20.04.2016 14:59:58,sl 1.43739,0.0,-240.4899999999907,0.0,0.0,1.44039,20.04.2016 14:00:00,13020,-0.10080472340694954,-42.0,IS,0.14,0.0,Phase3-EA-B1v1-GBPUSD-M30-14,GBPUSDMT4,864,59m 58s,Buy
148293.89,124001,20.04.2016 19:29:58,sl 124.001,0.0,-276.27999999999884,0.0,0.0,123771,20.04.2016 19:00:00,13021,-0.11580659895576939,-35.79,IS,0.17,0.0,Phase3-EA-T1v2-EURJPY-M15-322,EURJPYMT4,2470,29m 58s,Sell
148330.17,109393,20.04.2016 19:30:00,,0.0,-240.0,0.0,0.0,109246,20.04.2016 19:00:00,13022,-0.10059933310187046,36.28,IS,0.27,0.0,Phase3-EA-S1v2-USDJPY-M15-0,USDJPYMT4,3728,30m 0s,Buy
148340.7,124133,20.04.2016 21:30:00,,0.0,-229.47000000000116,0.0,0.0,124065,20.04.2016 20:30:00,13023,-0.09618553736202638,10.53,IS,0.17,0.0,Phase3-EA-T1v2-EURJPY-M15-322,EURJPYMT4,2472,1h 0m,Buy
148306.14,0.97143,21.04.2016 03:15:00,,-9.48,-264.02999999999884,0.0,0.0,0.97101,20.04.2016 23:00:00,13024,-0.11067184132869474,-34.56,IS,0.58,0.0,Phase3-EA-SA2v2-USDCHF-M15-107,USDCHFMT4,2542,4h 15m,Sell
148219.62,1.09753,21.04.2016 04:25:00,,-6.32,-350.54999999998836,0.0,0.0,1.09563,20.04.2016 20:05:00,13025,-0.14693790091191467,-86.52,IS,0.41,0.0,Phase3-EA-SA2v2-EURCHF-M5-43,EURCHFMT4,6664,8h 20m,Sell
148186.45,123926,21.04.2016 05:15:00,,0.0,-383.72000000000116,0.0,0.0,124.14,21.04.2016 03:15:00,13026,-0.16084156707437436,-33.17,IS,0.17,0.0,Phase3-EA-T1v2-EURJPY-M15-322,EURJPYMT4,2474,2h 0m,Buy
148126.73,157121,21.04.2016 05:15:00,,-2.26,-443.4400000000023,0.0,0.0,157395,20.04.2016 23:50:00,13027,-0.1858740344612236,-59.72,IS,0.23,0.0,Phase3-EA-S4v1-GBPJPY-M5-194,GBPJPYMT4,2848,5h 25m,Buy
148109.21,1097,21.04.2016 14:15:00,,0.0,-460.95999999999185,0.0,0.0,1.0975,21.04.2016 05:30:00,13028,-0.19321778577765578,-17.52,IS,0.34,0.0,Phase3-EA-S4v1-EURCHF-M15-221,EURCHFMT4,3400,8h 45m,Buy
148259.64,157935,21.04.2016 15:59:58,tp 157.935,-1.19,-310.52999999999884,0.0,0.0,156085,19.04.2016 07:30:00,13029,-0.13016296211718215,150.43,IS,0.09,0.0,Phase3-EA-B1v1-GBPJPY-M30-1,GBPJPYMT4,1214,2d 8h 29m,Buy
148361.5,124717,21.04.2016 16:59:58,tp 124.717,-1.61,-208.6700000000128,0.0,0.0,123457,19.04.2016 09:30:00,13030,-0.08746692849320248,101.86,IS,0.09,0.0,Phase3-EA-TR1v1-EURJPY-M30-91,EURJPYMT4,2326,2d 7h 29m,Buy
148394.82,109401,21.04.2016 23:30:00,,0.0,-175.35000000000582,0.0,0.0,109536,21.04.2016 22:15:00,13031,-0.07350038774755654,33.32,IS,0.27,0.0,Phase3-EA-S1v2-USDJPY-M15-0,USDJPYMT4,3730,1h 15m,Sell
148357.17,0.97494,22.04.2016 02:30:00,,-3.15,-213.0,0.0,0.0,0.97436,21.04.2016 22:15:00,13032,-0.08928190812791002,-37.65,IS,0.58,0.0,Phase3-EA-SA2v2-USDCHF-M15-107,USDCHFMT4,2544,4h 15m,Sell
148293.6,1.10031,22.04.2016 05:20:00,,-2.1,-276.570000000007,0.0,0.0,1.09885,21.04.2016 21:00:00,13033,-0.1159281564832709,-63.57,IS,0.41,0.0,Phase3-EA-SA2v2-EURCHF-M5-43,EURCHFMT4,6666,8h 20m,Sell
148257.31,123847,22.04.2016 08:44:58,sl 123.847,-0.54,-312.86000000001513,0.0,0.0,123617,21.04.2016 18:45:00,13034,-0.13113961397605298,-36.29,IS,0.17,0.0,Phase3-EA-T1v2-EURJPY-M15-322,EURJPYMT4,2476,13h 59m,Sell
148324.2,111853,25.04.2016 01:00:00,,-0.7,-245.97000000000116,0.0,0.0,111573,22.04.2016 23:30:00,13035,-0.10310174151277997,66.89,IS,0.27,0.0,Phase3-EA-S1v2-USDJPY-M15-0,USDJPYMT4,3732,2d 1h 30m,Buy
148282.2,1.44284,25.04.2016 06:29:58,sl 1.44284,0.0,-287.97000000000116,0.0,0.0,1.44584,25.04.2016 01:30:00,13036,-0.1207066248056073,-42.0,IS,0.14,0.0,Phase3-EA-B1v1-GBPUSD-M30-14,GBPUSDMT4,866,4h 59m,Buy
148227.68,160269,25.04.2016 06:29:58,sl 160.269,-0.29,-342.4899999999907,0.0,0.0,160939,22.04.2016 22:00:00,13037,-0.14355943997524448,-54.52,IS,0.09,0.0,Phase3-EA-B1v1-GBPJPY-M30-1,GBPJPYMT4,1216,2d 8h 29m,Buy
148226.42,1.09833,25.04.2016 09:25:00,,0.0,-343.75,0.0,0.0,1.09836,25.04.2016 01:05:00,13038,-0.14408758647403322,-1.26,IS,0.41,0.0,Phase3-EA-SA2v2-EURCHF-M5-43,EURCHFMT4,6668,8h 20m,Buy
148224.68,1.09813,25.04.2016 10:00:00,,0.0,-345.4899999999907,0.0,0.0,1.09818,25.04.2016 01:15:00,13039,-0.14481693163901785,-1.74,IS,0.34,0.0,Phase3-EA-S4v1-EURCHF-M15-221,EURCHFMT4,3402,8h 45m,Buy
148189.49,124939,25.04.2016 16:14:58,sl 124.939,0.0,-380.679999999993,0.0,0.0,125169,25.04.2016 12:00:00,13040,-0.15956730885508058,-35.19,IS,0.17,0.0,Phase3-EA-T1v2-EURJPY-M15-322,EURJPYMT4,2478,4h 14m,Buy
148154.32,125156,25.04.2016 17:29:58,sl 125.156,0.0,-415.8500000000058,0.0,0.0,124926,25.04.2016 16:15:00,13041,-0.17430930279338921,-35.17,IS,0.17,0.0,Phase3-EA-T1v2-EURJPY-M15-322,EURJPYMT4,2480,1h 14m,Sell
148151.8,1.09853,26.04.2016 04:45:00,,-2.1,-418.36999999999534,0.0,0.0,1.09852,25.04.2016 20:25:00,13042,-0.17536559579095448,-2.52,IS,0.41,0.0,Phase3-EA-SA2v2-EURCHF-M5-43,EURCHFMT4,6670,8h 20m,Sell
148092.49,124689,26.04.2016 11:29:57,sl 124.689,-0.8,-477.679999999993,0.0,0.0,124278,22.04.2016 09:00:00,13043,-0.20022620598375324,-59.31,IS,0.09,0.0,Phase3-EA-TR1v1-EURJPY-M30-91,EURJPYMT4,2328,4d 2h 29m,Buy
148196.4,125568,26.04.2016 16:59:58,tp 125.568,-0.8,-373.7699999999895,0.0,0.0,125409,22.04.2016 22:30:00,13044,-0.15667088638952112,103.91,IS,0.09,0.0,Phase3-EA-TR1v1-EURJPY-M30-91,EURJPYMT4,2329,3d 18h 29m,Buy
148252.85,0.97314,27.04.2016 01:14:57,tp 0.97314,-3.15,-317.3199999999779,0.0,0.0,0.97414,26.04.2016 22:30:00,13045,-0.13300908491618044,56.45,IS,0.58,0.0,Phase3-EA-SA2v2-USDCHF-M15-107,USDCHFMT4,2546,2h 44m,Sell
148219.47,0.97291,27.04.2016 05:30:00,,0.0,-350.69999999998254,0.0,0.0,0.97347,27.04.2016 01:15:00,13046,-0.14700077549510088,-33.38,IS,0.58,0.0,Phase3-EA-SA2v2-USDCHF-M15-107,USDCHFMT4,2548,4h 15m,Buy
148255.53,1.10011,27.04.2016 05:55:00,,-1.01,-314.63999999998487,0.0,0.0,1.09923,26.04.2016 21:35:00,13047,-0.13188572569654583,36.06,IS,0.41,0.0,Phase3-EA-SA2v2-EURCHF-M5-43,EURCHFMT4,6672,8h 20m,Buy
148222.27,111212,27.04.2016 10:00:00,,0.0,-347.8999999999942,0.0,0.0,111349,27.04.2016 00:45:00,13048,-0.14582711660891728,-33.26,IS,0.27,0.0,Phase3-EA-S1v2-USDJPY-M15-0,USDJPYMT4,3734,9h 15m,Buy
148179.74,1.44767,27.04.2016 22:29:57,sl 1.44767,-0.53,-390.429999999993,0.0,0.0,1.45067,26.04.2016 05:30:00,13049,-0.16365415676234407,-42.53,IS,0.14,0.0,Phase3-EA-B1v1-GBPUSD-M30-14,GBPUSDMT4,868,1d 16h 59m,Buy
148142.5,125656,28.04.2016 07:14:58,sl 125.656,-2.24,-427.6699999999837,0.0,0.0,125886,27.04.2016 11:00:00,13050,-0.17926381994864707,-37.24,IS,0.17,0.0,Phase3-EA-T1v2-EURJPY-M15-322,EURJPYMT4,2482,20h 14m,Buy
148082.9,125157,28.04.2016 07:29:58,sl 125.157,-1.59,-487.2699999999895,0.0,0.0,125877,26.04.2016 20:00:00,13051,-0.20424598766894736,-59.6,IS,0.09,0.0,Phase3-EA-TR1v1-EURJPY-M30-91,EURJPYMT4,2332,1d 11h 29m,Buy
148128.54,1.09769,29.04.2016 00:04:58,tp 1.09769,-1.02,-441.62999999997555,0.0,0.0,1.09659,28.04.2016 20:50:00,13052,-0.18511534782406913,45.64,IS,0.41,0.0,Phase3-EA-SA2v2-EURCHF-M5-43,EURCHFMT4,6674,3h 14m,Buy
148063.24,121998,29.04.2016 05:59:58,sl 121.998,0.0,-506.9299999999639,0.0,0.0,122778,29.04.2016 03:00:00,13053,-0.2124867497055315,-65.3,IS,0.09,0.0,Phase3-EA-TR1v1-EURJPY-M30-91,EURJPYMT4,2334,2h 59m,Buy
148026.61,122.22,29.04.2016 22:29:58,sl 122.220,0.0,-543.5599999999686,0.0,0.0,121.99,29.04.2016 21:45:00,13054,-0.22784072292020643,-36.63,IS,0.17,0.0,Phase3-EA-T1v2-EURJPY-M15-322,EURJPYMT4,2484,44m 58s,Sell
147989.85,122211,02.05.2016 12:14:58,sl 122.211,0.0,-580.3199999999779,0.0,0.0,121981,02.05.2016 11:15:00,13055,-0.24324918744031349,-36.76,IS,0.17,0.0,Phase3-EA-T1v2-EURJPY-M15-322,EURJPYMT4,2486,59m 58s,Sell
147966.06,1.09994,02.05.2016 14:00:00,,0.0,-604.109999999986,0.0,0.0,1.09927,02.05.2016 05:15:00,13056,-0.25322109633403983,-23.79,IS,0.34,0.0,Phase3-EA-S4v1-EURCHF-M15-221,EURCHFMT4,3404,8h 45m,Sell
147950.86,0.95425,03.05.2016 05:30:00,,0.0,-619.3099999999977,0.0,0.0,0.9545,03.05.2016 01:15:00,13057,-0.2595923874304965,-15.2,IS,0.58,0.0,Phase3-EA-SA2v2-USDCHF-M15-107,USDCHFMT4,2550,4h 15m,Buy
147954.73,1.10035,03.05.2016 08:25:00,,0.0,-615.4400000000023,0.0,0.0,1.10044,03.05.2016 00:05:00,13058,-0.2579702231842308,3.87,IS,0.41,0.0,Phase3-EA-SA2v2-EURCHF-M5-43,EURCHFMT4,6676,8h 20m,Sell
147917.93,122555,03.05.2016 20:59:58,sl 122.555,0.0,-652.2399999999907,0.0,0.0,122325,03.05.2016 18:15:00,13059,-0.273395454259846,-36.8,IS,0.17,0.0,Phase3-EA-T1v2-EURJPY-M15-322,EURJPYMT4,2488,2h 44m,Sell
147963.06,1.09691,04.05.2016 01:04:57,tp 1.09691,-2.15,-607.109999999986,0.0,0.0,1.09801,03.05.2016 23:45:00,13060,-0.2544785879978132,45.13,IS,0.41,0.0,Phase3-EA-SA2v2-EURCHF-M5-43,EURCHFMT4,6678,1h 19m,Sell
148020.68,0.95331,04.05.2016 01:14:57,tp 0.95331,-3.22,-549.4899999999907,0.0,0.0,0.95431,03.05.2016 23:45:00,13061,-0.23032636477560775,57.62,IS,0.58,0.0,Phase3-EA-SA2v2-USDCHF-M15-107,USDCHFMT4,2552,1h 29m,Sell
147848.35,155676,04.05.2016 01:39:58,sl 155.676,0.0,-721.8199999999779,0.0,0.0,154876,04.05.2016 01:00:00,13062,-0.3025608775816246,-172.33,IS,0.23,0.0,Phase3-EA-S4v1-GBPJPY-M5-194,GBPJPYMT4,2850,39m 58s,Sell
147955.17,123323,04.05.2016 01:59:58,tp 123.323,-1.23,-614.9999999999709,0.0,0.0,122033,29.04.2016 15:30:00,13063,-0.25778579107353083,106.82,IS,0.09,0.0,Phase3-EA-TR1v1-EURJPY-M30-91,EURJPYMT4,2336,4d 10h 29m,Buy
148039.18,155186,04.05.2016 02:29:57,tp 155.186,0.0,-530.9899999999616,0.0,0.0,155576,04.05.2016 01:45:00,13064,-0.22257183284899304,84.01,IS,0.23,0.0,Phase3-EA-S4v1-GBPJPY-M5-194,GBPJPYMT4,2852,44m 57s,Sell
147926.99,0.95643,04.05.2016 06:15:00,,0.0,-643.1799999999639,0.0,0.0,0.95458,04.05.2016 02:00:00,13065,-0.2695978294352392,-112.19,IS,0.58,0.0,Phase3-EA-SA2v2-USDCHF-M15-107,USDCHFMT4,2554,4h 15m,Sell
147923.43,1.09828,04.05.2016 15:30:00,,0.0,-646.7399999999616,0.0,0.0,1.09818,04.05.2016 06:45:00,13066,-0.2710900528762493,-3.56,IS,0.34,0.0,Phase3-EA-S4v1-EURCHF-M15-221,EURCHFMT4,3406,8h 45m,Sell
147952.76,107054,05.05.2016 04:15:00,,-2.2,-617.4099999999744,0.0,0.0,106929,04.05.2016 22:45:00,13067,-0.25879597604343024,29.33,IS,0.27,0.0,Phase3-EA-S1v2-USDJPY-M15-0,USDJPYMT4,3736,5h 30m,Buy
147957.0,0.95731,05.05.2016 05:30:00,,0.0,-613.1699999999837,0.0,0.0,0.95738,05.05.2016 01:15:00,13068,-0.25701872115863444,4.24,IS,0.58,0.0,Phase3-EA-SA2v2-USDCHF-M15-107,USDCHFMT4,2556,4h 15m,Sell
147911.63,1.10081,05.05.2016 09:50:00,,0.0,-658.539999999979,0.0,0.0,1.09975,05.05.2016 01:30:00,13069,-0.27603618675376523,-45.37,IS,0.41,0.0,Phase3-EA-SA2v2-EURCHF-M5-43,EURCHFMT4,6680,8h 20m,Sell
147875.13,122842,05.05.2016 11:59:58,sl 122.842,0.0,-695.039999999979,0.0,0.0,123072,05.05.2016 05:00:00,13070,-0.2913356686630081,-36.5,IS,0.17,0.0,Phase3-EA-T1v2-EURJPY-M15-322,EURJPYMT4,2490,6h 59m,Buy
147849.68,1.10063,05.05.2016 13:45:00,,0.0,-720.4899999999907,0.0,0.0,1.09991,05.05.2016 05:00:00,13071,-0.30200338961069045,-25.45,IS,0.34,0.0,Phase3-EA-S4v1-EURCHF-M15-221,EURCHFMT4,3408,8h 45m,Sell
147894.17,1.10346,06.05.2016 01:00:00,tp 1.10346,-2.12,-676.0,0.0,0.0,1.10456,05.05.2016 20:40:00,13072,-0.2833547882369351,44.49,IS,0.41,0.0,Phase3-EA-SA2v2-EURCHF-M5-43,EURCHFMT4,6682,4h 20m,Sell
147906.02,107305,06.05.2016 02:30:00,,-0.73,-664.1499999999942,0.0,0.0,107255,05.05.2016 23:15:00,13073,-0.27838769616502784,11.85,IS,0.27,0.0,Phase3-EA-S1v2-USDJPY-M15-0,USDJPYMT4,3738,3h 15m,Buy
147939.56,0.96831,06.05.2016 05:30:00,,0.0,-630.609999999986,0.0,0.0,0.96775,06.05.2016 01:15:00,13074,-0.264328939364038,33.54,IS,0.58,0.0,Phase3-EA-SA2v2-USDCHF-M15-107,USDCHFMT4,2558,4h 15m,Buy
148023.34,155024,06.05.2016 05:54:57,tp 155.024,0.0,-546.8299999999872,0.0,0.0,155414,06.05.2016 02:20:00,13075,-0.22921138883372721,83.78,IS,0.23,0.0,Phase3-EA-S4v1-GBPJPY-M5-194,GBPJPYMT4,2854,3h 34m,Sell
148048.65,1.10429,06.05.2016 13:15:00,,0.0,-521.5199999999895,0.0,0.0,1.10357,06.05.2016 04:30:00,13076,-0.21860235083036011,25.31,IS,0.34,0.0,Phase3-EA-S4v1-EURCHF-M15-221,EURCHFMT4,3410,8h 45m,Buy
148092.96,1.10703,09.05.2016 01:04:57,tp 1.10703,-2.11,-477.20999999999185,0.0,0.0,1.10813,06.05.2016 23:20:00,13077,-0.20002919895642826,44.31,IS,0.41,0.0,Phase3-EA-SA2v2-EURCHF-M5-43,EURCHFMT4,6684,2d 1h 44m,Sell
148061.76,0.97235,09.05.2016 02:45:00,,-3.16,-508.4100000000035,0.0,0.0,0.97188,06.05.2016 22:30:00,13078,-0.2131071122596763,-31.2,IS,0.58,0.0,Phase3-EA-SA2v2-USDCHF-M15-107,USDCHFMT4,2560,2d 4h 15m,Sell
147963.1,154891,09.05.2016 04:25:00,,-1.25,-607.070000000007,0.0,0.0,154436,06.05.2016 23:00:00,13079,-0.254461821442305,-98.66,IS,0.23,0.0,Phase3-EA-S4v1-GBPJPY-M5-194,GBPJPYMT4,2856,2d 5h 25m,Sell
147753.65,107577,09.05.2016 04:29:58,sl 107.577,-1.13,-816.5200000000186,0.0,0.0,106747,06.05.2016 21:30:00,13080,-0.34225569776808806,-209.45,IS,0.27,0.0,Phase3-EA-S1v2-USDJPY-M15-0,USDJPYMT4,3740,2d 6h 59m,Sell
147716.66,122551,09.05.2016 08:59:58,sl 122.551,-0.56,-853.5100000000093,0.0,0.0,122321,06.05.2016 03:30:00,13081,-0.35776056998240996,-36.99,IS,0.17,0.0,Phase3-EA-T1v2-EURJPY-M15-322,EURJPYMT4,2492,3d 5h 29m,Sell
147707.92,1108,09.05.2016 09:45:00,,0.0,-862.25,0.0,0.0,1.10775,09.05.2016 01:00:00,13082,-0.36142406236286584,-8.74,IS,0.34,0.0,Phase3-EA-S4v1-EURCHF-M15-221,EURCHFMT4,3412,8h 45m,Sell
147647.07,122856,09.05.2016 10:59:58,sl 122.856,-0.58,-923.1000000000058,0.0,0.0,122136,05.05.2016 17:00:00,13083,-0.3869301849430717,-60.85,IS,0.09,0.0,Phase3-EA-TR1v1-EURJPY-M30-91,EURJPYMT4,2338,3d 17h 59m,Sell
147624.19,0.97132,10.05.2016 02:15:00,,-3.17,-945.9800000000105,0.0,0.0,0.97099,09.05.2016 22:00:00,13084,-0.3965206546987853,-22.88,IS,0.58,0.0,Phase3-EA-SA2v2-USDCHF-M15-107,USDCHFMT4,2562,4h 15m,Sell
147599.09,1.10509,10.05.2016 05:25:00,,-1.01,-971.0800000000163,0.0,0.0,1.10566,09.05.2016 21:05:00,13085,-0.40704166828569166,-25.1,IS,0.41,0.0,Phase3-EA-SA2v2-EURCHF-M5-43,EURCHFMT4,6686,8h 20m,Buy
147702.61,124287,10.05.2016 13:59:58,tp 124.287,-0.41,-867.5600000000268,0.0,0.0,123027,09.05.2016 14:00:00,13086,-0.36364982260775597,103.52,IS,0.09,0.0,Phase3-EA-TR1v1-EURJPY-M30-91,EURJPYMT4,2340,23h 59m,Buy
147817.76,1.10844,10.05.2016 14:30:00,,0.0,-752.4100000000326,0.0,0.0,1.10514,10.05.2016 05:45:00,13087,-0.3153831009132568,115.15,IS,0.34,0.0,Phase3-EA-S4v1-EURCHF-M15-221,EURCHFMT4,3414,8h 45m,Buy
147851.13,109217,10.05.2016 20:00:00,,0.0,-719.0400000000373,0.0,0.0,109082,10.05.2016 17:15:00,13088,-0.3013956019732195,33.37,IS,0.27,0.0,Phase3-EA-S1v2-USDJPY-M15-0,USDJPYMT4,3742,2h 45m,Buy
147874.59,109348,11.05.2016 01:45:00,,0.0,-695.5800000000454,0.0,0.0,109253,11.05.2016 01:15:00,13089,-0.29156201716251506,23.46,IS,0.27,0.0,Phase3-EA-S1v2-USDJPY-M15-0,USDJPYMT4,3744,30m 0s,Buy
147819.35,157258,11.05.2016 05:59:58,sl 157.258,0.0,-750.8200000000361,0.0,0.0,157928,11.05.2016 02:00:00,13090,-0.31471663033145836,-55.24,IS,0.09,0.0,Phase3-EA-B1v1-GBPJPY-M30-1,GBPJPYMT4,1218,3h 59m,Buy
147805.71,1.10883,11.05.2016 07:15:00,,-1.01,-764.4600000000501,0.0,0.0,1.10913,10.05.2016 22:55:00,13091,-0.32043402576275387,-13.64,IS,0.41,0.0,Phase3-EA-SA2v2-EURCHF-M5-43,EURCHFMT4,6688,8h 20m,Buy
147779.52,1.10857,11.05.2016 12:30:00,,0.0,-790.6500000000524,0.0,0.0,1.10932,11.05.2016 03:45:00,13092,-0.33141192798749647,-26.19,IS,0.34,0.0,Phase3-EA-S4v1-EURCHF-M15-221,EURCHFMT4,3416,8h 45m,Buy
147778.65,108383,12.05.2016 01:15:00,,-3.36,-791.5200000000477,0.0,0.0,108393,11.05.2016 23:45:00,13093,-0.33177660056998876,-0.87,IS,0.27,0.0,Phase3-EA-S1v2-USDJPY-M15-0,USDJPYMT4,3746,1h 30m,Sell
147757.03,1.10891,12.05.2016 06:50:00,,-3.04,-813.1400000000431,0.0,0.0,1.10935,11.05.2016 22:30:00,13094,-0.34083892382691366,-21.62,IS,0.41,0.0,Phase3-EA-SA2v2-EURCHF-M5-43,EURCHFMT4,6690,8h 20m,Buy
147697.55,124578,12.05.2016 13:59:58,sl 124.578,0.0,-872.6200000000536,0.0,0.0,124012,10.05.2016 15:30:00,13095,-0.3657707918806649,-59.48,IS,0.09,0.0,Phase3-EA-TR1v1-EURJPY-M30-91,EURJPYMT4,2342,1d 22h 29m,Sell
147642.04,157.4,12.05.2016 19:29:58,sl 157.400,0.0,-928.1300000000629,0.0,0.0,158.07,12.05.2016 17:00:00,13096,-0.38903857929935565,-55.51,IS,0.09,0.0,Phase3-EA-B1v1-GBPJPY-M30-1,GBPJPYMT4,1220,2h 29m,Buy
147686.4,1.10265,13.05.2016 01:00:00,tp 1.10265,-2.11,-883.7700000000768,0.0,0.0,1.10375,12.05.2016 22:45:00,13097,-0.3704444692310324,44.36,IS,0.41,0.0,Phase3-EA-SA2v2-EURCHF-M5-43,EURCHFMT4,6692,2h 15m,Sell
147710.82,108942,13.05.2016 03:00:00,,-1.11,-859.350000000064,0.0,0.0,109045,12.05.2016 22:00:00,13098,-0.36020848708791176,24.42,IS,0.27,0.0,Phase3-EA-S1v2-USDJPY-M15-0,USDJPYMT4,3748,5h 0m,Sell
147823.65,1.10147,13.05.2016 13:15:00,,0.0,-746.5200000000768,0.0,0.0,1.10469,13.05.2016 04:30:00,13099,-0.31291422561340027,112.83,IS,0.34,0.0,Phase3-EA-S4v1-EURCHF-M15-221,EURCHFMT4,3418,8h 45m,Sell
147867.8,1.10181,16.05.2016 01:00:00,tp 1.10181,-2.1,-702.3700000000827,0.0,0.0,1.10291,13.05.2016 22:35:00,13100,-0.2944081399615378,44.15,IS,0.41,0.0,Phase3-EA-SA2v2-EURCHF-M5-43,EURCHFMT4,6694,2d 2h 25m,Sell
147914.04,1.10321,16.05.2016 02:04:57,tp 1.10321,0.0,-656.130000000092,0.0,0.0,1.10211,16.05.2016 01:05:00,13101,-0.2750260017839146,46.24,IS,0.41,0.0,Phase3-EA-SA2v2-EURCHF-M5-43,EURCHFMT4,6696,59m 57s,Buy
148019.15,122722,16.05.2016 02:29:58,tp 122.722,-1.74,-551.0200000001059,0.0,0.0,123858,12.05.2016 04:00:00,13102,-0.23096768552418048,105.11,IS,0.09,0.0,Phase3-EA-TR1v1-EURJPY-M30-91,EURJPYMT4,2343,3d 22h 29m,Sell
147929.47,108661,16.05.2016 04:00:00,,-0.72,-640.700000000099,0.0,0.0,109019,13.05.2016 20:15:00,13103,-0.2685583029932431,-89.68,IS,0.27,0.0,Phase3-EA-S1v2-USDJPY-M15-0,USDJPYMT4,3750,2d 7h 45m,Buy
148011.91,156213,16.05.2016 05:39:58,tp 156.213,0.0,-558.2600000000966,0.0,0.0,155823,16.05.2016 01:05:00,13104,-0.23400243207274968,82.44,IS,0.23,0.0,Phase3-EA-S4v1-GBPJPY-M5-194,GBPJPYMT4,2858,4h 34m,Buy
147977.07,1.10478,16.05.2016 13:00:00,,0.0,-593.1000000000931,0.0,0.0,1.10378,16.05.2016 04:15:00,13105,-0.2486061019280364,-34.84,IS,0.34,0.0,Phase3-EA-S4v1-EURCHF-M15-221,EURCHFMT4,3420,8h 45m,Sell
148058.57,157217,17.05.2016 03:09:58,tp 157.217,-0.76,-511.60000000009313,0.0,0.0,156827,16.05.2016 23:00:00,13106,-0.2144442450621929,81.5,IS,0.23,0.0,Phase3-EA-S4v1-GBPJPY-M5-194,GBPJPYMT4,2860,4h 9m,Buy
148051.44,1.10693,17.05.2016 04:25:00,,-2.1,-518.7300000000978,0.0,0.0,1.10681,16.05.2016 20:05:00,13107,-0.21743288358309626,-7.13,IS,0.41,0.0,Phase3-EA-SA2v2-EURCHF-M5-43,EURCHFMT4,6698,8h 20m,Sell
148026.96,157722,17.05.2016 09:05:00,,0.0,-543.2100000001083,0.0,0.0,157606,17.05.2016 03:40:00,13108,-0.22769401555949143,-24.48,IS,0.23,0.0,Phase3-EA-S4v1-GBPJPY-M5-194,GBPJPYMT4,2862,5h 25m,Sell
147989.98,123.56,17.05.2016 09:59:58,sl 123.560,-1.1,-580.1900000001187,0.0,0.0,123.33,13.05.2016 18:15:00,13109,-0.24319469613494235,-36.98,IS,0.17,0.0,Phase3-EA-T1v2-EURJPY-M15-322,EURJPYMT4,2494,3d 15h 44m,Sell
148004.33,123602,17.05.2016 18:45:00,,0.0,-565.8400000001129,0.0,0.0,123.51,17.05.2016 10:00:00,13110,-0.23717969434322392,14.35,IS,0.17,0.0,Phase3-EA-T1v2-EURJPY-M15-322,EURJPYMT4,2496,8h 45m,Buy
147949.13,0.98043,18.05.2016 02:30:00,,-3.14,-621.0400000001246,0.0,0.0,0.97955,17.05.2016 22:15:00,13111,-0.260317540956659,-55.2,IS,0.58,0.0,Phase3-EA-SA2v2-USDCHF-M15-107,USDCHFMT4,2564,4h 15m,Sell
147972.54,109015,18.05.2016 04:00:00,,-1.11,-597.6300000001211,0.0,0.0,109114,17.05.2016 22:00:00,13112,-0.25050491434034594,23.41,IS,0.27,0.0,Phase3-EA-S1v2-USDJPY-M15-0,USDJPYMT4,3752,6h 0m,Sell
147893.11,1.10893,18.05.2016 05:35:00,,-2.09,-677.0600000001141,0.0,0.0,1.10708,17.05.2016 21:15:00,13113,-0.28379910195818286,-79.43,IS,0.41,0.0,Phase3-EA-SA2v2-EURCHF-M5-43,EURCHFMT4,6700,8h 20m,Sell
147824.28,1.10915,18.05.2016 09:45:00,,0.0,-745.8900000001013,0.0,0.0,1.10716,18.05.2016 01:00:00,13114,-0.3126501523640181,-68.83,IS,0.34,0.0,Phase3-EA-S4v1-EURCHF-M15-221,EURCHFMT4,3422,8h 45m,Sell
147976.18,159378,18.05.2016 17:29:58,tp 159.378,-0.3,-593.9900000001071,0.0,0.0,157528,17.05.2016 05:30:00,13115,-0.24897915778829502,151.9,IS,0.09,0.0,Phase3-EA-B1v1-GBPJPY-M30-1,GBPJPYMT4,1222,1d 11h 59m,Buy
148007.73,109548,18.05.2016 17:30:00,,0.0,-562.4400000001187,0.0,0.0,109.42,18.05.2016 17:00:00,13116,-0.23575453712428318,31.55,IS,0.27,0.0,Phase3-EA-S1v2-USDJPY-M15-0,USDJPYMT4,3754,30m 0s,Buy
148053.69,1.10696,18.05.2016 22:04:57,tp 1.10696,0.0,-516.4800000001269,0.0,0.0,1.10806,18.05.2016 20:30:00,13117,-0.2164897648352784,45.96,IS,0.41,0.0,Phase3-EA-SA2v2-EURCHF-M5-43,EURCHFMT4,6702,1h 34m,Sell
148112.74,0.9823,18.05.2016 22:14:57,tp 0.98230,0.0,-457.43000000013853,0.0,0.0,0.9813,18.05.2016 22:00:00,13118,-0.1917381372533439,59.05,IS,0.58,0.0,Phase3-EA-SA2v2-USDCHF-M15-107,USDCHFMT4,2566,14m 57s,Buy
148210.94,109976,18.05.2016 22:14:57,tp 109.976,0.0,-359.2300000001269,0.0,0.0,109576,18.05.2016 22:00:00,13119,-0.15057624345915704,98.2,IS,0.27,0.0,Phase3-EA-S1v2-USDJPY-M15-0,USDJPYMT4,3756,14m 57s,Buy
148172.83,109818,18.05.2016 22:30:00,,0.0,-397.3400000001129,0.0,0.0,109973,18.05.2016 22:15:00,13120,-0.16655057922795236,-38.11,IS,0.27,0.0,Phase3-EA-S1v2-USDJPY-M15-0,USDJPYMT4,3758,15m 0s,Buy
148218.49,1.10708,19.05.2016 01:00:00,tp 1.10708,0.0,-351.68000000010943,0.0,0.0,1.10818,19.05.2016 00:30:00,13121,-0.14741155610532006,45.66,IS,0.41,0.0,Phase3-EA-SA2v2-EURCHF-M5-43,EURCHFMT4,6704,30m 0s,Sell
148153.97,0.98798,19.05.2016 04:00:00,,-9.34,-416.20000000009895,0.0,0.0,0.98704,18.05.2016 23:45:00,13122,-0.17445601015420184,-64.52,IS,0.58,0.0,Phase3-EA-SA2v2-USDCHF-M15-107,USDCHFMT4,2568,4h 15m,Sell
148199.63,1.10755,19.05.2016 10:14:57,tp 1.10755,0.0,-370.54000000009546,0.0,0.0,1.10865,19.05.2016 02:35:00,13123,-0.15531698703156951,45.66,IS,0.41,0.0,Phase3-EA-SA2v2-EURCHF-M5-43,EURCHFMT4,6706,7h 39m,Sell
148164.17,123479,19.05.2016 11:14:58,sl 123.479,0.0,-406.0000000000873,0.0,0.0,123709,19.05.2016 10:15:00,13124,-0.17018053849736745,-35.46,IS,0.17,0.0,Phase3-EA-T1v2-EURJPY-M15-322,EURJPYMT4,2498,59m 58s,Buy
148193.43,1.10758,19.05.2016 11:30:00,,0.0,-376.740000000078,0.0,0.0,1.10843,19.05.2016 02:45:00,13125,-0.15791580313669384,29.26,IS,0.34,0.0,Phase3-EA-S4v1-EURCHF-M15-221,EURCHFMT4,3424,8h 45m,Sell
148291.81,109783,19.05.2016 17:59:58,tp 109.783,0.0,-278.36000000007334,0.0,0.0,110183,19.05.2016 17:00:00,13126,-0.11667845984268349,98.38,IS,0.27,0.0,Phase3-EA-S1v2-USDJPY-M15-0,USDJPYMT4,3760,59m 58s,Sell
148337.34,1.10866,20.05.2016 01:00:00,tp 1.10866,0.0,-232.8300000000745,0.0,0.0,1.10976,20.05.2016 00:10:00,13127,-0.0975939280254833,45.53,IS,0.41,0.0,Phase3-EA-SA2v2-EURCHF-M5-43,EURCHFMT4,6708,50m 0s,Sell
148338.7,109915,20.05.2016 04:00:00,,-1.1,-231.47000000008848,0.0,0.0,109925,19.05.2016 23:30:00,13128,-0.09702386513791189,1.36,IS,0.27,0.0,Phase3-EA-S1v2-USDJPY-M15-0,USDJPYMT4,3762,4h 30m,Sell
148324.66,0.99117,20.05.2016 04:30:00,,0.0,-245.51000000009662,0.0,0.0,0.99093,20.05.2016 00:15:00,13129,-0.10290892612437473,-14.04,IS,0.58,0.0,Phase3-EA-SA2v2-USDCHF-M15-107,USDCHFMT4,2570,4h 15m,Sell
148322.57,160531,20.05.2016 05:30:00,,0.0,-247.60000000009313,0.0,0.0,160541,20.05.2016 00:05:00,13130,-0.10378497865013539,-2.09,IS,0.23,0.0,Phase3-EA-S4v1-GBPJPY-M5-194,GBPJPYMT4,2864,5h 25m,Buy
148207.35,1.11085,20.05.2016 09:45:00,,0.0,-362.8200000000943,0.0,0.0,1.10749,20.05.2016 01:00:00,13131,-0.1520810418167922,-115.22,IS,0.34,0.0,Phase3-EA-S4v1-EURCHF-M15-221,EURCHFMT4,3426,8h 45m,Sell
148151.46,159847,20.05.2016 22:29:58,sl 159.847,-1.17,-418.71000000010827,0.0,0.0,160517,18.05.2016 23:00:00,13132,-0.17550811151289614,-55.89,IS,0.09,0.0,Phase3-EA-B1v1-GBPJPY-M30-1,GBPJPYMT4,1224,1d 23h 29m,Buy
148095.78,0.98961,23.05.2016 05:30:00,,0.0,-474.3900000001013,0.0,0.0,0.99056,23.05.2016 01:15:00,13133,-0.19884715679252715,-55.68,IS,0.58,0.0,Phase3-EA-SA2v2-USDCHF-M15-107,USDCHFMT4,2572,4h 15m,Buy
148110.11,1.1117,23.05.2016 05:45:00,,-0.99,-460.0600000001141,0.0,0.0,1.11133,20.05.2016 21:25:00,13134,-0.192840538278575,14.33,IS,0.41,0.0,Phase3-EA-SA2v2-EURCHF-M5-43,EURCHFMT4,6710,2d 8h 20m,Buy
148143.39,1.11103,23.05.2016 13:00:00,,0.0,-426.78000000011525,0.0,0.0,1112,23.05.2016 04:15:00,13135,-0.17889076408844945,33.28,IS,0.34,0.0,Phase3-EA-S4v1-EURCHF-M15-221,EURCHFMT4,3428,8h 45m,Sell
148081.44,122657,23.05.2016 13:59:58,sl 122.657,-2.8,-488.7300000001269,0.0,0.0,122.97,16.05.2016 04:00:00,13136,-0.20485796694537464,-61.95,IS,0.09,0.0,Phase3-EA-TR1v1-EURJPY-M30-91,EURJPYMT4,2346,7d 9h 59m,Buy
148112.54,109374,23.05.2016 18:15:00,,0.0,-457.6300000001211,0.0,0.0,109.5,23.05.2016 17:15:00,13137,-0.1918219700309215,31.1,IS,0.27,0.0,Phase3-EA-S1v2-USDJPY-M15-0,USDJPYMT4,3764,1h 0m,Sell
148117.47,109423,23.05.2016 19:45:00,,0.0,-452.70000000012806,0.0,0.0,109443,23.05.2016 19:30:00,13138,-0.18975549206345682,4.93,IS,0.27,0.0,Phase3-EA-S1v2-USDJPY-M15-0,USDJPYMT4,3766,15m 0s,Sell
148072.81,1445,23.05.2016 19:59:58,sl 1.44500,-2.66,-497.36000000013155,0.0,0.0,1448,18.05.2016 15:00:00,13139,-0.2084753512981647,-44.66,IS,0.14,0.0,Phase3-EA-B1v1-GBPUSD-M30-14,GBPUSDMT4,870,5d 4h 59m,Buy
148077.5,109402,23.05.2016 20:45:00,,0.0,-492.6700000001292,0.0,0.0,109421,23.05.2016 19:45:00,13140,-0.206509472663798,4.69,IS,0.27,0.0,Phase3-EA-S1v2-USDJPY-M15-0,USDJPYMT4,3768,1h 0m,Sell
148123.06,1.11072,23.05.2016 21:44:58,tp 1.11072,0.0,-447.11000000013155,0.0,0.0,1.10962,23.05.2016 21:00:00,13141,-0.18741236592996055,45.56,IS,0.41,0.0,Phase3-EA-SA2v2-EURCHF-M5-43,EURCHFMT4,6712,44m 58s,Buy
148168.57,1.11098,24.05.2016 07:39:57,tp 1.11098,0.0,-401.60000000012224,0.0,0.0,1.10988,24.05.2016 00:05:00,13142,-0.16833621739051446,45.51,IS,0.41,0.0,Phase3-EA-SA2v2-EURCHF-M5-43,EURCHFMT4,6714,7h 34m,Buy
148139.46,1.10894,24.05.2016 12:30:00,,0.0,-430.71000000010827,0.0,0.0,1.10979,24.05.2016 03:45:00,13143,-0.18053807816798964,-29.11,IS,0.34,0.0,Phase3-EA-S4v1-EURCHF-M15-221,EURCHFMT4,3430,8h 45m,Buy
147936.16,1.10175,25.05.2016 01:00:00,sl 1.10175,-0.99,-634.0100000000966,0.0,0.0,1.10665,24.05.2016 20:30:00,13144,-0.2657540965830275,-203.3,IS,0.41,0.0,Phase3-EA-SA2v2-EURCHF-M5-43,EURCHFMT4,6716,4h 30m,Buy
147960.2,110079,25.05.2016 03:15:00,,0.0,-609.9700000000885,0.0,0.0,109981,25.05.2016 00:15:00,13145,-0.2556773967173201,24.04,IS,0.27,0.0,Phase3-EA-S1v2-USDJPY-M15-0,USDJPYMT4,3770,3h 0m,Buy
147984.59,1.10578,25.05.2016 09:40:00,,0.0,-585.5800000000745,0.0,0.0,1.10637,25.05.2016 01:20:00,13146,-0.24545398949083666,24.39,IS,0.41,0.0,Phase3-EA-SA2v2-EURCHF-M5-43,EURCHFMT4,6718,8h 20m,Sell
147975.01,122584,25.05.2016 11:30:00,,0.0,-595.1600000000617,0.0,0.0,122646,25.05.2016 03:45:00,13147,-0.24946957953714763,-9.58,IS,0.17,0.0,Phase3-EA-T1v2-EURJPY-M15-322,EURJPYMT4,2500,7h 45m,Buy
147968.5,1.10582,25.05.2016 13:00:00,,0.0,-601.670000000071,0.0,0.0,1.10601,25.05.2016 04:15:00,13148,-0.25219833644753975,-6.51,IS,0.34,0.0,Phase3-EA-S4v1-EURCHF-M15-221,EURCHFMT4,3432,8h 45m,Buy
148007.8,1.10448,26.05.2016 01:00:00,tp 1.10448,-6.2,-562.3700000000827,0.0,0.0,1.10558,25.05.2016 20:20:00,13149,-0.23572519565211333,39.3,IS,0.41,0.0,Phase3-EA-SA2v2-EURCHF-M5-43,EURCHFMT4,6720,4h 40m,Sell
148009.03,110131,26.05.2016 04:00:00,,0.0,-561.1400000000722,0.0,0.0,110136,26.05.2016 01:00:00,13150,-0.23520962406996188,1.23,IS,0.27,0.0,Phase3-EA-S1v2-USDJPY-M15-0,USDJPYMT4,3772,3h 0m,Sell
148014.0,1.1058,26.05.2016 10:05:00,,0.0,-556.170000000071,0.0,0.0,1.10592,26.05.2016 01:45:00,13151,-0.23312637954697682,4.97,IS,0.41,0.0,Phase3-EA-SA2v2-EURCHF-M5-43,EURCHFMT4,6722,8h 20m,Sell
148058.59,1.1075,27.05.2016 00:49:57,tp 1.10750,-0.99,-511.5800000000745,0.0,0.0,1.1064,26.05.2016 21:25:00,13152,-0.21443586178442658,44.59,IS,0.41,0.0,Phase3-EA-SA2v2-EURCHF-M5-43,EURCHFMT4,6724,3h 24m,Buy
148038.44,109705,27.05.2016 04:00:00,,-0.71,-531.7300000000687,0.0,0.0,109784,26.05.2016 17:00:00,13153,-0.22288201412610203,-20.15,IS,0.27,0.0,Phase3-EA-S1v2-USDJPY-M15-0,USDJPYMT4,3774,11h 0m,Buy
148047.97,1.10717,27.05.2016 09:10:00,,0.0,-522.2000000000698,0.0,0.0,1.1074,27.05.2016 00:50:00,13154,-0.21888738227418242,9.53,IS,0.41,0.0,Phase3-EA-SA2v2-EURCHF-M5-43,EURCHFMT4,6726,8h 20m,Sell
148012.32,122623,27.05.2016 11:14:57,sl 122.623,0.0,-557.850000000064,0.0,0.0,122853,27.05.2016 01:00:00,13155,-0.23383057487868697,-35.65,IS,0.17,0.0,Phase3-EA-T1v2-EURJPY-M15-322,EURJPYMT4,2502,10h 14m,Buy
148020.9,1.10716,27.05.2016 14:00:00,,0.0,-549.2700000000768,0.0,0.0,1.10691,27.05.2016 05:15:00,13156,-0.23023414872030049,8.58,IS,0.34,0.0,Phase3-EA-S4v1-EURCHF-M15-221,EURCHFMT4,3434,8h 45m,Buy
148010.43,1.10435,30.05.2016 04:50:00,,-0.99,-559.740000000078,0.0,0.0,1.10458,27.05.2016 20:30:00,13157,-0.23462279462687005,-10.47,IS,0.41,0.0,Phase3-EA-SA2v2-EURCHF-M5-43,EURCHFMT4,6728,2d 8h 20m,Buy
147975.45,0.99475,30.05.2016 05:15:00,,0.0,-594.7200000000885,0.0,0.0,0.99415,30.05.2016 01:00:00,13158,-0.24928514742647206,-34.98,IS,0.58,0.0,Phase3-EA-SA2v2-USDCHF-M15-107,USDCHFMT4,2574,4h 15m,Sell
147809.63,162183,30.05.2016 06:29:58,sl 162.183,0.0,-760.5400000000955,0.0,0.0,161383,30.05.2016 02:15:00,13159,-0.318790903322109,-165.82,IS,0.23,0.0,Phase3-EA-S4v1-GBPJPY-M5-194,GBPJPYMT4,2866,4h 14m,Sell
147749.21,123378,30.05.2016 08:29:58,sl 123.378,-2.02,-820.9600000001083,0.0,0.0,123377,16.05.2016 17:00:00,13160,-0.3441167854305103,-60.42,IS,0.09,0.0,Phase3-EA-TR1v1-EURJPY-M30-91,EURJPYMT4,2347,13d 15h 29m,Buy
147748.19,1.10502,30.05.2016 09:45:00,,0.0,-821.9800000000978,0.0,0.0,1.10499,30.05.2016 01:00:00,13161,-0.34454433259618883,-1.02,IS,0.34,0.0,Phase3-EA-S4v1-EURCHF-M15-221,EURCHFMT4,3436,8h 45m,Sell
147764.96,111064,30.05.2016 19:00:00,,0.0,-805.2100000001083,0.0,0.0,111133,30.05.2016 18:45:00,13162,-0.3375149541957,16.77,IS,0.27,0.0,Phase3-EA-S1v2-USDJPY-M15-0,USDJPYMT4,3776,15m 0s,Sell
147759.86,111083,30.05.2016 19:15:00,,0.0,-810.3100000001141,0.0,0.0,111062,30.05.2016 19:00:00,13163,-0.3396526900241172,-5.1,IS,0.27,0.0,Phase3-EA-S1v2-USDJPY-M15-0,USDJPYMT4,3778,15m 0s,Sell
147803.25,1.10473,31.05.2016 01:00:00,tp 1.10473,-2.07,-766.9200000001001,0.0,0.0,1.10583,30.05.2016 20:45:00,13164,-0.321465168927069,43.39,IS,0.41,0.0,Phase3-EA-SA2v2-EURCHF-M5-43,EURCHFMT4,6730,4h 15m,Sell
147884.12,162917,31.05.2016 05:19:58,tp 162.917,0.0,-686.0500000001048,0.0,0.0,162527,31.05.2016 02:00:00,13165,-0.28756738531061987,80.87,IS,0.23,0.0,Phase3-EA-S4v1-GBPJPY-M5-194,GBPJPYMT4,2868,3h 19m,Buy
147929.58,1.10593,31.05.2016 07:44:58,tp 1.10593,0.0,-640.5900000001129,0.0,0.0,1.10483,31.05.2016 01:05:00,13166,-0.2685121949655773,45.46,IS,0.41,0.0,Phase3-EA-SA2v2-EURCHF-M5-43,EURCHFMT4,6732,6h 39m,Buy
147894.4,123609,31.05.2016 12:14:58,sl 123.609,0.0,-675.7700000001059,0.0,0.0,123839,31.05.2016 06:15:00,13167,-0.28325838054275687,-35.18,IS,0.17,0.0,Phase3-EA-T1v2-EURJPY-M15-322,EURJPYMT4,2504,5h 59m,Buy
147839.86,161.98,31.05.2016 12:29:58,sl 161.980,-0.29,-730.3100000001141,0.0,0.0,162.65,30.05.2016 16:30:00,13168,-0.3061195789901604,-54.54,IS,0.09,0.0,Phase3-EA-B1v1-GBPJPY-M30-1,GBPJPYMT4,1226,19h 59m,Buy
147869.05,1.10466,31.05.2016 15:15:00,,0.0,-701.1200000001118,0.0,0.0,1.10551,31.05.2016 06:30:00,13169,-0.2938841851016444,29.19,IS,0.34,0.0,Phase3-EA-S4v1-EURCHF-M15-221,EURCHFMT4,3438,8h 45m,Sell
147833.79,123677,31.05.2016 18:59:58,sl 123.677,0.0,-736.3800000001211,0.0,0.0,123907,31.05.2016 14:45:00,13170,-0.3086639037898648,-35.26,IS,0.17,0.0,Phase3-EA-T1v2-EURJPY-M15-322,EURJPYMT4,2506,4h 14m,Buy
147774.79,123028,31.05.2016 23:29:57,sl 123.028,-0.4,-795.3800000001211,0.0,0.0,122658,23.05.2016 14:00:00,13171,-0.33339457317740795,-59.0,IS,0.09,0.0,Phase3-EA-TR1v1-EURJPY-M30-91,EURJPYMT4,2349,8d 9h 29m,Sell
147769.36,0.99344,01.06.2016 03:30:00,,-3.09,-800.8100000001141,0.0,0.0,0.9934,31.05.2016 23:15:00,13172,-0.3356706330888348,-5.43,IS,0.58,0.0,Phase3-EA-SA2v2-USDCHF-M15-107,USDCHFMT4,2576,4h 15m,Sell
147850.42,160052,01.06.2016 04:04:58,tp 160.052,0.0,-719.7500000001164,0.0,0.0,160442,01.06.2016 03:05:00,13173,-0.3016932083336791,81.06,IS,0.23,0.0,Phase3-EA-S4v1-GBPJPY-M5-194,GBPJPYMT4,2870,59m 58s,Sell
147898.55,110504,01.06.2016 04:15:00,,0.0,-671.6200000001118,0.0,0.0,110701,01.06.2016 00:15:00,13174,-0.28151885040787283,48.13,IS,0.27,0.0,Phase3-EA-S1v2-USDJPY-M15-0,USDJPYMT4,3780,4h 0m,Sell
147865.79,1.10525,01.06.2016 07:05:00,,-0.99,-704.3800000001211,0.0,0.0,1.10602,31.05.2016 22:45:00,13175,-0.29525065937628203,-32.76,IS,0.41,0.0,Phase3-EA-SA2v2-EURCHF-M5-43,EURCHFMT4,6734,8h 20m,Buy
147795.86,122.19,01.06.2016 09:29:58,sl 122.190,-6.4,-774.3100000001141,0.0,0.0,123748,30.05.2016 10:30:00,13176,-0.32456279005883665,-69.93,IS,0.09,0.0,Phase3-EA-TR1v1-EURJPY-M30-91,EURJPYMT4,2351,1d 22h 59m,Buy
147826.38,1.10636,01.06.2016 13:30:00,,0.0,-743.7900000001246,0.0,0.0,1.10547,01.06.2016 04:45:00,13177,-0.3117699081993865,30.52,IS,0.34,0.0,Phase3-EA-S4v1-EURCHF-M15-221,EURCHFMT4,3440,8h 45m,Buy
147762.3,121957,01.06.2016 15:29:58,sl 121.957,0.0,-807.8700000001118,0.0,0.0,122737,01.06.2016 12:00:00,13178,-0.3386299301375805,-64.08,IS,0.09,0.0,Phase3-EA-TR1v1-EURJPY-M30-91,EURJPYMT4,2354,3h 29m,Buy
147801.78,1.10363,02.06.2016 01:04:57,tp 1.10363,-6.23,-768.3900000001013,0.0,0.0,1.10473,01.06.2016 21:05:00,13179,-0.32208133984231846,39.48,IS,0.41,0.0,Phase3-EA-SA2v2-EURCHF-M5-43,EURCHFMT4,6736,3h 59m,Sell
147800.92,109459,02.06.2016 02:00:00,,-3.33,-769.2500000000873,0.0,0.0,109469,01.06.2016 18:15:00,13180,-0.32244182078592765,-0.86,IS,0.27,0.0,Phase3-EA-S1v2-USDJPY-M15-0,USDJPYMT4,3782,7h 45m,Sell
147789.2,1.10611,02.06.2016 11:45:00,,0.0,-780.9700000000885,0.0,0.0,1.10577,02.06.2016 03:00:00,13181,-0.3273544215524028,-11.72,IS,0.34,0.0,Phase3-EA-S4v1-EURCHF-M15-221,EURCHFMT4,3442,8h 45m,Sell
148052.25,121764,02.06.2016 16:44:57,tp 121.764,-2.17,-517.9200000001001,0.0,0.0,123464,31.05.2016 19:30:00,13182,-0.2170933608338784,263.05,IS,0.17,0.0,Phase3-EA-T1v2-EURJPY-M15-322,EURJPYMT4,2508,1d 21h 14m,Sell
148029.05,108809,03.06.2016 03:45:00,,-1.12,-541.1200000001118,0.0,0.0,108.72,02.06.2016 21:15:00,13183,-0.22681796303373078,-23.2,IS,0.27,0.0,Phase3-EA-S1v2-USDJPY-M15-0,USDJPYMT4,3784,6h 30m,Sell
148111.33,157.22,03.06.2016 05:29:58,tp 157.220,0.0,-458.8400000001129,0.0,0.0,156.83,03.06.2016 02:15:00,13184,-0.19232915833530667,82.28,IS,0.23,0.0,Phase3-EA-S4v1-GBPJPY-M5-194,GBPJPYMT4,2872,3h 14m,Buy
148111.58,1.10418,03.06.2016 07:10:00,,-0.99,-458.5900000001129,0.0,0.0,1.10415,02.06.2016 22:50:00,13185,-0.19222436736332554,0.25,IS,0.41,0.0,Phase3-EA-SA2v2-EURCHF-M5-43,EURCHFMT4,6738,8h 20m,Buy
148129.76,1.10441,03.06.2016 14:00:00,,0.0,-440.4100000001199,0.0,0.0,1.10388,03.06.2016 05:15:00,13186,-0.18460396788086178,18.18,IS,0.34,0.0,Phase3-EA-S4v1-EURCHF-M15-221,EURCHFMT4,3444,8h 45m,Buy
148093.48,121533,03.06.2016 16:44:58,sl 121.533,0.0,-476.69000000011874,0.0,0.0,121303,03.06.2016 15:45:00,13187,-0.19981123373476073,-36.28,IS,0.17,0.0,Phase3-EA-T1v2-EURJPY-M15-322,EURJPYMT4,2510,59m 58s,Sell
148139.63,1.10753,03.06.2016 21:44:58,tp 1.10753,0.0,-430.54000000012456,0.0,0.0,1.10863,03.06.2016 20:40:00,13188,-0.18046682030704933,46.15,IS,0.41,0.0,Phase3-EA-SA2v2-EURCHF-M5-43,EURCHFMT4,6740,1h 4m,Sell
148223.89,154333,06.06.2016 02:04:58,tp 154.333,0.0,-346.28000000011525,0.0,0.0,153943,06.06.2016 01:20:00,13189,-0.1451480711105304,84.26,IS,0.23,0.0,Phase3-EA-S4v1-GBPJPY-M5-194,GBPJPYMT4,2874,44m 58s,Buy
148307.91,154051,06.06.2016 03:04:59,tp 154.051,0.0,-262.26000000012573,0.0,0.0,154441,06.06.2016 02:50:00,13190,-0.10992992124712164,84.02,IS,0.23,0.0,Phase3-EA-S4v1-GBPJPY-M5-194,GBPJPYMT4,2876,14m 59s,Sell
148366.55,0.97729,06.06.2016 03:14:58,tp 0.97729,-0.71,-203.62000000011176,0.0,0.0,0.97629,03.06.2016 23:45:00,13191,-0.08535015085922544,58.64,IS,0.58,0.0,Phase3-EA-SA2v2-USDCHF-M15-107,USDCHFMT4,2578,2d 3h 29m,Buy
148381.5,106751,06.06.2016 03:15:00,,-0.73,-188.67000000010012,0.0,0.0,106689,03.06.2016 23:00:00,13192,-0.07908365073474988,14.95,IS,0.27,0.0,Phase3-EA-S1v2-USDJPY-M15-0,USDJPYMT4,3786,2d 4h 15m,Buy
148465.63,153706,06.06.2016 04:09:58,tp 153.706,0.0,-104.54000000009546,0.0,0.0,153316,06.06.2016 03:30:00,13193,-0.04381939284366309,84.13,IS,0.23,0.0,Phase3-EA-S4v1-GBPJPY-M5-194,GBPJPYMT4,2878,39m 58s,Buy
148428.46,121344,06.06.2016 06:59:57,sl 121.344,-0.56,-141.71000000010827,0.0,0.0,121114,03.06.2016 18:30:00,13194,-0.05939971455782064,-37.17,IS,0.17,0.0,Phase3-EA-T1v2-EURJPY-M15-322,EURJPYMT4,2512,2d 12h 29m,Sell
148431.39,1.10817,06.06.2016 08:10:00,,-2.1,-138.78000000011525,0.0,0.0,1.10829,03.06.2016 23:50:00,13195,-0.0581715643662049,2.93,IS,0.41,0.0,Phase3-EA-SA2v2-EURCHF-M5-43,EURCHFMT4,6742,2d 8h 20m,Sell
148375.13,154862,06.06.2016 13:59:57,sl 154.862,0.0,-195.04000000012456,0.0,0.0,154192,06.06.2016 01:00:00,13196,-0.08175372470083894,-56.26,IS,0.09,0.0,Phase3-EA-B1v1-GBPJPY-M30-1,GBPJPYMT4,1228,12h 59m,Sell
148376.14,107154,06.06.2016 18:00:00,,0.0,-194.03000000011525,0.0,0.0,107.15,06.06.2016 17:00:00,13197,-0.08133036917403133,1.01,IS,0.27,0.0,Phase3-EA-S1v2-USDJPY-M15-0,USDJPYMT4,3788,1h 0m,Buy
148168.03,1.09852,07.06.2016 01:04:58,sl 1.09852,-1.01,-402.1400000001013,0.0,0.0,1.10342,06.06.2016 20:15:00,13198,-0.1685625658899849,-208.11,IS,0.41,0.0,Phase3-EA-SA2v2-EURCHF-M5-43,EURCHFMT4,6744,4h 49m,Buy
148250.33,155162,07.06.2016 04:19:58,tp 155.162,-1.24,-319.8400000001129,0.0,0.0,155552,06.06.2016 23:50:00,13199,-0.13406537791380668,82.3,IS,0.23,0.0,Phase3-EA-S4v1-GBPJPY-M5-194,GBPJPYMT4,2880,4h 29m,Sell
148189.28,122398,07.06.2016 07:29:58,sl 122.398,-0.88,-380.8900000001013,0.0,0.0,121678,02.06.2016 17:30:00,13200,-0.15965533327159012,-61.05,IS,0.09,0.0,Phase3-EA-TR1v1-EURJPY-M30-91,EURJPYMT4,2356,4d 13h 59m,Sell
148220.1,1.10254,07.06.2016 09:25:00,,0.0,-350.0700000000943,0.0,0.0,1.10181,07.06.2016 01:05:00,13201,-0.14673670224575533,30.82,IS,0.41,0.0,Phase3-EA-SA2v2-EURCHF-M5-43,EURCHFMT4,6746,8h 20m,Buy
148233.4,1.10257,07.06.2016 10:00:00,,0.0,-336.77000000010594,0.0,0.0,1.10219,07.06.2016 01:15:00,13202,-0.1411618225363649,13.3,IS,0.34,0.0,Phase3-EA-S4v1-EURCHF-M15-221,EURCHFMT4,3446,8h 45m,Buy
148227.24,107348,08.06.2016 03:45:00,,-1.13,-342.93000000010943,0.0,0.0,107328,07.06.2016 23:15:00,13203,-0.14374387208598102,-6.16,IS,0.27,0.0,Phase3-EA-S1v2-USDJPY-M15-0,USDJPYMT4,3790,4h 30m,Sell
148214.33,1.09634,08.06.2016 04:25:00,,-1.02,-355.8400000001129,0.0,0.0,1.09662,07.06.2016 20:05:00,13204,-0.14915527787908725,-12.91,IS,0.41,0.0,Phase3-EA-SA2v2-EURCHF-M5-43,EURCHFMT4,6748,8h 20m,Buy
148221.54,0.96499,08.06.2016 05:15:00,,0.0,-348.6300000001211,0.0,0.0,0.96511,08.06.2016 01:00:00,13205,-0.1461331062471553,7.21,IS,0.58,0.0,Phase3-EA-SA2v2-USDCHF-M15-107,USDCHFMT4,2580,4h 15m,Sell
148240.56,1.09678,08.06.2016 10:00:00,,0.0,-329.61000000013155,0.0,0.0,1.09624,08.06.2016 01:15:00,13206,-0.13816060909883648,19.02,IS,0.34,0.0,Phase3-EA-S4v1-EURCHF-M15-221,EURCHFMT4,3448,8h 45m,Buy
148244.23,106771,09.06.2016 04:00:00,,-3.41,-325.94000000011874,0.0,0.0,106799,08.06.2016 21:15:00,13207,-0.13662227763014834,3.67,IS,0.27,0.0,Phase3-EA-S1v2-USDJPY-M15-0,USDJPYMT4,3792,6h 45m,Sell
148239.01,1.09271,09.06.2016 05:10:00,,-3.08,-331.1600000001199,0.0,0.0,1.09276,08.06.2016 20:50:00,13208,-0.13881031312511452,-5.22,IS,0.41,0.0,Phase3-EA-SA2v2-EURCHF-M5-43,EURCHFMT4,6750,8h 20m,Buy
148346.85,121.01,09.06.2016 11:59:58,tp 121.010,-1.17,-223.3200000001234,0.0,0.0,122.3,07.06.2016 10:30:00,13209,-0.09360767945134219,107.84,IS,0.09,0.0,Phase3-EA-TR1v1-EURJPY-M30-91,EURJPYMT4,2358,2d 1h 29m,Sell
148452.08,120504,09.06.2016 18:29:58,tp 120.504,-1.17,-118.09000000011292,0.0,0.0,121764,07.06.2016 19:30:00,13210,-0.04949906352504684,105.23,IS,0.09,0.0,Phase3-EA-TR1v1-EURJPY-M30-91,EURJPYMT4,2359,1d 22h 59m,Sell
148491.64,106468,09.06.2016 18:45:00,,0.0,-78.53000000011525,0.0,0.0,106624,09.06.2016 17:00:00,13211,-0.03291694011875617,39.56,IS,0.27,0.0,Phase3-EA-S1v2-USDJPY-M15-0,USDJPYMT4,3794,1h 45m,Sell
148430.92,121076,09.06.2016 22:59:58,sl 121.076,0.0,-139.25000000011642,0.0,0.0,120356,09.06.2016 18:30:00,13212,-0.05836857139352988,-60.72,IS,0.09,0.0,Phase3-EA-TR1v1-EURJPY-M30-91,EURJPYMT4,2362,4h 29m,Sell
148513.4,154778,10.06.2016 00:49:58,tp 154.778,-1.25,-56.77000000010594,0.0,0.0,155168,09.06.2016 23:55:00,13213,-0.023795933917516013,82.48,IS,0.23,0.0,Phase3-EA-S4v1-GBPJPY-M5-194,GBPJPYMT4,2882,54m 58s,Sell
148524.71,0.96397,10.06.2016 02:45:00,,-0.72,-45.460000000108266,0.0,0.0,0.96377,09.06.2016 22:30:00,13214,-0.019055190345091344,11.31,IS,0.58,0.0,Phase3-EA-SA2v2-USDCHF-M15-107,USDCHFMT4,2582,4h 15m,Buy
148552.19,154797,10.06.2016 06:50:00,,0.0,-17.98000000009779,0.0,0.0,154669,10.06.2016 01:25:00,13215,-0.007536566704922785,27.48,IS,0.23,0.0,Phase3-EA-S4v1-GBPJPY-M5-194,GBPJPYMT4,2884,5h 25m,Buy
148497.34,1.08961,10.06.2016 10:50:00,,0.0,-72.83000000010361,0.0,0.0,1.0909,10.06.2016 02:30:00,13216,-0.030527705957581867,-54.85,IS,0.41,0.0,Phase3-EA-SA2v2-EURCHF-M5-43,EURCHFMT4,6752,8h 20m,Buy
148437.37,1.08836,10.06.2016 14:30:00,,0.0,-132.80000000010477,0.0,0.0,1.09006,10.06.2016 05:45:00,13217,-0.055664964316412234,-59.97,IS,0.34,0.0,Phase3-EA-S4v1-EURCHF-M15-221,EURCHFMT4,3450,8h 45m,Buy
148701.97,1.42576,10.06.2016 21:59:58,tp 1.42576,0.0,-0.0,0.0,0.0,1.44466,10.06.2016 09:00:00,13218,-0.0,264.6,IS,0.14,0.0,Phase3-EA-B1v1-GBPUSD-M30-14,GBPUSDMT4,872,12h 59m,Sell
148728.77,106791,10.06.2016 22:00:00,,0.0,-0.0,0.0,0.0,106897,10.06.2016 17:00:00,13219,-0.0,26.8,IS,0.27,0.0,Phase3-EA-S1v2-USDJPY-M15-0,USDJPYMT4,3796,5h 0m,Sell
148556.15,151.28,13.06.2016 03:39:58,sl 151.280,0.0,-172.61999999999534,0.0,0.0,152.08,13.06.2016 01:35:00,13220,-0.072308000414024,-172.62,IS,0.23,0.0,Phase3-EA-S4v1-GBPJPY-M5-194,GBPJPYMT4,2886,2h 4m,Buy
148640.31,151349,13.06.2016 04:09:58,tp 151.349,0.0,-88.45999999999185,0.0,0.0,150959,13.06.2016 03:45:00,13221,-0.037054603850215195,84.16,IS,0.23,0.0,Phase3-EA-S4v1-GBPJPY-M5-194,GBPJPYMT4,2888,24m 58s,Buy
148546.15,1.08443,13.06.2016 04:25:00,,-1.02,-182.61999999999534,0.0,0.0,1.08662,10.06.2016 20:05:00,13222,-0.0764968545684688,-94.16,IS,0.41,0.0,Phase3-EA-SA2v2-EURCHF-M5-43,EURCHFMT4,6754,2d 8h 20m,Buy
148661.72,1.08765,13.06.2016 13:00:00,,0.0,-67.04999999998836,0.0,0.0,1.08437,13.06.2016 04:15:00,13223,-0.02808626710554744,115.57,IS,0.34,0.0,Phase3-EA-S4v1-EURCHF-M15-221,EURCHFMT4,3452,8h 45m,Buy
148604.85,150.96,13.06.2016 17:59:58,sl 150.960,0.0,-123.9199999999837,0.0,0.0,150.29,13.06.2016 09:00:00,13224,-0.05190828068187301,-56.87,IS,0.09,0.0,Phase3-EA-B1v1-GBPJPY-M30-1,GBPJPYMT4,1230,8h 59m,Sell
148543.89,120153,13.06.2016 18:29:57,sl 120.153,0.0,-184.87999999997555,0.0,0.0,119433,13.06.2016 05:30:00,13225,-0.07744353560736504,-60.96,IS,0.09,0.0,Phase3-EA-TR1v1-EURJPY-M30-91,EURJPYMT4,2364,12h 59m,Sell
148487.19,150964,13.06.2016 19:59:58,sl 150.964,0.0,-241.5799999999872,0.0,0.0,151634,13.06.2016 18:00:00,13226,-0.10119433866307187,-56.7,IS,0.09,0.0,Phase3-EA-B1v1-GBPJPY-M30-1,GBPJPYMT4,1232,1h 59m,Buy
148571.69,150852,14.06.2016 01:44:58,tp 150.852,0.0,-157.0799999999872,0.0,0.0,151242,14.06.2016 00:55:00,13227,-0.0657985210580134,84.5,IS,0.23,0.0,Phase3-EA-S4v1-GBPJPY-M5-194,GBPJPYMT4,2890,49m 58s,Sell
148573.22,106.15,14.06.2016 02:15:00,,0.0,-155.54999999998836,0.0,0.0,106156,14.06.2016 01:15:00,13228,-0.06515762637238383,1.53,IS,0.27,0.0,Phase3-EA-S1v2-USDJPY-M15-0,USDJPYMT4,3798,1h 0m,Sell
148534.58,0.96351,14.06.2016 02:30:00,,-0.72,-194.19000000000233,0.0,0.0,0.96414,13.06.2016 22:15:00,13229,-0.08134335882516434,-38.64,IS,0.58,0.0,Phase3-EA-SA2v2-USDCHF-M15-107,USDCHFMT4,2584,4h 15m,Buy
148619.09,150874,14.06.2016 03:59:57,tp 150.874,0.0,-109.67999999999302,0.0,0.0,150484,14.06.2016 02:50:00,13230,-0.04594335236594753,84.51,IS,0.23,0.0,Phase3-EA-S4v1-GBPJPY-M5-194,GBPJPYMT4,2892,1h 9m,Buy
148591.26,1.08802,14.06.2016 07:45:00,,-1.02,-137.5099999999802,0.0,0.0,1.08865,13.06.2016 23:25:00,13231,-0.05760093347776202,-27.83,IS,0.41,0.0,Phase3-EA-SA2v2-EURCHF-M5-43,EURCHFMT4,6756,8h 20m,Buy
148863.42,118976,14.06.2016 11:14:57,tp 118.976,-1.12,-0.0,0.0,0.0,120676,10.06.2016 21:45:00,13232,-0.0,272.16,IS,0.17,0.0,Phase3-EA-T1v2-EURJPY-M15-322,EURJPYMT4,2514,3d 13h 29m,Sell
148725.87,1.08347,14.06.2016 11:29:58,sl 1.08347,0.0,-137.54999999998836,0.0,0.0,1.08737,14.06.2016 04:15:00,13233,-0.05758520915424707,-137.55,IS,0.34,0.0,Phase3-EA-S4v1-EURCHF-M15-221,EURCHFMT4,3454,7h 14m,Buy
148810.42,149778,15.06.2016 03:59:57,tp 149.778,0.0,-53.0,0.0,0.0,149388,15.06.2016 01:25:00,13234,-0.022188412105964034,84.55,IS,0.23,0.0,Phase3-EA-S4v1-GBPJPY-M5-194,GBPJPYMT4,2894,2h 34m,Buy
148773.6,119028,15.06.2016 04:14:58,sl 119.028,0.0,-89.82000000000698,0.0,0.0,118798,15.06.2016 01:45:00,13235,-0.03760307878033669,-36.82,IS,0.17,0.0,Phase3-EA-T1v2-EURJPY-M15-322,EURJPYMT4,2516,2h 29m,Sell
148736.76,119014,15.06.2016 06:14:58,sl 119.014,0.0,-126.66000000000349,0.0,0.0,118784,15.06.2016 05:45:00,13236,-0.05302611844040533,-36.84,IS,0.17,0.0,Phase3-EA-T1v2-EURJPY-M15-322,EURJPYMT4,2518,29m 58s,Sell
148764.66,1.07995,15.06.2016 06:20:00,,-1.02,-98.76000000000931,0.0,0.0,1.07927,14.06.2016 22:00:00,13237,-0.04134580338840028,27.9,IS,0.41,0.0,Phase3-EA-SA2v2-EURCHF-M5-43,EURCHFMT4,6758,8h 20m,Buy
148905.47,1.08353,15.06.2016 11:59:57,tp 1.08353,0.0,-0.0,0.0,0.0,1.07953,15.06.2016 06:00:00,13238,-0.0,140.81,IS,0.34,0.0,Phase3-EA-S4v1-EURCHF-M15-221,EURCHFMT4,3456,5h 59m,Buy
148952.41,1.0829,15.06.2016 22:19:58,tp 1.08290,0.0,-0.0,0.0,0.0,1084,15.06.2016 20:05:00,13239,-0.0,46.94,IS,0.41,0.0,Phase3-EA-SA2v2-EURCHF-M5-43,EURCHFMT4,6760,2h 14m,Sell
149033.34,150093,16.06.2016 04:04:58,tp 150.093,-3.78,-0.0,0.0,0.0,150483,15.06.2016 23:45:00,13240,-0.0,80.93,IS,0.23,0.0,Phase3-EA-S4v1-GBPJPY-M5-194,GBPJPYMT4,2896,4h 19m,Sell
149066.14,105785,16.06.2016 04:15:00,,-3.44,-0.0,0.0,0.0,105927,15.06.2016 22:45:00,13241,-0.0,32.8,IS,0.27,0.0,Phase3-EA-S1v2-USDJPY-M15-0,USDJPYMT4,3800,5h 30m,Sell
149026.83,119129,16.06.2016 04:29:58,sl 119.129,-2.36,-39.30999999999767,0.0,0.0,119359,15.06.2016 22:45:00,13242,-0.016443148327068596,-39.31,IS,0.17,0.0,Phase3-EA-T1v2-EURJPY-M15-322,EURJPYMT4,2520,5h 44m,Buy
148950.28,1.08136,16.06.2016 07:30:00,,-3.07,-115.85999999998603,0.0,0.0,1.08308,15.06.2016 23:10:00,13243,-0.04846357581211017,-76.55,IS,0.41,0.0,Phase3-EA-SA2v2-EURCHF-M5-43,EURCHFMT4,6762,8h 20m,Buy
148954.53,1.08219,16.06.2016 12:30:00,,0.0,-111.60999999998603,0.0,0.0,1.08207,16.06.2016 03:45:00,13244,-0.04668582510262033,4.25,IS,0.34,0.0,Phase3-EA-S4v1-EURCHF-M15-221,EURCHFMT4,3458,8h 45m,Buy
149063.37,116293,16.06.2016 17:29:58,tp 116.293,0.0,-2.7699999999895226,0.0,0.0,117553,16.06.2016 09:00:00,13245,-0.0011586751682984083,108.84,IS,0.09,0.0,Phase3-EA-TR1v1-EURJPY-M30-91,EURJPYMT4,2366,8h 29m,Sell
149005.33,146867,16.06.2016 19:29:58,sl 146.867,0.0,-60.80999999999767,0.0,0.0,146197,16.06.2016 18:00:00,13246,-0.025436475445664266,-58.04,IS,0.09,0.0,Phase3-EA-B1v1-GBPJPY-M30-1,GBPJPYMT4,1234,1h 29m,Sell
148943.28,116.96,16.06.2016 20:59:58,sl 116.960,0.0,-122.85999999998603,0.0,0.0,116.24,16.06.2016 17:30:00,13247,-0.051391635804211085,-62.05,IS,0.09,0.0,Phase3-EA-TR1v1-EURJPY-M30-91,EURJPYMT4,2368,3h 29m,Sell
149046.56,104.57,16.06.2016 21:14:57,tp 104.570,0.0,-19.579999999987194,0.0,0.0,104.17,16.06.2016 17:30:00,13248,-0.00819020209218549,103.28,IS,0.27,0.0,Phase3-EA-S1v2-USDJPY-M15-0,USDJPYMT4,3802,3h 44m,Buy
149093.32,1.08309,16.06.2016 23:29:57,tp 1.08309,0.0,-0.0,0.0,0.0,1.08419,16.06.2016 20:55:00,13249,-0.0,46.76,IS,0.41,0.0,Phase3-EA-SA2v2-EURCHF-M5-43,EURCHFMT4,6764,2h 34m,Sell
149139.04,1.08425,17.06.2016 01:39:57,tp 1.08425,-1.02,-0.0,0.0,0.0,1.08315,16.06.2016 23:45:00,13250,-0.0,45.72,IS,0.41,0.0,Phase3-EA-SA2v2-EURCHF-M5-43,EURCHFMT4,6766,1h 54m,Buy
149183.51,104432,17.06.2016 02:30:00,,0.0,-0.0,0.0,0.0,104.26,17.06.2016 00:45:00,13251,-0.0,44.47,IS,0.27,0.0,Phase3-EA-S1v2-USDJPY-M15-0,USDJPYMT4,3804,1h 45m,Buy
149269.45,148407,17.06.2016 02:34:58,tp 148.407,0.0,-0.0,0.0,0.0,148017,17.06.2016 01:10:00,13252,-0.0,85.94,IS,0.23,0.0,Phase3-EA-S4v1-GBPJPY-M5-194,GBPJPYMT4,2898,1h 24m,Buy
149093.5,149123,17.06.2016 03:59:59,sl 149.123,0.0,-175.95000000001164,0.0,0.0,148323,17.06.2016 02:45:00,13253,-0.07353634155969795,-175.95,IS,0.23,0.0,Phase3-EA-S4v1-GBPJPY-M5-194,GBPJPYMT4,2900,1h 14m,Sell
149188.11,1.08341,17.06.2016 13:30:00,,0.0,-81.34000000002561,0.0,0.0,1.08609,17.06.2016 04:45:00,13254,-0.033995146476085925,94.61,IS,0.34,0.0,Phase3-EA-S4v1-EURCHF-M15-221,EURCHFMT4,3460,8h 45m,Sell
149150.6,117496,17.06.2016 20:44:57,sl 117.496,0.0,-118.85000000003492,0.0,0.0,117266,17.06.2016 20:00:00,13255,-0.04967203293192436,-37.51,IS,0.17,0.0,Phase3-EA-T1v2-EURJPY-M15-322,EURJPYMT4,2522,44m 57s,Sell
149197.61,1.08283,17.06.2016 21:29:58,tp 1.08283,0.0,-71.84000000002561,0.0,0.0,1.08173,17.06.2016 20:55:00,13256,-0.030024727352374166,47.01,IS,0.41,0.0,Phase3-EA-SA2v2-EURCHF-M5-43,EURCHFMT4,6768,34m 58s,Buy
149461.15,1.4394,20.06.2016 01:00:00,tp 1.43940,-1.06,-0.0,0.0,0.0,1.4205,16.06.2016 21:30:00,13257,-0.0,263.54,IS,0.14,0.0,Phase3-EA-B1v1-GBPUSD-M30-14,GBPUSDMT4,874,3d 3h 30m,Buy
149571.84,118245,20.06.2016 01:29:57,tp 118.245,-0.84,-0.0,0.0,0.0,116955,16.06.2016 21:00:00,13258,-0.0,110.69,IS,0.09,0.0,Phase3-EA-TR1v1-EURJPY-M30-91,EURJPYMT4,2370,3d 4h 29m,Buy
149657.59,151044,20.06.2016 02:19:57,tp 151.044,0.0,-0.0,0.0,0.0,151434,20.06.2016 01:20:00,13259,-0.0,85.75,IS,0.23,0.0,Phase3-EA-S4v1-GBPJPY-M5-194,GBPJPYMT4,2902,59m 57s,Sell
149717.89,0.96189,20.06.2016 02:59:58,tp 0.96189,0.0,-0.0,0.0,0.0,0.96289,20.06.2016 01:45:00,13260,-0.0,60.3,IS,0.58,0.0,Phase3-EA-SA2v2-USDCHF-M15-107,USDCHFMT4,2586,1h 14m,Sell
149734.99,1.08894,20.06.2016 09:55:00,,0.0,-0.0,0.0,0.0,1.08934,20.06.2016 01:35:00,13261,-0.0,17.1,IS,0.41,0.0,Phase3-EA-SA2v2-EURCHF-M5-43,EURCHFMT4,6770,8h 20m,Sell
149808.06,1.08742,20.06.2016 11:15:00,,0.0,-0.0,0.0,0.0,1.08948,20.06.2016 02:30:00,13262,-0.0,73.07,IS,0.34,0.0,Phase3-EA-S4v1-EURCHF-M15-221,EURCHFMT4,3462,8h 45m,Sell
149919.44,117399,21.06.2016 00:29:58,tp 117.399,-0.3,-0.0,0.0,0.0,118689,20.06.2016 12:30:00,13263,-0.0,111.38,IS,0.09,0.0,Phase3-EA-TR1v1-EURJPY-M30-91,EURJPYMT4,2372,11h 59m,Sell
149964.19,1.08774,21.06.2016 00:59:59,tp 1.08774,-2.13,-0.0,0.0,0.0,1.08884,20.06.2016 22:30:00,13264,-0.0,44.75,IS,0.41,0.0,Phase3-EA-SA2v2-EURCHF-M5-43,EURCHFMT4,6772,2h 29m,Sell
150011.09,1.08827,21.06.2016 01:29:58,tp 1.08827,0.0,-0.0,0.0,0.0,1.08717,21.06.2016 01:05:00,13265,-0.0,46.9,IS,0.41,0.0,Phase3-EA-SA2v2-EURCHF-M5-43,EURCHFMT4,6774,24m 58s,Buy
149988.16,0.96136,21.06.2016 05:30:00,,0.0,-22.929999999993015,0.0,0.0,0.96174,21.06.2016 01:15:00,13266,-0.009553725204944862,-22.93,IS,0.58,0.0,Phase3-EA-SA2v2-USDCHF-M15-107,USDCHFMT4,2588,4h 15m,Buy
149925.68,118278,21.06.2016 09:59:58,sl 118.278,-0.3,-85.41000000000349,0.0,0.0,117558,20.06.2016 23:30:00,13267,-0.03558585563692205,-62.48,IS,0.09,0.0,Phase3-EA-TR1v1-EURJPY-M30-91,EURJPYMT4,2373,10h 29m,Sell
150067.66,1.08577,21.06.2016 14:59:58,tp 1.08577,0.0,-0.0,0.0,0.0,1.08977,21.06.2016 06:30:00,13268,-0.0,141.98,IS,0.34,0.0,Phase3-EA-S4v1-EURCHF-M15-221,EURCHFMT4,3464,8h 29m,Sell
150104.54,104698,21.06.2016 21:15:00,,0.0,-0.0,0.0,0.0,104555,21.06.2016 20:15:00,13269,-0.0,36.88,IS,0.27,0.0,Phase3-EA-S1v2-USDJPY-M15-0,USDJPYMT4,3806,1h 0m,Buy
150149.29,1.08115,22.06.2016 01:04:57,tp 1.08115,-2.13,-0.0,0.0,0.0,1.08225,21.06.2016 22:05:00,13270,-0.0,44.75,IS,0.41,0.0,Phase3-EA-SA2v2-EURCHF-M5-43,EURCHFMT4,6776,2h 59m,Sell
150196.17,1.08293,22.06.2016 02:14:57,tp 1.08293,0.0,-0.0,0.0,0.0,1.08183,22.06.2016 01:05:00,13271,-0.0,46.88,IS,0.41,0.0,Phase3-EA-SA2v2-EURCHF-M5-43,EURCHFMT4,6778,1h 9m,Buy
150243.07,1.08151,22.06.2016 05:14:58,tp 1.08151,0.0,-0.0,0.0,0.0,1.08261,22.06.2016 02:15:00,13272,-0.0,46.9,IS,0.41,0.0,Phase3-EA-SA2v2-EURCHF-M5-43,EURCHFMT4,6780,2h 59m,Sell
150264.35,1.08228,22.06.2016 14:30:00,,0.0,-0.0,0.0,0.0,1.08168,22.06.2016 05:45:00,13273,-0.0,21.28,IS,0.34,0.0,Phase3-EA-S4v1-EURCHF-M15-221,EURCHFMT4,3466,8h 45m,Buy
150304.98,1.08196,23.06.2016 00:59:58,tp 1.08196,-6.41,-0.0,0.0,0.0,1.08306,22.06.2016 21:05:00,13274,-0.0,40.63,IS,0.41,0.0,Phase3-EA-SA2v2-EURCHF-M5-43,EURCHFMT4,6782,3h 54m,Sell
150352.05,1.08326,23.06.2016 01:09:57,tp 1.08326,0.0,-0.0,0.0,0.0,1.08216,23.06.2016 01:05:00,13275,-0.0,47.07,IS,0.41,0.0,Phase3-EA-SA2v2-EURCHF-M5-43,EURCHFMT4,6784,4m 57s,Buy
150437.59,154878,23.06.2016 01:44:58,tp 154.878,0.0,-0.0,0.0,0.0,155268,23.06.2016 01:40:00,13276,-0.0,85.54,IS,0.23,0.0,Phase3-EA-S4v1-GBPJPY-M5-194,GBPJPYMT4,2904,4m 58s,Sell
150547.12,118949,23.06.2016 01:59:57,tp 118.949,-1.27,-0.0,0.0,0.0,117659,22.06.2016 10:00:00,13277,-0.0,109.53,IS,0.09,0.0,Phase3-EA-TR1v1-EURJPY-M30-91,EURJPYMT4,2376,15h 59m,Buy
150607.6,0.95902,23.06.2016 02:14:57,tp 0.95902,0.0,-0.0,0.0,0.0,0.95802,23.06.2016 01:15:00,13278,-0.0,60.48,IS,0.58,0.0,Phase3-EA-SA2v2-USDCHF-M15-107,USDCHFMT4,2590,59m 57s,Buy
150622.12,959,23.06.2016 07:00:00,,0.0,-0.0,0.0,0.0,0.95924,23.06.2016 02:45:00,13279,-0.0,14.52,IS,0.58,0.0,Phase3-EA-SA2v2-USDCHF-M15-107,USDCHFMT4,2592,4h 15m,Sell
150615.41,104601,23.06.2016 07:30:00,,0.0,-6.709999999991851,0.0,0.0,104575,23.06.2016 01:15:00,13280,-0.0027886048049081337,-6.71,IS,0.27,0.0,Phase3-EA-S1v2-USDJPY-M15-0,USDJPYMT4,3808,6h 15m,Sell
150580.3,1.08684,23.06.2016 10:05:00,,0.0,-41.81999999997788,0.0,0.0,1.08602,23.06.2016 01:45:00,13281,-0.017379948277397632,-35.11,IS,0.41,0.0,Phase3-EA-SA2v2-EURCHF-M5-43,EURCHFMT4,6786,8h 20m,Sell
150683.74,1084,23.06.2016 12:30:00,,0.0,-0.0,0.0,0.0,1.08691,23.06.2016 03:45:00,13282,-0.0,103.44,IS,0.34,0.0,Phase3-EA-S4v1-EURCHF-M15-221,EURCHFMT4,3468,8h 45m,Sell
150616.57,119258,23.06.2016 13:29:58,sl 119.258,0.0,-67.1700000000128,0.0,0.0,118478,23.06.2016 11:30:00,13283,-0.027907992455166453,-67.17,IS,0.09,0.0,Phase3-EA-TR1v1-EURJPY-M30-91,EURJPYMT4,2378,1h 59m,Sell
150663.65,1.08746,23.06.2016 22:09:58,tp 1.08746,0.0,-20.09000000002561,0.0,0.0,1.08856,23.06.2016 21:25:00,13284,-0.008347053274153669,47.08,IS,0.41,0.0,Phase3-EA-SA2v2-EURCHF-M5-43,EURCHFMT4,6788,44m 58s,Sell
150710.7,1.08825,23.06.2016 23:44:58,tp 1.08825,0.0,-0.0,0.0,0.0,1.08715,23.06.2016 22:20:00,13285,-0.0,47.05,IS,0.41,0.0,Phase3-EA-SA2v2-EURCHF-M5-43,EURCHFMT4,6790,1h 24m,Buy
150850.04,120135,23.06.2016 23:45:00,,0.0,-0.0,0.0,0.0,119268,23.06.2016 13:30:00,13286,-0.0,139.34,IS,0.17,0.0,Phase3-EA-T1v2-EURJPY-M15-322,EURJPYMT4,2524,10h 15m,Buy
150897.15,1.09008,24.06.2016 00:59:59,tp 1.09008,0.0,-0.0,0.0,0.0,1.09118,24.06.2016 00:30:00,13287,-0.0,47.11,IS,0.41,0.0,Phase3-EA-SA2v2-EURCHF-M5-43,EURCHFMT4,6792,29m 59s,Sell
150981.67,157291,24.06.2016 01:04:57,tp 157.291,0.0,-0.0,0.0,0.0,157681,24.06.2016 00:20:00,13288,-0.0,84.52,IS,0.23,0.0,Phase3-EA-S4v1-GBPJPY-M5-194,GBPJPYMT4,2906,44m 57s,Sell
150771.34,1.09668,24.06.2016 01:14:57,sl 1.09668,0.0,-210.3299999999872,0.0,0.0,1.09178,24.06.2016 01:10:00,13289,-0.08728049730918792,-210.33,IS,0.41,0.0,Phase3-EA-SA2v2-EURCHF-M5-43,EURCHFMT4,6794,4m 57s,Sell
150560.12,106677,24.06.2016 01:14:58,sl 106.677,-1.15,-421.54999999998836,0.0,0.0,105847,23.06.2016 20:15:00,13290,-0.17493031731417008,-211.22,IS,0.27,0.0,Phase3-EA-S1v2-USDJPY-M15-0,USDJPYMT4,3810,4h 59m,Sell
150493.44,121187,24.06.2016 01:29:58,sl 121.187,-0.3,-488.2299999999814,0.0,0.0,120407,23.06.2016 20:00:00,13291,-0.20260047164582223,-66.68,IS,0.09,0.0,Phase3-EA-TR1v1-EURJPY-M30-91,EURJPYMT4,2380,5h 29m,Sell
150577.8,159441,24.06.2016 01:29:58,tp 159.441,0.0,-403.86999999999534,0.0,0.0,159831,24.06.2016 01:20:00,13292,-0.16759365971693752,84.36,IS,0.23,0.0,Phase3-EA-S4v1-GBPJPY-M5-194,GBPJPYMT4,2908,9m 58s,Sell
150624.53,1.09775,24.06.2016 02:49:58,tp 1.09775,0.0,-357.13999999998487,0.0,0.0,1.09885,24.06.2016 01:45:00,13293,-0.14820214334143467,46.73,IS,0.41,0.0,Phase3-EA-SA2v2-EURCHF-M5-43,EURCHFMT4,6796,1h 4m,Sell
150765.44,1.09494,24.06.2016 02:59:58,tp 1.09494,0.0,-216.22999999998137,0.0,0.0,1.09894,24.06.2016 02:45:00,13294,-0.08972881630373808,140.91,IS,0.34,0.0,Phase3-EA-S4v1-EURCHF-M15-221,EURCHFMT4,3470,14m 58s,Sell
150591.94,156471,24.06.2016 03:19:58,sl 156.471,0.0,-389.7299999999814,0.0,0.0,157271,24.06.2016 03:15:00,13295,-0.1617259935164278,-173.5,IS,0.23,0.0,Phase3-EA-S4v1-GBPJPY-M5-194,GBPJPYMT4,2910,4m 58s,Buy
150677.99,152781,24.06.2016 03:29:58,tp 152.781,0.0,-303.679999999993,0.0,0.0,152391,24.06.2016 03:25:00,13296,-0.1260178834348652,86.05,IS,0.23,0.0,Phase3-EA-S4v1-GBPJPY-M5-194,GBPJPYMT4,2912,4m 58s,Buy
150788.33,117578,24.06.2016 05:29:58,tp 117.578,0.0,-193.3399999999965,0.0,0.0,118868,24.06.2016 03:30:00,13297,-0.08023016854352263,110.34,IS,0.09,0.0,Phase3-EA-TR1v1-EURJPY-M30-91,EURJPYMT4,2382,1h 59m,Sell
150724.56,111337,24.06.2016 08:29:58,sl 111.337,0.0,-257.10999999998603,0.0,0.0,110617,24.06.2016 08:00:00,13298,-0.10669276215074149,-63.77,IS,0.09,0.0,Phase3-EA-TR1v1-EURJPY-M30-91,EURJPYMT4,2384,29m 58s,Sell
150660.34,111724,24.06.2016 08:59:57,sl 111.724,0.0,-321.3299999999872,0.0,0.0,111004,24.06.2016 08:30:00,13299,-0.13334209195246494,-64.22,IS,0.09,0.0,Phase3-EA-TR1v1-EURJPY-M30-91,EURJPYMT4,2386,29m 57s,Sell
150596.54,111.59,24.06.2016 09:59:58,sl 111.590,0.0,-385.12999999997555,0.0,0.0,110.87,24.06.2016 09:00:00,13300,-0.1598171346393166,-63.8,IS,0.09,0.0,Phase3-EA-TR1v1-EURJPY-M30-91,EURJPYMT4,2388,59m 58s,Sell
150642.89,1.08162,24.06.2016 20:14:58,tp 1.08162,0.0,-338.77999999996973,0.0,0.0,1.08272,24.06.2016 20:10:00,13301,-0.1405833066058377,46.35,IS,0.41,0.0,Phase3-EA-SA2v2-EURCHF-M5-43,EURCHFMT4,6798,4m 58s,Sell
150604.63,113941,24.06.2016 20:59:58,sl 113.941,0.0,-377.03999999997905,0.0,0.0,113711,24.06.2016 20:30:00,13302,-0.15646003283153326,-38.26,IS,0.17,0.0,Phase3-EA-T1v2-EURJPY-M15-322,EURJPYMT4,2526,29m 58s,Sell
150651.08,1.08248,24.06.2016 21:09:58,tp 1.08248,0.0,-330.5899999999674,0.0,0.0,1.08358,24.06.2016 21:00:00,13303,-0.1371847078659409,46.45,IS,0.41,0.0,Phase3-EA-SA2v2-EURCHF-M5-43,EURCHFMT4,6800,9m 58s,Sell
150697.38,1.08457,24.06.2016 22:19:58,tp 1.08457,0.0,-284.28999999997905,0.0,0.0,1.08567,24.06.2016 22:15:00,13304,-0.11797162829852478,46.3,IS,0.41,0.0,Phase3-EA-SA2v2-EURCHF-M5-43,EURCHFMT4,6802,4m 58s,Sell
150743.96,1.07925,24.06.2016 23:54:58,tp 1.07925,0.0,-237.70999999999185,0.0,0.0,1.07815,24.06.2016 23:25:00,13305,-0.09864235732119819,46.58,IS,0.41,0.0,Phase3-EA-SA2v2-EURCHF-M5-43,EURCHFMT4,6804,29m 58s,Buy
150705.51,111985,27.06.2016 01:14:58,sl 111.985,0.0,-276.1600000000035,0.0,0.0,111755,27.06.2016 01:00:00,13306,-0.11459792771790572,-38.45,IS,0.17,0.0,Phase3-EA-T1v2-EURJPY-M15-322,EURJPYMT4,2528,14m 58s,Sell
150765.12,0.97302,27.06.2016 01:14:58,tp 0.97302,0.0,-216.55000000001746,0.0,0.0,0.97402,27.06.2016 01:00:00,13307,-0.08986160648650844,59.61,IS,0.58,0.0,Phase3-EA-SA2v2-USDCHF-M15-107,USDCHFMT4,2594,14m 58s,Sell
150853.2,137151,27.06.2016 02:04:58,tp 137.151,0.0,-128.47000000003027,0.0,0.0,136761,27.06.2016 01:20:00,13308,-0.053311108683091794,88.08,IS,0.23,0.0,Phase3-EA-S4v1-GBPJPY-M5-194,GBPJPYMT4,2914,44m 58s,Buy
150873.12,1.07469,27.06.2016 10:45:00,,0.0,-108.55000000001746,0.0,0.0,1.07412,27.06.2016 02:00:00,13309,-0.04504491980656326,19.92,IS,0.34,0.0,Phase3-EA-S4v1-EURCHF-M15-221,EURCHFMT4,3472,8h 45m,Buy
150919.23,1.07764,27.06.2016 20:24:58,tp 1.07764,0.0,-62.44000000003143,0.0,0.0,1.07874,27.06.2016 20:15:00,13310,-0.02591068441015913,46.11,IS,0.41,0.0,Phase3-EA-SA2v2-EURCHF-M5-43,EURCHFMT4,6806,9m 58s,Sell
150880.78,112224,27.06.2016 20:29:58,sl 112.224,0.0,-100.89000000004307,0.0,0.0,111994,27.06.2016 14:30:00,13311,-0.04186625480686666,-38.45,IS,0.17,0.0,Phase3-EA-T1v2-EURJPY-M15-322,EURJPYMT4,2530,5h 59m,Sell
150926.92,1.07704,27.06.2016 22:29:58,tp 1.07704,0.0,-54.750000000029104,0.0,0.0,1.07594,27.06.2016 22:25:00,13312,-0.02271957033081762,46.14,IS,0.41,0.0,Phase3-EA-SA2v2-EURCHF-M5-43,EURCHFMT4,6808,4m 58s,Buy
150973.06,1.07709,28.06.2016 01:59:59,tp 1.07709,0.0,-8.610000000015134,0.0,0.0,1.07819,28.06.2016 00:45:00,13313,-0.0035728858547685767,46.14,IS,0.41,0.0,Phase3-EA-SA2v2-EURCHF-M5-43,EURCHFMT4,6810,1h 14m,Sell
150909.34,101907,28.06.2016 03:45:00,,-1.19,-72.3300000000163,0.0,0.0,101671,27.06.2016 18:45:00,13314,-0.03001473099593672,-63.72,IS,0.27,0.0,Phase3-EA-S1v2-USDJPY-M15-0,USDJPYMT4,3812,9h 0m,Sell
150820.86,0.97671,28.06.2016 06:30:00,,0.0,-160.81000000002678,0.0,0.0,0.9782,28.06.2016 02:15:00,13315,-0.06673121652780727,-88.48,IS,0.58,0.0,Phase3-EA-SA2v2-USDCHF-M15-107,USDCHFMT4,2596,4h 15m,Buy
150685.17,1.08291,28.06.2016 11:59:58,sl 1.08291,0.0,-296.5000000000291,0.0,0.0,1.07901,28.06.2016 06:00:00,13316,-0.12303840370930602,-135.69,IS,0.34,0.0,Phase3-EA-S4v1-EURCHF-M15-221,EURCHFMT4,3474,5h 59m,Sell
150798.2,113573,28.06.2016 14:29:57,tp 113.573,-0.43,-183.47000000003027,0.0,0.0,112283,27.06.2016 20:30:00,13317,-0.07613442134417499,113.03,IS,0.09,0.0,Phase3-EA-TR1v1-EURJPY-M30-91,EURJPYMT4,2390,17h 59m,Buy
150844.19,1.08355,28.06.2016 21:14:57,tp 1.08355,0.0,-137.48000000003958,0.0,0.0,1.08465,28.06.2016 20:20:00,13318,-0.0570499822663022,45.99,IS,0.41,0.0,Phase3-EA-SA2v2-EURCHF-M5-43,EURCHFMT4,6812,54m 57s,Sell
150903.26,0.98181,28.06.2016 23:29:58,tp 0.98181,0.0,-78.4100000000326,0.0,0.0,0.98281,28.06.2016 22:15:00,13319,-0.03253774446829595,59.07,IS,0.58,0.0,Phase3-EA-SA2v2-USDCHF-M15-107,USDCHFMT4,2598,1h 14m,Sell
150962.38,0.98101,29.06.2016 00:44:58,tp 0.98101,0.0,-19.290000000037253,0.0,0.0,0.98001,29.06.2016 00:15:00,13320,-0.008004758204239001,59.12,IS,0.58,0.0,Phase3-EA-SA2v2-USDCHF-M15-107,USDCHFMT4,2600,29m 58s,Buy
151037.79,113154,29.06.2016 05:15:00,,-0.81,-0.0,0.0,0.0,112695,28.06.2016 06:00:00,13321,-0.0,75.41,IS,0.17,0.0,Phase3-EA-T1v2-EURJPY-M15-322,EURJPYMT4,2532,23h 15m,Buy
151081.68,1.08383,29.06.2016 05:19:58,tp 1.08383,-2.09,-0.0,0.0,0.0,1.08493,28.06.2016 22:05:00,13322,-0.0,43.89,IS,0.41,0.0,Phase3-EA-SA2v2-EURCHF-M5-43,EURCHFMT4,6814,7h 14m,Sell
151033.24,102488,29.06.2016 12:45:00,,-0.76,-48.44000000000233,0.0,0.0,102669,28.06.2016 23:30:00,13323,-0.020092775195527955,-48.44,IS,0.27,0.0,Phase3-EA-S1v2-USDJPY-M15-0,USDJPYMT4,3814,13h 15m,Buy
151096.42,1.08603,29.06.2016 14:30:00,,0.0,-0.0,0.0,0.0,1.08421,29.06.2016 05:45:00,13324,-0.0,63.18,IS,0.34,0.0,Phase3-EA-S4v1-EURCHF-M15-221,EURCHFMT4,3476,8h 45m,Buy
151027.76,114294,29.06.2016 18:29:57,sl 114.294,-0.31,-68.66000000000349,0.0,0.0,113514,28.06.2016 23:00:00,13325,-0.028478232899519264,-68.66,IS,0.09,0.0,Phase3-EA-TR1v1-EURJPY-M30-91,EURJPYMT4,2392,19h 29m,Sell
151055.88,102742,29.06.2016 20:30:00,,0.0,-40.54000000000815,0.0,0.0,102635,29.06.2016 18:30:00,13326,-0.016814849428294268,28.12,IS,0.27,0.0,Phase3-EA-S1v2-USDJPY-M15-0,USDJPYMT4,3816,2h 0m,Buy
151143.16,138143,30.06.2016 00:59:58,tp 138.143,0.0,-0.0,0.0,0.0,138533,30.06.2016 00:30:00,13327,-0.0,87.28,IS,0.23,0.0,Phase3-EA-S4v1-GBPJPY-M5-194,GBPJPYMT4,2916,29m 58s,Sell
151182.92,1.08759,30.06.2016 07:39:57,tp 1.08759,-6.27,-0.0,0.0,0.0,1.08869,29.06.2016 23:20:00,13328,-0.0,39.76,IS,0.41,0.0,Phase3-EA-SA2v2-EURCHF-M5-43,EURCHFMT4,6816,8h 19m,Sell
151262.33,1.08698,30.06.2016 10:00:00,,0.0,-0.0,0.0,0.0,1.08927,30.06.2016 01:15:00,13329,-0.0,79.41,IS,0.34,0.0,Phase3-EA-S4v1-EURCHF-M15-221,EURCHFMT4,3478,8h 45m,Sell
151288.05,102886,30.06.2016 17:45:00,,0.0,-0.0,0.0,0.0,102788,30.06.2016 17:30:00,13330,-0.0,25.72,IS,0.27,0.0,Phase3-EA-S1v2-USDJPY-M15-0,USDJPYMT4,3818,15m 0s,Buy
151258.36,102775,30.06.2016 18:00:00,,0.0,-29.69000000000233,0.0,0.0,102888,30.06.2016 17:45:00,13331,-0.012304795036472872,-29.69,IS,0.27,0.0,Phase3-EA-S1v2-USDJPY-M15-0,USDJPYMT4,3820,15m 0s,Buy
151284.6,102877,30.06.2016 18:15:00,,0.0,-3.4500000000116415,0.0,0.0,102777,30.06.2016 18:00:00,13332,-0.001429826300975794,26.24,IS,0.27,0.0,Phase3-EA-S1v2-USDJPY-M15-0,USDJPYMT4,3822,15m 0s,Buy
151330.63,1.0818,30.06.2016 20:09:58,tp 1.08180,0.0,-0.0,0.0,0.0,1.0807,30.06.2016 20:05:00,13333,-0.0,46.03,IS,0.41,0.0,Phase3-EA-SA2v2-EURCHF-M5-43,EURCHFMT4,6818,4m 58s,Buy
151227.07,137474,01.07.2016 04:50:00,,-1.29,-103.55999999999767,0.0,0.0,137016,30.06.2016 23:25:00,13334,-0.04291208289639701,-103.56,IS,0.23,0.0,Phase3-EA-S4v1-GBPJPY-M5-194,GBPJPYMT4,2918,5h 25m,Sell
151225.29,0.97583,01.07.2016 05:00:00,,0.0,-105.33999999999651,0.0,0.0,0.97586,01.07.2016 00:45:00,13335,-0.04364966021925853,-1.78,IS,0.58,0.0,Phase3-EA-SA2v2-USDCHF-M15-107,USDCHFMT4,2602,4h 15m,Buy
151186.48,114178,01.07.2016 06:14:58,sl 114.178,-0.81,-144.14999999999418,0.0,0.0,114408,30.06.2016 23:00:00,13336,-0.059731332073344134,-38.81,IS,0.17,0.0,Phase3-EA-T1v2-EURJPY-M15-322,EURJPYMT4,2534,7h 14m,Buy
151168.42,1.08367,01.07.2016 07:25:00,,-2.1,-162.20999999999185,0.0,0.0,1.08329,30.06.2016 23:05:00,13337,-0.06721484131541489,-18.06,IS,0.41,0.0,Phase3-EA-SA2v2-EURCHF-M5-43,EURCHFMT4,6820,8h 20m,Sell
151172.25,1.08403,01.07.2016 12:30:00,,0.0,-158.38000000000466,0.0,0.0,1.08414,01.07.2016 03:45:00,13338,-0.06562780696341938,3.83,IS,0.34,0.0,Phase3-EA-S4v1-EURCHF-M15-221,EURCHFMT4,3480,8h 45m,Sell
151025.74,102647,01.07.2016 16:45:00,,0.0,-304.89000000001397,0.0,0.0,103204,01.07.2016 01:15:00,13339,-0.1263370505434857,-146.51,IS,0.27,0.0,Phase3-EA-S1v2-USDJPY-M15-0,USDJPYMT4,3824,15h 30m,Buy
151046.8,102545,01.07.2016 18:00:00,,0.0,-283.8300000000163,0.0,0.0,102625,01.07.2016 17:00:00,13340,-0.11761043345389471,21.06,IS,0.27,0.0,Phase3-EA-S1v2-USDJPY-M15-0,USDJPYMT4,3826,1h 0m,Sell
151106.35,0.97399,01.07.2016 23:29:58,tp 0.97399,0.0,-224.28000000002794,0.0,0.0,0.97499,01.07.2016 22:45:00,13341,-0.09293474268062318,59.55,IS,0.58,0.0,Phase3-EA-SA2v2-USDCHF-M15-107,USDCHFMT4,2604,44m 58s,Sell
151150.61,1.08345,04.07.2016 01:00:00,tp 1.08345,-2.11,-180.02000000001863,0.0,0.0,1.08455,01.07.2016 22:55:00,13342,-0.07459475823687102,44.26,IS,0.41,0.0,Phase3-EA-SA2v2-EURCHF-M5-43,EURCHFMT4,6822,2d 2h 5m,Sell
151111.95,114258,04.07.2016 01:14:58,sl 114.258,-0.58,-218.68000000002212,0.0,0.0,114028,01.07.2016 22:00:00,13343,-0.09061427469858303,-38.66,IS,0.17,0.0,Phase3-EA-T1v2-EURJPY-M15-322,EURJPYMT4,2536,2d 3h 14m,Sell
151171.57,0.97287,04.07.2016 01:14:59,tp 0.97287,0.0,-159.06000000002678,0.0,0.0,0.97187,04.07.2016 01:00:00,13344,-0.06590957807553313,59.62,IS,0.58,0.0,Phase3-EA-SA2v2-USDCHF-M15-107,USDCHFMT4,2606,14m 59s,Buy
151140.23,136.19,04.07.2016 04:50:00,,-1.3,-190.40000000002328,0.0,0.0,136056,01.07.2016 23:25:00,13345,-0.07889591138929292,-31.34,IS,0.23,0.0,Phase3-EA-S4v1-GBPJPY-M5-194,GBPJPYMT4,2920,2d 5h 25m,Sell
151102.17,113.98,04.07.2016 12:44:58,sl 113.980,0.0,-228.46000000002095,0.0,0.0,114.21,04.07.2016 05:45:00,13346,-0.09466680628149847,-38.06,IS,0.17,0.0,Phase3-EA-T1v2-EURJPY-M15-322,EURJPYMT4,2538,6h 59m,Buy
151146.54,1.08188,05.07.2016 01:04:57,tp 1.08188,-2.11,-184.0900000000256,0.0,0.0,1.08298,04.07.2016 23:05:00,13347,-0.07628124121667634,44.37,IS,0.41,0.0,Phase3-EA-SA2v2-EURCHF-M5-43,EURCHFMT4,6824,1h 59m,Sell
151164.34,0.97099,05.07.2016 02:30:00,,-0.72,-166.29000000003725,0.0,0.0,0.97068,04.07.2016 22:15:00,13348,-0.0689054679880612,17.8,IS,0.58,0.0,Phase3-EA-SA2v2-USDCHF-M15-107,USDCHFMT4,2608,4h 15m,Buy
151205.63,1.08273,05.07.2016 14:00:00,,0.0,-125.0000000000291,0.0,0.0,1.08155,05.07.2016 05:15:00,13349,-0.05179616031335454,41.29,IS,0.34,0.0,Phase3-EA-S4v1-EURCHF-M15-221,EURCHFMT4,3482,8h 45m,Buy
151204.83,101.62,05.07.2016 17:15:00,,0.0,-125.80000000001746,0.0,0.0,101617,05.07.2016 17:00:00,13350,-0.05212765573935511,-0.8,IS,0.27,0.0,Phase3-EA-S1v2-USDJPY-M15-0,USDJPYMT4,3828,15m 0s,Sell
151318.14,112872,05.07.2016 18:59:58,tp 112.872,-0.92,-12.49000000001979,0.0,0.0,114162,30.06.2016 05:30:00,13351,-0.005175472338517381,113.31,IS,0.09,0.0,Phase3-EA-TR1v1-EURJPY-M30-91,EURJPYMT4,2394,5d 13h 29m,Sell
151323.85,101529,06.07.2016 03:15:00,,-1.2,-6.78000000002794,0.0,0.0,101555,05.07.2016 23:00:00,13352,-0.0028094237354072734,5.71,IS,0.27,0.0,Phase3-EA-S1v2-USDJPY-M15-0,USDJPYMT4,3830,4h 15m,Sell
151142.55,130998,06.07.2016 03:24:58,sl 130.998,0.0,-188.0800000000163,0.0,0.0,131798,06.07.2016 03:15:00,13353,-0.07793457465387438,-181.3,IS,0.23,0.0,Phase3-EA-S4v1-GBPJPY-M5-194,GBPJPYMT4,2922,9m 58s,Buy
150960.23,130379,06.07.2016 05:24:57,sl 130.379,0.0,-370.4000000000233,0.0,0.0,131179,06.07.2016 03:40:00,13354,-0.1534823822405061,-182.32,IS,0.23,0.0,Phase3-EA-S4v1-GBPJPY-M5-194,GBPJPYMT4,2924,1h 44m,Buy
151124.32,130813,06.07.2016 05:29:58,tp 130.813,-0.51,-206.31000000002678,0.0,0.0,132663,05.07.2016 17:00:00,13355,-0.08548852667397659,164.09,IS,0.09,0.0,Phase3-EA-B1v1-GBPJPY-M30-1,GBPJPYMT4,1236,12h 29m,Sell
151236.11,111416,06.07.2016 05:29:58,tp 111.416,-0.31,-94.52000000001863,0.0,0.0,112676,05.07.2016 20:30:00,13356,-0.03916618458254477,111.79,IS,0.09,0.0,Phase3-EA-TR1v1-EURJPY-M30-91,EURJPYMT4,2396,8h 59m,Sell
151193.18,1.08042,06.07.2016 07:45:00,,-1.01,-137.45000000001164,0.0,0.0,1.08142,05.07.2016 23:25:00,13357,-0.056955057880556215,-42.93,IS,0.41,0.0,Phase3-EA-SA2v2-EURCHF-M5-43,EURCHFMT4,6826,8h 20m,Buy
151332.12,1.08376,06.07.2016 12:29:57,tp 1.08376,0.0,-0.0,0.0,0.0,1.07976,06.07.2016 05:45:00,13358,-0.0,138.94,IS,0.34,0.0,Phase3-EA-S4v1-EURCHF-M15-221,EURCHFMT4,3484,6h 44m,Buy
151293.21,111424,06.07.2016 16:14:58,sl 111.424,0.0,-38.91000000000349,0.0,0.0,111194,06.07.2016 12:45:00,13359,-0.016123009237230132,-38.91,IS,0.17,0.0,Phase3-EA-T1v2-EURJPY-M15-322,EURJPYMT4,2540,3h 29m,Sell
151229.13,112084,06.07.2016 20:29:58,sl 112.084,0.0,-102.98999999999069,0.0,0.0,111364,06.07.2016 05:30:00,13360,-0.0426756289216662,-64.08,IS,0.09,0.0,Phase3-EA-TR1v1-EURJPY-M30-91,EURJPYMT4,2398,14h 59m,Sell
151275.34,1.08198,06.07.2016 21:54:57,tp 1.08198,0.0,-56.779999999998836,0.0,0.0,1.08308,06.07.2016 20:10:00,13361,-0.0235277425980423,46.21,IS,0.41,0.0,Phase3-EA-SA2v2-EURCHF-M5-43,EURCHFMT4,6828,1h 44m,Sell
151124.01,101255,07.07.2016 02:30:00,,-3.6,-208.10999999998603,0.0,0.0,100701,06.07.2016 17:00:00,13362,-0.08623385896580406,-151.33,IS,0.27,0.0,Phase3-EA-S1v2-USDJPY-M15-0,USDJPYMT4,3832,9h 30m,Sell
151212.64,130778,07.07.2016 04:24:57,tp 130.778,0.0,-119.47999999998137,0.0,0.0,130388,07.07.2016 02:55:00,13363,-0.04950853620312986,88.63,IS,0.23,0.0,Phase3-EA-S4v1-GBPJPY-M5-194,GBPJPYMT4,2926,1h 29m,Buy
151214.42,0.97515,07.07.2016 05:00:00,,0.0,-117.69999999998254,0.0,0.0,0.97518,07.07.2016 00:45:00,13364,-0.04877096343411808,1.78,IS,0.58,0.0,Phase3-EA-SA2v2-USDCHF-M15-107,USDCHFMT4,2610,4h 15m,Sell
151279.18,1.08327,07.07.2016 14:00:00,,0.0,-52.939999999973224,0.0,0.0,1.08141,07.07.2016 05:15:00,13365,-0.021936574377241193,64.76,IS,0.34,0.0,Phase3-EA-S4v1-EURCHF-M15-221,EURCHFMT4,3486,8h 45m,Buy
151191.04,100752,08.07.2016 04:00:00,,-0.78,-141.0799999999872,0.0,0.0,101078,07.07.2016 17:30:00,13366,-0.0584588574450788,-88.14,IS,0.27,0.0,Phase3-EA-S1v2-USDJPY-M15-0,USDJPYMT4,3834,10h 30m,Buy
151280.02,130287,08.07.2016 04:19:57,tp 130.287,0.0,-52.09999999997672,0.0,0.0,129897,08.07.2016 02:50:00,13367,-0.02158850632894472,88.98,IS,0.23,0.0,Phase3-EA-S4v1-GBPJPY-M5-194,GBPJPYMT4,2928,1h 29m,Buy
151260.46,0.97831,08.07.2016 05:30:00,,0.0,-71.65999999997439,0.0,0.0,0.97864,08.07.2016 01:15:00,13368,-0.029693519453595336,-19.56,IS,0.58,0.0,Phase3-EA-SA2v2-USDCHF-M15-107,USDCHFMT4,2612,4h 15m,Buy
151220.65,1.0833,08.07.2016 07:15:00,,-2.09,-111.46999999997206,0.0,0.0,1.0824,07.07.2016 22:55:00,13369,-0.04618945874257083,-39.81,IS,0.41,0.0,Phase3-EA-SA2v2-EURCHF-M5-43,EURCHFMT4,6830,8h 20m,Sell
151179.37,1.08447,08.07.2016 14:45:00,,0.0,-152.7499999999709,0.0,0.0,1.08328,08.07.2016 06:00:00,13370,-0.06329451711606816,-41.28,IS,0.34,0.0,Phase3-EA-S4v1-EURCHF-M15-221,EURCHFMT4,3488,8h 45m,Sell
151109.72,110927,08.07.2016 17:29:58,sl 110.927,0.0,-222.39999999996508,0.0,0.0,111707,08.07.2016 05:00:00,13371,-0.09215515945410167,-69.65,IS,0.09,0.0,Phase3-EA-TR1v1-EURJPY-M30-91,EURJPYMT4,2400,12h 29m,Buy
151155.62,1.08635,11.07.2016 02:04:57,tp 1.08635,0.0,-176.4999999999709,0.0,0.0,1.08525,11.07.2016 01:05:00,13372,-0.0731357268149677,45.9,IS,0.41,0.0,Phase3-EA-SA2v2-EURCHF-M5-43,EURCHFMT4,6832,59m 57s,Buy
151115.8,111912,11.07.2016 09:14:58,sl 111.912,-1.18,-216.31999999997788,0.0,0.0,111682,07.07.2016 18:45:00,13373,-0.0896358097711887,-39.82,IS,0.17,0.0,Phase3-EA-T1v2-EURJPY-M15-322,EURJPYMT4,2542,3d 14h 29m,Sell
150894.86,101432,11.07.2016 09:14:58,sl 101.432,0.0,-437.2599999999802,0.0,0.0,100602,11.07.2016 01:00:00,13374,-0.18118599380802608,-220.94,IS,0.27,0.0,Phase3-EA-S1v2-USDJPY-M15-0,USDJPYMT4,3836,8h 14m,Sell
150912.15,1.08596,11.07.2016 10:00:00,,0.0,-419.96999999997206,0.0,0.0,1.08546,11.07.2016 01:15:00,13375,-0.17402159314722385,17.29,IS,0.34,0.0,Phase3-EA-S4v1-EURCHF-M15-221,EURCHFMT4,3490,8h 45m,Buy
151026.14,112409,11.07.2016 10:29:58,tp 112.409,-0.44,-305.9799999999814,0.0,0.0,111119,08.07.2016 20:30:00,13376,-0.12678793025975155,113.99,IS,0.09,0.0,Phase3-EA-TR1v1-EURJPY-M30-91,EURJPYMT4,2402,2d 13h 59m,Buy
151136.52,113.62,11.07.2016 20:59:58,tp 113.620,0.0,-195.59999999997672,0.0,0.0,112.36,11.07.2016 11:30:00,13377,-0.08105013124650617,110.38,IS,0.09,0.0,Phase3-EA-TR1v1-EURJPY-M30-91,EURJPYMT4,2404,9h 29m,Buy
151144.07,0.98257,12.07.2016 02:15:00,,-0.71,-188.04999999998836,0.0,0.0,0.98243,11.07.2016 22:00:00,13378,-0.07792166247907135,7.55,IS,0.58,0.0,Phase3-EA-SA2v2-USDCHF-M15-107,USDCHFMT4,2614,4h 15m,Buy
151231.53,133571,12.07.2016 04:49:58,tp 133.571,0.0,-100.58999999999651,0.0,0.0,133181,12.07.2016 03:35:00,13379,-0.04168114878367456,87.46,IS,0.23,0.0,Phase3-EA-S4v1-GBPJPY-M5-194,GBPJPYMT4,2930,1h 14m,Buy
151291.81,103016,12.07.2016 05:15:00,,0.0,-40.30999999999767,0.0,0.0,102786,12.07.2016 01:30:00,13380,-0.016703122651057587,60.28,IS,0.27,0.0,Phase3-EA-S1v2-USDJPY-M15-0,USDJPYMT4,3838,3h 45m,Buy
151453.42,134.7,12.07.2016 06:29:58,tp 134.700,-0.31,-0.0,0.0,0.0,132.85,11.07.2016 15:00:00,13381,-0.0,161.61,IS,0.09,0.0,Phase3-EA-B1v1-GBPJPY-M30-1,GBPJPYMT4,1238,15h 29m,Buy
151342.46,1.08897,12.07.2016 07:40:00,,-2.09,-110.95999999999185,0.0,0.0,1.08636,11.07.2016 23:20:00,13382,-0.04595503348015999,-110.96,IS,0.41,0.0,Phase3-EA-SA2v2-EURCHF-M5-43,EURCHFMT4,6834,8h 20m,Sell
151451.88,114835,12.07.2016 11:29:58,tp 114.835,-0.43,-1.5399999999790452,0.0,0.0,113575,11.07.2016 21:00:00,13383,-6.378041777080804E-4,109.42,IS,0.09,0.0,Phase3-EA-TR1v1-EURJPY-M30-91,EURJPYMT4,2406,14h 29m,Buy
151612.87,136954,12.07.2016 13:59:58,tp 136.954,0.0,-0.0,0.0,0.0,135104,12.07.2016 10:30:00,13384,-0.0,160.99,IS,0.09,0.0,Phase3-EA-B1v1-GBPJPY-M30-1,GBPJPYMT4,1240,3h 29m,Buy
151544.99,115.22,12.07.2016 13:59:58,sl 115.220,0.0,-67.88000000000466,0.0,0.0,114.44,12.07.2016 12:00:00,13385,-0.028094529898181467,-67.88,IS,0.09,0.0,Phase3-EA-TR1v1-EURJPY-M30-91,EURJPYMT4,2408,1h 59m,Sell
151515.22,1.08952,12.07.2016 15:00:00,,0.0,-97.64999999999418,0.0,0.0,1.08866,12.07.2016 06:15:00,13386,-0.04041589340832452,-29.77,IS,0.34,0.0,Phase3-EA-S4v1-EURCHF-M15-221,EURCHFMT4,3492,8h 45m,Sell
151792.22,115761,12.07.2016 17:29:57,tp 115.761,0.0,-0.0,0.0,0.0,114061,12.07.2016 05:30:00,13387,-0.0,277.0,IS,0.17,0.0,Phase3-EA-T1v2-EURJPY-M15-322,EURJPYMT4,2544,11h 59m,Buy
151951.27,138995,12.07.2016 20:29:58,tp 138.995,0.0,-0.0,0.0,0.0,137145,12.07.2016 17:00:00,13388,-0.0,159.05,IS,0.09,0.0,Phase3-EA-B1v1-GBPJPY-M30-1,GBPJPYMT4,1242,3h 29m,Buy
151996.87,1.09311,13.07.2016 01:04:57,tp 1.09311,0.0,-0.0,0.0,0.0,1.09421,13.07.2016 00:35:00,13389,-0.0,45.6,IS,0.41,0.0,Phase3-EA-SA2v2-EURCHF-M5-43,EURCHFMT4,6836,29m 57s,Sell
152082.51,138775,13.07.2016 04:04:58,tp 138.775,0.0,-0.0,0.0,0.0,139165,13.07.2016 03:40:00,13390,-0.0,85.64,IS,0.23,0.0,Phase3-EA-S4v1-GBPJPY-M5-194,GBPJPYMT4,2932,24m 58s,Sell
152024.94,138435,13.07.2016 04:29:58,sl 138.435,0.0,-57.570000000006985,0.0,0.0,139105,13.07.2016 03:30:00,13391,-0.023781148006110274,-57.57,IS,0.09,0.0,Phase3-EA-B1v1-GBPJPY-M30-1,GBPJPYMT4,1244,59m 58s,Buy
152040.78,0.98888,13.07.2016 05:00:00,,0.0,-41.73000000001048,0.0,0.0,0.98915,13.07.2016 00:45:00,13392,-0.017237924375457885,15.84,IS,0.58,0.0,Phase3-EA-SA2v2-USDCHF-M15-107,USDCHFMT4,2616,4h 15m,Sell
152024.61,1.09384,13.07.2016 09:45:00,,0.0,-57.90000000002328,0.0,0.0,1.09337,13.07.2016 01:00:00,13393,-0.023917465165088962,-16.17,IS,0.34,0.0,Phase3-EA-S4v1-EURCHF-M15-221,EURCHFMT4,3494,8h 45m,Sell
151936.41,104.39,13.07.2016 11:30:00,,0.0,-146.10000000003492,0.0,0.0,104731,13.07.2016 00:30:00,13394,-0.06035132401759805,-88.2,IS,0.27,0.0,Phase3-EA-S1v2-USDJPY-M15-0,USDJPYMT4,3840,11h 0m,Buy
151899.0,115716,13.07.2016 16:29:58,sl 115.716,0.0,-183.51000000003842,0.0,0.0,115946,13.07.2016 13:45:00,13395,-0.07580473285742019,-37.41,IS,0.17,0.0,Phase3-EA-T1v2-EURJPY-M15-322,EURJPYMT4,2546,2h 44m,Buy
151866.24,104437,14.07.2016 01:00:00,,-2.25,-216.27000000004773,0.0,0.0,104555,13.07.2016 17:15:00,13396,-0.08933730900263992,-32.76,IS,0.27,0.0,Phase3-EA-S1v2-USDJPY-M15-0,USDJPYMT4,3842,7h 45m,Buy
151815.04,0.98443,14.07.2016 03:45:00,,-9.37,-267.4700000000594,0.0,0.0,0.98372,13.07.2016 23:30:00,13397,-0.11048712275829346,-51.2,IS,0.58,0.0,Phase3-EA-SA2v2-USDCHF-M15-107,USDCHFMT4,2618,4h 15m,Sell
151901.03,137385,14.07.2016 06:04:58,tp 137.385,0.0,-181.48000000006869,0.0,0.0,136995,14.07.2016 02:20:00,13398,-0.07496617578860522,85.99,IS,0.23,0.0,Phase3-EA-S4v1-GBPJPY-M5-194,GBPJPYMT4,2934,3h 44m,Buy
151888.11,1.09251,14.07.2016 08:30:00,,0.0,-194.4000000000815,0.0,0.0,1.0922,14.07.2016 00:10:00,13399,-0.0803031991035125,-12.92,IS,0.41,0.0,Phase3-EA-SA2v2-EURCHF-M5-43,EURCHFMT4,6838,8h 20m,Sell
151994.78,116477,14.07.2016 09:59:58,tp 116.477,-1.69,-87.73000000006869,0.0,0.0,115217,12.07.2016 14:30:00,13400,-0.0362397101715726,106.67,IS,0.09,0.0,Phase3-EA-TR1v1-EURJPY-M30-91,EURJPYMT4,2410,1d 19h 29m,Buy
152267.76,117726,14.07.2016 14:14:57,tp 117.726,0.0,-0.0,0.0,0.0,116026,14.07.2016 06:30:00,13401,-0.0,272.98,IS,0.17,0.0,Phase3-EA-T1v2-EURJPY-M15-322,EURJPYMT4,2548,7h 44m,Buy
152210.73,139501,14.07.2016 14:59:58,sl 139.501,0.0,-57.029999999998836,0.0,0.0,140171,14.07.2016 14:00:00,13402,-0.023540069879706062,-57.03,IS,0.09,0.0,Phase3-EA-B1v1-GBPJPY-M30-1,GBPJPYMT4,1246,59m 58s,Buy
152153.76,140504,14.07.2016 17:59:58,sl 140.504,0.0,-114.0,0.0,0.0,141174,14.07.2016 15:30:00,13403,-0.047055373773216655,-56.97,IS,0.09,0.0,Phase3-EA-B1v1-GBPJPY-M30-1,GBPJPYMT4,1248,2h 29m,Buy
152199.75,1.09046,14.07.2016 21:14:58,tp 1.09046,0.0,-68.01000000000931,0.0,0.0,1.08936,14.07.2016 20:25:00,13404,-0.028072245353657044,45.99,IS,0.41,0.0,Phase3-EA-SA2v2-EURCHF-M5-43,EURCHFMT4,6840,49m 58s,Buy
152229.1,105361,15.07.2016 02:00:00,,-1.15,-38.66000000000349,0.0,0.0,105.48,14.07.2016 23:15:00,13405,-0.015957550439234386,29.35,IS,0.27,0.0,Phase3-EA-S1v2-USDJPY-M15-0,USDJPYMT4,3844,2h 45m,Sell
152313.13,140173,15.07.2016 03:49:58,tp 140.173,-1.27,-0.0,0.0,0.0,140563,14.07.2016 23:00:00,13406,-0.0,84.03,IS,0.23,0.0,Phase3-EA-S4v1-GBPJPY-M5-194,GBPJPYMT4,2936,4h 49m,Sell
152314.8,1.09027,15.07.2016 09:20:00,,0.0,-0.0,0.0,0.0,1.09031,15.07.2016 01:00:00,13407,-0.0,1.67,IS,0.41,0.0,Phase3-EA-SA2v2-EURCHF-M5-43,EURCHFMT4,6842,8h 20m,Sell
152378.81,117623,15.07.2016 16:15:00,,0.0,-0.0,0.0,0.0,117225,15.07.2016 05:30:00,13408,-0.0,64.01,IS,0.17,0.0,Phase3-EA-T1v2-EURJPY-M15-322,EURJPYMT4,2550,10h 45m,Buy
152317.07,116616,15.07.2016 20:29:58,sl 116.616,-0.42,-61.73999999999069,0.0,0.0,117336,14.07.2016 14:30:00,13409,-0.025472523773835836,-61.74,IS,0.09,0.0,Phase3-EA-TR1v1-EURJPY-M30-91,EURJPYMT4,2412,1d 5h 59m,Buy
152371.03,105338,18.07.2016 01:00:00,,-1.15,-7.779999999998836,0.0,0.0,105553,15.07.2016 23:45:00,13410,-0.0032098515542669753,53.96,IS,0.27,0.0,Phase3-EA-S1v2-USDJPY-M15-0,USDJPYMT4,3846,2d 1h 15m,Sell
152416.93,1.08599,18.07.2016 02:04:57,tp 1.08599,0.0,-0.0,0.0,0.0,1.08489,18.07.2016 01:05:00,13411,-0.0,45.9,IS,0.41,0.0,Phase3-EA-SA2v2-EURCHF-M5-43,EURCHFMT4,6844,59m 57s,Buy
152501.85,139775,18.07.2016 02:59:58,tp 139.775,0.0,-0.0,0.0,0.0,140165,18.07.2016 02:30:00,13412,-0.0,84.92,IS,0.23,0.0,Phase3-EA-S4v1-GBPJPY-M5-194,GBPJPYMT4,2938,29m 58s,Sell
152509.02,105408,18.07.2016 09:15:00,,0.0,-0.0,0.0,0.0,105436,18.07.2016 01:45:00,13413,-0.0,7.17,IS,0.27,0.0,Phase3-EA-S1v2-USDJPY-M15-0,USDJPYMT4,3848,7h 30m,Sell
152604.14,1.08793,18.07.2016 10:00:00,,0.0,-0.0,0.0,0.0,1.08518,18.07.2016 01:15:00,13414,-0.0,95.12,IS,0.34,0.0,Phase3-EA-S4v1-EURCHF-M15-221,EURCHFMT4,3496,8h 45m,Buy
152567.07,116.8,18.07.2016 18:14:58,sl 116.800,0.0,-37.070000000006985,0.0,0.0,116.57,18.07.2016 17:15:00,13415,-0.015280036029066447,-37.07,IS,0.17,0.0,Phase3-EA-T1v2-EURJPY-M15-322,EURJPYMT4,2552,59m 58s,Sell
152611.97,1.08839,19.07.2016 02:44:57,tp 1.08839,-1.0,-0.0,0.0,0.0,1.08729,18.07.2016 21:45:00,13416,-0.0,44.9,IS,0.41,0.0,Phase3-EA-SA2v2-EURCHF-M5-43,EURCHFMT4,6846,4h 59m,Buy
152632.59,106.06,19.07.2016 04:15:00,,0.0,-0.0,0.0,0.0,106141,19.07.2016 01:00:00,13417,-0.0,20.62,IS,0.27,0.0,Phase3-EA-S1v2-USDJPY-M15-0,USDJPYMT4,3850,3h 15m,Sell
152652.05,117127,19.07.2016 05:30:00,,-0.78,-0.0,0.0,0.0,117001,18.07.2016 18:45:00,13418,-0.0,19.46,IS,0.17,0.0,Phase3-EA-T1v2-EURJPY-M15-322,EURJPYMT4,2554,10h 45m,Buy
152615.2,117094,19.07.2016 15:59:58,sl 117.094,0.0,-36.85000000000582,0.0,0.0,117324,19.07.2016 12:45:00,13419,-0.015186354287963217,-36.85,IS,0.17,0.0,Phase3-EA-T1v2-EURJPY-M15-322,EURJPYMT4,2556,3h 14m,Buy
152578.41,117413,19.07.2016 16:44:57,sl 117.413,0.0,-73.64000000001397,0.0,0.0,117183,19.07.2016 16:15:00,13420,-0.030347981811822165,-36.79,IS,0.17,0.0,Phase3-EA-T1v2-EURJPY-M15-322,EURJPYMT4,2558,29m 57s,Sell
152624.21,1.08491,20.07.2016 01:04:58,tp 1.08491,0.0,-27.84000000002561,0.0,0.0,1.08601,20.07.2016 00:35:00,13421,-0.011473218544836312,45.8,IS,0.41,0.0,Phase3-EA-SA2v2-EURCHF-M5-43,EURCHFMT4,6848,29m 58s,Sell
152643.31,106003,20.07.2016 04:30:00,,0.0,-8.74000000001979,0.0,0.0,106078,20.07.2016 00:15:00,13422,-0.00360186530466969,19.1,IS,0.27,0.0,Phase3-EA-S1v2-USDJPY-M15-0,USDJPYMT4,3852,4h 15m,Sell
152606.43,116839,20.07.2016 09:14:57,sl 116.839,0.0,-45.62000000002445,0.0,0.0,116609,20.07.2016 05:00:00,13423,-0.01880058297468504,-36.88,IS,0.17,0.0,Phase3-EA-T1v2-EURJPY-M15-322,EURJPYMT4,2560,4h 14m,Sell
152597.81,1.08576,20.07.2016 09:45:00,,0.0,-54.24000000001979,0.0,0.0,1.08551,20.07.2016 01:00:00,13424,-0.0223529947511342,-8.62,IS,0.34,0.0,Phase3-EA-S4v1-EURCHF-M15-221,EURCHFMT4,3498,8h 45m,Sell
152614.44,1.08594,20.07.2016 10:45:00,,0.0,-37.610000000015134,0.0,0.0,1.08634,20.07.2016 02:25:00,13425,-0.015499559966633275,16.63,IS,0.41,0.0,Phase3-EA-SA2v2-EURCHF-M5-43,EURCHFMT4,6850,8h 20m,Sell
152641.28,106624,20.07.2016 18:45:00,,0.0,-10.770000000018626,0.0,0.0,106518,20.07.2016 17:45:00,13426,-0.004438454156896089,26.84,IS,0.27,0.0,Phase3-EA-S1v2-USDJPY-M15-0,USDJPYMT4,3854,1h 0m,Buy
152575.38,117907,20.07.2016 23:59:58,sl 117.907,-0.3,-76.6700000000128,0.0,0.0,117127,19.07.2016 05:30:00,13427,-0.0315966833991357,-65.9,IS,0.09,0.0,Phase3-EA-TR1v1-EURJPY-M30-91,EURJPYMT4,2414,1d 18h 29m,Sell
152655.52,140941,21.07.2016 00:09:57,tp 140.941,-3.74,-0.0,0.0,0.0,141331,20.07.2016 23:35:00,13428,-0.0,80.14,IS,0.23,0.0,Phase3-EA-S4v1-GBPJPY-M5-194,GBPJPYMT4,2940,34m 57s,Sell
152739.23,141581,21.07.2016 02:24:58,tp 141.581,0.0,-0.0,0.0,0.0,141971,21.07.2016 01:15:00,13429,-0.0,83.71,IS,0.23,0.0,Phase3-EA-S4v1-GBPJPY-M5-194,GBPJPYMT4,2942,1h 9m,Sell
152822.86,141864,21.07.2016 03:59:58,tp 141.864,0.0,-0.0,0.0,0.0,142254,21.07.2016 03:55:00,13430,-0.0,83.63,IS,0.23,0.0,Phase3-EA-S4v1-GBPJPY-M5-194,GBPJPYMT4,2944,4m 58s,Sell
152932.34,116733,21.07.2016 13:29:57,tp 116.733,0.0,-0.0,0.0,0.0,118023,21.07.2016 11:30:00,13431,-0.0,109.48,IS,0.09,0.0,Phase3-EA-TR1v1-EURJPY-M30-91,EURJPYMT4,2416,1h 59m,Sell
153002.11,106035,21.07.2016 20:15:00,,0.0,-0.0,0.0,0.0,106309,21.07.2016 17:15:00,13432,-0.0,69.77,IS,0.27,0.0,Phase3-EA-S1v2-USDJPY-M15-0,USDJPYMT4,3856,3h 0m,Sell
153017.15,106097,22.07.2016 01:45:00,,-0.74,-0.0,0.0,0.0,106035,21.07.2016 20:15:00,13433,-0.0,15.04,IS,0.27,0.0,Phase3-EA-S1v2-USDJPY-M15-0,USDJPYMT4,3858,5h 30m,Buy
152948.16,0.9853,22.07.2016 03:00:00,,-0.71,-68.98999999999069,0.0,0.0,0.98646,21.07.2016 22:45:00,13434,-0.02838894292027964,-68.99,IS,0.58,0.0,Phase3-EA-SA2v2-USDCHF-M15-107,USDCHFMT4,2620,4h 15m,Buy
153032.91,139.92,22.07.2016 03:09:57,tp 139.920,0.0,-0.0,0.0,0.0,140.31,22.07.2016 02:00:00,13435,-0.0,84.75,IS,0.23,0.0,Phase3-EA-S4v1-GBPJPY-M5-194,GBPJPYMT4,2946,1h 9m,Sell
153135.09,105697,22.07.2016 04:14:57,tp 105.697,0.0,-0.0,0.0,0.0,106097,22.07.2016 01:45:00,13436,-0.0,102.18,IS,0.27,0.0,Phase3-EA-S1v2-USDJPY-M15-0,USDJPYMT4,3860,2h 29m,Sell
153123.27,1.0866,22.07.2016 04:40:00,,-1.0,-11.820000000006985,0.0,0.0,1.08686,21.07.2016 20:20:00,13437,-0.004861494899813486,-11.82,IS,0.41,0.0,Phase3-EA-SA2v2-EURCHF-M5-43,EURCHFMT4,6852,8h 20m,Buy
153086.32,116827,22.07.2016 10:29:58,sl 116.827,0.0,-48.77000000001863,0.0,0.0,116597,22.07.2016 05:00:00,13438,-0.02005880763653588,-36.95,IS,0.17,0.0,Phase3-EA-T1v2-EURJPY-M15-322,EURJPYMT4,2562,5h 29m,Sell
153044.32,1.32021,22.07.2016 12:59:57,sl 1.32021,0.0,-90.77000000001863,0.0,0.0,1.32321,22.07.2016 06:00:00,13439,-0.037333154996269026,-42.0,IS,0.14,0.0,Phase3-EA-B1v1-GBPUSD-M30-14,GBPUSDMT4,876,6h 59m,Buy
153078.62,106257,22.07.2016 19:00:00,,0.0,-56.47000000003027,0.0,0.0,106122,22.07.2016 17:00:00,13440,-0.023225771319158414,34.3,IS,0.27,0.0,Phase3-EA-S1v2-USDJPY-M15-0,USDJPYMT4,3862,2h 0m,Buy
153060.89,0.98794,25.07.2016 02:30:00,,-0.7,-74.20000000004075,0.0,0.0,0.98823,22.07.2016 22:15:00,13441,-0.03051801366887864,-17.73,IS,0.58,0.0,Phase3-EA-SA2v2-USDCHF-M15-107,USDCHFMT4,2622,2d 4h 15m,Buy
153023.38,1.0837,25.07.2016 04:25:00,,-1.0,-111.71000000005006,0.0,0.0,1.08458,22.07.2016 20:05:00,13442,-0.04594565103706319,-37.51,IS,0.41,0.0,Phase3-EA-SA2v2-EURCHF-M5-43,EURCHFMT4,6854,2d 8h 20m,Buy
152986.06,116895,25.07.2016 04:59:58,sl 116.895,-0.56,-149.03000000005704,0.0,0.0,116665,22.07.2016 17:45:00,13443,-0.06129514254814322,-37.32,IS,0.17,0.0,Phase3-EA-T1v2-EURJPY-M15-322,EURJPYMT4,2564,2d 11h 14m,Sell
152949.2,116528,25.07.2016 16:44:58,sl 116.528,0.0,-185.89000000004307,0.0,0.0,116758,25.07.2016 13:15:00,13444,-0.07645543882622709,-36.86,IS,0.17,0.0,Phase3-EA-T1v2-EURJPY-M15-322,EURJPYMT4,2566,3h 29m,Buy
152774.38,137975,26.07.2016 04:14:58,sl 137.975,0.0,-360.71000000005006,0.0,0.0,138775,26.07.2016 02:50:00,13445,-0.14835785324119538,-174.82,IS,0.23,0.0,Phase3-EA-S4v1-GBPJPY-M5-194,GBPJPYMT4,2948,1h 24m,Buy
152707.08,115819,26.07.2016 04:29:58,sl 115.819,-0.84,-428.0100000000384,0.0,0.0,116599,22.07.2016 05:00:00,13446,-0.17603793841523918,-67.3,IS,0.09,0.0,Phase3-EA-TR1v1-EURJPY-M30-91,EURJPYMT4,2418,3d 23h 29m,Buy
152814.54,115184,26.07.2016 05:29:57,tp 115.184,-0.6,-320.55000000004657,0.0,0.0,116444,22.07.2016 21:00:00,13447,-0.13184028681341103,107.46,IS,0.09,0.0,Phase3-EA-TR1v1-EURJPY-M30-91,EURJPYMT4,2419,3d 8h 29m,Sell
152830.76,1.08357,26.07.2016 08:35:00,,0.0,-304.3300000000454,0.0,0.0,1.08396,26.07.2016 00:15:00,13448,-0.1251690983806755,16.22,IS,0.41,0.0,Phase3-EA-SA2v2-EURCHF-M5-43,EURCHFMT4,6856,8h 20m,Sell
152868.06,1.08437,26.07.2016 13:45:00,,0.0,-267.03000000005704,0.0,0.0,1.08329,26.07.2016 05:00:00,13449,-0.10982783274929825,37.3,IS,0.34,0.0,Phase3-EA-S4v1-EURCHF-M15-221,EURCHFMT4,3500,8h 45m,Buy
152911.43,1.08929,27.07.2016 01:00:00,tp 1.08929,-2.07,-223.6600000000617,0.0,0.0,1.09039,26.07.2016 21:05:00,13450,-0.09199001263045191,43.37,IS,0.41,0.0,Phase3-EA-SA2v2-EURCHF-M5-43,EURCHFMT4,6858,3h 55m,Sell
152996.3,137751,27.07.2016 03:19:58,tp 137.751,-0.79,-138.79000000006636,0.0,0.0,137361,26.07.2016 23:05:00,13451,-0.057083492144250216,84.87,IS,0.23,0.0,Phase3-EA-S4v1-GBPJPY-M5-194,GBPJPYMT4,2950,4h 14m,Buy
152958.96,115151,27.07.2016 03:29:58,sl 115.151,0.0,-176.13000000006286,0.0,0.0,114921,27.07.2016 00:30:00,13452,-0.07244120953502105,-37.34,IS,0.17,0.0,Phase3-EA-T1v2-EURJPY-M15-322,EURJPYMT4,2568,2h 59m,Sell
153013.59,104821,27.07.2016 03:30:00,,-0.75,-121.50000000005821,0.0,0.0,104606,26.07.2016 23:00:00,13453,-0.049972219147823384,54.63,IS,0.27,0.0,Phase3-EA-S1v2-USDJPY-M15-0,USDJPYMT4,3864,4h 30m,Buy
152951.67,115838,27.07.2016 06:59:58,sl 115.838,-0.3,-183.420000000071,0.0,0.0,115118,26.07.2016 06:30:00,13454,-0.07543954268389237,-61.92,IS,0.09,0.0,Phase3-EA-TR1v1-EURJPY-M30-91,EURJPYMT4,2422,1d 0h 29m,Sell
152777.22,138578,27.07.2016 07:04:59,sl 138.578,0.0,-357.87000000008265,0.0,0.0,137778,27.07.2016 03:45:00,13455,-0.14718977832450303,-174.45,IS,0.23,0.0,Phase3-EA-S4v1-GBPJPY-M5-194,GBPJPYMT4,2952,3h 19m,Sell
152740.16,115.98,27.07.2016 22:14:57,sl 115.980,0.0,-394.9300000000803,0.0,0.0,116.21,27.07.2016 15:45:00,13456,-0.1624323333995428,-37.06,IS,0.17,0.0,Phase3-EA-T1v2-EURJPY-M15-322,EURJPYMT4,2570,6h 29m,Buy
152757.77,105773,27.07.2016 22:15:00,,0.0,-377.3200000000943,0.0,0.0,105704,27.07.2016 20:30:00,13457,-0.15518944632800327,17.61,IS,0.27,0.0,Phase3-EA-S1v2-USDJPY-M15-0,USDJPYMT4,3866,1h 45m,Buy
152816.58,0.98616,28.07.2016 01:44:59,tp 0.98616,0.0,-318.5100000000966,0.0,0.0,0.98516,28.07.2016 01:15:00,13458,-0.1310012470845303,58.81,IS,0.58,0.0,Phase3-EA-SA2v2-USDCHF-M15-107,USDCHFMT4,2624,29m 59s,Buy
152901.85,138945,28.07.2016 02:54:57,tp 138.945,0.0,-233.2400000001071,0.0,0.0,139335,28.07.2016 01:10:00,13459,-0.09593020900442877,85.27,IS,0.23,0.0,Phase3-EA-S4v1-GBPJPY-M5-194,GBPJPYMT4,2954,1h 44m,Sell
152944.59,1.09127,28.07.2016 06:09:58,tp 1.09127,-2.99,-190.50000000011642,0.0,0.0,1.09017,27.07.2016 23:55:00,13460,-0.07835150409598034,42.74,IS,0.41,0.0,Phase3-EA-SA2v2-EURCHF-M5-43,EURCHFMT4,6860,6h 14m,Buy
153037.74,1.09261,28.07.2016 10:15:00,,0.0,-97.35000000012224,0.0,0.0,1.08991,28.07.2016 01:30:00,13461,-0.040039469416003164,93.15,IS,0.34,0.0,Phase3-EA-S4v1-EURCHF-M15-221,EURCHFMT4,3502,8h 45m,Buy
153000.39,116285,28.07.2016 16:44:58,sl 116.285,0.0,-134.70000000012806,0.0,0.0,116055,28.07.2016 15:00:00,13462,-0.05540129974662539,-37.35,IS,0.17,0.0,Phase3-EA-T1v2-EURJPY-M15-322,EURJPYMT4,2572,1h 44m,Sell
152963.09,116088,28.07.2016 21:14:58,sl 116.088,0.0,-172.00000000011642,0.0,0.0,116318,28.07.2016 16:45:00,13463,-0.07074256537800265,-37.3,IS,0.17,0.0,Phase3-EA-T1v2-EURJPY-M15-322,EURJPYMT4,2574,4h 29m,Buy
152925.78,116296,28.07.2016 21:59:57,sl 116.296,0.0,-209.3100000001141,0.0,0.0,116066,28.07.2016 21:30:00,13464,-0.0860879439492313,-37.31,IS,0.17,0.0,Phase3-EA-T1v2-EURJPY-M15-322,EURJPYMT4,2576,29m 57s,Sell
152887.83,116273,29.07.2016 02:44:58,sl 116.273,-0.79,-247.26000000012573,0.0,0.0,116503,28.07.2016 22:00:00,13465,-0.10169655067070925,-37.95,IS,0.17,0.0,Phase3-EA-T1v2-EURJPY-M15-322,EURJPYMT4,2578,4h 44m,Buy
152973.85,137693,29.07.2016 02:44:58,tp 137.693,0.0,-161.2400000001362,0.0,0.0,137303,29.07.2016 02:40:00,13466,-0.06631704210204106,86.02,IS,0.23,0.0,Phase3-EA-S4v1-GBPJPY-M5-194,GBPJPYMT4,2956,4m 58s,Buy
152910.58,115279,29.07.2016 02:59:58,sl 115.279,-1.68,-224.51000000012573,0.0,0.0,115999,27.07.2016 07:00:00,13467,-0.09233961251752046,-63.27,IS,0.09,0.0,Phase3-EA-TR1v1-EURJPY-M30-91,EURJPYMT4,2424,1d 19h 59m,Buy
152865.19,1.08506,29.07.2016 05:20:00,,-1.0,-269.9000000001397,0.0,0.0,1.08612,28.07.2016 21:00:00,13468,-0.11100824648558066,-45.39,IS,0.41,0.0,Phase3-EA-SA2v2-EURCHF-M5-43,EURCHFMT4,6862,8h 20m,Buy
152817.56,1.08457,29.07.2016 11:45:00,,0.0,-317.53000000014435,0.0,0.0,1.08594,29.07.2016 03:00:00,13469,-0.13059817897948947,-47.63,IS,0.34,0.0,Phase3-EA-S4v1-EURCHF-M15-221,EURCHFMT4,3504,8h 45m,Buy
152877.43,0.96876,29.07.2016 23:44:58,tp 0.96876,0.0,-257.660000000149,0.0,0.0,0.96776,29.07.2016 23:30:00,13470,-0.10597400811217655,59.87,IS,0.58,0.0,Phase3-EA-SA2v2-USDCHF-M15-107,USDCHFMT4,2626,14m 58s,Buy
152817.97,135.66,01.08.2016 05:29:58,sl 135.660,-0.51,-317.12000000014086,0.0,0.0,134.99,29.07.2016 23:00:00,13471,-0.13042954844573826,-59.46,IS,0.09,0.0,Phase3-EA-B1v1-GBPJPY-M30-1,GBPJPYMT4,1250,2d 6h 29m,Sell
152754.46,114652,01.08.2016 06:29:58,sl 114.652,-0.31,-380.6300000001502,0.0,0.0,113932,29.07.2016 22:00:00,13472,-0.15655082941756715,-63.51,IS,0.09,0.0,Phase3-EA-TR1v1-EURJPY-M30-91,EURJPYMT4,2426,2d 8h 29m,Sell
152759.11,1.08291,01.08.2016 08:00:00,,-2.12,-375.980000000156,0.0,0.0,1.08307,29.07.2016 23:40:00,13473,-0.1546383123884562,4.65,IS,0.41,0.0,Phase3-EA-SA2v2-EURCHF-M5-43,EURCHFMT4,6864,2d 8h 20m,Sell
152669.44,102373,01.08.2016 09:00:00,,0.0,-465.6500000001688,0.0,0.0,102033,01.08.2016 01:15:00,13474,-0.19151904400149175,-89.67,IS,0.27,0.0,Phase3-EA-S1v2-USDJPY-M15-0,USDJPYMT4,3868,7h 45m,Sell
152659.68,0.96826,02.08.2016 04:00:00,,-3.17,-475.4100000001781,0.0,0.0,0.96815,01.08.2016 23:45:00,13475,-0.19553327329270975,-9.76,IS,0.58,0.0,Phase3-EA-SA2v2-USDCHF-M15-107,USDCHFMT4,2628,4h 15m,Sell
152620.9,114541,02.08.2016 05:59:58,sl 114.541,-0.58,-514.190000000177,0.0,0.0,114311,01.08.2016 11:45:00,13476,-0.21148325402152954,-38.78,IS,0.17,0.0,Phase3-EA-T1v2-EURJPY-M15-322,EURJPYMT4,2580,18h 14m,Sell
152636.58,1.08103,02.08.2016 09:00:00,,0.0,-498.51000000018394,0.0,0.0,1.08066,02.08.2016 00:40:00,13477,-0.20503416434056537,15.68,IS,0.41,0.0,Phase3-EA-SA2v2-EURCHF-M5-43,EURCHFMT4,6866,8h 20m,Buy
152658.14,100839,03.08.2016 08:00:00,,-1.2,-476.95000000018626,0.0,0.0,100924,02.08.2016 23:30:00,13478,-0.19616666602923666,21.56,IS,0.27,0.0,Phase3-EA-S1v2-USDJPY-M15-0,USDJPYMT4,3870,8h 30m,Sell
152619.38,113372,03.08.2016 08:59:58,sl 113.372,0.0,-515.7100000001956,0.0,0.0,113142,03.08.2016 08:15:00,13479,-0.21210842087836565,-38.76,IS,0.17,0.0,Phase3-EA-T1v2-EURJPY-M15-322,EURJPYMT4,2582,44m 58s,Sell
152637.64,1.08257,03.08.2016 09:30:00,,0.0,-497.45000000018626,0.0,0.0,1.08214,03.08.2016 01:10:00,13480,-0.20459819271672544,18.26,IS,0.41,0.0,Phase3-EA-SA2v2-EURCHF-M5-43,EURCHFMT4,6868,8h 20m,Buy
152595.64,1.3325,03.08.2016 16:29:58,sl 1.33250,0.0,-539.4500000001863,0.0,0.0,1.3355,03.08.2016 16:00:00,13481,-0.2218725400764586,-42.0,IS,0.14,0.0,Phase3-EA-B1v1-GBPUSD-M30-14,GBPUSDMT4,878,29m 58s,Buy
152621.34,0.9728,04.08.2016 02:30:00,,-9.48,-513.7500000001746,0.0,0.0,0.97339,03.08.2016 22:15:00,13482,-0.21130228466823614,25.7,IS,0.58,0.0,Phase3-EA-SA2v2-USDCHF-M15-107,USDCHFMT4,2630,4h 15m,Sell
152640.01,134788,04.08.2016 06:25:00,,0.0,-495.0800000001618,0.0,0.0,134.87,04.08.2016 01:00:00,13483,-0.20362342597284475,18.67,IS,0.23,0.0,Phase3-EA-S4v1-GBPJPY-M5-194,GBPJPYMT4,2958,5h 25m,Sell
152635.12,1.08426,04.08.2016 14:15:00,,0.0,-499.9700000001758,0.0,0.0,1.0844,04.08.2016 05:30:00,13484,-0.20563465355830512,-4.89,IS,0.34,0.0,Phase3-EA-S4v1-EURCHF-M15-221,EURCHFMT4,3506,8h 45m,Buy
152593.12,1.33017,04.08.2016 14:59:58,sl 1.33017,0.0,-541.9700000001758,0.0,0.0,1.33317,04.08.2016 14:30:00,13485,-0.22290900091803828,-42.0,IS,0.14,0.0,Phase3-EA-B1v1-GBPUSD-M30-14,GBPUSDMT4,880,29m 58s,Buy
152551.12,1.33003,04.08.2016 15:29:57,sl 1.33003,0.0,-583.9700000001758,0.0,0.0,1.32703,04.08.2016 15:00:00,13486,-0.2401833482777714,-42.0,IS,0.14,0.0,Phase3-EA-B1v1-GBPUSD-M30-14,GBPUSDMT4,882,29m 57s,Sell
152639.72,133.0,05.08.2016 04:09:58,tp 133.000,0.0,-495.37000000016997,0.0,0.0,132.61,05.08.2016 01:10:00,13487,-0.2037427012284272,88.6,IS,0.23,0.0,Phase3-EA-S4v1-GBPJPY-M5-194,GBPJPYMT4,2960,2h 59m,Buy
152668.59,1.08446,05.08.2016 06:05:00,,-1.01,-466.5000000001746,0.0,0.0,1.08375,04.08.2016 21:45:00,13488,-0.19186864388853636,28.87,IS,0.41,0.0,Phase3-EA-SA2v2-EURCHF-M5-43,EURCHFMT4,6870,8h 20m,Buy
152679.67,101145,05.08.2016 06:45:00,,-1.2,-455.42000000018743,0.0,0.0,101191,04.08.2016 21:45:00,13489,-0.18731150653745013,11.08,IS,0.27,0.0,Phase3-EA-S1v2-USDJPY-M15-0,USDJPYMT4,3872,9h 0m,Sell
152643.01,1.08523,05.08.2016 13:45:00,,0.0,-492.0800000001909,0.0,0.0,1.08418,05.08.2016 05:00:00,13490,-0.20238954401859005,-36.66,IS,0.34,0.0,Phase3-EA-S4v1-EURCHF-M15-221,EURCHFMT4,3508,8h 45m,Sell
152689.09,1.08666,05.08.2016 21:29:57,tp 1.08666,0.0,-446.0000000002037,0.0,0.0,1.08556,05.08.2016 20:05:00,13491,-0.18343711720105954,46.08,IS,0.41,0.0,Phase3-EA-SA2v2-EURCHF-M5-43,EURCHFMT4,6872,1h 24m,Buy
152733.35,101928,08.08.2016 01:00:00,,-0.77,-401.7400000001944,0.0,0.0,101758,05.08.2016 22:30:00,13492,-0.16523324543577503,44.26,IS,0.27,0.0,Phase3-EA-S1v2-USDJPY-M15-0,USDJPYMT4,3874,2d 2h 30m,Buy
152777.26,1.08598,08.08.2016 01:00:00,tp 1.08598,-2.09,-357.8300000001909,0.0,0.0,1.08708,05.08.2016 23:35:00,13493,-0.14717332656515733,43.91,IS,0.41,0.0,Phase3-EA-SA2v2-EURCHF-M5-43,EURCHFMT4,6874,2d 1h 25m,Sell
152836.57,0.97795,08.08.2016 01:14:57,tp 0.97795,0.0,-298.52000000019325,0.0,0.0,0.97895,08.08.2016 01:00:00,13494,-0.12277948032930656,59.31,IS,0.58,0.0,Phase3-EA-SA2v2-USDCHF-M15-107,USDCHFMT4,2632,14m 57s,Sell
152882.64,1.0864,08.08.2016 01:14:57,tp 1.08640,0.0,-252.45000000018626,0.0,0.0,1.0853,08.08.2016 01:10:00,13495,-0.10383116645161546,46.07,IS,0.41,0.0,Phase3-EA-SA2v2-EURCHF-M5-43,EURCHFMT4,6876,4m 57s,Buy
152815.54,102005,08.08.2016 07:45:00,,-1.19,-319.5500000001921,0.0,0.0,101756,05.08.2016 22:30:00,13496,-0.1314289928287153,-67.1,IS,0.27,0.0,Phase3-EA-S1v2-USDJPY-M15-0,USDJPYMT4,3875,2d 9h 15m,Sell
152825.91,133483,08.08.2016 08:30:00,,0.0,-309.18000000019674,0.0,0.0,133529,08.08.2016 03:05:00,13497,-0.12716387420680217,10.37,IS,0.23,0.0,Phase3-EA-S4v1-GBPJPY-M5-194,GBPJPYMT4,2962,5h 25m,Sell
152784.72,113446,08.08.2016 11:59:58,sl 113.446,-2.93,-350.37000000019907,0.0,0.0,113216,03.08.2016 16:00:00,13498,-0.14410507343888426,-41.19,IS,0.17,0.0,Phase3-EA-T1v2-EURJPY-M15-322,EURJPYMT4,2584,4d 19h 59m,Sell
152770.44,0.98282,09.08.2016 02:15:00,,-0.71,-364.6500000001979,0.0,0.0,0.98305,08.08.2016 22:00:00,13499,-0.14997835154119307,-14.28,IS,0.58,0.0,Phase3-EA-SA2v2-USDCHF-M15-107,USDCHFMT4,2634,4h 15m,Buy
152766.78,102487,09.08.2016 05:45:00,,-0.76,-368.3100000002014,0.0,0.0,102498,08.08.2016 21:45:00,13500,-0.1514836875253998,-3.66,IS,0.27,0.0,Phase3-EA-S1v2-USDJPY-M15-0,USDJPYMT4,3878,8h 0m,Buy
152785.8,1.0894,09.08.2016 05:55:00,,-1.0,-349.2900000002119,0.0,0.0,1.08892,08.08.2016 21:35:00,13501,-0.14366087593535354,19.02,IS,0.41,0.0,Phase3-EA-SA2v2-EURCHF-M5-43,EURCHFMT4,6878,8h 20m,Buy
152701.75,132999,09.08.2016 09:10:00,,0.0,-433.34000000020023,0.0,0.0,133373,09.08.2016 03:45:00,13502,-0.17823013535405283,-84.05,IS,0.23,0.0,Phase3-EA-S4v1-GBPJPY-M5-194,GBPJPYMT4,2964,5h 25m,Buy
152674.07,1.09035,09.08.2016 13:15:00,,0.0,-461.02000000019325,0.0,0.0,1.08955,09.08.2016 04:30:00,13503,-0.1896147528520836,-27.68,IS,0.34,0.0,Phase3-EA-S4v1-EURCHF-M15-221,EURCHFMT4,3510,8h 45m,Sell
152683.48,101864,10.08.2016 01:15:00,,-1.19,-451.61000000018976,0.0,0.0,101904,09.08.2016 23:15:00,13504,-0.18574447645553244,9.41,IS,0.27,0.0,Phase3-EA-S1v2-USDJPY-M15-0,USDJPYMT4,3880,2h 0m,Sell
152666.81,0.9815,10.08.2016 04:00:00,,-0.71,-468.28000000020256,0.0,0.0,0.98177,09.08.2016 23:45:00,13505,-0.19260074718141273,-16.67,IS,0.58,0.0,Phase3-EA-SA2v2-USDCHF-M15-107,USDCHFMT4,2636,4h 15m,Buy
152711.84,1.09192,10.08.2016 05:29:58,tp 1.09192,-1.0,-423.2500000002037,0.0,0.0,1.09082,09.08.2016 21:20:00,13506,-0.17408017904787074,45.03,IS,0.41,0.0,Phase3-EA-SA2v2-EURCHF-M5-43,EURCHFMT4,6880,8h 9m,Buy
152761.12,1.09216,10.08.2016 10:00:00,,0.0,-373.9700000002049,0.0,0.0,1.09074,10.08.2016 01:15:00,13507,-0.15381161147911768,49.28,IS,0.34,0.0,Phase3-EA-S4v1-EURCHF-M15-221,EURCHFMT4,3512,8h 45m,Buy
152749.25,101255,11.08.2016 00:45:00,,-3.6,-385.84000000020023,0.0,0.0,101224,10.08.2016 18:15:00,13508,-0.15869367107816415,-11.87,IS,0.27,0.0,Phase3-EA-S1v2-USDJPY-M15-0,USDJPYMT4,3882,6h 30m,Sell
152669.11,0.97411,11.08.2016 02:45:00,,-2.14,-465.9800000002142,0.0,0.0,0.97542,10.08.2016 22:30:00,13509,-0.19165477101647976,-80.14,IS,0.58,0.0,Phase3-EA-SA2v2-USDCHF-M15-107,USDCHFMT4,2638,4h 15m,Buy
152634.5,1.08951,11.08.2016 04:30:00,,-3.03,-500.59000000020023,0.0,0.0,1.09026,10.08.2016 20:10:00,13510,-0.20588965582886362,-34.61,IS,0.41,0.0,Phase3-EA-SA2v2-EURCHF-M5-43,EURCHFMT4,6882,8h 20m,Buy
152669.74,131758,11.08.2016 06:40:00,,0.0,-465.35000000020955,0.0,0.0,131603,11.08.2016 01:15:00,13511,-0.19139565580608184,35.24,IS,0.23,0.0,Phase3-EA-S4v1-GBPJPY-M5-194,GBPJPYMT4,2966,5h 25m,Buy
152628.98,113512,11.08.2016 21:59:58,sl 113.512,-2.34,-506.11000000021886,0.0,0.0,113282,09.08.2016 14:15:00,13512,-0.20815999862472193,-40.76,IS,0.17,0.0,Phase3-EA-T1v2-EURJPY-M15-322,EURJPYMT4,2586,2d 7h 44m,Sell
152614.53,0.97526,12.08.2016 02:30:00,,-3.15,-520.5600000002305,0.0,0.0,0.97507,11.08.2016 22:15:00,13513,-0.21410319670444442,-14.45,IS,0.58,0.0,Phase3-EA-SA2v2-USDCHF-M15-107,USDCHFMT4,2640,4h 15m,Sell
152547.31,113886,12.08.2016 11:29:58,sl 113.886,-3.72,-587.7800000002317,0.0,0.0,113166,02.08.2016 20:00:00,13514,-0.24175037835971305,-67.22,IS,0.09,0.0,Phase3-EA-TR1v1-EURJPY-M30-91,EURJPYMT4,2428,9d 15h 29m,Sell
152709.46,130944,12.08.2016 18:29:57,tp 130.944,-2.57,-425.6300000002375,0.0,0.0,132794,09.08.2016 11:00:00,13515,-0.17505905873160285,162.15,IS,0.09,0.0,Phase3-EA-B1v1-GBPJPY-M30-1,GBPJPYMT4,1252,3d 7h 29m,Sell
152745.19,101248,12.08.2016 23:00:00,,0.0,-389.900000000227,0.0,0.0,101114,12.08.2016 22:15:00,13516,-0.1603635246562827,35.73,IS,0.27,0.0,Phase3-EA-S1v2-USDJPY-M15-0,USDJPYMT4,3884,45m 0s,Buy
152801.59,0.97394,15.08.2016 01:00:00,tp 0.97394,-3.15,-333.50000000023283,0.0,0.0,0.97494,12.08.2016 23:00:00,13517,-0.13716654391607203,56.4,IS,0.58,0.0,Phase3-EA-SA2v2-USDCHF-M15-107,USDCHFMT4,2642,2d 2h 0m,Sell
152845.77,1.08724,15.08.2016 01:00:00,tp 1.08724,-2.1,-289.3200000002398,0.0,0.0,1.08834,12.08.2016 21:25:00,13518,-0.11899557566957465,44.18,IS,0.41,0.0,Phase3-EA-SA2v2-EURCHF-M5-43,EURCHFMT4,6884,2d 3h 35m,Sell
152867.61,130772,15.08.2016 04:40:00,,-1.32,-267.4800000002433,0.0,0.0,130874,12.08.2016 23:15:00,13519,-0.11001291504251486,21.84,IS,0.23,0.0,Phase3-EA-S4v1-GBPJPY-M5-194,GBPJPYMT4,2968,2d 5h 25m,Sell
152822.16,101278,15.08.2016 09:45:00,,-1.2,-312.93000000025495,0.0,0.0,101112,12.08.2016 22:15:00,13520,-0.12870622664965942,-45.45,IS,0.27,0.0,Phase3-EA-S1v2-USDJPY-M15-0,USDJPYMT4,3885,2d 11h 30m,Sell
152843.6,1.08863,15.08.2016 09:45:00,,0.0,-291.4900000002526,0.0,0.0,1.08812,15.08.2016 01:25:00,13521,-0.11988808361649946,21.44,IS,0.41,0.0,Phase3-EA-SA2v2-EURCHF-M5-43,EURCHFMT4,6886,8h 20m,Buy
152932.41,130029,16.08.2016 05:54:58,tp 130.029,0.0,-202.68000000025495,0.0,0.0,130419,16.08.2016 00:55:00,13522,-0.08336106483035993,88.81,IS,0.23,0.0,Phase3-EA-S4v1-GBPJPY-M5-194,GBPJPYMT4,2970,4h 59m,Sell
152954.59,1.08783,16.08.2016 06:45:00,,-1.01,-180.50000000026193,0.0,0.0,1.08728,15.08.2016 22:25:00,13523,-0.07423856424848468,22.18,IS,0.41,0.0,Phase3-EA-SA2v2-EURCHF-M5-43,EURCHFMT4,6888,8h 20m,Buy
153069.36,112458,16.08.2016 07:29:58,tp 112.458,-0.62,-65.73000000027241,0.0,0.0,113748,12.08.2016 16:00:00,13524,-0.027034353618094406,114.77,IS,0.09,0.0,Phase3-EA-TR1v1-EURJPY-M30-91,EURJPYMT4,2430,3d 15h 29m,Sell
153009.25,130194,16.08.2016 12:59:57,sl 130.194,0.0,-125.84000000025844,0.0,0.0,129524,16.08.2016 10:00:00,13525,-0.05175723504174483,-60.11,IS,0.09,0.0,Phase3-EA-B1v1-GBPJPY-M30-1,GBPJPYMT4,1254,2h 59m,Sell
152948.89,129925,16.08.2016 17:29:58,sl 129.925,0.0,-186.20000000024447,0.0,0.0,129255,16.08.2016 16:30:00,13526,-0.07658293996158415,-60.36,IS,0.09,0.0,Phase3-EA-B1v1-GBPJPY-M30-1,GBPJPYMT4,1256,59m 58s,Sell
152884.33,113156,16.08.2016 18:29:57,sl 113.156,0.0,-250.76000000024214,0.0,0.0,112436,16.08.2016 08:30:00,13527,-0.10313607961740155,-64.56,IS,0.09,0.0,Phase3-EA-TR1v1-EURJPY-M30-91,EURJPYMT4,2432,9h 59m,Sell
152905.36,100274,17.08.2016 03:00:00,,-0.78,-229.7300000002433,0.0,0.0,100193,16.08.2016 22:00:00,13528,-0.0944865671179928,21.03,IS,0.27,0.0,Phase3-EA-S1v2-USDJPY-M15-0,USDJPYMT4,3888,5h 0m,Buy
152851.63,0.96074,17.08.2016 05:30:00,,0.0,-283.4600000002538,0.0,0.0,0.96163,17.08.2016 01:15:00,13529,-0.11658539291891286,-53.73,IS,0.58,0.0,Phase3-EA-SA2v2-USDCHF-M15-107,USDCHFMT4,2644,4h 15m,Buy
152853.17,1.08471,17.08.2016 06:40:00,,-1.02,-281.92000000024564,0.0,0.0,1.08465,16.08.2016 22:20:00,13530,-0.11595200018238597,1.54,IS,0.41,0.0,Phase3-EA-SA2v2-EURCHF-M5-43,EURCHFMT4,6890,8h 20m,Buy
152849.99,1.08429,17.08.2016 12:15:00,,0.0,-285.10000000023865,0.0,0.0,1.08438,17.08.2016 03:30:00,13531,-0.11725991505390575,-3.18,IS,0.34,0.0,Phase3-EA-S4v1-EURCHF-M15-221,EURCHFMT4,3514,8h 45m,Buy
152848.37,100123,17.08.2016 22:30:00,,0.0,-286.720000000234,0.0,0.0,100117,17.08.2016 22:15:00,13532,-0.11792621130920782,-1.62,IS,0.27,0.0,Phase3-EA-S1v2-USDJPY-M15-0,USDJPYMT4,3890,15m 0s,Sell
152873.01,100242,18.08.2016 01:15:00,,-3.64,-262.08000000022,0.0,0.0,100347,17.08.2016 23:45:00,13533,-0.1077919275248253,24.64,IS,0.27,0.0,Phase3-EA-S1v2-USDJPY-M15-0,USDJPYMT4,3892,1h 30m,Sell
152910.77,100.1,18.08.2016 02:45:00,,0.0,-224.3200000002107,0.0,0.0,100.24,18.08.2016 01:15:00,13534,-0.09226146666045186,37.76,IS,0.27,0.0,Phase3-EA-S1v2-USDJPY-M15-0,USDJPYMT4,3894,1h 30m,Sell
153000.56,130588,18.08.2016 06:39:58,tp 130.588,0.0,-134.53000000020256,0.0,0.0,130198,18.08.2016 03:45:00,13535,-0.05533137976924759,89.79,IS,0.23,0.0,Phase3-EA-S4v1-GBPJPY-M5-194,GBPJPYMT4,2972,2h 54m,Buy
153051.66,1.08474,18.08.2016 12:30:00,,0.0,-83.43000000019674,0.0,0.0,1.08618,18.08.2016 03:45:00,13536,-0.034314257148236535,51.1,IS,0.34,0.0,Phase3-EA-S4v1-EURCHF-M15-221,EURCHFMT4,3516,8h 45m,Sell
153216.64,132.08,18.08.2016 13:29:58,tp 132.080,-1.29,-0.0,0.0,0.0,130.23,16.08.2016 18:00:00,13537,-0.0,164.98,IS,0.09,0.0,Phase3-EA-B1v1-GBPJPY-M30-1,GBPJPYMT4,1258,1d 19h 29m,Buy
153145.93,100007,19.08.2016 02:15:00,,-0.78,-70.70999999999185,0.0,0.0,100266,18.08.2016 17:45:00,13538,-0.02907284633156332,-70.71,IS,0.27,0.0,Phase3-EA-S1v2-USDJPY-M15-0,USDJPYMT4,3896,8h 30m,Buy
153205.93,0.95503,19.08.2016 03:14:58,tp 0.95503,-0.73,-10.709999999991851,0.0,0.0,0.95403,18.08.2016 23:15:00,13539,-0.004403481603886892,60.0,IS,0.58,0.0,Phase3-EA-SA2v2-USDCHF-M15-107,USDCHFMT4,2646,3h 59m,Buy
153198.9,1.08304,19.08.2016 07:25:00,,-1.03,-17.739999999990687,0.0,0.0,1.08318,18.08.2016 23:05:00,13540,-0.007293908837812502,-7.03,IS,0.41,0.0,Phase3-EA-SA2v2-EURCHF-M5-43,EURCHFMT4,6892,8h 20m,Buy
153193.66,113496,19.08.2016 11:45:00,,-0.83,-22.979999999981374,0.0,0.0,113522,18.08.2016 23:45:00,13541,-0.009448366690692414,-5.24,IS,0.17,0.0,Phase3-EA-T1v2-EURJPY-M15-322,EURJPYMT4,2588,12h 0m,Buy
153253.31,0.96051,22.08.2016 01:00:00,tp 0.96051,-0.73,-0.0,0.0,0.0,0.95951,19.08.2016 23:45:00,13542,-0.0,59.65,IS,0.58,0.0,Phase3-EA-SA2v2-USDCHF-M15-107,USDCHFMT4,2648,2d 1h 15m,Buy
153298.18,1.08545,22.08.2016 01:04:58,tp 1.08545,-2.14,-0.0,0.0,0.0,1.08655,19.08.2016 20:00:00,13543,-0.0,44.87,IS,0.41,0.0,Phase3-EA-SA2v2-EURCHF-M5-43,EURCHFMT4,6894,2d 5h 4m,Sell
153345.12,1.08593,22.08.2016 01:54:58,tp 1.08593,0.0,-0.0,0.0,0.0,1.08703,22.08.2016 01:15:00,13544,-0.0,46.94,IS,0.41,0.0,Phase3-EA-SA2v2-EURCHF-M5-43,EURCHFMT4,6896,39m 58s,Sell
153306.22,113688,22.08.2016 02:29:58,sl 113.688,0.0,-38.89999999999418,0.0,0.0,113918,22.08.2016 01:00:00,13545,-0.015985527057207485,-38.9,IS,0.17,0.0,Phase3-EA-T1v2-EURJPY-M15-322,EURJPYMT4,2590,1h 29m,Buy
153301.65,131457,22.08.2016 06:35:00,,0.0,-43.470000000001164,0.0,0.0,131437,22.08.2016 01:10:00,13546,-0.01786351828218334,-4.57,IS,0.23,0.0,Phase3-EA-S4v1-GBPJPY-M5-194,GBPJPYMT4,2974,5h 25m,Sell
153262.8,113566,22.08.2016 14:44:58,sl 113.566,0.0,-82.32000000000698,0.0,0.0,113796,22.08.2016 12:15:00,13547,-0.03382849838945061,-38.85,IS,0.17,0.0,Phase3-EA-T1v2-EURJPY-M15-322,EURJPYMT4,2592,2h 29m,Buy
153308.67,1.08948,23.08.2016 01:59:57,tp 1.08948,-1.02,-36.45000000001164,0.0,0.0,1.08838,22.08.2016 21:35:00,13548,-0.014978726509909668,45.87,IS,0.41,0.0,Phase3-EA-SA2v2-EURCHF-M5-43,EURCHFMT4,6898,4h 24m,Buy
153368.21,0.96242,23.08.2016 01:59:58,tp 0.96242,-0.72,-0.0,0.0,0.0,0.96142,22.08.2016 23:00:00,13549,-0.0,59.54,IS,0.58,0.0,Phase3-EA-SA2v2-USDCHF-M15-107,USDCHFMT4,2650,2h 59m,Buy
153329.21,113654,23.08.2016 06:59:57,sl 113.654,0.0,-39.0,0.0,0.0,113424,23.08.2016 04:15:00,13550,-0.016025100402390205,-39.0,IS,0.17,0.0,Phase3-EA-T1v2-EURJPY-M15-322,EURJPYMT4,2594,2h 44m,Sell
153357.52,1.08876,23.08.2016 13:00:00,,0.0,-10.690000000002328,0.0,0.0,1.08956,23.08.2016 04:15:00,13551,-0.004392521110297144,28.31,IS,0.34,0.0,Phase3-EA-S4v1-EURCHF-M15-221,EURCHFMT4,3518,8h 45m,Sell
153366.46,1.08865,24.08.2016 08:40:00,,0.0,-1.75,0.0,0.0,1.08886,24.08.2016 00:20:00,13552,-7.190750180559708E-4,8.94,IS,0.41,0.0,Phase3-EA-SA2v2-EURCHF-M5-43,EURCHFMT4,6900,8h 20m,Sell
153300.01,112795,24.08.2016 15:59:58,sl 112.795,-1.76,-68.20000000001164,0.0,0.0,113555,17.08.2016 12:30:00,13553,-0.028023380703671757,-66.45,IS,0.09,0.0,Phase3-EA-TR1v1-EURJPY-M30-91,EURJPYMT4,2434,7d 3h 29m,Sell
153304.39,100453,25.08.2016 02:00:00,,-2.34,-63.820000000006985,0.0,0.0,100428,24.08.2016 22:30:00,13554,-0.026223638658478328,4.38,IS,0.27,0.0,Phase3-EA-S1v2-USDJPY-M15-0,USDJPYMT4,3898,3h 30m,Buy
153278.1,1.08954,25.08.2016 06:45:00,,-6.36,-90.11000000001513,0.0,0.0,1.08907,24.08.2016 22:25:00,13555,-0.037026199929733945,-26.29,IS,0.41,0.0,Phase3-EA-SA2v2-EURCHF-M5-43,EURCHFMT4,6902,8h 20m,Sell
153326.64,132826,25.08.2016 09:20:00,,0.0,-41.570000000006985,0.0,0.0,133038,25.08.2016 03:55:00,13556,-0.01708111342890956,48.54,IS,0.23,0.0,Phase3-EA-S4v1-GBPJPY-M5-194,GBPJPYMT4,2976,5h 25m,Sell
153343.92,1.08895,25.08.2016 13:30:00,,0.0,-24.29000000000815,0.0,0.0,1.08944,25.08.2016 04:45:00,13557,-0.009980761250620222,17.28,IS,0.34,0.0,Phase3-EA-S4v1-EURCHF-M15-221,EURCHFMT4,3520,8h 45m,Sell
153300.32,1.31864,25.08.2016 15:29:58,sl 1.31864,-1.6,-67.89000000001397,0.0,0.0,1.32164,24.08.2016 12:30:00,13558,-0.027896001700474227,-43.6,IS,0.14,0.0,Phase3-EA-B1v1-GBPUSD-M30-14,GBPUSDMT4,884,1d 2h 59m,Buy
153261.93,0.96695,26.08.2016 05:30:00,,0.0,-106.28000000002794,0.0,0.0,0.96759,26.08.2016 01:15:00,13559,-0.04367045309657638,-38.39,IS,0.58,0.0,Phase3-EA-SA2v2-USDCHF-M15-107,USDCHFMT4,2652,4h 15m,Buy
153285.68,1.09117,26.08.2016 09:05:00,,0.0,-82.53000000002794,0.0,0.0,1.09173,26.08.2016 00:45:00,13560,-0.03391157785153106,23.75,IS,0.41,0.0,Phase3-EA-SA2v2-EURCHF-M5-43,EURCHFMT4,6904,8h 20m,Sell
153230.04,1.09004,26.08.2016 12:45:00,,0.0,-138.1700000000419,0.0,0.0,1.09162,26.08.2016 04:00:00,13561,-0.05677405442561349,-55.64,IS,0.34,0.0,Phase3-EA-S4v1-EURCHF-M15-221,EURCHFMT4,3522,8h 45m,Buy
153188.33,113732,26.08.2016 18:14:58,sl 113.732,-2.96,-179.88000000003376,0.0,0.0,113502,23.08.2016 13:45:00,13562,-0.07391269385596132,-41.71,IS,0.17,0.0,Phase3-EA-T1v2-EURJPY-M15-322,EURJPYMT4,2596,3d 4h 29m,Sell
153122.86,113682,26.08.2016 18:29:58,sl 113.682,-1.25,-245.35000000003492,0.0,0.0,113515,18.08.2016 16:00:00,13563,-0.10081431753146144,-65.47,IS,0.09,0.0,Phase3-EA-TR1v1-EURJPY-M30-91,EURJPYMT4,2435,8d 2h 29m,Buy
153182.17,0.97787,26.08.2016 23:44:58,tp 0.97787,0.0,-186.04000000003725,0.0,0.0,0.97887,26.08.2016 23:00:00,13564,-0.07644383791951977,59.31,IS,0.58,0.0,Phase3-EA-SA2v2-USDCHF-M15-107,USDCHFMT4,2654,44m 58s,Sell
153149.46,1.09473,29.08.2016 05:45:00,,-2.1,-218.7500000000291,0.0,0.0,1094,26.08.2016 21:25:00,13565,-0.0898843772570083,-32.71,IS,0.41,0.0,Phase3-EA-SA2v2-EURCHF-M5-43,EURCHFMT4,6906,2d 8h 20m,Sell
153076.96,114335,29.08.2016 06:29:58,sl 114.335,-3.75,-291.2500000000291,0.0,0.0,112962,24.08.2016 17:00:00,13566,-0.11967462800504138,-72.5,IS,0.09,0.0,Phase3-EA-TR1v1-EURJPY-M30-91,EURJPYMT4,2437,4d 13h 29m,Sell
153096.54,0.9776,29.08.2016 06:45:00,,0.0,-271.6700000000419,0.0,0.0,0.97793,29.08.2016 02:30:00,13567,-0.11162920580302611,19.58,IS,0.58,0.0,Phase3-EA-SA2v2-USDCHF-M15-107,USDCHFMT4,2656,4h 15m,Sell
153257.93,134189,29.08.2016 08:29:58,tp 134.189,-1.61,-110.28000000002794,0.0,0.0,132339,24.08.2016 03:00:00,13568,-0.04531405313784717,161.39,IS,0.09,0.0,Phase3-EA-B1v1-GBPJPY-M30-1,GBPJPYMT4,1260,5d 5h 29m,Buy
153204.53,102142,29.08.2016 13:45:00,,0.0,-163.68000000002212,0.0,0.0,101.94,29.08.2016 01:45:00,13569,-0.06725611368880982,-53.4,IS,0.27,0.0,Phase3-EA-S1v2-USDJPY-M15-0,USDJPYMT4,3900,12h 0m,Sell
153142.21,1.0953,30.08.2016 07:25:00,,-2.1,-226.0000000000291,0.0,0.0,1.09386,29.08.2016 23:05:00,13570,-0.0928634023318116,-62.32,IS,0.41,0.0,Phase3-EA-SA2v2-EURCHF-M5-43,EURCHFMT4,6908,8h 20m,Sell
153116.89,1.09499,30.08.2016 09:45:00,,0.0,-251.3200000000361,0.0,0.0,1.09426,30.08.2016 01:00:00,13571,-0.10326739059305859,-25.32,IS,0.34,0.0,Phase3-EA-S4v1-EURCHF-M15-221,EURCHFMT4,3524,8h 45m,Sell
153141.77,103112,31.08.2016 04:45:00,,0.0,-226.44000000003143,0.0,0.0,103017,31.08.2016 00:15:00,13572,-0.09304419833635236,24.88,IS,0.27,0.0,Phase3-EA-S1v2-USDJPY-M15-0,USDJPYMT4,3902,4h 30m,Buy
153129.69,1.09589,31.08.2016 05:00:00,,-2.08,-238.52000000001863,0.0,0.0,1.09565,30.08.2016 20:40:00,13573,-0.09800787046098487,-12.08,IS,0.41,0.0,Phase3-EA-SA2v2-EURCHF-M5-43,EURCHFMT4,6910,8h 20m,Sell
153111.74,1.09671,31.08.2016 15:15:00,,0.0,-256.47000000003027,0.0,0.0,1.09619,31.08.2016 06:30:00,13574,-0.10538352564619233,-17.95,IS,0.34,0.0,Phase3-EA-S4v1-EURCHF-M15-221,EURCHFMT4,3526,8h 45m,Sell
153153.31,103467,01.09.2016 00:15:00,,-2.27,-214.90000000002328,0.0,0.0,103299,31.08.2016 20:30:00,13575,-0.08830241221728277,41.57,IS,0.27,0.0,Phase3-EA-S1v2-USDJPY-M15-0,USDJPYMT4,3904,3h 45m,Buy
153112.87,1.09714,01.09.2016 06:35:00,,-6.25,-255.3400000000256,0.0,0.0,1.09632,31.08.2016 22:15:00,13576,-0.10491920863453143,-40.44,IS,0.41,0.0,Phase3-EA-SA2v2-EURCHF-M5-43,EURCHFMT4,6912,8h 20m,Sell
153127.79,135798,01.09.2016 07:40:00,,0.0,-240.4200000000128,0.0,0.0,135731,01.09.2016 02:15:00,13577,-0.09878858048058611,14.92,IS,0.23,0.0,Phase3-EA-S4v1-GBPJPY-M5-194,GBPJPYMT4,2978,5h 25m,Buy
153145.42,1.0968,01.09.2016 10:00:00,,0.0,-222.79000000000815,0.0,0.0,1.09731,01.09.2016 01:15:00,13578,-0.0915444132986832,17.63,IS,0.34,0.0,Phase3-EA-S4v1-EURCHF-M15-221,EURCHFMT4,3528,8h 45m,Sell
153305.22,136964,01.09.2016 12:59:57,tp 136.964,-0.94,-62.99000000001979,0.0,0.0,135114,31.08.2016 10:30:00,13579,-0.025882591649919903,159.8,IS,0.09,0.0,Phase3-EA-B1v1-GBPJPY-M30-1,GBPJPYMT4,1262,1d 2h 29m,Buy
153412.42,115624,01.09.2016 15:29:58,tp 115.624,-2.14,-0.0,0.0,0.0,114364,29.08.2016 07:30:00,13580,-0.0,107.2,IS,0.09,0.0,Phase3-EA-TR1v1-EURJPY-M30-91,EURJPYMT4,2440,3d 7h 59m,Buy
153458.42,1.0969,01.09.2016 21:54:58,tp 1.09690,0.0,-0.0,0.0,0.0,1.0958,01.09.2016 20:25:00,13581,-0.0,46.0,IS,0.41,0.0,Phase3-EA-SA2v2-EURCHF-M5-43,EURCHFMT4,6914,1h 29m,Buy
153500.91,115603,02.09.2016 02:30:00,,-0.81,-0.0,0.0,0.0,115.34,01.09.2016 12:15:00,13582,-0.0,42.49,IS,0.17,0.0,Phase3-EA-T1v2-EURJPY-M15-322,EURJPYMT4,2598,14h 15m,Buy
153389.01,103247,02.09.2016 05:00:00,,-0.76,-111.89999999999418,0.0,0.0,103672,01.09.2016 18:15:00,13583,-0.0459546537218254,-111.9,IS,0.27,0.0,Phase3-EA-S1v2-USDJPY-M15-0,USDJPYMT4,3906,10h 45m,Buy
153368.1,1.09764,02.09.2016 06:25:00,,-2.09,-132.80999999999767,0.0,0.0,1.09719,01.09.2016 22:05:00,13584,-0.054541890623734074,-20.91,IS,0.41,0.0,Phase3-EA-SA2v2-EURCHF-M5-43,EURCHFMT4,6916,8h 20m,Sell
153416.32,1.09603,02.09.2016 14:15:00,,0.0,-84.58999999999651,0.0,0.0,1.09742,02.09.2016 05:30:00,13585,-0.03473908988676723,48.22,IS,0.34,0.0,Phase3-EA-S4v1-EURCHF-M15-221,EURCHFMT4,3530,8h 45m,Sell
153446.19,104058,05.09.2016 02:30:00,,-0.75,-54.720000000001164,0.0,0.0,103.94,02.09.2016 23:00:00,13586,-0.022472195278449243,29.87,IS,0.27,0.0,Phase3-EA-S1v2-USDJPY-M15-0,USDJPYMT4,3908,2d 3h 30m,Buy
153421.33,1.09336,05.09.2016 04:20:00,,-1.0,-79.5799999999872,0.0,0.0,1.09393,02.09.2016 20:00:00,13587,-0.03268160270940543,-24.86,IS,0.41,0.0,Phase3-EA-SA2v2-EURCHF-M5-43,EURCHFMT4,6918,2d 8h 20m,Buy
153382.7,115406,05.09.2016 11:29:57,sl 115.406,-0.8,-118.20999999999185,0.0,0.0,115636,02.09.2016 05:15:00,13588,-0.048546019807478906,-38.63,IS,0.17,0.0,Phase3-EA-T1v2-EURJPY-M15-322,EURJPYMT4,2600,3d 6h 14m,Buy
153324.34,137492,05.09.2016 13:59:58,sl 137.492,0.0,-176.56999999997788,0.0,0.0,138162,05.09.2016 13:00:00,13589,-0.07251307602915208,-58.36,IS,0.09,0.0,Phase3-EA-B1v1-GBPJPY-M30-1,GBPJPYMT4,1264,59m 58s,Buy
153282.34,1.32928,05.09.2016 18:59:58,sl 1.32928,0.0,-218.56999999997788,0.0,0.0,1.33228,05.09.2016 12:30:00,13590,-0.08976147152796143,-42.0,IS,0.14,0.0,Phase3-EA-B1v1-GBPUSD-M30-14,GBPUSDMT4,886,6h 29m,Buy
153300.16,1.09302,06.09.2016 07:25:00,,-1.0,-200.7499999999709,0.0,0.0,1.09257,05.09.2016 23:05:00,13591,-0.08244322372346374,17.82,IS,0.41,0.0,Phase3-EA-SA2v2-EURCHF-M5-43,EURCHFMT4,6920,8h 20m,Buy
153315.42,1.09279,06.09.2016 10:00:00,,0.0,-185.48999999996158,0.0,0.0,1.09235,06.09.2016 01:15:00,13592,-0.07617630669222585,15.26,IS,0.34,0.0,Phase3-EA-S4v1-EURCHF-M15-221,EURCHFMT4,3532,8h 45m,Buy
153350.21,103214,06.09.2016 18:00:00,,0.0,-150.69999999995343,0.0,0.0,103347,06.09.2016 17:00:00,13593,-0.06188888575404208,34.79,IS,0.27,0.0,Phase3-EA-S1v2-USDJPY-M15-0,USDJPYMT4,3910,1h 0m,Sell
153286.15,115034,06.09.2016 18:29:57,sl 115.034,-1.28,-214.7599999999511,0.0,0.0,115754,01.09.2016 18:00:00,13594,-0.08819679565055845,-64.06,IS,0.09,0.0,Phase3-EA-TR1v1-EURJPY-M30-91,EURJPYMT4,2442,5d 0h 29m,Buy
153290.21,0.97039,07.09.2016 03:00:00,,-0.72,-210.69999999995343,0.0,0.0,0.97031,06.09.2016 22:45:00,13595,-0.08652945075234117,4.06,IS,0.58,0.0,Phase3-EA-SA2v2-USDCHF-M15-107,USDCHFMT4,2658,4h 15m,Buy
153109.32,136147,07.09.2016 03:39:58,sl 136.147,0.0,-391.5899999999674,0.0,0.0,136947,07.09.2016 00:15:00,13596,-0.1608166474613856,-180.89,IS,0.23,0.0,Phase3-EA-S4v1-GBPJPY-M5-194,GBPJPYMT4,2980,3h 24m,Buy
153047.44,1.0906,07.09.2016 04:45:00,,-1.01,-453.46999999997206,0.0,0.0,1.09204,06.09.2016 20:25:00,13597,-0.18622928349629997,-61.88,IS,0.41,0.0,Phase3-EA-SA2v2-EURCHF-M5-43,EURCHFMT4,6922,8h 20m,Buy
153006.64,136084,07.09.2016 09:15:00,,0.0,-494.2699999999604,0.0,0.0,136264,07.09.2016 03:50:00,13598,-0.20298486769513857,-40.8,IS,0.23,0.0,Phase3-EA-S4v1-GBPJPY-M5-194,GBPJPYMT4,2982,5h 25m,Buy
152887.54,101.56,07.09.2016 11:15:00,,0.0,-613.3699999999662,0.0,0.0,102008,07.09.2016 00:15:00,13599,-0.25189638921676466,-119.1,IS,0.27,0.0,Phase3-EA-S1v2-USDJPY-M15-0,USDJPYMT4,3912,11h 0m,Buy
152832.09,1.08915,07.09.2016 13:45:00,,0.0,-668.8199999999779,0.0,0.0,1.09073,07.09.2016 05:00:00,13600,-0.27466837803603084,-55.45,IS,0.34,0.0,Phase3-EA-S4v1-EURCHF-M15-221,EURCHFMT4,3534,8h 45m,Buy
152793.54,114293,07.09.2016 18:29:58,sl 114.293,0.0,-707.3699999999662,0.0,0.0,114063,07.09.2016 17:15:00,13601,-0.2904999410474332,-38.55,IS,0.17,0.0,Phase3-EA-T1v2-EURJPY-M15-322,EURJPYMT4,2602,1h 14m,Sell
152853.56,101658,07.09.2016 18:45:00,,0.0,-647.3499999999767,0.0,0.0,101432,07.09.2016 17:00:00,13602,-0.2658511625274723,60.02,IS,0.27,0.0,Phase3-EA-S1v2-USDJPY-M15-0,USDJPYMT4,3914,1h 45m,Buy
152893.73,1.08893,08.09.2016 01:00:00,tp 1.08893,-6.34,-607.1799999999639,0.0,0.0,1.09003,07.09.2016 20:05:00,13603,-0.24935430426110583,40.17,IS,0.41,0.0,Phase3-EA-SA2v2-EURCHF-M5-43,EURCHFMT4,6924,4h 55m,Sell
152921.04,101839,08.09.2016 04:00:00,,0.0,-579.8699999999662,0.0,0.0,101736,08.09.2016 00:45:00,13604,-0.23813874042604766,27.31,IS,0.27,0.0,Phase3-EA-S1v2-USDJPY-M15-0,USDJPYMT4,3916,3h 15m,Buy
152882.58,114409,08.09.2016 09:44:57,sl 114.409,0.0,-618.3299999999581,0.0,0.0,114179,08.09.2016 08:30:00,13605,-0.25393334258995404,-38.46,IS,0.17,0.0,Phase3-EA-T1v2-EURJPY-M15-322,EURJPYMT4,2604,1h 14m,Sell
152871.86,114332,08.09.2016 11:30:00,,0.0,-629.0499999999593,0.0,0.0,114396,08.09.2016 10:30:00,13606,-0.2583357902029839,-10.72,IS,0.17,0.0,Phase3-EA-T1v2-EURJPY-M15-322,EURJPYMT4,2606,1h 0m,Buy
152842.75,1.09531,09.09.2016 04:20:00,,-2.11,-658.1599999999453,0.0,0.0,1.09467,08.09.2016 20:00:00,13607,-0.2702905709879863,-29.11,IS,0.41,0.0,Phase3-EA-SA2v2-EURCHF-M5-43,EURCHFMT4,6926,8h 20m,Sell
152795.0,0.97176,09.09.2016 05:00:00,,0.0,-705.9099999999453,0.0,0.0,0.97256,09.09.2016 00:45:00,13608,-0.28990035396579933,-47.75,IS,0.58,0.0,Phase3-EA-SA2v2-USDCHF-M15-107,USDCHFMT4,2660,4h 15m,Buy
152733.45,102207,09.09.2016 10:45:00,,0.0,-767.4599999999336,0.0,0.0,102.44,09.09.2016 01:15:00,13609,-0.31517746689321635,-61.55,IS,0.27,0.0,Phase3-EA-S1v2-USDJPY-M15-0,USDJPYMT4,3918,9h 30m,Buy
152672.49,136513,09.09.2016 14:59:57,sl 136.513,-2.05,-828.4199999999255,0.0,0.0,135843,07.09.2016 13:30:00,13610,-0.34021228093148487,-60.96,IS,0.09,0.0,Phase3-EA-B1v1-GBPJPY-M30-1,GBPJPYMT4,1266,2d 1h 29m,Sell
152607.94,115.53,09.09.2016 14:59:57,sl 115.530,-1.24,-892.9699999999139,0.0,0.0,114.81,07.09.2016 00:30:00,13611,-0.36672142210881686,-64.55,IS,0.09,0.0,Phase3-EA-TR1v1-EURJPY-M30-91,EURJPYMT4,2444,2d 14h 29m,Sell
152654.18,1.09549,12.09.2016 01:39:58,tp 1.09549,0.0,-846.7299999999232,0.0,0.0,1.09439,12.09.2016 01:05:00,13612,-0.3477317600167982,46.24,IS,0.41,0.0,Phase3-EA-SA2v2-EURCHF-M5-43,EURCHFMT4,6928,34m 58s,Buy
152657.75,0.97476,12.09.2016 05:30:00,,0.0,-843.1599999999162,0.0,0.0,0.9747,12.09.2016 01:15:00,13613,-0.34626564639939655,3.57,IS,0.58,0.0,Phase3-EA-SA2v2-USDCHF-M15-107,USDCHFMT4,2662,4h 15m,Buy
152650.57,136036,12.09.2016 06:30:00,,0.0,-850.3399999999092,0.0,0.0,136068,12.09.2016 01:05:00,13614,-0.34921430067752346,-7.18,IS,0.23,0.0,Phase3-EA-S4v1-GBPJPY-M5-194,GBPJPYMT4,2984,5h 25m,Buy
152569.88,1.09698,12.09.2016 10:25:00,,0.0,-931.0299999999115,0.0,0.0,1.09506,12.09.2016 02:05:00,13615,-0.3823517538394036,-80.69,IS,0.41,0.0,Phase3-EA-SA2v2-EURCHF-M5-43,EURCHFMT4,6930,8h 20m,Sell
152650.38,1.09411,12.09.2016 14:45:00,,0.0,-850.5299999999115,0.0,0.0,1.09642,12.09.2016 06:00:00,13616,-0.34929232913335234,80.5,IS,0.34,0.0,Phase3-EA-S4v1-EURCHF-M15-221,EURCHFMT4,3536,8h 45m,Sell
152429.52,101816,12.09.2016 15:59:58,sl 101.816,-0.76,-1071.3899999998976,0.0,0.0,102646,09.09.2016 18:30:00,13617,-0.43999424889208555,-220.86,IS,0.27,0.0,Phase3-EA-S1v2-USDJPY-M15-0,USDJPYMT4,3920,2d 21h 29m,Buy
152535.82,101602,12.09.2016 21:29:57,tp 101.602,0.0,-965.0899999999092,0.0,0.0,102002,12.09.2016 17:45:00,13618,-0.3963393812367705,106.3,IS,0.27,0.0,Phase3-EA-S1v2-USDJPY-M15-0,USDJPYMT4,3922,3h 44m,Sell
152624.0,135569,13.09.2016 04:09:57,tp 135.569,0.0,-876.9099999999162,0.0,0.0,135959,13.09.2016 02:10:00,13619,-0.3601259642109398,88.18,IS,0.23,0.0,Phase3-EA-S4v1-GBPJPY-M5-194,GBPJPYMT4,2986,1h 59m,Sell
152618.52,1.09183,13.09.2016 09:00:00,,0.0,-882.3899999999267,0.0,0.0,1.09196,13.09.2016 00:40:00,13620,-0.3623764691474554,-5.48,IS,0.41,0.0,Phase3-EA-SA2v2-EURCHF-M5-43,EURCHFMT4,6932,8h 20m,Buy
152576.52,1.32992,13.09.2016 11:59:57,sl 1.32992,0.0,-924.3899999999267,0.0,0.0,1.33292,13.09.2016 06:30:00,13621,-0.37962486464626477,-42.0,IS,0.14,0.0,Phase3-EA-B1v1-GBPUSD-M30-14,GBPUSDMT4,888,5h 29m,Buy
152582.47,1.09183,13.09.2016 15:00:00,,0.0,-918.439999999915,0.0,0.0,1.09166,13.09.2016 06:15:00,13622,-0.37718134195059533,5.95,IS,0.34,0.0,Phase3-EA-S4v1-EURCHF-M15-221,EURCHFMT4,3538,8h 45m,Buy
152518.74,115032,13.09.2016 18:59:57,sl 115.032,-0.31,-982.1699999999255,0.0,0.0,114312,12.09.2016 16:30:00,13623,-0.40335372873962627,-63.73,IS,0.09,0.0,Phase3-EA-TR1v1-EURJPY-M30-91,EURJPYMT4,2446,1d 2h 29m,Sell
152592.79,102455,13.09.2016 21:15:00,,0.0,-908.1199999999371,0.0,0.0,102174,13.09.2016 19:00:00,13624,-0.37294316477089695,74.05,IS,0.27,0.0,Phase3-EA-S1v2-USDJPY-M15-0,USDJPYMT4,3924,2h 15m,Buy
152652.16,0.97694,13.09.2016 23:59:58,tp 0.97694,0.0,-848.7499999999418,0.0,0.0,0.97794,13.09.2016 22:45:00,13625,-0.3485613257050819,59.37,IS,0.58,0.0,Phase3-EA-SA2v2-USDCHF-M15-107,USDCHFMT4,2664,1h 14m,Sell
152612.89,115355,14.09.2016 04:29:58,sl 115.355,-1.16,-888.0199999999313,0.0,0.0,115125,12.09.2016 11:30:00,13626,-0.3646885754964644,-39.27,IS,0.17,0.0,Phase3-EA-T1v2-EURJPY-M15-322,EURJPYMT4,2608,1d 16h 59m,Sell
152574.28,1.09601,14.09.2016 04:50:00,,-2.1,-926.6299999999173,0.0,0.0,1.09514,13.09.2016 20:30:00,13627,-0.3805447790728641,-38.61,IS,0.41,0.0,Phase3-EA-SA2v2-EURCHF-M5-43,EURCHFMT4,6934,8h 20m,Sell
152585.56,0.97711,14.09.2016 05:30:00,,0.0,-915.3499999999185,0.0,0.0,0.97692,14.09.2016 01:15:00,13628,-0.37591235285318436,11.28,IS,0.58,0.0,Phase3-EA-SA2v2-USDCHF-M15-107,USDCHFMT4,2666,4h 15m,Buy
152517.37,115751,14.09.2016 05:59:58,sl 115.751,0.0,-983.5399999999208,0.0,0.0,114971,14.09.2016 03:00:00,13629,-0.4039163549737522,-68.19,IS,0.09,0.0,Phase3-EA-TR1v1-EURJPY-M30-91,EURJPYMT4,2448,2h 59m,Sell
152587.34,102646,14.09.2016 19:00:00,,0.0,-913.5699999999197,0.0,0.0,102912,14.09.2016 17:15:00,13630,-0.37518134942490194,69.97,IS,0.27,0.0,Phase3-EA-S1v2-USDJPY-M15-0,USDJPYMT4,3926,1h 45m,Sell
152627.36,1094,15.09.2016 01:00:00,tp 1.09400,-6.32,-873.5499999999302,0.0,0.0,1.0951,14.09.2016 23:00:00,13631,-0.3587460925710408,40.02,IS,0.41,0.0,Phase3-EA-SA2v2-EURCHF-M5-43,EURCHFMT4,6936,2h 0m,Sell
152629.47,102.37,15.09.2016 05:30:00,,0.0,-871.4399999999441,0.0,0.0,102378,15.09.2016 00:15:00,13632,-0.357879566035273,2.11,IS,0.27,0.0,Phase3-EA-S1v2-USDJPY-M15-0,USDJPYMT4,3928,5h 15m,Sell
152614.11,1.09227,16.09.2016 04:25:00,,-1.01,-886.7999999999302,0.0,0.0,1.09261,15.09.2016 20:05:00,13633,-0.36418755067483183,-15.36,IS,0.41,0.0,Phase3-EA-SA2v2-EURCHF-M5-43,EURCHFMT4,6938,8h 20m,Buy
152637.1,135033,16.09.2016 08:20:00,,0.0,-863.8099999999395,0.0,0.0,134931,16.09.2016 02:55:00,13634,-0.354746107519654,22.99,IS,0.23,0.0,Phase3-EA-S4v1-GBPJPY-M5-194,GBPJPYMT4,2988,5h 25m,Buy
152595.1,1.32127,16.09.2016 11:29:58,sl 1.32127,0.0,-905.8099999999395,0.0,0.0,1.32427,16.09.2016 03:00:00,13635,-0.3719945030184634,-42.0,IS,0.14,0.0,Phase3-EA-B1v1-GBPUSD-M30-14,GBPUSDMT4,890,8h 29m,Buy
152636.66,1.09341,16.09.2016 13:30:00,,0.0,-864.2499999999418,0.0,0.0,1.09222,16.09.2016 04:45:00,13636,-0.3549268049963092,41.56,IS,0.34,0.0,Phase3-EA-S4v1-EURCHF-M15-221,EURCHFMT4,3540,8h 45m,Buy
152749.49,114214,16.09.2016 15:29:57,tp 114.214,-1.23,-751.4199999999546,0.0,0.0,115504,14.09.2016 13:00:00,13637,-0.308590222517013,112.83,IS,0.09,0.0,Phase3-EA-TR1v1-EURJPY-M30-91,EURJPYMT4,2450,2d 2h 29m,Sell
152805.53,0.98027,19.09.2016 01:00:00,tp 0.98027,-3.13,-695.3799999999464,0.0,0.0,0.98127,16.09.2016 22:30:00,13638,-0.28557593480859833,56.04,IS,0.58,0.0,Phase3-EA-SA2v2-USDCHF-M15-107,USDCHFMT4,2668,2d 2h 30m,Sell
152849.47,1.09244,19.09.2016 01:00:00,tp 1.09244,-2.09,-651.4399999999441,0.0,0.0,1.09354,16.09.2016 21:55:00,13639,-0.2675308277081763,43.94,IS,0.41,0.0,Phase3-EA-SA2v2-EURCHF-M5-43,EURCHFMT4,6940,2d 3h 5m,Sell
152937.15,133167,19.09.2016 03:34:58,tp 133.167,0.0,-563.7599999999511,0.0,0.0,132777,19.09.2016 01:30:00,13640,-0.23152274872399814,87.68,IS,0.23,0.0,Phase3-EA-S4v1-GBPJPY-M5-194,GBPJPYMT4,2990,2h 4m,Buy
152920.57,0.97941,19.09.2016 05:30:00,,0.0,-580.3399999999383,0.0,0.0,0.97969,19.09.2016 01:15:00,13641,-0.23833175818518954,-16.58,IS,0.58,0.0,Phase3-EA-SA2v2-USDCHF-M15-107,USDCHFMT4,2670,4h 15m,Buy
152928.11,1.09323,19.09.2016 09:25:00,,0.0,-572.7999999999302,0.0,0.0,1.09305,19.09.2016 01:05:00,13642,-0.23523526051706659,7.54,IS,0.41,0.0,Phase3-EA-SA2v2-EURCHF-M5-43,EURCHFMT4,6942,8h 20m,Buy
152942.58,1.09561,20.09.2016 05:20:00,,-1.0,-558.329999999929,0.0,0.0,1.09524,19.09.2016 21:00:00,13643,-0.229292777591643,14.47,IS,0.41,0.0,Phase3-EA-SA2v2-EURCHF-M5-43,EURCHFMT4,6944,8h 20m,Buy
153104.93,131986,20.09.2016 14:59:58,tp 131.986,-1.02,-395.97999999992317,0.0,0.0,133836,16.09.2016 17:30:00,13644,-0.16261951546707631,162.35,IS,0.09,0.0,Phase3-EA-B1v1-GBPJPY-M30-1,GBPJPYMT4,1268,3d 21h 29m,Sell
153034.65,113425,21.09.2016 00:59:58,sl 113.425,-1.29,-466.259999999922,0.0,0.0,114205,16.09.2016 21:00:00,13645,-0.19148183060175017,-70.28,IS,0.09,0.0,Phase3-EA-TR1v1-EURJPY-M30-91,EURJPYMT4,2452,4d 3h 59m,Buy
153316.52,113288,21.09.2016 01:14:57,tp 113.288,-2.32,-184.38999999992666,0.0,0.0,114988,15.09.2016 20:30:00,13646,-0.07572456300057602,281.87,IS,0.17,0.0,Phase3-EA-T1v2-EURJPY-M15-322,EURJPYMT4,2610,5d 4h 44m,Sell
153285.77,1.0921,21.09.2016 04:45:00,,-1.01,-215.13999999992666,0.0,0.0,1.09281,20.09.2016 20:25:00,13647,-0.0883528525622043,-30.75,IS,0.41,0.0,Phase3-EA-SA2v2-EURCHF-M5-43,EURCHFMT4,6946,8h 20m,Buy
153225.56,132649,21.09.2016 08:29:58,sl 132.649,-0.51,-275.3499999999185,0.0,0.0,131979,20.09.2016 17:00:00,13648,-0.11307965953799409,-60.21,IS,0.09,0.0,Phase3-EA-B1v1-GBPJPY-M30-1,GBPJPYMT4,1270,15h 29m,Sell
153162.17,114176,21.09.2016 08:59:58,sl 114.176,0.0,-338.7399999999325,0.0,0.0,113456,21.09.2016 02:00:00,13649,-0.13911241645870281,-63.39,IS,0.09,0.0,Phase3-EA-TR1v1-EURJPY-M30-91,EURJPYMT4,2454,6h 59m,Sell
153181.92,1.09203,21.09.2016 10:15:00,,0.0,-318.9899999999325,0.0,0.0,1.09146,21.09.2016 01:30:00,13650,-0.13100156381342937,19.75,IS,0.34,0.0,Phase3-EA-S4v1-EURCHF-M15-221,EURCHFMT4,3542,8h 45m,Buy
153167.45,100777,21.09.2016 22:00:00,,0.0,-333.45999999993364,0.0,0.0,100831,21.09.2016 21:45:00,13651,-0.13694404673885296,-14.47,IS,0.27,0.0,Phase3-EA-S1v2-USDJPY-M15-0,USDJPYMT4,3930,15m 0s,Buy
153213.57,1.08831,21.09.2016 22:09:58,tp 1.08831,0.0,-287.3399999999383,0.0,0.0,1.08941,21.09.2016 20:55:00,13652,-0.11800366577682898,46.12,IS,0.41,0.0,Phase3-EA-SA2v2-EURCHF-M5-43,EURCHFMT4,6948,1h 14m,Sell
153291.72,100538,21.09.2016 22:15:00,,0.0,-209.18999999994412,0.0,0.0,100829,21.09.2016 21:45:00,13653,-0.08590932986654681,78.15,IS,0.27,0.0,Phase3-EA-S1v2-USDJPY-M15-0,USDJPYMT4,3931,30m 0s,Sell
153280.45,100578,21.09.2016 22:30:00,,0.0,-220.45999999993364,0.0,0.0,100536,21.09.2016 22:15:00,13654,-0.09053764932538969,-11.27,IS,0.27,0.0,Phase3-EA-S1v2-USDJPY-M15-0,USDJPYMT4,3934,15m 0s,Sell
153326.46,1.08973,21.09.2016 22:34:58,tp 1.08973,0.0,-174.44999999992433,0.0,0.0,1.08863,21.09.2016 22:15:00,13655,-0.07164244273252351,46.01,IS,0.41,0.0,Phase3-EA-SA2v2-EURCHF-M5-43,EURCHFMT4,6950,19m 58s,Buy
153331.83,100497,21.09.2016 23:00:00,,0.0,-169.079999999929,0.0,0.0,100517,21.09.2016 22:45:00,13656,-0.06943711216517766,5.37,IS,0.27,0.0,Phase3-EA-S1v2-USDJPY-M15-0,USDJPYMT4,3936,15m 0s,Sell
153317.33,100549,21.09.2016 23:15:00,,0.0,-183.579999999929,0.0,0.0,100495,21.09.2016 23:00:00,13657,-0.07539191537309994,-14.5,IS,0.27,0.0,Phase3-EA-S1v2-USDJPY-M15-0,USDJPYMT4,3938,15m 0s,Sell
153344.33,1.08991,22.09.2016 12:15:00,,0.0,-156.579999999929,0.0,0.0,1.08914,22.09.2016 03:30:00,13658,-0.06430366112386535,27.0,IS,0.34,0.0,Phase3-EA-S4v1-EURCHF-M15-221,EURCHFMT4,3544,8h 45m,Buy
153419.57,100841,22.09.2016 18:00:00,,0.0,-81.3399999999383,0.0,0.0,100.56,22.09.2016 17:00:00,13659,-0.03340439261600212,75.24,IS,0.27,0.0,Phase3-EA-S1v2-USDJPY-M15-0,USDJPYMT4,3940,1h 0m,Buy
153406.44,100794,22.09.2016 18:15:00,,0.0,-94.46999999994296,0.0,0.0,100843,22.09.2016 18:00:00,13660,-0.038796569589798484,-13.13,IS,0.27,0.0,Phase3-EA-S1v2-USDJPY-M15-0,USDJPYMT4,3942,15m 0s,Buy
153420.63,0.96891,23.09.2016 02:45:00,,-3.17,-80.27999999994063,0.0,0.0,0.9692,22.09.2016 22:30:00,13661,-0.032969075967699796,14.19,IS,0.58,0.0,Phase3-EA-SA2v2-USDCHF-M15-107,USDCHFMT4,2672,4h 15m,Sell
153478.12,101004,23.09.2016 04:30:00,,-0.78,-22.78999999994994,0.0,0.0,100786,22.09.2016 23:45:00,13662,-0.009359307938500046,57.49,IS,0.27,0.0,Phase3-EA-S1v2-USDJPY-M15-0,USDJPYMT4,3944,4h 45m,Buy
153464.0,1.08602,23.09.2016 04:40:00,,-1.01,-36.909999999945285,0.0,0.0,1.08633,22.09.2016 20:20:00,13663,-0.015158054234764518,-14.12,IS,0.41,0.0,Phase3-EA-SA2v2-EURCHF-M5-43,EURCHFMT4,6952,8h 20m,Buy
153421.47,1.30375,23.09.2016 07:29:58,sl 1.30375,-0.53,-79.43999999994412,0.0,0.0,1.30675,22.09.2016 15:30:00,13664,-0.03262410805772504,-42.53,IS,0.14,0.0,Phase3-EA-B1v1-GBPUSD-M30-14,GBPUSDMT4,892,15h 59m,Buy
153443.55,1.08654,23.09.2016 10:00:00,,0.0,-57.359999999956926,0.0,0.0,1.08591,23.09.2016 01:15:00,13665,-0.023556380138356238,22.08,IS,0.34,0.0,Phase3-EA-S4v1-EURCHF-M15-221,EURCHFMT4,3546,8h 45m,Buy
153404.83,112996,23.09.2016 10:14:57,sl 112.996,0.0,-96.07999999995809,0.0,0.0,113226,23.09.2016 04:45:00,13666,-0.03945775808392572,-38.72,IS,0.17,0.0,Phase3-EA-T1v2-EURJPY-M15-322,EURJPYMT4,2612,5h 29m,Buy
153431.64,113396,26.09.2016 04:00:00,,-0.82,-69.26999999996042,0.0,0.0,113232,23.09.2016 17:30:00,13667,-0.02844753229052004,26.81,IS,0.17,0.0,Phase3-EA-T1v2-EURJPY-M15-322,EURJPYMT4,2614,2d 10h 30m,Buy
153442.9,1.08924,26.09.2016 04:20:00,,-1.01,-58.009999999951106,0.0,0.0,1.08895,23.09.2016 20:00:00,13668,-0.023823319592502088,11.26,IS,0.41,0.0,Phase3-EA-SA2v2-EURCHF-M5-43,EURCHFMT4,6954,2d 8h 20m,Buy
153506.62,130793,26.09.2016 04:45:00,,-1.32,-0.0,0.0,0.0,131078,23.09.2016 23:20:00,13669,-0.0,63.72,IS,0.23,0.0,Phase3-EA-S4v1-GBPJPY-M5-194,GBPJPYMT4,2992,2d 5h 25m,Sell
153538.94,0.96908,26.09.2016 05:30:00,,0.0,-0.0,0.0,0.0,0.96962,26.09.2016 01:15:00,13670,-0.0,32.32,IS,0.58,0.0,Phase3-EA-SA2v2-USDCHF-M15-107,USDCHFMT4,2674,4h 15m,Sell
153573.91,100384,26.09.2016 18:00:00,,0.0,-0.0,0.0,0.0,100514,26.09.2016 17:00:00,13671,-0.0,34.97,IS,0.27,0.0,Phase3-EA-S1v2-USDJPY-M15-0,USDJPYMT4,3946,1h 0m,Sell
153597.86,100352,26.09.2016 19:15:00,,0.0,-0.0,0.0,0.0,100441,26.09.2016 18:15:00,13672,-0.0,23.95,IS,0.27,0.0,Phase3-EA-S1v2-USDJPY-M15-0,USDJPYMT4,3948,1h 0m,Sell
153644.4,1.09085,26.09.2016 21:44:59,tp 1.09085,0.0,-0.0,0.0,0.0,1.08975,26.09.2016 20:15:00,13673,-0.0,46.54,IS,0.41,0.0,Phase3-EA-SA2v2-EURCHF-M5-43,EURCHFMT4,6956,1h 29m,Buy
153628.66,0.96906,27.09.2016 02:15:00,,-3.17,-15.739999999990687,0.0,0.0,0.96885,26.09.2016 22:00:00,13674,-0.006460234669867487,-15.74,IS,0.58,0.0,Phase3-EA-SA2v2-USDCHF-M15-107,USDCHFMT4,2676,4h 15m,Sell
153589.17,113158,27.09.2016 05:44:58,sl 113.158,-0.59,-55.22999999998137,0.0,0.0,112928,26.09.2016 20:30:00,13675,-0.022668282135760616,-39.49,IS,0.17,0.0,Phase3-EA-T1v2-EURJPY-M15-322,EURJPYMT4,2616,9h 14m,Sell
153602.27,1.09043,27.09.2016 06:25:00,,-2.12,-42.12999999997555,0.0,0.0,1.09079,26.09.2016 22:05:00,13676,-0.01729159381458198,13.1,IS,0.41,0.0,Phase3-EA-SA2v2-EURCHF-M5-43,EURCHFMT4,6958,8h 20m,Sell
153559.74,1.29448,27.09.2016 13:59:58,sl 1.29448,-0.53,-84.65999999997439,0.0,0.0,1.29748,26.09.2016 19:00:00,13677,-0.03474736131836973,-42.53,IS,0.14,0.0,Phase3-EA-B1v1-GBPUSD-M30-14,GBPUSDMT4,894,18h 59m,Buy
153623.32,1.08884,27.09.2016 15:00:00,,0.0,-21.079999999987194,0.0,0.0,1.09065,27.09.2016 06:15:00,13678,-0.008651953420635608,63.58,IS,0.34,0.0,Phase3-EA-S4v1-EURCHF-M15-221,EURCHFMT4,3548,8h 45m,Sell
153636.51,100277,27.09.2016 23:00:00,,0.0,-7.889999999984866,0.0,0.0,100326,27.09.2016 17:45:00,13679,-0.0032383260193892542,13.19,IS,0.27,0.0,Phase3-EA-S1v2-USDJPY-M15-0,USDJPYMT4,3950,5h 15m,Sell
153636.05,130751,28.09.2016 06:30:00,,0.0,-8.349999999976717,0.0,0.0,130749,28.09.2016 01:05:00,13680,-0.003427125761961564,-0.46,IS,0.23,0.0,Phase3-EA-S4v1-GBPJPY-M5-194,GBPJPYMT4,2994,5h 25m,Sell
153636.47,1.08887,28.09.2016 08:35:00,,0.0,-7.929999999963911,0.0,0.0,1.08886,28.09.2016 00:15:00,13681,-0.0032547433883002757,0.42,IS,0.41,0.0,Phase3-EA-SA2v2-EURCHF-M5-43,EURCHFMT4,6960,8h 20m,Buy
153597.66,112783,28.09.2016 12:14:57,sl 112.783,0.0,-46.73999999996158,0.0,0.0,112553,28.09.2016 11:15:00,13682,-0.019183695582562697,-38.81,IS,0.17,0.0,Phase3-EA-T1v2-EURJPY-M15-322,EURJPYMT4,2618,59m 57s,Sell
153648.74,1.08985,28.09.2016 13:45:00,,0.0,-0.0,0.0,0.0,1.08839,28.09.2016 05:00:00,13683,-0.0,51.08,IS,0.34,0.0,Phase3-EA-S4v1-EURCHF-M15-221,EURCHFMT4,3550,8h 45m,Buy
153609.87,112632,28.09.2016 18:14:58,sl 112.632,0.0,-38.86999999999534,0.0,0.0,112862,28.09.2016 12:15:00,13684,-0.01595329407408188,-38.87,IS,0.17,0.0,Phase3-EA-T1v2-EURJPY-M15-322,EURJPYMT4,2620,5h 59m,Buy
153610.11,0.97122,29.09.2016 02:15:00,,-2.15,-38.63000000000466,0.0,0.0,0.97118,28.09.2016 22:00:00,13685,-0.01585479161517703,0.24,IS,0.58,0.0,Phase3-EA-SA2v2-USDCHF-M15-107,USDCHFMT4,2678,4h 15m,Buy
153547.14,131553,29.09.2016 03:29:58,sl 131.553,-3.12,-101.60000000000582,0.0,0.0,130883,23.09.2016 14:30:00,13686,-0.041699374271340524,-62.97,IS,0.09,0.0,Phase3-EA-B1v1-GBPJPY-M30-1,GBPJPYMT4,1272,5d 12h 59m,Sell
153534.05,1.08953,29.09.2016 04:35:00,,-6.33,-114.69000000000233,0.0,0.0,1.08937,28.09.2016 20:15:00,13687,-0.04707186255098295,-13.09,IS,0.41,0.0,Phase3-EA-SA2v2-EURCHF-M5-43,EURCHFMT4,6962,8h 20m,Sell
153466.82,113809,29.09.2016 05:29:58,sl 113.809,-3.12,-181.9200000000128,0.0,0.0,113089,21.09.2016 15:00:00,13688,-0.0746648638527792,-67.23,IS,0.09,0.0,Phase3-EA-TR1v1-EURJPY-M30-91,EURJPYMT4,2456,7d 14h 29m,Sell
153357.75,132072,29.09.2016 08:40:00,,0.0,-290.9900000000198,0.0,0.0,131591,29.09.2016 03:15:00,13689,-0.11943012715765265,-109.07,IS,0.23,0.0,Phase3-EA-S4v1-GBPJPY-M5-194,GBPJPYMT4,2996,5h 25m,Sell
153315.75,1.30125,29.09.2016 09:59:57,sl 1.30125,0.0,-332.9900000000198,0.0,0.0,1.30425,29.09.2016 03:30:00,13690,-0.13666805746667038,-42.0,IS,0.14,0.0,Phase3-EA-B1v1-GBPUSD-M30-14,GBPUSDMT4,896,6h 29m,Buy
153380.96,1.08782,29.09.2016 14:30:00,,0.0,-267.78000000002794,0.0,0.0,1.08968,29.09.2016 05:45:00,13691,-0.10990411852736309,65.21,IS,0.34,0.0,Phase3-EA-S4v1-EURCHF-M15-221,EURCHFMT4,3552,8h 45m,Sell
153521.09,113804,29.09.2016 15:00:00,,-2.48,-127.65000000002328,0.0,0.0,112953,28.09.2016 22:30:00,13692,-0.05239099533205988,140.13,IS,0.17,0.0,Phase3-EA-T1v2-EURJPY-M15-322,EURJPYMT4,2622,16h 30m,Buy
153479.09,1.30221,29.09.2016 15:29:58,sl 1.30221,0.0,-169.65000000002328,0.0,0.0,1.29921,29.09.2016 13:00:00,13693,-0.06962892564107762,-42.0,IS,0.14,0.0,Phase3-EA-B1v1-GBPUSD-M30-14,GBPUSDMT4,898,2h 29m,Sell
153440.48,113775,29.09.2016 20:59:57,sl 113.775,0.0,-208.2600000000093,0.0,0.0,114005,29.09.2016 16:45:00,13694,-0.0854755087180046,-38.61,IS,0.17,0.0,Phase3-EA-T1v2-EURJPY-M15-322,EURJPYMT4,2624,4h 14m,Buy
153381.05,131.47,29.09.2016 20:59:58,sl 131.470,0.0,-267.6900000000023,0.0,0.0,132.14,29.09.2016 08:30:00,13695,-0.10986718010526184,-59.43,IS,0.09,0.0,Phase3-EA-B1v1-GBPJPY-M30-1,GBPJPYMT4,1274,12h 29m,Buy
153316.86,113138,29.09.2016 21:29:58,sl 113.138,0.0,-331.88000000000466,0.0,0.0,113858,29.09.2016 08:00:00,13696,-0.13621248359421156,-64.19,IS,0.09,0.0,Phase3-EA-TR1v1-EURJPY-M30-91,EURJPYMT4,2458,13h 29m,Buy
153405.58,130843,30.09.2016 04:39:58,tp 130.843,0.0,-243.1600000000035,0.0,0.0,131233,30.09.2016 03:15:00,13697,-0.09979940795097171,88.72,IS,0.23,0.0,Phase3-EA-S4v1-GBPJPY-M5-194,GBPJPYMT4,2998,1h 24m,Sell
153409.05,101055,30.09.2016 04:45:00,,0.0,-239.69000000000233,0.0,0.0,101068,30.09.2016 01:45:00,13698,-0.09837522656591668,3.47,IS,0.27,0.0,Phase3-EA-S1v2-USDJPY-M15-0,USDJPYMT4,3952,3h 0m,Sell
153338.02,1.0837,30.09.2016 04:45:00,,-1.02,-310.72000000000116,0.0,0.0,1.08535,29.09.2016 20:25:00,13699,-0.12752785013376214,-71.03,IS,0.41,0.0,Phase3-EA-SA2v2-EURCHF-M5-43,EURCHFMT4,6964,8h 20m,Buy
153478.28,1.08744,30.09.2016 13:59:58,tp 1.08744,0.0,-170.45999999999185,0.0,0.0,1.08344,30.09.2016 05:15:00,13700,-0.06996137143988149,140.26,IS,0.34,0.0,Phase3-EA-S4v1-EURCHF-M15-221,EURCHFMT4,3554,8h 44m,Buy
153439.63,113555,30.09.2016 17:29:58,sl 113.555,0.0,-209.10999999998603,0.0,0.0,113325,30.09.2016 10:15:00,13701,-0.0858243715932966,-38.65,IS,0.17,0.0,Phase3-EA-T1v2-EURJPY-M15-322,EURJPYMT4,2626,7h 14m,Sell
153483.96,1.08974,03.10.2016 01:00:00,tp 1.08974,-2.11,-164.77999999999884,0.0,0.0,1.09084,30.09.2016 20:35:00,13702,-0.06763014657904576,44.33,IS,0.41,0.0,Phase3-EA-SA2v2-EURCHF-M5-43,EURCHFMT4,6966,2d 4h 25m,Sell
153572.37,131307,03.10.2016 03:54:58,tp 131.307,0.0,-76.36999999999534,0.0,0.0,130917,03.10.2016 01:15:00,13703,-0.031344303278562,88.41,IS,0.23,0.0,Phase3-EA-S4v1-GBPJPY-M5-194,GBPJPYMT4,3000,2h 39m,Buy
153569.18,113891,03.10.2016 08:15:00,,0.0,-79.55999999999767,0.0,0.0,113.91,03.10.2016 07:00:00,13704,-0.032653565128224066,-3.19,IS,0.17,0.0,Phase3-EA-T1v2-EURJPY-M15-322,EURJPYMT4,2628,1h 15m,Buy
153556.11,1.09221,03.10.2016 10:30:00,,0.0,-92.63000000000466,0.0,0.0,1.0919,03.10.2016 02:10:00,13705,-0.0380178448696284,-13.07,IS,0.41,0.0,Phase3-EA-SA2v2-EURCHF-M5-43,EURCHFMT4,6968,8h 20m,Sell
153586.21,1.09133,03.10.2016 15:30:00,,0.0,-62.529999999998836,0.0,0.0,1.09219,03.10.2016 06:45:00,13706,-0.02566399481482997,30.1,IS,0.34,0.0,Phase3-EA-S4v1-EURCHF-M15-221,EURCHFMT4,3556,8h 45m,Sell
153563.94,113845,03.10.2016 20:45:00,,0.0,-84.79999999998836,0.0,0.0,113978,03.10.2016 19:00:00,13707,-0.03480420214772626,-22.27,IS,0.17,0.0,Phase3-EA-T1v2-EURJPY-M15-322,EURJPYMT4,2630,1h 45m,Buy
153579.38,101613,04.10.2016 00:15:00,,-0.77,-69.35999999998603,0.0,0.0,101552,03.10.2016 23:30:00,13708,-0.028467210624600694,15.44,IS,0.27,0.0,Phase3-EA-S1v2-USDJPY-M15-0,USDJPYMT4,3954,45m 0s,Buy
153604.28,0.97353,04.10.2016 02:30:00,,-0.72,-44.45999999999185,0.0,0.0,0.9731,03.10.2016 22:15:00,13709,-0.018247580512828283,24.9,IS,0.58,0.0,Phase3-EA-SA2v2-USDCHF-M15-107,USDCHFMT4,2680,4h 15m,Buy
153535.23,114618,04.10.2016 06:29:58,sl 114.618,-0.31,-113.50999999998021,0.0,0.0,113838,03.10.2016 10:30:00,13710,-0.0465875587946729,-69.05,IS,0.09,0.0,Phase3-EA-TR1v1-EURJPY-M30-91,EURJPYMT4,2460,19h 59m,Sell
153537.59,1.09135,04.10.2016 07:25:00,,-1.01,-111.14999999999418,0.0,0.0,1.09127,03.10.2016 23:05:00,13711,-0.04561895128207668,2.36,IS,0.41,0.0,Phase3-EA-SA2v2-EURCHF-M5-43,EURCHFMT4,6970,8h 20m,Buy
153443.77,131235,04.10.2016 08:55:00,,0.0,-204.97000000000116,0.0,0.0,130818,04.10.2016 03:30:00,13712,-0.08412520417712821,-93.82,IS,0.23,0.0,Phase3-EA-S4v1-GBPJPY-M5-194,GBPJPYMT4,3002,5h 25m,Sell
153488.42,102872,05.10.2016 00:45:00,,-0.76,-160.32000000000698,0.0,0.0,102699,04.10.2016 21:45:00,13713,-0.06579964255099627,44.65,IS,0.27,0.0,Phase3-EA-S1v2-USDJPY-M15-0,USDJPYMT4,3956,3h 0m,Buy
153476.69,1.09723,05.10.2016 05:50:00,,-2.09,-172.05000000001746,0.0,0.0,1097,04.10.2016 21:30:00,13714,-0.07061395023016195,-11.73,IS,0.41,0.0,Phase3-EA-SA2v2-EURCHF-M5-43,EURCHFMT4,6972,8h 20m,Sell
153586.16,115895,05.10.2016 18:29:58,tp 115.895,-0.43,-62.5800000000163,0.0,0.0,114635,04.10.2016 06:30:00,13715,-0.02568451616044311,109.47,IS,0.09,0.0,Phase3-EA-TR1v1-EURJPY-M30-91,EURJPYMT4,2462,1d 11h 59m,Buy
153864.39,116.16,05.10.2016 22:59:58,tp 116.160,-0.81,-0.0,0.0,0.0,114.46,04.10.2016 16:00:00,13716,-0.0,278.23,IS,0.17,0.0,Phase3-EA-T1v2-EURJPY-M15-322,EURJPYMT4,2632,1d 6h 59m,Buy
153763.69,1.09136,06.10.2016 04:20:00,,-3.03,-100.70000000001164,0.0,0.0,1.09368,05.10.2016 20:00:00,13717,-0.04129344181822168,-100.7,IS,0.41,0.0,Phase3-EA-SA2v2-EURCHF-M5-43,EURCHFMT4,6974,8h 20m,Buy
153742.29,103454,06.10.2016 04:30:00,,0.0,-122.10000000000582,0.0,0.0,103536,06.10.2016 00:15:00,13718,-0.05006881078455337,-21.4,IS,0.27,0.0,Phase3-EA-S1v2-USDJPY-M15-0,USDJPYMT4,3958,4h 15m,Buy
153783.1,131934,06.10.2016 04:40:00,,-3.86,-81.29000000000815,0.0,0.0,132135,05.10.2016 23:15:00,13719,-0.03333410015296116,40.81,IS,0.23,0.0,Phase3-EA-S4v1-GBPJPY-M5-194,GBPJPYMT4,3004,5h 25m,Sell
153745.39,115793,06.10.2016 13:59:58,sl 115.793,0.0,-119.0,0.0,0.0,116023,06.10.2016 10:15:00,13720,-0.04879761247634371,-37.71,IS,0.17,0.0,Phase3-EA-T1v2-EURJPY-M15-322,EURJPYMT4,2634,3h 44m,Buy
153677.95,1.09405,06.10.2016 14:30:00,,0.0,-186.44000000000233,0.0,0.0,1.09211,06.10.2016 05:45:00,13721,-0.0764523266394087,-67.44,IS,0.34,0.0,Phase3-EA-S4v1-EURCHF-M15-221,EURCHFMT4,3558,8h 45m,Sell
153733.98,0.98045,07.10.2016 01:14:57,tp 0.98045,-3.13,-130.4100000000035,0.0,0.0,0.98145,06.10.2016 23:15:00,13722,-0.05347644237848869,56.03,IS,0.58,0.0,Phase3-EA-SA2v2-USDCHF-M15-107,USDCHFMT4,2682,1h 59m,Sell
153695.58,115825,07.10.2016 02:44:58,sl 115.825,-0.8,-168.80999999999767,0.0,0.0,116055,06.10.2016 22:00:00,13723,-0.06922289884144091,-38.4,IS,0.17,0.0,Phase3-EA-T1v2-EURJPY-M15-322,EURJPYMT4,2636,4h 44m,Buy
153781.97,126537,07.10.2016 03:19:58,tp 126.537,0.0,-82.4199999999837,0.0,0.0,126147,07.10.2016 03:15:00,13724,-0.0337974724394912,86.39,IS,0.23,0.0,Phase3-EA-S4v1-GBPJPY-M5-194,GBPJPYMT4,3006,4m 58s,Buy
153745.46,1.09248,07.10.2016 05:20:00,,-1.0,-118.92999999999302,0.0,0.0,1.09333,06.10.2016 21:00:00,13725,-0.04876890799841359,-36.51,IS,0.41,0.0,Phase3-EA-SA2v2-EURCHF-M5-43,EURCHFMT4,6976,8h 20m,Buy
153703.58,1.09204,07.10.2016 10:45:00,,0.0,-160.80999999999767,0.0,0.0,1.09325,07.10.2016 02:00:00,13726,-0.06594238707832537,-41.88,IS,0.34,0.0,Phase3-EA-S4v1-EURCHF-M15-221,EURCHFMT4,3560,8h 45m,Buy
153749.67,1.09459,07.10.2016 23:04:59,tp 1.09459,0.0,-114.72000000000116,0.0,0.0,1.09349,07.10.2016 21:55:00,13727,-0.047042538683077374,46.09,IS,0.41,0.0,Phase3-EA-SA2v2-EURCHF-M5-43,EURCHFMT4,6978,1h 9m,Buy
153854.5,103024,07.10.2016 23:29:58,tp 103.024,0.0,-9.89000000001397,0.0,0.0,103424,07.10.2016 20:00:00,13728,-0.0040555326671573196,104.83,IS,0.27,0.0,Phase3-EA-S1v2-USDJPY-M15-0,USDJPYMT4,3960,3h 29m,Sell
153898.55,1.09328,10.10.2016 01:00:00,tp 1.09328,-2.1,-0.0,0.0,0.0,1.09438,07.10.2016 23:10:00,13729,-0.0,44.05,IS,0.41,0.0,Phase3-EA-SA2v2-EURCHF-M5-43,EURCHFMT4,6980,2d 1h 50m,Sell
153944.7,1.09391,10.10.2016 01:09:58,tp 1.09391,0.0,-0.0,0.0,0.0,1.09281,10.10.2016 01:05:00,13730,-0.0,46.15,IS,0.41,0.0,Phase3-EA-SA2v2-EURCHF-M5-43,EURCHFMT4,6982,4m 58s,Buy
153958.78,103699,11.10.2016 04:00:00,,-0.76,-0.0,0.0,0.0,103642,10.10.2016 23:15:00,13731,-0.0,14.08,IS,0.27,0.0,Phase3-EA-S1v2-USDJPY-M15-0,USDJPYMT4,3962,4h 45m,Buy
153948.61,1.09446,11.10.2016 05:55:00,,-1.0,-10.170000000012806,0.0,0.0,1.09468,10.10.2016 21:35:00,13732,-0.004168737030088757,-10.17,IS,0.41,0.0,Phase3-EA-SA2v2-EURCHF-M5-43,EURCHFMT4,6984,8h 20m,Buy
153955.91,128048,11.10.2016 09:05:00,,0.0,-2.870000000024447,0.0,0.0,128015,11.10.2016 03:40:00,13733,-0.0011764282474377168,7.3,IS,0.23,0.0,Phase3-EA-S4v1-GBPJPY-M5-194,GBPJPYMT4,3008,5h 25m,Buy
154066.95,114656,11.10.2016 18:59:58,tp 114.656,-0.91,-0.0,0.0,0.0,115946,06.10.2016 01:00:00,13734,-0.0,111.04,IS,0.09,0.0,Phase3-EA-TR1v1-EURJPY-M30-91,EURJPYMT4,2464,5d 17h 59m,Sell
154175.92,114173,11.10.2016 21:29:58,tp 114.173,-0.61,-0.0,0.0,0.0,115433,07.10.2016 05:00:00,13735,-0.0,108.97,IS,0.09,0.0,Phase3-EA-TR1v1-EURJPY-M30-91,EURJPYMT4,2465,4d 16h 29m,Sell
154221.53,1.0927,11.10.2016 22:04:57,tp 1.09270,0.0,-0.0,0.0,0.0,1.0938,11.10.2016 20:55:00,13736,-0.0,45.61,IS,0.41,0.0,Phase3-EA-SA2v2-EURCHF-M5-43,EURCHFMT4,6986,1h 9m,Sell
154262.31,103284,12.10.2016 03:45:00,,0.0,-0.0,0.0,0.0,103.44,12.10.2016 00:15:00,13737,-0.0,40.78,IS,0.27,0.0,Phase3-EA-S1v2-USDJPY-M15-0,USDJPYMT4,3964,3h 30m,Sell
154084.62,127098,12.10.2016 04:54:58,sl 127.098,0.0,-177.69000000000233,0.0,0.0,126298,12.10.2016 02:50:00,13738,-0.07274556602694932,-177.69,IS,0.23,0.0,Phase3-EA-S4v1-GBPJPY-M5-194,GBPJPYMT4,3010,2h 4m,Sell
154042.62,1.22743,12.10.2016 12:29:58,sl 1.22743,0.0,-219.69000000000233,0.0,0.0,1.23043,12.10.2016 12:00:00,13739,-0.08994019584929064,-42.0,IS,0.14,0.0,Phase3-EA-B1v1-GBPUSD-M30-14,GBPUSDMT4,900,29m 58s,Buy
154012.39,1.09127,12.10.2016 13:30:00,,0.0,-249.9200000000128,0.0,0.0,1.09215,12.10.2016 04:45:00,13740,-0.10231623536189918,-30.23,IS,0.34,0.0,Phase3-EA-S4v1-EURCHF-M15-221,EURCHFMT4,3562,8h 45m,Buy
153949.79,114806,12.10.2016 19:29:58,sl 114.806,-0.3,-312.5200000000186,0.0,0.0,114086,11.10.2016 22:00:00,13741,-0.12794442171615317,-62.6,IS,0.09,0.0,Phase3-EA-TR1v1-EURJPY-M30-91,EURJPYMT4,2468,21h 29m,Sell
153989.11,1.08979,13.10.2016 01:00:00,tp 1.08979,-6.21,-273.20000000001164,0.0,0.0,1.09089,12.10.2016 22:20:00,13742,-0.11184697303485361,39.32,IS,0.41,0.0,Phase3-EA-SA2v2-EURCHF-M5-43,EURCHFMT4,6988,2h 40m,Sell
153993.85,104326,13.10.2016 03:45:00,,-2.25,-268.46000000002095,0.0,0.0,104299,12.10.2016 22:30:00,13743,-0.10990643624062177,4.74,IS,0.27,0.0,Phase3-EA-S1v2-USDJPY-M15-0,USDJPYMT4,3966,5h 15m,Buy
153956.34,114625,13.10.2016 06:14:57,sl 114.625,0.0,-305.97000000003027,0.0,0.0,114855,13.10.2016 03:30:00,13744,-0.12526287825576898,-37.51,IS,0.17,0.0,Phase3-EA-T1v2-EURJPY-M15-322,EURJPYMT4,2638,2h 44m,Buy
153924.42,1.08952,13.10.2016 09:25:00,,0.0,-337.8900000000431,0.0,0.0,1.09029,13.10.2016 01:05:00,13745,-0.13833079692075365,-31.92,IS,0.41,0.0,Phase3-EA-SA2v2-EURCHF-M5-43,EURCHFMT4,6990,8h 20m,Buy
153886.63,114298,13.10.2016 19:29:58,sl 114.298,0.0,-375.6800000000512,0.0,0.0,114068,13.10.2016 19:00:00,13746,-0.15380186980138266,-37.79,IS,0.17,0.0,Phase3-EA-T1v2-EURJPY-M15-322,EURJPYMT4,2640,29m 58s,Sell
153848.86,114486,13.10.2016 21:59:58,sl 114.486,0.0,-413.45000000004075,0.0,0.0,114256,13.10.2016 21:15:00,13747,-0.16926475476304104,-37.77,IS,0.17,0.0,Phase3-EA-T1v2-EURJPY-M15-322,EURJPYMT4,2642,44m 58s,Sell
153935.33,127.27,14.10.2016 05:34:58,tp 127.270,0.0,-326.9800000000396,0.0,0.0,126.88,14.10.2016 02:15:00,13748,-0.13386428712642498,86.47,IS,0.23,0.0,Phase3-EA-S4v1-GBPJPY-M5-194,GBPJPYMT4,3012,3h 19m,Buy
153978.98,1.08905,14.10.2016 07:14:59,tp 1.08905,-2.08,-283.3300000000454,0.0,0.0,1.09015,13.10.2016 23:10:00,13749,-0.1159941539896369,43.65,IS,0.41,0.0,Phase3-EA-SA2v2-EURCHF-M5-43,EURCHFMT4,6992,8h 4m,Sell
153983.45,1.08973,14.10.2016 14:15:00,,0.0,-278.86000000004424,0.0,0.0,1.0896,14.10.2016 05:30:00,13750,-0.11416415410140153,4.47,IS,0.34,0.0,Phase3-EA-S4v1-EURCHF-M15-221,EURCHFMT4,3564,8h 45m,Buy
153767.71,104442,14.10.2016 16:44:57,sl 104.442,-1.17,-494.6000000000349,0.0,0.0,103612,13.10.2016 23:15:00,13751,-0.20248723595549104,-215.74,IS,0.27,0.0,Phase3-EA-S1v2-USDJPY-M15-0,USDJPYMT4,3968,17h 29m,Sell
153771.85,104342,14.10.2016 17:30:00,,0.0,-490.46000000002095,0.0,0.0,104326,14.10.2016 17:00:00,13752,-0.20079233673014024,4.14,IS,0.27,0.0,Phase3-EA-S1v2-USDJPY-M15-0,USDJPYMT4,3970,30m 0s,Buy
153749.06,104256,14.10.2016 17:45:00,,0.0,-513.2500000000291,0.0,0.0,104344,14.10.2016 17:30:00,13753,-0.21012247038850448,-22.79,IS,0.27,0.0,Phase3-EA-S1v2-USDJPY-M15-0,USDJPYMT4,3972,15m 0s,Buy
153767.95,104331,14.10.2016 19:00:00,,0.0,-494.36000000001513,0.0,0.0,104258,14.10.2016 17:45:00,13754,-0.20238898092792668,18.89,IS,0.27,0.0,Phase3-EA-S1v2-USDJPY-M15-0,USDJPYMT4,3974,1h 15m,Buy
153730.45,114617,14.10.2016 19:29:58,sl 114.617,0.0,-531.8600000000151,0.0,0.0,114847,14.10.2016 17:30:00,13755,-0.21774132898358858,-37.5,IS,0.17,0.0,Phase3-EA-T1v2-EURJPY-M15-322,EURJPYMT4,2644,1h 59m,Buy
153776.0,1.08668,14.10.2016 23:49:59,tp 1.08668,0.0,-486.3100000000268,0.0,0.0,1.08778,14.10.2016 21:05:00,13756,-0.19909334354531602,45.55,IS,0.41,0.0,Phase3-EA-SA2v2-EURCHF-M5-43,EURCHFMT4,6994,2h 44m,Sell
153765.87,0.99045,17.10.2016 04:00:00,,-3.1,-496.44000000003143,0.0,0.0,0.99033,14.10.2016 23:45:00,13757,-0.2032405245000874,-10.13,IS,0.58,0.0,Phase3-EA-SA2v2-USDCHF-M15-107,USDCHFMT4,2684,2d 4h 15m,Sell
153751.96,126676,17.10.2016 06:30:00,,0.0,-510.3500000000349,0.0,0.0,126739,17.10.2016 01:05:00,13758,-0.20893522213886903,-13.91,IS,0.23,0.0,Phase3-EA-S4v1-GBPJPY-M5-194,GBPJPYMT4,3014,5h 25m,Buy
153778.48,1.08676,17.10.2016 09:25:00,,0.0,-483.8300000000454,0.0,0.0,1.08612,17.10.2016 01:05:00,13759,-0.1980780415939092,26.52,IS,0.41,0.0,Phase3-EA-SA2v2-EURCHF-M5-43,EURCHFMT4,6996,8h 20m,Buy
153732.88,127047,18.10.2016 09:15:00,,0.0,-529.4300000000512,0.0,0.0,126841,18.10.2016 03:50:00,13760,-0.21674649682959646,-45.6,IS,0.23,0.0,Phase3-EA-S4v1-GBPJPY-M5-194,GBPJPYMT4,3016,5h 25m,Sell
153718.43,1.08821,18.10.2016 13:30:00,,0.0,-543.8800000000629,0.0,0.0,1.08779,18.10.2016 04:45:00,13761,-0.22266226828038296,-14.45,IS,0.34,0.0,Phase3-EA-S4v1-EURCHF-M15-221,EURCHFMT4,3566,8h 45m,Sell
153711.41,103859,19.10.2016 03:15:00,,0.0,-550.9000000000524,0.0,0.0,103832,19.10.2016 00:30:00,13762,-0.22553622783639857,-7.02,IS,0.27,0.0,Phase3-EA-S1v2-USDJPY-M15-0,USDJPYMT4,3976,2h 45m,Sell
153652.96,127.41,19.10.2016 05:29:57,sl 127.410,-0.31,-609.350000000064,0.0,0.0,128.08,18.10.2016 17:30:00,13763,-0.24946542100582836,-58.45,IS,0.09,0.0,Phase3-EA-B1v1-GBPJPY-M30-1,GBPJPYMT4,1276,11h 59m,Buy
153653.63,1.08695,19.10.2016 07:35:00,,-0.99,-608.6800000000512,0.0,0.0,1.08691,18.10.2016 23:15:00,13764,-0.24919112572056196,0.67,IS,0.41,0.0,Phase3-EA-SA2v2-EURCHF-M5-43,EURCHFMT4,6998,8h 20m,Buy
153662.58,1.08669,19.10.2016 14:00:00,,0.0,-599.7300000000396,0.0,0.0,1.08695,19.10.2016 05:15:00,13765,-0.24552703198460588,8.95,IS,0.34,0.0,Phase3-EA-S4v1-EURCHF-M15-221,EURCHFMT4,3568,8h 45m,Sell
153773.96,113445,19.10.2016 15:29:58,tp 113.445,-0.9,-488.3500000000349,0.0,0.0,114735,14.10.2016 16:30:00,13766,-0.19992851127954736,111.38,IS,0.09,0.0,Phase3-EA-TR1v1-EURJPY-M30-91,EURJPYMT4,2470,4d 22h 59m,Sell
153811.86,103297,19.10.2016 17:45:00,,0.0,-450.45000000004075,0.0,0.0,103442,19.10.2016 17:00:00,13767,-0.18441240484462745,37.9,IS,0.27,0.0,Phase3-EA-S1v2-USDJPY-M15-0,USDJPYMT4,3978,45m 0s,Sell
153728.98,127356,20.10.2016 04:55:00,,-3.87,-533.3300000000454,0.0,0.0,127.0,19.10.2016 23:30:00,13768,-0.21834314102738292,-82.88,IS,0.23,0.0,Phase3-EA-S4v1-GBPJPY-M5-194,GBPJPYMT4,3018,5h 25m,Sell
153665.49,114292,20.10.2016 16:59:58,sl 114.292,-0.91,-596.8200000000361,0.0,0.0,113572,19.10.2016 15:00:00,13769,-0.2443356897754851,-63.49,IS,0.09,0.0,Phase3-EA-TR1v1-EURJPY-M30-91,EURJPYMT4,2471,1d 1h 59m,Sell
153708.86,1.08417,21.10.2016 01:49:57,tp 1.08417,-2.07,-553.4500000000407,0.0,0.0,1.08527,20.10.2016 21:55:00,13770,-0.22658018750417883,43.37,IS,0.41,0.0,Phase3-EA-SA2v2-EURCHF-M5-43,EURCHFMT4,7000,3h 54m,Sell
153715.64,103982,21.10.2016 02:15:00,,-0.75,-546.6700000000419,0.0,0.0,103953,20.10.2016 23:15:00,13771,-0.22380448297571562,6.78,IS,0.27,0.0,Phase3-EA-S1v2-USDJPY-M15-0,USDJPYMT4,3980,3h 0m,Buy
153743.51,0.99249,21.10.2016 02:30:00,,-3.1,-518.8000000000466,0.0,0.0,0.99302,20.10.2016 22:15:00,13772,-0.2123946179007496,27.87,IS,0.58,0.0,Phase3-EA-SA2v2-USDCHF-M15-107,USDCHFMT4,2686,4h 15m,Sell
153766.05,127387,21.10.2016 08:45:00,,0.0,-496.2600000000384,0.0,0.0,127489,21.10.2016 03:20:00,13773,-0.20316683322942308,22.54,IS,0.23,0.0,Phase3-EA-S4v1-GBPJPY-M5-194,GBPJPYMT4,3020,5h 25m,Sell
153836.85,1.08301,21.10.2016 14:30:00,,0.0,-425.46000000005006,0.0,0.0,1.08508,21.10.2016 05:45:00,13774,-0.17418160010033817,70.8,IS,0.34,0.0,Phase3-EA-S4v1-EURCHF-M15-221,EURCHFMT4,3570,8h 45m,Sell
153846.58,1.08156,24.10.2016 04:20:00,,-0.99,-415.7300000000396,0.0,0.0,1.0813,21.10.2016 20:00:00,13775,-0.1701981775248248,9.73,IS,0.41,0.0,Phase3-EA-SA2v2-EURCHF-M5-43,EURCHFMT4,7002,2d 8h 20m,Buy
153842.46,126804,24.10.2016 05:15:00,,-0.8,-419.8500000000349,0.0,0.0,126819,21.10.2016 23:50:00,13776,-0.17188488883120495,-4.12,IS,0.23,0.0,Phase3-EA-S4v1-GBPJPY-M5-194,GBPJPYMT4,3022,2d 5h 25m,Buy
153779.94,113431,24.10.2016 18:29:58,sl 113.431,-0.3,-482.37000000002445,0.0,0.0,113439,20.10.2016 17:30:00,13777,-0.1974803235096002,-62.52,IS,0.09,0.0,Phase3-EA-TR1v1-EURJPY-M30-91,EURJPYMT4,2474,4d 0h 59m,Sell
153793.43,104296,25.10.2016 02:30:00,,-0.75,-468.88000000003376,0.0,0.0,104241,24.10.2016 23:45:00,13778,-0.19195757216904724,13.49,IS,0.27,0.0,Phase3-EA-S1v2-USDJPY-M15-0,USDJPYMT4,3982,2h 45m,Buy
153851.76,0.99434,25.10.2016 04:29:57,tp 0.99434,0.0,-410.55000000004657,0.0,0.0,0.99334,25.10.2016 01:15:00,13779,-0.16807750651340558,58.33,IS,0.58,0.0,Phase3-EA-SA2v2-USDCHF-M15-107,USDCHFMT4,2688,3h 14m,Buy
153823.04,1.08204,25.10.2016 15:15:00,,0.0,-439.27000000004773,0.0,0.0,1.0812,25.10.2016 06:30:00,13780,-0.17983535814430232,-28.72,IS,0.34,0.0,Phase3-EA-S4v1-EURCHF-M15-221,EURCHFMT4,3572,8h 45m,Sell
153784.49,113809,25.10.2016 16:59:58,sl 113.809,-1.14,-477.8200000000361,0.0,0.0,113579,21.10.2016 06:15:00,13781,-0.195617571945518,-38.55,IS,0.17,0.0,Phase3-EA-T1v2-EURJPY-M15-322,EURJPYMT4,2646,4d 10h 44m,Sell
153726.93,127232,25.10.2016 17:29:58,sl 127.232,0.0,-535.3800000000338,0.0,0.0,127902,25.10.2016 14:30:00,13782,-0.2191824027210877,-57.56,IS,0.09,0.0,Phase3-EA-B1v1-GBPJPY-M30-1,GBPJPYMT4,1278,2h 59m,Buy
153732.29,1.08284,26.10.2016 06:35:00,,-2.06,-530.0200000000477,0.0,0.0,1.08302,25.10.2016 22:15:00,13783,-0.21698804043900413,5.36,IS,0.41,0.0,Phase3-EA-SA2v2-EURCHF-M5-43,EURCHFMT4,7004,8h 20m,Sell
153674.51,127362,26.10.2016 17:29:58,sl 127.362,0.0,-587.8000000000466,0.0,0.0,126692,26.10.2016 05:30:00,13784,-0.2406429383231675,-57.78,IS,0.09,0.0,Phase3-EA-B1v1-GBPJPY-M30-1,GBPJPYMT4,1280,11h 59m,Sell
153732.84,0.99429,27.10.2016 06:14:57,tp 0.99429,0.0,-529.4700000000594,0.0,0.0,0.99329,27.10.2016 02:15:00,13785,-0.21676287266752584,58.33,IS,0.58,0.0,Phase3-EA-SA2v2-USDCHF-M15-107,USDCHFMT4,2690,3h 59m,Buy
153663.61,114219,27.10.2016 12:59:58,sl 114.219,-2.1,-598.7000000000698,0.0,0.0,112711,21.10.2016 17:30:00,13786,-0.24510535415802276,-69.23,IS,0.09,0.0,Phase3-EA-TR1v1-EURJPY-M30-91,EURJPYMT4,2475,5d 19h 29m,Sell
153769.66,114.69,27.10.2016 19:59:58,tp 114.690,-2.11,-492.6500000000815,0.0,0.0,113.43,24.10.2016 19:30:00,13787,-0.20168891385661566,106.05,IS,0.09,0.0,Phase3-EA-TR1v1-EURJPY-M30-91,EURJPYMT4,2477,3d 0h 29m,Buy
153795.82,105278,28.10.2016 03:45:00,,0.0,-466.490000000078,0.0,0.0,105176,28.10.2016 01:30:00,13788,-0.1909791158529845,26.16,IS,0.27,0.0,Phase3-EA-S1v2-USDJPY-M15-0,USDJPYMT4,3984,2h 15m,Buy
153758.94,1.08295,28.10.2016 05:10:00,,-0.99,-503.37000000008265,0.0,0.0,1.08382,27.10.2016 20:50:00,13789,-0.20607763842079468,-36.88,IS,0.41,0.0,Phase3-EA-SA2v2-EURCHF-M5-43,EURCHFMT4,7006,8h 20m,Buy
153850.99,114618,28.10.2016 06:30:00,,-0.79,-411.3200000000943,0.0,0.0,114044,27.10.2016 11:00:00,13790,-0.16839274139350138,92.05,IS,0.17,0.0,Phase3-EA-T1v2-EURJPY-M15-322,EURJPYMT4,2648,19h 30m,Buy
153795.94,1.08468,28.10.2016 14:45:00,,0.0,-466.37000000008265,0.0,0.0,1.08307,28.10.2016 06:00:00,13791,-0.1909299883392083,-55.05,IS,0.34,0.0,Phase3-EA-S4v1-EURCHF-M15-221,EURCHFMT4,3574,8h 45m,Sell
153841.47,1.08482,28.10.2016 22:19:58,tp 1.08482,0.0,-420.8400000000838,0.0,0.0,1.08592,28.10.2016 21:05:00,13792,-0.17229019081989444,45.53,IS,0.41,0.0,Phase3-EA-SA2v2-EURCHF-M5-43,EURCHFMT4,7008,1h 14m,Sell
153792.02,0.98764,31.10.2016 02:45:00,,-0.71,-470.29000000009546,0.0,0.0,0.98847,28.10.2016 22:30:00,13793,-0.19253482045596537,-49.45,IS,0.58,0.0,Phase3-EA-SA2v2-USDCHF-M15-107,USDCHFMT4,2692,2d 4h 15m,Buy
153759.9,1.08364,31.10.2016 06:50:00,,-1.0,-502.4100000000908,0.0,0.0,1.08439,28.10.2016 22:30:00,13794,-0.20568461831057308,-32.12,IS,0.41,0.0,Phase3-EA-SA2v2-EURCHF-M5-43,EURCHFMT4,7010,2d 8h 20m,Buy
153750.02,127737,31.10.2016 09:20:00,,0.0,-512.2900000000955,0.0,0.0,127692,31.10.2016 03:55:00,13795,-0.20972945027830672,-9.88,IS,0.23,0.0,Phase3-EA-S4v1-GBPJPY-M5-194,GBPJPYMT4,3024,5h 25m,Sell
153734.84,104958,31.10.2016 17:45:00,,0.0,-527.4700000000885,0.0,0.0,105017,31.10.2016 17:30:00,13796,-0.21594408077123578,-15.18,IS,0.27,0.0,Phase3-EA-S1v2-USDJPY-M15-0,USDJPYMT4,3986,15m 0s,Buy
153731.32,0.98922,01.11.2016 04:45:00,,0.0,-530.990000000078,0.0,0.0,0.98928,01.11.2016 00:30:00,13797,-0.21738515450872298,-3.52,IS,0.58,0.0,Phase3-EA-SA2v2-USDCHF-M15-107,USDCHFMT4,2694,4h 15m,Buy
153706.45,1.0849,01.11.2016 04:45:00,,-2.07,-555.8600000000733,0.0,0.0,1.08435,31.10.2016 20:25:00,13798,-0.22756683173923603,-24.87,IS,0.41,0.0,Phase3-EA-SA2v2-EURCHF-M5-43,EURCHFMT4,7012,8h 20m,Sell
153732.92,1.08477,01.11.2016 09:45:00,,0.0,-529.3900000000722,0.0,0.0,1.08554,01.11.2016 01:00:00,13799,-0.21673012099167902,26.47,IS,0.34,0.0,Phase3-EA-S4v1-EURCHF-M15-221,EURCHFMT4,3576,8h 45m,Sell
153614.2,1.07768,02.11.2016 04:55:00,,-1.01,-648.1100000000733,0.0,0.0,1.08048,01.11.2016 20:35:00,13800,-0.26533360795616434,-118.72,IS,0.41,0.0,Phase3-EA-SA2v2-EURCHF-M5-43,EURCHFMT4,7014,8h 20m,Buy
153617.69,1.07753,02.11.2016 14:30:00,,0.0,-644.6200000000827,0.0,0.0,1.07743,02.11.2016 05:45:00,13801,-0.2639048160971212,3.49,IS,0.34,0.0,Phase3-EA-S4v1-EURCHF-M15-221,EURCHFMT4,3578,8h 45m,Buy
153637.31,103.23,02.11.2016 20:30:00,,0.0,-625.0000000000873,0.0,0.0,103305,02.11.2016 19:45:00,13802,-0.2558724675944008,19.62,IS,0.27,0.0,Phase3-EA-S1v2-USDJPY-M15-0,USDJPYMT4,3988,45m 0s,Sell
153628.46,1.07938,03.11.2016 04:40:00,,-6.32,-633.8500000000931,0.0,0.0,1.07932,02.11.2016 20:20:00,13803,-0.25949562173553936,-8.85,IS,0.41,0.0,Phase3-EA-SA2v2-EURCHF-M5-43,EURCHFMT4,7016,8h 20m,Sell
153890.4,1.2402,03.11.2016 14:29:58,tp 1.24020,-2.66,-371.9100000000908,0.0,0.0,1.2213,31.10.2016 20:00:00,13804,-0.15225844707686967,261.94,IS,0.14,0.0,Phase3-EA-B1v1-GBPUSD-M30-14,GBPUSDMT4,902,2d 18h 29m,Buy
153880.61,1.07872,03.11.2016 14:30:00,,0.0,-381.70000000009895,0.0,0.0,1079,03.11.2016 05:45:00,13805,-0.15626643340927113,-9.79,IS,0.34,0.0,Phase3-EA-S4v1-EURCHF-M15-221,EURCHFMT4,3580,8h 45m,Buy
153880.37,103061,04.11.2016 04:00:00,,-0.76,-381.94000000008964,0.0,0.0,103059,03.11.2016 19:00:00,13806,-0.15636468843682355,-0.24,IS,0.27,0.0,Phase3-EA-S1v2-USDJPY-M15-0,USDJPYMT4,3990,9h 0m,Buy
153862.28,1.08176,04.11.2016 04:30:00,,-2.1,-400.03000000008615,0.0,0.0,1.08138,03.11.2016 20:10:00,13807,-0.16377066113887342,-18.09,IS,0.41,0.0,Phase3-EA-SA2v2-EURCHF-M5-43,EURCHFMT4,7018,8h 20m,Sell
153883.8,102891,04.11.2016 18:00:00,,0.0,-378.5100000000966,0.0,0.0,102973,04.11.2016 17:45:00,13808,-0.15496046033466854,21.52,IS,0.27,0.0,Phase3-EA-S1v2-USDJPY-M15-0,USDJPYMT4,3992,15m 0s,Sell
153849.73,103019,04.11.2016 18:15:00,,0.0,-412.5800000001036,0.0,0.0,102889,04.11.2016 18:00:00,13809,-0.16890858028817543,-34.07,IS,0.27,0.0,Phase3-EA-S1v2-USDJPY-M15-0,USDJPYMT4,3994,15m 0s,Sell
153909.57,0.96925,04.11.2016 23:44:58,tp 0.96925,0.0,-352.7400000001071,0.0,0.0,0.97025,04.11.2016 22:00:00,13810,-0.14441032675082197,59.84,IS,0.58,0.0,Phase3-EA-SA2v2-USDCHF-M15-107,USDCHFMT4,2696,1h 44m,Sell
153868.75,114838,07.11.2016 02:00:00,sl 114.838,-2.89,-393.5600000001141,0.0,0.0,114608,02.11.2016 21:30:00,13811,-0.161121869354348,-40.82,IS,0.17,0.0,Phase3-EA-T1v2-EURJPY-M15-322,EURJPYMT4,2650,4d 4h 30m,Sell
153651.77,103847,07.11.2016 02:00:00,sl 103.847,-1.18,-610.5400000001246,0.0,0.0,103017,04.11.2016 18:15:00,13812,-0.2499526021841528,-216.98,IS,0.27,0.0,Phase3-EA-S1v2-USDJPY-M15-0,USDJPYMT4,3996,2d 7h 45m,Sell
153738.07,129594,07.11.2016 05:19:58,tp 129.594,0.0,-524.2400000001362,0.0,0.0,129984,07.11.2016 03:50:00,13813,-0.21462173185872765,86.3,IS,0.23,0.0,Phase3-EA-S4v1-GBPJPY-M5-194,GBPJPYMT4,3026,1h 29m,Sell
153741.64,0.9749,07.11.2016 06:30:00,,0.0,-520.6700000001292,0.0,0.0,0.97484,07.11.2016 02:15:00,13814,-0.21316018832382577,3.57,IS,0.58,0.0,Phase3-EA-SA2v2-USDCHF-M15-107,USDCHFMT4,2698,4h 15m,Buy
153648.29,1.08053,07.11.2016 06:35:00,,-2.12,-614.020000000135,0.0,0.0,1.07836,04.11.2016 22:15:00,13815,-0.25137730008372255,-93.35,IS,0.41,0.0,Phase3-EA-SA2v2-EURCHF-M5-43,EURCHFMT4,7020,2d 8h 20m,Sell
153634.72,1.08123,07.11.2016 11:15:00,,0.0,-627.590000000142,0.0,0.0,1.08084,07.11.2016 02:30:00,13816,-0.2569328031001342,-13.57,IS,0.34,0.0,Phase3-EA-S4v1-EURCHF-M15-221,EURCHFMT4,3582,8h 45m,Sell
153526.24,0.97407,08.11.2016 02:30:00,,-0.71,-736.0700000001525,0.0,0.0,0.97588,07.11.2016 22:15:00,13817,-0.30134407555555726,-108.48,IS,0.58,0.0,Phase3-EA-SA2v2-USDCHF-M15-107,USDCHFMT4,2700,4h 15m,Buy
153521.85,104528,08.11.2016 03:45:00,,0.0,-740.4600000001665,0.0,0.0,104545,08.11.2016 00:15:00,13818,-0.30314132376794584,-4.39,IS,0.27,0.0,Phase3-EA-S1v2-USDJPY-M15-0,USDJPYMT4,3998,3h 30m,Buy
153455.62,1.0759,08.11.2016 04:45:00,,-1.01,-806.690000000177,0.0,0.0,1.07745,07.11.2016 20:25:00,13819,-0.3302556174139898,-66.23,IS,0.41,0.0,Phase3-EA-SA2v2-EURCHF-M5-43,EURCHFMT4,7022,8h 20m,Buy
153418.22,115244,08.11.2016 05:29:58,sl 115.244,0.0,-844.0900000001711,0.0,0.0,115474,08.11.2016 03:15:00,13820,-0.34556702587483423,-37.4,IS,0.17,0.0,Phase3-EA-T1v2-EURJPY-M15-322,EURJPYMT4,2652,2h 14m,Buy
153429.39,1.07595,08.11.2016 10:15:00,,0.0,-832.9200000001583,0.0,0.0,1.07563,08.11.2016 01:30:00,13821,-0.3409940731339825,11.17,IS,0.34,0.0,Phase3-EA-S4v1-EURCHF-M15-221,EURCHFMT4,3584,8h 45m,Buy
153391.94,115508,08.11.2016 12:14:58,sl 115.508,0.0,-870.37000000017,0.0,0.0,115278,08.11.2016 05:30:00,13822,-0.3563259513922416,-37.45,IS,0.17,0.0,Phase3-EA-T1v2-EURJPY-M15-322,EURJPYMT4,2654,6h 44m,Sell
153444.46,104878,08.11.2016 20:15:00,,0.0,-817.8500000001804,0.0,0.0,104674,08.11.2016 19:15:00,13823,-0.3348244761953562,52.52,IS,0.27,0.0,Phase3-EA-S1v2-USDJPY-M15-0,USDJPYMT4,4000,1h 0m,Buy
153548.47,115941,08.11.2016 20:29:58,tp 115.941,-4.24,-713.8400000001711,0.0,0.0,114681,27.10.2016 20:00:00,13824,-0.2922432036281685,104.01,IS,0.09,0.0,Phase3-EA-TR1v1-EURJPY-M30-91,EURJPYMT4,2480,12d 0h 29m,Buy
153594.6,1.07766,08.11.2016 22:34:58,tp 1.07766,0.0,-667.7100000001665,0.0,0.0,1.07656,08.11.2016 20:10:00,13825,-0.27335776853996174,46.13,IS,0.41,0.0,Phase3-EA-SA2v2-EURCHF-M5-43,EURCHFMT4,7024,2h 24m,Buy
153653.95,0.9773,09.11.2016 02:14:57,tp 0.97730,0.0,-608.3600000001607,0.0,0.0,0.9783,09.11.2016 01:45:00,13826,-0.24906011901719843,59.35,IS,0.58,0.0,Phase3-EA-SA2v2-USDCHF-M15-107,USDCHFMT4,2702,29m 57s,Sell
153698.28,1.07648,09.11.2016 06:04:58,tp 1.07648,-2.1,-564.0300000001735,0.0,0.0,1.07758,08.11.2016 22:35:00,13827,-0.23091159663567057,44.33,IS,0.41,0.0,Phase3-EA-SA2v2-EURCHF-M5-43,EURCHFMT4,7026,7h 29m,Sell
153638.25,128167,09.11.2016 06:29:58,sl 128.167,-0.93,-624.0600000001723,0.0,0.0,128837,04.11.2016 18:30:00,13828,-0.25548763540317365,-60.03,IS,0.09,0.0,Phase3-EA-B1v1-GBPJPY-M30-1,GBPJPYMT4,1282,4d 11h 59m,Buy
153752.05,114433,09.11.2016 06:29:58,tp 114.433,0.0,-510.26000000018394,0.0,0.0,115723,09.11.2016 03:30:00,13829,-0.20889837650359644,113.8,IS,0.09,0.0,Phase3-EA-TR1v1-EURJPY-M30-91,EURJPYMT4,2482,2h 59m,Sell
153613.89,1.08176,09.11.2016 10:44:57,sl 1.08176,0.0,-648.4200000001874,0.0,0.0,1.07786,09.11.2016 02:45:00,13830,-0.2654605207001378,-138.16,IS,0.34,0.0,Phase3-EA-S4v1-EURCHF-M15-221,EURCHFMT4,3586,7h 59m,Sell
153659.77,1.07597,09.11.2016 20:59:57,tp 1.07597,0.0,-602.5400000001828,0.0,0.0,1.07487,09.11.2016 20:05:00,13831,-0.24667743459896876,45.88,IS,0.41,0.0,Phase3-EA-SA2v2-EURCHF-M5-43,EURCHFMT4,7028,54m 57s,Buy
153705.63,1.07561,09.11.2016 22:04:58,tp 1.07561,0.0,-556.6800000001967,0.0,0.0,1.07451,09.11.2016 21:15:00,13832,-0.22790253641677036,45.86,IS,0.41,0.0,Phase3-EA-SA2v2-EURCHF-M5-43,EURCHFMT4,7030,49m 58s,Buy
153790.51,131.23,10.11.2016 01:49:58,tp 131.230,0.0,-471.8000000001921,0.0,0.0,131.62,10.11.2016 00:05:00,13833,-0.19315300833771293,84.88,IS,0.23,0.0,Phase3-EA-S4v1-GBPJPY-M5-194,GBPJPYMT4,3028,1h 44m,Sell
153709.86,0.98456,10.11.2016 04:00:00,,-9.37,-552.4500000001863,0.0,0.0,0.98335,09.11.2016 23:45:00,13834,-0.2261707915560874,-80.65,IS,0.58,0.0,Phase3-EA-SA2v2-USDCHF-M15-107,USDCHFMT4,2704,4h 15m,Sell
153794.59,131.62,10.11.2016 04:14:58,tp 131.620,0.0,-467.7200000001758,0.0,0.0,131.23,10.11.2016 02:05:00,13835,-0.19148267286925025,84.73,IS,0.23,0.0,Phase3-EA-S4v1-GBPJPY-M5-194,GBPJPYMT4,3030,2h 9m,Buy
153840.43,1.07538,10.11.2016 04:29:58,tp 1.07538,0.0,-421.8800000001793,0.0,0.0,1.07428,10.11.2016 01:05:00,13836,-0.17271596260601055,45.84,IS,0.41,0.0,Phase3-EA-SA2v2-EURCHF-M5-43,EURCHFMT4,7032,3h 24m,Buy
153898.18,1.07581,10.11.2016 10:00:00,,0.0,-364.1300000001793,0.0,0.0,1.07414,10.11.2016 01:15:00,13837,-0.14907334660029123,57.75,IS,0.34,0.0,Phase3-EA-S4v1-EURCHF-M15-221,EURCHFMT4,3588,8h 45m,Buy
154054.31,132935,10.11.2016 18:29:58,tp 132.935,0.0,-208.00000000017462,0.0,0.0,131085,10.11.2016 11:30:00,13838,-0.08515435721547618,156.13,IS,0.09,0.0,Phase3-EA-B1v1-GBPJPY-M30-1,GBPJPYMT4,1284,6h 59m,Buy
154155.48,106756,10.11.2016 20:29:58,tp 106.756,0.0,-106.83000000016182,0.0,0.0,106356,10.11.2016 19:30:00,13839,-0.04373576914103588,101.17,IS,0.27,0.0,Phase3-EA-S1v2-USDJPY-M15-0,USDJPYMT4,4002,59m 58s,Buy
154201.13,1.07573,10.11.2016 21:24:58,tp 1.07573,0.0,-61.18000000016764,0.0,0.0,1.07463,10.11.2016 20:05:00,13840,-0.025046844107945835,45.65,IS,0.41,0.0,Phase3-EA-SA2v2-EURCHF-M5-43,EURCHFMT4,7034,1h 19m,Buy
154271.6,106508,10.11.2016 21:30:00,,0.0,-0.0,0.0,0.0,106788,10.11.2016 20:30:00,13841,-0.0,70.47,IS,0.27,0.0,Phase3-EA-S1v2-USDJPY-M15-0,USDJPYMT4,4004,1h 0m,Buy
154402.54,116118,10.11.2016 22:45:00,,0.0,-0.0,0.0,0.0,115297,10.11.2016 10:45:00,13842,-0.0,130.94,IS,0.17,0.0,Phase3-EA-T1v2-EURJPY-M15-322,EURJPYMT4,2656,12h 0m,Buy
154430.35,106901,11.11.2016 00:15:00,,-0.73,-0.0,0.0,0.0,106786,10.11.2016 20:30:00,13843,-0.0,27.81,IS,0.27,0.0,Phase3-EA-S1v2-USDJPY-M15-0,USDJPYMT4,4005,3h 45m,Sell
154473.97,1.07455,11.11.2016 01:59:58,tp 1.07455,-2.08,-0.0,0.0,0.0,1.07565,10.11.2016 21:50:00,13844,-0.0,43.62,IS,0.41,0.0,Phase3-EA-SA2v2-EURCHF-M5-43,EURCHFMT4,7036,4h 9m,Sell
154519.66,1.07503,11.11.2016 02:34:58,tp 1.07503,0.0,-0.0,0.0,0.0,1.07393,11.11.2016 02:05:00,13845,-0.0,45.69,IS,0.41,0.0,Phase3-EA-SA2v2-EURCHF-M5-43,EURCHFMT4,7038,29m 58s,Buy
154603.55,134195,11.11.2016 03:49:57,tp 134.195,0.0,-0.0,0.0,0.0,133805,11.11.2016 02:50:00,13846,-0.0,83.89,IS,0.23,0.0,Phase3-EA-S4v1-GBPJPY-M5-194,GBPJPYMT4,3032,59m 57s,Buy
154662.27,0.98782,11.11.2016 05:44:57,tp 0.98782,0.0,-0.0,0.0,0.0,0.98682,11.11.2016 02:15:00,13847,-0.0,58.72,IS,0.58,0.0,Phase3-EA-SA2v2-USDCHF-M15-107,USDCHFMT4,2706,3h 29m,Buy
154625.65,116092,11.11.2016 12:44:58,sl 116.092,0.0,-36.61999999999534,0.0,0.0,116322,11.11.2016 10:30:00,13848,-0.014967571419980374,-36.62,IS,0.17,0.0,Phase3-EA-T1v2-EURJPY-M15-322,EURJPYMT4,2658,2h 14m,Buy
154684.24,0.99001,14.11.2016 04:29:57,tp 0.99001,0.0,-0.0,0.0,0.0,0.98901,14.11.2016 02:15:00,13849,-0.0,58.59,IS,0.58,0.0,Phase3-EA-SA2v2-USDCHF-M15-107,USDCHFMT4,2708,2h 14m,Buy
154473.99,107.17,14.11.2016 04:44:58,sl 107.170,-1.14,-210.25,0.0,0.0,106.34,11.11.2016 18:30:00,13850,-0.08592707074227555,-210.25,IS,0.27,0.0,Phase3-EA-S1v2-USDJPY-M15-0,USDJPYMT4,4008,2d 10h 14m,Sell
154557.51,134666,14.11.2016 05:09:59,tp 134.666,0.0,-126.73000000001048,0.0,0.0,134276,14.11.2016 02:05:00,13851,-0.051793282640520716,83.52,IS,0.23,0.0,Phase3-EA-S4v1-GBPJPY-M5-194,GBPJPYMT4,3034,3h 4m,Buy
154502.03,1.07053,14.11.2016 05:25:00,,-1.0,-182.21000000002095,0.0,0.0,1.07185,11.11.2016 21:05:00,13852,-0.07446740337670311,-55.48,IS,0.41,0.0,Phase3-EA-SA2v2-EURCHF-M5-43,EURCHFMT4,7040,2d 8h 20m,Buy
154574.49,108066,14.11.2016 18:15:00,,0.0,-109.7500000000291,0.0,0.0,107776,14.11.2016 17:30:00,13853,-0.04485372658248391,72.46,IS,0.27,0.0,Phase3-EA-S1v2-USDJPY-M15-0,USDJPYMT4,4010,45m 0s,Buy
154565.49,108032,14.11.2016 18:30:00,,0.0,-118.7500000000291,0.0,0.0,108068,14.11.2016 18:15:00,13854,-0.04853193650724244,-9.0,IS,0.27,0.0,Phase3-EA-S1v2-USDJPY-M15-0,USDJPYMT4,4012,15m 0s,Buy
154529.27,115866,14.11.2016 18:44:58,sl 115.866,0.0,-154.97000000003027,0.0,0.0,116096,14.11.2016 14:45:00,13855,-0.06333468800443778,-36.22,IS,0.17,0.0,Phase3-EA-T1v2-EURJPY-M15-322,EURJPYMT4,2660,3h 59m,Buy
154574.5,1.0709,14.11.2016 21:34:58,tp 1.07090,0.0,-109.74000000001979,0.0,0.0,1.0698,14.11.2016 20:20:00,13856,-0.04484963968256371,45.23,IS,0.41,0.0,Phase3-EA-SA2v2-EURCHF-M5-43,EURCHFMT4,7042,1h 14m,Buy
154674.09,108449,14.11.2016 23:44:58,tp 108.449,0.0,-10.150000000023283,0.0,0.0,108049,14.11.2016 22:30:00,13857,-0.004148203415153853,99.59,IS,0.27,0.0,Phase3-EA-S1v2-USDJPY-M15-0,USDJPYMT4,4014,1h 14m,Buy
154826.62,135537,15.11.2016 00:29:57,tp 135.537,-0.9,-0.0,0.0,0.0,133687,10.11.2016 20:30:00,13858,-0.0,152.53,IS,0.09,0.0,Phase3-EA-B1v1-GBPJPY-M30-1,GBPJPYMT4,1286,4d 3h 59m,Buy
154869.8,1.07044,15.11.2016 02:04:57,tp 1.07044,-2.05,-0.0,0.0,0.0,1.07154,14.11.2016 21:55:00,13859,-0.0,43.18,IS,0.41,0.0,Phase3-EA-SA2v2-EURCHF-M5-43,EURCHFMT4,7044,4h 9m,Sell
154922.67,135045,15.11.2016 04:40:00,,-1.23,-0.0,0.0,0.0,135299,14.11.2016 23:15:00,13860,-0.0,52.87,IS,0.23,0.0,Phase3-EA-S4v1-GBPJPY-M5-194,GBPJPYMT4,3036,5h 25m,Sell
154886.52,116163,15.11.2016 07:59:58,sl 116.163,0.0,-36.14999999999418,0.0,0.0,116393,15.11.2016 07:00:00,13861,-0.014759760703243217,-36.15,IS,0.17,0.0,Phase3-EA-T1v2-EURJPY-M15-322,EURJPYMT4,2662,59m 58s,Buy
154820.69,116843,15.11.2016 13:59:58,sl 116.843,-0.88,-101.97999999998137,0.0,0.0,116063,10.11.2016 20:30:00,13862,-0.041637631992163505,-65.83,IS,0.09,0.0,Phase3-EA-TR1v1-EURJPY-M30-91,EURJPYMT4,2484,4d 17h 29m,Sell
154840.37,135687,16.11.2016 04:40:00,,-1.22,-82.29999999998836,0.0,0.0,135786,15.11.2016 23:15:00,13863,-0.033602442762847594,19.68,IS,0.23,0.0,Phase3-EA-S4v1-GBPJPY-M5-194,GBPJPYMT4,3038,5h 25m,Sell
154632.09,108718,17.11.2016 03:29:58,sl 108.718,-2.15,-290.5799999999872,0.0,0.0,109548,16.11.2016 17:00:00,13864,-0.11864152877313736,-208.28,IS,0.27,0.0,Phase3-EA-S1v2-USDJPY-M15-0,USDJPYMT4,4016,10h 29m,Buy
154597.61,1.07146,17.11.2016 04:30:00,,-2.94,-325.0599999999977,0.0,0.0,1.07223,16.11.2016 20:10:00,13865,-0.13271944160987492,-34.48,IS,0.41,0.0,Phase3-EA-SA2v2-EURCHF-M5-43,EURCHFMT4,7046,8h 20m,Buy
154562.28,1.00148,17.11.2016 06:30:00,,0.0,-360.38999999998487,0.0,0.0,1.00209,17.11.2016 02:15:00,13866,-0.14714440276189367,-35.33,IS,0.58,0.0,Phase3-EA-SA2v2-USDCHF-M15-107,USDCHFMT4,2710,4h 15m,Buy
154516.11,1.07292,17.11.2016 12:45:00,,0.0,-406.5599999999977,0.0,0.0,1.07156,17.11.2016 04:00:00,13867,-0.16599525066421836,-46.17,IS,0.34,0.0,Phase3-EA-S4v1-EURCHF-M15-221,EURCHFMT4,3590,8h 45m,Sell
154588.88,116831,17.11.2016 21:00:00,,-3.05,-333.79000000000815,0.0,0.0,116342,15.11.2016 11:00:00,13868,-0.1362838319539825,72.77,IS,0.17,0.0,Phase3-EA-T1v2-EURJPY-M15-322,EURJPYMT4,2664,2d 10h 0m,Buy
154534.6,1.06961,18.11.2016 05:00:00,,-0.98,-388.070000000007,0.0,0.0,1.07092,17.11.2016 20:40:00,13869,-0.1584459290763104,-54.28,IS,0.41,0.0,Phase3-EA-SA2v2-EURCHF-M5-43,EURCHFMT4,7048,8h 20m,Buy
154550.1,1.07009,18.11.2016 13:45:00,,0.0,-372.570000000007,0.0,0.0,1.06963,18.11.2016 05:00:00,13870,-0.1521174009739506,15.5,IS,0.34,0.0,Phase3-EA-S4v1-EURCHF-M15-221,EURCHFMT4,3592,8h 45m,Buy
154495.49,136.72,18.11.2016 15:59:58,sl 136.720,0.0,-427.179999999993,0.0,0.0,137.39,18.11.2016 12:30:00,13871,-0.1744142345010332,-54.61,IS,0.09,0.0,Phase3-EA-B1v1-GBPJPY-M30-1,GBPJPYMT4,1288,3h 29m,Buy
154459.98,116783,18.11.2016 16:59:57,sl 116.783,0.0,-462.6900000000023,0.0,0.0,117013,18.11.2016 02:15:00,13872,-0.18891268823747545,-35.51,IS,0.17,0.0,Phase3-EA-T1v2-EURJPY-M15-322,EURJPYMT4,2666,14h 44m,Buy
154504.62,1.07041,18.11.2016 21:49:58,tp 1.07041,0.0,-418.04999999998836,0.0,0.0,1.06931,18.11.2016 20:10:00,13873,-0.17068652730267353,44.64,IS,0.41,0.0,Phase3-EA-SA2v2-EURCHF-M5-43,EURCHFMT4,7050,1h 39m,Buy
154604.49,118082,21.11.2016 02:00:00,tp 118.082,-2.41,-318.179999999993,0.0,0.0,116822,15.11.2016 14:30:00,13874,-0.12991039171669652,99.87,IS,0.09,0.0,Phase3-EA-TR1v1-EURJPY-M30-91,EURJPYMT4,2486,5d 11h 30m,Buy
154401.86,111202,21.11.2016 02:00:00,sl 111.202,-1.1,-520.8099999999977,0.0,0.0,110372,18.11.2016 19:00:00,13875,-0.2126426271606446,-202.63,IS,0.27,0.0,Phase3-EA-S1v2-USDJPY-M15-0,USDJPYMT4,4018,2d 7h 0m,Sell
154444.49,1.06926,21.11.2016 02:14:58,tp 1.06926,-2.03,-478.179999999993,0.0,0.0,1.07036,18.11.2016 21:55:00,13876,-0.1952371334184751,42.63,IS,0.41,0.0,Phase3-EA-SA2v2-EURCHF-M5-43,EURCHFMT4,7052,2d 4h 19m,Sell
154501.85,1.01117,21.11.2016 03:44:58,tp 1.01117,0.0,-420.820000000007,0.0,0.0,1.01017,21.11.2016 02:15:00,13877,-0.17181749651839318,57.36,IS,0.58,0.0,Phase3-EA-SA2v2-USDCHF-M15-107,USDCHFMT4,2712,1h 29m,Buy
154564.85,117676,21.11.2016 16:30:00,,-0.75,-357.820000000007,0.0,0.0,117261,18.11.2016 22:00:00,13878,-0.14609509197331788,63.0,IS,0.17,0.0,Phase3-EA-T1v2-EURJPY-M15-322,EURJPYMT4,2668,2d 18h 30m,Buy
154608.54,1.07236,22.11.2016 00:44:57,tp 1.07236,-0.97,-314.13000000000466,0.0,0.0,1.07126,21.11.2016 22:30:00,13879,-0.128256808567375,43.69,IS,0.41,0.0,Phase3-EA-SA2v2-EURCHF-M5-43,EURCHFMT4,7054,2h 14m,Buy
154656.52,110604,22.11.2016 01:15:00,,-1.09,-266.1499999999942,0.0,0.0,110805,21.11.2016 17:30:00,13880,-0.10866695189954989,47.98,IS,0.27,0.0,Phase3-EA-S1v2-USDJPY-M15-0,USDJPYMT4,4020,7h 45m,Sell
154701.24,1.07106,22.11.2016 02:04:58,tp 1.07106,0.0,-221.42999999999302,0.0,0.0,1.07216,22.11.2016 00:50:00,13881,-0.09040812759390231,44.72,IS,0.41,0.0,Phase3-EA-SA2v2-EURCHF-M5-43,EURCHFMT4,7056,1h 14m,Sell
154649.45,1.00798,22.11.2016 05:45:00,,0.0,-273.22000000000116,0.0,0.0,1.00888,22.11.2016 01:30:00,13882,-0.11155357729850009,-51.79,IS,0.58,0.0,Phase3-EA-SA2v2-USDCHF-M15-107,USDCHFMT4,2714,4h 15m,Buy
154680.17,138447,22.11.2016 06:50:00,,0.0,-242.5,0.0,0.0,138299,22.11.2016 01:25:00,13883,-0.09901084289175813,30.72,IS,0.23,0.0,Phase3-EA-S4v1-GBPJPY-M5-194,GBPJPYMT4,3040,5h 25m,Buy
154724.84,1.07331,22.11.2016 21:24:58,tp 1.07331,0.0,-197.8299999999872,0.0,0.0,1.07221,22.11.2016 20:20:00,13884,-0.0807724331928876,44.67,IS,0.41,0.0,Phase3-EA-SA2v2-EURCHF-M5-43,EURCHFMT4,7058,1h 4m,Buy
154746.95,111123,22.11.2016 23:00:00,,0.0,-175.72000000000116,0.0,0.0,111032,22.11.2016 22:00:00,13885,-0.07174509407397878,22.11,IS,0.27,0.0,Phase3-EA-S1v2-USDJPY-M15-0,USDJPYMT4,4022,1h 0m,Buy
154702.34,1.07432,23.11.2016 05:50:00,,-2.03,-220.3299999999872,0.0,0.0,1.07327,22.11.2016 21:30:00,13886,-0.08995900624470021,-44.61,IS,0.41,0.0,Phase3-EA-SA2v2-EURCHF-M5-43,EURCHFMT4,7060,8h 20m,Sell
154713.24,1.01121,23.11.2016 06:30:00,,0.0,-209.42999999999302,0.0,0.0,1.01102,23.11.2016 02:15:00,13887,-0.08550862196626892,10.9,IS,0.58,0.0,Phase3-EA-SA2v2-USDCHF-M15-107,USDCHFMT4,2716,4h 15m,Buy
154737.44,117965,23.11.2016 07:45:00,,-0.75,-185.22999999998137,0.0,0.0,117802,22.11.2016 09:15:00,13888,-0.07562795228387016,24.2,IS,0.17,0.0,Phase3-EA-T1v2-EURJPY-M15-322,EURJPYMT4,2670,22h 30m,Buy
154726.35,1.07495,23.11.2016 12:15:00,,0.0,-196.31999999997788,0.0,0.0,1.07462,23.11.2016 03:30:00,13889,-0.08015591206807327,-11.09,IS,0.34,0.0,Phase3-EA-S4v1-EURCHF-M15-221,EURCHFMT4,3594,8h 45m,Sell
154684.35,1.23982,23.11.2016 17:29:58,sl 1.23982,0.0,-238.31999999997788,0.0,0.0,1.24282,23.11.2016 17:00:00,13890,-0.09730418176479014,-42.0,IS,0.14,0.0,Phase3-EA-B1v1-GBPUSD-M30-14,GBPUSDMT4,904,29m 58s,Buy
154621.37,118496,23.11.2016 18:29:58,sl 118.496,-0.56,-301.29999999998836,0.0,0.0,117716,21.11.2016 15:00:00,13891,-0.123018420467157,-62.98,IS,0.09,0.0,Phase3-EA-TR1v1-EURJPY-M30-91,EURJPYMT4,2488,2d 3h 29m,Sell
154678.45,1.01615,23.11.2016 23:14:58,tp 1.01615,0.0,-244.22000000000116,0.0,0.0,1.01715,23.11.2016 23:00:00,13892,-0.09971310536505272,57.08,IS,0.58,0.0,Phase3-EA-SA2v2-USDCHF-M15-107,USDCHFMT4,2718,14m 58s,Sell
154695.13,112473,24.11.2016 01:30:00,,-3.24,-227.54000000000815,0.0,0.0,112556,23.11.2016 23:15:00,13893,-0.09290279254264516,16.68,IS,0.27,0.0,Phase3-EA-S1v2-USDJPY-M15-0,USDJPYMT4,4024,2h 15m,Sell
154733.5,1.07194,24.11.2016 02:04:58,tp 1.07194,-6.05,-189.1700000000128,0.0,0.0,1.07304,23.11.2016 22:05:00,13894,-0.07723662329828929,38.37,IS,0.41,0.0,Phase3-EA-SA2v2-EURCHF-M5-43,EURCHFMT4,7062,3h 59m,Sell
154790.48,1.01793,24.11.2016 03:44:57,tp 1.01793,0.0,-132.19000000000233,0.0,0.0,1.01693,24.11.2016 02:15:00,13895,-0.05397213740973912,56.98,IS,0.58,0.0,Phase3-EA-SA2v2-USDCHF-M15-107,USDCHFMT4,2720,1h 29m,Buy
154834.76,1.07385,24.11.2016 09:34:58,tp 1.07385,0.0,-87.91000000000349,0.0,0.0,1.07275,24.11.2016 02:10:00,13896,-0.035892961643772384,44.28,IS,0.41,0.0,Phase3-EA-SA2v2-EURCHF-M5-43,EURCHFMT4,7064,7h 24m,Buy
154877.17,1.07223,25.11.2016 02:04:57,tp 1.07223,-2.02,-45.5,0.0,0.0,1.07333,24.11.2016 20:30:00,13897,-0.01857729217144328,42.41,IS,0.41,0.0,Phase3-EA-SA2v2-EURCHF-M5-43,EURCHFMT4,7066,5h 34m,Sell
154833.21,113318,25.11.2016 02:15:00,,-1.07,-89.45999999999185,0.0,0.0,113138,24.11.2016 19:00:00,13898,-0.03652581445400361,-43.96,IS,0.27,0.0,Phase3-EA-S1v2-USDJPY-M15-0,USDJPYMT4,4026,7h 15m,Sell
154942.09,119538,25.11.2016 03:15:00,,-0.73,-0.0,0.0,0.0,118808,24.11.2016 07:15:00,13899,-0.0,108.88,IS,0.17,0.0,Phase3-EA-T1v2-EURJPY-M15-322,EURJPYMT4,2672,20h 0m,Buy
154999.09,1.01753,25.11.2016 04:14:58,tp 1.01753,0.0,-0.0,0.0,0.0,1.01653,25.11.2016 02:15:00,13900,-0.0,57.0,IS,0.58,0.0,Phase3-EA-SA2v2-USDCHF-M15-107,USDCHFMT4,2722,1h 59m,Buy
154964.53,119597,25.11.2016 12:14:58,sl 119.597,0.0,-34.55999999999767,0.0,0.0,119827,25.11.2016 04:15:00,13901,-0.0141061748433423,-34.56,IS,0.17,0.0,Phase3-EA-T1v2-EURJPY-M15-322,EURJPYMT4,2674,7h 59m,Buy
154910.95,140288,25.11.2016 12:29:58,sl 140.288,-0.29,-88.13999999998487,0.0,0.0,140958,24.11.2016 15:00:00,13902,-0.03597564382789527,-53.58,IS,0.09,0.0,Phase3-EA-B1v1-GBPJPY-M30-1,GBPJPYMT4,1290,21h 29m,Buy
154988.57,112705,25.11.2016 18:15:00,,0.0,-10.519999999989523,0.0,0.0,113029,25.11.2016 17:00:00,13903,-0.0042938934997634026,77.62,IS,0.27,0.0,Phase3-EA-S1v2-USDJPY-M15-0,USDJPYMT4,4028,1h 15m,Sell
155031.11,1.07329,28.11.2016 02:04:57,tp 1.07329,-2.02,-0.0,0.0,0.0,1.07439,25.11.2016 20:15:00,13904,-0.0,42.54,IS,0.41,0.0,Phase3-EA-SA2v2-EURCHF-M5-43,EURCHFMT4,7068,2d 5h 49m,Sell
155088.31,1.01402,28.11.2016 03:14:57,tp 1.01402,0.0,-0.0,0.0,0.0,1.01302,28.11.2016 02:15:00,13905,-0.0,57.2,IS,0.58,0.0,Phase3-EA-SA2v2-USDCHF-M15-107,USDCHFMT4,2724,59m 57s,Buy
155053.57,119.31,28.11.2016 16:59:58,sl 119.310,0.0,-34.73999999999069,0.0,0.0,119.08,28.11.2016 16:00:00,13906,-0.014174482658920195,-34.74,IS,0.17,0.0,Phase3-EA-T1v2-EURJPY-M15-322,EURJPYMT4,2676,59m 58s,Sell
155097.13,1.0755,29.11.2016 01:49:58,tp 1.07550,-0.97,-0.0,0.0,0.0,1.0744,28.11.2016 21:35:00,13907,-0.0,43.56,IS,0.41,0.0,Phase3-EA-SA2v2-EURCHF-M5-43,EURCHFMT4,7070,4h 14m,Buy
155141.77,1.07426,29.11.2016 02:04:57,tp 1.07426,0.0,-0.0,0.0,0.0,1.07536,29.11.2016 01:50:00,13908,-0.0,44.64,IS,0.41,0.0,Phase3-EA-SA2v2-EURCHF-M5-43,EURCHFMT4,7072,14m 57s,Sell
155118.3,1.01329,29.11.2016 05:30:00,,0.0,-23.470000000001164,0.0,0.0,1.0137,29.11.2016 01:15:00,13909,-0.009574051782362949,-23.47,IS,0.58,0.0,Phase3-EA-SA2v2-USDCHF-M15-107,USDCHFMT4,2726,4h 15m,Buy
155063.47,138918,29.11.2016 06:30:00,,0.0,-78.29999999998836,0.0,0.0,139185,29.11.2016 01:05:00,13910,-0.03194070108900172,-54.83,IS,0.23,0.0,Phase3-EA-S4v1-GBPJPY-M5-194,GBPJPYMT4,3042,5h 25m,Buy
155027.63,112175,29.11.2016 07:15:00,,-0.7,-114.13999999998487,0.0,0.0,112321,28.11.2016 19:30:00,13911,-0.046560812545322024,-35.84,IS,0.27,0.0,Phase3-EA-S1v2-USDJPY-M15-0,USDJPYMT4,4030,11h 45m,Buy
155031.99,1.07482,29.11.2016 10:15:00,,0.0,-109.77999999999884,0.0,0.0,1.07495,29.11.2016 01:30:00,13912,-0.0447822498793243,4.36,IS,0.34,0.0,Phase3-EA-S4v1-EURCHF-M15-221,EURCHFMT4,3596,8h 45m,Sell
155009.51,1.01142,30.11.2016 02:45:00,,-0.69,-132.2600000000093,0.0,0.0,1.0118,29.11.2016 22:30:00,13913,-0.05395245371688752,-22.48,IS,0.58,0.0,Phase3-EA-SA2v2-USDCHF-M15-107,USDCHFMT4,2728,4h 15m,Buy
154974.76,119502,30.11.2016 04:14:58,sl 119.502,0.0,-167.0100000000093,0.0,0.0,119732,30.11.2016 02:15:00,13914,-0.06812792450670839,-34.75,IS,0.17,0.0,Phase3-EA-T1v2-EURJPY-M15-322,EURJPYMT4,2678,1h 59m,Buy
155054.66,140102,30.11.2016 04:14:58,tp 140.102,0.0,-87.11000000001513,0.0,0.0,140492,30.11.2016 03:10:00,13915,-0.03553453987054708,79.9,IS,0.23,0.0,Phase3-EA-S4v1-GBPJPY-M5-194,GBPJPYMT4,3044,1h 4m,Sell
154999.46,112463,30.11.2016 07:15:00,,-0.7,-142.31000000002678,0.0,0.0,112.69,29.11.2016 19:15:00,13916,-0.05805212224747593,-55.2,IS,0.27,0.0,Phase3-EA-S1v2-USDJPY-M15-0,USDJPYMT4,4032,12h 0m,Buy
154984.07,1.0771,30.11.2016 07:30:00,,-2.03,-157.70000000004075,0.0,0.0,1.07677,29.11.2016 23:10:00,13917,-0.06433012211670014,-15.39,IS,0.41,0.0,Phase3-EA-SA2v2-EURCHF-M5-43,EURCHFMT4,7074,8h 20m,Sell
154970.98,1.07751,30.11.2016 10:30:00,,0.0,-170.79000000003725,0.0,0.0,1.07712,30.11.2016 01:45:00,13918,-0.06966988938687872,-13.09,IS,0.34,0.0,Phase3-EA-S4v1-EURCHF-M15-221,EURCHFMT4,3598,8h 45m,Sell
155068.65,120206,30.11.2016 12:59:59,tp 120.206,-2.74,-73.12000000002445,0.0,0.0,118946,23.11.2016 20:30:00,13919,-0.029827638105094936,97.67,IS,0.09,0.0,Phase3-EA-TR1v1-EURJPY-M30-91,EURJPYMT4,2490,6d 16h 29m,Buy
155112.92,1.07816,30.11.2016 21:09:57,tp 1.07816,0.0,-28.850000000034925,0.0,0.0,1.07706,30.11.2016 20:30:00,13920,-0.011768700209692874,44.27,IS,0.41,0.0,Phase3-EA-SA2v2-EURCHF-M5-43,EURCHFMT4,7076,39m 57s,Buy
155363.42,121423,01.12.2016 03:44:58,tp 121.423,-2.19,-0.0,0.0,0.0,119723,30.11.2016 08:00:00,13921,-0.0,250.5,IS,0.17,0.0,Phase3-EA-T1v2-EURJPY-M15-322,EURJPYMT4,2680,19h 44m,Buy
155361.37,1.01704,01.12.2016 03:45:00,,-2.05,-2.0499999999883585,0.0,0.0,1.01704,30.11.2016 23:30:00,13922,-8.354953643816799E-4,-2.05,IS,0.58,0.0,Phase3-EA-SA2v2-USDCHF-M15-107,USDCHFMT4,2730,4h 15m,Buy
155332.03,143252,01.12.2016 06:25:00,,0.0,-31.389999999984866,0.0,0.0,143106,01.12.2016 01:00:00,13923,-0.012793268042964498,-29.34,IS,0.23,0.0,Phase3-EA-S4v1-GBPJPY-M5-194,GBPJPYMT4,3046,5h 25m,Sell
155322.34,1.07753,01.12.2016 10:00:00,,0.0,-41.079999999987194,0.0,0.0,1.07729,01.12.2016 01:40:00,13924,-0.01674251198487006,-9.69,IS,0.41,0.0,Phase3-EA-SA2v2-EURCHF-M5-43,EURCHFMT4,7078,8h 20m,Sell
155584.81,1.26194,01.12.2016 15:29:58,tp 1.26194,-2.13,-0.0,0.0,0.0,1.24304,29.11.2016 13:30:00,13925,-0.0,262.47,IS,0.14,0.0,Phase3-EA-B1v1-GBPUSD-M30-14,GBPUSDMT4,906,2d 1h 59m,Buy
155730.55,144958,01.12.2016 17:59:58,tp 144.958,0.0,-0.0,0.0,0.0,143108,01.12.2016 01:00:00,13926,-0.0,145.74,IS,0.09,0.0,Phase3-EA-B1v1-GBPJPY-M30-1,GBPJPYMT4,1292,16h 59m,Buy
155786.68,114483,01.12.2016 18:15:00,,0.0,-0.0,0.0,0.0,114245,01.12.2016 17:15:00,13927,-0.0,56.13,IS,0.27,0.0,Phase3-EA-S1v2-USDJPY-M15-0,USDJPYMT4,4034,1h 0m,Buy
155831.19,1.07679,01.12.2016 20:49:58,tp 1.07679,0.0,-0.0,0.0,0.0,1.07569,01.12.2016 20:10:00,13928,-0.0,44.51,IS,0.41,0.0,Phase3-EA-SA2v2-EURCHF-M5-43,EURCHFMT4,7080,39m 58s,Buy
155873.8,1.07627,02.12.2016 02:04:58,tp 1.07627,-2.03,-0.0,0.0,0.0,1.07737,01.12.2016 23:55:00,13929,-0.0,42.61,IS,0.41,0.0,Phase3-EA-SA2v2-EURCHF-M5-43,EURCHFMT4,7082,2h 9m,Sell
155812.64,143139,02.12.2016 04:45:00,,-0.73,-61.16000000000349,0.0,0.0,143438,01.12.2016 23:20:00,13930,-0.02487454946399465,-61.16,IS,0.23,0.0,Phase3-EA-S4v1-GBPJPY-M5-194,GBPJPYMT4,3048,5h 25m,Buy
155804.13,121272,02.12.2016 05:15:00,,-0.73,-69.6700000000128,0.0,0.0,121324,01.12.2016 13:00:00,13931,-0.028335674642850344,-8.51,IS,0.17,0.0,Phase3-EA-T1v2-EURJPY-M15-322,EURJPYMT4,2682,16h 15m,Buy
155785.18,1.0102,02.12.2016 05:30:00,,0.0,-88.62000000002445,0.0,0.0,1.01053,02.12.2016 01:15:00,13932,-0.03604288053465808,-18.95,IS,0.58,0.0,Phase3-EA-SA2v2-USDCHF-M15-107,USDCHFMT4,2732,4h 15m,Buy
155750.88,121437,02.12.2016 12:59:58,sl 121.437,0.0,-122.9200000000128,0.0,0.0,121667,02.12.2016 07:30:00,13933,-0.04999312655517277,-34.3,IS,0.17,0.0,Phase3-EA-T1v2-EURJPY-M15-322,EURJPYMT4,2684,5h 29m,Buy
155787.52,1.07666,02.12.2016 14:15:00,,0.0,-86.27999999999884,0.0,0.0,1.07775,02.12.2016 05:30:00,13934,-0.035091172788641385,36.64,IS,0.34,0.0,Phase3-EA-S4v1-EURCHF-M15-221,EURCHFMT4,3600,8h 45m,Sell
155832.18,1.07742,02.12.2016 22:39:57,tp 1.07742,0.0,-41.61999999999534,0.0,0.0,1.07852,02.12.2016 20:15:00,13935,-0.01692738307212692,44.66,IS,0.41,0.0,Phase3-EA-SA2v2-EURCHF-M5-43,EURCHFMT4,7084,2h 24m,Sell
155910.08,144.2,05.12.2016 02:00:00,tp 144.200,-1.17,-0.0,0.0,0.0,144.59,02.12.2016 23:20:00,13936,-0.0,77.9,IS,0.23,0.0,Phase3-EA-S4v1-GBPJPY-M5-194,GBPJPYMT4,3050,2d 2h 40m,Sell
156004.25,113.4,05.12.2016 02:00:00,tp 113.400,-1.07,-0.0,0.0,0.0,113.8,02.12.2016 23:15:00,13937,-0.0,94.17,IS,0.27,0.0,Phase3-EA-S1v2-USDJPY-M15-0,USDJPYMT4,4036,2d 2h 45m,Sell
155804.57,1.07218,05.12.2016 02:04:57,sl 1.07218,-0.97,-199.67999999999302,0.0,0.0,1.07708,02.12.2016 23:00:00,13938,-0.0811693293916639,-199.68,IS,0.41,0.0,Phase3-EA-SA2v2-EURCHF-M5-43,EURCHFMT4,7086,2d 3h 4m,Buy
155906.88,119827,05.12.2016 02:29:58,tp 119.827,-0.56,-97.36999999999534,0.0,0.0,121117,01.12.2016 05:30:00,13939,-0.03958061700153351,102.31,IS,0.09,0.0,Phase3-EA-TR1v1-EURJPY-M30-91,EURJPYMT4,2492,3d 20h 59m,Sell
155986.07,143603,05.12.2016 02:39:57,tp 143.603,0.0,-18.179999999993015,0.0,0.0,143213,05.12.2016 02:15:00,13940,-0.007390116227663933,79.19,IS,0.23,0.0,Phase3-EA-S4v1-GBPJPY-M5-194,GBPJPYMT4,3052,24m 57s,Buy
156120.33,1076,05.12.2016 12:14:58,tp 1.07600,0.0,-0.0,0.0,0.0,1072,05.12.2016 04:00:00,13941,-0.0,134.26,IS,0.34,0.0,Phase3-EA-S4v1-EURCHF-M15-221,EURCHFMT4,3602,8h 14m,Buy
156222.3,121547,05.12.2016 12:29:58,tp 121.547,0.0,-0.0,0.0,0.0,120257,05.12.2016 05:30:00,13942,-0.0,101.97,IS,0.09,0.0,Phase3-EA-TR1v1-EURJPY-M30-91,EURJPYMT4,2494,6h 59m,Buy
156270.2,114.42,05.12.2016 19:00:00,,0.0,-0.0,0.0,0.0,114217,05.12.2016 18:15:00,13943,-0.0,47.9,IS,0.27,0.0,Phase3-EA-S1v2-USDJPY-M15-0,USDJPYMT4,4038,45m 0s,Buy
156318.49,114627,05.12.2016 19:15:00,,0.0,-0.0,0.0,0.0,114422,05.12.2016 19:00:00,13944,-0.0,48.29,IS,0.27,0.0,Phase3-EA-S1v2-USDJPY-M15-0,USDJPYMT4,4040,15m 0s,Buy
156363.19,1.08293,05.12.2016 21:34:58,tp 1.08293,0.0,-0.0,0.0,0.0,1.08403,05.12.2016 20:05:00,13945,-0.0,44.7,IS,0.41,0.0,Phase3-EA-SA2v2-EURCHF-M5-43,EURCHFMT4,7088,1h 29m,Sell
156357.49,1.08325,06.12.2016 09:30:00,,0.0,-5.7000000000116415,0.0,0.0,1.08339,06.12.2016 01:10:00,13946,-0.0023136573284392122,-5.7,IS,0.41,0.0,Phase3-EA-SA2v2-EURCHF-M5-43,EURCHFMT4,7090,8h 20m,Buy
156340.59,1.08249,06.12.2016 12:00:00,,0.0,-22.60000000000582,0.0,0.0,1.08299,06.12.2016 03:15:00,13947,-0.009173448354847872,-16.9,IS,0.34,0.0,Phase3-EA-S4v1-EURCHF-M15-221,EURCHFMT4,3604,8h 45m,Buy
156306.31,122248,06.12.2016 16:14:58,sl 122.248,0.0,-56.88000000000466,0.0,0.0,122478,06.12.2016 10:00:00,13948,-0.023087864709011297,-34.28,IS,0.17,0.0,Phase3-EA-T1v2-EURJPY-M15-322,EURJPYMT4,2686,6h 14m,Buy
156263.78,1.26904,06.12.2016 21:29:58,sl 1.26904,-0.53,-99.41000000000349,0.0,0.0,1.27204,05.12.2016 12:30:00,13949,-0.0403509956174878,-42.53,IS,0.14,0.0,Phase3-EA-B1v1-GBPUSD-M30-14,GBPUSDMT4,908,1d 8h 59m,Buy
156242.52,1.08248,07.12.2016 04:45:00,,-0.97,-120.6700000000128,0.0,0.0,1.08298,06.12.2016 20:25:00,13950,-0.04898053154775775,-21.26,IS,0.41,0.0,Phase3-EA-SA2v2-EURCHF-M5-43,EURCHFMT4,7092,8h 20m,Buy
156250.81,114.02,07.12.2016 19:00:00,,0.0,-112.38000000000466,0.0,0.0,114055,07.12.2016 17:45:00,13951,-0.045615580801662885,8.29,IS,0.27,0.0,Phase3-EA-S1v2-USDJPY-M15-0,USDJPYMT4,4042,1h 15m,Sell
156291.84,113845,07.12.2016 19:15:00,,0.0,-71.35000000000582,0.0,0.0,114018,07.12.2016 19:00:00,13952,-0.028961307084879668,41.03,IS,0.27,0.0,Phase3-EA-S1v2-USDJPY-M15-0,USDJPYMT4,4044,15m 0s,Sell
156255.29,122287,08.12.2016 01:44:58,sl 122.287,-2.19,-107.89999999999418,0.0,0.0,122517,07.12.2016 23:15:00,13953,-0.043797127322468016,-36.55,IS,0.17,0.0,Phase3-EA-T1v2-EURJPY-M15-322,EURJPYMT4,2688,2h 29m,Buy
156291.88,113642,08.12.2016 04:15:00,,0.0,-71.30999999999767,0.0,0.0,113796,08.12.2016 00:15:00,13954,-0.028945070893097873,36.59,IS,0.27,0.0,Phase3-EA-S1v2-USDJPY-M15-0,USDJPYMT4,4046,4h 0m,Sell
156275.92,1.08308,08.12.2016 04:55:00,,-2.93,-87.26999999998952,0.0,0.0,1.0834,07.12.2016 20:35:00,13955,-0.03542331141271113,-15.96,IS,0.41,0.0,Phase3-EA-SA2v2-EURCHF-M5-43,EURCHFMT4,7094,8h 20m,Buy
156241.53,122413,08.12.2016 04:59:58,sl 122.413,0.0,-121.66000000000349,0.0,0.0,122183,08.12.2016 02:15:00,13956,-0.049382377294271536,-34.39,IS,0.17,0.0,Phase3-EA-T1v2-EURJPY-M15-322,EURJPYMT4,2690,2h 44m,Sell
156207.05,122446,08.12.2016 13:14:58,sl 122.446,0.0,-156.14000000001397,0.0,0.0,122216,08.12.2016 06:15:00,13957,-0.06337797460733213,-34.48,IS,0.17,0.0,Phase3-EA-T1v2-EURJPY-M15-322,EURJPYMT4,2692,6h 59m,Sell
156144.04,123.27,08.12.2016 16:59:57,sl 123.270,-1.11,-219.15000000002328,0.0,0.0,122.49,06.12.2016 03:30:00,13958,-0.08895403570639854,-63.01,IS,0.09,0.0,Phase3-EA-TR1v1-EURJPY-M30-91,EURJPYMT4,2496,2d 13h 29m,Sell
156152.34,114175,09.12.2016 04:15:00,,-0.69,-210.85000000003492,0.0,0.0,114137,08.12.2016 22:45:00,13959,-0.08558502591236708,8.3,IS,0.27,0.0,Phase3-EA-S1v2-USDJPY-M15-0,USDJPYMT4,4048,5h 30m,Buy
156153.39,1.07886,09.12.2016 04:40:00,,-0.97,-209.80000000004657,0.0,0.0,1.07881,08.12.2016 20:20:00,13960,-0.08515882587818652,1.05,IS,0.41,0.0,Phase3-EA-SA2v2-EURCHF-M5-43,EURCHFMT4,7096,8h 20m,Buy
156143.7,1.07762,09.12.2016 15:30:00,,0.0,-219.4900000000489,0.0,0.0,1.07791,09.12.2016 06:45:00,13961,-0.08909204333652608,-9.69,IS,0.34,0.0,Phase3-EA-S4v1-EURCHF-M15-221,EURCHFMT4,3606,8h 45m,Buy
155945.3,1.07024,12.12.2016 02:09:57,sl 1.07024,-0.97,-417.8900000000431,0.0,0.0,1.07514,09.12.2016 20:05:00,13962,-0.16962355455782235,-198.4,IS,0.41,0.0,Phase3-EA-SA2v2-EURCHF-M5-43,EURCHFMT4,7098,2d 6h 4m,Buy
155910.4,122007,12.12.2016 09:59:58,sl 122.007,-1.04,-452.79000000003725,0.0,0.0,121777,08.12.2016 18:00:00,13963,-0.18378963188455044,-34.9,IS,0.17,0.0,Phase3-EA-T1v2-EURJPY-M15-322,EURJPYMT4,2694,3d 15h 59m,Sell
156000.89,1.07566,12.12.2016 11:00:00,,0.0,-362.30000000004657,0.0,0.0,1.07295,12.12.2016 02:15:00,13964,-0.1470593070336706,90.49,IS,0.34,0.0,Phase3-EA-S4v1-EURCHF-M15-221,EURCHFMT4,3608,8h 45m,Buy
156100.75,122575,12.12.2016 12:29:58,tp 122.575,-0.38,-262.44000000006054,0.0,0.0,121285,09.12.2016 06:30:00,13965,-0.1065256542586819,99.86,IS,0.09,0.0,Phase3-EA-TR1v1-EURJPY-M30-91,EURJPYMT4,2498,3d 5h 59m,Buy
156145.18,1.0779,12.12.2016 21:14:58,tp 1.07790,0.0,-218.01000000006752,0.0,0.0,1.0768,12.12.2016 20:45:00,13966,-0.0884913042407296,44.43,IS,0.41,0.0,Phase3-EA-SA2v2-EURCHF-M5-43,EURCHFMT4,7100,29m 58s,Buy
155950.22,114947,12.12.2016 21:59:58,sl 114.947,0.0,-412.9700000000594,0.0,0.0,115777,12.12.2016 17:00:00,13967,-0.167626502969075,-194.96,IS,0.27,0.0,Phase3-EA-S1v2-USDJPY-M15-0,USDJPYMT4,4050,4h 59m,Buy
156007.42,1.0139,12.12.2016 22:59:57,tp 1.01390,0.0,-355.77000000004773,0.0,0.0,1.0129,12.12.2016 22:00:00,13968,-0.14440874872583295,57.2,IS,0.58,0.0,Phase3-EA-SA2v2-USDCHF-M15-107,USDCHFMT4,2734,59m 57s,Buy
156049.9,1.07749,13.12.2016 01:59:59,tp 1.07749,-2.02,-313.29000000003725,0.0,0.0,1.07859,12.12.2016 23:35:00,13969,-0.12716591305707484,42.48,IS,0.41,0.0,Phase3-EA-SA2v2-EURCHF-M5-43,EURCHFMT4,7102,2h 24m,Sell
156107.16,1.01301,13.12.2016 02:00:00,tp 1.01301,0.0,-256.03000000002794,0.0,0.0,1.01401,13.12.2016 00:15:00,13970,-0.10392380452616602,57.26,IS,0.58,0.0,Phase3-EA-SA2v2-USDCHF-M15-107,USDCHFMT4,2736,1h 45m,Sell
156151.69,1.07848,13.12.2016 04:14:58,tp 1.07848,0.0,-211.5000000000291,0.0,0.0,1.07738,13.12.2016 02:05:00,13971,-0.08584886402876515,44.53,IS,0.41,0.0,Phase3-EA-SA2v2-EURCHF-M5-43,EURCHFMT4,7104,2h 9m,Buy
156194.6,1.01377,13.12.2016 06:30:00,,0.0,-168.5900000000256,0.0,0.0,1.01302,13.12.2016 02:15:00,13972,-0.06843148929839113,42.91,IS,0.58,0.0,Phase3-EA-SA2v2-USDCHF-M15-107,USDCHFMT4,2738,4h 15m,Buy
156160.64,122473,13.12.2016 09:44:58,sl 122.473,0.0,-202.55000000001746,0.0,0.0,122243,13.12.2016 07:45:00,13973,-0.08221601611832381,-33.96,IS,0.17,0.0,Phase3-EA-T1v2-EURJPY-M15-322,EURJPYMT4,2696,1h 59m,Sell
156205.19,1.07574,13.12.2016 21:09:58,tp 1.07574,0.0,-158.0000000000291,0.0,0.0,1.07684,13.12.2016 20:20:00,13974,-0.06413295752503795,44.55,IS,0.41,0.0,Phase3-EA-SA2v2-EURCHF-M5-43,EURCHFMT4,7106,49m 58s,Sell
156171.27,122375,13.12.2016 23:44:57,sl 122.375,0.0,-191.9200000000419,0.0,0.0,122605,13.12.2016 19:45:00,13975,-0.07790124815320065,-33.92,IS,0.17,0.0,Phase3-EA-T1v2-EURJPY-M15-322,EURJPYMT4,2698,3h 59m,Buy
156108.73,1.0109,14.12.2016 06:30:00,,0.0,-254.46000000005006,0.0,0.0,1.01199,14.12.2016 02:15:00,13976,-0.10328653399886936,-62.54,IS,0.58,0.0,Phase3-EA-SA2v2-USDCHF-M15-107,USDCHFMT4,2740,4h 15m,Buy
156104.52,1.07538,14.12.2016 08:00:00,,-0.97,-258.6700000000419,0.0,0.0,1.07546,13.12.2016 23:40:00,13977,-0.10499539318355187,-4.21,IS,0.41,0.0,Phase3-EA-SA2v2-EURCHF-M5-43,EURCHFMT4,7108,8h 20m,Buy
156070.56,122.29,14.12.2016 12:44:58,sl 122.290,0.0,-292.63000000003376,0.0,0.0,122.52,14.12.2016 05:45:00,13978,-0.11877992000348457,-33.96,IS,0.17,0.0,Phase3-EA-T1v2-EURJPY-M15-322,EURJPYMT4,2700,6h 59m,Buy
156114.93,1.07483,14.12.2016 23:04:58,tp 1.07483,0.0,-248.26000000003842,0.0,0.0,1.07593,14.12.2016 20:10:00,13979,-0.10076992427319906,44.37,IS,0.41,0.0,Phase3-EA-SA2v2-EURCHF-M5-43,EURCHFMT4,7110,2h 54m,Sell
156072.93,1.26911,14.12.2016 23:29:58,sl 1.26911,0.0,-290.2600000000384,0.0,0.0,1.27211,14.12.2016 23:00:00,13980,-0.11781792564061107,-42.0,IS,0.14,0.0,Phase3-EA-B1v1-GBPUSD-M30-14,GBPUSDMT4,910,29m 58s,Buy
156214.2,147096,15.12.2016 00:59:58,tp 147.096,-1.4,-148.9900000000489,0.0,0.0,145246,12.12.2016 02:30:00,13981,-0.06047575532694164,141.27,IS,0.09,0.0,Phase3-EA-B1v1-GBPJPY-M30-1,GBPJPYMT4,1294,2d 22h 29m,Buy
156271.08,1.01978,15.12.2016 01:14:58,tp 1.01978,0.0,-92.11000000004424,0.0,0.0,1.02078,15.12.2016 00:45:00,13982,-0.03738789061793034,56.88,IS,0.58,0.0,Phase3-EA-SA2v2-USDCHF-M15-107,USDCHFMT4,2742,29m 58s,Sell
156110.99,147318,15.12.2016 04:19:58,sl 147.318,-3.44,-252.20000000004075,0.0,0.0,146518,14.12.2016 23:10:00,13983,-0.10236918916338103,-160.09,IS,0.23,0.0,Phase3-EA-S4v1-GBPJPY-M5-194,GBPJPYMT4,3054,5h 9m,Sell
156155.12,1.07549,15.12.2016 06:29:58,tp 1.07549,0.0,-208.0700000000361,0.0,0.0,1.07439,15.12.2016 00:40:00,13984,-0.08445661058376266,44.13,IS,0.41,0.0,Phase3-EA-SA2v2-EURCHF-M5-43,EURCHFMT4,7112,5h 49m,Buy
156151.13,1.07412,15.12.2016 09:45:00,,0.0,-212.06000000002678,0.0,0.0,1.07424,15.12.2016 01:00:00,13985,-0.08607617071366302,-3.99,IS,0.34,0.0,Phase3-EA-S4v1-EURCHF-M15-221,EURCHFMT4,3610,8h 45m,Buy
156245.43,123819,15.12.2016 14:29:58,tp 123.819,-1.9,-117.76000000003842,0.0,0.0,122559,12.12.2016 13:00:00,13986,-0.047799348595883175,94.3,IS,0.09,0.0,Phase3-EA-TR1v1-EURJPY-M30-91,EURJPYMT4,2500,3d 1h 29m,Buy
156260.04,122691,15.12.2016 17:45:00,,-2.15,-103.15000000005239,0.0,0.0,122575,14.12.2016 20:00:00,13987,-0.041869079548796234,14.61,IS,0.17,0.0,Phase3-EA-T1v2-EURJPY-M15-322,EURJPYMT4,2702,21h 45m,Buy
156351.26,118.39,15.12.2016 19:14:58,tp 118.390,0.0,-11.930000000051223,0.0,0.0,117.99,15.12.2016 17:30:00,13988,-0.004842444197954727,91.22,IS,0.27,0.0,Phase3-EA-S1v2-USDJPY-M15-0,USDJPYMT4,4052,1h 44m,Buy
156300.18,146342,15.12.2016 21:59:57,sl 146.342,0.0,-63.01000000003842,0.0,0.0,147012,15.12.2016 02:00:00,13989,-0.02557606109907823,-51.08,IS,0.09,0.0,Phase3-EA-B1v1-GBPJPY-M30-1,GBPJPYMT4,1296,19h 59m,Buy
156343.89,1.07384,15.12.2016 22:34:58,tp 1.07384,0.0,-19.300000000046566,0.0,0.0,1.07274,15.12.2016 20:30:00,13990,-0.007833962533139182,43.71,IS,0.41,0.0,Phase3-EA-SA2v2-EURCHF-M5-43,EURCHFMT4,7114,2h 4m,Buy
156305.47,1.02967,16.12.2016 03:30:00,,-0.68,-57.72000000005937,0.0,0.0,1.03034,15.12.2016 23:15:00,13991,-0.023428824736381748,-38.42,IS,0.58,0.0,Phase3-EA-SA2v2-USDCHF-M15-107,USDCHFMT4,2744,4h 15m,Buy
156303.08,1.07269,16.12.2016 09:55:00,,0.0,-60.11000000007334,0.0,0.0,1.07275,16.12.2016 01:35:00,13992,-0.024398937195152053,-2.39,IS,0.41,0.0,Phase3-EA-SA2v2-EURCHF-M5-43,EURCHFMT4,7116,8h 20m,Buy
156347.07,1.07259,16.12.2016 20:49:57,tp 1.07259,0.0,-16.120000000082655,0.0,0.0,1.07149,16.12.2016 20:10:00,13993,-0.006543185286764064,43.99,IS,0.41,0.0,Phase3-EA-SA2v2-EURCHF-M5-43,EURCHFMT4,7118,39m 57s,Buy
156381.79,117804,19.12.2016 04:00:00,,-1.03,-0.0,0.0,0.0,117.96,16.12.2016 23:45:00,13994,-0.0,34.72,IS,0.27,0.0,Phase3-EA-S1v2-USDJPY-M15-0,USDJPYMT4,4054,2d 4h 15m,Sell
156425.75,1.0733,19.12.2016 04:54:57,tp 1.07330,0.0,-0.0,0.0,0.0,1.0722,19.12.2016 02:05:00,13995,-0.0,43.96,IS,0.41,0.0,Phase3-EA-SA2v2-EURCHF-M5-43,EURCHFMT4,7120,2h 49m,Buy
156524.35,121921,19.12.2016 17:59:57,tp 121.921,-0.54,-0.0,0.0,0.0,123211,15.12.2016 16:00:00,13996,-0.0,98.6,IS,0.09,0.0,Phase3-EA-TR1v1-EURJPY-M30-91,EURJPYMT4,2502,4d 1h 59m,Sell
156599.82,145052,20.12.2016 00:34:57,tp 145.052,-1.14,-0.0,0.0,0.0,145442,19.12.2016 23:05:00,13997,-0.0,75.47,IS,0.23,0.0,Phase3-EA-S4v1-GBPJPY-M5-194,GBPJPYMT4,3056,1h 29m,Sell
156591.68,1.06831,20.12.2016 04:20:00,,-0.96,-8.14000000001397,0.0,0.0,1.06849,19.12.2016 20:00:00,13998,-0.003300894542426651,-8.14,IS,0.41,0.0,Phase3-EA-SA2v2-EURCHF-M5-43,EURCHFMT4,7122,8h 20m,Buy
156630.54,117065,20.12.2016 04:45:00,,-1.04,-0.0,0.0,0.0,117238,19.12.2016 22:45:00,13999,-0.0,38.86,IS,0.27,0.0,Phase3-EA-S1v2-USDJPY-M15-0,USDJPYMT4,4056,6h 0m,Sell
156679.0,145392,20.12.2016 06:15:00,,0.0,-0.0,0.0,0.0,145145,20.12.2016 00:50:00,14000,-0.0,48.46,IS,0.23,0.0,Phase3-EA-S4v1-GBPJPY-M5-194,GBPJPYMT4,3058,5h 25m,Buy
156679.33,1.06849,20.12.2016 15:15:00,,0.0,-0.0,0.0,0.0,1.0685,20.12.2016 06:30:00,14001,-0.0,0.33,IS,0.34,0.0,Phase3-EA-S4v1-EURCHF-M15-221,EURCHFMT4,3612,8h 45m,Sell
156941.86,1.23145,20.12.2016 18:29:57,tp 1.23145,-2.07,-0.0,0.0,0.0,1.25035,15.12.2016 15:30:00,14002,-0.0,262.53,IS,0.14,0.0,Phase3-EA-B1v1-GBPUSD-M30-14,GBPUSDMT4,912,5d 2h 59m,Sell
156970.19,118.16,20.12.2016 18:45:00,,0.0,-0.0,0.0,0.0,118036,20.12.2016 17:45:00,14003,-0.0,28.33,IS,0.27,0.0,Phase3-EA-S1v2-USDJPY-M15-0,USDJPYMT4,4058,1h 0m,Buy
157014.03,1.06918,20.12.2016 22:34:57,tp 1.06918,0.0,-0.0,0.0,0.0,1.06808,20.12.2016 20:05:00,14004,-0.0,43.84,IS,0.41,0.0,Phase3-EA-SA2v2-EURCHF-M5-43,EURCHFMT4,7124,2h 29m,Buy
157055.9,1.06781,21.12.2016 02:04:57,tp 1.06781,-1.99,-0.0,0.0,0.0,1.06891,20.12.2016 22:35:00,14005,-0.0,41.87,IS,0.41,0.0,Phase3-EA-SA2v2-EURCHF-M5-43,EURCHFMT4,7126,3h 29m,Sell
157008.82,1.0699,21.12.2016 11:10:00,,0.0,-47.079999999987194,0.0,0.0,1.06872,21.12.2016 02:50:00,14006,-0.019056415977107635,-47.08,IS,0.41,0.0,Phase3-EA-SA2v2-EURCHF-M5-43,EURCHFMT4,7128,8h 20m,Sell
157033.33,1.06847,21.12.2016 15:30:00,,0.0,-22.56999999997788,0.0,0.0,1.06921,21.12.2016 06:45:00,14007,-0.009135584294881368,24.51,IS,0.34,0.0,Phase3-EA-S4v1-EURCHF-M15-221,EURCHFMT4,3614,8h 45m,Sell
157077.32,1.06911,21.12.2016 20:54:57,tp 1.06911,0.0,-0.0,0.0,0.0,1.07021,21.12.2016 20:05:00,14008,-0.0,43.99,IS,0.41,0.0,Phase3-EA-SA2v2-EURCHF-M5-43,EURCHFMT4,7130,49m 57s,Sell
157118.39,1.07022,22.12.2016 00:34:57,tp 1.07022,-2.88,-0.0,0.0,0.0,1.06912,21.12.2016 22:00:00,14009,-0.0,41.07,IS,0.41,0.0,Phase3-EA-SA2v2-EURCHF-M5-43,EURCHFMT4,7132,2h 34m,Buy
157086.8,117535,22.12.2016 01:45:00,,-3.1,-31.589999999996508,0.0,0.0,117411,21.12.2016 19:15:00,14010,-0.01278334647615518,-31.59,IS,0.27,0.0,Phase3-EA-S1v2-USDJPY-M15-0,USDJPYMT4,4060,6h 30m,Sell
157130.72,1.06898,22.12.2016 02:04:58,tp 1.06898,0.0,-0.0,0.0,0.0,1.07008,22.12.2016 00:35:00,14011,-0.0,43.92,IS,0.41,0.0,Phase3-EA-SA2v2-EURCHF-M5-43,EURCHFMT4,7134,1h 29m,Sell
157187.26,1.02578,22.12.2016 02:14:58,tp 1.02578,0.0,-0.0,0.0,0.0,1.02678,22.12.2016 01:45:00,14012,-0.0,56.54,IS,0.58,0.0,Phase3-EA-SA2v2-USDCHF-M15-107,USDCHFMT4,2746,29m 58s,Sell
157205.85,117616,22.12.2016 04:00:00,,0.0,-0.0,0.0,0.0,117535,22.12.2016 01:45:00,14013,-0.0,18.59,IS,0.27,0.0,Phase3-EA-S1v2-USDJPY-M15-0,USDJPYMT4,4062,2h 15m,Buy
157175.72,145365,22.12.2016 06:00:00,,0.0,-30.130000000004657,0.0,0.0,145211,22.12.2016 00:35:00,14014,-0.012188222891976287,-30.13,IS,0.23,0.0,Phase3-EA-S4v1-GBPJPY-M5-194,GBPJPYMT4,3060,5h 25m,Sell
157167.43,1.07046,22.12.2016 09:45:00,,0.0,-38.420000000012806,0.0,0.0,1.07021,22.12.2016 01:00:00,14015,-0.015541703402250669,-8.29,IS,0.34,0.0,Phase3-EA-S4v1-EURCHF-M15-221,EURCHFMT4,3616,8h 45m,Sell
157116.65,1.07039,22.12.2016 10:45:00,,0.0,-89.20000000001164,0.0,0.0,1.06912,22.12.2016 02:25:00,14016,-0.036083288482053055,-50.78,IS,0.41,0.0,Phase3-EA-SA2v2-EURCHF-M5-43,EURCHFMT4,7136,8h 20m,Sell
157136.41,117.5,23.12.2016 02:15:00,,0.0,-69.44000000000233,0.0,0.0,117586,23.12.2016 00:45:00,14017,-0.02808995013669867,19.76,IS,0.27,0.0,Phase3-EA-S1v2-USDJPY-M15-0,USDJPYMT4,4064,1h 30m,Sell
157117.06,1.07054,23.12.2016 05:25:00,,-0.96,-88.79000000000815,0.0,0.0,1071,22.12.2016 21:05:00,14018,-0.03591743480180905,-19.35,IS,0.41,0.0,Phase3-EA-SA2v2-EURCHF-M5-43,EURCHFMT4,7138,8h 20m,Buy
157107.46,1.07269,26.12.2016 08:00:00,,-2.0,-98.39000000001397,0.0,0.0,1.0725,23.12.2016 20:05:00,14019,-0.03980083804651616,-9.6,IS,0.41,0.0,Phase3-EA-SA2v2-EURCHF-M5-43,EURCHFMT4,7140,2d 11h 55m,Sell
157371.37,1.20804,26.12.2016 13:29:58,tp 1.20804,-0.69,-0.0,0.0,0.0,1.22694,23.12.2016 12:30:00,14020,-0.0,263.91,IS,0.14,0.0,Phase3-EA-B1v1-GBPUSD-M30-14,GBPUSDMT4,914,3d 0h 59m,Sell
157614.76,121388,26.12.2016 14:14:57,tp 121.388,-3.56,-0.0,0.0,0.0,123088,19.12.2016 03:45:00,14021,-0.0,243.39,IS,0.17,0.0,Phase3-EA-T1v2-EURJPY-M15-322,EURJPYMT4,2704,7d 10h 29m,Sell
157709.78,121403,26.12.2016 14:29:57,tp 121.403,-1.88,-0.0,0.0,0.0,122663,19.12.2016 10:00:00,14022,-0.0,95.02,IS,0.09,0.0,Phase3-EA-TR1v1-EURJPY-M30-91,EURJPYMT4,2503,7d 4h 29m,Sell
157751.73,1.07204,27.12.2016 02:04:57,tp 1.07204,-2.0,-0.0,0.0,0.0,1.07314,26.12.2016 20:30:00,14023,-0.0,41.95,IS,0.41,0.0,Phase3-EA-SA2v2-EURCHF-M5-43,EURCHFMT4,7142,5h 34m,Sell
157743.36,1.07369,27.12.2016 11:10:00,,0.0,-8.369999999995343,0.0,0.0,1.07348,27.12.2016 02:50:00,14024,-0.0033783820601354904,-8.37,IS,0.41,0.0,Phase3-EA-SA2v2-EURCHF-M5-43,EURCHFMT4,7144,8h 20m,Sell
157708.65,1.07413,27.12.2016 11:45:00,,0.0,-43.079999999987194,0.0,0.0,1.07308,27.12.2016 03:00:00,14025,-0.017388375047870327,-34.71,IS,0.34,0.0,Phase3-EA-S4v1-EURCHF-M15-221,EURCHFMT4,3618,8h 45m,Sell
157708.89,1.07525,28.12.2016 06:20:00,,-0.96,-42.83999999999651,0.0,0.0,1.07522,27.12.2016 22:00:00,14026,-0.017291503877690934,0.24,IS,0.41,0.0,Phase3-EA-SA2v2-EURCHF-M5-43,EURCHFMT4,7146,8h 20m,Buy
157636.16,144526,28.12.2016 08:55:00,,0.0,-115.57000000000698,0.0,0.0,144154,28.12.2016 03:30:00,14027,-0.046647504741947364,-72.73,IS,0.23,0.0,Phase3-EA-S4v1-GBPJPY-M5-194,GBPJPYMT4,3062,5h 25m,Sell
157593.63,1.22489,28.12.2016 12:59:58,sl 1.22489,-0.53,-158.10000000000582,0.0,0.0,1.22789,27.12.2016 23:00:00,14028,-0.06381388335815266,-42.53,IS,0.14,0.0,Phase3-EA-B1v1-GBPUSD-M30-14,GBPUSDMT4,916,13h 59m,Buy
157685.57,1.07246,28.12.2016 15:00:00,,0.0,-66.16000000000349,0.0,0.0,1.07524,28.12.2016 06:15:00,14029,-0.026704152580489866,91.94,IS,0.34,0.0,Phase3-EA-S4v1-EURCHF-M15-221,EURCHFMT4,3620,8h 45m,Sell
157569.56,1.02786,29.12.2016 03:00:00,,-2.03,-182.1700000000128,0.0,0.0,1.02988,28.12.2016 22:45:00,14030,-0.07352925446777395,-116.01,IS,0.58,0.0,Phase3-EA-SA2v2-USDCHF-M15-107,USDCHFMT4,2748,4h 15m,Buy
157610.59,1.07148,29.12.2016 04:29:57,tp 1.07148,-2.87,-141.14000000001397,0.0,0.0,1.07038,28.12.2016 21:35:00,14031,-0.05696832066521333,41.03,IS,0.41,0.0,Phase3-EA-SA2v2-EURCHF-M5-43,EURCHFMT4,7148,6h 54m,Buy
157563.81,142975,29.12.2016 04:30:00,,-2.12,-187.9200000000128,0.0,0.0,143202,28.12.2016 23:05:00,14032,-0.07585012625341192,-46.78,IS,0.23,0.0,Phase3-EA-S4v1-GBPJPY-M5-194,GBPJPYMT4,3064,5h 25m,Buy
157544.21,1.07172,29.12.2016 13:45:00,,0.0,-207.52000000001863,0.0,0.0,1.07113,29.12.2016 05:00:00,14033,-0.08376127181837155,-19.6,IS,0.34,0.0,Phase3-EA-S4v1-EURCHF-M15-221,EURCHFMT4,3622,8h 45m,Sell
157510.61,121953,29.12.2016 14:44:57,sl 121.953,0.0,-241.12000000002445,0.0,0.0,121723,29.12.2016 11:00:00,14034,-0.09732323564401496,-33.6,IS,0.17,0.0,Phase3-EA-T1v2-EURJPY-M15-322,EURJPYMT4,2706,3h 44m,Sell
157650.57,142333,29.12.2016 19:59:58,tp 142.333,-2.68,-101.1600000000326,0.0,0.0,144183,23.12.2016 04:30:00,14035,-0.04083119823221105,139.96,IS,0.09,0.0,Phase3-EA-B1v1-GBPJPY-M30-1,GBPJPYMT4,1298,6d 15h 29m,Sell
157694.67,1.07288,29.12.2016 23:24:58,tp 1.07288,0.0,-57.060000000026776,0.0,0.0,1.07178,29.12.2016 22:15:00,14036,-0.02303112071105481,44.1,IS,0.41,0.0,Phase3-EA-SA2v2-EURCHF-M5-43,EURCHFMT4,7150,1h 9m,Buy
157751.37,1.02301,30.12.2016 01:44:58,tp 1.02301,0.0,-0.360000000015134,0.0,0.0,1.02401,30.12.2016 01:00:00,14037,-1.4530675528083413E-4,56.7,IS,0.58,0.0,Phase3-EA-SA2v2-USDCHF-M15-107,USDCHFMT4,2750,44m 58s,Sell
157793.5,1072,30.12.2016 02:04:58,tp 1.07200,-2.0,-0.0,0.0,0.0,1.0731,29.12.2016 23:55:00,14038,-0.0,42.13,IS,0.41,0.0,Phase3-EA-SA2v2-EURCHF-M5-43,EURCHFMT4,7152,2h 9m,Sell
157830.35,116491,30.12.2016 03:30:00,,0.0,-0.0,0.0,0.0,116.65,30.12.2016 00:15:00,14039,-0.0,36.85,IS,0.27,0.0,Phase3-EA-S1v2-USDJPY-M15-0,USDJPYMT4,4066,3h 15m,Sell
157768.75,123543,30.12.2016 03:59:58,sl 123.543,-1.35,-61.60000000000582,0.0,0.0,122763,27.12.2016 23:00:00,14040,-0.02485571278901298,-61.6,IS,0.09,0.0,Phase3-EA-TR1v1-EURJPY-M30-91,EURJPYMT4,2506,2d 4h 59m,Sell
157712.05,123114,30.12.2016 03:59:58,sl 123.114,-1.08,-118.30000000001746,0.0,0.0,122394,28.12.2016 17:00:00,14041,-0.04773426660617519,-56.7,IS,0.09,0.0,Phase3-EA-TR1v1-EURJPY-M30-91,EURJPYMT4,2507,1d 10h 59m,Sell
157661.27,142.97,30.12.2016 04:55:00,,-1.14,-169.0800000000163,0.0,0.0,142719,29.12.2016 23:30:00,14042,-0.06822408958386887,-50.78,IS,0.23,0.0,Phase3-EA-S4v1-GBPJPY-M5-194,GBPJPYMT4,3066,5h 25m,Sell
157682.94,1.07322,30.12.2016 13:00:00,,0.0,-147.4100000000035,0.0,0.0,1.07387,30.12.2016 04:15:00,14043,-0.059480204906301036,21.67,IS,0.34,0.0,Phase3-EA-S4v1-EURCHF-M15-221,EURCHFMT4,3624,8h 45m,Sell
157643.89,116.78,02.01.2017 02:00:00,,-0.67,-186.45999999999185,0.0,0.0,116946,30.12.2016 17:45:00,14044,-0.07523695140647273,-39.05,IS,0.27,0.0,Phase3-EA-S1v2-USDJPY-M15-0,USDJPYMT4,4068,2d 8h 15m,Buy
157586.18,1.01808,02.01.2017 02:15:00,,-3.02,-244.1699999999837,0.0,0.0,1.01712,30.12.2016 22:00:00,14045,-0.09852304207292728,-57.71,IS,0.58,0.0,Phase3-EA-SA2v2-USDCHF-M15-107,USDCHFMT4,2752,2d 4h 15m,Sell
157643.11,1.01878,02.01.2017 04:44:57,tp 1.01878,0.0,-187.2399999999907,0.0,0.0,1.01778,02.01.2017 02:45:00,14046,-0.07555168283464479,56.93,IS,0.58,0.0,Phase3-EA-SA2v2-USDCHF-M15-107,USDCHFMT4,2754,1h 59m,Buy
157687.45,1.07248,02.01.2017 05:04:58,tp 1.07248,0.0,-142.89999999999418,0.0,0.0,1.07138,02.01.2017 02:05:00,14047,-0.05766041164853043,44.34,IS,0.41,0.0,Phase3-EA-SA2v2-EURCHF-M5-43,EURCHFMT4,7154,2h 59m,Buy
157716.13,1.07227,02.01.2017 11:45:00,,0.0,-114.22000000000116,0.0,0.0,1.07141,02.01.2017 03:00:00,14048,-0.04608797913572765,28.68,IS,0.34,0.0,Phase3-EA-S4v1-EURCHF-M15-221,EURCHFMT4,3626,8h 45m,Buy
157716.36,117356,02.01.2017 22:15:00,,0.0,-113.98999999999069,0.0,0.0,117355,02.01.2017 17:30:00,14049,-0.04599517371459562,0.23,IS,0.27,0.0,Phase3-EA-S1v2-USDJPY-M15-0,USDJPYMT4,4070,4h 45m,Buy
157760.47,1.07106,03.01.2017 02:24:58,tp 1.07106,0.0,-69.88000000000466,0.0,0.0,1.06996,03.01.2017 02:05:00,14050,-0.02819670794961329,44.11,IS,0.41,0.0,Phase3-EA-SA2v2-EURCHF-M5-43,EURCHFMT4,7156,19m 58s,Buy
157836.91,143996,03.01.2017 02:54:57,tp 143.996,0.0,-0.0,0.0,0.0,144386,03.01.2017 00:05:00,14051,-0.0,76.44,IS,0.23,0.0,Phase3-EA-S4v1-GBPJPY-M5-194,GBPJPYMT4,3068,2h 49m,Sell
157893.55,1.02395,03.01.2017 03:14:58,tp 1.02395,0.0,-0.0,0.0,0.0,1.02295,03.01.2017 02:15:00,14052,-0.0,56.64,IS,0.58,0.0,Phase3-EA-SA2v2-USDCHF-M15-107,USDCHFMT4,2756,59m 58s,Buy
157860.23,123053,03.01.2017 07:59:59,sl 123.053,0.0,-33.320000000006985,0.0,0.0,122823,03.01.2017 02:15:00,14053,-0.013441253312160353,-33.32,IS,0.17,0.0,Phase3-EA-T1v2-EURJPY-M15-322,EURJPYMT4,2708,5h 44m,Sell
157825.32,1.07152,03.01.2017 10:50:00,,0.0,-68.23000000001048,0.0,0.0,1.07065,03.01.2017 02:30:00,14054,-0.0275239109690471,-34.91,IS,0.41,0.0,Phase3-EA-SA2v2-EURCHF-M5-43,EURCHFMT4,7158,8h 20m,Sell
157880.88,1.07171,03.01.2017 11:00:00,,0.0,-12.670000000012806,0.0,0.0,1.07004,03.01.2017 02:15:00,14055,-0.005111064809880195,55.56,IS,0.34,0.0,Phase3-EA-S4v1-EURCHF-M15-221,EURCHFMT4,3628,8h 45m,Buy
157971.97,118565,03.01.2017 19:14:58,tp 118.565,0.0,-0.0,0.0,0.0,118165,03.01.2017 18:45:00,14056,-0.0,91.09,IS,0.27,0.0,Phase3-EA-S1v2-USDJPY-M15-0,USDJPYMT4,4072,29m 58s,Buy
157928.38,1.22149,03.01.2017 19:29:58,sl 1.22149,-1.59,-43.58999999999651,0.0,0.0,1.22449,29.12.2016 07:30:00,14057,-0.01757859971028031,-43.59,IS,0.14,0.0,Phase3-EA-B1v1-GBPUSD-M30-14,GBPUSDMT4,918,5d 11h 59m,Buy
157972.29,1.06947,03.01.2017 20:29:58,tp 1.06947,0.0,-0.0,0.0,0.0,1.06837,03.01.2017 20:05:00,14058,-0.0,43.91,IS,0.41,0.0,Phase3-EA-SA2v2-EURCHF-M5-43,EURCHFMT4,7160,24m 58s,Buy
157920.39,143556,03.01.2017 22:29:58,sl 143.556,-0.56,-51.89999999999418,0.0,0.0,144226,30.12.2016 17:00:00,14059,-0.020929757917706862,-51.9,IS,0.09,0.0,Phase3-EA-B1v1-GBPJPY-M30-1,GBPJPYMT4,1300,4d 5h 29m,Buy
157973.9,1.02659,04.01.2017 00:29:58,tp 1.02659,-2.99,-0.0,0.0,0.0,1.02759,03.01.2017 23:30:00,14060,-0.0,53.51,IS,0.58,0.0,Phase3-EA-SA2v2-USDCHF-M15-107,USDCHFMT4,2758,59m 58s,Sell
157993.45,1.06943,04.01.2017 09:55:00,,0.0,-0.0,0.0,0.0,1.06894,04.01.2017 01:35:00,14061,-0.0,19.55,IS,0.41,0.0,Phase3-EA-SA2v2-EURCHF-M5-43,EURCHFMT4,7162,8h 20m,Buy
157915.91,118044,04.01.2017 11:15:00,,0.0,-77.54000000000815,0.0,0.0,117705,04.01.2017 01:15:00,14062,-0.03126695483288285,-77.54,IS,0.27,0.0,Phase3-EA-S1v2-USDJPY-M15-0,USDJPYMT4,4074,10h 0m,Sell
157924.64,117472,04.01.2017 18:15:00,,0.0,-68.80999999999767,0.0,0.0,117.51,04.01.2017 18:00:00,14063,-0.027746700568098658,8.73,IS,0.27,0.0,Phase3-EA-S1v2-USDJPY-M15-0,USDJPYMT4,4076,15m 0s,Sell
157968.76,1.07098,04.01.2017 20:39:58,tp 1.07098,0.0,-24.69000000000233,0.0,0.0,1.07208,04.01.2017 20:00:00,14064,-0.00995590810967074,44.12,IS,0.41,0.0,Phase3-EA-SA2v2-EURCHF-M5-43,EURCHFMT4,7164,39m 58s,Sell
157990.17,117283,04.01.2017 23:15:00,,0.0,-3.279999999998836,0.0,0.0,117376,04.01.2017 22:45:00,14065,-0.00132261557714481,21.41,IS,0.27,0.0,Phase3-EA-S1v2-USDJPY-M15-0,USDJPYMT4,4078,30m 0s,Sell
158001.81,117217,05.01.2017 02:00:00,,-3.1,-0.0,0.0,0.0,117281,04.01.2017 23:15:00,14066,-0.0,11.64,IS,0.27,0.0,Phase3-EA-S1v2-USDJPY-M15-0,USDJPYMT4,4080,2h 45m,Sell
158043.28,1.07184,05.01.2017 04:09:58,tp 1.07184,-2.89,-0.0,0.0,0.0,1.07074,04.01.2017 21:20:00,14067,-0.0,41.47,IS,0.41,0.0,Phase3-EA-SA2v2-EURCHF-M5-43,EURCHFMT4,7166,6h 49m,Buy
158007.77,122829,05.01.2017 04:14:58,sl 122.829,-2.13,-35.51000000000931,0.0,0.0,123059,04.01.2017 20:30:00,14068,-0.014316050005470498,-35.51,IS,0.17,0.0,Phase3-EA-T1v2-EURJPY-M15-322,EURJPYMT4,2710,7h 44m,Buy
157785.42,1.01731,05.01.2017 04:14:58,sl 1.01731,0.0,-257.86000000001513,0.0,0.0,1.02121,05.01.2017 02:15:00,14069,-0.10395766416248581,-222.35,IS,0.58,0.0,Phase3-EA-SA2v2-USDCHF-M15-107,USDCHFMT4,2760,1h 59m,Buy
157627.64,143729,05.01.2017 04:59:58,sl 143.729,0.0,-415.64000000001397,0.0,0.0,144529,05.01.2017 00:50:00,14070,-0.16756753095669943,-157.78,IS,0.23,0.0,Phase3-EA-S4v1-GBPJPY-M5-194,GBPJPYMT4,3070,4h 9m,Buy
157662.33,1.07103,05.01.2017 14:15:00,,0.0,-380.95000000001164,0.0,0.0,1.07207,05.01.2017 05:30:00,14071,-0.15358206841967678,34.69,IS,0.34,0.0,Phase3-EA-S4v1-EURCHF-M15-221,EURCHFMT4,3630,8h 45m,Sell
157760.72,122049,05.01.2017 19:29:58,tp 122.049,-1.61,-282.5599999999977,0.0,0.0,123339,30.12.2016 15:30:00,14072,-0.11391560376076175,98.39,IS,0.09,0.0,Phase3-EA-TR1v1-EURJPY-M30-91,EURJPYMT4,2510,6d 3h 59m,Sell
157566.55,115416,05.01.2017 19:29:58,sl 115.416,0.0,-476.7300000000105,0.0,0.0,116246,05.01.2017 17:30:00,14073,-0.19219629735585217,-194.17,IS,0.27,0.0,Phase3-EA-S1v2-USDJPY-M15-0,USDJPYMT4,4082,1h 59m,Buy
157620.97,1.00944,06.01.2017 01:59:57,tp 1.00944,-3.04,-422.3099999999977,0.0,0.0,1.01044,05.01.2017 23:30:00,14074,-0.1702565778036786,54.42,IS,0.58,0.0,Phase3-EA-SA2v2-USDCHF-M15-107,USDCHFMT4,2762,2h 29m,Sell
157713.59,115295,06.01.2017 01:59:58,tp 115.295,-1.05,-329.6900000000023,0.0,0.0,115695,05.01.2017 23:15:00,14075,-0.13291632008736592,92.62,IS,0.27,0.0,Phase3-EA-S1v2-USDJPY-M15-0,USDJPYMT4,4084,2h 44m,Sell
157791.08,143637,06.01.2017 05:09:58,tp 143.637,0.0,-252.20000000001164,0.0,0.0,143247,06.01.2017 02:10:00,14076,-0.1016758043193151,77.49,IS,0.23,0.0,Phase3-EA-S4v1-GBPJPY-M5-194,GBPJPYMT4,3072,2h 59m,Buy
157795.78,1.07067,06.01.2017 11:45:00,,0.0,-247.5,0.0,0.0,1.07053,06.01.2017 03:00:00,14077,-0.09978097370749138,4.7,IS,0.34,0.0,Phase3-EA-S4v1-EURCHF-M15-221,EURCHFMT4,3632,8h 45m,Buy
157767.83,1.01679,09.01.2017 06:30:00,,0.0,-275.45000000001164,0.0,0.0,1.01728,09.01.2017 02:15:00,14078,-0.11104916851607945,-27.95,IS,0.58,0.0,Phase3-EA-SA2v2-USDCHF-M15-107,USDCHFMT4,2764,4h 15m,Buy
157815.05,143715,09.01.2017 07:35:00,,0.0,-228.23000000001048,0.0,0.0,143474,09.01.2017 02:10:00,14079,-0.09201216819903758,47.22,IS,0.23,0.0,Phase3-EA-S4v1-GBPJPY-M5-194,GBPJPYMT4,3074,5h 25m,Buy
157913.15,123603,09.01.2017 07:59:58,tp 123.603,-0.76,-130.13000000000466,0.0,0.0,122313,05.01.2017 22:00:00,14080,-0.052462618620429564,98.1,IS,0.09,0.0,Phase3-EA-TR1v1-EURJPY-M30-91,EURJPYMT4,2512,3d 9h 59m,Buy
157868.49,1.2237,09.01.2017 08:29:58,sl 1.22370,-2.66,-174.79000000000815,0.0,0.0,1.2267,04.01.2017 11:30:00,14081,-0.07046754098720498,-44.66,IS,0.14,0.0,Phase3-EA-B1v1-GBPUSD-M30-14,GBPUSDMT4,920,4d 20h 59m,Buy
157912.74,1.07214,09.01.2017 10:19:58,tp 1.07214,0.0,-130.54000000000815,0.0,0.0,1.07104,09.01.2017 02:05:00,14082,-0.052627912354653486,44.25,IS,0.41,0.0,Phase3-EA-SA2v2-EURCHF-M5-43,EURCHFMT4,7168,8h 14m,Buy
157969.91,1.01446,09.01.2017 23:59:58,tp 1.01446,0.0,-73.36999999999534,0.0,0.0,1.01546,09.01.2017 23:15:00,14083,-0.029579515316841123,57.17,IS,0.58,0.0,Phase3-EA-SA2v2-USDCHF-M15-107,USDCHFMT4,2766,44m 58s,Sell
158047.22,141229,10.01.2017 03:34:58,tp 141.229,0.0,-0.0,0.0,0.0,140839,10.01.2017 02:10:00,14084,-0.0,77.31,IS,0.23,0.0,Phase3-EA-S4v1-GBPJPY-M5-194,GBPJPYMT4,3076,1h 24m,Buy
158015.69,1.07381,10.01.2017 04:25:00,,-2.02,-31.529999999998836,0.0,0.0,1.07308,09.01.2017 20:05:00,14085,-0.01271128940691161,-31.53,IS,0.41,0.0,Phase3-EA-SA2v2-EURCHF-M5-43,EURCHFMT4,7170,8h 20m,Sell
157981.93,122868,10.01.2017 12:14:58,sl 122.868,0.0,-65.29000000000815,0.0,0.0,122638,10.01.2017 07:00:00,14086,-0.02632160118545491,-33.76,IS,0.17,0.0,Phase3-EA-T1v2-EURJPY-M15-322,EURJPYMT4,2712,5h 14m,Sell
157958.43,1.07419,10.01.2017 12:30:00,,0.0,-88.79000000000815,0.0,0.0,1.07349,10.01.2017 03:45:00,14087,-0.03579560375641697,-23.5,IS,0.34,0.0,Phase3-EA-S4v1-EURCHF-M15-221,EURCHFMT4,3634,8h 45m,Sell
157916.43,1.21447,10.01.2017 13:59:58,sl 1.21447,0.0,-130.79000000000815,0.0,0.0,1.21147,10.01.2017 12:30:00,14088,-0.05272786367047683,-42.0,IS,0.14,0.0,Phase3-EA-B1v1-GBPUSD-M30-14,GBPUSDMT4,922,1h 29m,Sell
157958.78,1.07274,11.01.2017 02:00:00,tp 1.07274,-2.02,-88.44000000000233,0.0,0.0,1.07384,10.01.2017 21:15:00,14089,-0.03565450159046413,42.35,IS,0.41,0.0,Phase3-EA-SA2v2-EURCHF-M5-43,EURCHFMT4,7172,4h 45m,Sell
158058.55,122.0,11.01.2017 02:29:57,tp 122.000,-0.54,-0.0,0.0,0.0,123.29,09.01.2017 13:30:00,14090,-0.0,99.77,IS,0.09,0.0,Phase3-EA-TR1v1-EURJPY-M30-91,EURJPYMT4,2514,1d 12h 59m,Sell
158060.83,1.01641,11.01.2017 05:30:00,,0.0,-0.0,0.0,0.0,1.01637,11.01.2017 01:15:00,14091,-0.0,2.28,IS,0.58,0.0,Phase3-EA-SA2v2-USDCHF-M15-107,USDCHFMT4,2768,4h 15m,Buy
158057.15,1.07315,11.01.2017 10:15:00,,0.0,-3.679999999993015,0.0,0.0,1.07326,11.01.2017 01:30:00,14092,-0.0014835070897702808,-3.68,IS,0.34,0.0,Phase3-EA-S4v1-EURCHF-M15-221,EURCHFMT4,3636,8h 45m,Buy
158071.26,1.07324,11.01.2017 10:25:00,,0.0,-0.0,0.0,0.0,1.07289,11.01.2017 02:05:00,14093,-0.0,14.11,IS,0.41,0.0,Phase3-EA-SA2v2-EURCHF-M5-43,EURCHFMT4,7174,8h 20m,Buy
158004.33,115985,11.01.2017 10:30:00,,-1.05,-66.92999999999302,0.0,0.0,115702,10.01.2017 23:30:00,14094,-0.02698015078409035,-66.93,IS,0.27,0.0,Phase3-EA-S1v2-USDJPY-M15-0,USDJPYMT4,4086,11h 0m,Sell
158102.02,121508,11.01.2017 22:29:58,tp 121.508,-0.54,-0.0,0.0,0.0,122768,09.01.2017 17:00:00,14095,-0.0,97.69,IS,0.09,0.0,Phase3-EA-TR1v1-EURJPY-M30-91,EURJPYMT4,2515,2d 5h 29m,Sell
158057.49,1.07331,12.01.2017 06:15:00,,-6.06,-44.529999999998836,0.0,0.0,1.07236,11.01.2017 21:55:00,14096,-0.017948261767477224,-44.53,IS,0.41,0.0,Phase3-EA-SA2v2-EURCHF-M5-43,EURCHFMT4,7176,8h 20m,Sell
157896.92,139733,12.01.2017 07:49:58,sl 139.733,0.0,-205.10000000000582,0.0,0.0,140533,12.01.2017 03:40:00,14097,-0.0826676058502084,-160.57,IS,0.23,0.0,Phase3-EA-S4v1-GBPJPY-M5-194,GBPJPYMT4,3078,4h 9m,Buy
157890.54,1.07346,12.01.2017 09:45:00,,0.0,-211.48000000001048,0.0,0.0,1.07327,12.01.2017 01:00:00,14098,-0.08523912864555065,-6.38,IS,0.34,0.0,Phase3-EA-S4v1-EURCHF-M15-221,EURCHFMT4,3638,8h 45m,Sell
157934.84,113977,12.01.2017 19:15:00,,0.0,-167.18000000002212,0.0,0.0,114164,12.01.2017 17:30:00,14099,-0.06738357067790968,44.3,IS,0.27,0.0,Phase3-EA-S1v2-USDJPY-M15-0,USDJPYMT4,4088,1h 45m,Sell
158078.94,138978,12.01.2017 20:59:58,tp 138.978,-1.81,-23.080000000016298,0.0,0.0,140828,10.01.2017 02:30:00,14100,-0.009302624783150184,144.1,IS,0.09,0.0,Phase3-EA-B1v1-GBPJPY-M30-1,GBPJPYMT4,1302,2d 18h 29m,Sell
157991.7,139811,13.01.2017 05:30:00,,0.0,-110.32000000000698,0.0,0.0,139375,13.01.2017 00:05:00,14101,-0.044465579119431047,-87.24,IS,0.23,0.0,Phase3-EA-S4v1-GBPJPY-M5-194,GBPJPYMT4,3080,5h 25m,Sell
157970.61,1.07223,13.01.2017 08:30:00,,0.0,-131.4100000000035,0.0,0.0,1.07275,13.01.2017 00:10:00,14102,-0.05296611450402664,-21.09,IS,0.41,0.0,Phase3-EA-SA2v2-EURCHF-M5-43,EURCHFMT4,7178,8h 20m,Buy
157963.87,1.07228,13.01.2017 10:45:00,,0.0,-138.14999999999418,0.0,0.0,1.07248,13.01.2017 02:00:00,14103,-0.05568273889910036,-6.74,IS,0.34,0.0,Phase3-EA-S4v1-EURCHF-M15-221,EURCHFMT4,3640,8h 45m,Buy
158008.54,1.07317,13.01.2017 22:59:59,tp 1.07317,0.0,-93.47999999998137,0.0,0.0,1.07207,13.01.2017 21:25:00,14104,-0.03767804873171975,44.67,IS,0.41,0.0,Phase3-EA-SA2v2-EURCHF-M5-43,EURCHFMT4,7180,1h 34m,Buy
157846.9,138918,16.01.2017 02:00:00,sl 138.918,-0.72,-255.11999999999534,0.0,0.0,139718,13.01.2017 23:00:00,14105,-0.10282866701367226,-161.64,IS,0.23,0.0,Phase3-EA-S4v1-GBPJPY-M5-194,GBPJPYMT4,3082,2d 3h 0m,Buy
157889.63,1.07237,16.01.2017 02:00:00,tp 1.07237,-2.03,-212.38999999998487,0.0,0.0,1.07347,13.01.2017 23:15:00,14106,-0.08560591324487572,42.73,IS,0.41,0.0,Phase3-EA-SA2v2-EURCHF-M5-43,EURCHFMT4,7182,2d 2h 45m,Sell
157934.27,1.0734,16.01.2017 03:04:57,tp 1.07340,0.0,-167.7499999999709,0.0,0.0,1.0723,16.01.2017 02:05:00,14107,-0.06761331487747273,44.64,IS,0.41,0.0,Phase3-EA-SA2v2-EURCHF-M5-43,EURCHFMT4,7184,59m 57s,Buy
157836.74,137208,16.01.2017 07:35:00,,0.0,-265.27999999996973,0.0,0.0,137692,16.01.2017 02:10:00,14108,-0.10692375660624162,-97.53,IS,0.23,0.0,Phase3-EA-S4v1-GBPJPY-M5-194,GBPJPYMT4,3084,5h 25m,Buy
157774.18,120976,16.01.2017 10:59:58,sl 120.976,-0.77,-327.8399999999674,0.0,0.0,121756,12.01.2017 16:30:00,14109,-0.13213919016055023,-62.56,IS,0.09,0.0,Phase3-EA-TR1v1-EURJPY-M30-91,EURJPYMT4,2518,3d 18h 29m,Buy
157773.51,1.07233,16.01.2017 11:00:00,,0.0,-328.5099999999802,0.0,0.0,1.07235,16.01.2017 02:15:00,14110,-0.13240924036006607,-0.67,IS,0.34,0.0,Phase3-EA-S4v1-EURCHF-M15-221,EURCHFMT4,3642,8h 45m,Buy
157767.83,114108,16.01.2017 21:45:00,,0.0,-334.1899999999732,0.0,0.0,114132,16.01.2017 17:15:00,14111,-0.13469862115591488,-5.68,IS,0.27,0.0,Phase3-EA-S1v2-USDJPY-M15-0,USDJPYMT4,4090,4h 30m,Buy
157810.42,1.07109,17.01.2017 02:04:57,tp 1.07109,-2.03,-291.5999999999767,0.0,0.0,1.07219,16.01.2017 23:50:00,14112,-0.11753229578702173,42.59,IS,0.41,0.0,Phase3-EA-SA2v2-EURCHF-M5-43,EURCHFMT4,7186,2h 14m,Sell
158061.9,120743,17.01.2017 10:59:58,tp 120.743,-3.62,-40.11999999996624,0.0,0.0,122443,10.01.2017 18:45:00,14113,-0.016170767170684913,251.48,IS,0.17,0.0,Phase3-EA-T1v2-EURJPY-M15-322,EURJPYMT4,2714,6d 16h 14m,Sell
158100.73,1.07287,17.01.2017 11:00:00,,0.0,-1.2899999999790452,0.0,0.0,1.07172,17.01.2017 02:15:00,14114,-5.199473990494077E-4,38.83,IS,0.34,0.0,Phase3-EA-S4v1-EURCHF-M15-221,EURCHFMT4,3644,8h 45m,Buy
158365.33,1.22598,17.01.2017 16:29:57,tp 1.22598,0.0,-0.0,0.0,0.0,1.20708,17.01.2017 08:00:00,14115,-0.0,264.6,IS,0.14,0.0,Phase3-EA-B1v1-GBPUSD-M30-14,GBPUSDMT4,924,8h 29m,Buy
158330.89,121.03,17.01.2017 17:59:58,sl 121.030,0.0,-34.44000000000233,0.0,0.0,121.26,17.01.2017 16:30:00,14116,-0.013866669715939103,-34.44,IS,0.17,0.0,Phase3-EA-T1v2-EURJPY-M15-322,EURJPYMT4,2716,1h 29m,Buy
158296.29,120972,17.01.2017 22:44:57,sl 120.972,0.0,-69.04000000000815,0.0,0.0,120742,17.01.2017 20:45:00,14117,-0.027797760661686526,-34.6,IS,0.17,0.0,Phase3-EA-T1v2-EURJPY-M15-322,EURJPYMT4,2718,1h 59m,Sell
158339.27,1.07138,18.01.2017 02:04:57,tp 1.07138,-2.05,-26.05999999999767,0.0,0.0,1.07248,17.01.2017 20:25:00,14118,-0.010492607804800125,42.98,IS,0.41,0.0,Phase3-EA-SA2v2-EURCHF-M5-43,EURCHFMT4,7188,5h 39m,Sell
158397.12,1.0026,18.01.2017 03:44:58,tp 1.00260,0.0,-0.0,0.0,0.0,1.0016,18.01.2017 02:15:00,14119,-0.0,57.85,IS,0.58,0.0,Phase3-EA-SA2v2-USDCHF-M15-107,USDCHFMT4,2770,1h 29m,Buy
158399.57,1.07298,18.01.2017 10:25:00,,0.0,-0.0,0.0,0.0,1.07292,18.01.2017 02:05:00,14120,-0.0,2.45,IS,0.41,0.0,Phase3-EA-SA2v2-EURCHF-M5-43,EURCHFMT4,7190,8h 20m,Buy
158350.74,1.07126,18.01.2017 15:00:00,,0.0,-48.829999999987194,0.0,0.0,1.0727,18.01.2017 06:15:00,14121,-0.01965784401317081,-48.83,IS,0.34,0.0,Phase3-EA-S4v1-EURCHF-M15-221,EURCHFMT4,3646,8h 45m,Buy
158389.48,1.07064,19.01.2017 00:09:58,tp 1.07064,-6.13,-10.089999999996508,0.0,0.0,1.07174,18.01.2017 21:40:00,14122,-0.004062003811035774,38.74,IS,0.41,0.0,Phase3-EA-SA2v2-EURCHF-M5-43,EURCHFMT4,7192,2h 29m,Sell
158266.2,140734,19.01.2017 06:10:00,,0.0,-133.36999999999534,0.0,0.0,140119,19.01.2017 00:45:00,14123,-0.05369171935361841,-123.28,IS,0.23,0.0,Phase3-EA-S4v1-GBPJPY-M5-194,GBPJPYMT4,3086,5h 25m,Sell
158275.97,1.07112,19.01.2017 08:30:00,,0.0,-123.60000000000582,0.0,0.0,1.07088,19.01.2017 00:10:00,14124,-0.04975854024224173,9.77,IS,0.41,0.0,Phase3-EA-SA2v2-EURCHF-M5-43,EURCHFMT4,7194,8h 20m,Buy
158301.63,1.07145,19.01.2017 11:00:00,,0.0,-97.94000000000233,0.0,0.0,1.07069,19.01.2017 02:15:00,14125,-0.03942840963855211,25.66,IS,0.34,0.0,Phase3-EA-S4v1-EURCHF-M15-221,EURCHFMT4,3648,8h 45m,Buy
158400.68,122.2,19.01.2017 11:59:58,tp 122.200,-1.94,-0.0,0.0,0.0,120.91,16.01.2017 16:30:00,14126,-0.0,99.05,IS,0.09,0.0,Phase3-EA-TR1v1-EURJPY-M30-91,EURJPYMT4,2520,2d 19h 29m,Buy
158443.47,1.0719,20.01.2017 02:04:58,tp 1.07190,-2.04,-0.0,0.0,0.0,1073,19.01.2017 21:10:00,14127,-0.0,42.79,IS,0.41,0.0,Phase3-EA-SA2v2-EURCHF-M5-43,EURCHFMT4,7196,4h 54m,Sell
158486.33,141879,20.01.2017 04:50:00,,-0.72,-0.0,0.0,0.0,141661,19.01.2017 23:25:00,14128,-0.0,42.86,IS,0.23,0.0,Phase3-EA-S4v1-GBPJPY-M5-194,GBPJPYMT4,3088,5h 25m,Buy
158543.93,1.00691,20.01.2017 04:59:57,tp 1.00691,0.0,-0.0,0.0,0.0,1.00591,20.01.2017 02:15:00,14129,-0.0,57.6,IS,0.58,0.0,Phase3-EA-SA2v2-USDCHF-M15-107,USDCHFMT4,2772,2h 44m,Buy
158468.69,114788,20.01.2017 05:15:00,,-0.68,-75.23999999999069,0.0,0.0,115105,19.01.2017 23:15:00,14130,-0.030272314435516666,-75.24,IS,0.27,0.0,Phase3-EA-S1v2-USDJPY-M15-0,USDJPYMT4,4092,6h 0m,Buy
158653.77,122479,20.01.2017 07:30:00,,-2.93,-0.0,0.0,0.0,121212,18.01.2017 19:15:00,14131,-0.0,185.08,IS,0.17,0.0,Phase3-EA-T1v2-EURJPY-M15-322,EURJPYMT4,2720,1d 12h 15m,Buy
158672.14,1.07291,20.01.2017 10:25:00,,0.0,-0.0,0.0,0.0,1.07246,20.01.2017 02:05:00,14132,-0.0,18.37,IS,0.41,0.0,Phase3-EA-SA2v2-EURCHF-M5-43,EURCHFMT4,7198,8h 20m,Buy
158689.05,1.0731,20.01.2017 12:00:00,,0.0,-0.0,0.0,0.0,1.0726,20.01.2017 03:15:00,14133,-0.0,16.91,IS,0.34,0.0,Phase3-EA-S4v1-EURCHF-M15-221,EURCHFMT4,3650,8h 45m,Buy
158673.8,122425,20.01.2017 12:30:00,,0.0,-15.25,0.0,0.0,122528,20.01.2017 08:30:00,14134,-0.006132155798576556,-15.25,IS,0.17,0.0,Phase3-EA-T1v2-EURJPY-M15-322,EURJPYMT4,2722,4h 0m,Buy
158645.09,122419,20.01.2017 13:30:00,,0.0,-43.95999999999185,0.0,0.0,122613,20.01.2017 13:00:00,14135,-0.017676693042975436,-28.71,IS,0.17,0.0,Phase3-EA-T1v2-EURJPY-M15-322,EURJPYMT4,2724,30m 0s,Buy
158448.13,114182,23.01.2017 03:14:58,sl 114.182,-0.69,-240.9199999999837,0.0,0.0,115012,20.01.2017 17:30:00,14136,-0.09687599836019435,-196.96,IS,0.27,0.0,Phase3-EA-S1v2-USDJPY-M15-0,USDJPYMT4,4094,2d 9h 44m,Buy
158492.26,1.07349,23.01.2017 05:59:58,tp 1.07349,-0.98,-196.78999999997905,0.0,0.0,1.07239,20.01.2017 22:20:00,14137,-0.07913094685913127,44.13,IS,0.41,0.0,Phase3-EA-SA2v2-EURCHF-M5-43,EURCHFMT4,7200,2d 7h 39m,Buy
158296.57,0.9988,23.01.2017 06:30:00,,0.0,-392.4799999999814,0.0,0.0,1.00217,23.01.2017 02:15:00,14138,-0.15781957428362048,-195.69,IS,0.58,0.0,Phase3-EA-SA2v2-USDCHF-M15-107,USDCHFMT4,2774,4h 15m,Buy
158329.53,141198,23.01.2017 09:00:00,,0.0,-359.5199999999895,0.0,0.0,141035,23.01.2017 03:35:00,14139,-0.14456607558715928,32.96,IS,0.23,0.0,Phase3-EA-S4v1-GBPJPY-M5-194,GBPJPYMT4,3090,5h 25m,Buy
158365.97,1.07203,23.01.2017 15:00:00,,0.0,-323.0799999999872,0.0,0.0,1.0731,23.01.2017 06:15:00,14140,-0.12991323904288754,36.44,IS,0.34,0.0,Phase3-EA-S4v1-EURCHF-M15-221,EURCHFMT4,3652,8h 45m,Sell
158372.62,113616,23.01.2017 18:30:00,,0.0,-316.429999999993,0.0,0.0,113588,23.01.2017 17:15:00,14141,-0.12723921700613355,6.65,IS,0.27,0.0,Phase3-EA-S1v2-USDJPY-M15-0,USDJPYMT4,4096,1h 15m,Buy
158314.56,121164,23.01.2017 20:59:58,sl 121.164,-0.77,-374.4899999999907,0.0,0.0,121884,19.01.2017 03:30:00,14142,-0.15058564098418867,-58.06,IS,0.09,0.0,Phase3-EA-TR1v1-EURJPY-M30-91,EURJPYMT4,2521,4d 17h 29m,Buy
158410.35,112745,24.01.2017 01:44:58,tp 112.745,0.0,-278.69999999998254,0.0,0.0,113145,24.01.2017 01:00:00,14143,-0.1120676603975855,95.79,IS,0.27,0.0,Phase3-EA-S1v2-USDJPY-M15-0,USDJPYMT4,4098,44m 58s,Sell
158441.98,112681,24.01.2017 02:00:00,,0.0,-247.06999999997788,0.0,0.0,112813,24.01.2017 01:45:00,14144,-0.09934896610847042,31.63,IS,0.27,0.0,Phase3-EA-S1v2-USDJPY-M15-0,USDJPYMT4,4100,15m 0s,Sell
158419.76,141493,24.01.2017 06:30:00,,0.0,-269.28999999997905,0.0,0.0,141384,24.01.2017 01:05:00,14145,-0.10828381868842965,-22.22,IS,0.23,0.0,Phase3-EA-S4v1-GBPJPY-M5-194,GBPJPYMT4,3092,5h 25m,Sell
158385.1,121451,24.01.2017 08:29:58,sl 121.451,0.0,-303.94999999998254,0.0,0.0,121221,24.01.2017 07:30:00,14146,-0.12222090196572045,-34.66,IS,0.17,0.0,Phase3-EA-T1v2-EURJPY-M15-322,EURJPYMT4,2726,59m 58s,Sell
158390.85,1.07242,24.01.2017 10:25:00,,0.0,-298.19999999998254,0.0,0.0,1.07228,24.01.2017 02:05:00,14147,-0.11990877764822439,5.75,IS,0.41,0.0,Phase3-EA-SA2v2-EURCHF-M5-43,EURCHFMT4,7202,8h 20m,Buy
158441.52,113508,24.01.2017 20:45:00,,0.0,-247.52999999996973,0.0,0.0,113295,24.01.2017 17:30:00,14148,-0.09953393605386683,50.67,IS,0.27,0.0,Phase3-EA-S1v2-USDJPY-M15-0,USDJPYMT4,4102,3h 15m,Buy
158499.52,0.99992,24.01.2017 22:29:57,tp 0.99992,0.0,-189.52999999996973,0.0,0.0,0.99892,24.01.2017 22:00:00,14149,-0.07621163859042814,58.0,IS,0.58,0.0,Phase3-EA-SA2v2-USDCHF-M15-107,USDCHFMT4,2776,29m 57s,Buy
158557.49,1.00057,25.01.2017 02:14:57,tp 1.00057,0.0,-131.55999999996857,0.0,0.0,1.00157,25.01.2017 00:15:00,14150,-0.052901404384297634,57.97,IS,0.58,0.0,Phase3-EA-SA2v2-USDCHF-M15-107,USDCHFMT4,2778,1h 59m,Sell
158702.56,142584,25.01.2017 02:59:59,tp 142.584,-1.13,-0.0,0.0,0.0,140734,19.01.2017 05:30:00,14151,-0.0,145.07,IS,0.09,0.0,Phase3-EA-B1v1-GBPJPY-M30-1,GBPJPYMT4,1304,5d 21h 29m,Buy
158781.49,142268,25.01.2017 06:04:58,tp 142.268,0.0,-0.0,0.0,0.0,142658,25.01.2017 03:25:00,14152,-0.0,78.93,IS,0.23,0.0,Phase3-EA-S4v1-GBPJPY-M5-194,GBPJPYMT4,3094,2h 39m,Sell
158791.57,1.07418,25.01.2017 08:05:00,,-0.98,-0.0,0.0,0.0,1.07391,24.01.2017 23:45:00,14153,-0.0,10.08,IS,0.41,0.0,Phase3-EA-SA2v2-EURCHF-M5-43,EURCHFMT4,7204,8h 20m,Buy
159054.58,1.25467,25.01.2017 13:29:58,tp 1.25467,-1.59,-0.0,0.0,0.0,1.23577,20.01.2017 23:00:00,14154,-0.0,263.01,IS,0.14,0.0,Phase3-EA-B1v1-GBPUSD-M30-14,GBPUSDMT4,926,4d 14h 29m,Buy
159020.13,121881,25.01.2017 16:29:58,sl 121.881,0.0,-34.45000000001164,0.0,0.0,122111,25.01.2017 13:30:00,14155,-0.013832309367694232,-34.45,IS,0.17,0.0,Phase3-EA-T1v2-EURJPY-M15-322,EURJPYMT4,2728,2h 59m,Buy
158985.68,122015,25.01.2017 18:14:57,sl 122.015,0.0,-68.90000000002328,0.0,0.0,121785,25.01.2017 17:15:00,14156,-0.027664618735388464,-34.45,IS,0.17,0.0,Phase3-EA-T1v2-EURJPY-M15-322,EURJPYMT4,2730,59m 57s,Sell
158867.15,0.99827,26.01.2017 04:30:00,,0.0,-187.43000000002212,0.0,0.0,1.00031,26.01.2017 00:15:00,14157,-0.07525659636535151,-118.53,IS,0.58,0.0,Phase3-EA-SA2v2-USDCHF-M15-107,USDCHFMT4,2780,4h 15m,Buy
158786.0,113357,26.01.2017 06:15:00,,-2.07,-268.5800000000163,0.0,0.0,113689,25.01.2017 23:45:00,14158,-0.10783981567414475,-81.15,IS,0.27,0.0,Phase3-EA-S1v2-USDJPY-M15-0,USDJPYMT4,4104,6h 30m,Buy
158792.16,1074,26.01.2017 08:45:00,,0.0,-262.4200000000128,0.0,0.0,1.07415,26.01.2017 00:25:00,14159,-0.10536646224293965,6.16,IS,0.41,0.0,Phase3-EA-SA2v2-EURCHF-M5-43,EURCHFMT4,7206,8h 20m,Sell
158750.16,1.2629,26.01.2017 13:59:58,sl 1.26290,0.0,-304.4200000000128,0.0,0.0,1.2659,26.01.2017 12:30:00,14160,-0.12223023563751037,-42.0,IS,0.14,0.0,Phase3-EA-B1v1-GBPUSD-M30-14,GBPUSDMT4,928,1h 29m,Buy
158844.37,114643,26.01.2017 19:44:57,tp 114.643,0.0,-210.21000000002095,0.0,0.0,114243,26.01.2017 18:00:00,14161,-0.08440318583983489,94.21,IS,0.27,0.0,Phase3-EA-S1v2-USDJPY-M15-0,USDJPYMT4,4106,1h 44m,Buy
158837.55,122368,26.01.2017 21:00:00,,0.0,-217.03000000002794,0.0,0.0,122414,26.01.2017 20:15:00,14162,-0.08714154142438464,-6.82,IS,0.17,0.0,Phase3-EA-T1v2-EURJPY-M15-322,EURJPYMT4,2732,45m 0s,Buy
158895.52,1.00047,27.01.2017 01:59:59,tp 1.00047,0.0,-159.06000000002678,0.0,0.0,1.00147,27.01.2017 01:15:00,14163,-0.06386551895573502,57.97,IS,0.58,0.0,Phase3-EA-SA2v2-USDCHF-M15-107,USDCHFMT4,2782,44m 59s,Sell
158952.54,114651,27.01.2017 05:00:00,,-0.68,-102.04000000003725,0.0,0.0,114406,26.01.2017 22:15:00,14164,-0.04097093898053868,57.02,IS,0.27,0.0,Phase3-EA-S1v2-USDJPY-M15-0,USDJPYMT4,4108,6h 45m,Buy
158954.18,1.06828,27.01.2017 09:55:00,,0.0,-100.40000000002328,0.0,0.0,1.06824,27.01.2017 01:35:00,14165,-0.040312448781316505,1.64,IS,0.41,0.0,Phase3-EA-SA2v2-EURCHF-M5-43,EURCHFMT4,7208,8h 20m,Buy
159053.17,122844,27.01.2017 10:29:58,tp 122.844,-1.94,-1.4100000000325963,0.0,0.0,121554,24.01.2017 01:00:00,14166,-5.661409639736765E-4,98.99,IS,0.09,0.0,Phase3-EA-TR1v1-EURJPY-M30-91,EURJPYMT4,2524,3d 9h 29m,Buy
159097.41,1.06923,30.01.2017 04:59:57,tp 1.06923,-0.99,-0.0,0.0,0.0,1.06813,27.01.2017 20:40:00,14167,-0.0,44.24,IS,0.41,0.0,Phase3-EA-SA2v2-EURCHF-M5-43,EURCHFMT4,7210,2d 8h 19m,Buy
159100.81,1.06873,30.01.2017 12:00:00,,0.0,-0.0,0.0,0.0,1.06883,30.01.2017 03:15:00,14168,-0.0,3.4,IS,0.34,0.0,Phase3-EA-S4v1-EURCHF-M15-221,EURCHFMT4,3654,8h 45m,Sell
159043.96,122373,30.01.2017 15:59:58,sl 122.373,-0.38,-56.85000000000582,0.0,0.0,123093,27.01.2017 13:00:00,14169,-0.022822085564477148,-56.85,IS,0.09,0.0,Phase3-EA-TR1v1-EURJPY-M30-91,EURJPYMT4,2526,3d 2h 59m,Buy
158989.8,142795,30.01.2017 19:29:58,sl 142.795,-1.42,-111.01000000000931,0.0,0.0,143465,25.01.2017 23:00:00,14170,-0.04456428704507583,-54.16,IS,0.09,0.0,Phase3-EA-B1v1-GBPJPY-M30-1,GBPJPYMT4,1306,4d 20h 29m,Buy
158995.97,113.71,31.01.2017 04:15:00,,0.0,-104.83999999999651,0.0,0.0,113736,31.01.2017 01:15:00,14171,-0.042087378198407376,6.17,IS,0.27,0.0,Phase3-EA-S1v2-USDJPY-M15-0,USDJPYMT4,4110,3h 0m,Sell
158972.32,1.06431,31.01.2017 05:45:00,,-0.99,-128.4899999999907,0.0,0.0,1.06486,30.01.2017 21:25:00,14172,-0.0515815263707855,-23.65,IS,0.41,0.0,Phase3-EA-SA2v2-EURCHF-M5-43,EURCHFMT4,7212,8h 20m,Buy
158919.39,142383,31.01.2017 13:29:57,sl 142.383,0.0,-181.4199999999837,0.0,0.0,141713,31.01.2017 12:00:00,14173,-0.07282995185763673,-52.93,IS,0.09,0.0,Phase3-EA-B1v1-GBPJPY-M30-1,GBPJPYMT4,1308,1h 29m,Sell
158884.55,121455,31.01.2017 19:59:58,sl 121.455,0.0,-216.2599999999802,0.0,0.0,121225,31.01.2017 19:00:00,14174,-0.08681625724138735,-34.84,IS,0.17,0.0,Phase3-EA-T1v2-EURJPY-M15-322,EURJPYMT4,2734,59m 58s,Sell
158831.02,141997,31.01.2017 21:29:58,sl 141.997,0.0,-269.78999999997905,0.0,0.0,141327,31.01.2017 14:00:00,14175,-0.10830554906665225,-53.53,IS,0.09,0.0,Phase3-EA-B1v1-GBPJPY-M30-1,GBPJPYMT4,1310,7h 29m,Sell
158796.4,121751,31.01.2017 22:44:58,sl 121.751,0.0,-304.4099999999744,0.0,0.0,121981,31.01.2017 21:30:00,14176,-0.12220353679298492,-34.62,IS,0.17,0.0,Phase3-EA-T1v2-EURJPY-M15-322,EURJPYMT4,2736,1h 14m,Buy
158892.19,112745,31.01.2017 22:59:58,tp 112.745,0.0,-208.61999999996624,0.0,0.0,113145,31.01.2017 21:30:00,14177,-0.08374922586561064,95.79,IS,0.27,0.0,Phase3-EA-S1v2-USDJPY-M15-0,USDJPYMT4,4112,1h 29m,Sell
158857.49,121765,31.01.2017 23:59:57,sl 121.765,0.0,-243.31999999997788,0.0,0.0,121535,31.01.2017 23:15:00,14178,-0.09767932910373801,-34.7,IS,0.17,0.0,Phase3-EA-T1v2-EURJPY-M15-322,EURJPYMT4,2738,44m 57s,Sell
158915.4,0.98965,01.02.2017 00:29:58,tp 0.98965,-0.7,-185.4099999999744,0.0,0.0,0.98865,31.01.2017 23:45:00,14179,-0.07443171300806843,57.91,IS,0.58,0.0,Phase3-EA-SA2v2-USDCHF-M15-107,USDCHFMT4,2784,44m 58s,Buy
158880.76,121644,01.02.2017 02:44:58,sl 121.644,0.0,-220.04999999998836,0.0,0.0,121874,01.02.2017 01:00:00,14180,-0.0883377296123556,-34.64,IS,0.17,0.0,Phase3-EA-T1v2-EURJPY-M15-322,EURJPYMT4,2740,1h 44m,Buy
158823.22,1.06861,01.02.2017 05:10:00,,-2.07,-277.5899999999965,0.0,0.0,1.06727,31.01.2017 20:50:00,14181,-0.11143681146600673,-57.54,IS,0.41,0.0,Phase3-EA-SA2v2-EURCHF-M5-43,EURCHFMT4,7214,8h 20m,Sell
158765.45,122439,01.02.2017 11:59:58,sl 122.439,-0.56,-335.35999999998603,0.0,0.0,121719,30.01.2017 17:30:00,14182,-0.13462822541604139,-57.77,IS,0.09,0.0,Phase3-EA-TR1v1-EURJPY-M30-91,EURJPYMT4,2528,1d 18h 29m,Sell
158568.21,113619,01.02.2017 11:59:58,sl 113.619,0.0,-532.5999999999767,0.0,0.0,112789,01.02.2017 00:15:00,14183,-0.21380901972979335,-197.24,IS,0.27,0.0,Phase3-EA-S1v2-USDJPY-M15-0,USDJPYMT4,4114,11h 44m,Sell
158578.87,1.06834,01.02.2017 15:00:00,,0.0,-521.9399999999732,0.0,0.0,1.06865,01.02.2017 06:15:00,14184,-0.20952962778401707,10.66,IS,0.34,0.0,Phase3-EA-S4v1-EURCHF-M15-221,EURCHFMT4,3656,8h 45m,Sell
158637.23,0.99384,01.02.2017 23:14:58,tp 0.99384,0.0,-463.5799999999872,0.0,0.0,0.99484,01.02.2017 23:00:00,14185,-0.186101361934546,58.36,IS,0.58,0.0,Phase3-EA-SA2v2-USDCHF-M15-107,USDCHFMT4,2786,14m 58s,Sell
158716.56,143079,02.02.2017 04:29:58,tp 143.079,0.0,-384.25,0.0,0.0,143469,02.02.2017 03:30:00,14186,-0.15425481755759798,79.33,IS,0.23,0.0,Phase3-EA-S4v1-GBPJPY-M5-194,GBPJPYMT4,3096,59m 58s,Sell
158679.76,1.06883,02.02.2017 05:20:00,,-6.2,-421.04999999998836,0.0,0.0,1.06809,01.02.2017 21:00:00,14187,-0.16902795298015572,-36.8,IS,0.41,0.0,Phase3-EA-SA2v2-EURCHF-M5-43,EURCHFMT4,7216,8h 20m,Sell
158681.48,1.06916,02.02.2017 10:15:00,,0.0,-419.3299999999872,0.0,0.0,1.06921,02.02.2017 01:30:00,14188,-0.1683374694767094,1.72,IS,0.34,0.0,Phase3-EA-S4v1-EURCHF-M15-221,EURCHFMT4,3658,8h 45m,Sell
158734.16,112236,02.02.2017 18:45:00,,0.0,-366.6499999999942,0.0,0.0,112455,02.02.2017 18:15:00,14189,-0.14718940496419625,52.68,IS,0.27,0.0,Phase3-EA-S1v2-USDJPY-M15-0,USDJPYMT4,4116,30m 0s,Sell
158716.61,112307,02.02.2017 19:00:00,,0.0,-384.19999999998254,0.0,0.0,112234,02.02.2017 18:45:00,14190,-0.15423474536272336,-17.55,IS,0.27,0.0,Phase3-EA-S1v2-USDJPY-M15-0,USDJPYMT4,4118,15m 0s,Sell
158759.96,1.06811,03.02.2017 00:34:57,tp 1.06811,-2.07,-340.8499999999767,0.0,0.0,1.06921,02.02.2017 22:10:00,14191,-0.13683215241250146,43.35,IS,0.41,0.0,Phase3-EA-SA2v2-EURCHF-M5-43,EURCHFMT4,7218,2h 24m,Sell
158738.16,0.99242,03.02.2017 03:30:00,,-3.1,-362.6499999999651,0.0,0.0,0.9921,02.02.2017 23:15:00,14192,-0.1455836293747756,-21.8,IS,0.58,0.0,Phase3-EA-SA2v2-USDCHF-M15-107,USDCHFMT4,2788,4h 15m,Sell
158703.0,121589,03.02.2017 05:14:57,sl 121.589,-0.53,-397.80999999996857,0.0,0.0,121359,02.02.2017 23:30:00,14193,-0.15969839680568174,-35.16,IS,0.17,0.0,Phase3-EA-T1v2-EURJPY-M15-322,EURJPYMT4,2742,5h 44m,Sell
158705.89,1.06804,03.02.2017 08:55:00,,0.0,-394.9199999999546,0.0,0.0,1.06797,03.02.2017 00:35:00,14194,-0.15853822394232817,2.89,IS,0.41,0.0,Phase3-EA-SA2v2-EURCHF-M5-43,EURCHFMT4,7220,8h 20m,Buy
158714.11,1.06833,03.02.2017 11:00:00,,0.0,-386.69999999995343,0.0,0.0,1.06809,03.02.2017 02:15:00,14195,-0.15523835510609227,8.22,IS,0.34,0.0,Phase3-EA-S4v1-EURCHF-M15-221,EURCHFMT4,3660,8h 45m,Buy
158669.45,1.24992,03.02.2017 13:59:57,sl 1.24992,-2.66,-431.3599999999569,0.0,0.0,1.25292,31.01.2017 18:30:00,14196,-0.1731668395618447,-44.66,IS,0.14,0.0,Phase3-EA-B1v1-GBPUSD-M30-14,GBPUSDMT4,930,2d 19h 29m,Buy
158709.65,112508,06.02.2017 02:15:00,,-1.08,-391.1599999999453,0.0,0.0,112.68,03.02.2017 22:30:00,14197,-0.15702879488828,40.2,IS,0.27,0.0,Phase3-EA-S1v2-USDJPY-M15-0,USDJPYMT4,4120,2d 3h 45m,Sell
158719.4,1.06947,06.02.2017 07:25:00,,-0.99,-381.4099999999453,0.0,0.0,1.06921,03.02.2017 23:05:00,14198,-0.15311471688909567,9.75,IS,0.41,0.0,Phase3-EA-SA2v2-EURCHF-M5-43,EURCHFMT4,7222,2d 8h 20m,Buy
158696.27,140322,06.02.2017 07:30:00,,0.0,-404.53999999994994,0.0,0.0,140435,06.02.2017 02:05:00,14199,-0.16240011423485484,-23.13,IS,0.23,0.0,Phase3-EA-S4v1-GBPJPY-M5-194,GBPJPYMT4,3098,5h 25m,Buy
158797.86,121026,06.02.2017 12:29:57,tp 121.026,-1.4,-302.94999999995343,0.0,0.0,122316,01.02.2017 16:00:00,14200,-0.12161742870284223,101.59,IS,0.09,0.0,Phase3-EA-TR1v1-EURJPY-M30-91,EURJPYMT4,2530,4d 20h 29m,Sell
158843.83,112188,06.02.2017 21:45:00,,0.0,-256.97999999995227,0.0,0.0,112379,06.02.2017 19:00:00,14201,-0.10316305274155932,45.97,IS,0.27,0.0,Phase3-EA-S1v2-USDJPY-M15-0,USDJPYMT4,4122,2h 45m,Sell
158874.73,0.99129,07.02.2017 04:00:00,,-0.7,-226.0799999999581,0.0,0.0,0.99075,06.02.2017 23:45:00,14202,-0.09075843631337746,30.9,IS,0.58,0.0,Phase3-EA-SA2v2-USDCHF-M15-107,USDCHFMT4,2790,4h 15m,Buy
158815.87,1.06449,07.02.2017 06:10:00,,-0.99,-284.9399999999441,0.0,0.0,1.06589,06.02.2017 21:50:00,14203,-0.11438742411152467,-58.86,IS,0.41,0.0,Phase3-EA-SA2v2-EURCHF-M5-43,EURCHFMT4,7224,8h 20m,Buy
158800.04,139443,07.02.2017 08:05:00,,0.0,-300.7699999999313,0.0,0.0,139366,07.02.2017 02:40:00,14204,-0.12074228100660547,-15.83,IS,0.23,0.0,Phase3-EA-S4v1-GBPJPY-M5-194,GBPJPYMT4,3100,5h 25m,Sell
159057.9,119681,07.02.2017 10:14:58,tp 119.681,-0.53,-42.909999999945285,0.0,0.0,121381,06.02.2017 02:15:00,14205,-0.017225957635362627,257.86,IS,0.17,0.0,Phase3-EA-T1v2-EURJPY-M15-322,EURJPYMT4,2744,1d 7h 59m,Sell
159084.78,1.06557,07.02.2017 14:30:00,,0.0,-16.029999999940628,0.0,0.0,1.06478,07.02.2017 05:45:00,14206,-0.006435145674532563,26.88,IS,0.34,0.0,Phase3-EA-S4v1-EURCHF-M15-221,EURCHFMT4,3662,8h 45m,Buy
159126.78,112488,07.02.2017 19:00:00,,0.0,-0.0,0.0,0.0,112313,07.02.2017 18:30:00,14207,-0.0,42.0,IS,0.27,0.0,Phase3-EA-S1v2-USDJPY-M15-0,USDJPYMT4,4124,30m 0s,Buy
159091.91,119979,07.02.2017 23:59:58,sl 119.979,0.0,-34.86999999999534,0.0,0.0,119749,07.02.2017 21:45:00,14208,-0.013996889455238505,-34.87,IS,0.17,0.0,Phase3-EA-T1v2-EURJPY-M15-322,EURJPYMT4,2746,2h 14m,Sell
159100.1,112383,08.02.2017 01:45:00,,-0.7,-26.679999999993015,0.0,0.0,112346,07.02.2017 19:30:00,14209,-0.010709406672374976,8.19,IS,0.27,0.0,Phase3-EA-S1v2-USDJPY-M15-0,USDJPYMT4,4126,6h 15m,Buy
159143.56,140215,08.02.2017 05:40:00,,0.0,-0.0,0.0,0.0,140427,08.02.2017 00:15:00,14210,-0.0,43.46,IS,0.23,0.0,Phase3-EA-S4v1-GBPJPY-M5-194,GBPJPYMT4,3102,5h 25m,Sell
159201.75,0.99677,08.02.2017 05:59:57,tp 0.99677,0.0,-0.0,0.0,0.0,0.99777,08.02.2017 01:45:00,14211,-0.0,58.19,IS,0.58,0.0,Phase3-EA-SA2v2-USDCHF-M15-107,USDCHFMT4,2792,4h 14m,Sell
159166.9,119778,08.02.2017 06:29:58,sl 119.778,0.0,-34.85000000000582,0.0,0.0,120008,08.02.2017 00:15:00,14212,-0.013984652997021771,-34.85,IS,0.17,0.0,Phase3-EA-T1v2-EURJPY-M15-322,EURJPYMT4,2748,6h 14m,Buy
159161.39,1.06533,08.02.2017 07:10:00,,-0.99,-40.360000000015134,0.0,0.0,1.06544,07.02.2017 22:50:00,14213,-0.016195712911331882,-5.51,IS,0.41,0.0,Phase3-EA-SA2v2-EURCHF-M5-43,EURCHFMT4,7226,8h 20m,Buy
159152.2,1.06509,08.02.2017 11:30:00,,0.0,-49.55000000001746,0.0,0.0,1.06536,08.02.2017 02:45:00,14214,-0.019883487977117854,-9.19,IS,0.34,0.0,Phase3-EA-S4v1-EURCHF-M15-221,EURCHFMT4,3664,8h 45m,Buy
159168.75,111839,09.02.2017 03:00:00,,-3.25,-33.000000000029104,0.0,0.0,111921,08.02.2017 22:15:00,14215,-0.013242282608380155,16.55,IS,0.27,0.0,Phase3-EA-S1v2-USDJPY-M15-0,USDJPYMT4,4128,4h 45m,Sell
159226.99,0.99593,09.02.2017 04:59:57,tp 0.99593,0.0,-0.0,0.0,0.0,0.99493,09.02.2017 01:45:00,14216,-0.0,58.24,IS,0.58,0.0,Phase3-EA-SA2v2-USDCHF-M15-107,USDCHFMT4,2794,3h 14m,Buy
159230.06,1.06387,09.02.2017 11:15:00,,0.0,-0.0,0.0,0.0,1.06396,09.02.2017 02:30:00,14217,-0.0,3.07,IS,0.34,0.0,Phase3-EA-S4v1-EURCHF-M15-221,EURCHFMT4,3666,8h 45m,Sell
159193.69,120007,09.02.2017 12:14:58,sl 120.007,-1.59,-36.36999999999534,0.0,0.0,119777,08.02.2017 06:30:00,14218,-0.01459294276139693,-36.37,IS,0.17,0.0,Phase3-EA-T1v2-EURJPY-M15-322,EURJPYMT4,2750,1d 5h 44m,Sell
159135.0,121194,10.02.2017 05:29:58,sl 121.194,-1.68,-95.05999999999767,0.0,0.0,120474,06.02.2017 17:00:00,14219,-0.038141466563061194,-58.69,IS,0.09,0.0,Phase3-EA-TR1v1-EURJPY-M30-91,EURJPYMT4,2532,3d 12h 29m,Sell
159179.04,1.06783,10.02.2017 07:04:58,tp 1.06783,-0.98,-51.01999999998952,0.0,0.0,1.06673,09.02.2017 22:45:00,14220,-0.02047104590834242,44.04,IS,0.41,0.0,Phase3-EA-SA2v2-EURCHF-M5-43,EURCHFMT4,7228,8h 19m,Buy
159042.75,142245,10.02.2017 08:20:00,,0.0,-187.30999999999767,0.0,0.0,141571,10.02.2017 02:55:00,14221,-0.07515546078189647,-136.29,IS,0.23,0.0,Phase3-EA-S4v1-GBPJPY-M5-194,GBPJPYMT4,3104,5h 25m,Sell
159067.86,1.06766,10.02.2017 11:45:00,,0.0,-162.20000000001164,0.0,0.0,1.06692,10.02.2017 03:00:00,14222,-0.06508043211160448,25.11,IS,0.34,0.0,Phase3-EA-S4v1-EURCHF-M15-221,EURCHFMT4,3668,8h 45m,Buy
159010.83,120431,10.02.2017 20:29:58,sl 120.431,0.0,-219.23000000001048,0.0,0.0,121151,10.02.2017 07:30:00,14223,-0.08796290463518315,-57.03,IS,0.09,0.0,Phase3-EA-TR1v1-EURJPY-M30-91,EURJPYMT4,2534,12h 59m,Buy
159068.61,1.00386,13.02.2017 03:14:57,tp 1.00386,0.0,-161.45000000001164,0.0,0.0,1.00286,13.02.2017 02:15:00,14224,-0.06477950532933753,57.78,IS,0.58,0.0,Phase3-EA-SA2v2-USDCHF-M15-107,USDCHFMT4,2796,59m 57s,Buy
159042.33,1.06642,13.02.2017 06:25:00,,-0.98,-187.73000000001048,0.0,0.0,1.06704,10.02.2017 22:05:00,14225,-0.0753239797799711,-26.28,IS,0.41,0.0,Phase3-EA-SA2v2-EURCHF-M5-43,EURCHFMT4,7230,2d 8h 20m,Buy
159032.84,142258,13.02.2017 09:05:00,,0.0,-197.22000000000116,0.0,0.0,142211,13.02.2017 03:40:00,14226,-0.07913170666491856,-9.49,IS,0.23,0.0,Phase3-EA-S4v1-GBPJPY-M5-194,GBPJPYMT4,3106,5h 25m,Sell
158998.48,120815,13.02.2017 18:44:58,sl 120.815,0.0,-231.5799999999872,0.0,0.0,121045,13.02.2017 12:45:00,14227,-0.0929181656498363,-34.36,IS,0.17,0.0,Phase3-EA-T1v2-EURJPY-M15-322,EURJPYMT4,2752,5h 59m,Buy
159001.58,1.06582,14.02.2017 07:50:00,,-0.98,-228.47999999998137,0.0,0.0,1.06572,13.02.2017 23:30:00,14228,-0.09167433494979724,3.1,IS,0.41,0.0,Phase3-EA-SA2v2-EURCHF-M5-43,EURCHFMT4,7232,8h 20m,Buy
158967.09,120528,14.02.2017 16:14:58,sl 120.528,0.0,-262.96999999997206,0.0,0.0,120298,14.02.2017 14:45:00,14229,-0.10551295457697647,-34.49,IS,0.17,0.0,Phase3-EA-T1v2-EURJPY-M15-322,EURJPYMT4,2754,1h 29m,Sell
158932.65,120571,14.02.2017 18:59:58,sl 120.571,0.0,-297.4099999999744,0.0,0.0,120341,14.02.2017 18:00:00,14230,-0.1193315124186759,-34.44,IS,0.17,0.0,Phase3-EA-T1v2-EURJPY-M15-322,EURJPYMT4,2756,59m 58s,Sell
158972.32,114348,15.02.2017 04:15:00,,0.0,-257.7399999999616,0.0,0.0,114.18,15.02.2017 00:15:00,14231,-0.10341449181529737,39.67,IS,0.27,0.0,Phase3-EA-S1v2-USDJPY-M15-0,USDJPYMT4,4130,4h 0m,Buy
158970.59,1.00647,15.02.2017 05:30:00,,0.0,-259.46999999997206,0.0,0.0,1.0065,15.02.2017 01:15:00,14232,-0.10410862959306402,-1.73,IS,0.58,0.0,Phase3-EA-SA2v2-USDCHF-M15-107,USDCHFMT4,2798,4h 15m,Buy
158964.31,1.06456,15.02.2017 07:20:00,,-0.98,-265.7499999999709,0.0,0.0,1.06469,14.02.2017 23:00:00,14233,-0.10662838984991217,-6.28,IS,0.41,0.0,Phase3-EA-SA2v2-EURCHF-M5-43,EURCHFMT4,7234,8h 20m,Buy
158987.65,142503,15.02.2017 08:35:00,,0.0,-242.4099999999744,0.0,0.0,142619,15.02.2017 03:10:00,14234,-0.09726354838576598,23.34,IS,0.23,0.0,Phase3-EA-S4v1-GBPJPY-M5-194,GBPJPYMT4,3108,5h 25m,Sell
159000.83,1.06463,15.02.2017 11:00:00,,0.0,-229.22999999998137,0.0,0.0,1.06424,15.02.2017 02:15:00,14235,-0.09197526173206419,13.18,IS,0.34,0.0,Phase3-EA-S4v1-EURCHF-M15-221,EURCHFMT4,3670,8h 45m,Buy
159025.93,120.85,15.02.2017 14:15:00,,-0.73,-204.12999999997555,0.0,0.0,120676,14.02.2017 19:15:00,14236,-0.08190424541886114,25.1,IS,0.17,0.0,Phase3-EA-T1v2-EURJPY-M15-322,EURJPYMT4,2758,19h 0m,Buy
158968.73,121169,15.02.2017 19:59:58,sl 121.169,-0.56,-261.3299999999872,0.0,0.0,120449,13.02.2017 23:30:00,14237,-0.10485492801309214,-57.2,IS,0.09,0.0,Phase3-EA-TR1v1-EURJPY-M30-91,EURJPYMT4,2536,1d 20h 29m,Sell
159007.5,1.06496,16.02.2017 02:00:00,tp 1.06496,-6.11,-222.55999999999767,0.0,0.0,1.06606,15.02.2017 20:05:00,14238,-0.08929901954844328,38.77,IS,0.41,0.0,Phase3-EA-SA2v2-EURCHF-M5-43,EURCHFMT4,7236,5h 55m,Sell
158973.43,1.00438,16.02.2017 05:45:00,,0.0,-256.63000000000466,0.0,0.0,1.00497,16.02.2017 01:30:00,14239,-0.10296912017755956,-34.07,IS,0.58,0.0,Phase3-EA-SA2v2-USDCHF-M15-107,USDCHFMT4,2800,4h 15m,Buy
158962.94,1.06509,16.02.2017 11:30:00,,0.0,-267.11999999999534,0.0,0.0,1.0654,16.02.2017 02:45:00,14240,-0.10717808277219629,-10.49,IS,0.34,0.0,Phase3-EA-S4v1-EURCHF-M15-221,EURCHFMT4,3672,8h 45m,Buy
159023.4,113434,16.02.2017 19:15:00,,0.0,-206.6600000000035,0.0,0.0,113688,16.02.2017 17:45:00,14241,-0.08291937176438621,60.46,IS,0.27,0.0,Phase3-EA-S1v2-USDJPY-M15-0,USDJPYMT4,4132,1h 30m,Sell
158988.42,121061,17.02.2017 05:44:58,sl 121.061,-0.53,-241.64000000001397,0.0,0.0,120831,16.02.2017 21:00:00,14242,-0.09695459688932112,-34.98,IS,0.17,0.0,Phase3-EA-T1v2-EURJPY-M15-322,EURJPYMT4,2760,8h 44m,Sell
158976.74,1.06421,17.02.2017 06:55:00,,-0.99,-253.32000000000698,0.0,0.0,1.06447,16.02.2017 22:35:00,14243,-0.101641029978489,-11.68,IS,0.41,0.0,Phase3-EA-SA2v2-EURCHF-M5-43,EURCHFMT4,7238,8h 20m,Buy
158975.72,1.0643,17.02.2017 09:45:00,,0.0,-254.3399999999965,0.0,0.0,1.06433,17.02.2017 01:00:00,14244,-0.10205029040236786,-1.02,IS,0.34,0.0,Phase3-EA-S4v1-EURCHF-M15-221,EURCHFMT4,3674,8h 45m,Buy
158931.59,1.24338,17.02.2017 13:59:58,sl 1.24338,-2.13,-298.47000000000116,0.0,0.0,1.24638,15.02.2017 20:30:00,14245,-0.11975682227095727,-44.13,IS,0.14,0.0,Phase3-EA-B1v1-GBPUSD-M30-14,GBPUSDMT4,932,1d 17h 29m,Buy
158957.69,112746,17.02.2017 20:30:00,,0.0,-272.36999999999534,0.0,0.0,112855,17.02.2017 18:45:00,14246,-0.10928457024806496,26.1,IS,0.27,0.0,Phase3-EA-S1v2-USDJPY-M15-0,USDJPYMT4,4134,1h 45m,Sell
159015.5,1.0033,20.02.2017 05:29:58,tp 1.00330,0.0,-214.55999999999767,0.0,0.0,1.0023,20.02.2017 02:15:00,14247,-0.08608913387092912,57.81,IS,0.58,0.0,Phase3-EA-SA2v2-USDCHF-M15-107,USDCHFMT4,2802,3h 14m,Buy
158993.42,1.06492,20.02.2017 11:15:00,,0.0,-236.63999999998487,0.0,0.0,1.06438,20.02.2017 02:55:00,14248,-0.0949484183408631,-22.08,IS,0.41,0.0,Phase3-EA-SA2v2-EURCHF-M5-43,EURCHFMT4,7240,8h 20m,Sell
158968.33,1.06494,20.02.2017 12:15:00,,0.0,-261.7299999999814,0.0,0.0,1.0642,20.02.2017 03:30:00,14249,-0.1050154222969655,-25.09,IS,0.34,0.0,Phase3-EA-S4v1-EURCHF-M15-221,EURCHFMT4,3676,8h 45m,Sell
159023.13,1.00225,21.02.2017 02:14:57,tp 1.00225,-3.07,-206.92999999999302,0.0,0.0,1.00325,20.02.2017 22:00:00,14250,-0.0830277054059981,54.8,IS,0.58,0.0,Phase3-EA-SA2v2-USDCHF-M15-107,USDCHFMT4,2804,4h 14m,Sell
159016.43,1.06428,21.02.2017 04:25:00,,-0.98,-213.63000000000466,0.0,0.0,1.06442,20.02.2017 20:05:00,14251,-0.0857159846609209,-6.7,IS,0.41,0.0,Phase3-EA-SA2v2-EURCHF-M5-43,EURCHFMT4,7242,8h 20m,Buy
159074.23,1.00351,21.02.2017 04:29:58,tp 1.00351,0.0,-155.8300000000163,0.0,0.0,1.00251,21.02.2017 02:15:00,14252,-0.06252456064088568,57.8,IS,0.58,0.0,Phase3-EA-SA2v2-USDCHF-M15-107,USDCHFMT4,2806,2h 14m,Buy
159020.8,141385,21.02.2017 08:50:00,,0.0,-209.2600000000093,0.0,0.0,141121,21.02.2017 03:25:00,14253,-0.08396258460958066,-53.43,IS,0.23,0.0,Phase3-EA-S4v1-GBPJPY-M5-194,GBPJPYMT4,3110,5h 25m,Sell
159013.36,1.06397,21.02.2017 11:00:00,,0.0,-216.70000000001164,0.0,0.0,1.06419,21.02.2017 02:15:00,14254,-0.08694777828966976,-7.44,IS,0.34,0.0,Phase3-EA-S4v1-EURCHF-M15-221,EURCHFMT4,3678,8h 45m,Buy
158970.83,1.24196,21.02.2017 11:59:58,sl 1.24196,-0.53,-259.2300000000105,0.0,0.0,1.24496,20.02.2017 12:30:00,14255,-0.104012333022754,-42.53,IS,0.14,0.0,Phase3-EA-B1v1-GBPUSD-M30-14,GBPUSDMT4,934,23h 29m,Buy
158936.4,119.91,21.02.2017 12:29:58,sl 119.910,0.0,-293.6600000000035,0.0,0.0,120.14,21.02.2017 03:45:00,14256,-0.11782687850735281,-34.43,IS,0.17,0.0,Phase3-EA-T1v2-EURJPY-M15-322,EURJPYMT4,2762,8h 44m,Buy
158875.04,141963,22.02.2017 05:45:00,,0.0,-355.0199999999895,0.0,0.0,141.66,22.02.2017 00:20:00,14257,-0.1424467016538809,-61.36,IS,0.23,0.0,Phase3-EA-S4v1-GBPJPY-M5-194,GBPJPYMT4,3112,5h 25m,Sell
158883.16,1.06397,22.02.2017 10:25:00,,0.0,-346.8999999999942,0.0,0.0,1.06377,22.02.2017 02:05:00,14258,-0.1391886676912059,8.12,IS,0.41,0.0,Phase3-EA-SA2v2-EURCHF-M5-43,EURCHFMT4,7244,8h 20m,Buy
158820.49,119163,22.02.2017 11:59:57,sl 119.163,-0.78,-409.570000000007,0.0,0.0,119943,20.02.2017 03:30:00,14259,-0.16433410961743766,-62.67,IS,0.09,0.0,Phase3-EA-TR1v1-EURJPY-M30-91,EURJPYMT4,2538,2d 8h 29m,Buy
158778.49,1.24666,22.02.2017 12:59:58,sl 1.24666,0.0,-451.570000000007,0.0,0.0,1.24966,22.02.2017 11:30:00,14260,-0.18118600942438706,-42.0,IS,0.14,0.0,Phase3-EA-B1v1-GBPUSD-M30-14,GBPUSDMT4,936,1h 29m,Buy
158721.2,119434,22.02.2017 19:59:58,sl 119.434,0.0,-508.86000000001513,0.0,0.0,118714,22.02.2017 15:30:00,14261,-0.20417280323248868,-57.29,IS,0.09,0.0,Phase3-EA-TR1v1-EURJPY-M30-91,EURJPYMT4,2540,4h 29m,Sell
158724.07,113071,22.02.2017 23:15:00,,0.0,-505.9900000000198,0.0,0.0,113083,22.02.2017 18:45:00,14262,-0.20302125674568233,2.87,IS,0.27,0.0,Phase3-EA-S1v2-USDJPY-M15-0,USDJPYMT4,4136,4h 30m,Sell
158762.62,1.06506,23.02.2017 02:04:58,tp 1.06506,-6.09,-467.44000000003143,0.0,0.0,1.06616,22.02.2017 20:05:00,14263,-0.1875536201371656,38.55,IS,0.41,0.0,Phase3-EA-SA2v2-EURCHF-M5-43,EURCHFMT4,7246,5h 59m,Sell
158780.92,141034,23.02.2017 04:45:00,,-2.2,-449.1400000000431,0.0,0.0,140933,22.02.2017 23:20:00,14264,-0.1802110066498566,18.3,IS,0.23,0.0,Phase3-EA-S4v1-GBPJPY-M5-194,GBPJPYMT4,3114,5h 25m,Buy
158815.1,112571,24.02.2017 02:00:00,,-1.08,-414.96000000005006,0.0,0.0,112718,23.02.2017 22:45:00,14265,-0.1664967700926801,34.18,IS,0.27,0.0,Phase3-EA-S1v2-USDJPY-M15-0,USDJPYMT4,4138,3h 15m,Sell
158837.56,1.00704,24.02.2017 05:00:00,,0.0,-392.5000000000582,0.0,0.0,1.00665,24.02.2017 00:45:00,14266,-0.15748501605306234,22.46,IS,0.58,0.0,Phase3-EA-SA2v2-USDCHF-M15-107,USDCHFMT4,2808,4h 15m,Buy
158838.62,1.06486,24.02.2017 06:45:00,,-0.98,-391.44000000006054,0.0,0.0,1.06481,23.02.2017 22:25:00,14267,-0.15705970620079265,1.06,IS,0.41,0.0,Phase3-EA-SA2v2-EURCHF-M5-43,EURCHFMT4,7248,8h 20m,Buy
158902.44,112118,24.02.2017 21:30:00,,0.0,-327.62000000005355,0.0,0.0,112383,24.02.2017 18:45:00,14268,-0.13145284320842054,63.82,IS,0.27,0.0,Phase3-EA-S1v2-USDJPY-M15-0,USDJPYMT4,4140,2h 45m,Sell
158839.82,118551,24.02.2017 21:59:58,sl 118.551,0.0,-390.2400000000489,0.0,0.0,119331,24.02.2017 03:30:00,14269,-0.15657822334916086,-62.62,IS,0.09,0.0,Phase3-EA-TR1v1-EURJPY-M30-91,EURJPYMT4,2542,18h 29m,Buy
158818.24,1.06466,27.02.2017 05:55:00,,-2.04,-411.8200000000361,0.0,0.0,1.06418,24.02.2017 21:35:00,14270,-0.1652368899642502,-21.58,IS,0.41,0.0,Phase3-EA-SA2v2-EURCHF-M5-43,EURCHFMT4,7250,2d 8h 20m,Sell
158760.24,119227,27.02.2017 22:29:58,sl 119.227,-0.28,-469.8200000000361,0.0,0.0,118507,24.02.2017 23:00:00,14271,-0.18850856112622794,-58.0,IS,0.09,0.0,Phase3-EA-TR1v1-EURJPY-M30-91,EURJPYMT4,2544,2d 23h 29m,Sell
158708.65,1.06836,28.02.2017 04:20:00,,-2.03,-521.4100000000326,0.0,0.0,1.06714,27.02.2017 20:00:00,14272,-0.20920831138909604,-51.59,IS,0.41,0.0,Phase3-EA-SA2v2-EURCHF-M5-43,EURCHFMT4,7252,8h 20m,Sell
158737.06,140128,28.02.2017 04:35:00,,-1.18,-493.0000000000291,0.0,0.0,140273,27.02.2017 23:10:00,14273,-0.19780920487682244,28.41,IS,0.23,0.0,Phase3-EA-S4v1-GBPJPY-M5-194,GBPJPYMT4,3116,5h 25m,Sell
158783.31,1.06695,28.02.2017 09:45:00,,0.0,-446.7500000000291,0.0,0.0,1.06832,28.02.2017 01:00:00,14274,-0.17925205330369365,46.25,IS,0.34,0.0,Phase3-EA-S4v1-EURCHF-M15-221,EURCHFMT4,3680,8h 45m,Sell
158832.58,111803,28.02.2017 21:30:00,,0.0,-397.4800000000396,0.0,0.0,112007,28.02.2017 21:15:00,14275,-0.15948316988730743,49.27,IS,0.27,0.0,Phase3-EA-S1v2-USDJPY-M15-0,USDJPYMT4,4142,15m 0s,Sell
158814.09,1.06373,01.03.2017 04:25:00,,-0.98,-415.97000000003027,0.0,0.0,1.06416,28.02.2017 20:05:00,14276,-0.16690201815945832,-18.49,IS,0.41,0.0,Phase3-EA-SA2v2-EURCHF-M5-43,EURCHFMT4,7254,8h 20m,Buy
158756.48,1.0068,01.03.2017 06:00:00,,0.0,-473.5800000000163,0.0,0.0,1.0058,01.03.2017 01:45:00,14277,-0.19001720739465164,-57.61,IS,0.58,0.0,Phase3-EA-SA2v2-USDCHF-M15-107,USDCHFMT4,2810,4h 15m,Sell
158702.48,140483,01.03.2017 08:59:58,sl 140.483,-0.93,-527.5800000000163,0.0,0.0,139813,27.02.2017 02:00:00,14278,-0.2116839357178723,-54.0,IS,0.09,0.0,Phase3-EA-B1v1-GBPJPY-M30-1,GBPJPYMT4,1312,2d 6h 59m,Sell
158716.96,1.06388,01.03.2017 14:30:00,,0.0,-513.1000000000058,0.0,0.0,1.06431,01.03.2017 05:45:00,14279,-0.20587404264156745,14.48,IS,0.34,0.0,Phase3-EA-S4v1-EURCHF-M15-221,EURCHFMT4,3682,8h 45m,Sell
158678.84,119919,01.03.2017 15:14:58,sl 119.919,-3.7,-551.2200000000012,0.0,0.0,119689,22.02.2017 06:00:00,14280,-0.2211691478949206,-38.12,IS,0.17,0.0,Phase3-EA-T1v2-EURJPY-M15-322,EURJPYMT4,2764,7d 9h 14m,Sell
158662.05,113733,02.03.2017 02:15:00,,-2.07,-568.0100000000093,0.0,0.0,113795,01.03.2017 19:45:00,14281,-0.22790589546060674,-16.79,IS,0.27,0.0,Phase3-EA-S1v2-USDJPY-M15-0,USDJPYMT4,4144,6h 30m,Buy
158740.9,140048,02.03.2017 03:04:57,tp 140.048,0.0,-489.1600000000035,0.0,0.0,139658,02.03.2017 00:05:00,14282,-0.19626845975160537,78.85,IS,0.23,0.0,Phase3-EA-S4v1-GBPJPY-M5-194,GBPJPYMT4,3118,2h 59m,Buy
158631.29,1.01025,02.03.2017 04:00:00,,-9.14,-598.7699999999895,0.0,0.0,1.0085,01.03.2017 23:45:00,14283,-0.24024790589064077,-109.61,IS,0.58,0.0,Phase3-EA-SA2v2-USDCHF-M15-107,USDCHFMT4,2812,4h 15m,Sell
158624.7,1.06405,02.03.2017 05:10:00,,-2.93,-605.359999999986,0.0,0.0,1.06414,01.03.2017 20:50:00,14284,-0.24289204921749166,-6.59,IS,0.41,0.0,Phase3-EA-SA2v2-EURCHF-M5-43,EURCHFMT4,7256,8h 20m,Buy
158678.96,1.01247,03.03.2017 02:14:57,tp 1.01247,-3.03,-551.0999999999767,0.0,0.0,1.01347,02.03.2017 22:00:00,14285,-0.22112099960974807,54.26,IS,0.58,0.0,Phase3-EA-SA2v2-USDCHF-M15-107,USDCHFMT4,2814,4h 14m,Sell
158710.78,1.06472,03.03.2017 04:45:00,,-0.97,-519.2799999999697,0.0,0.0,1.06391,02.03.2017 20:25:00,14286,-0.20835367932743265,31.82,IS,0.41,0.0,Phase3-EA-SA2v2-EURCHF-M5-43,EURCHFMT4,7258,8h 20m,Buy
158687.25,1.06557,03.03.2017 14:45:00,,0.0,-542.8099999999686,0.0,0.0,1.06487,03.03.2017 06:00:00,14287,-0.21779475557642075,-23.53,IS,0.34,0.0,Phase3-EA-S4v1-EURCHF-M15-221,EURCHFMT4,3684,8h 45m,Sell
158784.05,120631,03.03.2017 15:29:58,tp 120.631,-2.33,-446.0099999999802,0.0,0.0,119371,27.02.2017 22:30:00,14288,-0.17895513887850395,96.8,IS,0.09,0.0,Phase3-EA-TR1v1-EURJPY-M30-91,EURJPYMT4,2546,3d 16h 59m,Buy
158829.1,114466,03.03.2017 19:15:00,,0.0,-400.95999999999185,0.0,0.0,114275,03.03.2017 17:45:00,14289,-0.16087947015700696,45.05,IS,0.27,0.0,Phase3-EA-S1v2-USDJPY-M15-0,USDJPYMT4,4146,1h 30m,Buy
158787.1,1.22587,03.03.2017 19:59:58,sl 1.22587,0.0,-442.95999999999185,0.0,0.0,1.22287,03.03.2017 14:00:00,14290,-0.17773136996395636,-42.0,IS,0.14,0.0,Phase3-EA-B1v1-GBPUSD-M30-14,GBPUSDMT4,938,5h 59m,Sell
158738.04,139772,06.03.2017 05:05:00,,-0.73,-492.0199999999895,0.0,0.0,140011,03.03.2017 23:40:00,14291,-0.19741599388131106,-49.06,IS,0.23,0.0,Phase3-EA-S4v1-GBPJPY-M5-194,GBPJPYMT4,3120,2d 5h 25m,Buy
158651.01,1.06982,06.03.2017 05:25:00,,-2.03,-579.0499999999884,0.0,0.0,1.06773,03.03.2017 21:05:00,14292,-0.2323355376955679,-87.03,IS,0.41,0.0,Phase3-EA-SA2v2-EURCHF-M5-43,EURCHFMT4,7260,2d 8h 20m,Sell
158629.15,1.00807,06.03.2017 06:30:00,,0.0,-600.9099999999744,0.0,0.0,1.00845,06.03.2017 02:15:00,14293,-0.24110655030936975,-21.86,IS,0.58,0.0,Phase3-EA-SA2v2-USDCHF-M15-107,USDCHFMT4,2816,4h 15m,Buy
158586.62,1.22415,06.03.2017 20:59:58,sl 1.22415,-0.53,-643.4399999999732,0.0,0.0,1.22715,03.03.2017 23:00:00,14294,-0.258171105042454,-42.53,IS,0.14,0.0,Phase3-EA-B1v1-GBPUSD-M30-14,GBPUSDMT4,940,2d 21h 59m,Buy
158640.93,1.01135,07.03.2017 00:14:58,tp 1.01135,-3.04,-589.1299999999756,0.0,0.0,1.01235,06.03.2017 22:00:00,14295,-0.2363799936492306,54.31,IS,0.58,0.0,Phase3-EA-SA2v2-USDCHF-M15-107,USDCHFMT4,2818,2h 14m,Sell
158671.0,114018,07.03.2017 04:45:00,,0.0,-559.0599999999686,0.0,0.0,113891,07.03.2017 00:30:00,14296,-0.2243148358588714,30.07,IS,0.27,0.0,Phase3-EA-S1v2-USDJPY-M15-0,USDJPYMT4,4148,4h 15m,Buy
158679.89,139462,07.03.2017 08:40:00,,0.0,-550.1699999999546,0.0,0.0,139506,07.03.2017 03:15:00,14297,-0.2207478503997282,8.89,IS,0.23,0.0,Phase3-EA-S4v1-GBPJPY-M5-194,GBPJPYMT4,3122,5h 25m,Sell
158696.91,1.07107,07.03.2017 10:25:00,,0.0,-533.1499999999651,0.0,0.0,1.07065,07.03.2017 02:05:00,14298,-0.213918818620821,17.02,IS,0.41,0.0,Phase3-EA-SA2v2-EURCHF-M5-43,EURCHFMT4,7262,8h 20m,Buy
158643.94,138932,07.03.2017 12:59:57,sl 138.932,0.0,-586.1199999999662,0.0,0.0,139602,07.03.2017 05:30:00,14299,-0.23517227416306216,-52.97,IS,0.09,0.0,Phase3-EA-B1v1-GBPJPY-M30-1,GBPJPYMT4,1314,7h 29m,Buy
158581.44,1.07073,08.03.2017 04:20:00,,-0.97,-648.6199999999662,0.0,0.0,1.07225,07.03.2017 20:00:00,14300,-0.2602495060186416,-62.5,IS,0.41,0.0,Phase3-EA-SA2v2-EURCHF-M5-43,EURCHFMT4,7264,8h 20m,Buy
158585.8,1.07092,08.03.2017 10:15:00,,0.0,-644.2599999999802,0.0,0.0,1.07079,08.03.2017 01:30:00,14301,-0.258500118324402,4.36,IS,0.34,0.0,Phase3-EA-S4v1-EURCHF-M15-221,EURCHFMT4,3686,8h 45m,Buy
158551.18,120744,08.03.2017 17:29:58,sl 120.744,-0.52,-678.8799999999756,0.0,0.0,120514,07.03.2017 01:00:00,14302,-0.2723908985938427,-34.62,IS,0.17,0.0,Phase3-EA-T1v2-EURJPY-M15-322,EURJPYMT4,2766,1d 16h 29m,Sell
158498.09,139607,08.03.2017 18:29:58,sl 139.607,-0.46,-731.9699999999721,0.0,0.0,138937,07.03.2017 14:30:00,14303,-0.2936925024212447,-53.09,IS,0.09,0.0,Phase3-EA-B1v1-GBPJPY-M30-1,GBPJPYMT4,1316,1d 3h 59m,Sell
158542.55,1.06985,08.03.2017 21:09:58,tp 1.06985,0.0,-687.5099999999802,0.0,0.0,1.07095,08.03.2017 20:05:00,14304,-0.27585356276846296,44.46,IS,0.41,0.0,Phase3-EA-SA2v2-EURCHF-M5-43,EURCHFMT4,7266,1h 4m,Sell
158525.88,114489,09.03.2017 04:15:00,,-2.05,-704.179999999993,0.0,0.0,114551,08.03.2017 22:15:00,14305,-0.28254216204898824,-16.67,IS,0.27,0.0,Phase3-EA-S1v2-USDJPY-M15-0,USDJPYMT4,4150,6h 0m,Buy
158520.95,1.06964,09.03.2017 05:50:00,,-2.91,-709.109999999986,0.0,0.0,1.06969,08.03.2017 21:30:00,14306,-0.28452025409775356,-4.93,IS,0.41,0.0,Phase3-EA-SA2v2-EURCHF-M5-43,EURCHFMT4,7268,8h 20m,Buy
158532.34,1.06998,09.03.2017 11:15:00,,0.0,-697.7199999999721,0.0,0.0,1.06964,09.03.2017 02:30:00,14307,-0.27995017936438715,11.39,IS,0.34,0.0,Phase3-EA-S4v1-EURCHF-M15-221,EURCHFMT4,3688,8h 45m,Buy
158474.96,121131,09.03.2017 12:59:58,sl 121.131,-0.83,-755.0999999999767,0.0,0.0,120713,06.03.2017 05:00:00,14308,-0.30297308438635945,-57.38,IS,0.09,0.0,Phase3-EA-TR1v1-EURJPY-M30-91,EURJPYMT4,2548,3d 7h 59m,Sell
158412.27,121493,09.03.2017 17:59:58,sl 121.493,-1.39,-817.789999999979,0.0,0.0,120411,08.03.2017 04:30:00,14309,-0.3281265510267808,-62.69,IS,0.09,0.0,Phase3-EA-TR1v1-EURJPY-M30-91,EURJPYMT4,2549,1d 13h 29m,Sell
158444.95,114944,10.03.2017 00:15:00,,-0.68,-785.109999999986,0.0,0.0,114802,09.03.2017 23:45:00,14310,-0.3150141680341382,32.68,IS,0.27,0.0,Phase3-EA-S1v2-USDJPY-M15-0,USDJPYMT4,4152,30m 0s,Buy
158522.86,140078,10.03.2017 04:14:57,tp 140.078,0.0,-707.1999999999825,0.0,0.0,139688,10.03.2017 02:25:00,14311,-0.28375389389224565,77.91,IS,0.23,0.0,Phase3-EA-S4v1-GBPJPY-M5-194,GBPJPYMT4,3124,1h 49m,Buy
158492.33,1.07169,10.03.2017 05:15:00,,-0.97,-737.7299999999814,0.0,0.0,1.07242,09.03.2017 20:55:00,14312,-0.2960036201090587,-30.53,IS,0.41,0.0,Phase3-EA-SA2v2-EURCHF-M5-43,EURCHFMT4,7270,8h 20m,Buy
158430.47,1.01254,10.03.2017 05:30:00,,0.0,-799.5899999999674,0.0,0.0,1.01146,10.03.2017 01:15:00,14313,-0.3208240611104314,-61.86,IS,0.58,0.0,Phase3-EA-SA2v2-USDCHF-M15-107,USDCHFMT4,2820,4h 15m,Sell
158315.16,1.07943,13.03.2017 04:20:00,,-2.03,-914.8999999999651,0.0,0.0,1.07664,10.03.2017 20:00:00,14314,-0.3670905507947003,-115.31,IS,0.41,0.0,Phase3-EA-SA2v2-EURCHF-M5-43,EURCHFMT4,7272,2d 8h 20m,Sell
158286.09,122481,13.03.2017 12:15:00,,0.0,-943.9699999999721,0.0,0.0,122677,13.03.2017 03:00:00,14315,-0.37875447287537023,-29.07,IS,0.17,0.0,Phase3-EA-T1v2-EURJPY-M15-322,EURJPYMT4,2768,9h 15m,Buy
158242.77,1.07317,14.03.2017 04:20:00,,-0.98,-987.289999999979,0.0,0.0,1.07421,13.03.2017 20:00:00,14316,-0.3961360038191123,-43.32,IS,0.41,0.0,Phase3-EA-SA2v2-EURCHF-M5-43,EURCHFMT4,7274,8h 20m,Buy
158234.76,140189,14.03.2017 09:05:00,,0.0,-995.2999999999884,0.0,0.0,140229,14.03.2017 03:40:00,14317,-0.39934990185372704,-8.01,IS,0.23,0.0,Phase3-EA-S4v1-GBPJPY-M5-194,GBPJPYMT4,3126,5h 25m,Buy
158200.78,122552,14.03.2017 11:29:58,sl 122.552,0.0,-1029.2799999999988,0.0,0.0,122322,14.03.2017 06:00:00,14318,-0.4129838912689727,-33.98,IS,0.17,0.0,Phase3-EA-T1v2-EURJPY-M15-322,EURJPYMT4,2770,5h 29m,Sell
158229.79,1.07256,14.03.2017 14:45:00,,0.0,-1000.2699999999895,0.0,0.0,1.07342,14.03.2017 06:00:00,14319,-0.4013440433308832,29.01,IS,0.34,0.0,Phase3-EA-S4v1-EURCHF-M15-221,EURCHFMT4,3690,8h 45m,Sell
158229.91,114651,15.03.2017 03:45:00,,-1.06,-1000.1499999999942,0.0,0.0,114656,14.03.2017 22:15:00,14320,-0.4012958950457224,0.12,IS,0.27,0.0,Phase3-EA-S1v2-USDJPY-M15-0,USDJPYMT4,4154,5h 30m,Sell
158202.94,1.07132,15.03.2017 04:50:00,,-0.97,-1027.1199999999953,0.0,0.0,1.07196,14.03.2017 20:30:00,14321,-0.41211722213604246,-26.97,IS,0.41,0.0,Phase3-EA-SA2v2-EURCHF-M5-43,EURCHFMT4,7276,8h 20m,Buy
158247.63,1.07122,15.03.2017 22:04:58,tp 1.07122,0.0,-982.429999999993,0.0,0.0,1.07232,15.03.2017 20:55:00,14322,-0.39418599827002804,44.69,IS,0.41,0.0,Phase3-EA-SA2v2-EURCHF-M5-43,EURCHFMT4,7278,1h 9m,Sell
158189.93,121317,15.03.2017 22:29:58,sl 121.317,-1.14,-1040.1300000000047,0.0,0.0,122037,10.03.2017 08:00:00,14323,-0.41733729871910363,-57.7,IS,0.09,0.0,Phase3-EA-TR1v1-EURJPY-M30-91,EURJPYMT4,2552,5d 14h 29m,Buy
158232.1,1.0719,16.03.2017 00:04:57,tp 1.07190,-2.95,-997.9599999999919,0.0,0.0,1.0708,15.03.2017 23:20:00,14324,-0.4004171888415019,42.17,IS,0.41,0.0,Phase3-EA-SA2v2-EURCHF-M5-43,EURCHFMT4,7280,44m 57s,Buy
158277.22,1.07201,16.03.2017 08:19:58,tp 1.07201,0.0,-952.8399999999965,0.0,0.0,1.07311,16.03.2017 00:20:00,14325,-0.3823134336203239,45.12,IS,0.41,0.0,Phase3-EA-SA2v2-EURCHF-M5-43,EURCHFMT4,7282,7h 59m,Sell
158344.29,1.07191,16.03.2017 11:15:00,,0.0,-885.7699999999895,0.0,0.0,1.07388,16.03.2017 02:30:00,14326,-0.35540255457146164,67.07,IS,0.34,0.0,Phase3-EA-S4v1-EURCHF-M15-221,EURCHFMT4,3692,8h 45m,Sell
158607.29,1.23648,16.03.2017 16:59:58,tp 1.23648,-1.6,-622.7699999999895,0.0,0.0,1.21758,15.03.2017 10:00:00,14327,-0.24987756292318328,263.0,IS,0.14,0.0,Phase3-EA-B1v1-GBPUSD-M30-14,GBPUSDMT4,942,1d 6h 59m,Buy
158665.51,0.99628,16.03.2017 22:59:58,tp 0.99628,0.0,-564.5499999999884,0.0,0.0,0.99728,16.03.2017 22:00:00,14328,-0.22651761990507344,58.22,IS,0.58,0.0,Phase3-EA-SA2v2-USDCHF-M15-107,USDCHFMT4,2822,59m 58s,Sell
158608.09,122167,17.03.2017 05:29:58,sl 122.167,-0.28,-621.9700000000012,0.0,0.0,121447,16.03.2017 12:00:00,14329,-0.24955657435543654,-57.42,IS,0.09,0.0,Phase3-EA-TR1v1-EURJPY-M30-91,EURJPYMT4,2554,17h 29m,Sell
158447.19,1.07339,17.03.2017 07:10:00,,-2.06,-782.8699999999953,0.0,0.0,1.06953,16.03.2017 22:50:00,14330,-0.31411540004443794,-160.9,IS,0.41,0.0,Phase3-EA-SA2v2-EURCHF-M5-43,EURCHFMT4,7284,8h 20m,Sell
158409.69,113388,17.03.2017 10:00:00,,-1.07,-820.3699999999953,0.0,0.0,113235,16.03.2017 21:45:00,14331,-0.3291617391577856,-37.5,IS,0.27,0.0,Phase3-EA-S1v2-USDJPY-M15-0,USDJPYMT4,4156,12h 15m,Sell
158362.62,1.07379,17.03.2017 10:15:00,,0.0,-867.4400000000023,0.0,0.0,1.07241,17.03.2017 01:30:00,14332,-0.34804790401286245,-47.07,IS,0.34,0.0,Phase3-EA-S4v1-EURCHF-M15-221,EURCHFMT4,3694,8h 45m,Sell
158305.36,121472,17.03.2017 15:59:58,sl 121.472,0.0,-924.7000000000116,0.0,0.0,122192,17.03.2017 05:30:00,14333,-0.3710226607496738,-57.26,IS,0.09,0.0,Phase3-EA-TR1v1-EURJPY-M30-91,EURJPYMT4,2556,10h 29m,Buy
158350.61,1.07085,17.03.2017 21:54:58,tp 1.07085,0.0,-879.4500000000116,0.0,0.0,1.07195,17.03.2017 20:20:00,14334,-0.3528667448862343,45.25,IS,0.41,0.0,Phase3-EA-SA2v2-EURCHF-M5-43,EURCHFMT4,7286,1h 34m,Sell
158408.75,0.99757,17.03.2017 22:59:58,tp 0.99757,0.0,-821.3099999999977,0.0,0.0,0.99657,17.03.2017 22:00:00,14335,-0.3295389007248945,58.14,IS,0.58,0.0,Phase3-EA-SA2v2-USDCHF-M15-107,USDCHFMT4,2824,59m 58s,Buy
158425.17,112648,20.03.2017 02:15:00,,-1.08,-804.8899999999849,0.0,0.0,112721,17.03.2017 23:45:00,14336,-0.3229506103717915,16.42,IS,0.27,0.0,Phase3-EA-S1v2-USDJPY-M15-0,USDJPYMT4,4158,2d 2h 30m,Sell
158468.3,1.07095,21.03.2017 01:04:57,tp 1.07095,-2.05,-761.7599999999802,0.0,0.0,1.07205,20.03.2017 20:35:00,14337,-0.3056453142128914,43.13,IS,0.41,0.0,Phase3-EA-SA2v2-EURCHF-M5-43,EURCHFMT4,7288,4h 29m,Sell
158410.33,121742,21.03.2017 12:29:58,sl 121.742,-0.56,-819.7299999999814,0.0,0.0,121022,17.03.2017 20:00:00,14338,-0.3289049483035789,-57.97,IS,0.09,0.0,Phase3-EA-TR1v1-EURJPY-M30-91,EURJPYMT4,2558,3d 16h 29m,Sell
158455.68,1.07434,21.03.2017 22:59:58,tp 1.07434,0.0,-774.3799999999756,0.0,0.0,1.07324,21.03.2017 21:00:00,14339,-0.31070890886916813,45.35,IS,0.41,0.0,Phase3-EA-SA2v2-EURCHF-M5-43,EURCHFMT4,7290,1h 59m,Buy
158510.97,0.99341,22.03.2017 01:14:57,tp 0.99341,-3.09,-719.0899999999674,0.0,0.0,0.99441,21.03.2017 22:45:00,14340,-0.28852458648044504,55.29,IS,0.58,0.0,Phase3-EA-SA2v2-USDCHF-M15-107,USDCHFMT4,2826,2h 29m,Sell
158765.34,120542,22.03.2017 02:44:58,tp 120.542,-4.22,-464.71999999997206,0.0,0.0,122242,14.03.2017 15:30:00,14341,-0.18646225900678695,254.37,IS,0.17,0.0,Phase3-EA-T1v2-EURJPY-M15-322,EURJPYMT4,2772,7d 11h 14m,Sell
158808.64,1.07331,22.03.2017 06:09:58,tp 1.07331,-2.06,-421.4199999999837,0.0,0.0,1.07441,21.03.2017 23:05:00,14342,-0.16908875277724617,43.3,IS,0.41,0.0,Phase3-EA-SA2v2-EURCHF-M5-43,EURCHFMT4,7292,7h 4m,Sell
158819.56,139229,22.03.2017 08:15:00,,0.0,-410.4999999999709,0.0,0.0,139176,22.03.2017 02:50:00,14343,-0.1647072588274342,10.92,IS,0.23,0.0,Phase3-EA-S4v1-GBPJPY-M5-194,GBPJPYMT4,3128,5h 25m,Buy
158757.28,1.07178,22.03.2017 14:45:00,,0.0,-472.77999999996973,0.0,0.0,1.0736,22.03.2017 06:00:00,14344,-0.18969621882688154,-62.28,IS,0.34,0.0,Phase3-EA-S4v1-EURCHF-M15-221,EURCHFMT4,3696,8h 45m,Buy
158790.82,111096,22.03.2017 17:15:00,,0.0,-439.2399999999616,0.0,0.0,111234,22.03.2017 17:00:00,14345,-0.17623877312390013,33.54,IS,0.27,0.0,Phase3-EA-S1v2-USDJPY-M15-0,USDJPYMT4,4160,15m 0s,Sell
158830.11,1.07024,23.03.2017 00:59:59,tp 1.07024,-6.2,-399.94999999995343,0.0,0.0,1.07134,22.03.2017 21:55:00,14346,-0.16047422209020537,39.29,IS,0.41,0.0,Phase3-EA-SA2v2-EURCHF-M5-43,EURCHFMT4,7294,3h 4m,Sell
158774.45,138864,23.03.2017 01:59:58,sl 138.864,-1.41,-455.6099999999569,0.0,0.0,138194,22.03.2017 17:30:00,14347,-0.18280700169151162,-55.66,IS,0.09,0.0,Phase3-EA-B1v1-GBPJPY-M30-1,GBPJPYMT4,1318,8h 29m,Sell
158747.02,0.9917,23.03.2017 02:45:00,,-9.3,-483.03999999994994,0.0,0.0,0.99139,22.03.2017 22:30:00,14348,-0.19381289720828554,-27.43,IS,0.58,0.0,Phase3-EA-SA2v2-USDCHF-M15-107,USDCHFMT4,2828,4h 15m,Sell
158766.02,1.0707,23.03.2017 09:25:00,,0.0,-464.03999999994994,0.0,0.0,1.07024,23.03.2017 01:05:00,14349,-0.18618941872418937,19.0,IS,0.41,0.0,Phase3-EA-SA2v2-EURCHF-M5-43,EURCHFMT4,7296,8h 20m,Buy
158688.24,111265,23.03.2017 10:45:00,,-3.28,-541.8199999999488,0.0,0.0,110958,22.03.2017 23:15:00,14350,-0.21739753222382044,-77.78,IS,0.27,0.0,Phase3-EA-S1v2-USDJPY-M15-0,USDJPYMT4,4162,11h 30m,Sell
158623.59,119.36,23.03.2017 17:29:58,sl 119.360,-1.19,-606.469999999943,0.0,0.0,120.14,22.03.2017 15:30:00,14351,-0.2433374208552295,-64.65,IS,0.09,0.0,Phase3-EA-TR1v1-EURJPY-M30-91,EURJPYMT4,2560,1d 1h 59m,Buy
158703.32,111105,24.03.2017 04:15:00,,-0.71,-526.7399999999325,0.0,0.0,110774,23.03.2017 23:45:00,14352,-0.21134689772169968,79.73,IS,0.27,0.0,Phase3-EA-S1v2-USDJPY-M15-0,USDJPYMT4,4164,4h 30m,Buy
158754.84,139005,24.03.2017 05:05:00,,-0.75,-475.21999999994296,0.0,0.0,138752,23.03.2017 23:40:00,14353,-0.19067523395851263,51.52,IS,0.23,0.0,Phase3-EA-S4v1-GBPJPY-M5-194,GBPJPYMT4,3130,5h 25m,Buy
158733.0,1.07104,24.03.2017 05:30:00,,-2.06,-497.05999999993946,0.0,0.0,1.07056,23.03.2017 21:10:00,14354,-0.1994382218581249,-21.84,IS,0.41,0.0,Phase3-EA-SA2v2-EURCHF-M5-43,EURCHFMT4,7298,8h 20m,Sell
158743.29,1.07076,24.03.2017 14:45:00,,0.0,-486.7699999999313,0.0,0.0,1.07106,24.03.2017 06:00:00,14355,-0.19530950640541903,10.29,IS,0.34,0.0,Phase3-EA-S4v1-EURCHF-M15-221,EURCHFMT4,3698,8h 45m,Sell
158785.14,110964,24.03.2017 19:45:00,,0.0,-444.9199999999255,0.0,0.0,111136,24.03.2017 17:15:00,14356,-0.1785177919549207,41.85,IS,0.27,0.0,Phase3-EA-S1v2-USDJPY-M15-0,USDJPYMT4,4166,2h 30m,Sell
158865.99,138783,24.03.2017 23:44:58,tp 138.783,0.0,-364.0699999999197,0.0,0.0,138393,24.03.2017 23:25:00,14357,-0.14607788482654077,80.85,IS,0.23,0.0,Phase3-EA-S4v1-GBPJPY-M5-194,GBPJPYMT4,3132,19m 58s,Buy
158829.63,120222,27.03.2017 02:14:58,sl 120.222,-1.08,-400.4299999999057,0.0,0.0,119992,23.03.2017 11:30:00,14358,-0.16066681523083706,-36.36,IS,0.17,0.0,Phase3-EA-T1v2-EURJPY-M15-322,EURJPYMT4,2774,3d 14h 44m,Sell
158874.29,1072,27.03.2017 04:04:58,tp 1.07200,-0.99,-355.7699999999022,0.0,0.0,1.0709,24.03.2017 20:00:00,14359,-0.14274762843611283,44.66,IS,0.41,0.0,Phase3-EA-SA2v2-EURCHF-M5-43,EURCHFMT4,7300,2d 8h 4m,Buy
158937.83,1.06962,27.03.2017 12:00:00,,0.0,-292.22999999989406,0.0,0.0,1.07146,27.03.2017 03:15:00,14360,-0.11725311144245325,63.54,IS,0.34,0.0,Phase3-EA-S4v1-EURCHF-M15-221,EURCHFMT4,3700,8h 45m,Sell
158883.2,138848,27.03.2017 15:29:59,sl 138.848,0.0,-346.8599999998987,0.0,0.0,138178,27.03.2017 05:30:00,14361,-0.13917261826278002,-54.63,IS,0.09,0.0,Phase3-EA-B1v1-GBPJPY-M30-1,GBPJPYMT4,1320,9h 59m,Sell
158885.55,0.98545,28.03.2017 05:15:00,,0.0,-344.5099999998929,0.0,0.0,0.98549,28.03.2017 01:00:00,14362,-0.1382297143450079,2.35,IS,0.58,0.0,Phase3-EA-SA2v2-USDCHF-M15-107,USDCHFMT4,2830,4h 15m,Sell
158879.31,1.07054,28.03.2017 07:00:00,,-2.08,-350.7499999998836,0.0,0.0,1.07044,27.03.2017 22:40:00,14363,-0.1407334251734652,-6.24,IS,0.41,0.0,Phase3-EA-SA2v2-EURCHF-M5-43,EURCHFMT4,7302,8h 20m,Sell
158880.69,1.07071,28.03.2017 12:00:00,,0.0,-349.3699999998789,0.0,0.0,1.07075,28.03.2017 03:15:00,14364,-0.14017971989409214,1.38,IS,0.34,0.0,Phase3-EA-S4v1-EURCHF-M15-221,EURCHFMT4,3702,8h 45m,Sell
158845.33,119971,28.03.2017 16:14:57,sl 119.971,0.0,-384.72999999986496,0.0,0.0,120201,28.03.2017 15:15:00,14365,-0.15436741458869918,-35.36,IS,0.17,0.0,Phase3-EA-T1v2-EURJPY-M15-322,EURJPYMT4,2776,59m 57s,Buy
158617.23,0.99167,28.03.2017 23:14:58,sl 0.99167,0.0,-612.8299999998708,0.0,0.0,0.98777,28.03.2017 22:15:00,14366,-0.2458892799688243,-228.1,IS,0.58,0.0,Phase3-EA-SA2v2-USDCHF-M15-107,USDCHFMT4,2832,59m 58s,Sell
158573.64,1.24531,28.03.2017 23:29:58,sl 1.24531,-1.59,-656.4199999998673,0.0,0.0,1.24831,23.03.2017 06:00:00,14367,-0.2633791445541782,-43.59,IS,0.14,0.0,Phase3-EA-B1v1-GBPUSD-M30-14,GBPUSDMT4,944,5d 17h 29m,Buy
158406.82,111108,29.03.2017 05:45:00,,-1.09,-823.2399999998743,0.0,0.0,110426,28.03.2017 20:15:00,14368,-0.33031328564454526,-166.82,IS,0.27,0.0,Phase3-EA-S1v2-USDJPY-M15-0,USDJPYMT4,4168,9h 30m,Sell
158275.0,1.0731,29.03.2017 06:10:00,,-2.07,-955.0599999998813,0.0,0.0,1.06996,28.03.2017 21:50:00,14369,-0.38320417689578784,-131.82,IS,0.41,0.0,Phase3-EA-SA2v2-EURCHF-M5-43,EURCHFMT4,7304,8h 20m,Sell
158282.2,1.07246,29.03.2017 11:00:00,,0.0,-947.8599999998696,0.0,0.0,1.07267,29.03.2017 02:15:00,14370,-0.38031527978602037,7.2,IS,0.34,0.0,Phase3-EA-S4v1-EURCHF-M15-221,EURCHFMT4,3704,8h 45m,Sell
158288.37,1.07203,30.03.2017 05:45:00,,-6.17,-941.6899999998568,0.0,0.0,1.07233,29.03.2017 21:25:00,14371,-0.37783965545723247,6.17,IS,0.41,0.0,Phase3-EA-SA2v2-EURCHF-M5-43,EURCHFMT4,7306,8h 20m,Sell
158224.28,138443,30.03.2017 08:55:00,,0.0,-1005.7799999998533,0.0,0.0,138133,30.03.2017 03:30:00,14372,-0.40355485209121644,-64.09,IS,0.23,0.0,Phase3-EA-S4v1-GBPJPY-M5-194,GBPJPYMT4,3134,5h 25m,Sell
158166.84,111165,30.03.2017 10:45:00,,-3.28,-1063.2199999998556,0.0,0.0,110942,29.03.2017 19:45:00,14373,-0.4266018312557691,-57.44,IS,0.27,0.0,Phase3-EA-S1v2-USDJPY-M15-0,USDJPYMT4,4170,15h 0m,Sell
158131.31,119449,31.03.2017 00:44:58,sl 119.449,-0.53,-1098.7499999998545,0.0,0.0,119219,30.03.2017 22:00:00,14374,-0.44085773602102846,-35.53,IS,0.17,0.0,Phase3-EA-T1v2-EURJPY-M15-322,EURJPYMT4,2778,2h 44m,Sell
158116.81,1.06897,31.03.2017 04:20:00,,-0.98,-1113.2499999998545,0.0,0.0,1.0693,30.03.2017 20:00:00,14375,-0.4466756538115229,-14.5,IS,0.41,0.0,Phase3-EA-SA2v2-EURCHF-M5-43,EURCHFMT4,7308,8h 20m,Buy
157966.3,139.98,31.03.2017 04:55:00,,-1.2,-1263.7599999998638,0.0,0.0,139252,30.03.2017 23:30:00,14376,-0.5070656404768589,-150.51,IS,0.23,0.0,Phase3-EA-S4v1-GBPJPY-M5-194,GBPJPYMT4,3136,5h 25m,Sell
157946.6,1.00083,31.03.2017 05:30:00,,0.0,-1283.4599999998754,0.0,0.0,1.00049,31.03.2017 01:15:00,14377,-0.5149699839577422,-19.7,IS,0.58,0.0,Phase3-EA-SA2v2-USDCHF-M15-107,USDCHFMT4,2834,4h 15m,Sell
157892.63,139251,31.03.2017 10:59:58,sl 139.251,0.0,-1337.4299999998766,0.0,0.0,139921,31.03.2017 05:00:00,14378,-0.5366246752096726,-53.97,IS,0.09,0.0,Phase3-EA-B1v1-GBPJPY-M30-1,GBPJPYMT4,1322,5h 59m,Buy
157857.66,119425,31.03.2017 14:44:58,sl 119.425,0.0,-1372.3999999998778,0.0,0.0,119655,31.03.2017 12:45:00,14379,-0.5506558879775069,-34.97,IS,0.17,0.0,Phase3-EA-T1v2-EURJPY-M15-322,EURJPYMT4,2780,1h 59m,Buy
157959.61,118717,03.04.2017 01:29:58,tp 118.717,-2.25,-1270.4499999998661,0.0,0.0,120007,24.03.2017 20:30:00,14380,-0.5097499073746811,101.95,IS,0.09,0.0,Phase3-EA-TR1v1-EURJPY-M30-91,EURJPYMT4,2562,9d 4h 59m,Sell
157980.24,111.27,03.04.2017 04:00:00,,0.0,-1249.8199999998615,0.0,0.0,111355,03.04.2017 01:00:00,14381,-0.5014724146837894,20.63,IS,0.27,0.0,Phase3-EA-S1v2-USDJPY-M15-0,USDJPYMT4,4172,3h 0m,Sell
157975.61,1.00145,03.04.2017 05:15:00,,0.0,-1254.4499999998661,0.0,0.0,1.00137,03.04.2017 01:00:00,14382,-0.5033301360196527,-4.63,IS,0.58,0.0,Phase3-EA-SA2v2-USDCHF-M15-107,USDCHFMT4,2836,4h 15m,Sell
157969.31,1.06917,03.04.2017 06:50:00,,-0.98,-1260.7499999998545,0.0,0.0,1.0693,31.03.2017 22:30:00,14383,-0.5058579209906904,-6.3,IS,0.41,0.0,Phase3-EA-SA2v2-EURCHF-M5-43,EURCHFMT4,7310,2d 8h 20m,Buy
158069.86,118539,03.04.2017 18:59:58,tp 118.539,-1.41,-1160.1999999998661,0.0,0.0,119799,29.03.2017 15:30:00,14384,-0.46551367038143887,100.55,IS,0.09,0.0,Phase3-EA-TR1v1-EURJPY-M30-91,EURJPYMT4,2563,5d 3h 29m,Sell
158069.04,1.06878,04.04.2017 06:30:00,,-2.05,-1161.019999999873,0.0,0.0,1.06881,03.04.2017 22:10:00,14385,-0.4658426836633869,-0.82,IS,0.41,0.0,Phase3-EA-SA2v2-EURCHF-M5-43,EURCHFMT4,7312,8h 20m,Sell
158025.45,1.24195,04.04.2017 11:59:57,sl 1.24195,-1.59,-1204.6099999998696,0.0,0.0,1.24495,30.03.2017 16:00:00,14386,-0.4833325482487408,-43.59,IS,0.14,0.0,Phase3-EA-B1v1-GBPUSD-M30-14,GBPUSDMT4,946,4d 19h 59m,Buy
158065.78,1.06755,04.04.2017 15:00:00,,0.0,-1164.2799999998824,0.0,0.0,1.06874,04.04.2017 06:15:00,14387,-0.4671507120769776,40.33,IS,0.34,0.0,Phase3-EA-S4v1-EURCHF-M15-221,EURCHFMT4,3706,8h 45m,Sell
158115.25,110841,05.04.2017 02:45:00,,-0.71,-1114.8099999998813,0.0,0.0,110635,04.04.2017 23:00:00,14388,-0.4473015815186489,49.47,IS,0.27,0.0,Phase3-EA-S1v2-USDJPY-M15-0,USDJPYMT4,4174,3h 45m,Buy
158075.14,1.06984,05.04.2017 07:30:00,,-2.05,-1154.9199999998673,0.0,0.0,1.06891,04.04.2017 23:10:00,14389,-0.46339514583428,-40.11,IS,0.41,0.0,Phase3-EA-SA2v2-EURCHF-M5-43,EURCHFMT4,7314,8h 20m,Sell
158125.66,137698,05.04.2017 09:20:00,,0.0,-1104.3999999998778,0.0,0.0,137941,05.04.2017 03:55:00,14390,-0.4431247177807822,50.52,IS,0.23,0.0,Phase3-EA-S4v1-GBPJPY-M5-194,GBPJPYMT4,3138,5h 25m,Sell
158127.02,1.06948,05.04.2017 11:45:00,,0.0,-1103.0399999998917,0.0,0.0,1.06952,05.04.2017 03:00:00,14391,-0.44257903721561037,1.36,IS,0.34,0.0,Phase3-EA-S4v1-EURCHF-M15-221,EURCHFMT4,3708,8h 45m,Sell
158072.19,138451,05.04.2017 13:59:57,sl 138.451,-0.47,-1157.869999999879,0.0,0.0,137781,04.04.2017 08:30:00,14392,-0.464578791177868,-54.83,IS,0.09,0.0,Phase3-EA-B1v1-GBPJPY-M30-1,GBPJPYMT4,1324,1d 5h 29m,Sell
158013.48,118615,05.04.2017 16:29:58,sl 118.615,-0.28,-1216.5799999998708,0.0,0.0,117895,04.04.2017 08:30:00,14393,-0.48813533969372186,-58.71,IS,0.09,0.0,Phase3-EA-TR1v1-EURJPY-M30-91,EURJPYMT4,2566,1d 7h 59m,Sell
158002.8,111266,05.04.2017 22:30:00,,0.0,-1227.2599999998638,0.0,0.0,111.31,05.04.2017 22:15:00,14394,-0.49242053707320044,-10.68,IS,0.27,0.0,Phase3-EA-S1v2-USDJPY-M15-0,USDJPYMT4,4176,15m 0s,Buy
158041.58,1.07062,06.04.2017 01:04:57,tp 1.07062,-6.13,-1188.479999999865,0.0,0.0,1.07172,05.04.2017 20:10:00,14395,-0.476860616251451,38.78,IS,0.41,0.0,Phase3-EA-SA2v2-EURCHF-M5-43,EURCHFMT4,7316,4h 54m,Sell
157836.54,110438,06.04.2017 02:29:58,sl 110.438,-2.12,-1393.519999999873,0.0,0.0,111268,05.04.2017 22:30:00,14396,-0.5591299861661424,-205.04,IS,0.27,0.0,Phase3-EA-S1v2-USDJPY-M15-0,USDJPYMT4,4178,3h 59m,Buy
157747.49,137.94,06.04.2017 04:55:00,,-2.24,-1482.5699999998615,0.0,0.0,138357,05.04.2017 23:30:00,14397,-0.5948600261139674,-89.05,IS,0.23,0.0,Phase3-EA-S4v1-GBPJPY-M5-194,GBPJPYMT4,3140,5h 25m,Buy
157724.16,1.07056,06.04.2017 11:15:00,,0.0,-1505.8999999998487,0.0,0.0,1.07125,06.04.2017 02:30:00,14398,-0.604220855221013,-23.33,IS,0.34,0.0,Phase3-EA-S4v1-EURCHF-M15-221,EURCHFMT4,3710,8h 45m,Buy
157741.7,110844,06.04.2017 18:45:00,,0.0,-1488.3599999998405,0.0,0.0,110772,06.04.2017 17:30:00,14399,-0.5971831808730599,17.54,IS,0.27,0.0,Phase3-EA-S1v2-USDJPY-M15-0,USDJPYMT4,4180,1h 15m,Buy
157758.5,110921,06.04.2017 19:15:00,,0.0,-1471.5599999998522,0.0,0.0,110852,06.04.2017 19:00:00,14400,-0.5904424209502848,16.8,IS,0.27,0.0,Phase3-EA-S1v2-USDJPY-M15-0,USDJPYMT4,4182,15m 0s,Buy
157758.5,1.06963,07.04.2017 09:10:00,,0.0,-1471.5599999998522,0.0,0.0,1.06963,07.04.2017 00:50:00,14401,-0.5904424209502848,0.0,IS,0.41,0.0,Phase3-EA-SA2v2-EURCHF-M5-43,EURCHFMT4,7318,8h 20m,Buy
157751.73,1.0694,07.04.2017 10:00:00,,0.0,-1478.3299999998417,0.0,0.0,1.0696,07.04.2017 01:15:00,14402,-0.593158786704877,-6.77,IS,0.34,0.0,Phase3-EA-S4v1-EURCHF-M15-221,EURCHFMT4,3712,8h 45m,Buy
157814.57,111277,10.04.2017 03:15:00,,0.0,-1415.4899999998452,0.0,0.0,111018,10.04.2017 01:00:00,14403,-0.5679451347080046,62.84,IS,0.27,0.0,Phase3-EA-S1v2-USDJPY-M15-0,USDJPYMT4,4184,2h 15m,Buy
157828.61,1.06838,10.04.2017 05:10:00,,-0.98,-1401.449999999837,0.0,0.0,1.06801,07.04.2017 20:50:00,14404,-0.5623117853439639,14.04,IS,0.41,0.0,Phase3-EA-SA2v2-EURCHF-M5-43,EURCHFMT4,7320,2d 8h 20m,Buy
157797.6,1.01003,10.04.2017 06:30:00,,0.0,-1432.4599999998463,0.0,0.0,1.00949,10.04.2017 02:15:00,14405,-0.574754104701432,-31.01,IS,0.58,0.0,Phase3-EA-SA2v2-USDCHF-M15-107,USDCHFMT4,2838,4h 15m,Sell
157741.25,137969,10.04.2017 08:05:00,,0.0,-1488.8099999998522,0.0,0.0,137696,10.04.2017 02:40:00,14406,-0.5973637369424247,-56.35,IS,0.23,0.0,Phase3-EA-S4v1-GBPJPY-M5-194,GBPJPYMT4,3142,5h 25m,Sell
157775.47,110847,11.04.2017 01:45:00,,-1.1,-1454.589999999851,0.0,0.0,110992,10.04.2017 23:30:00,14407,-0.5836334509568574,34.22,IS,0.27,0.0,Phase3-EA-S1v2-USDJPY-M15-0,USDJPYMT4,4186,2h 15m,Sell
157829.98,1.00768,11.04.2017 03:14:58,tp 1.00768,-3.05,-1400.0799999998417,0.0,0.0,1.00868,10.04.2017 23:15:00,14408,-0.5617620924216915,54.51,IS,0.58,0.0,Phase3-EA-SA2v2-USDCHF-M15-107,USDCHFMT4,2840,3h 59m,Sell
157933.18,117243,11.04.2017 04:29:57,tp 117.243,-1.69,-1296.87999999983,0.0,0.0,118533,05.04.2017 20:30:00,14409,-0.520354567181754,103.2,IS,0.09,0.0,Phase3-EA-TR1v1-EURJPY-M30-91,EURJPYMT4,2568,5d 7h 59m,Sell
158189.84,117118,11.04.2017 06:44:58,tp 117.118,-4.31,-1040.2199999998265,0.0,0.0,118818,03.04.2017 12:45:00,14410,-0.4173734099329042,256.66,IS,0.17,0.0,Phase3-EA-T1v2-EURJPY-M15-322,EURJPYMT4,2782,7d 17h 59m,Sell
158189.84,1.06807,11.04.2017 09:25:00,,0.0,-1040.2199999998265,0.0,0.0,1.06807,11.04.2017 01:05:00,14411,-0.4173734099329042,0.0,IS,0.41,0.0,Phase3-EA-SA2v2-EURCHF-M5-43,EURCHFMT4,7322,8h 20m,Buy
158181.41,1.06797,11.04.2017 10:00:00,,0.0,-1048.6499999998196,0.0,0.0,1.06822,11.04.2017 01:15:00,14412,-0.42075582696558195,-8.43,IS,0.34,0.0,Phase3-EA-S4v1-EURCHF-M15-221,EURCHFMT4,3714,8h 45m,Buy
158283.45,116651,11.04.2017 18:59:58,tp 116.651,-0.84,-946.6099999998114,0.0,0.0,117911,06.04.2017 03:30:00,14413,-0.37981373514888545,102.04,IS,0.09,0.0,Phase3-EA-TR1v1-EURJPY-M30-91,EURJPYMT4,2569,5d 15h 29m,Sell
158301.17,109684,12.04.2017 04:30:00,,0.0,-928.8899999998102,0.0,0.0,109612,12.04.2017 01:00:00,14414,-0.3727038383731911,17.72,IS,0.27,0.0,Phase3-EA-S1v2-USDJPY-M15-0,USDJPYMT4,4188,3h 30m,Buy
158282.28,1.06828,12.04.2017 06:35:00,,-0.98,-947.7799999998242,0.0,0.0,1.06872,11.04.2017 22:15:00,14415,-0.380283180929227,-18.89,IS,0.41,0.0,Phase3-EA-SA2v2-EURCHF-M5-43,EURCHFMT4,7324,8h 20m,Buy
158240.67,136619,12.04.2017 07:05:00,,0.0,-989.3899999998102,0.0,0.0,136817,12.04.2017 01:40:00,14416,-0.396978598809392,-41.61,IS,0.23,0.0,Phase3-EA-S4v1-GBPJPY-M5-194,GBPJPYMT4,3144,5h 25m,Buy
158252.15,1.0682,12.04.2017 09:45:00,,0.0,-977.9099999997998,0.0,0.0,1.06786,12.04.2017 01:00:00,14417,-0.39237241286215496,11.48,IS,0.34,0.0,Phase3-EA-S4v1-EURCHF-M15-221,EURCHFMT4,3716,8h 45m,Buy
158188.58,136575,13.04.2017 04:50:00,,-2.28,-1041.4799999998068,0.0,0.0,136865,12.04.2017 23:25:00,14418,-0.41787896692710474,-63.57,IS,0.23,0.0,Phase3-EA-S4v1-GBPJPY-M5-194,GBPJPYMT4,3146,5h 25m,Buy
158149.72,1.06875,13.04.2017 05:35:00,,-6.13,-1080.3399999997928,0.0,0.0,1.06795,12.04.2017 21:15:00,14419,-0.4334709866056242,-38.86,IS,0.41,0.0,Phase3-EA-SA2v2-EURCHF-M5-43,EURCHFMT4,7326,8h 20m,Sell
158167.36,1.06875,13.04.2017 09:45:00,,0.0,-1062.6999999997788,0.0,0.0,1.06927,13.04.2017 01:00:00,14420,-0.4263931886866999,17.64,IS,0.34,0.0,Phase3-EA-S4v1-EURCHF-M15-221,EURCHFMT4,3718,8h 45m,Sell
158129.85,116451,13.04.2017 10:14:58,sl 116.451,-1.64,-1100.2099999997881,0.0,0.0,116221,12.04.2017 19:45:00,14421,-0.44144354015714815,-37.51,IS,0.17,0.0,Phase3-EA-T1v2-EURJPY-M15-322,EURJPYMT4,2784,14h 29m,Sell
158184.5,1.00499,14.04.2017 01:44:57,tp 1.00499,-3.06,-1045.559999999794,0.0,0.0,1.00599,13.04.2017 23:30:00,14422,-0.41951600862263183,54.65,IS,0.58,0.0,Phase3-EA-SA2v2-USDCHF-M15-107,USDCHFMT4,2842,2h 14m,Sell
158177.84,109151,14.04.2017 02:30:00,,-0.72,-1052.2199999997974,0.0,0.0,109175,13.04.2017 20:30:00,14423,-0.4221882384491638,-6.66,IS,0.27,0.0,Phase3-EA-S1v2-USDJPY-M15-0,USDJPYMT4,4190,6h 0m,Buy
158164.38,1.06698,14.04.2017 08:50:00,,0.0,-1065.6799999997893,0.0,0.0,1.06731,14.04.2017 00:30:00,14424,-0.4275888711015781,-13.46,IS,0.41,0.0,Phase3-EA-SA2v2-EURCHF-M5-43,EURCHFMT4,7328,8h 20m,Buy
158152.88,1.06691,14.04.2017 09:45:00,,0.0,-1077.1799999997893,0.0,0.0,1.06725,14.04.2017 01:00:00,14425,-0.4322030817630047,-11.5,IS,0.34,0.0,Phase3-EA-S4v1-EURCHF-M15-221,EURCHFMT4,3720,8h 45m,Buy
158255.82,115252,14.04.2017 22:29:58,tp 115.252,-1.45,-974.239999999787,0.0,0.0,116512,11.04.2017 20:30:00,14426,-0.3908998778075902,102.94,IS,0.09,0.0,Phase3-EA-TR1v1-EURJPY-M30-91,EURJPYMT4,2572,3d 1h 59m,Sell
158242.44,135709,17.04.2017 09:05:00,,0.0,-987.6199999997916,0.0,0.0,135772,17.04.2017 03:40:00,14427,-0.3962684116032345,-13.38,IS,0.23,0.0,Phase3-EA-S4v1-GBPJPY-M5-194,GBPJPYMT4,3148,5h 25m,Buy
158211.95,1.06755,17.04.2017 15:30:00,,0.0,-1018.1099999997823,0.0,0.0,1.06665,17.04.2017 06:45:00,14428,-0.4085020883916567,-30.49,IS,0.34,0.0,Phase3-EA-S4v1-EURCHF-M15-221,EURCHFMT4,3722,8h 45m,Sell
158256.92,1.06885,17.04.2017 22:14:57,tp 1.06885,0.0,-973.1399999997811,0.0,0.0,1.06775,17.04.2017 20:35:00,14429,-0.39045851852692964,44.97,IS,0.41,0.0,Phase3-EA-SA2v2-EURCHF-M5-43,EURCHFMT4,7330,1h 39m,Buy
158197.06,115976,17.04.2017 23:29:58,sl 115.976,-0.29,-1032.9999999997672,0.0,0.0,115256,14.04.2017 22:30:00,14430,-0.41447648810892385,-59.86,IS,0.09,0.0,Phase3-EA-TR1v1-EURJPY-M30-91,EURJPYMT4,2574,3d 0h 59m,Sell
158239.94,1.06785,18.04.2017 01:04:57,tp 1.06785,-2.04,-990.1199999997625,0.0,0.0,1.06895,17.04.2017 23:10:00,14431,-0.397271500877446,42.88,IS,0.41,0.0,Phase3-EA-SA2v2-EURCHF-M5-43,EURCHFMT4,7332,1h 54m,Sell
158202.49,116194,18.04.2017 04:14:58,sl 116.194,-1.65,-1027.5699999997742,0.0,0.0,115964,13.04.2017 12:15:00,14432,-0.4122977782053139,-37.45,IS,0.17,0.0,Phase3-EA-T1v2-EURJPY-M15-322,EURJPYMT4,2786,4d 15h 59m,Sell
158174.91,137034,18.04.2017 05:00:00,,-1.22,-1055.1499999997613,0.0,0.0,136909,17.04.2017 23:35:00,14433,-0.42336385907853885,-27.58,IS,0.23,0.0,Phase3-EA-S4v1-GBPJPY-M5-194,GBPJPYMT4,3150,5h 25m,Sell
158438.45,1.2719,18.04.2017 16:59:58,tp 1.27190,-1.06,-791.6099999997532,0.0,0.0,1253,14.04.2017 17:00:00,14434,-0.317622200147025,263.54,IS,0.14,0.0,Phase3-EA-B1v1-GBPUSD-M30-14,GBPUSDMT4,948,3d 23h 59m,Buy
158591.19,138493,18.04.2017 17:29:58,tp 138.493,-0.3,-638.8699999997625,0.0,0.0,136643,17.04.2017 22:30:00,14435,-0.25633745784908946,152.74,IS,0.09,0.0,Phase3-EA-B1v1-GBPJPY-M30-1,GBPJPYMT4,1326,18h 59m,Buy
158629.46,108657,18.04.2017 18:30:00,,0.0,-600.599999999773,0.0,0.0,108811,18.04.2017 17:45:00,14436,-0.24098216723928526,38.27,IS,0.27,0.0,Phase3-EA-S1v2-USDJPY-M15-0,USDJPYMT4,4192,45m 0s,Sell
158593.39,116006,18.04.2017 20:14:57,sl 116.006,0.0,-636.66999999978,0.0,0.0,116236,18.04.2017 15:45:00,14437,-0.25545473928778006,-36.07,IS,0.17,0.0,Phase3-EA-T1v2-EURJPY-M15-322,EURJPYMT4,2788,4h 29m,Buy
158592.69,0.99596,19.04.2017 03:45:00,,-0.7,-637.3699999997916,0.0,0.0,0.99596,18.04.2017 23:30:00,14438,-0.25573560428456726,-0.7,IS,0.58,0.0,Phase3-EA-SA2v2-USDCHF-M15-107,USDCHFMT4,2844,4h 15m,Buy
158624.62,1.06894,19.04.2017 04:20:00,,-0.99,-605.4399999997986,0.0,0.0,1.06814,18.04.2017 20:00:00,14439,-0.2429241480741916,31.93,IS,0.41,0.0,Phase3-EA-SA2v2-EURCHF-M5-43,EURCHFMT4,7334,8h 20m,Buy
158635.2,1.06887,19.04.2017 15:15:00,,0.0,-594.8599999998114,0.0,0.0,1.06918,19.04.2017 06:30:00,14440,-0.23867907426568427,10.58,IS,0.34,0.0,Phase3-EA-S4v1-EURCHF-M15-221,EURCHFMT4,3724,8h 45m,Sell
158570.41,116857,19.04.2017 15:29:58,sl 116.857,-0.29,-659.6499999998196,0.0,0.0,116077,18.04.2017 09:00:00,14441,-0.2646751358964554,-64.79,IS,0.09,0.0,Phase3-EA-TR1v1-EURJPY-M30-91,EURJPYMT4,2576,1d 6h 29m,Sell
158613.99,109053,19.04.2017 17:45:00,,0.0,-616.0699999998324,0.0,0.0,108877,19.04.2017 17:00:00,14442,-0.24718928366820211,43.58,IS,0.27,0.0,Phase3-EA-S1v2-USDJPY-M15-0,USDJPYMT4,4194,45m 0s,Buy
158669.99,0.99848,20.04.2017 01:14:58,tp 0.99848,-2.09,-560.0699999998324,0.0,0.0,0.99748,19.04.2017 22:30:00,14443,-0.22472008392560291,56.0,IS,0.58,0.0,Phase3-EA-SA2v2-USDCHF-M15-107,USDCHFMT4,2846,2h 44m,Buy
158638.96,139369,20.04.2017 08:00:00,,0.0,-591.0999999998312,0.0,0.0,139222,20.04.2017 02:35:00,14444,-0.23717042799726054,-31.03,IS,0.23,0.0,Phase3-EA-S4v1-GBPJPY-M5-194,GBPJPYMT4,3152,5h 25m,Sell
158623.09,108903,20.04.2017 09:45:00,,0.0,-606.9699999998265,0.0,0.0,108839,20.04.2017 01:00:00,14445,-0.2435380387100274,-15.87,IS,0.27,0.0,Phase3-EA-S1v2-USDJPY-M15-0,USDJPYMT4,4196,8h 45m,Sell
158585.23,1.07004,20.04.2017 11:10:00,,0.0,-644.8299999998126,0.0,0.0,1.06912,20.04.2017 02:50:00,14446,-0.2587288226788576,-37.86,IS,0.41,0.0,Phase3-EA-SA2v2-EURCHF-M5-43,EURCHFMT4,7336,8h 20m,Sell
158545.97,1.07055,20.04.2017 15:15:00,,0.0,-684.0899999998219,0.0,0.0,1.0694,20.04.2017 06:30:00,14447,-0.2744813366412621,-39.26,IS,0.34,0.0,Phase3-EA-S4v1-EURCHF-M15-221,EURCHFMT4,3726,8h 45m,Sell
158480.73,117603,20.04.2017 17:29:58,sl 117.603,-0.87,-749.3299999998126,0.0,0.0,116823,19.04.2017 19:30:00,14448,-0.3006579543413865,-65.24,IS,0.09,0.0,Phase3-EA-TR1v1-EURJPY-M30-91,EURJPYMT4,2578,21h 59m,Sell
158538.13,117125,20.04.2017 23:30:00,,0.0,-691.9299999998184,0.0,0.0,116756,20.04.2017 04:30:00,14449,-0.27762702460522465,57.4,IS,0.17,0.0,Phase3-EA-T1v2-EURJPY-M15-322,EURJPYMT4,2790,19h 0m,Buy
158593.21,0.99718,21.04.2017 01:14:57,tp 0.99718,-3.08,-636.8499999998312,0.0,0.0,0.99818,20.04.2017 22:00:00,14450,-0.25552696171554473,55.08,IS,0.58,0.0,Phase3-EA-SA2v2-USDCHF-M15-107,USDCHFMT4,2848,3h 14m,Sell
158615.94,109384,21.04.2017 03:00:00,,-0.72,-614.1199999998207,0.0,0.0,109289,20.04.2017 23:15:00,14451,-0.24640687403430336,22.73,IS,0.27,0.0,Phase3-EA-S1v2-USDJPY-M15-0,USDJPYMT4,4198,3h 45m,Buy
158614.13,1.07033,21.04.2017 05:50:00,,-0.99,-615.9299999998184,0.0,0.0,1.07035,20.04.2017 21:30:00,14452,-0.24713311066884,-1.81,IS,0.41,0.0,Phase3-EA-SA2v2-EURCHF-M5-43,EURCHFMT4,7338,8h 20m,Buy
158617.1,109083,21.04.2017 18:15:00,,0.0,-612.9599999998172,0.0,0.0,109095,21.04.2017 17:00:00,14453,-0.2459414406110624,2.97,IS,0.27,0.0,Phase3-EA-S1v2-USDJPY-M15-0,USDJPYMT4,4200,1h 15m,Sell
158768.09,141001,24.04.2017 01:00:00,tp 141.001,-1.79,-461.96999999982654,0.0,0.0,139151,18.04.2017 22:00:00,14454,-0.18535886080508307,150.99,IS,0.09,0.0,Phase3-EA-B1v1-GBPJPY-M30-1,GBPJPYMT4,1328,5d 3h 0m,Buy
158703.09,117.96,24.04.2017 01:00:00,sl 117.960,-0.58,-526.9699999998265,0.0,0.0,117.18,20.04.2017 22:30:00,14455,-0.2114391819348857,-65.0,IS,0.09,0.0,Phase3-EA-TR1v1-EURJPY-M30-91,EURJPYMT4,2580,3d 2h 30m,Sell
158666.66,117185,24.04.2017 01:00:00,sl 117.185,-0.55,-563.3999999998196,0.0,0.0,116955,21.04.2017 12:45:00,14456,-0.22605619883886305,-36.43,IS,0.17,0.0,Phase3-EA-T1v2-EURJPY-M15-322,EURJPYMT4,2792,2d 12h 15m,Sell
158748.16,140887,24.04.2017 02:54:58,tp 140.887,0.0,-481.89999999981956,0.0,0.0,141277,24.04.2017 01:10:00,14457,-0.19335548849918743,81.5,IS,0.23,0.0,Phase3-EA-S4v1-GBPJPY-M5-194,GBPJPYMT4,3154,1h 44m,Sell
158793.4,1.08211,24.04.2017 08:44:57,tp 1.08211,0.0,-436.65999999982887,0.0,0.0,1.08101,24.04.2017 01:05:00,14458,-0.17520358499284855,45.24,IS,0.41,0.0,Phase3-EA-SA2v2-EURCHF-M5-43,EURCHFMT4,7340,7h 39m,Buy
158660.42,1.08324,24.04.2017 09:59:57,sl 1.08324,0.0,-569.6399999998393,0.0,0.0,1.07934,24.04.2017 02:45:00,14459,-0.22855990966733206,-132.98,IS,0.34,0.0,Phase3-EA-S4v1-EURCHF-M15-221,EURCHFMT4,3728,7h 14m,Sell
158694.99,109722,25.04.2017 00:30:00,,-1.11,-535.0699999998324,0.0,0.0,109867,24.04.2017 22:30:00,14460,-0.21468919118337113,34.57,IS,0.27,0.0,Phase3-EA-S1v2-USDJPY-M15-0,USDJPYMT4,4202,2h 0m,Sell
158659.35,119105,25.04.2017 03:59:58,sl 119.105,0.0,-570.7099999998463,0.0,0.0,119335,25.04.2017 03:15:00,14461,-0.22898923187670236,-35.64,IS,0.17,0.0,Phase3-EA-T1v2-EURJPY-M15-322,EURJPYMT4,2794,44m 58s,Buy
158623.7,119338,25.04.2017 04:29:58,sl 119.338,0.0,-606.3599999998405,0.0,0.0,119108,25.04.2017 04:00:00,14462,-0.24329328492712257,-35.65,IS,0.17,0.0,Phase3-EA-T1v2-EURJPY-M15-322,EURJPYMT4,2796,29m 58s,Sell
158634.18,0.99597,25.04.2017 04:45:00,,0.0,-595.87999999983,0.0,0.0,0.99579,25.04.2017 00:30:00,14463,-0.2390883346895748,10.48,IS,0.58,0.0,Phase3-EA-SA2v2-USDCHF-M15-107,USDCHFMT4,2850,4h 15m,Buy
158614.42,1.08208,25.04.2017 07:20:00,,-2.06,-615.6399999998393,0.0,0.0,1.08165,24.04.2017 23:00:00,14464,-0.24701675231303852,-19.76,IS,0.41,0.0,Phase3-EA-SA2v2-EURCHF-M5-43,EURCHFMT4,7342,8h 20m,Sell
158550.5,120125,25.04.2017 11:59:57,sl 120.125,-0.29,-679.5599999998522,0.0,0.0,119345,24.04.2017 19:00:00,14465,-0.2726637388763819,-63.92,IS,0.09,0.0,Phase3-EA-TR1v1-EURJPY-M30-91,EURJPYMT4,2582,16h 59m,Sell
158652.78,121593,25.04.2017 20:29:58,tp 121.593,0.0,-577.2799999998533,0.0,0.0,120333,25.04.2017 13:00:00,14466,-0.2316253504893637,102.28,IS,0.09,0.0,Phase3-EA-TR1v1-EURJPY-M30-91,EURJPYMT4,2584,7h 29m,Buy
158696.1,1.0848,26.04.2017 01:04:58,tp 1.08480,-2.06,-533.9599999998463,0.0,0.0,1.0859,25.04.2017 20:10:00,14467,-0.21424381954562166,43.32,IS,0.41,0.0,Phase3-EA-SA2v2-EURCHF-M5-43,EURCHFMT4,7344,4h 54m,Sell
158727.9,111234,26.04.2017 04:15:00,,0.0,-502.159999999858,0.0,0.0,111103,26.04.2017 01:15:00,14468,-0.2014845239775075,31.8,IS,0.27,0.0,Phase3-EA-S1v2-USDJPY-M15-0,USDJPYMT4,4204,3h 0m,Buy
158618.73,111291,26.04.2017 22:00:00,,0.0,-611.3299999998708,0.0,0.0,111741,26.04.2017 21:45:00,14469,-0.24528742640429038,-109.17,IS,0.27,0.0,Phase3-EA-S1v2-USDJPY-M15-0,USDJPYMT4,4206,15m 0s,Buy
158677.05,0.99445,26.04.2017 22:44:58,tp 0.99445,0.0,-553.0099999998638,0.0,0.0,0.99345,26.04.2017 22:15:00,14470,-0.22188735981520927,58.32,IS,0.58,0.0,Phase3-EA-SA2v2-USDCHF-M15-107,USDCHFMT4,2852,29m 58s,Buy
158637.53,143003,27.04.2017 08:00:00,,0.0,-592.5299999998533,0.0,0.0,142812,27.04.2017 02:35:00,14471,-0.23774419506212507,-39.52,IS,0.23,0.0,Phase3-EA-S4v1-GBPJPY-M5-194,GBPJPYMT4,3156,5h 25m,Sell
158785.78,143529,27.04.2017 11:29:58,tp 143.529,-1.17,-444.2799999998533,0.0,0.0,141679,25.04.2017 15:30:00,14472,-0.1782610011006906,148.25,IS,0.09,0.0,Phase3-EA-B1v1-GBPJPY-M30-1,GBPJPYMT4,1330,1d 19h 59m,Buy
158823.08,1.08272,27.04.2017 14:45:00,,0.0,-406.97999999986496,0.0,0.0,1.08381,27.04.2017 06:00:00,14473,-0.16329490912928546,37.3,IS,0.34,0.0,Phase3-EA-S4v1-EURCHF-M15-221,EURCHFMT4,3730,8h 45m,Sell
158787.96,121505,27.04.2017 16:44:58,sl 121.505,0.0,-442.0999999998603,0.0,0.0,121275,27.04.2017 14:15:00,14474,-0.1773863072535708,-35.12,IS,0.17,0.0,Phase3-EA-T1v2-EURJPY-M15-322,EURJPYMT4,2798,2h 29m,Sell
158752.85,121316,27.04.2017 17:29:58,sl 121.316,0.0,-477.20999999984633,0.0,0.0,121086,27.04.2017 17:15:00,14475,-0.1914736930207555,-35.11,IS,0.17,0.0,Phase3-EA-T1v2-EURJPY-M15-322,EURJPYMT4,2800,14m 58s,Sell
158693.1,120813,27.04.2017 18:59:58,sl 120.813,-1.59,-536.9599999998463,0.0,0.0,121533,25.04.2017 20:30:00,14476,-0.21544752667468947,-59.75,IS,0.09,0.0,Phase3-EA-TR1v1-EURJPY-M30-91,EURJPYMT4,2586,1d 22h 29m,Buy
158677.27,1.08033,28.04.2017 04:20:00,,-0.99,-552.7899999998335,0.0,0.0,1.08069,27.04.2017 20:00:00,14477,-0.2217990879590655,-15.83,IS,0.41,0.0,Phase3-EA-SA2v2-EURCHF-M5-43,EURCHFMT4,7346,8h 20m,Buy
158671.69,111254,28.04.2017 05:00:00,,0.0,-558.3699999998207,0.0,0.0,111231,28.04.2017 00:45:00,14478,-0.2240379832191265,-5.58,IS,0.27,0.0,Phase3-EA-S1v2-USDJPY-M15-0,USDJPYMT4,4208,4h 15m,Sell
158682.62,1.08085,28.04.2017 10:00:00,,0.0,-547.4399999998277,0.0,0.0,1.08053,28.04.2017 01:15:00,14479,-0.21965247691222556,10.93,IS,0.34,0.0,Phase3-EA-S4v1-EURCHF-M15-221,EURCHFMT4,3732,8h 45m,Buy
158728.02,1.08363,28.04.2017 21:49:58,tp 1.08363,0.0,-502.0399999998335,0.0,0.0,1.08253,28.04.2017 20:10:00,14480,-0.20143637569233497,45.4,IS,0.41,0.0,Phase3-EA-SA2v2-EURCHF-M5-43,EURCHFMT4,7348,1h 39m,Buy
158651.46,1.08484,01.05.2017 09:20:00,,0.0,-578.5999999998312,0.0,0.0,1.08298,01.05.2017 01:00:00,14481,-0.23215498162614465,-76.56,IS,0.41,0.0,Phase3-EA-SA2v2-EURCHF-M5-43,EURCHFMT4,7350,8h 20m,Sell
158641.9,1.08455,01.05.2017 12:45:00,,0.0,-588.1599999998289,0.0,0.0,1.08427,01.05.2017 04:00:00,14482,-0.23599079501077316,-9.56,IS,0.34,0.0,Phase3-EA-S4v1-EURCHF-M15-221,EURCHFMT4,3734,8h 45m,Sell
158664.34,111903,02.05.2017 02:30:00,,0.0,-565.7199999998265,0.0,0.0,111.81,02.05.2017 01:15:00,14483,-0.22698706568534496,22.44,IS,0.27,0.0,Phase3-EA-S1v2-USDJPY-M15-0,USDJPYMT4,4210,1h 15m,Buy
158647.46,1.08601,02.05.2017 04:25:00,,-2.06,-582.5999999998312,0.0,0.0,1.08565,01.05.2017 20:05:00,14484,-0.23375992446490174,-16.88,IS,0.41,0.0,Phase3-EA-SA2v2-EURCHF-M5-43,EURCHFMT4,7352,8h 20m,Sell
158694.61,144.4,02.05.2017 05:00:00,,-0.74,-535.449999999837,0.0,0.0,144167,01.05.2017 23:35:00,14485,-0.21484166075305494,47.15,IS,0.23,0.0,Phase3-EA-S4v1-GBPJPY-M5-194,GBPJPYMT4,3158,5h 25m,Buy
158797.6,122331,02.05.2017 09:29:58,tp 122.331,-0.79,-432.45999999984633,0.0,0.0,121041,28.04.2017 11:00:00,14486,-0.17351839501216063,102.99,IS,0.09,0.0,Phase3-EA-TR1v1-EURJPY-M30-91,EURJPYMT4,2588,3d 22h 29m,Buy
158819.47,1.08524,02.05.2017 12:00:00,,0.0,-410.589999999851,0.0,0.0,1.08588,02.05.2017 03:15:00,14487,-0.1647433700412581,21.87,IS,0.34,0.0,Phase3-EA-S4v1-EURCHF-M15-221,EURCHFMT4,3736,8h 45m,Sell
158941.36,122311,02.05.2017 19:15:00,,-0.75,-288.699999999837,0.0,0.0,121502,01.05.2017 04:45:00,14488,-0.11583674938722724,121.89,IS,0.17,0.0,Phase3-EA-T1v2-EURJPY-M15-322,EURJPYMT4,2802,1d 14h 30m,Buy
158986.83,1.08307,02.05.2017 20:29:58,tp 1.08307,0.0,-243.22999999983585,0.0,0.0,1.08197,02.05.2017 20:10:00,14489,-0.0975925616676556,45.47,IS,0.41,0.0,Phase3-EA-SA2v2-EURCHF-M5-43,EURCHFMT4,7354,19m 58s,Buy
158949.37,991,03.05.2017 05:30:00,,0.0,-280.6899999998277,0.0,0.0,0.99164,03.05.2017 01:15:00,14490,-0.11262285135261244,-37.46,IS,0.58,0.0,Phase3-EA-SA2v2-USDCHF-M15-107,USDCHFMT4,2854,4h 15m,Buy
158957.23,1.08366,03.05.2017 05:45:00,,-2.07,-272.8299999998417,0.0,0.0,1.0839,02.05.2017 21:25:00,14491,-0.10946913867446037,7.86,IS,0.41,0.0,Phase3-EA-SA2v2-EURCHF-M5-43,EURCHFMT4,7356,8h 20m,Sell
158951.03,122378,03.05.2017 11:15:00,,-0.74,-279.0299999998533,0.0,0.0,122414,02.05.2017 23:00:00,14492,-0.11195680007453852,-6.2,IS,0.17,0.0,Phase3-EA-T1v2-EURJPY-M15-322,EURJPYMT4,2804,12h 15m,Buy
158915.14,1.08284,04.05.2017 04:25:00,,-6.19,-314.9199999998673,0.0,0.0,1.08212,03.05.2017 20:05:00,14493,-0.12635714969529208,-35.89,IS,0.41,0.0,Phase3-EA-SA2v2-EURCHF-M5-43,EURCHFMT4,7358,8h 20m,Sell
158913.39,0.99467,04.05.2017 05:00:00,,0.0,-316.6699999998673,0.0,0.0,0.99464,04.05.2017 00:45:00,14494,-0.1270593121872483,-1.75,IS,0.58,0.0,Phase3-EA-SA2v2-USDCHF-M15-107,USDCHFMT4,2856,4h 15m,Sell
159059.02,145437,04.05.2017 12:29:57,tp 145.437,-2.02,-171.03999999986263,0.0,0.0,143587,27.04.2017 13:30:00,14495,-0.06862735578519785,145.63,IS,0.09,0.0,Phase3-EA-B1v1-GBPJPY-M30-1,GBPJPYMT4,1332,6d 22h 59m,Buy
159157.23,123118,04.05.2017 12:29:57,tp 123.118,-2.35,-72.82999999987078,0.0,0.0,121858,28.04.2017 14:30:00,14496,-0.02922199673661778,98.21,IS,0.09,0.0,Phase3-EA-TR1v1-EURJPY-M30-91,EURJPYMT4,2589,5d 21h 59m,Buy
159114.17,0.98604,05.05.2017 03:45:00,,-0.71,-115.88999999986845,0.0,0.0,0.98676,04.05.2017 23:30:00,14497,-0.04649920639583687,-43.06,IS,0.58,0.0,Phase3-EA-SA2v2-USDCHF-M15-107,USDCHFMT4,2858,4h 15m,Buy
159086.57,1.08284,05.05.2017 04:50:00,,-1.0,-143.48999999987427,0.0,0.0,1.08348,04.05.2017 20:30:00,14498,-0.05757331198326309,-27.6,IS,0.41,0.0,Phase3-EA-SA2v2-EURCHF-M5-43,EURCHFMT4,7360,8h 20m,Buy
159083.91,145398,05.05.2017 07:05:00,,0.0,-146.14999999987776,0.0,0.0,145385,05.05.2017 01:40:00,14499,-0.058640598971037954,-2.66,IS,0.23,0.0,Phase3-EA-S4v1-GBPJPY-M5-194,GBPJPYMT4,3160,5h 25m,Sell
159130.07,112305,05.05.2017 07:45:00,,0.0,-99.98999999987427,0.0,0.0,112497,05.05.2017 01:30:00,14500,-0.04011955861177979,46.16,IS,0.27,0.0,Phase3-EA-S1v2-USDJPY-M15-0,USDJPYMT4,4212,6h 15m,Sell
159217.57,123239,05.05.2017 08:45:00,,-2.96,-12.489999999874271,0.0,0.0,122642,03.05.2017 16:45:00,14501,-0.0050114340139685515,87.5,IS,0.17,0.0,Phase3-EA-T1v2-EURJPY-M15-322,EURJPYMT4,2806,1d 16h 0m,Buy
159259.91,1.08406,05.05.2017 12:15:00,,0.0,-0.0,0.0,0.0,1.08283,05.05.2017 03:30:00,14502,-0.0,42.34,IS,0.34,0.0,Phase3-EA-S4v1-EURCHF-M15-221,EURCHFMT4,3738,8h 45m,Buy
159305.59,1.08515,05.05.2017 20:29:59,tp 1.08515,0.0,-0.0,0.0,0.0,1.08625,05.05.2017 20:10:00,14503,-0.0,45.68,IS,0.41,0.0,Phase3-EA-SA2v2-EURCHF-M5-43,EURCHFMT4,7362,19m 59s,Sell
159242.68,124172,08.05.2017 01:00:00,sl 124.172,-0.56,-62.91000000000349,0.0,0.0,123392,04.05.2017 17:30:00,14504,-0.025234091221140793,-62.91,IS,0.09,0.0,Phase3-EA-TR1v1-EURJPY-M30-91,EURJPYMT4,2592,3d 7h 30m,Sell
159318.0,112938,08.05.2017 01:00:00,,-0.7,-0.0,0.0,0.0,112.62,05.05.2017 23:00:00,14505,-0.0,75.32,IS,0.27,0.0,Phase3-EA-S1v2-USDJPY-M15-0,USDJPYMT4,4214,2d 2h 0m,Buy
159362.73,1.08606,08.05.2017 01:00:00,tp 1.08606,-1.0,-0.0,0.0,0.0,1.08496,05.05.2017 21:00:00,14506,-0.0,44.73,IS,0.41,0.0,Phase3-EA-SA2v2-EURCHF-M5-43,EURCHFMT4,7364,2d 4h 0m,Buy
159421.36,0.98933,08.05.2017 02:29:58,tp 0.98933,0.0,-0.0,0.0,0.0,0.98833,08.05.2017 01:15:00,14507,-0.0,58.63,IS,0.58,0.0,Phase3-EA-SA2v2-USDCHF-M15-107,USDCHFMT4,2860,1h 14m,Buy
159341.39,1.08589,08.05.2017 09:25:00,,0.0,-79.97000000000116,0.0,0.0,1.08782,08.05.2017 01:05:00,14508,-0.032062209908566314,-79.97,IS,0.41,0.0,Phase3-EA-SA2v2-EURCHF-M5-43,EURCHFMT4,7366,8h 20m,Buy
159325.6,1.0877,08.05.2017 11:00:00,,0.0,-95.76000000000931,0.0,0.0,1.08724,08.05.2017 02:15:00,14509,-0.03839286258402606,-15.79,IS,0.34,0.0,Phase3-EA-S4v1-EURCHF-M15-221,EURCHFMT4,3740,8h 45m,Sell
159267.65,123139,08.05.2017 13:59:57,sl 123.139,-0.39,-153.71000000002095,0.0,0.0,123859,05.05.2017 20:30:00,14510,-0.061626638552536306,-57.95,IS,0.09,0.0,Phase3-EA-TR1v1-EURJPY-M30-91,EURJPYMT4,2593,2d 17h 29m,Buy
159310.76,1.09045,09.05.2017 01:04:58,tp 1.09045,-2.05,-110.60000000003492,0.0,0.0,1.09155,08.05.2017 21:10:00,14511,-0.04434263368623862,43.11,IS,0.41,0.0,Phase3-EA-SA2v2-EURCHF-M5-43,EURCHFMT4,7368,3h 54m,Sell
159315.64,146537,09.05.2017 05:55:00,,0.0,-105.72000000003027,0.0,0.0,146561,09.05.2017 00:30:00,14512,-0.04238610518362576,4.88,IS,0.23,0.0,Phase3-EA-S4v1-GBPJPY-M5-194,GBPJPYMT4,3162,5h 25m,Sell
159347.66,1.09121,09.05.2017 09:25:00,,0.0,-73.70000000004075,0.0,0.0,1.09043,09.05.2017 01:05:00,14513,-0.02954839152510453,32.02,IS,0.41,0.0,Phase3-EA-SA2v2-EURCHF-M5-43,EURCHFMT4,7370,8h 20m,Buy
159382.67,1.09161,09.05.2017 12:45:00,,0.0,-38.69000000003143,0.0,0.0,1.09058,09.05.2017 04:00:00,14514,-0.015511903230754288,35.01,IS,0.34,0.0,Phase3-EA-S4v1-EURCHF-M15-221,EURCHFMT4,3742,8h 45m,Buy
159339.61,1.29085,09.05.2017 16:29:58,sl 1.29085,-1.06,-81.7500000000291,0.0,0.0,1.29385,05.05.2017 11:00:00,14515,-0.03277586169846431,-43.06,IS,0.14,0.0,Phase3-EA-B1v1-GBPUSD-M30-14,GBPUSDMT4,950,4d 5h 29m,Buy
159397.19,1.00728,09.05.2017 23:59:58,tp 1.00728,0.0,-24.17000000004191,0.0,0.0,1.00828,09.05.2017 22:30:00,14516,-0.009690429079547083,57.58,IS,0.58,0.0,Phase3-EA-SA2v2-USDCHF-M15-107,USDCHFMT4,2862,1h 29m,Sell
159439.92,1.09491,10.05.2017 01:04:59,tp 1.09491,-2.04,-0.0,0.0,0.0,1.09601,09.05.2017 20:20:00,14517,-0.0,42.73,IS,0.41,0.0,Phase3-EA-SA2v2-EURCHF-M5-43,EURCHFMT4,7372,4h 44m,Sell
159484.72,1.09651,10.05.2017 04:54:58,tp 1.09651,0.0,-0.0,0.0,0.0,1.09541,10.05.2017 01:10:00,14518,-0.0,44.8,IS,0.41,0.0,Phase3-EA-SA2v2-EURCHF-M5-43,EURCHFMT4,7374,3h 44m,Buy
159525.59,147499,10.05.2017 05:15:00,,-0.73,-0.0,0.0,0.0,147293,09.05.2017 23:50:00,14519,-0.0,40.87,IS,0.23,0.0,Phase3-EA-S4v1-GBPJPY-M5-194,GBPJPYMT4,3164,5h 25m,Buy
159491.27,124181,10.05.2017 10:59:57,sl 124.181,0.0,-34.320000000006985,0.0,0.0,123951,10.05.2017 06:30:00,14520,-0.013754100330954776,-34.32,IS,0.17,0.0,Phase3-EA-T1v2-EURJPY-M15-322,EURJPYMT4,2808,4h 29m,Sell
159636.66,147926,10.05.2017 10:59:58,tp 147.926,-0.86,-0.0,0.0,0.0,146076,05.05.2017 21:00:00,14521,-0.0,145.39,IS,0.09,0.0,Phase3-EA-B1v1-GBPJPY-M30-1,GBPJPYMT4,1334,4d 13h 59m,Buy
159711.96,1.09441,10.05.2017 14:45:00,,0.0,-0.0,0.0,0.0,1.09664,10.05.2017 06:00:00,14522,-0.0,75.3,IS,0.34,0.0,Phase3-EA-S4v1-EURCHF-M15-221,EURCHFMT4,3744,8h 45m,Sell
159677.66,124036,10.05.2017 19:14:58,sl 124.036,0.0,-34.29999999998836,0.0,0.0,123806,10.05.2017 13:15:00,14523,-0.013735825869128668,-34.3,IS,0.17,0.0,Phase3-EA-T1v2-EURJPY-M15-322,EURJPYMT4,2810,5h 59m,Sell
159722.37,1.0956,10.05.2017 21:39:58,tp 1.09560,0.0,-0.0,0.0,0.0,1.0967,10.05.2017 20:00:00,14524,-0.0,44.71,IS,0.41,0.0,Phase3-EA-SA2v2-EURCHF-M5-43,EURCHFMT4,7376,1h 39m,Sell
159630.07,114235,11.05.2017 05:00:00,,-3.19,-92.29999999998836,0.0,0.0,113858,10.05.2017 18:00:00,14525,-0.03696104598077778,-92.3,IS,0.27,0.0,Phase3-EA-S1v2-USDJPY-M15-0,USDJPYMT4,4216,11h 0m,Sell
159666.59,1.09664,11.05.2017 06:30:00,,-2.93,-55.779999999998836,0.0,0.0,1.09567,10.05.2017 22:10:00,14526,-0.02233680546920912,36.52,IS,0.41,0.0,Phase3-EA-SA2v2-EURCHF-M5-43,EURCHFMT4,7378,8h 20m,Buy
159609.67,123533,11.05.2017 16:29:58,sl 123.533,0.0,-112.70000000001164,0.0,0.0,123513,08.05.2017 21:00:00,14527,-0.04513011789853317,-56.92,IS,0.09,0.0,Phase3-EA-TR1v1-EURJPY-M30-91,EURJPYMT4,2596,2d 19h 29m,Buy
159632.81,113773,12.05.2017 02:45:00,,-1.07,-89.55999999999767,0.0,0.0,113875,11.05.2017 20:15:00,14528,-0.0358638274977117,23.14,IS,0.27,0.0,Phase3-EA-S1v2-USDJPY-M15-0,USDJPYMT4,4218,6h 30m,Sell
159612.46,1.09505,12.05.2017 08:30:00,,0.0,-109.91000000000349,0.0,0.0,1.09455,12.05.2017 00:10:00,14529,-0.04401287718036758,-20.35,IS,0.41,0.0,Phase3-EA-SA2v2-EURCHF-M5-43,EURCHFMT4,7380,8h 20m,Sell
159590.87,1.09579,12.05.2017 15:15:00,,0.0,-131.5,0.0,0.0,1.09515,12.05.2017 06:30:00,14530,-0.0526584782933141,-21.59,IS,0.34,0.0,Phase3-EA-S4v1-EURCHF-M15-221,EURCHFMT4,3746,8h 45m,Sell
159556.5,123873,12.05.2017 15:29:58,sl 123.873,0.0,-165.86999999999534,0.0,0.0,123643,12.05.2017 06:15:00,14531,-0.06642176269590695,-34.37,IS,0.17,0.0,Phase3-EA-T1v2-EURJPY-M15-322,EURJPYMT4,2812,9h 14m,Sell
159580.81,113273,12.05.2017 23:45:00,,0.0,-141.55999999999767,0.0,0.0,113375,12.05.2017 22:30:00,14532,-0.056686951993927155,24.31,IS,0.27,0.0,Phase3-EA-S1v2-USDJPY-M15-0,USDJPYMT4,4220,1h 15m,Sell
159623.87,1.09336,15.05.2017 01:00:00,tp 1.09336,-2.05,-98.5,0.0,0.0,1.09446,12.05.2017 23:05:00,14533,-0.03944380313225429,43.06,IS,0.41,0.0,Phase3-EA-SA2v2-EURCHF-M5-43,EURCHFMT4,7382,2d 1h 55m,Sell
159681.82,1.0008,15.05.2017 02:14:58,tp 1.00080,0.0,-40.54999999998836,0.0,0.0,0.9998,15.05.2017 01:15:00,14534,-0.016238032660024895,57.95,IS,0.58,0.0,Phase3-EA-SA2v2-USDCHF-M15-107,USDCHFMT4,2864,59m 58s,Buy
159726.88,1.09427,15.05.2017 04:34:58,tp 1.09427,0.0,-0.0,0.0,0.0,1.09317,15.05.2017 01:05:00,14535,-0.0,45.06,IS,0.41,0.0,Phase3-EA-SA2v2-EURCHF-M5-43,EURCHFMT4,7384,3h 29m,Buy
159781.56,1.0941,15.05.2017 10:00:00,,0.0,-0.0,0.0,0.0,1.09249,15.05.2017 01:15:00,14536,-0.0,54.68,IS,0.34,0.0,Phase3-EA-S4v1-EURCHF-M15-221,EURCHFMT4,3748,8h 45m,Buy
159881.2,124803,15.05.2017 17:59:58,tp 124.803,-2.72,-0.0,0.0,0.0,124253,11.05.2017 04:00:00,14537,-0.0,99.64,IS,0.09,0.0,Phase3-EA-TR1v1-EURJPY-M30-91,EURJPYMT4,2597,4d 13h 59m,Buy
159897.92,1.09356,16.05.2017 05:05:00,,-0.99,-0.0,0.0,0.0,1.09313,15.05.2017 20:45:00,14538,-0.0,16.72,IS,0.41,0.0,Phase3-EA-SA2v2-EURCHF-M5-43,EURCHFMT4,7386,8h 20m,Buy
159867.3,146403,16.05.2017 06:40:00,,0.0,-30.619999999995343,0.0,0.0,146554,16.05.2017 01:15:00,14539,-0.012253003146242766,-30.62,IS,0.23,0.0,Phase3-EA-S4v1-GBPJPY-M5-194,GBPJPYMT4,3166,5h 25m,Buy
159979.42,124.64,16.05.2017 07:00:00,,-0.73,-0.0,0.0,0.0,123887,15.05.2017 04:30:00,14540,-0.0,112.12,IS,0.17,0.0,Phase3-EA-T1v2-EURJPY-M15-322,EURJPYMT4,2814,1d 2h 30m,Buy
159937.42,1.28929,16.05.2017 13:29:58,sl 1.28929,0.0,-42.0,0.0,0.0,1.29229,16.05.2017 10:30:00,14541,-0.016801383089855893,-42.0,IS,0.14,0.0,Phase3-EA-B1v1-GBPUSD-M30-14,GBPUSDMT4,952,2h 59m,Buy
159895.42,1.29087,16.05.2017 17:29:58,sl 1.29087,0.0,-84.0,0.0,0.0,1.28787,16.05.2017 13:30:00,14542,-0.033602766179711786,-42.0,IS,0.14,0.0,Phase3-EA-B1v1-GBPUSD-M30-14,GBPUSDMT4,954,3h 59m,Sell
159860.8,125281,16.05.2017 23:29:58,sl 125.281,0.0,-118.61999999999534,0.0,0.0,125511,16.05.2017 21:45:00,14543,-0.04745190624091971,-34.62,IS,0.17,0.0,Phase3-EA-T1v2-EURJPY-M15-322,EURJPYMT4,2816,1h 44m,Buy
159831.25,0.98538,17.05.2017 02:15:00,,-0.71,-148.1699999999837,0.0,0.0,0.98587,16.05.2017 22:00:00,14544,-0.059272879343420806,-29.55,IS,0.58,0.0,Phase3-EA-SA2v2-USDCHF-M15-107,USDCHFMT4,2866,4h 15m,Buy
159631.62,112645,17.05.2017 03:44:58,sl 112.645,-0.69,-347.79999999998836,0.0,0.0,113475,16.05.2017 17:15:00,14545,-0.13913145330123058,-199.63,IS,0.27,0.0,Phase3-EA-S1v2-USDJPY-M15-0,USDJPYMT4,4222,10h 29m,Buy
159523.96,1.09109,17.05.2017 04:35:00,,-1.0,-455.45999999999185,0.0,0.0,1.09365,16.05.2017 20:15:00,14546,-0.18219899862156258,-107.66,IS,0.41,0.0,Phase3-EA-SA2v2-EURCHF-M5-43,EURCHFMT4,7388,8h 20m,Buy
159467.3,145419,17.05.2017 08:20:00,,0.0,-512.1199999999953,0.0,0.0,145696,17.05.2017 02:55:00,14547,-0.204864864475641,-56.66,IS,0.23,0.0,Phase3-EA-S4v1-GBPJPY-M5-194,GBPJPYMT4,3168,5h 25m,Buy
159446.2,1.09173,17.05.2017 09:45:00,,0.0,-533.2200000000012,0.0,0.0,1.09234,17.05.2017 01:00:00,14548,-0.21330555931364237,-21.1,IS,0.34,0.0,Phase3-EA-S4v1-EURCHF-M15-221,EURCHFMT4,3750,8h 45m,Buy
159387.48,123961,17.05.2017 17:59:58,sl 123.961,-0.78,-591.9400000000023,0.0,0.0,124681,15.05.2017 18:30:00,14549,-0.2367954930049842,-58.72,IS,0.09,0.0,Phase3-EA-TR1v1-EURJPY-M30-91,EURJPYMT4,2600,1d 23h 29m,Buy
159446.7,0.9794,17.05.2017 22:59:58,tp 0.97940,0.0,-532.7200000000012,0.0,0.0,0.9784,17.05.2017 22:30:00,14550,-0.21310554284828695,59.22,IS,0.58,0.0,Phase3-EA-SA2v2-USDCHF-M15-107,USDCHFMT4,2868,29m 58s,Buy
159492.76,1.09139,17.05.2017 23:24:57,tp 1.09139,0.0,-486.6600000000035,0.0,0.0,1.09249,17.05.2017 20:55:00,14551,-0.1946800260597459,46.06,IS,0.41,0.0,Phase3-EA-SA2v2-EURCHF-M5-43,EURCHFMT4,7390,2h 29m,Sell
159641.62,143538,18.05.2017 01:29:57,tp 143.538,-1.41,-337.80000000001746,0.0,0.0,145388,17.05.2017 06:30:00,14552,-0.13513112399413368,148.86,IS,0.09,0.0,Phase3-EA-B1v1-GBPJPY-M30-1,GBPJPYMT4,1336,18h 59m,Sell
159684.7,1.09253,18.05.2017 02:09:57,tp 1.09253,-3.02,-294.72000000003027,0.0,0.0,1.09143,17.05.2017 23:25:00,14553,-0.11789770533911519,43.08,IS,0.41,0.0,Phase3-EA-SA2v2-EURCHF-M5-43,EURCHFMT4,7392,2h 44m,Buy
159765.46,144048,18.05.2017 03:49:58,tp 144.048,0.0,-213.96000000002095,0.0,0.0,143658,18.05.2017 01:20:00,14554,-0.08559104585490283,80.76,IS,0.23,0.0,Phase3-EA-S4v1-GBPJPY-M5-194,GBPJPYMT4,3170,2h 29m,Buy
160025.04,123.0,18.05.2017 13:29:58,tp 123.000,-1.61,-0.0,0.0,0.0,124.7,17.05.2017 16:30:00,14555,-0.0,259.58,IS,0.17,0.0,Phase3-EA-T1v2-EURJPY-M15-322,EURJPYMT4,2818,20h 59m,Sell
160126.87,122627,18.05.2017 13:59:58,tp 122.627,-0.85,-0.0,0.0,0.0,123887,17.05.2017 21:30:00,14556,-0.0,101.83,IS,0.09,0.0,Phase3-EA-TR1v1-EURJPY-M30-91,EURJPYMT4,2602,16h 29m,Sell
160173.04,1.08779,18.05.2017 20:29:57,tp 1.08779,0.0,-0.0,0.0,0.0,1.08669,18.05.2017 20:05:00,14557,-0.0,46.17,IS,0.41,0.0,Phase3-EA-SA2v2-EURCHF-M5-43,EURCHFMT4,7394,24m 57s,Buy
159972.21,111587,18.05.2017 21:59:58,sl 111.587,0.0,-200.8299999999872,0.0,0.0,110757,18.05.2017 17:00:00,14558,-0.08027643586214825,-200.83,IS,0.27,0.0,Phase3-EA-S1v2-USDJPY-M15-0,USDJPYMT4,4224,4h 59m,Sell
159976.39,1.08827,19.05.2017 07:00:00,,-2.09,-196.64999999999418,0.0,0.0,1.08842,18.05.2017 22:40:00,14559,-0.0786055923531942,4.18,IS,0.41,0.0,Phase3-EA-SA2v2-EURCHF-M5-43,EURCHFMT4,7396,8h 20m,Sell
160080.17,124457,19.05.2017 12:59:57,tp 124.457,-0.4,-92.86999999999534,0.0,0.0,123167,18.05.2017 16:30:00,14560,-0.03712230542507498,103.78,IS,0.09,0.0,Phase3-EA-TR1v1-EURJPY-M30-91,EURJPYMT4,2604,20h 29m,Buy
159972.01,1.09162,19.05.2017 14:30:00,,0.0,-201.02999999999884,0.0,0.0,1.08851,19.05.2017 05:45:00,14561,-0.08035638052765322,-108.16,IS,0.34,0.0,Phase3-EA-S4v1-EURCHF-M15-221,EURCHFMT4,3752,8h 45m,Sell
160089.46,124565,22.05.2017 02:15:00,,-0.75,-83.5799999999872,0.0,0.0,123792,19.05.2017 09:15:00,14562,-0.03340887571258154,117.45,IS,0.17,0.0,Phase3-EA-T1v2-EURJPY-M15-322,EURJPYMT4,2820,2d 17h 0m,Buy
160149.01,974,22.05.2017 04:14:57,tp 0.97400,0.0,-24.029999999998836,0.0,0.0,973,22.05.2017 01:15:00,14563,-0.009605351559863824,59.55,IS,0.58,0.0,Phase3-EA-SA2v2-USDCHF-M15-107,USDCHFMT4,2870,2h 59m,Buy
160111.74,144725,22.05.2017 05:05:00,,-0.74,-61.29999999998836,0.0,0.0,144902,19.05.2017 23:40:00,14564,-0.024503039975845575,-37.27,IS,0.23,0.0,Phase3-EA-S4v1-GBPJPY-M5-194,GBPJPYMT4,3172,2d 5h 25m,Buy
160101.47,1.08998,22.05.2017 05:25:00,,-1.01,-71.56999999997788,0.0,0.0,1.0902,19.05.2017 21:05:00,14565,-0.028608198549283176,-10.27,IS,0.41,0.0,Phase3-EA-SA2v2-EURCHF-M5-43,EURCHFMT4,7398,2d 8h 20m,Buy
160066.38,124.57,22.05.2017 10:29:58,sl 124.570,0.0,-106.65999999997439,0.0,0.0,124.8,22.05.2017 04:15:00,14566,-0.042634490111314156,-35.09,IS,0.17,0.0,Phase3-EA-T1v2-EURJPY-M15-322,EURJPYMT4,2822,6h 14m,Buy
160031.13,124875,22.05.2017 19:14:58,sl 124.875,0.0,-141.9099999999744,0.0,0.0,125105,22.05.2017 14:30:00,14567,-0.05672473740574679,-35.25,IS,0.17,0.0,Phase3-EA-T1v2-EURJPY-M15-322,EURJPYMT4,2824,4h 44m,Buy
160090.7,0.97363,22.05.2017 23:14:58,tp 0.97363,0.0,-82.3399999999674,0.0,0.0,0.97263,22.05.2017 22:15:00,14568,-0.0329132187864716,59.57,IS,0.58,0.0,Phase3-EA-SA2v2-USDCHF-M15-107,USDCHFMT4,2872,59m 58s,Buy
160055.57,124843,23.05.2017 02:44:58,sl 124.843,0.0,-117.46999999997206,0.0,0.0,125073,23.05.2017 01:00:00,14569,-0.046955499281605896,-35.13,IS,0.17,0.0,Phase3-EA-T1v2-EURJPY-M15-322,EURJPYMT4,2826,1h 44m,Buy
160075.63,111088,23.05.2017 02:45:00,,-1.09,-97.40999999997439,0.0,0.0,111175,22.05.2017 22:45:00,14570,-0.03893704933192403,20.06,IS,0.27,0.0,Phase3-EA-S1v2-USDJPY-M15-0,USDJPYMT4,4226,4h 0m,Sell
160135.29,0.97214,23.05.2017 05:59:58,tp 0.97214,0.0,-37.749999999970896,0.0,0.0,0.97314,23.05.2017 02:45:00,14571,-0.015089555613175088,59.66,IS,0.58,0.0,Phase3-EA-SA2v2-USDCHF-M15-107,USDCHFMT4,2874,3h 14m,Sell
160145.63,144379,23.05.2017 08:20:00,,0.0,-27.40999999997439,0.0,0.0,144329,23.05.2017 02:55:00,14572,-0.01095641640680958,10.34,IS,0.23,0.0,Phase3-EA-S4v1-GBPJPY-M5-194,GBPJPYMT4,3174,5h 25m,Buy
160136.78,1094,23.05.2017 08:35:00,,0.0,-36.25999999998021,0.0,0.0,1.09379,23.05.2017 00:15:00,14573,-0.014493967855201375,-8.85,IS,0.41,0.0,Phase3-EA-SA2v2-EURCHF-M5-43,EURCHFMT4,7400,8h 20m,Sell
160101.56,124794,23.05.2017 09:59:58,sl 124.794,0.0,-71.47999999998137,0.0,0.0,125024,23.05.2017 06:15:00,14574,-0.028572223449809427,-35.22,IS,0.17,0.0,Phase3-EA-T1v2-EURJPY-M15-322,EURJPYMT4,2828,3h 44m,Buy
160066.39,124895,23.05.2017 15:44:58,sl 124.895,0.0,-106.64999999999418,0.0,0.0,125125,23.05.2017 12:00:00,14575,-0.04263049287804705,-35.17,IS,0.17,0.0,Phase3-EA-T1v2-EURJPY-M15-322,EURJPYMT4,2830,3h 44m,Buy
160071.73,111249,23.05.2017 19:30:00,,0.0,-101.30999999999767,0.0,0.0,111227,23.05.2017 17:00:00,14576,-0.040495970309189715,5.34,IS,0.27,0.0,Phase3-EA-S1v2-USDJPY-M15-0,USDJPYMT4,4228,2h 30m,Buy
160036.73,124903,23.05.2017 20:29:58,sl 124.903,0.0,-136.30999999999767,0.0,0.0,125133,23.05.2017 20:15:00,14577,-0.05448628677174694,-35.0,IS,0.17,0.0,Phase3-EA-T1v2-EURJPY-M15-322,EURJPYMT4,2832,14m 58s,Buy
160003.97,1.0917,24.05.2017 07:40:00,,-2.1,-169.07000000000698,0.0,0.0,1.09097,23.05.2017 23:20:00,14578,-0.06758122298070422,-32.76,IS,0.41,0.0,Phase3-EA-SA2v2-EURCHF-M5-43,EURCHFMT4,7402,8h 20m,Sell
160014.09,125083,25.05.2017 00:45:00,,-2.99,-158.95000000001164,0.0,0.0,124997,23.05.2017 23:45:00,14579,-0.06353602290638954,10.12,IS,0.17,0.0,Phase3-EA-T1v2-EURJPY-M15-322,EURJPYMT4,2834,1d 1h 0m,Buy
160013.49,0.97296,25.05.2017 05:30:00,,0.0,-159.55000000001746,0.0,0.0,0.97297,25.05.2017 01:15:00,14580,-0.06377585690289285,-0.6,IS,0.58,0.0,Phase3-EA-SA2v2-USDCHF-M15-107,USDCHFMT4,2876,4h 15m,Buy
159948.91,125.49,25.05.2017 07:59:57,sl 125.490,-1.69,-224.13000000000466,0.0,0.0,124.71,19.05.2017 22:00:00,14581,-0.08958998939294333,-64.58,IS,0.09,0.0,Phase3-EA-TR1v1-EURJPY-M30-91,EURJPYMT4,2606,5d 9h 59m,Sell
159971.64,1.09229,25.05.2017 10:30:00,,0.0,-201.39999999999418,0.0,0.0,1.09164,25.05.2017 01:45:00,14582,-0.08050427815882696,22.73,IS,0.34,0.0,Phase3-EA-S4v1-EURCHF-M15-221,EURCHFMT4,3754,8h 45m,Buy
160015.89,1.08947,26.05.2017 01:04:58,tp 1.08947,-2.11,-157.14999999999418,0.0,0.0,1.09057,25.05.2017 23:10:00,14583,-0.06281652091687961,44.25,IS,0.41,0.0,Phase3-EA-SA2v2-EURCHF-M5-43,EURCHFMT4,7404,1h 54m,Sell
160072.39,0.97218,26.05.2017 01:14:57,tp 0.97218,-3.16,-100.64999999999418,0.0,0.0,0.97318,25.05.2017 22:45:00,14584,-0.040232152913037236,56.5,IS,0.58,0.0,Phase3-EA-SA2v2-USDCHF-M15-107,USDCHFMT4,2878,2h 29m,Sell
159907.57,143711,26.05.2017 06:24:57,sl 143.711,0.0,-265.47000000000116,0.0,0.0,144511,26.05.2017 03:10:00,14585,-0.10611455175185952,-164.82,IS,0.23,0.0,Phase3-EA-S4v1-GBPJPY-M5-194,GBPJPYMT4,3176,3h 14m,Buy
159849.08,124795,26.05.2017 09:29:58,sl 124.795,-0.39,-323.95999999999185,0.0,0.0,125515,25.05.2017 10:00:00,14586,-0.12949436917742643,-58.49,IS,0.09,0.0,Phase3-EA-TR1v1-EURJPY-M30-91,EURJPYMT4,2608,23h 29m,Buy
159876.48,1.09011,26.05.2017 10:55:00,,0.0,-296.5599999999977,0.0,0.0,1.09076,26.05.2017 02:35:00,14587,-0.11854195000388396,27.4,IS,0.41,0.0,Phase3-EA-SA2v2-EURCHF-M5-43,EURCHFMT4,7406,8h 20m,Sell
159864.71,111206,29.05.2017 01:30:00,,-1.09,-308.3299999999872,0.0,0.0,111162,26.05.2017 17:00:00,14588,-0.12324669356857401,-11.77,IS,0.27,0.0,Phase3-EA-S1v2-USDJPY-M15-0,USDJPYMT4,4230,2d 8h 30m,Sell
159945.32,142788,29.05.2017 04:34:58,tp 142.788,0.0,-227.72000000000116,0.0,0.0,142398,29.05.2017 01:05:00,14589,-0.09102499613867279,80.61,IS,0.23,0.0,Phase3-EA-S4v1-GBPJPY-M5-194,GBPJPYMT4,3178,3h 29m,Buy
160004.76,0.97571,29.05.2017 04:44:58,tp 0.97571,0.0,-168.27999999999884,0.0,0.0,0.97471,29.05.2017 01:15:00,14590,-0.06726544155197468,59.44,IS,0.58,0.0,Phase3-EA-SA2v2-USDCHF-M15-107,USDCHFMT4,2880,3h 29m,Buy
160009.22,1089,29.05.2017 05:10:00,,-1.01,-163.82000000000698,0.0,0.0,1.08887,26.05.2017 20:50:00,14591,-0.06548267551132064,4.46,IS,0.41,0.0,Phase3-EA-SA2v2-EURCHF-M5-43,EURCHFMT4,7408,2d 8h 20m,Buy
159851.43,0.97894,30.05.2017 02:30:00,,-3.15,-321.61000000001513,0.0,0.0,0.97633,29.05.2017 22:15:00,14592,-0.1285550193578069,-157.79,IS,0.58,0.0,Phase3-EA-SA2v2-USDCHF-M15-107,USDCHFMT4,2882,4h 15m,Sell
160110.75,123.56,30.05.2017 05:14:58,tp 123.560,-1.06,-62.29000000000815,0.0,0.0,125.26,26.05.2017 03:30:00,14593,-0.024898766070080104,259.32,IS,0.17,0.0,Phase3-EA-T1v2-EURJPY-M15-322,EURJPYMT4,2836,4d 1h 44m,Sell
159944.86,141829,30.05.2017 05:14:58,sl 141.829,0.0,-228.18000000002212,0.0,0.0,142629,30.05.2017 02:30:00,14594,-0.09120886886933192,-165.89,IS,0.23,0.0,Phase3-EA-S4v1-GBPJPY-M5-194,GBPJPYMT4,3180,2h 44m,Buy
160046.47,123469,30.05.2017 05:29:58,tp 123.469,-0.56,-126.57000000003609,0.0,0.0,124729,26.05.2017 10:00:00,14595,-0.05059298156189637,101.61,IS,0.09,0.0,Phase3-EA-TR1v1-EURJPY-M30-91,EURJPYMT4,2610,3d 19h 29m,Sell
160102.31,1.08942,30.05.2017 10:30:00,,0.0,-70.73000000003958,0.0,0.0,1.09103,30.05.2017 01:45:00,14596,-0.02827243095420647,55.84,IS,0.34,0.0,Phase3-EA-S4v1-EURCHF-M15-221,EURCHFMT4,3756,8h 45m,Sell
160043.98,123986,30.05.2017 13:59:59,sl 123.986,0.0,-129.06000000002678,0.0,0.0,123266,30.05.2017 06:00:00,14597,-0.05158829264737172,-58.33,IS,0.09,0.0,Phase3-EA-TR1v1-EURJPY-M30-91,EURJPYMT4,2612,7h 59m,Sell
160090.24,1.09036,30.05.2017 21:59:58,tp 1.09036,0.0,-82.80000000001746,0.0,0.0,1.08926,30.05.2017 20:15:00,14598,-0.03309709151714236,46.26,IS,0.41,0.0,Phase3-EA-SA2v2-EURCHF-M5-43,EURCHFMT4,7410,1h 44m,Buy
160239.02,141801,31.05.2017 01:59:58,tp 141.801,-1.41,-0.0,0.0,0.0,143651,26.05.2017 09:00:00,14599,-0.0,148.78,IS,0.09,0.0,Phase3-EA-B1v1-GBPJPY-M30-1,GBPJPYMT4,1338,4d 16h 59m,Sell
160203.74,123747,31.05.2017 03:29:58,sl 123.747,0.0,-35.279999999998836,0.0,0.0,123977,31.05.2017 00:45:00,14600,-0.01409852068634169,-35.28,IS,0.17,0.0,Phase3-EA-T1v2-EURJPY-M15-322,EURJPYMT4,2838,2h 44m,Buy
160284.55,142321,31.05.2017 05:14:59,tp 142.321,0.0,-0.0,0.0,0.0,141931,31.05.2017 01:45:00,14601,-0.0,80.81,IS,0.23,0.0,Phase3-EA-S4v1-GBPJPY-M5-194,GBPJPYMT4,3182,3h 29m,Buy
160282.17,0.97549,31.05.2017 07:00:00,,0.0,-2.3800000000046566,0.0,0.0,0.97545,31.05.2017 02:45:00,14602,-9.509176655149703E-4,-2.38,IS,0.58,0.0,Phase3-EA-SA2v2-USDCHF-M15-107,USDCHFMT4,2884,4h 15m,Sell
160283.43,1.09023,31.05.2017 07:10:00,,-2.1,-1.1199999999953434,0.0,0.0,1.09031,30.05.2017 22:50:00,14603,-4.474906661219558E-4,1.26,IS,0.41,0.0,Phase3-EA-SA2v2-EURCHF-M5-43,EURCHFMT4,7412,8h 20m,Sell
160248.19,123825,31.05.2017 09:59:59,sl 123.825,0.0,-36.35999999998603,0.0,0.0,124055,31.05.2017 05:15:00,14604,-0.014527464839514028,-35.24,IS,0.17,0.0,Phase3-EA-T1v2-EURJPY-M15-322,EURJPYMT4,2840,4h 44m,Buy
160235.28,110882,31.05.2017 11:30:00,,0.0,-49.26999999998952,0.0,0.0,110829,31.05.2017 01:00:00,14605,-0.019685593857067626,-12.91,IS,0.27,0.0,Phase3-EA-S1v2-USDJPY-M15-0,USDJPYMT4,4232,10h 30m,Sell
160200.03,123959,31.05.2017 11:59:57,sl 123.959,0.0,-84.51999999998952,0.0,0.0,124189,31.05.2017 11:00:00,14606,-0.03376956348283953,-35.25,IS,0.17,0.0,Phase3-EA-T1v2-EURJPY-M15-322,EURJPYMT4,2842,59m 57s,Buy
160175.47,1.08879,01.06.2017 08:55:00,,0.0,-109.0799999999872,0.0,0.0,1.08821,01.06.2017 00:35:00,14607,-0.04358239451855371,-24.56,IS,0.41,0.0,Phase3-EA-SA2v2-EURCHF-M5-43,EURCHFMT4,7414,8h 20m,Sell
160258.85,124.78,01.06.2017 15:15:00,,-2.26,-25.699999999982538,0.0,0.0,124.22,31.05.2017 14:45:00,14608,-0.010268312606584167,83.38,IS,0.17,0.0,Phase3-EA-T1v2-EURJPY-M15-322,EURJPYMT4,2844,1d 0h 30m,Buy
160053.48,111.5,02.06.2017 04:14:58,sl 111.500,-4.38,-231.06999999997788,0.0,0.0,110.67,31.05.2017 23:15:00,14609,-0.09232291805466102,-205.37,IS,0.27,0.0,Phase3-EA-S1v2-USDJPY-M15-0,USDJPYMT4,4234,1d 4h 59m,Sell
160042.93,1.08948,02.06.2017 06:30:00,,-2.11,-241.61999999996624,0.0,0.0,1.08928,01.06.2017 22:10:00,14610,-0.09653812031144768,-10.55,IS,0.41,0.0,Phase3-EA-SA2v2-EURCHF-M5-43,EURCHFMT4,7416,8h 20m,Sell
160031.03,1.08966,02.06.2017 13:15:00,,0.0,-253.51999999996042,0.0,0.0,1.08932,02.06.2017 04:30:00,14611,-0.1012927086390109,-11.9,IS,0.34,0.0,Phase3-EA-S4v1-EURCHF-M15-221,EURCHFMT4,3758,8h 45m,Sell
160065.66,125076,02.06.2017 14:00:00,,-0.75,-218.88999999995576,0.0,0.0,124844,01.06.2017 21:00:00,14612,-0.08745645706055569,34.63,IS,0.17,0.0,Phase3-EA-T1v2-EURJPY-M15-322,EURJPYMT4,2846,17h 0m,Buy
160110.44,1.08604,05.06.2017 01:00:00,tp 1.08604,-2.13,-174.10999999995693,0.0,0.0,1.08714,02.06.2017 22:00:00,14613,-0.0695648213203557,44.78,IS,0.41,0.0,Phase3-EA-SA2v2-EURCHF-M5-43,EURCHFMT4,7418,2d 3h 0m,Sell
160105.82,110443,05.06.2017 02:00:00,,-0.71,-178.72999999995227,0.0,0.0,110459,02.06.2017 22:45:00,14614,-0.07141072031811459,-4.62,IS,0.27,0.0,Phase3-EA-S1v2-USDJPY-M15-0,USDJPYMT4,4236,2d 3h 15m,Buy
160120.27,0.96338,05.06.2017 05:30:00,,0.0,-164.27999999994063,0.0,0.0,0.96314,05.06.2017 01:15:00,14615,-0.06563729163463748,14.45,IS,0.58,0.0,Phase3-EA-SA2v2-USDCHF-M15-107,USDCHFMT4,2886,4h 15m,Buy
160084.91,124699,05.06.2017 09:14:58,sl 124.699,0.0,-199.63999999992666,0.0,0.0,124469,05.06.2017 04:30:00,14616,-0.07976521123654096,-35.36,IS,0.17,0.0,Phase3-EA-T1v2-EURJPY-M15-322,EURJPYMT4,2848,4h 44m,Sell
160109.57,1.08652,05.06.2017 09:25:00,,0.0,-174.97999999992317,0.0,0.0,1.08594,05.06.2017 01:05:00,14617,-0.06991242567706339,24.66,IS,0.41,0.0,Phase3-EA-SA2v2-EURCHF-M5-43,EURCHFMT4,7420,8h 20m,Buy
160154.18,1.0853,06.06.2017 01:00:00,tp 1.08530,-2.12,-130.36999999993714,0.0,0.0,1.0864,05.06.2017 20:15:00,14618,-0.05208871262726233,44.61,IS,0.41,0.0,Phase3-EA-SA2v2-EURCHF-M5-43,EURCHFMT4,7422,4h 45m,Sell
160144.81,1.08593,06.06.2017 09:40:00,,0.0,-139.73999999993248,0.0,0.0,1.08615,06.06.2017 01:20:00,14619,-0.055832451503671325,-9.37,IS,0.41,0.0,Phase3-EA-SA2v2-EURCHF-M5-43,EURCHFMT4,7424,8h 20m,Buy
160249.81,123362,06.06.2017 11:29:58,tp 123.362,-0.86,-34.73999999993248,0.0,0.0,124652,01.06.2017 10:30:00,14620,-0.01388020155456354,105.0,IS,0.09,0.0,Phase3-EA-TR1v1-EURJPY-M30-91,EURJPYMT4,2614,5d 0h 59m,Sell
160227.61,1.08497,06.06.2017 15:15:00,,0.0,-56.93999999994412,0.0,0.0,1.0856,06.06.2017 06:30:00,14621,-0.02275010582952241,-22.2,IS,0.34,0.0,Phase3-EA-S4v1-EURCHF-M15-221,EURCHFMT4,3760,8h 45m,Buy
160263.43,109289,06.06.2017 21:45:00,,0.0,-21.119999999937136,0.0,0.0,109434,06.06.2017 20:30:00,14622,-0.008438395418309706,35.82,IS,0.27,0.0,Phase3-EA-S1v2-USDJPY-M15-0,USDJPYMT4,4238,1h 15m,Sell
160261.98,1.0847,07.06.2017 04:20:00,,-1.02,-22.569999999948777,0.0,0.0,1.08471,06.06.2017 20:00:00,14623,-0.009017736012849654,-1.45,IS,0.41,0.0,Phase3-EA-SA2v2-EURCHF-M5-43,EURCHFMT4,7426,8h 20m,Buy
160242.69,141306,07.06.2017 04:35:00,,-1.22,-41.859999999956926,0.0,0.0,141.22,06.06.2017 23:10:00,14624,-0.016724963646360426,-19.29,IS,0.23,0.0,Phase3-EA-S4v1-GBPJPY-M5-194,GBPJPYMT4,3184,5h 25m,Sell
160505.67,122779,07.06.2017 14:29:58,tp 122.779,-1.08,-0.0,0.0,0.0,124479,05.06.2017 11:00:00,14625,-0.0,262.98,IS,0.17,0.0,Phase3-EA-T1v2-EURJPY-M15-322,EURJPYMT4,2850,2d 3h 29m,Sell
160536.26,1.08408,07.06.2017 14:45:00,,0.0,-0.0,0.0,0.0,1.08495,07.06.2017 06:00:00,14626,-0.0,30.59,IS,0.34,0.0,Phase3-EA-S4v1-EURCHF-M15-221,EURCHFMT4,3762,8h 45m,Sell
160542.67,109565,07.06.2017 20:15:00,,0.0,-0.0,0.0,0.0,109539,07.06.2017 20:00:00,14627,-0.0,6.41,IS,0.27,0.0,Phase3-EA-S1v2-USDJPY-M15-0,USDJPYMT4,4240,15m 0s,Buy
160583.02,1085,08.06.2017 01:04:57,tp 1.08500,-6.38,-0.0,0.0,0.0,1.0861,07.06.2017 22:25:00,14628,-0.0,40.35,IS,0.41,0.0,Phase3-EA-SA2v2-EURCHF-M5-43,EURCHFMT4,7428,2h 39m,Sell
160526.21,142439,08.06.2017 03:59:57,sl 142.439,-1.91,-56.80999999999767,0.0,0.0,141769,06.06.2017 10:00:00,14629,-0.022671129113216632,-56.81,IS,0.09,0.0,Phase3-EA-B1v1-GBPJPY-M30-1,GBPJPYMT4,1340,1d 17h 59m,Sell
160471.21,141807,08.06.2017 09:59:58,sl 141.807,0.0,-111.80999999999767,0.0,0.0,142477,08.06.2017 04:00:00,14630,-0.044619942723971184,-55.0,IS,0.09,0.0,Phase3-EA-B1v1-GBPJPY-M30-1,GBPJPYMT4,1342,5h 59m,Buy
160411.19,124001,08.06.2017 15:59:57,sl 124.001,-1.15,-171.8299999999872,0.0,0.0,123281,06.06.2017 11:30:00,14631,-0.06857208441337587,-60.02,IS,0.09,0.0,Phase3-EA-TR1v1-EURJPY-M30-91,EURJPYMT4,2616,2d 4h 29m,Sell
160462.63,110221,08.06.2017 18:00:00,,0.0,-120.38999999998487,0.0,0.0,110011,08.06.2017 17:15:00,14632,-0.04804395764724378,51.44,IS,0.27,0.0,Phase3-EA-S1v2-USDJPY-M15-0,USDJPYMT4,4242,45m 0s,Buy
160459.93,110161,08.06.2017 19:30:00,,0.0,-123.08999999999651,0.0,0.0,110172,08.06.2017 19:15:00,14633,-0.04912144486086729,-2.7,IS,0.27,0.0,Phase3-EA-S1v2-USDJPY-M15-0,USDJPYMT4,4244,15m 0s,Buy
160519.86,0.9678,08.06.2017 23:44:58,tp 0.96780,0.0,-63.16000000000349,0.0,0.0,0.9668,08.06.2017 23:00:00,14634,-0.025205219411915163,59.93,IS,0.58,0.0,Phase3-EA-SA2v2-USDCHF-M15-107,USDCHFMT4,2888,44m 58s,Buy
160601.43,140668,09.06.2017 02:24:58,tp 140.668,0.0,-0.0,0.0,0.0,140278,09.06.2017 01:10:00,14635,-0.0,81.57,IS,0.23,0.0,Phase3-EA-S4v1-GBPJPY-M5-194,GBPJPYMT4,3186,1h 14m,Buy
160569.52,1.08435,09.06.2017 07:15:00,,-1.02,-31.910000000003492,0.0,0.0,1.08508,08.06.2017 22:55:00,14636,-0.012733367084139692,-31.91,IS,0.41,0.0,Phase3-EA-SA2v2-EURCHF-M5-43,EURCHFMT4,7430,8h 20m,Buy
160575.49,1.08482,09.06.2017 10:00:00,,0.0,-25.94000000000233,0.0,0.0,1.08465,09.06.2017 01:15:00,14637,-0.010351098156144692,5.97,IS,0.34,0.0,Phase3-EA-S4v1-EURCHF-M15-221,EURCHFMT4,3764,8h 45m,Buy
160539.63,123723,09.06.2017 17:29:57,sl 123.723,-0.54,-61.79999999998836,0.0,0.0,123493,08.06.2017 20:00:00,14638,-0.024660673324963918,-35.86,IS,0.17,0.0,Phase3-EA-T1v2-EURJPY-M15-322,EURJPYMT4,2852,21h 29m,Sell
160504.18,123482,12.06.2017 04:14:57,sl 123.482,0.0,-97.25,0.0,0.0,123712,12.06.2017 02:15:00,14639,-0.03880664208500312,-35.45,IS,0.17,0.0,Phase3-EA-T1v2-EURJPY-M15-322,EURJPYMT4,2854,1h 59m,Buy
160528.19,110216,12.06.2017 04:45:00,,0.0,-73.23999999999069,0.0,0.0,110314,12.06.2017 01:15:00,14640,-0.02922569117023411,24.01,IS,0.27,0.0,Phase3-EA-S1v2-USDJPY-M15-0,USDJPYMT4,4246,3h 30m,Sell
160541.56,1.08543,12.06.2017 07:15:00,,-1.02,-59.86999999999534,0.0,0.0,1.08509,09.06.2017 22:55:00,14641,-0.02389052608358824,13.37,IS,0.41,0.0,Phase3-EA-SA2v2-EURCHF-M5-43,EURCHFMT4,7432,2d 8h 20m,Buy
160560.99,109785,12.06.2017 18:00:00,,0.0,-40.44000000000233,0.0,0.0,109864,12.06.2017 17:45:00,14642,-0.016137178467019193,19.43,IS,0.27,0.0,Phase3-EA-S1v2-USDJPY-M15-0,USDJPYMT4,4248,15m 0s,Sell
160579.68,109814,12.06.2017 19:00:00,,0.0,-21.75,0.0,0.0,109.89,12.06.2017 18:30:00,14643,-0.008679120466311752,18.69,IS,0.27,0.0,Phase3-EA-S1v2-USDJPY-M15-0,USDJPYMT4,4250,30m 0s,Sell
160588.81,1.08525,13.06.2017 06:40:00,,-1.02,-12.619999999995343,0.0,0.0,1.08501,12.06.2017 22:20:00,14644,-0.005035885070566156,9.13,IS,0.41,0.0,Phase3-EA-SA2v2-EURCHF-M5-43,EURCHFMT4,7434,8h 20m,Buy
160533.52,139668,13.06.2017 11:29:57,sl 139.668,-0.48,-67.91000000000349,0.0,0.0,138998,12.06.2017 18:00:00,14645,-0.02709880785596604,-55.29,IS,0.09,0.0,Phase3-EA-B1v1-GBPJPY-M30-1,GBPJPYMT4,1344,17h 29m,Sell
160497.49,123646,13.06.2017 11:59:58,sl 123.646,-0.54,-103.94000000000233,0.0,0.0,123416,12.06.2017 12:30:00,14646,-0.041476219828435114,-36.03,IS,0.17,0.0,Phase3-EA-T1v2-EURJPY-M15-322,EURJPYMT4,2856,23h 29m,Sell
160478.86,1.08426,13.06.2017 14:00:00,,0.0,-122.57000000000698,0.0,0.0,1.08479,13.06.2017 05:15:00,14647,-0.0489103354278571,-18.63,IS,0.34,0.0,Phase3-EA-S4v1-EURCHF-M15-221,EURCHFMT4,3766,8h 45m,Buy
160456.84,1.08577,14.06.2017 05:10:00,,-2.12,-144.5899999999965,0.0,0.0,1.0853,13.06.2017 20:50:00,14648,-0.05769719669995337,-22.02,IS,0.41,0.0,Phase3-EA-SA2v2-EURCHF-M5-43,EURCHFMT4,7436,8h 20m,Sell
160420.05,1.08711,14.06.2017 15:15:00,,0.0,-181.38000000000466,0.0,0.0,1.08606,14.06.2017 06:30:00,14649,-0.07237787908872027,-36.79,IS,0.34,0.0,Phase3-EA-S4v1-EURCHF-M15-221,EURCHFMT4,3768,8h 45m,Sell
160364.59,139396,14.06.2017 18:29:58,sl 139.396,-0.29,-236.8399999999965,0.0,0.0,140066,13.06.2017 14:30:00,14650,-0.0945086386777584,-55.46,IS,0.09,0.0,Phase3-EA-B1v1-GBPJPY-M30-1,GBPJPYMT4,1346,1d 3h 59m,Buy
160411.25,1.08919,14.06.2017 21:54:58,tp 1.08919,0.0,-190.17999999999302,0.0,0.0,1.09029,14.06.2017 21:05:00,14651,-0.07588943127738429,46.66,IS,0.41,0.0,Phase3-EA-SA2v2-EURCHF-M5-43,EURCHFMT4,7438,49m 58s,Sell
160369.25,1.27583,14.06.2017 22:59:58,sl 1.27583,0.0,-232.17999999999302,0.0,0.0,1.27883,14.06.2017 17:00:00,14652,-0.09264911217784837,-42.0,IS,0.14,0.0,Phase3-EA-B1v1-GBPUSD-M30-14,GBPUSDMT4,956,5h 59m,Buy
160317.61,109531,15.06.2017 11:15:00,,-3.32,-283.820000000007,0.0,0.0,109335,14.06.2017 22:15:00,14653,-0.11325553888499595,-51.64,IS,0.27,0.0,Phase3-EA-S1v2-USDJPY-M15-0,USDJPYMT4,4252,13h 0m,Sell
160271.42,1.08773,15.06.2017 12:00:00,,0.0,-330.0100000000093,0.0,0.0,1.08905,15.06.2017 03:15:00,14654,-0.13168719747529298,-46.19,IS,0.34,0.0,Phase3-EA-S4v1-EURCHF-M15-221,EURCHFMT4,3770,8h 45m,Buy
160234.4,123425,15.06.2017 18:44:57,sl 123.425,-1.63,-367.02999999999884,0.0,0.0,123195,14.06.2017 17:00:00,14655,-0.14645965906898356,-37.02,IS,0.17,0.0,Phase3-EA-T1v2-EURJPY-M15-322,EURJPYMT4,2858,1d 1h 44m,Sell
160263.59,110.99,16.06.2017 04:00:00,,0.0,-337.8399999999965,0.0,0.0,110.87,16.06.2017 01:45:00,14656,-0.1348116808431601,29.19,IS,0.27,0.0,Phase3-EA-S1v2-USDJPY-M15-0,USDJPYMT4,4254,2h 15m,Buy
160274.11,1.08686,16.06.2017 07:10:00,,-2.1,-327.320000000007,0.0,0.0,1.08716,15.06.2017 22:50:00,14657,-0.13061377981761946,10.52,IS,0.41,0.0,Phase3-EA-SA2v2-EURCHF-M5-43,EURCHFMT4,7440,8h 20m,Sell
160208.95,124309,16.06.2017 12:29:58,sl 124.309,-2.01,-392.4800000000105,0.0,0.0,123529,09.06.2017 22:30:00,14658,-0.15661522761462654,-65.16,IS,0.09,0.0,Phase3-EA-TR1v1-EURJPY-M30-91,EURJPYMT4,2618,6d 13h 59m,Sell
160253.19,1.08897,19.06.2017 01:04:58,tp 1.08897,-2.11,-348.2400000000198,0.0,0.0,1.09007,16.06.2017 20:00:00,14659,-0.13896169706614145,44.24,IS,0.41,0.0,Phase3-EA-SA2v2-EURCHF-M5-43,EURCHFMT4,7442,2d 5h 4m,Sell
160267.2,110774,19.06.2017 01:45:00,,-1.1,-334.2300000000105,0.0,0.0,110836,16.06.2017 23:00:00,14660,-0.13337114636576863,14.01,IS,0.27,0.0,Phase3-EA-S1v2-USDJPY-M15-0,USDJPYMT4,4256,2d 2h 45m,Sell
160228.93,0.97307,19.06.2017 03:15:00,,-0.72,-372.5,0.0,0.0,0.9737,16.06.2017 23:00:00,14661,-0.14864240798625875,-38.27,IS,0.58,0.0,Phase3-EA-SA2v2-USDCHF-M15-107,USDCHFMT4,2890,2d 4h 15m,Buy
160309.69,141931,19.06.2017 04:34:57,tp 141.931,0.0,-291.7399999999907,0.0,0.0,141541,19.06.2017 01:10:00,14662,-0.11641593585479125,80.76,IS,0.23,0.0,Phase3-EA-S4v1-GBPJPY-M5-194,GBPJPYMT4,3188,3h 24m,Buy
160324.0,1.09012,19.06.2017 09:25:00,,0.0,-277.429999999993,0.0,0.0,1.08978,19.06.2017 01:05:00,14663,-0.11070567314799121,14.31,IS,0.41,0.0,Phase3-EA-SA2v2-EURCHF-M5-43,EURCHFMT4,7444,8h 20m,Buy
160327.98,124278,19.06.2017 16:00:00,,0.0,-273.44999999998254,0.0,0.0,124252,19.06.2017 01:00:00,14664,-0.10911749386265733,3.98,IS,0.17,0.0,Phase3-EA-T1v2-EURJPY-M15-322,EURJPYMT4,2860,15h 0m,Buy
160384.34,0.97469,20.06.2017 01:14:58,tp 0.97469,-3.15,-217.0899999999965,0.0,0.0,0.97569,19.06.2017 23:30:00,14665,-0.08662759825432588,56.36,IS,0.58,0.0,Phase3-EA-SA2v2-USDCHF-M15-107,USDCHFMT4,2892,1h 44m,Sell
160366.22,142233,20.06.2017 07:55:00,,0.0,-235.20999999999185,0.0,0.0,142145,20.06.2017 02:30:00,14666,-0.09385820344280996,-18.12,IS,0.23,0.0,Phase3-EA-S4v1-GBPJPY-M5-194,GBPJPYMT4,3190,5h 25m,Sell
160388.89,1.08786,20.06.2017 10:15:00,,0.0,-212.53999999997905,0.0,0.0,1.08721,20.06.2017 01:30:00,14667,-0.08481196615676864,22.67,IS,0.34,0.0,Phase3-EA-S4v1-EURCHF-M15-221,EURCHFMT4,3772,8h 45m,Buy
160384.26,1.08774,20.06.2017 10:30:00,,0.0,-217.1699999999837,0.0,0.0,1.08763,20.06.2017 02:10:00,14668,-0.08665952145603593,-4.63,IS,0.41,0.0,Phase3-EA-SA2v2-EURCHF-M5-43,EURCHFMT4,7446,8h 20m,Sell
160390.2,1.08534,21.06.2017 13:15:00,,0.0,-211.22999999998137,0.0,0.0,1.08517,21.06.2017 04:30:00,14669,-0.08428922372868367,5.94,IS,0.34,0.0,Phase3-EA-S4v1-EURCHF-M15-221,EURCHFMT4,3774,8h 45m,Buy
160335.98,141092,21.06.2017 15:29:57,sl 141.092,0.0,-265.44999999998254,0.0,0.0,140422,21.06.2017 10:00:00,14670,-0.10592517369114036,-54.22,IS,0.09,0.0,Phase3-EA-B1v1-GBPJPY-M30-1,GBPJPYMT4,1348,5h 29m,Sell
160352.68,0.97255,22.06.2017 05:15:00,,0.0,-248.7499999999709,0.0,0.0,0.97227,22.06.2017 01:00:00,14671,-0.09926120533309406,16.7,IS,0.58,0.0,Phase3-EA-SA2v2-USDCHF-M15-107,USDCHFMT4,2894,4h 15m,Buy
160371.14,1.08585,22.06.2017 05:40:00,,-3.04,-230.28999999997905,0.0,0.0,1.08534,21.06.2017 21:20:00,14672,-0.09189492653732191,18.46,IS,0.41,0.0,Phase3-EA-SA2v2-EURCHF-M5-43,EURCHFMT4,7448,8h 20m,Buy
160310.74,111174,22.06.2017 14:15:00,,-2.11,-290.6899999999732,0.0,0.0,111414,21.06.2017 20:45:00,14673,-0.11599694383227269,-60.4,IS,0.27,0.0,Phase3-EA-S1v2-USDJPY-M15-0,USDJPYMT4,4258,17h 30m,Buy
160275.59,124164,22.06.2017 18:44:58,sl 124.164,0.0,-325.8399999999674,0.0,0.0,123934,22.06.2017 17:45:00,14674,-0.13002320058587302,-35.15,IS,0.17,0.0,Phase3-EA-T1v2-EURJPY-M15-322,EURJPYMT4,2862,59m 58s,Sell
160253.9,124097,22.06.2017 23:15:00,,0.0,-347.52999999996973,0.0,0.0,124239,22.06.2017 19:00:00,14675,-0.13867837865089933,-21.69,IS,0.17,0.0,Phase3-EA-T1v2-EURJPY-M15-322,EURJPYMT4,2864,4h 15m,Buy
160239.45,0.97173,23.06.2017 03:45:00,,-0.72,-361.9799999999814,0.0,0.0,0.97196,22.06.2017 23:30:00,14676,-0.1444445069607065,-14.45,IS,0.58,0.0,Phase3-EA-SA2v2-USDCHF-M15-107,USDCHFMT4,2896,4h 15m,Buy
160262.0,111359,23.06.2017 04:30:00,,0.0,-339.429999999993,0.0,0.0,111266,23.06.2017 00:15:00,14677,-0.1354461544772477,22.55,IS,0.27,0.0,Phase3-EA-S1v2-USDJPY-M15-0,USDJPYMT4,4260,4h 15m,Buy
160228.08,1.08343,23.06.2017 05:00:00,,-1.01,-373.3500000000058,0.0,0.0,1.08421,22.06.2017 20:40:00,14678,-0.14898159200448474,-33.92,IS,0.41,0.0,Phase3-EA-SA2v2-EURCHF-M5-43,EURCHFMT4,7450,8h 20m,Buy
160229.83,1.0836,23.06.2017 10:00:00,,0.0,-371.6000000000058,0.0,0.0,1.08355,23.06.2017 01:15:00,14679,-0.1482832719669654,1.75,IS,0.34,0.0,Phase3-EA-S4v1-EURCHF-M15-221,EURCHFMT4,3776,8h 45m,Buy
160276.36,1.08527,26.06.2017 02:29:57,tp 1.08527,0.0,-325.070000000007,0.0,0.0,1.08417,26.06.2017 01:10:00,14680,-0.1297159397693803,46.53,IS,0.41,0.0,Phase3-EA-SA2v2-EURCHF-M5-43,EURCHFMT4,7452,1h 19m,Buy
160331.09,124526,26.06.2017 03:00:00,,-0.75,-270.3399999999965,0.0,0.0,124163,23.06.2017 05:15:00,14681,-0.10787647939598569,54.73,IS,0.17,0.0,Phase3-EA-T1v2-EURJPY-M15-322,EURJPYMT4,2866,2d 21h 45m,Buy
160429.31,124885,26.06.2017 11:29:58,tp 124.885,-3.59,-172.11999999999534,0.0,0.0,123625,15.06.2017 22:30:00,14682,-0.06868276849018567,98.22,IS,0.09,0.0,Phase3-EA-TR1v1-EURJPY-M30-91,EURJPYMT4,2619,10d 12h 59m,Buy
160387.31,1.27151,26.06.2017 13:59:57,sl 1.27151,0.0,-214.11999999999534,0.0,0.0,1.27451,26.06.2017 10:00:00,14683,-0.08544244939064974,-42.0,IS,0.14,0.0,Phase3-EA-B1v1-GBPUSD-M30-14,GBPUSDMT4,958,3h 59m,Buy
160446.78,111.69,26.06.2017 21:00:00,,0.0,-154.64999999999418,0.0,0.0,111444,26.06.2017 17:00:00,14684,-0.06171153931563503,59.47,IS,0.27,0.0,Phase3-EA-S1v2-USDJPY-M15-0,USDJPYMT4,4262,4h 0m,Buy
160503.31,0.97163,27.06.2017 01:14:58,tp 0.97163,-3.16,-98.11999999999534,0.0,0.0,0.97263,26.06.2017 22:45:00,14685,-0.039153806903653735,56.53,IS,0.58,0.0,Phase3-EA-SA2v2-USDCHF-M15-107,USDCHFMT4,2898,2h 29m,Sell
160518.75,1.08713,27.06.2017 04:25:00,,-1.01,-82.67999999999302,0.0,0.0,1.08674,26.06.2017 20:05:00,14686,-0.03299262897262506,15.44,IS,0.41,0.0,Phase3-EA-SA2v2-EURCHF-M5-43,EURCHFMT4,7454,8h 20m,Buy
160570.51,1.08823,27.06.2017 10:15:00,,0.0,-30.919999999983702,0.0,0.0,1.08675,27.06.2017 01:30:00,14687,-0.01233831746290657,51.76,IS,0.34,0.0,Phase3-EA-S4v1-EURCHF-M15-221,EURCHFMT4,3778,8h 45m,Buy
160619.24,124972,27.06.2017 11:00:00,,-0.74,-0.0,0.0,0.0,124647,26.06.2017 04:30:00,14688,-0.0,48.73,IS,0.17,0.0,Phase3-EA-T1v2-EURJPY-M15-322,EURJPYMT4,2868,1d 6h 30m,Buy
160556.04,125605,27.06.2017 13:29:58,sl 125.605,-0.28,-63.20000000001164,0.0,0.0,124825,26.06.2017 15:30:00,14689,-0.025217537169138094,-63.2,IS,0.09,0.0,Phase3-EA-TR1v1-EURJPY-M30-91,EURJPYMT4,2622,21h 59m,Sell
160813.05,127167,27.06.2017 19:59:58,tp 127.167,0.0,-0.0,0.0,0.0,125467,27.06.2017 12:45:00,14690,-0.0,257.01,IS,0.17,0.0,Phase3-EA-T1v2-EURJPY-M15-322,EURJPYMT4,2870,7h 14m,Buy
160872.71,0.96035,28.06.2017 00:59:58,tp 0.96035,-0.73,-0.0,0.0,0.0,0.95935,27.06.2017 23:15:00,14691,-0.0,59.66,IS,0.58,0.0,Phase3-EA-SA2v2-USDCHF-M15-107,USDCHFMT4,2900,1h 44m,Buy
160905.37,143615,28.06.2017 04:50:00,,-1.19,-0.0,0.0,0.0,143.78,27.06.2017 23:25:00,14692,-0.0,32.66,IS,0.23,0.0,Phase3-EA-S4v1-GBPJPY-M5-194,GBPJPYMT4,3192,5h 25m,Sell
160918.39,112201,28.06.2017 09:30:00,,-0.7,-0.0,0.0,0.0,112144,27.06.2017 22:15:00,14693,-0.0,13.02,IS,0.27,0.0,Phase3-EA-S1v2-USDJPY-M15-0,USDJPYMT4,4264,11h 15m,Buy
161019.14,127624,28.06.2017 10:29:58,tp 127.624,-0.39,-0.0,0.0,0.0,126364,27.06.2017 18:30:00,14694,-0.0,100.75,IS,0.09,0.0,Phase3-EA-TR1v1-EURJPY-M30-91,EURJPYMT4,2624,15h 59m,Buy
161083.31,1.09036,28.06.2017 10:30:00,,0.0,-0.0,0.0,0.0,1.08855,28.06.2017 01:45:00,14695,-0.0,64.17,IS,0.34,0.0,Phase3-EA-S4v1-EURCHF-M15-221,EURCHFMT4,3780,8h 45m,Buy
161048.37,127.09,28.06.2017 16:29:58,sl 127.090,0.0,-34.94000000000233,0.0,0.0,127.32,28.06.2017 09:15:00,14696,-0.013915699932425694,-34.94,IS,0.17,0.0,Phase3-EA-T1v2-EURJPY-M15-322,EURJPYMT4,2872,7h 14m,Buy
161196.33,144242,28.06.2017 17:59:58,tp 144.242,-0.29,-0.0,0.0,0.0,142392,27.06.2017 04:30:00,14697,-0.0,147.96,IS,0.09,0.0,Phase3-EA-B1v1-GBPJPY-M30-1,GBPJPYMT4,1350,1d 13h 29m,Buy
161161.47,127381,28.06.2017 18:59:58,sl 127.381,0.0,-34.85999999998603,0.0,0.0,127611,28.06.2017 18:45:00,14698,-0.01387759128486706,-34.86,IS,0.17,0.0,Phase3-EA-T1v2-EURJPY-M15-322,EURJPYMT4,2874,14m 58s,Buy
161160.27,112136,28.06.2017 19:00:00,,0.0,-36.05999999999767,0.0,0.0,112131,28.06.2017 17:30:00,14699,-0.014355305270581596,-1.2,IS,0.27,0.0,Phase3-EA-S1v2-USDJPY-M15-0,USDJPYMT4,4266,1h 30m,Sell
161177.59,112218,28.06.2017 20:45:00,,0.0,-18.739999999990687,0.0,0.0,112146,28.06.2017 19:30:00,14700,-0.007460300076832578,17.32,IS,0.27,0.0,Phase3-EA-S1v2-USDJPY-M15-0,USDJPYMT4,4268,1h 15m,Buy
161218.23,1.0908,29.06.2017 01:04:57,tp 1.09080,-6.41,-0.0,0.0,0.0,1.0919,28.06.2017 20:00:00,14701,-0.0,40.64,IS,0.41,0.0,Phase3-EA-SA2v2-EURCHF-M5-43,EURCHFMT4,7456,5h 4m,Sell
161157.02,1.09318,29.06.2017 10:15:00,,0.0,-61.20999999999185,0.0,0.0,1.09175,29.06.2017 01:55:00,14702,-0.024365269988563976,-61.21,IS,0.41,0.0,Phase3-EA-SA2v2-EURCHF-M5-43,EURCHFMT4,7458,8h 20m,Sell
161093.67,128194,29.06.2017 11:29:57,sl 128.194,-0.84,-124.55999999999767,0.0,0.0,127414,28.06.2017 12:30:00,14703,-0.04958238898506578,-63.35,IS,0.09,0.0,Phase3-EA-TR1v1-EURJPY-M30-91,EURJPYMT4,2626,22h 59m,Sell
161057.48,1.09316,29.06.2017 15:00:00,,0.0,-160.75,0.0,0.0,1.09214,29.06.2017 06:15:00,14704,-0.06398819066593989,-36.19,IS,0.34,0.0,Phase3-EA-S4v1-EURCHF-M15-221,EURCHFMT4,3782,8h 45m,Sell
161102.52,1.09261,30.06.2017 01:00:00,tp 1.09261,-2.14,-115.70999999999185,0.0,0.0,1.09371,29.06.2017 21:55:00,14705,-0.04605955547095106,45.04,IS,0.41,0.0,Phase3-EA-SA2v2-EURCHF-M5-43,EURCHFMT4,7460,3h 5m,Sell
161100.47,145802,30.06.2017 05:50:00,,0.0,-117.75999999998021,0.0,0.0,145792,30.06.2017 00:25:00,14706,-0.046875579053311446,-2.05,IS,0.23,0.0,Phase3-EA-S4v1-GBPJPY-M5-194,GBPJPYMT4,3194,5h 25m,Sell
160899.31,111791,30.06.2017 06:14:57,sl 111.791,-0.7,-318.9199999999837,0.0,0.0,112621,29.06.2017 18:00:00,14707,-0.1269493857989456,-201.16,IS,0.27,0.0,Phase3-EA-S1v2-USDJPY-M15-0,USDJPYMT4,4270,12h 14m,Buy
160901.79,1.09308,30.06.2017 12:45:00,,0.0,-316.4399999999732,0.0,0.0,1.09301,30.06.2017 04:00:00,14708,-0.1259621962944218,2.48,IS,0.34,0.0,Phase3-EA-S4v1-EURCHF-M15-221,EURCHFMT4,3784,8h 45m,Buy
160980.43,146088,03.07.2017 01:00:00,tp 146.088,-1.19,-237.79999999995925,0.0,0.0,146478,30.06.2017 23:05:00,14709,-0.09465873555432595,78.64,IS,0.23,0.0,Phase3-EA-S4v1-GBPJPY-M5-194,GBPJPYMT4,3196,2d 1h 55m,Sell
161025.38,1.09283,03.07.2017 01:04:57,tp 1.09283,-2.14,-192.8499999999476,0.0,0.0,1.09393,30.06.2017 20:25:00,14710,-0.07676592578490299,44.95,IS,0.41,0.0,Phase3-EA-SA2v2-EURCHF-M5-43,EURCHFMT4,7462,2d 4h 39m,Sell
161085.88,0.95868,03.07.2017 01:29:58,tp 0.95868,0.0,-132.3499999999476,0.0,0.0,0.95768,03.07.2017 01:00:00,14711,-0.05268327859803292,60.5,IS,0.58,0.0,Phase3-EA-SA2v2-USDCHF-M15-107,USDCHFMT4,2902,29m 58s,Buy
161146.36,0.95902,03.07.2017 03:14:58,tp 0.95902,0.0,-71.86999999993714,0.0,0.0,0.95802,03.07.2017 01:30:00,14712,-0.028608592616840293,60.48,IS,0.58,0.0,Phase3-EA-SA2v2-USDCHF-M15-107,USDCHFMT4,2904,1h 44m,Buy
161118.95,128198,03.07.2017 04:30:00,,0.0,-99.27999999994063,0.0,0.0,128379,03.07.2017 03:15:00,14713,-0.0395194250034881,-27.41,IS,0.17,0.0,Phase3-EA-T1v2-EURJPY-M15-322,EURJPYMT4,2876,1h 15m,Buy
161139.22,146.12,03.07.2017 06:40:00,,0.0,-79.0099999999511,0.0,0.0,146021,03.07.2017 01:15:00,14714,-0.0314507430451806,20.27,IS,0.23,0.0,Phase3-EA-S4v1-GBPJPY-M5-194,GBPJPYMT4,3198,5h 25m,Buy
161214.15,112426,03.07.2017 07:00:00,,0.0,-4.0799999999580905,0.0,0.0,112114,03.07.2017 01:00:00,14715,-0.001624085959031745,74.93,IS,0.27,0.0,Phase3-EA-S1v2-USDJPY-M15-0,USDJPYMT4,4272,6h 0m,Buy
161229.53,1.09445,03.07.2017 10:35:00,,0.0,-0.0,0.0,0.0,1.09481,03.07.2017 02:15:00,14716,-0.0,15.38,IS,0.41,0.0,Phase3-EA-SA2v2-EURCHF-M5-43,EURCHFMT4,7464,8h 20m,Sell
161324.46,1.09263,03.07.2017 12:15:00,,0.0,-0.0,0.0,0.0,1.09531,03.07.2017 03:30:00,14717,-0.0,94.93,IS,0.34,0.0,Phase3-EA-S4v1-EURCHF-M15-221,EURCHFMT4,3786,8h 45m,Sell
161336.64,113035,03.07.2017 17:15:00,,0.0,-0.0,0.0,0.0,112984,03.07.2017 17:00:00,14718,-0.0,12.18,IS,0.27,0.0,Phase3-EA-S1v2-USDJPY-M15-0,USDJPYMT4,4274,15m 0s,Buy
161325.57,1.09529,04.07.2017 04:30:00,,-2.13,-11.070000000006985,0.0,0.0,1.09508,03.07.2017 20:10:00,14719,-0.004404451336664221,-11.07,IS,0.41,0.0,Phase3-EA-SA2v2-EURCHF-M5-43,EURCHFMT4,7466,8h 20m,Sell
161356.24,146.66,04.07.2017 05:40:00,,0.0,-0.0,0.0,0.0,146811,04.07.2017 00:15:00,14720,-0.0,30.67,IS,0.23,0.0,Phase3-EA-S4v1-GBPJPY-M5-194,GBPJPYMT4,3200,5h 25m,Sell
161344.2,0.96325,04.07.2017 05:45:00,,0.0,-12.040000000008149,0.0,0.0,0.96345,04.07.2017 01:30:00,14721,-0.004790014363680846,-12.04,IS,0.58,0.0,Phase3-EA-SA2v2-USDCHF-M15-107,USDCHFMT4,2906,4h 15m,Buy
161308.86,128112,04.07.2017 09:59:57,sl 128.112,-0.73,-47.38000000000466,0.0,0.0,128342,03.07.2017 08:15:00,14722,-0.018849740909557076,-35.34,IS,0.17,0.0,Phase3-EA-T1v2-EURJPY-M15-322,EURJPYMT4,2878,1d 1h 44m,Buy
161258.79,113231,04.07.2017 23:45:00,,0.0,-97.45000000001164,0.0,0.0,113441,04.07.2017 01:15:00,14723,-0.03876967605817593,-50.07,IS,0.27,0.0,Phase3-EA-S1v2-USDJPY-M15-0,USDJPYMT4,4276,22h 30m,Buy
161303.38,1.09454,05.07.2017 01:00:00,tp 1.09454,-2.12,-52.860000000015134,0.0,0.0,1.09564,04.07.2017 20:35:00,14724,-0.021029913560138756,44.59,IS,0.41,0.0,Phase3-EA-SA2v2-EURCHF-M5-43,EURCHFMT4,7468,4h 25m,Sell
161322.09,146229,05.07.2017 08:20:00,,0.0,-34.15000000002328,0.0,0.0,146137,05.07.2017 02:55:00,14725,-0.013586294893662932,18.71,IS,0.23,0.0,Phase3-EA-S4v1-GBPJPY-M5-194,GBPJPYMT4,3202,5h 25m,Buy
161287.54,128616,05.07.2017 10:14:58,sl 128.616,0.0,-68.70000000001164,0.0,0.0,128386,05.07.2017 03:15:00,14726,-0.027331726477135145,-34.55,IS,0.17,0.0,Phase3-EA-T1v2-EURJPY-M15-322,EURJPYMT4,2880,6h 59m,Sell
161321.37,1.09564,05.07.2017 10:15:00,,0.0,-34.87000000002445,0.0,0.0,1.09468,05.07.2017 01:30:00,14727,-0.013872740935345112,33.83,IS,0.34,0.0,Phase3-EA-S4v1-EURCHF-M15-221,EURCHFMT4,3788,8h 45m,Buy
161279.37,1.29147,05.07.2017 10:29:58,sl 1.29147,0.0,-76.87000000002445,0.0,0.0,1.29447,05.07.2017 06:00:00,14728,-0.030582093366778616,-42.0,IS,0.14,0.0,Phase3-EA-B1v1-GBPUSD-M30-14,GBPUSDMT4,960,4h 29m,Buy
161237.37,1.29316,05.07.2017 19:59:58,sl 1.29316,0.0,-118.87000000002445,0.0,0.0,1.29016,05.07.2017 11:30:00,14729,-0.047291445798212116,-42.0,IS,0.14,0.0,Phase3-EA-B1v1-GBPUSD-M30-14,GBPUSDMT4,962,8h 29m,Sell
161297.47,0.96511,06.07.2017 04:29:57,tp 0.96511,0.0,-58.77000000001863,0.0,0.0,0.96411,06.07.2017 01:15:00,14730,-0.023381158152277575,60.1,IS,0.58,0.0,Phase3-EA-SA2v2-USDCHF-M15-107,USDCHFMT4,2908,3h 14m,Buy
161302.06,1.09426,06.07.2017 04:35:00,,-3.06,-54.18000000002212,0.0,0.0,1.09408,05.07.2017 20:15:00,14731,-0.021555064636558017,4.59,IS,0.41,0.0,Phase3-EA-SA2v2-EURCHF-M5-43,EURCHFMT4,7470,8h 20m,Buy
161198.59,113168,06.07.2017 10:30:00,,-2.07,-157.65000000002328,0.0,0.0,113593,05.07.2017 17:30:00,14732,-0.06271974787656859,-103.47,IS,0.27,0.0,Phase3-EA-S1v2-USDJPY-M15-0,USDJPYMT4,4278,17h 0m,Buy
161343.48,147127,06.07.2017 13:59:58,tp 147.127,-2.02,-12.760000000009313,0.0,0.0,145277,29.06.2017 02:30:00,14733,-0.005076460405363027,144.89,IS,0.09,0.0,Phase3-EA-B1v1-GBPJPY-M30-1,GBPJPYMT4,1352,7d 11h 29m,Buy
161440.79,129.32,06.07.2017 20:59:59,tp 129.320,-2.73,-0.0,0.0,0.0,128.06,29.06.2017 06:30:00,14734,-0.0,97.31,IS,0.09,0.0,Phase3-EA-TR1v1-EURJPY-M30-91,EURJPYMT4,2627,7d 14h 29m,Buy
161487.7,1.09775,06.07.2017 22:44:58,tp 1.09775,0.0,-0.0,0.0,0.0,1.09885,06.07.2017 20:05:00,14735,-0.0,46.91,IS,0.41,0.0,Phase3-EA-SA2v2-EURCHF-M5-43,EURCHFMT4,7472,2h 39m,Sell
161448.33,0.9604,07.07.2017 03:15:00,,-0.72,-39.36999999999534,0.0,0.0,0.96104,06.07.2017 23:00:00,14736,-0.015654841171156755,-39.37,IS,0.58,0.0,Phase3-EA-SA2v2-USDCHF-M15-107,USDCHFMT4,2910,4h 15m,Buy
161414.88,1.09684,07.07.2017 07:10:00,,-1.02,-72.82000000000698,0.0,0.0,1.0976,06.07.2017 22:50:00,14737,-0.028955690477111485,-33.45,IS,0.41,0.0,Phase3-EA-SA2v2-EURCHF-M5-43,EURCHFMT4,7474,8h 20m,Buy
161353.2,130008,07.07.2017 11:29:58,sl 130.008,0.0,-134.5,0.0,0.0,129228,07.07.2017 04:00:00,14738,-0.05348174085651086,-61.68,IS,0.09,0.0,Phase3-EA-TR1v1-EURJPY-M30-91,EURJPYMT4,2630,7h 29m,Sell
161397.88,1.09812,10.07.2017 01:00:00,tp 1.09812,-2.13,-89.82000000000698,0.0,0.0,1.09922,07.07.2017 20:25:00,14739,-0.03571546441436564,44.68,IS,0.41,0.0,Phase3-EA-SA2v2-EURCHF-M5-43,EURCHFMT4,7476,2d 4h 35m,Sell
161444.68,1.09843,10.07.2017 01:25:00,tp 1.09843,0.0,-43.02000000001863,0.0,0.0,1.09733,10.07.2017 01:05:00,14740,-0.017106204398870582,46.8,IS,0.41,0.0,Phase3-EA-SA2v2-EURCHF-M5-43,EURCHFMT4,7478,20m 0s,Buy
161434.54,129964,10.07.2017 04:00:00,,0.0,-53.160000000032596,0.0,0.0,130032,10.07.2017 02:30:00,14741,-0.021138210735567736,-10.14,IS,0.17,0.0,Phase3-EA-T1v2-EURJPY-M15-322,EURJPYMT4,2882,1h 30m,Buy
161432.62,0.9635,10.07.2017 04:00:00,,-0.72,-55.0800000000454,0.0,0.0,0.96352,07.07.2017 23:45:00,14742,-0.021901667556721537,-1.92,IS,0.58,0.0,Phase3-EA-SA2v2-USDCHF-M15-107,USDCHFMT4,2912,2d 4h 15m,Buy
161458.67,114097,10.07.2017 05:00:00,,-0.69,-29.030000000057044,0.0,0.0,113984,07.07.2017 23:00:00,14743,-0.0115433080822867,26.05,IS,0.27,0.0,Phase3-EA-S1v2-USDJPY-M15-0,USDJPYMT4,4280,2d 6h 0m,Buy
161537.22,147.18,10.07.2017 05:04:58,tp 147.180,0.0,-0.0,0.0,0.0,146.79,10.07.2017 01:20:00,14744,-0.0,78.55,IS,0.23,0.0,Phase3-EA-S4v1-GBPJPY-M5-194,GBPJPYMT4,3204,3h 44m,Buy
161580.26,1.09934,10.07.2017 10:00:00,,0.0,-0.0,0.0,0.0,1.09812,10.07.2017 01:15:00,14745,-0.0,43.04,IS,0.34,0.0,Phase3-EA-S4v1-EURCHF-M15-221,EURCHFMT4,3790,8h 45m,Buy
161616.18,147051,11.07.2017 04:55:00,,-0.73,-0.0,0.0,0.0,146869,10.07.2017 23:30:00,14746,-0.0,35.92,IS,0.23,0.0,Phase3-EA-S4v1-GBPJPY-M5-194,GBPJPYMT4,3206,5h 25m,Buy
161583.77,0.96643,11.07.2017 06:45:00,,0.0,-32.41000000000349,0.0,0.0,0.96589,11.07.2017 02:30:00,14747,-0.012880729689165208,-32.41,IS,0.58,0.0,Phase3-EA-SA2v2-USDCHF-M15-107,USDCHFMT4,2914,4h 15m,Sell
161549.6,130276,11.07.2017 09:14:59,sl 130.276,0.0,-66.5800000000163,0.0,0.0,130046,11.07.2017 06:30:00,14748,-0.026460937448464582,-34.17,IS,0.17,0.0,Phase3-EA-T1v2-EURJPY-M15-322,EURJPYMT4,2884,2h 44m,Sell
161463.59,1.1034,11.07.2017 13:45:00,,0.0,-152.5900000000256,0.0,0.0,1.10095,11.07.2017 05:00:00,14749,-0.06064395381887804,-86.01,IS,0.34,0.0,Phase3-EA-S4v1-EURCHF-M15-221,EURCHFMT4,3792,8h 45m,Sell
161401.63,130521,11.07.2017 16:59:57,sl 130.521,-0.56,-214.55000000001746,0.0,0.0,129741,07.07.2017 15:00:00,14750,-0.08526876133324043,-61.96,IS,0.09,0.0,Phase3-EA-TR1v1-EURJPY-M30-91,EURJPYMT4,2632,4d 1h 59m,Sell
161461.81,0.96383,11.07.2017 23:44:57,tp 0.96383,0.0,-154.37000000002445,0.0,0.0,0.96283,11.07.2017 22:45:00,14751,-0.06135138050344134,60.18,IS,0.58,0.0,Phase3-EA-SA2v2-USDCHF-M15-107,USDCHFMT4,2916,59m 57s,Buy
161480.31,113862,12.07.2017 02:45:00,,0.0,-135.87000000002445,0.0,0.0,113.94,12.07.2017 01:30:00,14752,-0.053998912152638176,18.5,IS,0.27,0.0,Phase3-EA-S1v2-USDJPY-M15-0,USDJPYMT4,4282,1h 15m,Sell
161500.3,1.10457,12.07.2017 10:55:00,,0.0,-115.88000000003376,0.0,0.0,1.10504,12.07.2017 02:35:00,14753,-0.046054272026557805,19.99,IS,0.41,0.0,Phase3-EA-SA2v2-EURCHF-M5-43,EURCHFMT4,7480,8h 20m,Sell
161564.54,1.10339,12.07.2017 13:15:00,,0.0,-51.640000000043074,0.0,0.0,1.10521,12.07.2017 04:30:00,14754,-0.020523322466799585,64.24,IS,0.34,0.0,Phase3-EA-S4v1-EURCHF-M15-221,EURCHFMT4,3794,8h 45m,Sell
161511.39,146208,12.07.2017 15:59:58,sl 146.208,0.0,-104.79000000003725,0.0,0.0,145538,12.07.2017 10:30:00,14755,-0.04164676532329394,-53.15,IS,0.09,0.0,Phase3-EA-B1v1-GBPJPY-M30-1,GBPJPYMT4,1354,5h 29m,Sell
161613.9,129122,12.07.2017 17:29:58,tp 129.122,-0.28,-2.2800000000279397,0.0,0.0,130412,11.07.2017 20:30:00,14756,-9.061420454073864E-4,102.51,IS,0.09,0.0,Phase3-EA-TR1v1-EURJPY-M30-91,EURJPYMT4,2634,20h 59m,Sell
161582.86,1.10223,13.07.2017 06:50:00,,-6.37,-33.32000000003609,0.0,0.0,1.10165,12.07.2017 22:30:00,14757,-0.013242391645893347,-31.04,IS,0.41,0.0,Phase3-EA-SA2v2-EURCHF-M5-43,EURCHFMT4,7482,8h 20m,Sell
161632.67,113035,13.07.2017 07:00:00,,-3.22,-0.0,0.0,0.0,113257,12.07.2017 21:30:00,14758,-0.0,49.81,IS,0.27,0.0,Phase3-EA-S1v2-USDJPY-M15-0,USDJPYMT4,4284,9h 30m,Sell
161598.08,129387,13.07.2017 09:59:58,sl 129.387,0.0,-34.58999999999651,0.0,0.0,129157,13.07.2017 07:45:00,14759,-0.013746227785126781,-34.59,IS,0.17,0.0,Phase3-EA-T1v2-EURJPY-M15-322,EURJPYMT4,2886,2h 14m,Sell
161671.37,1.0999,13.07.2017 13:15:00,,0.0,-0.0,0.0,0.0,1.10198,13.07.2017 04:30:00,14760,-0.0,73.29,IS,0.34,0.0,Phase3-EA-S4v1-EURCHF-M15-221,EURCHFMT4,3796,8h 45m,Sell
161608.02,128507,13.07.2017 14:59:58,sl 128.507,-1.17,-63.35000000000582,0.0,0.0,129287,12.07.2017 23:00:00,14761,-0.02517171500278541,-63.35,IS,0.09,0.0,Phase3-EA-TR1v1-EURJPY-M30-91,EURJPYMT4,2636,15h 59m,Buy
161620.2,113309,14.07.2017 02:45:00,,-0.69,-51.170000000012806,0.0,0.0,113255,13.07.2017 21:15:00,14762,-0.020332070350319392,12.18,IS,0.27,0.0,Phase3-EA-S1v2-USDJPY-M15-0,USDJPYMT4,4286,5h 30m,Buy
161636.87,0.96717,14.07.2017 03:15:00,,-0.72,-34.5,0.0,0.0,0.96688,13.07.2017 23:00:00,14763,-0.01370835307965299,16.67,IS,0.58,0.0,Phase3-EA-SA2v2-USDCHF-M15-107,USDCHFMT4,2918,4h 15m,Buy
161601.85,129311,14.07.2017 03:44:58,sl 129.311,-0.53,-69.51999999998952,0.0,0.0,129081,13.07.2017 20:45:00,14764,-0.02762332481441543,-35.02,IS,0.17,0.0,Phase3-EA-T1v2-EURJPY-M15-322,EURJPYMT4,2888,6h 59m,Sell
161621.61,1.10272,14.07.2017 05:55:00,,-1.02,-49.75999999998021,0.0,0.0,1.10223,13.07.2017 21:35:00,14765,-0.019771815920094537,19.76,IS,0.41,0.0,Phase3-EA-SA2v2-EURCHF-M5-43,EURCHFMT4,7484,8h 20m,Buy
161592.01,146906,14.07.2017 08:50:00,,0.0,-79.35999999998603,0.0,0.0,146.76,14.07.2017 03:25:00,14766,-0.03153318551887159,-29.6,IS,0.23,0.0,Phase3-EA-S4v1-GBPJPY-M5-194,GBPJPYMT4,3208,5h 25m,Sell
161691.23,1.10258,14.07.2017 09:45:00,,0.0,-0.0,0.0,0.0,1.09976,14.07.2017 01:00:00,14767,-0.0,99.22,IS,0.34,0.0,Phase3-EA-S4v1-EURCHF-M15-221,EURCHFMT4,3798,8h 45m,Buy
161637.51,146306,14.07.2017 16:59:58,sl 146.306,0.0,-53.720000000001164,0.0,0.0,146976,14.07.2017 09:30:00,14768,-0.021343612171151518,-53.72,IS,0.09,0.0,Phase3-EA-B1v1-GBPJPY-M30-1,GBPJPYMT4,1356,7h 29m,Buy
161899.98,1.3079,14.07.2017 18:29:57,tp 1.30790,-2.13,-0.0,0.0,0.0,1289,12.07.2017 18:30:00,14769,-0.0,262.47,IS,0.14,0.0,Phase3-EA-B1v1-GBPUSD-M30-14,GBPUSDMT4,964,1d 23h 59m,Buy
161944.73,1.10427,17.07.2017 01:00:00,tp 1.10427,-2.13,-0.0,0.0,0.0,1.10537,14.07.2017 20:05:00,14770,-0.0,44.75,IS,0.41,0.0,Phase3-EA-SA2v2-EURCHF-M5-43,EURCHFMT4,7486,2d 4h 55m,Sell
161959.49,112482,17.07.2017 01:15:00,,-1.08,-0.0,0.0,0.0,112.55,14.07.2017 22:45:00,14771,-0.0,14.76,IS,0.27,0.0,Phase3-EA-S1v2-USDJPY-M15-0,USDJPYMT4,4288,2d 2h 30m,Buy
162019.68,0.96355,17.07.2017 01:29:58,tp 0.96355,0.0,-0.0,0.0,0.0,0.96255,17.07.2017 01:00:00,14772,-0.0,60.19,IS,0.58,0.0,Phase3-EA-SA2v2-USDCHF-M15-107,USDCHFMT4,2920,29m 58s,Buy
162066.51,1.10535,17.07.2017 02:14:58,tp 1.10535,0.0,-0.0,0.0,0.0,1.10425,17.07.2017 01:00:00,14773,-0.0,46.83,IS,0.41,0.0,Phase3-EA-SA2v2-EURCHF-M5-43,EURCHFMT4,7488,1h 14m,Buy
162061.01,112.53,17.07.2017 02:45:00,,-0.7,-5.5,0.0,0.0,112548,14.07.2017 22:45:00,14774,-0.0021819637999510445,-5.5,IS,0.27,0.0,Phase3-EA-S1v2-USDJPY-M15-0,USDJPYMT4,4289,2d 4h 0m,Sell
162041.64,147513,17.07.2017 05:15:00,,-1.19,-24.869999999995343,0.0,0.0,147424,14.07.2017 23:50:00,14775,-0.009866443582685876,-19.37,IS,0.23,0.0,Phase3-EA-S4v1-GBPJPY-M5-194,GBPJPYMT4,3210,2d 5h 25m,Sell
162071.61,1.10534,17.07.2017 10:00:00,,0.0,-0.0,0.0,0.0,1.10449,17.07.2017 01:15:00,14776,-0.0,29.97,IS,0.34,0.0,Phase3-EA-S4v1-EURCHF-M15-221,EURCHFMT4,3800,8h 45m,Buy
162036.84,129204,17.07.2017 18:44:58,sl 129.204,0.0,-34.76999999998952,0.0,0.0,128974,17.07.2017 04:30:00,14777,-0.013793699338052941,-34.77,IS,0.17,0.0,Phase3-EA-T1v2-EURJPY-M15-322,EURJPYMT4,2890,14h 14m,Sell
162081.58,1.10349,18.07.2017 01:00:00,tp 1.10349,-2.13,-0.0,0.0,0.0,1.10459,17.07.2017 21:15:00,14778,-0.0,44.74,IS,0.41,0.0,Phase3-EA-SA2v2-EURCHF-M5-43,EURCHFMT4,7490,3h 45m,Sell
162085.91,112621,18.07.2017 03:30:00,,-0.7,-0.0,0.0,0.0,112.6,17.07.2017 22:45:00,14779,-0.0,4.33,IS,0.27,0.0,Phase3-EA-S1v2-USDJPY-M15-0,USDJPYMT4,4292,4h 45m,Buy
162027.6,129478,18.07.2017 06:29:57,sl 129.478,-0.56,-58.30999999999767,0.0,0.0,128758,14.07.2017 17:30:00,14780,-0.02313100323615765,-58.31,IS,0.09,0.0,Phase3-EA-TR1v1-EURJPY-M30-91,EURJPYMT4,2638,3d 12h 59m,Sell
161992.7,129143,18.07.2017 07:44:57,sl 129.143,0.0,-93.20999999999185,0.0,0.0,129373,18.07.2017 06:00:00,14781,-0.03697548982408081,-34.9,IS,0.17,0.0,Phase3-EA-T1v2-EURJPY-M15-322,EURJPYMT4,2892,1h 44m,Buy
161962.37,1.10545,18.07.2017 10:45:00,,0.0,-123.53999999997905,0.0,0.0,1.10474,18.07.2017 02:25:00,14782,-0.04900710238028718,-30.33,IS,0.41,0.0,Phase3-EA-SA2v2-EURCHF-M5-43,EURCHFMT4,7492,8h 20m,Sell
162104.46,1.10181,18.07.2017 13:29:58,tp 1.10181,0.0,-0.0,0.0,0.0,1.10581,18.07.2017 05:30:00,14783,-0.0,142.09,IS,0.34,0.0,Phase3-EA-S4v1-EURCHF-M15-221,EURCHFMT4,3802,7h 59m,Sell
162151.71,1.10361,18.07.2017 22:44:58,tp 1.10361,0.0,-0.0,0.0,0.0,1.10251,18.07.2017 21:20:00,14784,-0.0,47.25,IS,0.41,0.0,Phase3-EA-SA2v2-EURCHF-M5-43,EURCHFMT4,7494,1h 24m,Buy
162196.81,1.1025,19.07.2017 01:34:57,tp 1.10250,-2.15,-0.0,0.0,0.0,1.1036,18.07.2017 22:45:00,14785,-0.0,45.1,IS,0.41,0.0,Phase3-EA-SA2v2-EURCHF-M5-43,EURCHFMT4,7496,2h 49m,Sell
162207.06,111989,19.07.2017 04:00:00,,-1.08,-0.0,0.0,0.0,112036,18.07.2017 20:30:00,14786,-0.0,10.25,IS,0.27,0.0,Phase3-EA-S1v2-USDJPY-M15-0,USDJPYMT4,4294,7h 30m,Sell
162171.45,129113,19.07.2017 12:29:57,sl 129.113,-0.74,-35.60999999998603,0.0,0.0,129343,18.07.2017 11:45:00,14787,-0.01411935098089082,-35.61,IS,0.17,0.0,Phase3-EA-T1v2-EURJPY-M15-322,EURJPYMT4,2894,1d 0h 44m,Buy
162071.63,1.09996,19.07.2017 14:15:00,,0.0,-135.42999999999302,0.0,0.0,1.10276,19.07.2017 05:30:00,14788,-0.053697941683310726,-99.82,IS,0.34,0.0,Phase3-EA-S4v1-EURCHF-M15-221,EURCHFMT4,3804,8h 45m,Buy
162029.63,1.30219,19.07.2017 17:59:58,sl 1.30219,0.0,-177.42999999999302,0.0,0.0,1.30519,19.07.2017 15:00:00,14789,-0.07035092514856338,-42.0,IS,0.14,0.0,Phase3-EA-B1v1-GBPUSD-M30-14,GBPUSDMT4,966,2h 59m,Buy
162042.45,0.9551,20.07.2017 02:30:00,,-9.65,-164.60999999998603,0.0,0.0,0.95547,19.07.2017 22:15:00,14790,-0.0652678001955954,12.82,IS,0.58,0.0,Phase3-EA-SA2v2-USDCHF-M15-107,USDCHFMT4,2922,4h 15m,Sell
162016.74,111848,20.07.2017 04:15:00,,-3.26,-190.31999999997788,0.0,0.0,111755,19.07.2017 22:00:00,14791,-0.07546180507396469,-25.71,IS,0.27,0.0,Phase3-EA-S1v2-USDJPY-M15-0,USDJPYMT4,4296,6h 15m,Sell
161964.78,1.10058,20.07.2017 04:25:00,,-6.44,-242.27999999996973,0.0,0.0,1.09952,19.07.2017 20:05:00,14792,-0.09606392461811689,-51.96,IS,0.41,0.0,Phase3-EA-SA2v2-EURCHF-M5-43,EURCHFMT4,7498,8h 20m,Sell
161976.51,1.10036,20.07.2017 12:15:00,,0.0,-230.54999999995925,0.0,0.0,1.10069,20.07.2017 03:30:00,14793,-0.09141298423603145,11.73,IS,0.34,0.0,Phase3-EA-S4v1-EURCHF-M15-221,EURCHFMT4,3806,8h 45m,Sell
161912.77,130047,20.07.2017 18:29:57,sl 130.047,-1.13,-294.28999999994994,0.0,0.0,129267,18.07.2017 17:00:00,14794,-0.11668586914258024,-63.74,IS,0.09,0.0,Phase3-EA-TR1v1-EURJPY-M30-91,EURJPYMT4,2640,2d 1h 29m,Sell
162059.28,144909,20.07.2017 18:59:58,tp 144.909,-1.87,-147.77999999994063,0.0,0.0,146759,18.07.2017 05:00:00,14795,-0.05859471182128687,146.51,IS,0.09,0.0,Phase3-EA-B1v1-GBPJPY-M30-1,GBPJPYMT4,1358,2d 13h 59m,Sell
162053.61,0.9515,21.07.2017 03:15:00,,-3.23,-153.44999999995343,0.0,0.0,0.95146,20.07.2017 23:00:00,14796,-0.060842864589101056,-5.67,IS,0.58,0.0,Phase3-EA-SA2v2-USDCHF-M15-107,USDCHFMT4,2924,4h 15m,Sell
162049.91,145084,21.07.2017 07:00:00,,0.0,-157.14999999996508,0.0,0.0,145102,21.07.2017 01:35:00,14797,-0.062309913132473166,-3.7,IS,0.23,0.0,Phase3-EA-S4v1-GBPJPY-M5-194,GBPJPYMT4,3212,5h 25m,Buy
162072.24,111814,21.07.2017 10:15:00,,-1.09,-134.81999999997788,0.0,0.0,111911,20.07.2017 22:30:00,14798,-0.05345607692345225,22.33,IS,0.27,0.0,Phase3-EA-S1v2-USDJPY-M15-0,USDJPYMT4,4298,11h 45m,Sell
162133.62,0.94499,21.07.2017 23:44:57,tp 0.94499,0.0,-73.43999999997322,0.0,0.0,0.94399,21.07.2017 23:00:00,14799,-0.029118931087802596,61.38,IS,0.58,0.0,Phase3-EA-SA2v2-USDCHF-M15-107,USDCHFMT4,2926,44m 57s,Buy
162145.14,1.10383,24.07.2017 05:10:00,,-1.04,-61.9199999999837,0.0,0.0,1.10354,21.07.2017 20:50:00,14800,-0.024551255623051736,11.52,IS,0.41,0.0,Phase3-EA-SA2v2-EURCHF-M5-43,EURCHFMT4,7500,2d 8h 20m,Buy
162195.68,144505,24.07.2017 09:15:00,,0.0,-11.379999999975553,0.0,0.0,144261,24.07.2017 03:50:00,14801,-0.004512165519861145,50.54,IS,0.23,0.0,Phase3-EA-S4v1-GBPJPY-M5-194,GBPJPYMT4,3214,5h 25m,Buy
162160.46,129658,24.07.2017 09:29:58,sl 129.658,0.0,-46.59999999997672,0.0,0.0,129428,24.07.2017 04:15:00,14802,-0.018476881654294904,-35.22,IS,0.17,0.0,Phase3-EA-T1v2-EURJPY-M15-322,EURJPYMT4,2896,5h 14m,Sell
162264.94,128957,24.07.2017 11:59:57,tp 128.957,-0.28,-0.0,0.0,0.0,130247,21.07.2017 11:30:00,14803,-0.0,104.48,IS,0.09,0.0,Phase3-EA-TR1v1-EURJPY-M30-91,EURJPYMT4,2642,3d 0h 29m,Sell
162339.74,1.1016,24.07.2017 13:30:00,,0.0,-0.0,0.0,0.0,1.10368,24.07.2017 04:45:00,14804,-0.0,74.8,IS,0.34,0.0,Phase3-EA-S4v1-EURCHF-M15-221,EURCHFMT4,3808,8h 45m,Sell
162387.4,1.10196,24.07.2017 23:54:57,tp 1.10196,0.0,-0.0,0.0,0.0,1.10086,24.07.2017 20:05:00,14805,-0.0,47.66,IS,0.41,0.0,Phase3-EA-SA2v2-EURCHF-M5-43,EURCHFMT4,7502,3h 49m,Buy
162320.93,111087,25.07.2017 06:30:00,,-1.09,-66.47000000000116,0.0,0.0,110818,24.07.2017 17:00:00,14806,-0.026336496988360318,-66.47,IS,0.27,0.0,Phase3-EA-S1v2-USDJPY-M15-0,USDJPYMT4,4300,13h 30m,Sell
162382.23,0.94624,25.07.2017 06:59:57,tp 0.94624,0.0,-5.170000000012806,0.0,0.0,0.94724,25.07.2017 02:45:00,14807,-0.0020484382342433835,61.3,IS,0.58,0.0,Phase3-EA-SA2v2-USDCHF-M15-107,USDCHFMT4,2928,4h 14m,Sell
162318.11,1.10333,25.07.2017 08:35:00,,0.0,-69.29000000000815,0.0,0.0,1.10185,25.07.2017 00:15:00,14808,-0.027453826934311254,-64.12,IS,0.41,0.0,Phase3-EA-SA2v2-EURCHF-M5-43,EURCHFMT4,7504,8h 20m,Sell
162282.39,129.57,25.07.2017 11:59:58,sl 129.570,-0.54,-105.01000000000931,0.0,0.0,129.34,24.07.2017 11:00:00,14809,-0.041606672916321856,-35.72,IS,0.17,0.0,Phase3-EA-T1v2-EURJPY-M15-322,EURJPYMT4,2898,1d 0h 59m,Sell
162223.9,1.1041,25.07.2017 13:00:00,,0.0,-163.5,0.0,0.0,1.10247,25.07.2017 04:15:00,14810,-0.06478136388742044,-58.49,IS,0.34,0.0,Phase3-EA-S4v1-EURCHF-M15-221,EURCHFMT4,3810,8h 45m,Sell
162327.79,130399,25.07.2017 16:59:58,tp 130.399,-0.4,-59.60999999998603,0.0,0.0,129109,24.07.2017 18:00:00,14811,-0.023618453219132887,103.89,IS,0.09,0.0,Phase3-EA-TR1v1-EURJPY-M30-91,EURJPYMT4,2644,22h 59m,Buy
162332.39,111469,25.07.2017 18:15:00,,0.0,-55.00999999998021,0.0,0.0,111.45,25.07.2017 18:00:00,14812,-0.021795858271839243,4.6,IS,0.27,0.0,Phase3-EA-S1v2-USDJPY-M15-0,USDJPYMT4,4302,15m 0s,Buy
162276.19,0.95269,26.07.2017 04:00:00,,-3.23,-111.20999999999185,0.0,0.0,0.95182,25.07.2017 23:45:00,14813,-0.04406321393222935,-56.2,IS,0.58,0.0,Phase3-EA-SA2v2-USDCHF-M15-107,USDCHFMT4,2930,4h 15m,Sell
162209.45,1.10948,26.07.2017 06:55:00,,-2.15,-177.94999999998254,0.0,0.0,1.10798,25.07.2017 22:35:00,14814,-0.07050668931966567,-66.74,IS,0.41,0.0,Phase3-EA-SA2v2-EURCHF-M5-43,EURCHFMT4,7506,8h 20m,Sell
162291.2,130235,26.07.2017 09:00:00,,-0.74,-96.19999999998254,0.0,0.0,129692,25.07.2017 12:15:00,14815,-0.03811600737595544,81.75,IS,0.17,0.0,Phase3-EA-T1v2-EURJPY-M15-322,EURJPYMT4,2900,20h 45m,Buy
162278.02,1.10968,26.07.2017 12:30:00,,0.0,-109.37999999997555,0.0,0.0,1.10931,26.07.2017 03:45:00,14816,-0.04333813811623525,-13.18,IS,0.34,0.0,Phase3-EA-S4v1-EURCHF-M15-221,EURCHFMT4,3812,8h 45m,Sell
162325.3,1.11475,26.07.2017 22:24:58,tp 1.11475,0.0,-62.09999999997672,0.0,0.0,1.11585,26.07.2017 22:15:00,14817,-0.024605031788423857,47.28,IS,0.41,0.0,Phase3-EA-SA2v2-EURCHF-M5-43,EURCHFMT4,7508,9m 58s,Sell
162084.87,0.94946,27.07.2017 01:14:57,sl 0.94946,-2.19,-302.52999999996973,0.0,0.0,0.95336,26.07.2017 22:45:00,14818,-0.11986731508782474,-240.43,IS,0.58,0.0,Phase3-EA-SA2v2-USDCHF-M15-107,USDCHFMT4,2932,2h 29m,Buy
162027.71,145489,27.07.2017 04:40:00,,-2.23,-359.6899999999732,0.0,0.0,145754,26.07.2017 23:15:00,14819,-0.14251503838938545,-57.16,IS,0.23,0.0,Phase3-EA-S4v1-GBPJPY-M5-194,GBPJPYMT4,3216,5h 25m,Buy
162038.06,1.11591,27.07.2017 10:40:00,,0.0,-349.3399999999674,0.0,0.0,1.11615,27.07.2017 02:20:00,14820,-0.13841419975797764,10.35,IS,0.41,0.0,Phase3-EA-SA2v2-EURCHF-M5-43,EURCHFMT4,7510,8h 20m,Sell
162038.77,1.1161,27.07.2017 11:15:00,,0.0,-348.62999999997555,0.0,0.0,1.11612,27.07.2017 02:30:00,14821,-0.13813288619002936,0.71,IS,0.34,0.0,Phase3-EA-S4v1-EURCHF-M15-221,EURCHFMT4,3814,8h 45m,Sell
162003.75,130192,27.07.2017 18:59:59,sl 130.192,0.0,-383.6499999999651,0.0,0.0,130422,27.07.2017 09:00:00,14822,-0.15200838076701276,-35.02,IS,0.17,0.0,Phase3-EA-T1v2-EURJPY-M15-322,EURJPYMT4,2902,9h 59m,Buy
162050.41,111108,28.07.2017 04:15:00,,0.0,-336.9899999999616,0.0,0.0,111.3,28.07.2017 01:45:00,14823,-0.13352092854079098,46.66,IS,0.27,0.0,Phase3-EA-S1v2-USDJPY-M15-0,USDJPYMT4,4304,2h 30m,Sell
161994.6,145093,28.07.2017 04:59:58,sl 145.093,-1.45,-392.79999999995925,0.0,0.0,145763,25.07.2017 22:30:00,14824,-0.15563375984694866,-55.81,IS,0.09,0.0,Phase3-EA-B1v1-GBPJPY-M30-1,GBPJPYMT4,1360,2d 6h 29m,Buy
161784.61,1.13138,28.07.2017 04:59:58,sl 1.13138,-2.13,-602.7899999999499,0.0,0.0,1.12648,27.07.2017 23:00:00,14825,-0.23883521919079462,-209.99,IS,0.41,0.0,Phase3-EA-SA2v2-EURCHF-M5-43,EURCHFMT4,7512,5h 59m,Sell
161647.86,1.13516,28.07.2017 06:44:57,sl 1.13516,0.0,-739.5399999999499,0.0,0.0,1.13126,28.07.2017 05:30:00,14826,-0.29301779724342303,-136.75,IS,0.34,0.0,Phase3-EA-S4v1-EURCHF-M15-221,EURCHFMT4,3816,1h 14m,Sell
161612.61,130.05,28.07.2017 11:14:58,sl 130.050,0.0,-774.7899999999499,0.0,0.0,129.82,28.07.2017 08:45:00,14827,-0.30698442156777517,-35.25,IS,0.17,0.0,Phase3-EA-T1v2-EURJPY-M15-322,EURJPYMT4,2904,2h 29m,Sell
161659.12,1.1391,28.07.2017 22:44:58,tp 1.13910,0.0,-728.2799999999406,0.0,0.0,1.1402,28.07.2017 21:45:00,14828,-0.2885564017854845,46.51,IS,0.41,0.0,Phase3-EA-SA2v2-EURCHF-M5-43,EURCHFMT4,7514,59m 58s,Sell
161718.23,0.96946,31.07.2017 01:14:57,tp 0.96946,-0.72,-669.1699999999546,0.0,0.0,0.96846,28.07.2017 23:15:00,14829,-0.2651360567127963,59.11,IS,0.58,0.0,Phase3-EA-SA2v2-USDCHF-M15-107,USDCHFMT4,2934,2d 1h 59m,Buy
161764.8,1.13862,31.07.2017 01:19:57,tp 1.13862,0.0,-622.5999999999476,0.0,0.0,1.13752,31.07.2017 01:05:00,14830,-0.24668426395293314,46.57,IS,0.41,0.0,Phase3-EA-SA2v2-EURCHF-M5-43,EURCHFMT4,7516,14m 57s,Buy
161811.37,1.13772,31.07.2017 03:44:58,tp 1.13772,0.0,-576.0299999999406,0.0,0.0,1.13882,31.07.2017 02:15:00,14831,-0.22823247119307002,46.57,IS,0.41,0.0,Phase3-EA-SA2v2-EURCHF-M5-43,EURCHFMT4,7518,1h 29m,Sell
161864.32,1.13774,31.07.2017 14:00:00,,0.0,-523.079999999929,0.0,0.0,1.13623,31.07.2017 05:15:00,14832,-0.20725281848457053,52.95,IS,0.34,0.0,Phase3-EA-S4v1-EURCHF-M15-221,EURCHFMT4,3818,8h 45m,Buy
162125.2,1.31951,31.07.2017 19:29:57,tp 1.31951,-3.72,-262.19999999992433,0.0,0.0,1.30061,24.07.2017 03:30:00,14833,-0.10388791199557637,260.88,IS,0.14,0.0,Phase3-EA-B1v1-GBPUSD-M30-14,GBPUSDMT4,968,7d 15h 59m,Buy
162064.97,1.14287,01.08.2017 05:10:00,,-2.12,-322.4299999999348,0.0,0.0,1.1415,31.07.2017 20:50:00,14834,-0.1277520193163104,-60.23,IS,0.41,0.0,Phase3-EA-SA2v2-EURCHF-M5-43,EURCHFMT4,7520,8h 20m,Sell
162086.42,1.14347,01.08.2017 09:45:00,,0.0,-300.97999999992317,0.0,0.0,1.14408,01.08.2017 01:00:00,14835,-0.11925317983382767,21.45,IS,0.34,0.0,Phase3-EA-S4v1-EURCHF-M15-221,EURCHFMT4,3820,8h 45m,Sell
162050.96,130189,01.08.2017 17:59:58,sl 130.189,0.0,-336.439999999915,0.0,0.0,130419,01.08.2017 13:45:00,14836,-0.13330300957968333,-35.46,IS,0.17,0.0,Phase3-EA-T1v2-EURJPY-M15-322,EURJPYMT4,2906,4h 14m,Buy
162095.54,1.13895,02.08.2017 01:00:00,tp 1.13895,-2.12,-291.8599999999278,0.0,0.0,1.14005,01.08.2017 21:30:00,14837,-0.115639687242678,44.58,IS,0.41,0.0,Phase3-EA-SA2v2-EURCHF-M5-43,EURCHFMT4,7522,3h 30m,Sell
161958.26,1.1441,02.08.2017 12:14:58,sl 1.14410,0.0,-429.13999999992666,0.0,0.0,1.1402,02.08.2017 04:00:00,14838,-0.17003225993053733,-137.28,IS,0.34,0.0,Phase3-EA-S4v1-EURCHF-M15-221,EURCHFMT4,3822,8h 14m,Sell
161816.85,110838,02.08.2017 16:30:00,,-1.1,-570.5499999999302,0.0,0.0,110262,01.08.2017 22:45:00,14839,-0.22606120590803183,-141.41,IS,0.27,0.0,Phase3-EA-S1v2-USDJPY-M15-0,USDJPYMT4,4306,17h 45m,Sell
161867.16,0.96973,03.08.2017 01:14:58,tp 0.96973,-9.5,-520.2399999999325,0.0,0.0,0.97073,02.08.2017 23:45:00,14840,-0.20612756421276596,50.31,IS,0.58,0.0,Phase3-EA-SA2v2-USDCHF-M15-107,USDCHFMT4,2936,1h 29m,Sell
161830.85,1.15012,03.08.2017 04:35:00,,-6.33,-556.5499999999302,0.0,0.0,1.14941,02.08.2017 20:15:00,14841,-0.22051417780757993,-36.31,IS,0.41,0.0,Phase3-EA-SA2v2-EURCHF-M5-43,EURCHFMT4,7524,8h 20m,Sell
161793.28,131041,03.08.2017 05:44:57,sl 131.041,-2.26,-594.1199999999371,0.0,0.0,131271,02.08.2017 21:15:00,14842,-0.23540002393143827,-37.57,IS,0.17,0.0,Phase3-EA-T1v2-EURJPY-M15-322,EURJPYMT4,2908,8h 29m,Buy
161772.66,110646,03.08.2017 05:45:00,,-3.29,-614.7399999999325,0.0,0.0,110575,02.08.2017 22:45:00,14843,-0.2435700038908163,-20.62,IS,0.27,0.0,Phase3-EA-S1v2-USDJPY-M15-0,USDJPYMT4,4308,7h 0m,Sell
161825.89,146136,03.08.2017 06:00:00,,0.0,-561.509999999922,0.0,0.0,146392,03.08.2017 00:35:00,14844,-0.22247941062030824,53.23,IS,0.23,0.0,Phase3-EA-S4v1-GBPJPY-M5-194,GBPJPYMT4,3218,5h 25m,Sell
161776.08,1.14809,03.08.2017 14:00:00,,0.0,-611.3199999999197,0.0,0.0,1.14951,03.08.2017 05:15:00,14845,-0.2422149441691294,-49.81,IS,0.34,0.0,Phase3-EA-S4v1-EURCHF-M15-221,EURCHFMT4,3824,8h 45m,Buy
161720.7,145798,03.08.2017 15:29:58,sl 145.798,-0.88,-666.6999999999243,0.0,0.0,146468,02.08.2017 11:30:00,14846,-0.26415740246934744,-55.38,IS,0.09,0.0,Phase3-EA-B1v1-GBPJPY-M30-1,GBPJPYMT4,1362,1d 3h 59m,Buy
161767.21,1.15029,03.08.2017 22:59:58,tp 1.15029,0.0,-620.189999999915,0.0,0.0,1.15139,03.08.2017 20:25:00,14847,-0.2457293826870567,46.51,IS,0.41,0.0,Phase3-EA-SA2v2-EURCHF-M5-43,EURCHFMT4,7526,2h 34m,Sell
161736.9,110031,04.08.2017 00:15:00,,-1.11,-650.4999999999127,0.0,0.0,109912,03.08.2017 23:45:00,14848,-0.2577386985245342,-30.31,IS,0.27,0.0,Phase3-EA-S1v2-USDJPY-M15-0,USDJPYMT4,4310,30m 0s,Sell
161702.42,1.14952,04.08.2017 07:20:00,,-1.02,-684.9799999999232,0.0,0.0,1.15031,03.08.2017 23:00:00,14849,-0.27140023630336557,-34.48,IS,0.41,0.0,Phase3-EA-SA2v2-EURCHF-M5-43,EURCHFMT4,7528,8h 20m,Buy
161735.43,1.1506,04.08.2017 11:00:00,,0.0,-651.9699999999139,0.0,0.0,1.14966,04.08.2017 02:15:00,14850,-0.2583211364750821,33.01,IS,0.34,0.0,Phase3-EA-S4v1-EURCHF-M15-221,EURCHFMT4,3826,8h 45m,Buy
161700.08,130782,04.08.2017 17:59:58,sl 130.782,0.0,-687.3199999999197,0.0,0.0,131012,04.08.2017 17:00:00,14851,-0.27232738242872545,-35.35,IS,0.17,0.0,Phase3-EA-T1v2-EURJPY-M15-322,EURJPYMT4,2910,59m 58s,Buy
161759.72,0.97254,04.08.2017 23:29:57,tp 0.97254,0.0,-627.6799999999057,0.0,0.0,0.97354,04.08.2017 22:00:00,14852,-0.2486970427207948,59.64,IS,0.58,0.0,Phase3-EA-SA2v2-USDCHF-M15-107,USDCHFMT4,2938,1h 29m,Sell
161723.88,130567,07.08.2017 02:44:57,sl 130.567,-0.54,-663.5199999999022,0.0,0.0,130337,04.08.2017 18:30:00,14853,-0.2628974346579503,-35.84,IS,0.17,0.0,Phase3-EA-T1v2-EURJPY-M15-322,EURJPYMT4,2912,2d 8h 14m,Sell
161760.93,110822,07.08.2017 03:30:00,,-0.71,-626.4699999999139,0.0,0.0,110667,04.08.2017 22:30:00,14854,-0.24821762100640182,37.05,IS,0.27,0.0,Phase3-EA-S1v2-USDJPY-M15-0,USDJPYMT4,4312,2d 5h 0m,Buy
161712.0,0.97206,07.08.2017 05:30:00,,0.0,-675.3999999999069,0.0,0.0,0.97288,07.08.2017 01:15:00,14855,-0.26760448421747846,-48.93,IS,0.58,0.0,Phase3-EA-SA2v2-USDCHF-M15-107,USDCHFMT4,2940,4h 15m,Buy
161625.91,1.14633,07.08.2017 06:20:00,,-2.11,-761.4899999999034,0.0,0.0,1.14434,04.08.2017 22:00:00,14856,-0.3017147448723274,-86.09,IS,0.41,0.0,Phase3-EA-SA2v2-EURCHF-M5-43,EURCHFMT4,7530,2d 8h 20m,Sell
161522.62,1.14889,07.08.2017 11:45:00,,0.0,-864.7799999999115,0.0,0.0,1.14593,07.08.2017 03:00:00,14857,-0.342639925764879,-103.29,IS,0.34,0.0,Phase3-EA-S4v1-EURCHF-M15-221,EURCHFMT4,3828,8h 45m,Sell
161579.11,0.97238,08.08.2017 01:00:00,tp 0.97238,-3.16,-808.2899999999208,0.0,0.0,0.97338,07.08.2017 22:15:00,14858,-0.32025766737955924,56.49,IS,0.58,0.0,Phase3-EA-SA2v2-USDCHF-M15-107,USDCHFMT4,2942,2h 45m,Sell
161623.33,1.14647,08.08.2017 01:00:00,tp 1.14647,-2.11,-764.0699999999197,0.0,0.0,1.14757,07.08.2017 21:20:00,14859,-0.30273698290798856,44.22,IS,0.41,0.0,Phase3-EA-SA2v2-EURCHF-M5-43,EURCHFMT4,7532,3h 40m,Sell
161610.11,130583,08.08.2017 09:45:00,,0.0,-777.2899999999208,0.0,0.0,130669,08.08.2017 01:45:00,14860,-0.30797496229998716,-13.22,IS,0.17,0.0,Phase3-EA-T1v2-EURJPY-M15-322,EURJPYMT4,2914,8h 0m,Buy
161577.24,1.14868,08.08.2017 10:55:00,,0.0,-810.1599999999162,0.0,0.0,1.1479,08.08.2017 02:35:00,14861,-0.3209985918472606,-32.87,IS,0.41,0.0,Phase3-EA-SA2v2-EURCHF-M5-43,EURCHFMT4,7534,8h 20m,Sell
161573.05,1.14876,08.08.2017 13:15:00,,0.0,-814.3499999999185,0.0,0.0,1.14864,08.08.2017 04:30:00,14862,-0.3226587381144682,-4.19,IS,0.34,0.0,Phase3-EA-S4v1-EURCHF-M15-221,EURCHFMT4,3830,8h 45m,Sell
161619.28,1.14584,08.08.2017 20:54:58,tp 1.14584,0.0,-768.119999999908,0.0,0.0,1.14474,08.08.2017 20:05:00,14863,-0.3043416588941861,46.23,IS,0.41,0.0,Phase3-EA-SA2v2-EURCHF-M5-43,EURCHFMT4,7536,49m 58s,Buy
161665.55,1.14538,08.08.2017 23:34:59,tp 1.14538,0.0,-721.8499999999185,0.0,0.0,1.14648,08.08.2017 21:35:00,14864,-0.2860087310221967,46.27,IS,0.41,0.0,Phase3-EA-SA2v2-EURCHF-M5-43,EURCHFMT4,7538,1h 59m,Sell
161600.83,129422,09.08.2017 02:29:58,sl 129.422,-5.98,-786.5699999999197,0.0,0.0,130142,25.07.2017 16:30:00,14865,-0.31165184949800057,-64.72,IS,0.09,0.0,Phase3-EA-TR1v1-EURJPY-M30-91,EURJPYMT4,2645,14d 9h 59m,Buy
161681.03,143.09,09.08.2017 02:34:58,tp 143.090,-1.21,-706.369999999908,0.0,0.0,143.48,08.08.2017 23:30:00,14866,-0.27987530280826434,80.2,IS,0.23,0.0,Phase3-EA-S4v1-GBPJPY-M5-194,GBPJPYMT4,3220,3h 4m,Sell
161573.01,0.97186,09.08.2017 05:45:00,,0.0,-814.3899999998976,0.0,0.0,0.97367,09.08.2017 01:30:00,14867,-0.3226745867661755,-108.02,IS,0.58,0.0,Phase3-EA-SA2v2-USDCHF-M15-107,USDCHFMT4,2944,4h 15m,Buy
161365.26,1.14032,09.08.2017 06:04:58,sl 1.14032,-1.01,-1022.1399999998976,0.0,0.0,1.14522,08.08.2017 23:40:00,14868,-0.4049885216139528,-207.75,IS,0.41,0.0,Phase3-EA-SA2v2-EURCHF-M5-43,EURCHFMT4,7540,6h 24m,Buy
161228.81,1.14014,09.08.2017 06:14:58,sl 1.14014,0.0,-1158.5899999999092,0.0,0.0,1.14404,09.08.2017 02:30:00,14869,-0.45905223477871904,-136.45,IS,0.34,0.0,Phase3-EA-S4v1-EURCHF-M15-221,EURCHFMT4,3832,3h 44m,Buy
161147.8,142675,09.08.2017 08:25:00,,0.0,-1239.5999999999185,0.0,0.0,143062,09.08.2017 03:00:00,14870,-0.49114971666569474,-81.01,IS,0.23,0.0,Phase3-EA-S4v1-GBPJPY-M5-194,GBPJPYMT4,3222,5h 25m,Buy
161112.23,129203,09.08.2017 18:44:58,sl 129.203,0.0,-1275.1699999999255,0.0,0.0,128973,09.08.2017 12:00:00,14871,-0.5052431302037742,-35.57,IS,0.17,0.0,Phase3-EA-T1v2-EURJPY-M15-322,EURJPYMT4,2916,6h 44m,Sell
161117.88,109843,09.08.2017 23:00:00,,0.0,-1269.5199999999313,0.0,0.0,109866,09.08.2017 17:15:00,14872,-0.5030045081489514,5.65,IS,0.27,0.0,Phase3-EA-S1v2-USDJPY-M15-0,USDJPYMT4,4314,5h 45m,Sell
161161.63,1.13322,10.08.2017 02:04:57,tp 1.13322,-3.06,-1225.7699999999313,0.0,0.0,1.13212,09.08.2017 22:50:00,14873,-0.48567004533503916,43.75,IS,0.41,0.0,Phase3-EA-SA2v2-EURCHF-M5-43,EURCHFMT4,7542,3h 14m,Buy
161149.83,0.9635,10.08.2017 03:15:00,,-2.17,-1237.5699999999197,0.0,0.0,0.96366,09.08.2017 23:00:00,14874,-0.4903453975911297,-11.8,IS,0.58,0.0,Phase3-EA-SA2v2-USDCHF-M15-107,USDCHFMT4,2946,4h 15m,Buy
161195.05,110036,10.08.2017 04:00:00,,-2.14,-1192.3499999999185,0.0,0.0,109843,09.08.2017 23:00:00,14875,-0.4724284968266696,45.22,IS,0.27,0.0,Phase3-EA-S1v2-USDJPY-M15-0,USDJPYMT4,4316,5h 0m,Buy
161148.88,143221,10.08.2017 05:30:00,,0.0,-1238.5199999999313,0.0,0.0,143.0,10.08.2017 00:05:00,14876,-0.49072180306937924,-46.17,IS,0.23,0.0,Phase3-EA-S4v1-GBPJPY-M5-194,GBPJPYMT4,3224,5h 25m,Sell
161195.63,1.13228,10.08.2017 08:09:58,tp 1.13228,0.0,-1191.7699999999313,0.0,0.0,1.13338,10.08.2017 02:45:00,14877,-0.4721986913767988,46.75,IS,0.41,0.0,Phase3-EA-SA2v2-EURCHF-M5-43,EURCHFMT4,7544,5h 24m,Sell
161209.7,1.13296,10.08.2017 11:45:00,,0.0,-1177.6999999999243,0.0,0.0,1.13336,10.08.2017 03:00:00,14878,-0.46662392813584186,14.07,IS,0.34,0.0,Phase3-EA-S4v1-EURCHF-M15-221,EURCHFMT4,3834,8h 45m,Sell
161312.25,128251,10.08.2017 18:29:58,tp 128.251,-0.86,-1075.149999999936,0.0,0.0,129511,09.08.2017 02:30:00,14879,-0.4259919473000363,102.55,IS,0.09,0.0,Phase3-EA-TR1v1-EURJPY-M30-91,EURJPYMT4,2648,1d 15h 59m,Sell
161359.1,1.13233,10.08.2017 21:49:59,tp 1.13233,0.0,-1028.2999999999302,0.0,0.0,1.13343,10.08.2017 20:05:00,14880,-0.40742921397816456,46.85,IS,0.41,0.0,Phase3-EA-SA2v2-EURCHF-M5-43,EURCHFMT4,7546,1h 44m,Sell
161405.89,1.13319,10.08.2017 22:24:57,tp 1.13319,0.0,-981.509999999922,0.0,0.0,1.13209,10.08.2017 21:55:00,14881,-0.3888902536338653,46.79,IS,0.41,0.0,Phase3-EA-SA2v2-EURCHF-M5-43,EURCHFMT4,7548,29m 57s,Buy
161452.72,1.13273,10.08.2017 23:59:58,tp 1.13273,0.0,-934.6799999999348,0.0,0.0,1.13383,10.08.2017 23:05:00,14882,-0.3703354446378588,46.83,IS,0.41,0.0,Phase3-EA-SA2v2-EURCHF-M5-43,EURCHFMT4,7550,54m 58s,Sell
161419.54,0.96144,11.08.2017 04:45:00,,0.0,-967.8599999999278,0.0,0.0,0.96199,11.08.2017 00:30:00,14883,-0.383481901235927,-33.18,IS,0.58,0.0,Phase3-EA-SA2v2-USDCHF-M15-107,USDCHFMT4,2948,4h 15m,Buy
161569.95,141412,11.08.2017 07:29:58,tp 141.412,-2.37,-817.4499999999243,0.0,0.0,143262,08.08.2017 21:30:00,14884,-0.32388700862242775,150.41,IS,0.09,0.0,Phase3-EA-B1v1-GBPJPY-M30-1,GBPJPYMT4,1364,2d 9h 59m,Sell
161543.1,1.13179,11.08.2017 10:45:00,,0.0,-844.2999999999302,0.0,0.0,1.13255,11.08.2017 02:00:00,14885,-0.334525416086511,-26.85,IS,0.34,0.0,Phase3-EA-S4v1-EURCHF-M15-221,EURCHFMT4,3836,8h 45m,Buy
161526.49,1.13166,11.08.2017 10:50:00,,0.0,-860.9099999999162,0.0,0.0,1.13205,11.08.2017 02:30:00,14886,-0.34110656871139877,-16.61,IS,0.41,0.0,Phase3-EA-SA2v2-EURCHF-M5-43,EURCHFMT4,7552,8h 20m,Buy
161490.68,128.72,11.08.2017 16:44:58,sl 128.720,0.0,-896.7199999999139,0.0,0.0,128.49,11.08.2017 01:30:00,14887,-0.355295074159768,-35.81,IS,0.17,0.0,Phase3-EA-T1v2-EURJPY-M15-322,EURJPYMT4,2918,15h 14m,Sell
161395.78,1.13899,14.08.2017 05:15:00,,-2.13,-991.619999999908,0.0,0.0,1.13681,11.08.2017 20:55:00,14888,-0.39289600035497185,-94.9,IS,0.41,0.0,Phase3-EA-SA2v2-EURCHF-M5-43,EURCHFMT4,7554,2d 8h 20m,Sell
161328.19,1.14005,14.08.2017 13:00:00,,0.0,-1059.2099999999045,0.0,0.0,1.13813,14.08.2017 04:15:00,14889,-0.41967625959136645,-67.59,IS,0.34,0.0,Phase3-EA-S4v1-EURCHF-M15-221,EURCHFMT4,3838,8h 45m,Sell
161272.71,142.05,14.08.2017 16:00:00,sl 142.050,-0.48,-1114.689999999915,0.0,0.0,141.38,11.08.2017 12:30:00,14890,-0.44165833952087574,-55.48,IS,0.09,0.0,Phase3-EA-B1v1-GBPJPY-M30-1,GBPJPYMT4,1366,3d 3h 30m,Sell
161316.99,1.14406,15.08.2017 01:00:00,tp 1.14406,-2.11,-1070.4099999999162,0.0,0.0,1.14516,14.08.2017 21:35:00,14891,-0.4241138820717326,44.28,IS,0.41,0.0,Phase3-EA-SA2v2-EURCHF-M5-43,EURCHFMT4,7556,3h 25m,Sell
161421.81,129743,15.08.2017 04:29:58,tp 129.743,-0.8,-965.5899999999092,0.0,0.0,128453,11.08.2017 10:30:00,14892,-0.38258249025106067,104.82,IS,0.09,0.0,Phase3-EA-TR1v1-EURJPY-M30-91,EURJPYMT4,2650,3d 17h 59m,Buy
161298.32,142.95,15.08.2017 09:05:00,,0.0,-1089.0799999998999,0.0,0.0,142358,15.08.2017 03:40:00,14893,-0.4315112402599716,-123.49,IS,0.23,0.0,Phase3-EA-S4v1-GBPJPY-M5-194,GBPJPYMT4,3226,5h 25m,Sell
161437.99,1.14312,15.08.2017 11:14:58,tp 1.14312,0.0,-949.4099999998871,0.0,0.0,1.14712,15.08.2017 06:00:00,14894,-0.37617171063210103,139.67,IS,0.34,0.0,Phase3-EA-S4v1-EURCHF-M15-221,EURCHFMT4,3840,5h 14m,Sell
161436.6,129829,15.08.2017 13:30:00,,0.0,-950.799999999901,0.0,0.0,129838,15.08.2017 13:15:00,14895,-0.3767224512792229,-1.39,IS,0.17,0.0,Phase3-EA-T1v2-EURJPY-M15-322,EURJPYMT4,2920,15m 0s,Buy
161381.96,142297,15.08.2017 14:29:58,sl 142.297,0.0,-1005.439999999915,0.0,0.0,142967,15.08.2017 09:30:00,14896,-0.3983717095227064,-54.64,IS,0.09,0.0,Phase3-EA-B1v1-GBPJPY-M30-1,GBPJPYMT4,1368,4h 59m,Buy
161428.34,1.14172,16.08.2017 04:04:58,tp 1.14172,0.0,-959.0599999999104,0.0,0.0,1.14062,16.08.2017 01:20:00,14897,-0.37999519785849317,46.38,IS,0.41,0.0,Phase3-EA-SA2v2-EURCHF-M5-43,EURCHFMT4,7558,2h 44m,Buy
161408.0,142346,16.08.2017 04:50:00,,-1.21,-979.3999999999069,0.0,0.0,142254,15.08.2017 23:25:00,14898,-0.38805423725586263,-20.34,IS,0.23,0.0,Phase3-EA-S4v1-GBPJPY-M5-194,GBPJPYMT4,3228,5h 25m,Sell
161386.04,110635,16.08.2017 10:15:00,,0.0,-1001.3599999998987,0.0,0.0,110545,16.08.2017 00:15:00,14899,-0.3967551470477111,-21.96,IS,0.27,0.0,Phase3-EA-S1v2-USDJPY-M15-0,USDJPYMT4,4318,10h 0m,Sell
161377.65,1.14208,16.08.2017 13:30:00,,0.0,-1009.7499999999127,0.0,0.0,1.14184,16.08.2017 04:45:00,14900,-0.4000794017450589,-8.39,IS,0.34,0.0,Phase3-EA-S4v1-EURCHF-M15-221,EURCHFMT4,3842,8h 45m,Sell
161380.12,129714,16.08.2017 15:45:00,,-0.75,-1007.2799999999115,0.0,0.0,129693,15.08.2017 22:00:00,14901,-0.39910074750162156,2.47,IS,0.17,0.0,Phase3-EA-T1v2-EURJPY-M15-322,EURJPYMT4,2922,17h 45m,Buy
161146.25,0.9672,16.08.2017 22:29:57,sl 0.96720,0.0,-1241.1499999999069,0.0,0.0,0.9711,16.08.2017 22:00:00,14902,-0.49176385191966876,-233.87,IS,0.58,0.0,Phase3-EA-SA2v2-USDCHF-M15-107,USDCHFMT4,2950,29m 57s,Buy
161097.21,0.96508,17.08.2017 02:45:00,,-2.16,-1290.189999999915,0.0,0.0,0.96586,16.08.2017 22:30:00,14903,-0.5111942989229692,-49.04,IS,0.58,0.0,Phase3-EA-SA2v2-USDCHF-M15-107,USDCHFMT4,2952,4h 15m,Buy
160959.93,1.13606,17.08.2017 05:10:00,,-3.06,-1427.4699999999139,0.0,0.0,1.13922,16.08.2017 20:50:00,14904,-0.5655868716108285,-137.28,IS,0.41,0.0,Phase3-EA-SA2v2-EURCHF-M5-43,EURCHFMT4,7560,8h 20m,Buy
160983.52,1.13683,17.08.2017 10:45:00,,0.0,-1403.8799999999173,0.0,0.0,1.13616,17.08.2017 02:00:00,14905,-0.5562401292615685,23.59,IS,0.34,0.0,Phase3-EA-S4v1-EURCHF-M15-221,EURCHFMT4,3844,8h 45m,Buy
160941.52,1.28703,17.08.2017 14:29:58,sl 1.28703,0.0,-1445.8799999999173,0.0,0.0,1.29003,17.08.2017 05:30:00,14906,-0.5728812135629242,-42.0,IS,0.14,0.0,Phase3-EA-B1v1-GBPUSD-M30-14,GBPUSDMT4,970,8h 59m,Buy
160880.7,128634,17.08.2017 15:59:57,sl 128.634,-2.0,-1506.6999999999243,0.0,0.0,129354,14.08.2017 07:00:00,14907,-0.5969790884964615,-60.82,IS,0.09,0.0,Phase3-EA-TR1v1-EURJPY-M30-91,EURJPYMT4,2651,3d 8h 59m,Buy
160825.73,141309,17.08.2017 21:29:58,sl 141.309,0.0,-1561.6699999999255,0.0,0.0,141979,17.08.2017 17:00:00,14908,-0.6187590981165936,-54.97,IS,0.09,0.0,Phase3-EA-B1v1-GBPJPY-M30-1,GBPJPYMT4,1370,4h 29m,Buy
160747.6,1.12817,18.08.2017 04:40:00,,-1.02,-1639.7999999999302,0.0,0.0,1.12998,17.08.2017 20:20:00,14909,-0.649715477080046,-78.13,IS,0.41,0.0,Phase3-EA-SA2v2-EURCHF-M5-43,EURCHFMT4,7562,8h 20m,Buy
160781.36,0.96221,18.08.2017 04:45:00,,0.0,-1606.0399999999208,0.0,0.0,0.96277,18.08.2017 00:30:00,14910,-0.6363392150320953,33.76,IS,0.58,0.0,Phase3-EA-SA2v2-USDCHF-M15-107,USDCHFMT4,2954,4h 15m,Sell
160716.65,140741,18.08.2017 04:50:00,,-0.76,-1670.7499999999127,0.0,0.0,141045,17.08.2017 23:25:00,14911,-0.6619783713449666,-64.71,IS,0.23,0.0,Phase3-EA-S4v1-GBPJPY-M5-194,GBPJPYMT4,3230,5h 25m,Buy
160820.55,127628,18.08.2017 17:59:58,tp 127.628,-0.29,-1566.8499999999185,0.0,0.0,128888,17.08.2017 16:00:00,14912,-0.6208114985137579,103.9,IS,0.09,0.0,Phase3-EA-TR1v1-EURJPY-M30-91,EURJPYMT4,2654,1d 1h 59m,Sell
160873.39,109398,21.08.2017 03:15:00,,-0.72,-1514.009999999922,0.0,0.0,109181,18.08.2017 23:45:00,14913,-0.5998754295974823,52.84,IS,0.27,0.0,Phase3-EA-S1v2-USDJPY-M15-0,USDJPYMT4,4320,2d 3h 30m,Buy
160933.44,0.96589,21.08.2017 04:14:57,tp 0.96589,0.0,-1453.9599999999336,0.0,0.0,0.96489,21.08.2017 01:15:00,14914,-0.5760826412094772,60.05,IS,0.58,0.0,Phase3-EA-SA2v2-USDCHF-M15-107,USDCHFMT4,2956,2h 59m,Buy
160855.29,1.13438,21.08.2017 04:20:00,,-2.12,-1532.1099999999278,0.0,0.0,1.13259,18.08.2017 20:00:00,14915,-0.6070469444987832,-78.15,IS,0.41,0.0,Phase3-EA-SA2v2-EURCHF-M5-43,EURCHFMT4,7564,2d 8h 20m,Sell
160860.84,140614,21.08.2017 05:05:00,,-0.76,-1526.5599999999395,0.0,0.0,140584,18.08.2017 23:40:00,14916,-0.6048479440732515,5.55,IS,0.23,0.0,Phase3-EA-S4v1-GBPJPY-M5-194,GBPJPYMT4,3232,2d 5h 25m,Buy
160801.28,128659,21.08.2017 19:59:58,sl 128.659,0.0,-1586.1199999999371,0.0,0.0,128135,18.08.2017 19:30:00,14917,-0.6284465864777445,-59.56,IS,0.09,0.0,Phase3-EA-TR1v1-EURJPY-M30-91,EURJPYMT4,2656,3d 0h 29m,Buy
160848.18,1.13642,21.08.2017 21:59:57,tp 1.13642,0.0,-1539.219999999943,0.0,0.0,1.13752,21.08.2017 20:20:00,14918,-0.6098640423412329,46.9,IS,0.41,0.0,Phase3-EA-SA2v2-EURCHF-M5-43,EURCHFMT4,7566,1h 39m,Sell
160894.04,1.1373,22.08.2017 05:09:59,tp 1.13730,-1.02,-1493.359999999957,0.0,0.0,1.1362,21.08.2017 23:25:00,14919,-0.5916935631493296,45.86,IS,0.41,0.0,Phase3-EA-SA2v2-EURCHF-M5-43,EURCHFMT4,7568,5h 44m,Buy
160845.27,0.96331,22.08.2017 07:00:00,,0.0,-1542.1299999999464,0.0,0.0,0.9625,22.08.2017 02:45:00,14920,-0.6110170317535426,-48.77,IS,0.58,0.0,Phase3-EA-SA2v2-USDCHF-M15-107,USDCHFMT4,2958,4h 15m,Sell
160810.74,140765,22.08.2017 08:15:00,,0.0,-1576.6599999999453,0.0,0.0,140601,22.08.2017 02:50:00,14921,-0.6246983803470139,-34.53,IS,0.23,0.0,Phase3-EA-S4v1-GBPJPY-M5-194,GBPJPYMT4,3234,5h 25m,Sell
160809.33,1.13682,22.08.2017 13:00:00,,0.0,-1578.0699999999488,0.0,0.0,1.13678,22.08.2017 04:15:00,14922,-0.6252570453199893,-1.41,IS,0.34,0.0,Phase3-EA-S4v1-EURCHF-M15-221,EURCHFMT4,3846,8h 45m,Sell
160800.77,0.96822,23.08.2017 02:30:00,,-3.17,-1586.6299999999464,0.0,0.0,0.96813,22.08.2017 22:15:00,14923,-0.6286486567871218,-8.56,IS,0.58,0.0,Phase3-EA-SA2v2-USDCHF-M15-107,USDCHFMT4,2960,4h 15m,Sell
160744.89,1.13903,23.08.2017 06:40:00,,-2.12,-1642.509999999951,0.0,0.0,1.13776,22.08.2017 22:20:00,14924,-0.6507892232337845,-55.88,IS,0.41,0.0,Phase3-EA-SA2v2-EURCHF-M5-43,EURCHFMT4,7570,8h 20m,Sell
160819.74,140.27,23.08.2017 07:40:00,,0.0,-1567.6599999999453,0.0,0.0,140626,23.08.2017 02:15:00,14925,-0.621132433711009,74.85,IS,0.23,0.0,Phase3-EA-S4v1-GBPJPY-M5-194,GBPJPYMT4,3236,5h 25m,Sell
160823.95,1.13872,23.08.2017 11:30:00,,0.0,-1563.4499999999534,0.0,0.0,1.13884,23.08.2017 02:45:00,14926,-0.6194643631179478,4.21,IS,0.34,0.0,Phase3-EA-S4v1-EURCHF-M15-221,EURCHFMT4,3848,8h 45m,Sell
160788.14,128875,23.08.2017 18:14:58,sl 128.875,0.0,-1599.259999999951,0.0,0.0,128645,23.08.2017 16:30:00,14927,-0.6336528685663171,-35.81,IS,0.17,0.0,Phase3-EA-T1v2-EURJPY-M15-322,EURJPYMT4,2924,1h 44m,Sell
160786.11,128873,23.08.2017 19:30:00,,0.0,-1601.28999999995,0.0,0.0,128886,23.08.2017 18:30:00,14928,-0.6344571876408821,-2.03,IS,0.17,0.0,Phase3-EA-T1v2-EURJPY-M15-322,EURJPYMT4,2926,1h 0m,Buy
160832.8,1.1397,23.08.2017 20:59:57,tp 1.13970,0.0,-1554.5999999999476,0.0,0.0,1.1408,23.08.2017 20:00:00,14929,-0.6159578489258741,46.69,IS,0.41,0.0,Phase3-EA-SA2v2-EURCHF-M5-43,EURCHFMT4,7572,59m 57s,Sell
160848.39,109079,23.08.2017 21:45:00,,0.0,-1539.009999999951,0.0,0.0,109142,23.08.2017 20:45:00,14930,-0.6097808369197294,15.59,IS,0.27,0.0,Phase3-EA-S1v2-USDJPY-M15-0,USDJPYMT4,4322,1h 0m,Sell
160862.51,109023,23.08.2017 22:30:00,,0.0,-1524.8899999999558,0.0,0.0,109.08,23.08.2017 22:15:00,14931,-0.6041862628641326,14.12,IS,0.27,0.0,Phase3-EA-S1v2-USDJPY-M15-0,USDJPYMT4,4324,15m 0s,Sell
161011.94,139343,24.08.2017 02:29:58,tp 139.343,-3.36,-1375.4599999999627,0.0,0.0,141193,17.08.2017 23:00:00,14932,-0.5449796622176691,149.43,IS,0.09,0.0,Phase3-EA-B1v1-GBPJPY-M30-1,GBPJPYMT4,1372,6d 3h 29m,Sell
161058.63,1.14071,24.08.2017 04:59:58,tp 1.14071,0.0,-1328.7699999999604,0.0,0.0,1.13961,24.08.2017 01:10:00,14933,-0.526480323502661,46.69,IS,0.41,0.0,Phase3-EA-SA2v2-EURCHF-M5-43,EURCHFMT4,7574,3h 49m,Buy
161111.29,139.58,24.08.2017 07:50:00,,0.0,-1276.109999999957,0.0,0.0,139.33,24.08.2017 02:25:00,14934,-0.5056155735191028,52.66,IS,0.23,0.0,Phase3-EA-S4v1-GBPJPY-M5-194,GBPJPYMT4,3238,5h 25m,Buy
161075.44,128717,24.08.2017 10:14:58,sl 128.717,0.0,-1311.9599999999627,0.0,0.0,128947,24.08.2017 05:00:00,14935,-0.5198199276191908,-35.85,IS,0.17,0.0,Phase3-EA-T1v2-EURJPY-M15-322,EURJPYMT4,2928,5h 14m,Buy
161062.06,1.13912,24.08.2017 10:15:00,,0.0,-1325.3399999999674,0.0,0.0,1.1395,24.08.2017 01:30:00,14936,-0.5251213016180531,-13.38,IS,0.34,0.0,Phase3-EA-S4v1-EURCHF-M15-221,EURCHFMT4,3850,8h 45m,Buy
161069.46,109396,24.08.2017 21:30:00,,0.0,-1317.9399999999732,0.0,0.0,109366,24.08.2017 17:15:00,14937,-0.5221893010506737,7.4,IS,0.27,0.0,Phase3-EA-S1v2-USDJPY-M15-0,USDJPYMT4,4326,4h 15m,Buy
161065.72,140165,25.08.2017 04:30:00,,-1.22,-1321.679999999964,0.0,0.0,140153,24.08.2017 23:05:00,14938,-0.5236711499860764,-3.74,IS,0.23,0.0,Phase3-EA-S4v1-GBPJPY-M5-194,GBPJPYMT4,3240,5h 25m,Sell
161061.05,1.13887,25.08.2017 04:45:00,,-2.12,-1326.3499999999767,0.0,0.0,1.13881,24.08.2017 20:25:00,14939,-0.5255214800738751,-4.67,IS,0.41,0.0,Phase3-EA-SA2v2-EURCHF-M5-43,EURCHFMT4,7576,8h 20m,Sell
161164.25,129425,25.08.2017 04:59:58,tp 129.425,-2.81,-1223.149999999965,0.0,0.0,127939,21.08.2017 11:30:00,14940,-0.4846319586476822,103.2,IS,0.09,0.0,Phase3-EA-TR1v1-EURJPY-M30-91,EURJPYMT4,2657,3d 17h 29m,Sell
161214.32,1.13945,25.08.2017 15:30:00,,0.0,-1173.079999999958,0.0,0.0,1.13803,25.08.2017 06:45:00,14941,-0.4647934088627061,50.07,IS,0.34,0.0,Phase3-EA-S4v1-EURCHF-M15-221,EURCHFMT4,3852,8h 45m,Buy
161261.46,1.13748,25.08.2017 21:04:57,tp 1.13748,0.0,-1125.9399999999441,0.0,0.0,1.13638,25.08.2017 20:15:00,14942,-0.44611577281589326,47.14,IS,0.41,0.0,Phase3-EA-SA2v2-EURCHF-M5-43,EURCHFMT4,7578,49m 57s,Buy
161363.76,130.32,25.08.2017 23:29:58,tp 130.320,-1.61,-1023.6399999999558,0.0,0.0,129.06,23.08.2017 04:00:00,14943,-0.40558284605331,102.3,IS,0.09,0.0,Phase3-EA-TR1v1-EURJPY-M30-91,EURJPYMT4,2659,2d 19h 29m,Buy
161389.11,109204,28.08.2017 01:15:00,,-1.11,-998.2899999999499,0.0,0.0,109311,25.08.2017 23:15:00,14944,-0.3955387630285609,25.35,IS,0.27,0.0,Phase3-EA-S1v2-USDJPY-M15-0,USDJPYMT4,4328,2d 2h 0m,Sell
161449.79,0.95584,28.08.2017 04:14:58,tp 0.95584,0.0,-937.6099999999569,0.0,0.0,0.95484,28.08.2017 01:30:00,14945,-0.37149635837603356,60.68,IS,0.58,0.0,Phase3-EA-SA2v2-USDCHF-M15-107,USDCHFMT4,2962,2h 44m,Buy
161496.99,1.13923,28.08.2017 04:44:58,tp 1.13923,0.0,-890.4099999999453,0.0,0.0,1.14033,28.08.2017 01:25:00,14946,-0.35279494935164823,47.2,IS,0.41,0.0,Phase3-EA-SA2v2-EURCHF-M5-43,EURCHFMT4,7580,3h 19m,Sell
161579.19,140579,28.08.2017 06:24:57,tp 140.579,0.0,-808.2099999999336,0.0,0.0,140969,28.08.2017 01:25:00,14947,-0.3202259700761332,82.2,IS,0.23,0.0,Phase3-EA-S4v1-GBPJPY-M5-194,GBPJPYMT4,3242,4h 59m,Sell
161702.56,130127,28.08.2017 08:00:00,,-0.76,-684.8399999999383,0.0,0.0,129.33,25.08.2017 13:15:00,14948,-0.27134476602236707,123.37,IS,0.17,0.0,Phase3-EA-T1v2-EURJPY-M15-322,EURJPYMT4,2930,2d 18h 45m,Buy
161808.7,1.13841,28.08.2017 11:45:00,,0.0,-578.6999999999243,0.0,0.0,1.14139,28.08.2017 03:00:00,14949,-0.22929036869507832,106.14,IS,0.34,0.0,Phase3-EA-S4v1-EURCHF-M15-221,EURCHFMT4,3854,8h 45m,Sell
161853.77,1.14304,29.08.2017 01:19:57,tp 1.14304,-2.15,-533.6299999999173,0.0,0.0,1.14414,28.08.2017 20:35:00,14950,-0.21143290037454932,45.07,IS,0.41,0.0,Phase3-EA-SA2v2-EURCHF-M5-43,EURCHFMT4,7582,4h 44m,Sell
161935.97,140905,29.08.2017 01:24:58,tp 140.905,0.0,-451.4299999999057,0.0,0.0,141295,29.08.2017 00:25:00,14951,-0.17886392109903423,82.2,IS,0.23,0.0,Phase3-EA-S4v1-GBPJPY-M5-194,GBPJPYMT4,3244,59m 58s,Sell
161996.76,0.95409,29.08.2017 01:29:57,tp 0.95409,0.0,-390.63999999989755,0.0,0.0,0.95509,29.08.2017 01:15:00,14952,-0.15477793265428308,60.79,IS,0.58,0.0,Phase3-EA-SA2v2-USDCHF-M15-107,USDCHFMT4,2964,14m 57s,Sell
162044.1,1.14121,29.08.2017 01:34:58,tp 1.14121,0.0,-343.29999999990105,0.0,0.0,1.14231,29.08.2017 01:20:00,14953,-0.13602105334889925,47.34,IS,0.41,0.0,Phase3-EA-SA2v2-EURCHF-M5-43,EURCHFMT4,7584,14m 58s,Sell
162007.41,130049,29.08.2017 02:14:58,sl 130.049,-0.76,-379.9899999999034,0.0,0.0,130279,28.08.2017 13:15:00,14954,-0.15055822913501304,-36.69,IS,0.17,0.0,Phase3-EA-T1v2-EURJPY-M15-322,EURJPYMT4,2932,12h 59m,Buy
162054.84,1.13964,29.08.2017 02:34:58,tp 1.13964,0.0,-332.55999999991036,0.0,0.0,1.13854,29.08.2017 02:25:00,14955,-0.13176569036327054,47.43,IS,0.41,0.0,Phase3-EA-SA2v2-EURCHF-M5-43,EURCHFMT4,7586,9m 58s,Buy
162053.78,140762,29.08.2017 07:15:00,,0.0,-333.61999999990803,0.0,0.0,140767,29.08.2017 01:50:00,14956,-0.1321856796337324,-1.06,IS,0.23,0.0,Phase3-EA-S4v1-GBPJPY-M5-194,GBPJPYMT4,3246,5h 25m,Buy
162130.93,1.14146,29.08.2017 12:00:00,,0.0,-256.46999999991385,0.0,0.0,1.13931,29.08.2017 03:15:00,14957,-0.10161759263731583,77.15,IS,0.34,0.0,Phase3-EA-S4v1-EURCHF-M15-221,EURCHFMT4,3856,8h 45m,Buy
162120.49,108577,29.08.2017 17:45:00,,0.0,-266.9099999999162,0.0,0.0,108535,29.08.2017 17:00:00,14958,-0.10575409073508231,-10.44,IS,0.27,0.0,Phase3-EA-S1v2-USDJPY-M15-0,USDJPYMT4,4330,45m 0s,Sell
162055.68,130995,29.08.2017 19:59:58,sl 130.995,-0.29,-331.71999999991385,0.0,0.0,130215,28.08.2017 05:00:00,14959,-0.1314328686772448,-64.81,IS,0.09,0.0,Phase3-EA-TR1v1-EURJPY-M30-91,EURJPYMT4,2662,1d 14h 59m,Sell
161850.84,109405,29.08.2017 22:14:58,sl 109.405,0.0,-536.5599999999104,0.0,0.0,108575,29.08.2017 17:45:00,14960,-0.21259381411271255,-204.84,IS,0.27,0.0,Phase3-EA-S1v2-USDJPY-M15-0,USDJPYMT4,4332,4h 29m,Sell
161746.52,1.14374,30.08.2017 05:05:00,,-2.15,-640.8799999999173,0.0,0.0,1.14136,29.08.2017 20:45:00,14961,-0.2539270977869398,-104.32,IS,0.41,0.0,Phase3-EA-SA2v2-EURCHF-M5-43,EURCHFMT4,7588,8h 20m,Sell
161728.07,141883,30.08.2017 08:55:00,,0.0,-659.329999999929,0.0,0.0,141795,30.08.2017 03:30:00,14962,-0.2612372883907542,-18.45,IS,0.23,0.0,Phase3-EA-S4v1-GBPJPY-M5-194,GBPJPYMT4,3248,5h 25m,Sell
161778.77,0.96227,31.08.2017 01:29:57,tp 0.96227,-9.57,-608.6299999999173,0.0,0.0,0.96327,30.08.2017 22:30:00,14963,-0.24114912234125593,50.7,IS,0.58,0.0,Phase3-EA-SA2v2-USDCHF-M15-107,USDCHFMT4,2966,2h 59m,Sell
161695.76,1.14538,31.08.2017 05:15:00,,-6.38,-691.6399999999267,0.0,0.0,1.14358,30.08.2017 20:55:00,14964,-0.27403903681401054,-83.01,IS,0.41,0.0,Phase3-EA-SA2v2-EURCHF-M5-43,EURCHFMT4,7590,8h 20m,Sell
161651.1,1.2868,31.08.2017 14:29:58,sl 1.28680,-2.66,-736.2999999999302,0.0,0.0,1.2898,28.08.2017 11:00:00,14965,-0.2917340564544535,-44.66,IS,0.14,0.0,Phase3-EA-B1v1-GBPUSD-M30-14,GBPUSDMT4,972,3d 3h 29m,Buy
161697.07,1.1432,01.09.2017 02:34:58,tp 1.14320,-1.03,-690.329999999929,0.0,0.0,1.1421,31.08.2017 22:25:00,14966,-0.2735199934703263,45.97,IS,0.41,0.0,Phase3-EA-SA2v2-EURCHF-M5-43,EURCHFMT4,7592,4h 9m,Buy
161681.36,0.95967,01.09.2017 07:00:00,,0.0,-706.0399999999208,0.0,0.0,0.95941,01.09.2017 02:45:00,14967,-0.27974455143161586,-15.71,IS,0.58,0.0,Phase3-EA-SA2v2-USDCHF-M15-107,USDCHFMT4,2968,4h 15m,Sell
161728.35,1.14204,01.09.2017 08:29:58,tp 1.14204,0.0,-659.0499999999302,0.0,0.0,1.14314,01.09.2017 02:40:00,14968,-0.26112634782874566,46.99,IS,0.41,0.0,Phase3-EA-SA2v2-EURCHF-M5-43,EURCHFMT4,7594,5h 49m,Sell
161758.24,142251,01.09.2017 08:35:00,,0.0,-629.1599999999162,0.0,0.0,142394,01.09.2017 03:10:00,14969,-0.2492834428342753,29.89,IS,0.23,0.0,Phase3-EA-S4v1-GBPJPY-M5-194,GBPJPYMT4,3250,5h 25m,Sell
161784.44,1.1421,01.09.2017 12:15:00,,0.0,-602.9599999999045,0.0,0.0,1.14284,01.09.2017 03:30:00,14970,-0.23890257596056785,26.2,IS,0.34,0.0,Phase3-EA-S4v1-EURCHF-M15-221,EURCHFMT4,3858,8h 45m,Sell
161829.07,1.14271,04.09.2017 01:15:00,tp 1.14271,-2.13,-558.3299999998999,0.0,0.0,1.14381,01.09.2017 20:25:00,14971,-0.22121944280891112,44.63,IS,0.41,0.0,Phase3-EA-SA2v2-EURCHF-M5-43,EURCHFMT4,7596,2d 4h 50m,Sell
161876.08,1.14026,04.09.2017 02:04:57,tp 1.14026,0.0,-511.31999999989057,0.0,0.0,1.13916,04.09.2017 01:15:00,14972,-0.2025933148801757,47.01,IS,0.41,0.0,Phase3-EA-SA2v2-EURCHF-M5-43,EURCHFMT4,7598,49m 57s,Buy
161957.76,142446,04.09.2017 04:29:58,tp 142.446,0.0,-429.63999999989755,0.0,0.0,142056,04.09.2017 01:35:00,14973,-0.1702303680769705,81.68,IS,0.23,0.0,Phase3-EA-S4v1-GBPJPY-M5-194,GBPJPYMT4,3252,2h 54m,Buy
161980.08,1.14128,04.09.2017 11:00:00,,0.0,-407.31999999989057,0.0,0.0,1.14065,04.09.2017 02:15:00,14974,-0.16138682041967586,22.32,IS,0.34,0.0,Phase3-EA-S4v1-EURCHF-M15-221,EURCHFMT4,3860,8h 45m,Buy
162027.1,1.13977,04.09.2017 20:59:59,tp 1.13977,0.0,-360.29999999990105,0.0,0.0,1.14087,04.09.2017 20:00:00,14975,-0.14275673032801942,47.02,IS,0.41,0.0,Phase3-EA-SA2v2-EURCHF-M5-43,EURCHFMT4,7600,59m 59s,Sell
161970.3,141255,05.09.2017 06:29:58,sl 141.255,-1.76,-417.0999999998894,0.0,0.0,141925,30.08.2017 04:30:00,14976,-0.16526181576413393,-56.8,IS,0.09,0.0,Phase3-EA-B1v1-GBPJPY-M30-1,GBPJPYMT4,1374,6d 1h 59m,Buy
161908.35,130029,05.09.2017 06:29:58,sl 130.029,-2.8,-479.04999999990105,0.0,0.0,130749,29.08.2017 12:30:00,14977,-0.18980741510863822,-61.95,IS,0.09,0.0,Phase3-EA-TR1v1-EURJPY-M30-91,EURJPYMT4,2663,6d 17h 59m,Buy
162172.57,129437,05.09.2017 20:59:57,tp 129.437,-1.62,-214.82999999989988,0.0,0.0,131137,31.08.2017 14:45:00,14978,-0.08511914620139478,264.22,IS,0.17,0.0,Phase3-EA-T1v2-EURJPY-M15-322,EURJPYMT4,2934,5d 6h 14m,Sell
162227.74,108.64,06.09.2017 02:15:00,,0.0,-159.65999999988708,0.0,0.0,108862,06.09.2017 00:15:00,14979,-0.06325989332268031,55.17,IS,0.27,0.0,Phase3-EA-S1v2-USDJPY-M15-0,USDJPYMT4,4334,2h 0m,Sell
162194.47,1.13713,06.09.2017 05:25:00,,-1.03,-192.9299999998766,0.0,0.0,1.13788,05.09.2017 21:05:00,14980,-0.07644200938710723,-33.27,IS,0.41,0.0,Phase3-EA-SA2v2-EURCHF-M5-43,EURCHFMT4,7602,8h 20m,Buy
162234.73,1.13816,06.09.2017 11:15:00,,0.0,-152.6699999998673,0.0,0.0,1.13703,06.09.2017 02:30:00,14981,-0.06049034143537542,40.26,IS,0.34,0.0,Phase3-EA-S4v1-EURCHF-M15-221,EURCHFMT4,3862,8h 45m,Buy
162281.86,1.14082,06.09.2017 21:34:58,tp 1.14082,0.0,-105.53999999986263,0.0,0.0,1.14192,06.09.2017 21:25:00,14982,-0.04181666755149513,47.13,IS,0.41,0.0,Phase3-EA-SA2v2-EURCHF-M5-43,EURCHFMT4,7604,9m 58s,Sell
162245.94,130061,07.09.2017 16:44:57,sl 130.061,0.0,-141.45999999987544,0.0,0.0,130291,07.09.2017 12:00:00,14983,-0.056048756792088227,-35.92,IS,0.17,0.0,Phase3-EA-T1v2-EURJPY-M15-322,EURJPYMT4,2936,4h 44m,Buy
162351.34,130788,07.09.2017 16:59:58,tp 130.788,-1.21,-36.059999999881256,0.0,0.0,129498,06.09.2017 06:30:00,14984,-0.014287559521545496,105.4,IS,0.09,0.0,Phase3-EA-TR1v1-EURJPY-M30-91,EURJPYMT4,2666,1d 10h 29m,Buy
162398.71,1.14305,07.09.2017 21:14:58,tp 1.14305,0.0,-0.0,0.0,0.0,1.14195,07.09.2017 20:10:00,14985,-0.0,47.37,IS,0.41,0.0,Phase3-EA-SA2v2-EURCHF-M5-43,EURCHFMT4,7606,1h 4m,Buy
162468.4,108292,08.09.2017 02:15:00,,-1.12,-0.0,0.0,0.0,108576,07.09.2017 21:45:00,14986,-0.0,69.69,IS,0.27,0.0,Phase3-EA-S1v2-USDJPY-M15-0,USDJPYMT4,4336,4h 30m,Sell
162229.25,0.94584,08.09.2017 06:29:58,sl 0.94584,0.0,-239.14999999999418,0.0,0.0,0.94974,08.09.2017 02:45:00,14987,-0.09472472594589783,-239.15,IS,0.58,0.0,Phase3-EA-SA2v2-USDCHF-M15-107,USDCHFMT4,2970,3h 44m,Buy
162192.92,130111,08.09.2017 09:29:58,sl 130.111,0.0,-275.4799999999814,0.0,0.0,130341,08.09.2017 04:15:00,14988,-0.10911464563485179,-36.33,IS,0.17,0.0,Phase3-EA-T1v2-EURJPY-M15-322,EURJPYMT4,2938,5h 14m,Buy
162255.4,1.14276,08.09.2017 14:15:00,,0.0,-212.9999999999709,0.0,0.0,1.14102,08.09.2017 05:30:00,14989,-0.08436699404756,62.48,IS,0.34,0.0,Phase3-EA-S4v1-EURCHF-M15-221,EURCHFMT4,3864,8h 45m,Buy
162315.96,0.94613,11.09.2017 01:00:00,tp 0.94613,-0.74,-152.43999999997322,0.0,0.0,0.94513,08.09.2017 22:45:00,14990,-0.06037983367422321,60.56,IS,0.58,0.0,Phase3-EA-SA2v2-USDCHF-M15-107,USDCHFMT4,2972,2d 2h 15m,Buy
162411.35,108147,11.09.2017 01:15:00,,-0.73,-57.049999999959255,0.0,0.0,107762,08.09.2017 22:00:00,14991,-0.022596887372819334,95.39,IS,0.27,0.0,Phase3-EA-S1v2-USDJPY-M15-0,USDJPYMT4,4338,2d 3h 15m,Buy
162457.96,1.13798,11.09.2017 01:24:58,tp 1.13798,-1.04,-10.439999999973224,0.0,0.0,1.13688,08.09.2017 22:35:00,14992,-0.004135170975842196,46.61,IS,0.41,0.0,Phase3-EA-SA2v2-EURCHF-M5-43,EURCHFMT4,7608,2d 2h 49m,Buy
162519.18,0.9474,11.09.2017 02:59:57,tp 0.94740,0.0,-0.0,0.0,0.0,0.9464,11.09.2017 01:15:00,14993,-0.0,61.22,IS,0.58,0.0,Phase3-EA-SA2v2-USDCHF-M15-107,USDCHFMT4,2974,1h 44m,Buy
162489.05,142872,11.09.2017 07:00:00,,0.0,-30.130000000004657,0.0,0.0,142.73,11.09.2017 01:35:00,14994,-0.011931766925587403,-30.13,IS,0.23,0.0,Phase3-EA-S4v1-GBPJPY-M5-194,GBPJPYMT4,3254,5h 25m,Sell
162372.03,1.14066,11.09.2017 09:50:00,,0.0,-147.14999999999418,0.0,0.0,1.13795,11.09.2017 01:30:00,14995,-0.0582728012977048,-117.02,IS,0.41,0.0,Phase3-EA-SA2v2-EURCHF-M5-43,EURCHFMT4,7610,8h 20m,Sell
162346.6,1.14027,11.09.2017 14:00:00,,0.0,-172.5799999999872,0.0,0.0,1.13956,11.09.2017 05:15:00,14996,-0.06834332346556266,-25.43,IS,0.34,0.0,Phase3-EA-S4v1-EURCHF-M15-221,EURCHFMT4,3866,8h 45m,Sell
162286.9,130632,11.09.2017 21:29:58,sl 130.632,-0.29,-232.27999999999884,0.0,0.0,129912,08.09.2017 13:00:00,14997,-0.09198509198390308,-59.7,IS,0.09,0.0,Phase3-EA-TR1v1-EURJPY-M30-91,EURJPYMT4,2668,3d 8h 29m,Sell
162334.18,1.14154,11.09.2017 22:59:58,tp 1.14154,0.0,-185.0,0.0,0.0,1.14044,11.09.2017 20:30:00,14998,-0.07326176174023659,47.28,IS,0.41,0.0,Phase3-EA-SA2v2-EURCHF-M5-43,EURCHFMT4,7612,2h 29m,Buy
162391.69,0.95523,12.09.2017 01:00:00,tp 0.95523,-3.21,-127.48999999999069,0.0,0.0,0.95623,11.09.2017 23:30:00,14999,-0.05048725407709233,57.51,IS,0.58,0.0,Phase3-EA-SA2v2-USDCHF-M15-107,USDCHFMT4,2976,1h 30m,Sell
162436.71,1.1409,12.09.2017 01:00:00,tp 1.14090,-2.14,-82.47000000000116,0.0,0.0,1142,11.09.2017 23:10:00,15000,-0.032658905355229174,45.02,IS,0.41,0.0,Phase3-EA-SA2v2-EURCHF-M5-43,EURCHFMT4,7614,1h 50m,Sell
162588.17,145631,12.09.2017 13:29:57,tp 145.631,-0.3,-0.0,0.0,0.0,143781,11.09.2017 20:30:00,15001,-0.0,151.46,IS,0.09,0.0,Phase3-EA-B1v1-GBPJPY-M30-1,GBPJPYMT4,1376,16h 59m,Buy
162620.56,110027,12.09.2017 19:30:00,,0.0,-0.0,0.0,0.0,109895,12.09.2017 18:30:00,15002,-0.0,32.39,IS,0.27,0.0,Phase3-EA-S1v2-USDJPY-M15-0,USDJPYMT4,4340,1h 0m,Buy
162667.52,1.1482,12.09.2017 20:54:58,tp 1.14820,0.0,-0.0,0.0,0.0,1.1493,12.09.2017 20:30:00,15003,-0.0,46.96,IS,0.41,0.0,Phase3-EA-SA2v2-EURCHF-M5-43,EURCHFMT4,7616,24m 58s,Sell
162931.06,1.32937,12.09.2017 22:29:58,tp 1.32937,-1.06,-0.0,0.0,0.0,1.31047,08.09.2017 05:00:00,15004,-0.0,263.54,IS,0.14,0.0,Phase3-EA-B1v1-GBPUSD-M30-14,GBPUSDMT4,974,4d 17h 29m,Buy
162988.26,0.96024,13.09.2017 00:29:58,tp 0.96024,-3.2,-0.0,0.0,0.0,0.96124,12.09.2017 23:30:00,15005,-0.0,57.2,IS,0.58,0.0,Phase3-EA-SA2v2-USDCHF-M15-107,USDCHFMT4,2978,59m 58s,Sell
163033.08,1.14871,13.09.2017 00:29:58,tp 1.14871,-2.13,-0.0,0.0,0.0,1.14981,12.09.2017 23:25:00,15006,-0.0,44.82,IS,0.41,0.0,Phase3-EA-SA2v2-EURCHF-M5-43,EURCHFMT4,7618,1h 4m,Sell
163048.03,110197,13.09.2017 02:30:00,,0.0,-0.0,0.0,0.0,110136,13.09.2017 01:30:00,15007,-0.0,14.95,IS,0.27,0.0,Phase3-EA-S1v2-USDJPY-M15-0,USDJPYMT4,4342,1h 0m,Buy
163108.41,0.96062,13.09.2017 04:29:58,tp 0.96062,0.0,-0.0,0.0,0.0,0.95962,13.09.2017 01:15:00,15008,-0.0,60.38,IS,0.58,0.0,Phase3-EA-SA2v2-USDCHF-M15-107,USDCHFMT4,2980,3h 14m,Buy
163141.03,146339,13.09.2017 04:55:00,,-1.21,-0.0,0.0,0.0,146501,12.09.2017 23:30:00,15009,-0.0,32.62,IS,0.23,0.0,Phase3-EA-S4v1-GBPJPY-M5-194,GBPJPYMT4,3256,5h 25m,Sell
163286.24,131761,13.09.2017 12:00:00,,-0.76,-0.0,0.0,0.0,130817,12.09.2017 10:00:00,15010,-0.0,145.21,IS,0.17,0.0,Phase3-EA-T1v2-EURJPY-M15-322,EURJPYMT4,2940,1d 2h 0m,Buy
163309.98,1.14887,13.09.2017 14:00:00,,0.0,-0.0,0.0,0.0,1.14954,13.09.2017 05:15:00,15011,-0.0,23.74,IS,0.34,0.0,Phase3-EA-S4v1-EURCHF-M15-221,EURCHFMT4,3868,8h 45m,Sell
163314.79,0.96433,14.09.2017 05:00:00,,0.0,-0.0,0.0,0.0,0.96425,14.09.2017 00:45:00,15012,-0.0,4.81,IS,0.58,0.0,Phase3-EA-SA2v2-USDCHF-M15-107,USDCHFMT4,2982,4h 15m,Buy
163312.59,110.57,14.09.2017 05:00:00,,0.0,-2.2000000000116415,0.0,0.0,110579,14.09.2017 00:15:00,15013,-8.684846234251192E-4,-2.2,IS,0.27,0.0,Phase3-EA-S1v2-USDJPY-M15-0,USDJPYMT4,4344,4h 45m,Buy
163263.18,1.14488,14.09.2017 07:55:00,,-3.06,-51.610000000015134,0.0,0.0,1.14597,13.09.2017 23:35:00,15014,-0.02037385973397562,-49.41,IS,0.41,0.0,Phase3-EA-SA2v2-EURCHF-M5-43,EURCHFMT4,7620,8h 20m,Buy
163235.68,1.14517,14.09.2017 10:00:00,,0.0,-79.11000000001513,0.0,0.0,1.14595,14.09.2017 01:15:00,15015,-0.031229917526732168,-27.5,IS,0.34,0.0,Phase3-EA-S4v1-EURCHF-M15-221,EURCHFMT4,3870,8h 45m,Buy
163179.9,145385,14.09.2017 15:29:57,sl 145.385,-1.17,-134.89000000001397,0.0,0.0,146055,12.09.2017 19:30:00,15016,-0.05324995038782116,-55.78,IS,0.09,0.0,Phase3-EA-B1v1-GBPJPY-M30-1,GBPJPYMT4,1378,1d 19h 59m,Buy
163226.6,1.14851,14.09.2017 21:14:58,tp 1.14851,0.0,-88.19000000000233,0.0,0.0,1.14741,14.09.2017 20:45:00,15017,-0.034814390427026366,46.7,IS,0.41,0.0,Phase3-EA-SA2v2-EURCHF-M5-43,EURCHFMT4,7622,29m 58s,Buy
163271.27,1.14754,15.09.2017 00:39:58,tp 1.14754,-2.13,-43.51999999998952,0.0,0.0,1.14864,14.09.2017 21:20:00,15018,-0.017180204914205494,44.67,IS,0.41,0.0,Phase3-EA-SA2v2-EURCHF-M5-43,EURCHFMT4,7624,3h 19m,Sell
163318.12,1.14786,15.09.2017 01:44:58,tp 1.14786,0.0,-0.0,0.0,0.0,1.14676,15.09.2017 01:05:00,15019,-0.0,46.85,IS,0.41,0.0,Phase3-EA-SA2v2-EURCHF-M5-43,EURCHFMT4,7626,39m 58s,Buy
163151.29,146981,15.09.2017 02:04:58,sl 146.981,0.0,-166.8299999999872,0.0,0.0,147781,15.09.2017 00:50:00,15020,-0.0658579023087596,-166.83,IS,0.23,0.0,Phase3-EA-S4v1-GBPJPY-M5-194,GBPJPYMT4,3258,1h 14m,Buy
163198.2,1.14637,15.09.2017 03:09:59,tp 1.14637,0.0,-119.9199999999837,0.0,0.0,1.14527,15.09.2017 02:30:00,15021,-0.047339684977917545,46.91,IS,0.41,0.0,Phase3-EA-SA2v2-EURCHF-M5-43,EURCHFMT4,7628,39m 59s,Buy
163258.39,0.96359,15.09.2017 04:59:57,tp 0.96359,0.0,-59.72999999998137,0.0,0.0,0.96259,15.09.2017 01:15:00,15022,-0.023579047562796177,60.19,IS,0.58,0.0,Phase3-EA-SA2v2-USDCHF-M15-107,USDCHFMT4,2984,3h 44m,Buy
163308.06,147625,15.09.2017 07:35:00,,0.0,-10.059999999968568,0.0,0.0,147387,15.09.2017 02:10:00,15023,-0.003971291118048927,49.67,IS,0.23,0.0,Phase3-EA-S4v1-GBPJPY-M5-194,GBPJPYMT4,3260,5h 25m,Buy
163373.72,1.1479,15.09.2017 11:30:00,,0.0,-0.0,0.0,0.0,1.14604,15.09.2017 02:45:00,15024,-0.0,65.66,IS,0.34,0.0,Phase3-EA-S4v1-EURCHF-M15-221,EURCHFMT4,3872,8h 45m,Buy
163473.76,132101,15.09.2017 11:59:57,tp 132.101,-2.4,-0.0,0.0,0.0,130841,11.09.2017 23:30:00,15025,-0.0,100.04,IS,0.09,0.0,Phase3-EA-TR1v1-EURJPY-M30-91,EURJPYMT4,2670,3d 12h 29m,Buy
163738.36,1.35993,15.09.2017 14:29:58,tp 1.35993,0.0,-0.0,0.0,0.0,1.34103,15.09.2017 09:30:00,15026,-0.0,264.6,IS,0.14,0.0,Phase3-EA-B1v1-GBPUSD-M30-14,GBPUSDMT4,976,4h 59m,Buy
163814.5,111026,18.09.2017 01:15:00,,-0.71,-0.0,0.0,0.0,110.71,15.09.2017 17:00:00,15027,-0.0,76.14,IS,0.27,0.0,Phase3-EA-S1v2-USDJPY-M15-0,USDJPYMT4,4346,2d 8h 15m,Buy
163874.93,0.95976,18.09.2017 02:29:58,tp 0.95976,0.0,-0.0,0.0,0.0,0.96076,18.09.2017 01:45:00,15028,-0.0,60.43,IS,0.58,0.0,Phase3-EA-SA2v2-USDCHF-M15-107,USDCHFMT4,2986,44m 58s,Sell
163896.95,1.14733,18.09.2017 05:35:00,,-1.03,-0.0,0.0,0.0,1.14679,15.09.2017 21:15:00,15029,-0.0,22.02,IS,0.41,0.0,Phase3-EA-SA2v2-EURCHF-M5-43,EURCHFMT4,7630,2d 8h 20m,Buy
163852.49,151.19,18.09.2017 07:25:00,,0.0,-44.45999999999185,0.0,0.0,150975,18.09.2017 02:00:00,15030,-0.017511041389032693,-44.46,IS,0.23,0.0,Phase3-EA-S4v1-GBPJPY-M5-194,GBPJPYMT4,3262,5h 25m,Sell
163888.27,1.14634,18.09.2017 14:15:00,,0.0,-8.679999999993015,0.0,0.0,1.14735,18.09.2017 05:30:00,15031,-0.003418709834833768,35.78,IS,0.34,0.0,Phase3-EA-S4v1-EURCHF-M15-221,EURCHFMT4,3874,8h 45m,Sell
163989.72,133.24,18.09.2017 16:59:58,tp 133.240,-0.4,-0.0,0.0,0.0,131.98,15.09.2017 12:00:00,15032,-0.0,101.45,IS,0.09,0.0,Phase3-EA-TR1v1-EURJPY-M30-91,EURJPYMT4,2672,3d 4h 59m,Buy
163957.3,1.14995,19.09.2017 04:30:00,,-2.13,-32.420000000012806,0.0,0.0,1.14924,18.09.2017 20:10:00,15033,-0.01276429612978535,-32.42,IS,0.41,0.0,Phase3-EA-SA2v2-EURCHF-M5-43,EURCHFMT4,7632,8h 20m,Sell
163911.73,150759,19.09.2017 06:00:00,,0.0,-77.99000000001979,0.0,0.0,150538,19.09.2017 00:35:00,15034,-0.030705967154898796,-45.57,IS,0.23,0.0,Phase3-EA-S4v1-GBPJPY-M5-194,GBPJPYMT4,3264,5h 25m,Sell
163773.75,1.15383,19.09.2017 13:14:58,sl 1.15383,0.0,-215.97000000003027,0.0,0.0,1.14993,19.09.2017 04:30:00,15035,-0.08503100046727452,-137.98,IS,0.34,0.0,Phase3-EA-S4v1-EURCHF-M15-221,EURCHFMT4,3876,8h 44m,Sell
163884.2,133431,19.09.2017 16:15:00,,-0.75,-105.52000000001863,0.0,0.0,132702,18.09.2017 02:30:00,15036,-0.041544988513715485,110.45,IS,0.17,0.0,Phase3-EA-T1v2-EURJPY-M15-322,EURJPYMT4,2942,1d 13h 45m,Buy
163964.61,150.53,20.09.2017 01:04:58,tp 150.530,0.0,-25.110000000015134,0.0,0.0,150.92,20.09.2017 00:40:00,15037,-0.009886226891393483,80.41,IS,0.23,0.0,Phase3-EA-S4v1-GBPJPY-M5-194,GBPJPYMT4,3266,24m 58s,Sell
163961.71,111592,20.09.2017 04:00:00,,0.0,-28.010000000009313,0.0,0.0,111604,20.09.2017 00:45:00,15038,-0.011028005385418425,-2.9,IS,0.27,0.0,Phase3-EA-S1v2-USDJPY-M15-0,USDJPYMT4,4348,3h 15m,Buy
163961.71,1.15398,20.09.2017 05:10:00,,-2.13,-28.010000000009313,0.0,0.0,1.15403,19.09.2017 20:50:00,15039,-0.011028005385418425,0.0,IS,0.41,0.0,Phase3-EA-SA2v2-EURCHF-M5-43,EURCHFMT4,7634,8h 20m,Sell
164001.72,150.79,20.09.2017 06:35:00,,0.0,-0.0,0.0,0.0,150596,20.09.2017 01:10:00,15040,-0.0,40.01,IS,0.23,0.0,Phase3-EA-S4v1-GBPJPY-M5-194,GBPJPYMT4,3268,5h 25m,Buy
163993.65,133752,20.09.2017 11:30:00,,-0.75,-8.070000000006985,0.0,0.0,133.8,19.09.2017 21:15:00,15041,-0.0031771438398161033,-8.07,IS,0.17,0.0,Phase3-EA-T1v2-EURJPY-M15-322,EURJPYMT4,2944,14h 15m,Buy
164053.96,0.96168,20.09.2017 22:14:58,tp 0.96168,0.0,-0.0,0.0,0.0,0.96068,20.09.2017 22:00:00,15042,-0.0,60.31,IS,0.58,0.0,Phase3-EA-SA2v2-USDCHF-M15-107,USDCHFMT4,2988,14m 58s,Buy
164017.56,133656,21.09.2017 02:29:58,sl 133.656,-1.59,-36.39999999999418,0.0,0.0,133426,20.09.2017 22:30:00,15043,-0.014327664878750168,-36.4,IS,0.17,0.0,Phase3-EA-T1v2-EURJPY-M15-322,EURJPYMT4,2946,3h 59m,Sell
164020.42,151722,21.09.2017 07:55:00,,0.0,-33.54000000000815,0.0,0.0,151736,21.09.2017 02:30:00,15044,-0.013201919781139403,2.86,IS,0.23,0.0,Phase3-EA-S4v1-GBPJPY-M5-194,GBPJPYMT4,3270,5h 25m,Sell
163985.65,133757,21.09.2017 10:44:58,sl 133.757,0.0,-68.30999999999767,0.0,0.0,133527,21.09.2017 05:45:00,15045,-0.02688798867767987,-34.77,IS,0.17,0.0,Phase3-EA-T1v2-EURJPY-M15-322,EURJPYMT4,2948,4h 59m,Sell
164132.43,152568,21.09.2017 20:59:58,tp 152.568,-1.45,-0.0,0.0,0.0,150718,18.09.2017 01:30:00,15046,-0.0,146.78,IS,0.09,0.0,Phase3-EA-B1v1-GBPJPY-M30-1,GBPJPYMT4,1380,3d 19h 29m,Buy
164176.8,1.15847,22.09.2017 01:04:58,tp 1.15847,-2.11,-0.0,0.0,0.0,1.15957,21.09.2017 22:20:00,15047,-0.0,44.37,IS,0.41,0.0,Phase3-EA-SA2v2-EURCHF-M5-43,EURCHFMT4,7636,2h 44m,Sell
164094.22,0.96927,22.09.2017 05:15:00,,0.0,-82.5799999999872,0.0,0.0,0.97065,22.09.2017 01:00:00,15048,-0.032489196496291874,-82.58,IS,0.58,0.0,Phase3-EA-SA2v2-USDCHF-M15-107,USDCHFMT4,2990,4h 15m,Buy
163953.01,152003,22.09.2017 06:30:00,,0.0,-223.78999999997905,0.0,0.0,152.69,22.09.2017 01:05:00,15049,-0.08804501433646893,-141.21,IS,0.23,0.0,Phase3-EA-S4v1-GBPJPY-M5-194,GBPJPYMT4,3272,5h 25m,Buy
163925.48,1.15779,22.09.2017 09:25:00,,0.0,-251.31999999997788,0.0,0.0,1.15844,22.09.2017 01:05:00,15050,-0.09887605792502567,-27.53,IS,0.41,0.0,Phase3-EA-SA2v2-EURCHF-M5-43,EURCHFMT4,7638,8h 20m,Buy
164065.94,1.16171,22.09.2017 11:44:57,tp 1.16171,0.0,-110.85999999998603,0.0,0.0,1.15771,22.09.2017 05:45:00,15051,-0.043615310287951334,140.46,IS,0.34,0.0,Phase3-EA-S4v1-EURCHF-M15-221,EURCHFMT4,3878,5h 59m,Buy
164056.49,1.1582,25.09.2017 05:20:00,,-1.01,-120.30999999999767,0.0,0.0,1.1584,22.09.2017 21:00:00,15052,-0.047333194847050196,-9.45,IS,0.41,0.0,Phase3-EA-SA2v2-EURCHF-M5-43,EURCHFMT4,7640,2d 8h 20m,Buy
164086.94,0.97128,25.09.2017 05:30:00,,0.0,-89.85999999998603,0.0,0.0,0.97077,25.09.2017 01:15:00,15053,-0.03535334460107516,30.45,IS,0.58,0.0,Phase3-EA-SA2v2-USDCHF-M15-107,USDCHFMT4,2992,4h 15m,Buy
164073.41,151807,25.09.2017 08:05:00,,0.0,-103.38999999998487,0.0,0.0,151741,25.09.2017 02:40:00,15054,-0.04067641106504778,-13.53,IS,0.23,0.0,Phase3-EA-S4v1-GBPJPY-M5-194,GBPJPYMT4,3274,5h 25m,Sell
164091.26,1.15688,25.09.2017 10:45:00,,0.0,-85.53999999997905,0.0,0.0,1.15637,25.09.2017 02:00:00,15055,-0.033653740231200734,17.85,IS,0.34,0.0,Phase3-EA-S4v1-EURCHF-M15-221,EURCHFMT4,3880,8h 45m,Buy
164030.55,132.48,25.09.2017 19:29:58,sl 132.480,-2.76,-146.2499999999709,0.0,0.0,133.2,18.09.2017 17:30:00,15056,-0.0575386896050191,-60.71,IS,0.09,0.0,Phase3-EA-TR1v1-EURJPY-M30-91,EURJPYMT4,2674,7d 1h 59m,Buy
164289.33,132163,25.09.2017 20:14:58,tp 132.163,0.0,-0.0,0.0,0.0,133863,25.09.2017 10:00:00,15057,-0.0,258.78,IS,0.17,0.0,Phase3-EA-T1v2-EURJPY-M15-322,EURJPYMT4,2950,10h 14m,Sell
164335.98,1.14543,25.09.2017 20:34:58,tp 1.14543,0.0,-0.0,0.0,0.0,1.14433,25.09.2017 20:25:00,15058,-0.0,46.65,IS,0.41,0.0,Phase3-EA-SA2v2-EURCHF-M5-43,EURCHFMT4,7642,9m 58s,Buy
164380.52,1.14497,26.09.2017 00:39:58,tp 1.14497,-2.12,-0.0,0.0,0.0,1.14607,25.09.2017 23:30:00,15059,-0.0,44.54,IS,0.41,0.0,Phase3-EA-SA2v2-EURCHF-M5-43,EURCHFMT4,7644,1h 9m,Sell
164394.55,111627,26.09.2017 04:45:00,,0.0,-0.0,0.0,0.0,111685,26.09.2017 00:15:00,15060,-0.0,14.03,IS,0.27,0.0,Phase3-EA-S1v2-USDJPY-M15-0,USDJPYMT4,4350,4h 30m,Sell
164372.33,0.96587,26.09.2017 05:30:00,,0.0,-22.220000000001164,0.0,0.0,0.96624,26.09.2017 01:15:00,15061,-0.008734463847594635,-22.22,IS,0.58,0.0,Phase3-EA-SA2v2-USDCHF-M15-107,USDCHFMT4,2994,4h 15m,Buy
164419.0,1.14611,26.09.2017 06:49:57,tp 1.14611,0.0,-0.0,0.0,0.0,1.14501,26.09.2017 01:05:00,15062,-0.0,46.67,IS,0.41,0.0,Phase3-EA-SA2v2-EURCHF-M5-43,EURCHFMT4,7646,5h 44m,Buy
164395.43,112277,26.09.2017 21:00:00,,0.0,-23.570000000006985,0.0,0.0,112375,26.09.2017 20:45:00,15063,-0.009264245201815458,-23.57,IS,0.27,0.0,Phase3-EA-S1v2-USDJPY-M15-0,USDJPYMT4,4352,15m 0s,Buy
164360.59,132476,26.09.2017 21:29:58,sl 132.476,0.0,-58.41000000000349,0.0,0.0,132246,26.09.2017 08:15:00,15064,-0.02295819101560937,-34.84,IS,0.17,0.0,Phase3-EA-T1v2-EURJPY-M15-322,EURJPYMT4,2952,13h 14m,Sell
164382.71,112.29,26.09.2017 23:30:00,,0.0,-36.29000000000815,0.0,0.0,112198,26.09.2017 21:45:00,15065,-0.014263871802030498,22.12,IS,0.27,0.0,Phase3-EA-S1v2-USDJPY-M15-0,USDJPYMT4,4354,1h 45m,Buy
164428.16,1.14342,27.09.2017 04:49:58,tp 1.14342,-1.02,-0.0,0.0,0.0,1.14232,26.09.2017 23:30:00,15066,-0.0,45.45,IS,0.41,0.0,Phase3-EA-SA2v2-EURCHF-M5-43,EURCHFMT4,7648,5h 19m,Buy
164423.18,132483,27.09.2017 11:45:00,,0.0,-4.980000000010477,0.0,0.0,132516,27.09.2017 10:45:00,15067,-0.0019573305093313776,-4.98,IS,0.17,0.0,Phase3-EA-T1v2-EURJPY-M15-322,EURJPYMT4,2954,1h 0m,Buy
164387.92,1.1446,27.09.2017 14:30:00,,0.0,-40.24000000001979,0.0,0.0,1.14359,27.09.2017 05:45:00,15068,-0.015815859376579852,-35.26,IS,0.34,0.0,Phase3-EA-S4v1-EURCHF-M15-221,EURCHFMT4,3882,8h 45m,Sell
164353.22,132374,27.09.2017 19:29:58,sl 132.374,0.0,-74.94000000003143,0.0,0.0,132144,27.09.2017 19:00:00,15069,-0.029454286821093648,-34.7,IS,0.17,0.0,Phase3-EA-T1v2-EURJPY-M15-322,EURJPYMT4,2956,29m 58s,Sell
164324.34,112848,28.09.2017 02:45:00,,-2.08,-103.82000000003609,0.0,0.0,112.96,27.09.2017 18:30:00,15070,-0.040805231622174046,-28.88,IS,0.27,0.0,Phase3-EA-S1v2-USDJPY-M15-0,USDJPYMT4,4356,8h 15m,Buy
164287.45,132.38,28.09.2017 05:44:58,sl 132.380,-2.22,-140.71000000005006,0.0,0.0,132.61,27.09.2017 22:15:00,15071,-0.05530441284488689,-36.89,IS,0.17,0.0,Phase3-EA-T1v2-EURJPY-M15-322,EURJPYMT4,2958,7h 29m,Buy
164288.2,1.14214,28.09.2017 06:35:00,,-3.04,-139.96000000005006,0.0,0.0,1.14205,27.09.2017 22:15:00,15072,-0.05500963415372315,0.75,IS,0.41,0.0,Phase3-EA-SA2v2-EURCHF-M5-43,EURCHFMT4,7650,8h 20m,Buy
164253.58,132598,28.09.2017 07:59:58,sl 132.598,0.0,-174.5800000000454,0.0,0.0,132368,28.09.2017 05:45:00,15073,-0.06861661853783974,-34.62,IS,0.17,0.0,Phase3-EA-T1v2-EURJPY-M15-322,EURJPYMT4,2960,2h 14m,Sell
164246.46,151238,28.09.2017 08:25:00,,0.0,-181.70000000004075,0.0,0.0,151203,28.09.2017 03:00:00,15074,-0.07141505091261904,-7.12,IS,0.23,0.0,Phase3-EA-S4v1-GBPJPY-M5-194,GBPJPYMT4,3276,5h 25m,Sell
164299.48,1143,28.09.2017 10:00:00,,0.0,-128.68000000005122,0.0,0.0,1.14148,28.09.2017 01:15:00,15075,-0.05057616263862089,53.02,IS,0.34,0.0,Phase3-EA-S4v1-EURCHF-M15-221,EURCHFMT4,3884,8h 45m,Buy
164339.53,112581,28.09.2017 17:30:00,,0.0,-88.63000000006286,0.0,0.0,112748,28.09.2017 17:00:00,15076,-0.03483498053048154,40.05,IS,0.27,0.0,Phase3-EA-S1v2-USDJPY-M15-0,USDJPYMT4,4358,30m 0s,Sell
164304.75,132412,28.09.2017 22:29:58,sl 132.412,0.0,-123.4100000000617,0.0,0.0,132642,28.09.2017 08:15:00,15077,-0.0485048510353811,-34.78,IS,0.17,0.0,Phase3-EA-T1v2-EURJPY-M15-322,EURJPYMT4,2962,14h 14m,Buy
164313.03,1.14383,29.09.2017 04:30:00,,-1.01,-115.13000000006286,0.0,0.0,1.14361,28.09.2017 20:10:00,15078,-0.04525049428493383,8.28,IS,0.41,0.0,Phase3-EA-SA2v2-EURCHF-M5-43,EURCHFMT4,7652,8h 20m,Buy
164230.42,1.14619,29.09.2017 13:45:00,,0.0,-197.7400000000489,0.0,0.0,1.14383,29.09.2017 05:00:00,15079,-0.07771938452097753,-82.61,IS,0.34,0.0,Phase3-EA-S4v1-EURCHF-M15-221,EURCHFMT4,3886,8h 45m,Sell
164171.12,132911,29.09.2017 16:29:58,sl 132.911,-1.68,-257.04000000003725,0.0,0.0,132191,25.09.2017 21:30:00,15080,-0.10102655303565297,-59.3,IS,0.09,0.0,Phase3-EA-TR1v1-EURJPY-M30-91,EURJPYMT4,2676,3d 18h 59m,Sell
164129.12,1.34044,29.09.2017 16:59:58,sl 1.34044,0.0,-299.04000000003725,0.0,0.0,1.33744,29.09.2017 13:00:00,15081,-0.11753415974082262,-42.0,IS,0.14,0.0,Phase3-EA-B1v1-GBPUSD-M30-14,GBPUSDMT4,978,3h 59m,Sell
164208.75,150922,02.10.2017 02:24:57,tp 150.922,0.0,-219.4100000000326,0.0,0.0,150532,02.10.2017 01:15:00,15082,-0.0862365235043289,79.63,IS,0.23,0.0,Phase3-EA-S4v1-GBPJPY-M5-194,GBPJPYMT4,3278,1h 9m,Buy
164193.36,132923,02.10.2017 04:30:00,,0.0,-234.80000000004657,0.0,0.0,133025,02.10.2017 03:00:00,15083,-0.09228538224701441,-15.39,IS,0.17,0.0,Phase3-EA-T1v2-EURJPY-M15-322,EURJPYMT4,2964,1h 30m,Buy
164117.1,1.1421,02.10.2017 06:15:00,,-1.02,-311.0600000000559,0.0,0.0,1.14388,29.09.2017 21:55:00,15084,-0.12225847956454755,-76.26,IS,0.41,0.0,Phase3-EA-SA2v2-EURCHF-M5-43,EURCHFMT4,7654,2d 8h 20m,Buy
164128.11,150876,02.10.2017 08:05:00,,0.0,-300.05000000004657,0.0,0.0,150.93,02.10.2017 02:40:00,15085,-0.11793112837826013,11.01,IS,0.23,0.0,Phase3-EA-S4v1-GBPJPY-M5-194,GBPJPYMT4,3280,5h 25m,Sell
164076.62,1.14172,02.10.2017 10:00:00,,0.0,-351.54000000003725,0.0,0.0,1.14319,02.10.2017 01:15:00,15086,-0.1381686681222847,-51.49,IS,0.34,0.0,Phase3-EA-S4v1-EURCHF-M15-221,EURCHFMT4,3888,8h 45m,Buy
164120.79,1.14327,03.10.2017 01:09:57,tp 1.14327,-2.1,-307.37000000002445,0.0,0.0,1.14437,02.10.2017 20:25:00,15087,-0.12080816840400958,44.17,IS,0.41,0.0,Phase3-EA-SA2v2-EURCHF-M5-43,EURCHFMT4,7656,4h 44m,Sell
164086.1,132446,03.10.2017 04:59:58,sl 132.446,0.0,-342.0600000000268,0.0,0.0,132216,03.10.2017 04:30:00,15088,-0.13444266546597086,-34.69,IS,0.17,0.0,Phase3-EA-T1v2-EURJPY-M15-322,EURJPYMT4,2966,29m 58s,Sell
164132.3,1.14452,03.10.2017 05:39:58,tp 1.14452,0.0,-295.86000000001513,0.0,0.0,1.14342,03.10.2017 01:15:00,15089,-0.11628429809027965,46.2,IS,0.41,0.0,Phase3-EA-SA2v2-EURCHF-M5-43,EURCHFMT4,7658,4h 24m,Buy
164078.46,150055,03.10.2017 11:29:57,sl 150.055,-0.46,-349.70000000001164,0.0,0.0,149385,02.10.2017 20:00:00,15090,-0.13744547773328625,-53.84,IS,0.09,0.0,Phase3-EA-B1v1-GBPJPY-M30-1,GBPJPYMT4,1382,15h 29m,Sell
164166.19,1.14587,03.10.2017 13:00:00,,0.0,-261.97000000000116,0.0,0.0,1.14335,03.10.2017 04:15:00,15091,-0.10296423163222179,87.73,IS,0.34,0.0,Phase3-EA-S4v1-EURCHF-M15-221,EURCHFMT4,3890,8h 45m,Buy
164178.51,112817,04.10.2017 02:45:00,,-1.08,-249.64999999999418,0.0,0.0,112873,03.10.2017 23:15:00,15092,-0.09812200033203594,12.32,IS,0.27,0.0,Phase3-EA-S1v2-USDJPY-M15-0,USDJPYMT4,4360,3h 30m,Sell
164160.2,1.14392,04.10.2017 05:10:00,,-1.01,-267.95999999999185,0.0,0.0,1.14433,03.10.2017 20:50:00,15093,-0.10531853077897924,-18.31,IS,0.41,0.0,Phase3-EA-SA2v2-EURCHF-M5-43,EURCHFMT4,7660,8h 20m,Buy
164171.84,149447,04.10.2017 06:30:00,,0.0,-256.3199999999779,0.0,0.0,149.39,04.10.2017 01:05:00,15094,-0.10074356549211244,11.64,IS,0.23,0.0,Phase3-EA-S4v1-GBPJPY-M5-194,GBPJPYMT4,3282,5h 25m,Buy
164203.32,1.14433,04.10.2017 10:00:00,,0.0,-224.8399999999674,0.0,0.0,1.14343,04.10.2017 01:15:00,15095,-0.08837072122832877,31.48,IS,0.34,0.0,Phase3-EA-S4v1-EURCHF-M15-221,EURCHFMT4,3892,8h 45m,Buy
164168.67,132749,04.10.2017 20:14:58,sl 132.749,0.0,-259.4899999999616,0.0,0.0,132519,04.10.2017 08:45:00,15096,-0.10198949676009146,-34.65,IS,0.17,0.0,Phase3-EA-T1v2-EURJPY-M15-322,EURJPYMT4,2968,11h 29m,Sell
164208.63,1.14634,05.10.2017 01:04:57,tp 1.14634,-6.31,-219.52999999996973,0.0,0.0,1.14744,04.10.2017 20:00:00,15097,-0.08628368809489038,39.96,IS,0.41,0.0,Phase3-EA-SA2v2-EURCHF-M5-43,EURCHFMT4,7662,5h 4m,Sell
164217.56,112797,05.10.2017 03:45:00,,-2.08,-210.59999999997672,0.0,0.0,112751,04.10.2017 23:00:00,15098,-0.08277385647877016,8.93,IS,0.27,0.0,Phase3-EA-S1v2-USDJPY-M15-0,USDJPYMT4,4362,4h 45m,Buy
164193.1,132503,05.10.2017 13:30:00,,0.0,-235.05999999996857,0.0,0.0,132665,05.10.2017 11:30:00,15099,-0.09238757219325384,-24.46,IS,0.17,0.0,Phase3-EA-T1v2-EURJPY-M15-322,EURJPYMT4,2970,2h 0m,Buy
164138.63,112784,06.10.2017 03:30:00,,-1.08,-289.52999999996973,0.0,0.0,112561,05.10.2017 17:30:00,15100,-0.11379636593683981,-54.47,IS,0.27,0.0,Phase3-EA-S1v2-USDJPY-M15-0,USDJPYMT4,4364,10h 0m,Sell
164158.98,1.14606,06.10.2017 06:40:00,,-1.01,-269.1799999999639,0.0,0.0,1.14555,05.10.2017 22:20:00,15101,-0.10579803744992794,20.35,IS,0.41,0.0,Phase3-EA-SA2v2-EURCHF-M5-43,EURCHFMT4,7664,8h 20m,Buy
164172.17,1.14588,06.10.2017 10:00:00,,0.0,-255.98999999996158,0.0,0.0,1.1455,06.10.2017 01:15:00,15102,-0.10061386286799398,13.19,IS,0.34,0.0,Phase3-EA-S4v1-EURCHF-M15-221,EURCHFMT4,3894,8h 45m,Buy
164137.55,132314,06.10.2017 16:29:57,sl 132.314,0.0,-290.6099999999569,0.0,0.0,132084,06.10.2017 08:15:00,15103,-0.11422084725211057,-34.62,IS,0.17,0.0,Phase3-EA-T1v2-EURJPY-M15-322,EURJPYMT4,2972,8h 14m,Sell
164183.68,1.14814,09.10.2017 02:04:58,tp 1.14814,0.0,-244.47999999995227,0.0,0.0,1.14704,09.10.2017 01:00:00,15104,-0.09608999255426406,46.13,IS,0.41,0.0,Phase3-EA-SA2v2-EURCHF-M5-43,EURCHFMT4,7666,1h 4m,Buy
164263.33,147381,09.10.2017 07:09:58,tp 147.381,0.0,-164.8299999999581,0.0,0.0,146991,09.10.2017 02:30:00,15105,-0.06478449555267675,79.65,IS,0.23,0.0,Phase3-EA-S4v1-GBPJPY-M5-194,GBPJPYMT4,3284,4h 39m,Buy
164274.12,112602,09.10.2017 10:45:00,,0.0,-154.03999999994994,0.0,0.0,112557,09.10.2017 01:00:00,15106,-0.06054361278246448,10.79,IS,0.27,0.0,Phase3-EA-S1v2-USDJPY-M15-0,USDJPYMT4,4366,9h 45m,Buy
164272.38,1.14827,09.10.2017 13:15:00,,0.0,-155.77999999994063,0.0,0.0,1.14822,09.10.2017 04:30:00,15107,-0.06122749934596071,-1.74,IS,0.34,0.0,Phase3-EA-S4v1-EURCHF-M15-221,EURCHFMT4,3896,8h 45m,Sell
164218.38,148414,09.10.2017 15:29:58,sl 148.414,-0.46,-209.77999999994063,0.0,0.0,147744,06.10.2017 04:30:00,15108,-0.08245156510975027,-54.0,IS,0.09,0.0,Phase3-EA-B1v1-GBPJPY-M30-1,GBPJPYMT4,1384,3d 10h 59m,Sell
164264.47,1.15019,09.10.2017 23:44:59,tp 1.15019,0.0,-163.68999999994412,0.0,0.0,1.15129,09.10.2017 20:30:00,15109,-0.06433643194210237,46.09,IS,0.41,0.0,Phase3-EA-SA2v2-EURCHF-M5-43,EURCHFMT4,7668,3h 14m,Sell
164343.28,148346,10.10.2017 05:09:58,tp 148.346,-0.74,-84.87999999994645,0.0,0.0,147956,09.10.2017 23:50:00,15110,-0.03336108707461707,78.81,IS,0.23,0.0,Phase3-EA-S4v1-GBPJPY-M5-194,GBPJPYMT4,3286,5h 19m,Buy
164388.36,1.1512,10.10.2017 05:19:58,tp 1.15120,-1.01,-39.799999999959255,0.0,0.0,1.1501,09.10.2017 23:50:00,15111,-0.015642922544406666,45.08,IS,0.41,0.0,Phase3-EA-SA2v2-EURCHF-M5-43,EURCHFMT4,7670,5h 29m,Buy
164393.35,132406,10.10.2017 13:15:00,,0.0,-34.80999999996857,0.0,0.0,132373,10.10.2017 04:15:00,15112,-0.013681661652534215,4.99,IS,0.17,0.0,Phase3-EA-T1v2-EURJPY-M15-322,EURJPYMT4,2974,9h 0m,Buy
164412.16,1.15066,10.10.2017 14:30:00,,0.0,-15.999999999970896,0.0,0.0,1.1512,10.10.2017 05:45:00,15113,-0.006288612078148432,18.81,IS,0.34,0.0,Phase3-EA-S4v1-EURCHF-M15-221,EURCHFMT4,3898,8h 45m,Sell
164470.16,112193,10.10.2017 18:00:00,,0.0,-0.0,0.0,0.0,112434,10.10.2017 17:00:00,15114,-0.0,58.0,IS,0.27,0.0,Phase3-EA-S1v2-USDJPY-M15-0,USDJPYMT4,4368,1h 0m,Sell
164435.31,132299,10.10.2017 18:29:58,sl 132.299,0.0,-34.85000000000582,0.0,0.0,132529,10.10.2017 17:45:00,15115,-0.013695122445793111,-34.85,IS,0.17,0.0,Phase3-EA-T1v2-EURJPY-M15-322,EURJPYMT4,2976,44m 58s,Buy
164481.62,1.15127,10.10.2017 21:39:59,tp 1.15127,0.0,-0.0,0.0,0.0,1.15017,10.10.2017 20:20:00,15116,-0.0,46.31,IS,0.41,0.0,Phase3-EA-SA2v2-EURCHF-M5-43,EURCHFMT4,7672,1h 19m,Buy
164527.87,1.15087,10.10.2017 22:59:57,tp 1.15087,0.0,-0.0,0.0,0.0,1.15197,10.10.2017 21:45:00,15117,-0.0,46.25,IS,0.41,0.0,Phase3-EA-SA2v2-EURCHF-M5-43,EURCHFMT4,7674,1h 14m,Sell
164532.37,148462,11.10.2017 05:50:00,,0.0,-0.0,0.0,0.0,148484,11.10.2017 00:25:00,15118,-0.0,4.5,IS,0.23,0.0,Phase3-EA-S4v1-GBPJPY-M5-194,GBPJPYMT4,3288,5h 25m,Sell
164513.15,132534,11.10.2017 13:45:00,,-0.74,-19.220000000001164,0.0,0.0,132656,10.10.2017 21:45:00,15119,-0.007551102439348311,-19.22,IS,0.17,0.0,Phase3-EA-T1v2-EURJPY-M15-322,EURJPYMT4,2978,16h 0m,Buy
164452.9,133049,11.10.2017 19:29:58,sl 133.049,-2.52,-79.47000000000116,0.0,0.0,132845,29.09.2017 22:30:00,15120,-0.031221962063214502,-60.25,IS,0.09,0.0,Phase3-EA-TR1v1-EURJPY-M30-91,EURJPYMT4,2678,11d 20h 59m,Sell
164485.36,112521,12.10.2017 00:45:00,,-2.09,-47.01000000000931,0.0,0.0,112377,11.10.2017 23:30:00,15121,-0.01846916366669162,32.46,IS,0.27,0.0,Phase3-EA-S1v2-USDJPY-M15-0,USDJPYMT4,4370,1h 15m,Buy
164492.56,112496,12.10.2017 01:30:00,,0.0,-39.80999999999767,0.0,0.0,112466,12.10.2017 01:15:00,15122,-0.015640446831967768,7.2,IS,0.27,0.0,Phase3-EA-S1v2-USDJPY-M15-0,USDJPYMT4,4372,15m 0s,Buy
164447.47,1.15417,12.10.2017 04:35:00,,-6.32,-84.89999999999418,0.0,0.0,1.15325,11.10.2017 20:15:00,15123,-0.03335528600939588,-45.09,IS,0.41,0.0,Phase3-EA-SA2v2-EURCHF-M5-43,EURCHFMT4,7676,8h 20m,Sell
164431.31,148873,12.10.2017 06:05:00,,0.0,-101.05999999999767,0.0,0.0,148794,12.10.2017 00:40:00,15124,-0.03970418379398941,-16.16,IS,0.23,0.0,Phase3-EA-S4v1-GBPJPY-M5-194,GBPJPYMT4,3290,5h 25m,Sell
164495.72,133302,12.10.2017 10:30:00,,-2.22,-36.64999999999418,0.0,0.0,132862,11.10.2017 17:15:00,15125,-0.014398954443395156,64.41,IS,0.17,0.0,Phase3-EA-T1v2-EURJPY-M15-322,EURJPYMT4,2980,17h 15m,Buy
164509.7,1.15412,12.10.2017 11:30:00,,0.0,-22.669999999983702,0.0,0.0,1.15452,12.10.2017 02:45:00,15126,-0.008906529255977772,13.98,IS,0.34,0.0,Phase3-EA-S4v1-EURCHF-M15-221,EURCHFMT4,3900,8h 45m,Sell
164456.05,148185,12.10.2017 14:59:58,sl 148.185,0.0,-76.31999999997788,0.0,0.0,148855,12.10.2017 04:00:00,15127,-0.02998439844801567,-53.65,IS,0.09,0.0,Phase3-EA-B1v1-GBPJPY-M30-1,GBPJPYMT4,1386,10h 59m,Buy
164717.99,1.32785,12.10.2017 21:29:58,tp 1.32785,-2.66,-0.0,0.0,0.0,1.30895,09.10.2017 01:30:00,15128,-0.0,261.94,IS,0.14,0.0,Phase3-EA-B1v1-GBPUSD-M30-14,GBPUSDMT4,980,3d 19h 59m,Buy
164715.3,1.15412,13.10.2017 05:30:00,,-1.01,-2.6900000000023283,0.0,0.0,1.15416,12.10.2017 21:10:00,15129,-0.0010560698912559395,-2.69,IS,0.41,0.0,Phase3-EA-SA2v2-EURCHF-M5-43,EURCHFMT4,7678,8h 20m,Buy
164655.9,132534,13.10.2017 10:59:58,sl 132.534,-1.57,-62.08999999999651,0.0,0.0,132329,02.10.2017 14:30:00,15130,-0.024375977527145293,-59.4,IS,0.09,0.0,Phase3-EA-TR1v1-EURJPY-M30-91,EURJPYMT4,2679,10d 20h 29m,Sell
164666.7,1.15412,13.10.2017 12:15:00,,0.0,-51.29000000000815,0.0,0.0,1.15381,13.10.2017 03:30:00,15131,-0.02013599432062411,10.8,IS,0.34,0.0,Phase3-EA-S4v1-EURCHF-M15-221,EURCHFMT4,3902,8h 45m,Buy
164681.31,111784,16.10.2017 01:00:00,,-1.09,-36.68000000002212,0.0,0.0,111849,13.10.2017 22:00:00,15132,-0.014400239260690591,14.61,IS,0.27,0.0,Phase3-EA-S1v2-USDJPY-M15-0,USDJPYMT4,4374,2d 3h 0m,Sell
164761.43,148929,16.10.2017 04:54:58,tp 148.929,0.0,-0.0,0.0,0.0,148539,16.10.2017 01:05:00,15133,-0.0,80.12,IS,0.23,0.0,Phase3-EA-S4v1-GBPJPY-M5-194,GBPJPYMT4,3292,3h 49m,Buy
164820.88,0.97558,16.10.2017 05:14:58,tp 0.97558,0.0,-0.0,0.0,0.0,0.97458,16.10.2017 01:15:00,15134,-0.0,59.45,IS,0.58,0.0,Phase3-EA-SA2v2-USDCHF-M15-107,USDCHFMT4,2996,3h 59m,Buy
164806.01,1.15219,16.10.2017 06:35:00,,-1.01,-14.869999999995343,0.0,0.0,1.15252,13.10.2017 22:15:00,15135,-0.005835471567320255,-14.87,IS,0.41,0.0,Phase3-EA-SA2v2-EURCHF-M5-43,EURCHFMT4,7680,2d 8h 20m,Buy
164838.4,1.15124,16.10.2017 14:15:00,,0.0,-0.0,0.0,0.0,1.15217,16.10.2017 05:30:00,15136,-0.0,32.39,IS,0.34,0.0,Phase3-EA-S4v1-EURCHF-M15-221,EURCHFMT4,3904,8h 45m,Sell
164882.56,1.14992,17.10.2017 02:04:58,tp 1.14992,-2.1,-0.0,0.0,0.0,1.15102,16.10.2017 21:40:00,15137,-0.0,44.16,IS,0.41,0.0,Phase3-EA-SA2v2-EURCHF-M5-43,EURCHFMT4,7682,4h 24m,Sell
164941.97,0.97627,17.10.2017 04:59:58,tp 0.97627,0.0,-0.0,0.0,0.0,0.97527,17.10.2017 01:15:00,15138,-0.0,59.41,IS,0.58,0.0,Phase3-EA-SA2v2-USDCHF-M15-107,USDCHFMT4,2998,3h 44m,Buy
164988.13,1.15099,17.10.2017 09:19:58,tp 1.15099,0.0,-0.0,0.0,0.0,1.14989,17.10.2017 02:15:00,15139,-0.0,46.16,IS,0.41,0.0,Phase3-EA-SA2v2-EURCHF-M5-43,EURCHFMT4,7684,7h 4m,Buy
164960.65,1.14942,17.10.2017 15:00:00,,0.0,-27.480000000010477,0.0,0.0,1.15021,17.10.2017 06:15:00,15140,-0.010776972245731728,-27.48,IS,0.34,0.0,Phase3-EA-S4v1-EURCHF-M15-221,EURCHFMT4,3906,8h 45m,Buy
165004.67,1.15079,18.10.2017 01:19:58,tp 1.15079,-2.1,-0.0,0.0,0.0,1.15189,17.10.2017 20:05:00,15141,-0.0,44.02,IS,0.41,0.0,Phase3-EA-SA2v2-EURCHF-M5-43,EURCHFMT4,7686,5h 14m,Sell
165017.87,1.15127,18.10.2017 10:00:00,,0.0,-0.0,0.0,0.0,1.15089,18.10.2017 01:15:00,15142,-0.0,13.2,IS,0.34,0.0,Phase3-EA-S4v1-EURCHF-M15-221,EURCHFMT4,3908,8h 45m,Buy
164975.87,1.31888,18.10.2017 14:59:58,sl 1.31888,0.0,-42.0,0.0,0.0,1.31588,18.10.2017 13:00:00,15143,-0.01646943408318789,-42.0,IS,0.14,0.0,Phase3-EA-B1v1-GBPUSD-M30-14,GBPUSDMT4,982,1h 59m,Sell
164939.65,133013,18.10.2017 18:59:58,sl 133.013,-1.59,-78.22000000000116,0.0,0.0,132783,13.10.2017 09:45:00,15144,-0.030672360333023237,-36.22,IS,0.17,0.0,Phase3-EA-T1v2-EURJPY-M15-322,EURJPYMT4,2982,5d 9h 14m,Sell
164979.39,1.15596,19.10.2017 01:19:59,tp 1.15596,-6.27,-38.48000000001048,0.0,0.0,1.15706,18.10.2017 22:20:00,15145,-0.015089138655267679,39.74,IS,0.41,0.0,Phase3-EA-SA2v2-EURCHF-M5-43,EURCHFMT4,7688,2h 59m,Sell
165025.36,1.15681,19.10.2017 01:34:57,tp 1.15681,0.0,-0.0,0.0,0.0,1.15571,19.10.2017 01:25:00,15146,-0.0,45.97,IS,0.41,0.0,Phase3-EA-SA2v2-EURCHF-M5-43,EURCHFMT4,7690,9m 57s,Buy
165034.73,149258,19.10.2017 08:30:00,,0.0,-0.0,0.0,0.0,149304,19.10.2017 03:05:00,15147,-0.0,9.37,IS,0.23,0.0,Phase3-EA-S4v1-GBPJPY-M5-194,GBPJPYMT4,3294,5h 25m,Sell
164967.09,133625,19.10.2017 10:59:58,sl 133.625,-5.6,-67.64000000001397,0.0,0.0,133254,11.10.2017 22:00:00,15148,-0.026521878020304774,-67.64,IS,0.09,0.0,Phase3-EA-TR1v1-EURJPY-M30-91,EURJPYMT4,2681,7d 12h 59m,Buy
164912.65,148272,19.10.2017 12:29:58,sl 148.272,-0.86,-122.0800000000163,0.0,0.0,148942,18.10.2017 19:30:00,15149,-0.04786799037135674,-54.44,IS,0.09,0.0,Phase3-EA-B1v1-GBPJPY-M30-1,GBPJPYMT4,1388,16h 59m,Buy
164943.4,112408,19.10.2017 18:00:00,,0.0,-91.3300000000163,0.0,0.0,112536,19.10.2017 17:30:00,15150,-0.0358108089827671,30.75,IS,0.27,0.0,Phase3-EA-S1v2-USDJPY-M15-0,USDJPYMT4,4376,30m 0s,Sell
164959.12,112473,20.10.2017 00:15:00,,-1.08,-75.61000000001513,0.0,0.0,112543,19.10.2017 20:15:00,15151,-0.029646942594843746,15.72,IS,0.27,0.0,Phase3-EA-S1v2-USDJPY-M15-0,USDJPYMT4,4378,4h 0m,Sell
164752.1,1.1602,20.10.2017 06:04:58,sl 1.16020,-2.1,-282.63000000000466,0.0,0.0,1.1553,19.10.2017 23:20:00,15152,-0.11082020084088282,-207.02,IS,0.41,0.0,Phase3-EA-SA2v2-EURCHF-M5-43,EURCHFMT4,7692,6h 44m,Sell
164616.85,1.15999,20.10.2017 06:14:58,sl 1.15999,0.0,-417.88000000000466,0.0,0.0,1.15609,20.10.2017 01:15:00,15153,-0.16385219377768764,-135.25,IS,0.34,0.0,Phase3-EA-S4v1-EURCHF-M15-221,EURCHFMT4,3910,4h 59m,Sell
164715.31,133959,20.10.2017 14:29:57,tp 133.959,-1.56,-319.4200000000128,0.0,0.0,132699,18.10.2017 16:30:00,15154,-0.12524568712661652,98.46,IS,0.09,0.0,Phase3-EA-TR1v1-EURJPY-M30-91,EURJPYMT4,2683,1d 21h 59m,Buy
164704.22,133701,20.10.2017 18:15:00,,0.0,-330.5100000000093,0.0,0.0,133775,20.10.2017 17:30:00,15155,-0.12959411449570324,-11.09,IS,0.17,0.0,Phase3-EA-T1v2-EURJPY-M15-322,EURJPYMT4,2984,45m 0s,Buy
164747.94,1.15867,23.10.2017 01:04:57,tp 1.15867,-2.08,-286.79000000000815,0.0,0.0,1.15977,20.10.2017 22:05:00,15156,-0.11245135123361696,43.72,IS,0.41,0.0,Phase3-EA-SA2v2-EURCHF-M5-43,EURCHFMT4,7694,2d 2h 59m,Sell
164755.42,150066,23.10.2017 07:05:00,,0.0,-279.3099999999977,0.0,0.0,150103,23.10.2017 01:40:00,15157,-0.10951841735437218,7.48,IS,0.23,0.0,Phase3-EA-S4v1-GBPJPY-M5-194,GBPJPYMT4,3296,5h 25m,Sell
164725.84,1.15831,23.10.2017 09:25:00,,0.0,-308.88999999998487,0.0,0.0,1.15902,23.10.2017 01:05:00,15158,-0.12111683769500071,-29.58,IS,0.41,0.0,Phase3-EA-SA2v2-EURCHF-M5-43,EURCHFMT4,7696,8h 20m,Buy
164706.41,133847,23.10.2017 09:30:00,,0.0,-328.3199999999779,0.0,0.0,133977,23.10.2017 01:00:00,15159,-0.12873540791874746,-19.43,IS,0.17,0.0,Phase3-EA-T1v2-EURJPY-M15-322,EURJPYMT4,2986,8h 30m,Buy
164683.3,1.15821,23.10.2017 13:15:00,,0.0,-351.4299999999639,0.0,0.0,1.15888,23.10.2017 04:30:00,15160,-0.1377969188745243,-23.11,IS,0.34,0.0,Phase3-EA-S4v1-EURCHF-M15-221,EURCHFMT4,3912,8h 45m,Buy
164697.5,149675,24.10.2017 05:40:00,,0.0,-337.22999999995227,0.0,0.0,149605,24.10.2017 00:15:00,15161,-0.13222904974547997,14.2,IS,0.23,0.0,Phase3-EA-S4v1-GBPJPY-M5-194,GBPJPYMT4,3298,5h 25m,Buy
164696.5,1.15785,24.10.2017 06:25:00,,-1.0,-338.22999999995227,0.0,0.0,1.15785,23.10.2017 22:05:00,15162,-0.1326211532052715,-1.0,IS,0.41,0.0,Phase3-EA-SA2v2-EURCHF-M5-43,EURCHFMT4,7698,8h 20m,Buy
164731.69,1.15831,24.10.2017 10:45:00,,0.0,-303.03999999994994,0.0,0.0,1.15729,24.10.2017 02:00:00,15163,-0.11882303245520655,35.19,IS,0.34,0.0,Phase3-EA-S4v1-EURCHF-M15-221,EURCHFMT4,3914,8h 45m,Buy
164688.63,1.31289,24.10.2017 19:59:58,sl 1.31289,-1.06,-346.0999999999476,0.0,0.0,1.31589,20.10.2017 14:30:00,15164,-0.13570700743382905,-43.06,IS,0.14,0.0,Phase3-EA-B1v1-GBPUSD-M30-14,GBPUSDMT4,984,4d 5h 29m,Buy
164767.35,149653,25.10.2017 04:24:57,tp 149.653,0.0,-267.37999999994645,0.0,0.0,149263,25.10.2017 00:05:00,15165,-0.1048406230790391,78.72,IS,0.23,0.0,Phase3-EA-S4v1-GBPJPY-M5-194,GBPJPYMT4,3300,4h 19m,Buy
164752.87,1.16535,25.10.2017 07:30:00,,-2.07,-281.8599999999569,0.0,0.0,1.16505,24.10.2017 23:10:00,15166,-0.11051828117682462,-14.48,IS,0.41,0.0,Phase3-EA-SA2v2-EURCHF-M5-43,EURCHFMT4,7700,8h 20m,Sell
164754.08,113935,25.10.2017 13:45:00,,-0.69,-280.6499999999651,0.0,0.0,113927,24.10.2017 22:15:00,15167,-0.11004383599048005,1.21,IS,0.27,0.0,Phase3-EA-S1v2-USDJPY-M15-0,USDJPYMT4,4380,15h 30m,Buy
164696.61,134.21,25.10.2017 13:59:57,sl 134.210,-0.56,-338.11999999996624,0.0,0.0,133.72,20.10.2017 16:00:00,15168,-0.1325780218246999,-57.47,IS,0.09,0.0,Phase3-EA-TR1v1-EURJPY-M30-91,EURJPYMT4,2686,4d 21h 59m,Sell
164841.57,151252,25.10.2017 15:59:57,tp 151.252,-0.87,-193.1599999999744,0.0,0.0,149402,20.10.2017 18:00:00,15169,-0.07573870429332248,144.96,IS,0.09,0.0,Phase3-EA-B1v1-GBPJPY-M30-1,GBPJPYMT4,1390,4d 21h 59m,Buy
164779.09,134.5,25.10.2017 19:29:57,sl 134.500,-0.84,-255.63999999998487,0.0,0.0,133.49,23.10.2017 23:00:00,15170,-0.10023732846110157,-62.48,IS,0.09,0.0,Phase3-EA-TR1v1-EURJPY-M30-91,EURJPYMT4,2687,1d 20h 29m,Sell
164821.7,1.16823,26.10.2017 00:19:58,tp 1.16823,-2.98,-213.02999999999884,0.0,0.0,1.16713,25.10.2017 21:10:00,15171,-0.08352980003938983,42.61,IS,0.41,0.0,Phase3-EA-SA2v2-EURCHF-M5-43,EURCHFMT4,7702,3h 9m,Buy
164865.8,113601,26.10.2017 03:45:00,,-3.2,-168.92999999999302,0.0,0.0,113.8,25.10.2017 23:15:00,15172,-0.06623803746258095,44.1,IS,0.27,0.0,Phase3-EA-S1v2-USDJPY-M15-0,USDJPYMT4,4382,4h 30m,Sell
164831.34,134094,26.10.2017 06:44:58,sl 134.094,0.0,-203.38999999998487,0.0,0.0,134324,26.10.2017 02:30:00,15173,-0.07974992268699398,-34.46,IS,0.17,0.0,Phase3-EA-T1v2-EURJPY-M15-322,EURJPYMT4,2988,4h 14m,Buy
164803.56,1.16931,26.10.2017 08:55:00,,0.0,-231.1699999999837,0.0,0.0,1.16864,26.10.2017 00:35:00,15174,-0.0906425568000023,-27.78,IS,0.41,0.0,Phase3-EA-SA2v2-EURCHF-M5-43,EURCHFMT4,7704,8h 20m,Sell
164781.2,1.16955,26.10.2017 11:15:00,,0.0,-253.52999999996973,0.0,0.0,1.1689,26.10.2017 02:30:00,15175,-0.0994099901609355,-22.36,IS,0.34,0.0,Phase3-EA-S4v1-EURCHF-M15-221,EURCHFMT4,3916,8h 45m,Sell
164739.2,1.32411,26.10.2017 12:29:58,sl 1.32411,0.0,-295.52999999996973,0.0,0.0,1.32711,26.10.2017 08:30:00,15176,-0.11587833547217989,-42.0,IS,0.14,0.0,Phase3-EA-B1v1-GBPUSD-M30-14,GBPUSDMT4,986,3h 59m,Buy
164840.48,132808,26.10.2017 22:29:58,tp 132.808,-0.83,-194.2499999999709,0.0,0.0,134098,25.10.2017 21:30:00,15177,-0.07616609706449388,101.28,IS,0.09,0.0,Phase3-EA-TR1v1-EURJPY-M30-91,EURJPYMT4,2690,1d 0h 59m,Sell
164674.78,1.16115,27.10.2017 04:50:00,,-0.99,-359.94999999998254,0.0,0.0,1.16516,26.10.2017 20:30:00,15178,-0.14113764035195547,-165.7,IS,0.41,0.0,Phase3-EA-SA2v2-EURCHF-M5-43,EURCHFMT4,7706,8h 20m,Buy
164658.44,1.16209,27.10.2017 10:00:00,,0.0,-376.28999999997905,0.0,0.0,1.16257,27.10.2017 01:15:00,15179,-0.14754461088494775,-16.34,IS,0.34,0.0,Phase3-EA-S4v1-EURCHF-M15-221,EURCHFMT4,3918,8h 45m,Buy
164716.51,0.99879,30.10.2017 03:29:58,tp 0.99879,0.0,-318.21999999997206,0.0,0.0,0.99779,30.10.2017 02:15:00,15180,-0.1247751629748507,58.07,IS,0.58,0.0,Phase3-EA-SA2v2-USDCHF-M15-107,USDCHFMT4,3000,1h 14m,Buy
164741.4,1.15865,30.10.2017 04:25:00,,-0.99,-293.3299999999581,0.0,0.0,1.15802,27.10.2017 20:05:00,15181,-0.11501570786063396,24.89,IS,0.41,0.0,Phase3-EA-SA2v2-EURCHF-M5-43,EURCHFMT4,7708,2d 8h 20m,Buy
164707.01,132.12,30.10.2017 12:59:58,sl 132.120,0.0,-327.71999999997206,0.0,0.0,131.89,30.10.2017 07:15:00,15182,-0.12850014584287026,-34.39,IS,0.17,0.0,Phase3-EA-T1v2-EURJPY-M15-322,EURJPYMT4,2990,5h 44m,Sell
164806.22,131613,30.10.2017 18:29:58,tp 131.613,-0.56,-228.5099999999802,0.0,0.0,132873,26.10.2017 22:00:00,15183,-0.08959956159695545,99.21,IS,0.09,0.0,Phase3-EA-TR1v1-EURJPY-M30-91,EURJPYMT4,2691,3d 20h 29m,Sell
164831.17,1.15934,31.10.2017 05:30:00,,-0.99,-203.55999999996857,0.0,0.0,1.15871,30.10.2017 21:10:00,15184,-0.07981658027515214,24.95,IS,0.41,0.0,Phase3-EA-SA2v2-EURCHF-M5-43,EURCHFMT4,7710,8h 20m,Buy
164821.95,1.15928,31.10.2017 13:15:00,,0.0,-212.77999999996973,0.0,0.0,1.15901,31.10.2017 04:30:00,15185,-0.08343177417443054,-9.22,IS,0.34,0.0,Phase3-EA-S4v1-EURCHF-M15-221,EURCHFMT4,3920,8h 45m,Sell
164786.96,132053,31.10.2017 18:14:58,sl 132.053,-0.53,-247.76999999996042,0.0,0.0,131823,30.10.2017 18:15:00,15186,-0.09715147423253262,-34.99,IS,0.17,0.0,Phase3-EA-T1v2-EURJPY-M15-322,EURJPYMT4,2992,23h 59m,Sell
164732.9,150399,31.10.2017 18:29:58,sl 150.399,-0.92,-301.8299999999581,0.0,0.0,149729,27.10.2017 05:30:00,15187,-0.11834858726886198,-54.06,IS,0.09,0.0,Phase3-EA-B1v1-GBPJPY-M30-1,GBPJPYMT4,1392,4d 12h 59m,Sell
164778.1,1.16177,31.10.2017 20:49:57,tp 1.16177,0.0,-256.62999999994645,0.0,0.0,1.16287,31.10.2017 20:35:00,15188,-0.10062551088628013,45.2,IS,0.41,0.0,Phase3-EA-SA2v2-EURCHF-M5-43,EURCHFMT4,7712,14m 57s,Sell
164825.39,113619,31.10.2017 21:00:00,,0.0,-209.3399999999383,0.0,0.0,113.42,31.10.2017 20:45:00,15189,-0.08208293827273533,47.29,IS,0.27,0.0,Phase3-EA-S1v2-USDJPY-M15-0,USDJPYMT4,4384,15m 0s,Buy
164870.62,1.16253,31.10.2017 21:59:58,tp 1.16253,0.0,-164.10999999992782,0.0,0.0,1.16143,31.10.2017 21:05:00,15190,-0.06434809878636019,45.23,IS,0.41,0.0,Phase3-EA-SA2v2-EURCHF-M5-43,EURCHFMT4,7714,54m 58s,Buy
164915.84,1.16193,31.10.2017 23:19:58,tp 1.16193,0.0,-118.88999999992666,0.0,0.0,1.16083,31.10.2017 22:40:00,15191,-0.04661718033458661,45.22,IS,0.41,0.0,Phase3-EA-SA2v2-EURCHF-M5-43,EURCHFMT4,7716,39m 58s,Buy
164961.05,1.16264,01.11.2017 05:09:58,tp 1.16264,0.0,-73.67999999993481,0.0,0.0,1.16154,01.11.2017 02:10:00,15192,-0.028890182917414593,45.21,IS,0.41,0.0,Phase3-EA-SA2v2-EURCHF-M5-43,EURCHFMT4,7718,2h 59m,Buy
164979.78,1.1618,01.11.2017 11:30:00,,0.0,-54.94999999992433,0.0,0.0,1.16125,01.11.2017 02:45:00,15193,-0.02154608511551507,18.73,IS,0.34,0.0,Phase3-EA-S4v1-EURCHF-M15-221,EURCHFMT4,3922,8h 45m,Buy
165024.82,1.16401,01.11.2017 21:59:59,tp 1.16401,0.0,-9.909999999916181,0.0,0.0,1.16291,01.11.2017 21:35:00,15194,-0.0038857452865012267,45.04,IS,0.41,0.0,Phase3-EA-SA2v2-EURCHF-M5-43,EURCHFMT4,7720,24m 59s,Buy
165082.69,1.00229,02.11.2017 01:44:57,tp 1.00229,0.0,-0.0,0.0,0.0,1.00329,02.11.2017 01:15:00,15195,-0.0,57.87,IS,0.58,0.0,Phase3-EA-SA2v2-USDCHF-M15-107,USDCHFMT4,3002,29m 57s,Sell
165025.68,1.16521,02.11.2017 06:55:00,,-6.13,-57.01000000000931,0.0,0.0,1.16397,01.11.2017 22:35:00,15196,-0.022349615334544656,-57.01,IS,0.41,0.0,Phase3-EA-SA2v2-EURCHF-M5-43,EURCHFMT4,7722,8h 20m,Sell
165053.24,1.16482,02.11.2017 10:00:00,,0.0,-29.45000000001164,0.0,0.0,1.16563,02.11.2017 01:15:00,15197,-0.01154527576920703,27.56,IS,0.34,0.0,Phase3-EA-S4v1-EURCHF-M15-221,EURCHFMT4,3924,8h 45m,Sell
165008.58,1.31114,02.11.2017 17:29:58,sl 1.31114,-2.66,-74.11000000001513,0.0,0.0,1.31414,30.10.2017 13:00:00,15198,-0.029053323845696758,-44.66,IS,0.14,0.0,Phase3-EA-B1v1-GBPUSD-M30-14,GBPUSDMT4,988,3d 4h 29m,Buy
164954.92,150464,02.11.2017 17:29:58,sl 150.464,-0.85,-127.77000000001863,0.0,0.0,151134,01.11.2017 05:30:00,15199,-0.050089639559633754,-53.66,IS,0.09,0.0,Phase3-EA-B1v1-GBPJPY-M30-1,GBPJPYMT4,1394,1d 11h 59m,Buy
164951.89,1.16452,03.11.2017 07:45:00,,-0.98,-130.80000000001746,0.0,0.0,1.16457,02.11.2017 23:25:00,15200,-0.05127748966424055,-3.03,IS,0.41,0.0,Phase3-EA-SA2v2-EURCHF-M5-43,EURCHFMT4,7724,8h 20m,Buy
164995.07,149015,03.11.2017 09:15:00,,0.0,-87.62000000002445,0.0,0.0,148801,03.11.2017 03:50:00,15201,-0.03434964559924626,43.18,IS,0.23,0.0,Phase3-EA-S4v1-GBPJPY-M5-194,GBPJPYMT4,3302,5h 25m,Buy
164970.94,114.03,03.11.2017 11:00:00,,-0.69,-111.7500000000291,0.0,0.0,114129,02.11.2017 18:15:00,15202,-0.04380932316498172,-24.13,IS,0.27,0.0,Phase3-EA-S1v2-USDJPY-M15-0,USDJPYMT4,4386,16h 45m,Buy
164956.31,1.16422,03.11.2017 14:00:00,,0.0,-126.38000000003376,0.0,0.0,1.16465,03.11.2017 05:15:00,15203,-0.04954471822452283,-14.63,IS,0.34,0.0,Phase3-EA-S4v1-EURCHF-M15-221,EURCHFMT4,3926,8h 45m,Buy
164903.57,149.53,03.11.2017 19:59:57,sl 149.530,0.0,-179.12000000002445,0.0,0.0,148.86,03.11.2017 03:00:00,15204,-0.0702203665799602,-52.74,IS,0.09,0.0,Phase3-EA-B1v1-GBPJPY-M30-1,GBPJPYMT4,1396,16h 59m,Sell
164948.61,1.16263,03.11.2017 21:24:58,tp 1.16263,0.0,-134.0800000000163,0.0,0.0,1.16153,03.11.2017 20:15:00,15205,-0.052563347203220874,45.04,IS,0.41,0.0,Phase3-EA-SA2v2-EURCHF-M5-43,EURCHFMT4,7726,1h 9m,Buy
165003.0,149433,06.11.2017 04:50:00,,-0.73,-79.69000000000233,0.0,0.0,149159,03.11.2017 23:25:00,15206,-0.031240849780909047,54.39,IS,0.23,0.0,Phase3-EA-S4v1-GBPJPY-M5-194,GBPJPYMT4,3304,2d 5h 25m,Buy
165076.66,114398,06.11.2017 05:00:00,,-0.69,-6.029999999998836,0.0,0.0,114083,03.11.2017 23:30:00,15207,-0.0023639393170892167,73.66,IS,0.27,0.0,Phase3-EA-S1v2-USDJPY-M15-0,USDJPYMT4,4388,2d 5h 30m,Buy
165151.29,1.16346,06.11.2017 11:00:00,,0.0,-0.0,0.0,0.0,1.16126,06.11.2017 02:15:00,15208,-0.0,74.63,IS,0.34,0.0,Phase3-EA-S4v1-EURCHF-M15-221,EURCHFMT4,3928,8h 45m,Buy
165162.89,114.06,06.11.2017 20:30:00,,0.0,-0.0,0.0,0.0,114109,06.11.2017 18:15:00,15209,-0.0,11.6,IS,0.27,0.0,Phase3-EA-S1v2-USDJPY-M15-0,USDJPYMT4,4390,2h 15m,Sell
165152.02,149828,07.11.2017 04:50:00,,-1.17,-10.869999999995343,0.0,0.0,149.78,06.11.2017 23:25:00,15210,-0.004260023861618468,-10.87,IS,0.23,0.0,Phase3-EA-S4v1-GBPJPY-M5-194,GBPJPYMT4,3306,5h 25m,Sell
165197.19,1.15889,07.11.2017 06:49:58,tp 1.15889,0.0,-0.0,0.0,0.0,1.15779,07.11.2017 00:15:00,15211,-0.0,45.17,IS,0.41,0.0,Phase3-EA-SA2v2-EURCHF-M5-43,EURCHFMT4,7728,6h 34m,Buy
165254.3,1.15697,07.11.2017 14:45:00,,0.0,-0.0,0.0,0.0,1.15865,07.11.2017 06:00:00,15212,-0.0,57.11,IS,0.34,0.0,Phase3-EA-S4v1-EURCHF-M15-221,EURCHFMT4,3930,8h 45m,Sell
165195.23,131979,07.11.2017 15:29:58,sl 131.979,-2.33,-59.070000000006985,0.0,0.0,132453,01.11.2017 10:00:00,15213,-0.02314162778061199,-59.07,IS,0.09,0.0,Phase3-EA-TR1v1-EURJPY-M30-91,EURJPYMT4,2694,6d 5h 29m,Sell
165203.5,114213,07.11.2017 19:30:00,,0.0,-50.80000000001746,0.0,0.0,114178,07.11.2017 17:00:00,15214,-0.019901721538096395,8.27,IS,0.27,0.0,Phase3-EA-S1v2-USDJPY-M15-0,USDJPYMT4,4392,2h 30m,Buy
165258.47,0.99929,08.11.2017 02:14:58,tp 0.99929,-3.07,-0.0,0.0,0.0,1.00029,07.11.2017 23:15:00,15215,-0.0,54.97,IS,0.58,0.0,Phase3-EA-SA2v2-USDCHF-M15-107,USDCHFMT4,3004,2h 59m,Sell
165293.81,113837,08.11.2017 03:00:00,,0.0,-0.0,0.0,0.0,113986,08.11.2017 01:30:00,15216,-0.0,35.34,IS,0.27,0.0,Phase3-EA-S1v2-USDJPY-M15-0,USDJPYMT4,4394,1h 30m,Sell
165240.04,1.15843,08.11.2017 05:30:00,,-2.05,-53.76999999998952,0.0,0.0,1.15717,07.11.2017 21:10:00,15217,-0.021062006947990333,-53.77,IS,0.41,0.0,Phase3-EA-SA2v2-EURCHF-M5-43,EURCHFMT4,7730,8h 20m,Sell
165227.71,149858,08.11.2017 08:35:00,,0.0,-66.09999999997672,0.0,0.0,149919,08.11.2017 03:10:00,15218,-0.025891736270447125,-12.33,IS,0.23,0.0,Phase3-EA-S4v1-GBPJPY-M5-194,GBPJPYMT4,3308,5h 25m,Buy
165272.8,1.15915,08.11.2017 21:19:58,tp 1.15915,0.0,-21.00999999998021,0.0,0.0,1.15805,08.11.2017 20:30:00,15219,-0.008229733419693998,45.09,IS,0.41,0.0,Phase3-EA-SA2v2-EURCHF-M5-43,EURCHFMT4,7732,49m 58s,Buy
165248.58,149433,09.11.2017 06:00:00,,0.0,-45.22999999998137,0.0,0.0,149313,09.11.2017 00:35:00,15220,-0.017716841626509133,-24.22,IS,0.23,0.0,Phase3-EA-S4v1-GBPJPY-M5-194,GBPJPYMT4,3310,5h 25m,Sell
165249.81,1.15935,09.11.2017 07:15:00,,-6.15,-43.999999999970896,0.0,0.0,1.15953,08.11.2017 22:55:00,15221,-0.017235043810882318,1.23,IS,0.41,0.0,Phase3-EA-SA2v2-EURCHF-M5-43,EURCHFMT4,7734,8h 20m,Sell
165180.46,113876,09.11.2017 08:45:00,,-3.2,-113.34999999997672,0.0,0.0,113597,08.11.2017 19:45:00,15222,-0.044399823090100037,-69.35,IS,0.27,0.0,Phase3-EA-S1v2-USDJPY-M15-0,USDJPYMT4,4396,13h 0m,Sell
165247.42,1.16097,09.11.2017 14:45:00,,0.0,-46.389999999984866,0.0,0.0,1159,09.11.2017 06:00:00,15223,-0.018171220054252243,66.96,IS,0.34,0.0,Phase3-EA-S4v1-EURCHF-M15-221,EURCHFMT4,3932,8h 45m,Buy
165291.81,1.15769,10.11.2017 00:39:58,tp 1.15769,-0.99,-1.9999999999708962,0.0,0.0,1.15659,09.11.2017 21:45:00,15224,-7.834110823019507E-4,44.39,IS,0.41,0.0,Phase3-EA-SA2v2-EURCHF-M5-43,EURCHFMT4,7736,2h 54m,Buy
165337.2,1.15622,10.11.2017 02:04:57,tp 1.15622,0.0,-0.0,0.0,0.0,1.15732,10.11.2017 00:45:00,15225,-0.0,45.39,IS,0.41,0.0,Phase3-EA-SA2v2-EURCHF-M5-43,EURCHFMT4,7738,1h 19m,Sell
165395.6,0.99314,10.11.2017 02:14:57,tp 0.99314,0.0,-0.0,0.0,0.0,0.99414,10.11.2017 01:45:00,15226,-0.0,58.4,IS,0.58,0.0,Phase3-EA-SA2v2-USDCHF-M15-107,USDCHFMT4,3006,29m 57s,Sell
165424.69,1.15728,10.11.2017 15:00:00,,0.0,-0.0,0.0,0.0,1.15813,10.11.2017 06:15:00,15227,-0.0,29.09,IS,0.34,0.0,Phase3-EA-S4v1-EURCHF-M15-221,EURCHFMT4,3934,8h 45m,Sell
165467.93,1.15928,13.11.2017 02:00:00,tp 1.15928,-2.06,-0.0,0.0,0.0,1.16038,10.11.2017 20:20:00,15228,-0.0,43.24,IS,0.41,0.0,Phase3-EA-SA2v2-EURCHF-M5-43,EURCHFMT4,7740,2d 5h 40m,Sell
165393.06,149129,13.11.2017 07:35:00,,0.0,-74.86999999999534,0.0,0.0,149499,13.11.2017 02:10:00,15229,-0.02930700538419634,-74.87,IS,0.23,0.0,Phase3-EA-S4v1-GBPJPY-M5-194,GBPJPYMT4,3312,5h 25m,Buy
165463.03,1.16005,13.11.2017 12:45:00,,0.0,-4.899999999994179,0.0,0.0,1.1621,13.11.2017 04:00:00,15230,-0.0019180489699799708,69.97,IS,0.34,0.0,Phase3-EA-S4v1-EURCHF-M15-221,EURCHFMT4,3936,8h 45m,Sell
165508.33,1.16143,13.11.2017 23:09:57,tp 1.16143,0.0,-0.0,0.0,0.0,1.16253,13.11.2017 21:15:00,15231,-0.0,45.3,IS,0.41,0.0,Phase3-EA-SA2v2-EURCHF-M5-43,EURCHFMT4,7742,1h 54m,Sell
165518.31,113637,14.11.2017 02:30:00,,0.0,-0.0,0.0,0.0,113595,14.11.2017 01:00:00,15232,-0.0,9.98,IS,0.27,0.0,Phase3-EA-S1v2-USDJPY-M15-0,USDJPYMT4,4398,1h 30m,Buy
165496.26,149158,14.11.2017 05:55:00,,0.0,-22.04999999998836,0.0,0.0,149049,14.11.2017 00:30:00,15233,-0.008629518565612084,-22.05,IS,0.23,0.0,Phase3-EA-S4v1-GBPJPY-M5-194,GBPJPYMT4,3314,5h 25m,Sell
165465.81,1.16314,14.11.2017 09:00:00,,0.0,-52.5,0.0,0.0,1.1624,14.11.2017 00:40:00,15234,-0.020546472775277717,-30.45,IS,0.41,0.0,Phase3-EA-SA2v2-EURCHF-M5-43,EURCHFMT4,7744,8h 20m,Sell
165427.23,132908,14.11.2017 11:44:58,sl 132.908,-4.18,-91.0799999999872,0.0,0.0,132678,06.11.2017 12:15:00,15235,-0.035645195054705356,-38.58,IS,0.17,0.0,Phase3-EA-T1v2-EURJPY-M15-322,EURJPYMT4,2994,7d 23h 29m,Sell
165361.88,133233,14.11.2017 12:29:58,sl 133.233,-3.62,-156.42999999999302,0.0,0.0,132699,01.11.2017 17:30:00,15236,-0.06122066164260094,-65.35,IS,0.09,0.0,Phase3-EA-TR1v1-EURJPY-M30-91,EURJPYMT4,2695,12d 18h 59m,Buy
165266.84,1.16557,14.11.2017 14:30:00,,0.0,-251.47000000000116,0.0,0.0,1.16279,14.11.2017 05:45:00,15237,-0.09841564778664973,-95.04,IS,0.34,0.0,Phase3-EA-S4v1-EURCHF-M15-221,EURCHFMT4,3938,8h 45m,Sell
165365.63,133493,14.11.2017 17:59:58,tp 133.493,-1.17,-152.67999999999302,0.0,0.0,132233,09.11.2017 06:30:00,15238,-0.05975305644436682,98.79,IS,0.09,0.0,Phase3-EA-TR1v1-EURJPY-M30-91,EURJPYMT4,2697,5d 11h 29m,Buy
165411.21,1.16523,14.11.2017 21:59:57,tp 1.16523,0.0,-107.10000000000582,0.0,0.0,1.16633,14.11.2017 20:25:00,15239,-0.04191480446156882,45.58,IS,0.41,0.0,Phase3-EA-SA2v2-EURCHF-M5-43,EURCHFMT4,7746,1h 34m,Sell
165444.31,113383,14.11.2017 22:15:00,,0.0,-74.0,0.0,0.0,113522,14.11.2017 21:15:00,15240,-0.028960742578486683,33.1,IS,0.27,0.0,Phase3-EA-S1v2-USDJPY-M15-0,USDJPYMT4,4400,1h 0m,Sell
165523.41,148977,15.11.2017 05:19:58,tp 148.977,0.0,-0.0,0.0,0.0,149367,15.11.2017 01:20:00,15241,-0.0,79.1,IS,0.23,0.0,Phase3-EA-S4v1-GBPJPY-M5-194,GBPJPYMT4,3316,3h 59m,Sell
165569.0,1.1662,15.11.2017 06:14:58,tp 1.16620,0.0,-0.0,0.0,0.0,1.1673,15.11.2017 01:50:00,15242,-0.0,45.59,IS,0.41,0.0,Phase3-EA-SA2v2-EURCHF-M5-43,EURCHFMT4,7748,4h 24m,Sell
165605.9,1.16744,15.11.2017 15:30:00,,0.0,-0.0,0.0,0.0,1.16637,15.11.2017 06:45:00,15243,-0.0,36.9,IS,0.34,0.0,Phase3-EA-S4v1-EURCHF-M15-221,EURCHFMT4,3940,8h 45m,Buy
165567.79,112654,15.11.2017 18:00:00,,0.0,-38.10999999998603,0.0,0.0,112495,15.11.2017 17:45:00,15244,-0.014909671490363026,-38.11,IS,0.27,0.0,Phase3-EA-S1v2-USDJPY-M15-0,USDJPYMT4,4402,15m 0s,Sell
165590.8,112646,15.11.2017 18:45:00,,0.0,-15.099999999976717,0.0,0.0,112742,15.11.2017 18:15:00,15245,-0.005907531868386698,23.01,IS,0.27,0.0,Phase3-EA-S1v2-USDJPY-M15-0,USDJPYMT4,4404,30m 0s,Sell
165636.37,1.16715,15.11.2017 21:44:59,tp 1.16715,0.0,-0.0,0.0,0.0,1.16825,15.11.2017 20:50:00,15246,-0.0,45.57,IS,0.41,0.0,Phase3-EA-SA2v2-EURCHF-M5-43,EURCHFMT4,7750,54m 59s,Sell
165598.91,112787,16.11.2017 00:30:00,,-3.23,-37.45999999999185,0.0,0.0,112644,15.11.2017 18:45:00,15247,-0.014653626946741436,-37.46,IS,0.27,0.0,Phase3-EA-S1v2-USDJPY-M15-0,USDJPYMT4,4406,5h 45m,Sell
165678.42,148995,16.11.2017 03:34:57,tp 148.995,0.0,-0.0,0.0,0.0,148605,16.11.2017 00:15:00,15248,-0.0,79.51,IS,0.23,0.0,Phase3-EA-S4v1-GBPJPY-M5-194,GBPJPYMT4,3318,3h 19m,Buy
165725.02,112982,16.11.2017 04:45:00,,0.0,-0.0,0.0,0.0,112787,16.11.2017 00:30:00,15249,-0.0,46.6,IS,0.27,0.0,Phase3-EA-S1v2-USDJPY-M15-0,USDJPYMT4,4408,4h 15m,Buy
165673.11,1.16528,16.11.2017 07:05:00,,-2.99,-51.91000000000349,0.0,0.0,1.16646,15.11.2017 22:45:00,15250,-0.02029914788940214,-51.91,IS,0.41,0.0,Phase3-EA-SA2v2-EURCHF-M5-43,EURCHFMT4,7752,8h 20m,Buy
165703.37,1.16631,16.11.2017 10:30:00,,0.0,-21.64999999999418,0.0,0.0,1.16543,16.11.2017 01:45:00,15251,-0.00846612505885973,30.26,IS,0.34,0.0,Phase3-EA-S4v1-EURCHF-M15-221,EURCHFMT4,3942,8h 45m,Buy
165678.1,0.99385,17.11.2017 03:15:00,,-3.09,-46.9199999999837,0.0,0.0,0.99347,16.11.2017 23:00:00,15252,-0.01834783315296385,-25.27,IS,0.58,0.0,Phase3-EA-SA2v2-USDCHF-M15-107,USDCHFMT4,3008,4h 15m,Sell
165682.04,112923,17.11.2017 04:15:00,,-1.08,-42.97999999998137,0.0,0.0,112944,16.11.2017 22:30:00,15253,-0.016807115705761263,3.94,IS,0.27,0.0,Phase3-EA-S1v2-USDJPY-M15-0,USDJPYMT4,4410,5h 45m,Sell
165608.13,1.16999,17.11.2017 04:25:00,,-2.06,-116.88999999998487,0.0,0.0,1.16825,16.11.2017 20:05:00,15254,-0.0457092544171017,-73.91,IS,0.41,0.0,Phase3-EA-SA2v2-EURCHF-M5-43,EURCHFMT4,7754,8h 20m,Sell
165537.54,1.17179,17.11.2017 10:30:00,,0.0,-187.47999999998137,0.0,0.0,1.16973,17.11.2017 01:45:00,15255,-0.07331312360440144,-70.59,IS,0.34,0.0,Phase3-EA-S4v1-EURCHF-M15-221,EURCHFMT4,3944,8h 45m,Sell
165639.57,132081,17.11.2017 20:29:58,tp 132.081,-1.4,-85.44999999998254,0.0,0.0,133371,14.11.2017 20:00:00,15256,-0.03341479844247624,102.03,IS,0.09,0.0,Phase3-EA-TR1v1-EURJPY-M30-91,EURJPYMT4,2700,3d 0h 29m,Sell
165894.53,131729,20.11.2017 03:14:58,tp 131.729,-2.64,-0.0,0.0,0.0,133429,15.11.2017 21:30:00,15257,-0.0,254.96,IS,0.17,0.0,Phase3-EA-T1v2-EURJPY-M15-322,EURJPYMT4,2996,4d 5h 44m,Sell
165760.6,1.16166,20.11.2017 03:14:58,sl 1.16166,0.0,-133.92999999999302,0.0,0.0,1.16556,20.11.2017 02:15:00,15258,-0.05233796908436936,-133.93,IS,0.34,0.0,Phase3-EA-S4v1-EURCHF-M15-221,EURCHFMT4,3946,59m 58s,Buy
165556.61,1.16144,20.11.2017 03:29:58,sl 1.16144,-1.0,-337.9199999999837,0.0,0.0,1.16634,17.11.2017 20:25:00,15259,-0.1320544053833358,-203.99,IS,0.41,0.0,Phase3-EA-SA2v2-EURCHF-M5-43,EURCHFMT4,7756,2d 7h 4m,Buy
165657.23,131544,20.11.2017 03:59:58,tp 131.544,-0.56,-237.29999999998836,0.0,0.0,132804,16.11.2017 20:30:00,15260,-0.09273351798492412,100.62,IS,0.09,0.0,Phase3-EA-TR1v1-EURJPY-M30-91,EURJPYMT4,2701,3d 7h 29m,Sell
165737.2,148152,20.11.2017 04:29:57,tp 148.152,0.0,-157.3299999999872,0.0,0.0,147762,20.11.2017 03:40:00,15261,-0.06148236150260278,79.97,IS,0.23,0.0,Phase3-EA-S4v1-GBPJPY-M5-194,GBPJPYMT4,3320,49m 57s,Buy
165668.61,0.98941,20.11.2017 06:15:00,,0.0,-225.9199999999837,0.0,0.0,0.98824,20.11.2017 02:00:00,15262,-0.08828637329605382,-68.59,IS,0.58,0.0,Phase3-EA-SA2v2-USDCHF-M15-107,USDCHFMT4,3010,4h 15m,Sell
165806.16,1.16653,20.11.2017 12:44:59,tp 1.16653,0.0,-88.36999999999534,0.0,0.0,1.16253,20.11.2017 04:15:00,15263,-0.03453375888886521,137.55,IS,0.34,0.0,Phase3-EA-S4v1-EURCHF-M15-221,EURCHFMT4,3948,8h 29m,Buy
165851.59,1.16554,20.11.2017 21:14:58,tp 1.16554,0.0,-42.94000000000233,0.0,0.0,1.16444,20.11.2017 20:45:00,15264,-0.016780350873464193,45.43,IS,0.41,0.0,Phase3-EA-SA2v2-EURCHF-M5-43,EURCHFMT4,7758,29m 58s,Buy
165876.12,0.99298,21.11.2017 05:30:00,,0.0,-18.410000000003492,0.0,0.0,0.9934,21.11.2017 01:15:00,15265,-0.007194370274348338,24.53,IS,0.58,0.0,Phase3-EA-SA2v2-USDCHF-M15-107,USDCHFMT4,3012,4h 15m,Sell
165884.09,149036,21.11.2017 06:35:00,,0.0,-10.440000000002328,0.0,0.0,148997,21.11.2017 01:10:00,15266,-0.004079805848136836,7.97,IS,0.23,0.0,Phase3-EA-S4v1-GBPJPY-M5-194,GBPJPYMT4,3322,5h 25m,Buy
165890.29,1.16542,21.11.2017 10:30:00,,0.0,-4.239999999990687,0.0,0.0,1.16557,21.11.2017 02:10:00,15267,-0.0016569326433006062,6.2,IS,0.41,0.0,Phase3-EA-SA2v2-EURCHF-M5-43,EURCHFMT4,7760,8h 20m,Sell
165909.46,1.16528,21.11.2017 13:15:00,,0.0,-0.0,0.0,0.0,1.16584,21.11.2017 04:30:00,15268,-0.0,19.17,IS,0.34,0.0,Phase3-EA-S4v1-EURCHF-M15-221,EURCHFMT4,3950,8h 45m,Sell
165952.88,1.16329,22.11.2017 02:04:57,tp 1.16329,-2.07,-0.0,0.0,0.0,1.16439,21.11.2017 20:50:00,15269,-0.0,43.42,IS,0.41,0.0,Phase3-EA-SA2v2-EURCHF-M5-43,EURCHFMT4,7762,5h 14m,Sell
165898.54,148519,22.11.2017 11:29:58,sl 148.519,-0.58,-54.33999999999651,0.0,0.0,149189,20.11.2017 23:30:00,15270,-0.02123047023342585,-54.34,IS,0.09,0.0,Phase3-EA-B1v1-GBPJPY-M30-1,GBPJPYMT4,1398,1d 11h 59m,Buy
165879.98,1.1629,22.11.2017 12:00:00,,0.0,-72.89999999999418,0.0,0.0,1.16344,22.11.2017 03:15:00,15271,-0.028481804932217896,-18.56,IS,0.34,0.0,Phase3-EA-S4v1-EURCHF-M15-221,EURCHFMT4,3952,8h 45m,Buy
165925.83,1.16051,22.11.2017 22:59:57,tp 1.16051,0.0,-27.04999999998836,0.0,0.0,1.15941,22.11.2017 20:45:00,15272,-0.010568351487191001,45.85,IS,0.41,0.0,Phase3-EA-SA2v2-EURCHF-M5-43,EURCHFMT4,7764,2h 14m,Buy
165982.73,0.98248,23.11.2017 00:44:57,tp 0.98248,-2.13,-0.0,0.0,0.0,0.98148,22.11.2017 23:45:00,15273,-0.0,56.9,IS,0.58,0.0,Phase3-EA-SA2v2-USDCHF-M15-107,USDCHFMT4,3014,59m 57s,Buy
166022.38,1.15928,23.11.2017 02:04:58,tp 1.15928,-6.27,-0.0,0.0,0.0,1.16038,22.11.2017 23:00:00,15274,-0.0,39.65,IS,0.41,0.0,Phase3-EA-SA2v2-EURCHF-M5-43,EURCHFMT4,7766,3h 4m,Sell
166045.75,1.16277,24.11.2017 05:10:00,,-2.09,-0.0,0.0,0.0,1.16338,23.11.2017 20:50:00,15275,-0.0,23.37,IS,0.41,0.0,Phase3-EA-SA2v2-EURCHF-M5-43,EURCHFMT4,7768,8h 20m,Sell
166008.53,132091,24.11.2017 08:14:58,sl 132.091,-2.14,-37.220000000001164,0.0,0.0,131861,22.11.2017 04:30:00,15276,-0.014536464674770405,-37.22,IS,0.17,0.0,Phase3-EA-T1v2-EURJPY-M15-322,EURJPYMT4,2998,2d 3h 44m,Sell
166110.43,132737,24.11.2017 18:29:58,tp 132.737,-2.37,-0.0,0.0,0.0,131447,20.11.2017 07:30:00,15277,-0.0,101.9,IS,0.09,0.0,Phase3-EA-TR1v1-EURJPY-M30-91,EURJPYMT4,2704,4d 10h 59m,Buy
166156.51,1.16824,24.11.2017 21:04:57,tp 1.16824,0.0,-0.0,0.0,0.0,1.16934,24.11.2017 20:20:00,15278,-0.0,46.08,IS,0.41,0.0,Phase3-EA-SA2v2-EURCHF-M5-43,EURCHFMT4,7770,44m 57s,Sell
166236.98,148423,27.11.2017 05:39:57,tp 148.423,0.0,-0.0,0.0,0.0,148813,27.11.2017 03:15:00,15279,-0.0,80.47,IS,0.23,0.0,Phase3-EA-S4v1-GBPJPY-M5-194,GBPJPYMT4,3324,2h 24m,Sell
166286.67,1.16777,27.11.2017 12:15:00,,0.0,-0.0,0.0,0.0,1.1692,27.11.2017 03:30:00,15280,-0.0,49.69,IS,0.34,0.0,Phase3-EA-S4v1-EURCHF-M15-221,EURCHFMT4,3954,8h 45m,Sell
166345.81,0.98074,28.11.2017 02:14:57,tp 0.98074,0.0,-0.0,0.0,0.0,0.98174,28.11.2017 00:45:00,15281,-0.0,59.14,IS,0.58,0.0,Phase3-EA-SA2v2-USDCHF-M15-107,USDCHFMT4,3016,1h 29m,Sell
166282.11,1.16786,28.11.2017 04:20:00,,-1.0,-63.70000000001164,0.0,0.0,1.16936,27.11.2017 20:00:00,15282,-0.024849245634251355,-63.7,IS,0.41,0.0,Phase3-EA-SA2v2-EURCHF-M5-43,EURCHFMT4,7772,8h 20m,Buy
166290.75,110972,28.11.2017 04:30:00,,-1.09,-55.05999999999767,0.0,0.0,111012,27.11.2017 21:45:00,15283,-0.021478798502693432,8.64,IS,0.27,0.0,Phase3-EA-S1v2-USDJPY-M15-0,USDJPYMT4,4412,6h 45m,Sell
166238.13,1.16627,29.11.2017 05:50:00,,-1.0,-107.67999999999302,0.0,0.0,1.16751,28.11.2017 21:30:00,15284,-0.04200575776916049,-52.62,IS,0.41,0.0,Phase3-EA-SA2v2-EURCHF-M5-43,EURCHFMT4,7774,8h 20m,Buy
166325.86,1.16745,29.11.2017 10:30:00,,0.0,-19.949999999982538,0.0,0.0,1.16491,29.11.2017 01:45:00,15285,-0.007782456050279278,87.73,IS,0.34,0.0,Phase3-EA-S4v1-EURCHF-M15-221,EURCHFMT4,3956,8h 45m,Buy
166585.68,1.34209,29.11.2017 12:29:57,tp 1.34209,-4.78,-0.0,0.0,0.0,1.32319,20.11.2017 11:30:00,15286,-0.0,259.82,IS,0.14,0.0,Phase3-EA-B1v1-GBPUSD-M30-14,GBPUSDMT4,990,9d 0h 59m,Buy
166550.65,132273,29.11.2017 17:14:58,sl 132.273,0.0,-35.029999999998836,0.0,0.0,132043,29.11.2017 15:15:00,15287,-0.013652359710798603,-35.03,IS,0.17,0.0,Phase3-EA-T1v2-EURJPY-M15-322,EURJPYMT4,3000,1h 59m,Sell
166590.22,1.16668,30.11.2017 00:34:58,tp 1.16668,-6.25,-0.0,0.0,0.0,1.16778,29.11.2017 22:50:00,15288,-0.0,39.57,IS,0.41,0.0,Phase3-EA-SA2v2-EURCHF-M5-43,EURCHFMT4,7776,1h 44m,Sell
166618.28,111918,30.11.2017 02:00:00,,-2.1,-0.0,0.0,0.0,111793,29.11.2017 20:30:00,15289,-0.0,28.06,IS,0.27,0.0,Phase3-EA-S1v2-USDJPY-M15-0,USDJPYMT4,4414,5h 30m,Buy
166677.17,0.98494,30.11.2017 02:59:58,tp 0.98494,0.0,-0.0,0.0,0.0,0.98394,30.11.2017 02:45:00,15290,-0.0,58.89,IS,0.58,0.0,Phase3-EA-SA2v2-USDCHF-M15-107,USDCHFMT4,3018,14m 58s,Buy
166723.02,1.16764,30.11.2017 06:49:57,tp 1.16764,0.0,-0.0,0.0,0.0,1.16654,30.11.2017 01:05:00,15291,-0.0,45.85,IS,0.41,0.0,Phase3-EA-SA2v2-EURCHF-M5-43,EURCHFMT4,7778,5h 44m,Buy
166603.73,150855,30.11.2017 08:55:00,,0.0,-119.29000000000815,0.0,0.0,150274,30.11.2017 03:30:00,15292,-0.04646642128158489,-119.29,IS,0.23,0.0,Phase3-EA-S4v1-GBPJPY-M5-194,GBPJPYMT4,3326,5h 25m,Sell
166658.31,1.16797,30.11.2017 11:00:00,,0.0,-64.71000000002095,0.0,0.0,1.16639,30.11.2017 02:15:00,15293,-0.025206154087787126,54.58,IS,0.34,0.0,Phase3-EA-S4v1-EURCHF-M15-221,EURCHFMT4,3958,8h 45m,Buy
166757.42,133403,30.11.2017 19:59:58,tp 133.403,-2.38,-0.0,0.0,0.0,132143,24.11.2017 10:00:00,15294,-0.0,99.11,IS,0.09,0.0,Phase3-EA-TR1v1-EURJPY-M30-91,EURJPYMT4,2705,6d 9h 59m,Buy
166904.55,152097,30.11.2017 22:29:58,tp 152.097,-0.87,-0.0,0.0,0.0,150247,29.11.2017 20:30:00,15295,-0.0,147.13,IS,0.09,0.0,Phase3-EA-B1v1-GBPJPY-M30-1,GBPJPYMT4,1400,1d 1h 59m,Buy
166948.35,1.17005,01.12.2017 02:04:57,tp 1.17005,-2.08,-0.0,0.0,0.0,1.17115,30.11.2017 21:15:00,15296,-0.0,43.8,IS,0.41,0.0,Phase3-EA-SA2v2-EURCHF-M5-43,EURCHFMT4,7780,4h 49m,Sell
167014.69,1.17234,01.12.2017 11:30:00,,0.0,-0.0,0.0,0.0,1.17042,01.12.2017 02:45:00,15297,-0.0,66.34,IS,0.34,0.0,Phase3-EA-S4v1-EURCHF-M15-221,EURCHFMT4,3960,8h 45m,Buy
166961.06,151714,01.12.2017 13:29:58,sl 151.714,0.0,-53.63000000000466,0.0,0.0,152384,01.12.2017 01:30:00,15298,-0.020866511560099676,-53.63,IS,0.09,0.0,Phase3-EA-B1v1-GBPJPY-M30-1,GBPJPYMT4,1402,11h 59m,Buy
167007.12,1.16732,01.12.2017 20:19:58,tp 1.16732,0.0,-7.570000000006985,0.0,0.0,1.16622,01.12.2017 20:15:00,15299,-0.0029453569366042626,46.06,IS,0.41,0.0,Phase3-EA-SA2v2-EURCHF-M5-43,EURCHFMT4,7782,4m 58s,Buy
166949.29,132922,01.12.2017 20:29:58,sl 132.922,-0.39,-65.39999999999418,0.0,0.0,133642,30.11.2017 21:30:00,15300,-0.025446016334705928,-57.83,IS,0.09,0.0,Phase3-EA-TR1v1-EURJPY-M30-91,EURJPYMT4,2708,22h 59m,Buy
166994.24,1.16513,04.12.2017 04:49:58,tp 1.16513,-1.01,-20.449999999982538,0.0,0.0,1.16403,01.12.2017 20:35:00,15301,-0.007956743639821686,44.95,IS,0.41,0.0,Phase3-EA-SA2v2-EURCHF-M5-43,EURCHFMT4,7784,2d 8h 14m,Buy
167073.82,151836,04.12.2017 05:09:58,tp 151.836,0.0,-0.0,0.0,0.0,152226,04.12.2017 03:35:00,15302,-0.0,79.58,IS,0.23,0.0,Phase3-EA-S4v1-GBPJPY-M5-194,GBPJPYMT4,3328,1h 34m,Sell
167013.25,1.16625,04.12.2017 13:00:00,,0.0,-60.570000000006985,0.0,0.0,1.1645,04.12.2017 04:15:00,15303,-0.023561325692365964,-60.57,IS,0.34,0.0,Phase3-EA-S4v1-EURCHF-M15-221,EURCHFMT4,3962,8h 45m,Sell
167009.94,133922,04.12.2017 17:00:00,,0.0,-63.88000000000466,0.0,0.0,133944,04.12.2017 16:30:00,15304,-0.024848893597957306,-3.31,IS,0.17,0.0,Phase3-EA-T1v2-EURJPY-M15-322,EURJPYMT4,3002,30m 0s,Buy
166967.94,1.34762,04.12.2017 19:59:58,sl 1.34762,0.0,-105.88000000000466,0.0,0.0,1.35062,04.12.2017 15:30:00,15305,-0.0411866132459556,-42.0,IS,0.14,0.0,Phase3-EA-B1v1-GBPUSD-M30-14,GBPUSDMT4,992,4h 29m,Buy
167026.79,0.98558,04.12.2017 23:29:58,tp 0.98558,0.0,-47.029999999998836,0.0,0.0,0.98658,04.12.2017 22:00:00,15306,-0.01829435607250811,58.85,IS,0.58,0.0,Phase3-EA-SA2v2-USDCHF-M15-107,USDCHFMT4,3020,1h 29m,Sell
166983.07,1.16843,05.12.2017 04:30:00,,-2.08,-90.75,0.0,0.0,1.16743,04.12.2017 20:10:00,15307,-0.035301144239424875,-43.72,IS,0.41,0.0,Phase3-EA-SA2v2-EURCHF-M5-43,EURCHFMT4,7786,8h 20m,Sell
166999.84,151522,05.12.2017 06:50:00,,0.0,-73.98000000001048,0.0,0.0,151.44,05.12.2017 01:25:00,15308,-0.028777726179978206,16.77,IS,0.23,0.0,Phase3-EA-S4v1-GBPJPY-M5-194,GBPJPYMT4,3330,5h 25m,Buy
167024.49,112799,05.12.2017 22:15:00,,0.0,-49.3300000000163,0.0,0.0,112696,05.12.2017 21:45:00,15309,-0.019189040719905286,24.65,IS,0.27,0.0,Phase3-EA-S1v2-USDJPY-M15-0,USDJPYMT4,4416,30m 0s,Buy
167083.19,0.98803,06.12.2017 04:44:59,tp 0.98803,0.0,-0.0,0.0,0.0,0.98703,06.12.2017 02:15:00,15310,-0.0,58.7,IS,0.58,0.0,Phase3-EA-SA2v2-USDCHF-M15-107,USDCHFMT4,3022,2h 29m,Buy
167001.25,150.92,06.12.2017 05:10:00,,-0.74,-81.94000000000233,0.0,0.0,151317,05.12.2017 23:45:00,15311,-0.03187295131976613,-81.94,IS,0.23,0.0,Phase3-EA-S4v1-GBPJPY-M5-194,GBPJPYMT4,3332,5h 25m,Buy
166957.22,1.16859,06.12.2017 08:10:00,,-2.07,-125.97000000000116,0.0,0.0,1.16758,05.12.2017 23:50:00,15312,-0.04899970317001296,-44.03,IS,0.41,0.0,Phase3-EA-SA2v2-EURCHF-M5-43,EURCHFMT4,7788,8h 20m,Sell
167060.27,132465,06.12.2017 11:59:57,tp 132.465,-0.56,-22.920000000012806,0.0,0.0,133755,04.12.2017 19:00:00,15313,-0.008915402053324714,103.05,IS,0.09,0.0,Phase3-EA-TR1v1-EURJPY-M30-91,EURJPYMT4,2710,1d 16h 59m,Sell
167060.96,1.16782,06.12.2017 13:00:00,,0.0,-22.230000000010477,0.0,0.0,1.16784,06.12.2017 04:15:00,15314,-0.008647006441770988,0.69,IS,0.34,0.0,Phase3-EA-S4v1-EURCHF-M15-221,EURCHFMT4,3964,8h 45m,Sell
166926.45,112191,06.12.2017 15:30:00,,-0.7,-156.7400000000198,0.0,0.0,112747,05.12.2017 22:45:00,15315,-0.06096859152868723,-134.51,IS,0.27,0.0,Phase3-EA-S1v2-USDJPY-M15-0,USDJPYMT4,4418,16h 45m,Buy
166965.81,1.16681,07.12.2017 02:04:57,tp 1.16681,-6.21,-117.38000000003376,0.0,0.0,1.16791,06.12.2017 22:35:00,15316,-0.04565837229576663,39.36,IS,0.41,0.0,Phase3-EA-SA2v2-EURCHF-M5-43,EURCHFMT4,7790,3h 29m,Sell
166936.96,150.48,07.12.2017 06:55:00,,0.0,-146.23000000003958,0.0,0.0,150339,07.12.2017 01:30:00,15317,-0.05688042069185416,-28.85,IS,0.23,0.0,Phase3-EA-S4v1-GBPJPY-M5-194,GBPJPYMT4,3334,5h 25m,Sell
166953.1,1.16816,07.12.2017 10:30:00,,0.0,-130.0900000000256,0.0,0.0,1.16777,07.12.2017 02:10:00,15318,-0.050602297256395826,16.14,IS,0.41,0.0,Phase3-EA-SA2v2-EURCHF-M5-43,EURCHFMT4,7792,8h 20m,Buy
166898.15,150772,07.12.2017 12:59:58,sl 150.772,-1.39,-185.04000000003725,0.0,0.0,150102,06.12.2017 14:00:00,15319,-0.07197670139383139,-54.95,IS,0.09,0.0,Phase3-EA-B1v1-GBPJPY-M30-1,GBPJPYMT4,1404,22h 59m,Sell
166943.61,1.17055,07.12.2017 21:54:58,tp 1.17055,0.0,-139.5800000000454,0.0,0.0,1.16945,07.12.2017 20:55:00,15320,-0.054293709363122736,45.46,IS,0.41,0.0,Phase3-EA-SA2v2-EURCHF-M5-43,EURCHFMT4,7794,59m 58s,Buy
166896.79,0.99476,08.12.2017 04:00:00,,-3.09,-186.4000000000524,0.0,0.0,0.99401,07.12.2017 23:45:00,15321,-0.07250571303399936,-46.82,IS,0.58,0.0,Phase3-EA-SA2v2-USDCHF-M15-107,USDCHFMT4,3024,4h 15m,Sell
166894.73,1.17105,08.12.2017 06:45:00,,-2.06,-188.46000000005006,0.0,0.0,1.17105,07.12.2017 22:25:00,15322,-0.07330701007718513,-2.06,IS,0.41,0.0,Phase3-EA-SA2v2-EURCHF-M5-43,EURCHFMT4,7796,8h 20m,Sell
166797.13,152957,08.12.2017 08:50:00,,0.0,-286.0600000000559,0.0,0.0,152476,08.12.2017 03:25:00,15323,-0.11127137484176007,-97.6,IS,0.23,0.0,Phase3-EA-S4v1-GBPJPY-M5-194,GBPJPYMT4,3336,5h 25m,Sell
166755.13,1.34624,08.12.2017 14:59:58,sl 1.34624,0.0,-328.0600000000559,0.0,0.0,1.34924,08.12.2017 12:00:00,15324,-0.127608499023236,-42.0,IS,0.14,0.0,Phase3-EA-B1v1-GBPUSD-M30-14,GBPUSDMT4,994,2h 59m,Buy
166701.99,151964,08.12.2017 17:59:57,sl 151.964,0.0,-381.20000000006985,0.0,0.0,152634,08.12.2017 04:00:00,15325,-0.1482788509042803,-53.14,IS,0.09,0.0,Phase3-EA-B1v1-GBPJPY-M30-1,GBPJPYMT4,1406,13h 59m,Buy
166759.66,0.99361,11.12.2017 02:00:00,tp 0.99361,-0.7,-323.53000000005704,0.0,0.0,0.99261,08.12.2017 23:30:00,15326,-0.12584642348652014,57.67,IS,0.58,0.0,Phase3-EA-SA2v2-USDCHF-M15-107,USDCHFMT4,3026,2d 2h 30m,Buy
166722.05,133639,11.12.2017 02:44:58,sl 133.639,-3.17,-361.1400000000431,0.0,0.0,133409,05.12.2017 12:45:00,15327,-0.14047592921187924,-37.61,IS,0.17,0.0,Phase3-EA-T1v2-EURJPY-M15-322,EURJPYMT4,3004,5d 13h 59m,Sell
166726.84,1.16845,11.12.2017 05:00:00,,-0.99,-356.3500000000349,0.0,0.0,1.16831,08.12.2017 20:40:00,15328,-0.13861271909689346,4.79,IS,0.41,0.0,Phase3-EA-SA2v2-EURCHF-M5-43,EURCHFMT4,7798,2d 8h 20m,Buy
166739.71,0.99158,12.12.2017 05:45:00,,0.0,-343.4800000000396,0.0,0.0,0.9918,12.12.2017 01:30:00,15329,-0.1336065574727144,12.87,IS,0.58,0.0,Phase3-EA-SA2v2-USDCHF-M15-107,USDCHFMT4,3028,4h 15m,Sell
166702.34,1.1671,12.12.2017 06:00:00,,-0.99,-380.8500000000349,0.0,0.0,1.16798,11.12.2017 21:40:00,15330,-0.14814270820275444,-37.37,IS,0.41,0.0,Phase3-EA-SA2v2-EURCHF-M5-43,EURCHFMT4,7800,8h 20m,Buy
166725.85,151362,12.12.2017 07:00:00,,0.0,-357.3400000000256,0.0,0.0,151478,12.12.2017 01:35:00,15331,-0.13899780845259604,23.51,IS,0.23,0.0,Phase3-EA-S4v1-GBPJPY-M5-194,GBPJPYMT4,3338,5h 25m,Sell
166748.82,1.16807,12.12.2017 11:45:00,,0.0,-334.37000000002445,0.0,0.0,1.1674,12.12.2017 03:00:00,15332,-0.13006295744191695,22.97,IS,0.34,0.0,Phase3-EA-S4v1-EURCHF-M15-221,EURCHFMT4,3966,8h 45m,Buy
166735.42,1.16394,13.12.2017 04:20:00,,-0.99,-347.7700000000186,0.0,0.0,1.16424,12.12.2017 20:00:00,15333,-0.1352752780140999,-13.4,IS,0.41,0.0,Phase3-EA-SA2v2-EURCHF-M5-43,EURCHFMT4,7802,8h 20m,Buy
166709.18,1.16483,14.12.2017 08:30:00,,0.0,-374.0100000000093,0.0,0.0,1.1642,14.12.2017 00:10:00,15334,-0.14548209083604696,-26.24,IS,0.41,0.0,Phase3-EA-SA2v2-EURCHF-M5-43,EURCHFMT4,7804,8h 20m,Sell
166721.95,1.16469,14.12.2017 10:00:00,,0.0,-361.2400000000198,0.0,0.0,1.16506,14.12.2017 01:15:00,15335,-0.14051482712658797,12.77,IS,0.34,0.0,Phase3-EA-S4v1-EURCHF-M15-221,EURCHFMT4,3968,8h 45m,Sell
166645.07,1.16456,15.12.2017 04:25:00,,-1.0,-438.12000000002445,0.0,0.0,1.16639,14.12.2017 20:05:00,15336,-0.17041954396163433,-76.88,IS,0.41,0.0,Phase3-EA-SA2v2-EURCHF-M5-43,EURCHFMT4,7806,8h 20m,Buy
166691.52,112179,15.12.2017 06:15:00,,0.0,-391.6700000000128,0.0,0.0,112372,15.12.2017 01:30:00,15337,-0.15235146257521176,46.45,IS,0.27,0.0,Phase3-EA-S1v2-USDJPY-M15-0,USDJPYMT4,4420,4h 45m,Sell
166789.27,132103,15.12.2017 12:29:58,tp 132.103,-3.36,-293.9200000000128,0.0,0.0,133363,05.12.2017 01:30:00,15338,-0.11432875093856239,97.75,IS,0.09,0.0,Phase3-EA-TR1v1-EURJPY-M30-91,EURJPYMT4,2711,10d 10h 59m,Sell
166738.02,1.16654,15.12.2017 14:45:00,,0.0,-345.1700000000128,0.0,0.0,1.16505,15.12.2017 06:00:00,15339,-0.13426393223143482,-51.25,IS,0.34,0.0,Phase3-EA-S4v1-EURCHF-M15-221,EURCHFMT4,3970,8h 45m,Sell
166883.16,149983,15.12.2017 16:59:58,tp 149.983,-3.24,-200.02999999999884,0.0,0.0,151833,08.12.2017 20:00:00,15340,-0.07780749881001464,145.14,IS,0.09,0.0,Phase3-EA-B1v1-GBPJPY-M30-1,GBPJPYMT4,1408,6d 20h 59m,Sell
166790.79,1.1646,18.12.2017 04:25:00,,-0.99,-292.3999999999942,0.0,0.0,1.16681,15.12.2017 20:05:00,15341,-0.11373750263484458,-92.37,IS,0.41,0.0,Phase3-EA-SA2v2-EURCHF-M5-43,EURCHFMT4,7808,2d 8h 20m,Buy
166849.16,1.16513,18.12.2017 10:45:00,,0.0,-234.02999999999884,0.0,0.0,1.16343,18.12.2017 02:00:00,15342,-0.09103278981406661,58.37,IS,0.34,0.0,Phase3-EA-S4v1-EURCHF-M15-221,EURCHFMT4,3972,8h 45m,Buy
166738.76,1.1614,19.12.2017 04:20:00,,-1.0,-344.429999999993,0.0,0.0,1.16403,18.12.2017 20:00:00,15343,-0.1339760876625154,-110.4,IS,0.41,0.0,Phase3-EA-SA2v2-EURCHF-M5-43,EURCHFMT4,7810,8h 20m,Buy
166777.05,1.16249,19.12.2017 11:00:00,,0.0,-306.13999999998487,0.0,0.0,1.16138,19.12.2017 02:15:00,15344,-0.11908207611706667,38.29,IS,0.34,0.0,Phase3-EA-S4v1-EURCHF-M15-221,EURCHFMT4,3974,8h 45m,Buy
166879.06,133.6,19.12.2017 21:29:58,tp 133.600,-0.78,-204.12999999997555,0.0,0.0,132.31,15.12.2017 14:00:00,15345,-0.07940231331343539,102.01,IS,0.09,0.0,Phase3-EA-TR1v1-EURJPY-M30-91,EURJPYMT4,2714,4d 7h 29m,Buy
166840.76,133793,19.12.2017 22:14:58,sl 133.793,-3.7,-242.4299999999639,0.0,0.0,133563,12.12.2017 01:15:00,15346,-0.09430021465034821,-38.3,IS,0.17,0.0,Phase3-EA-T1v2-EURJPY-M15-322,EURJPYMT4,3006,7d 20h 59m,Sell
166851.04,112986,20.12.2017 04:15:00,,0.0,-232.14999999996508,0.0,0.0,112943,20.12.2017 00:15:00,15347,-0.09030150901735884,10.28,IS,0.27,0.0,Phase3-EA-S1v2-USDJPY-M15-0,USDJPYMT4,4422,4h 0m,Buy
166834.4,1.16651,20.12.2017 04:20:00,,-2.08,-248.78999999997905,0.0,0.0,1.16616,19.12.2017 20:00:00,15348,-0.09677412202640617,-16.64,IS,0.41,0.0,Phase3-EA-SA2v2-EURCHF-M5-43,EURCHFMT4,7812,8h 20m,Sell
166933.85,134088,20.12.2017 12:59:57,tp 134.088,-0.78,-149.3399999999674,0.0,0.0,132828,18.12.2017 13:00:00,15349,-0.05809014583954966,99.45,IS,0.09,0.0,Phase3-EA-TR1v1-EURJPY-M30-91,EURJPYMT4,2715,1d 23h 59m,Buy
166973.32,1.17042,21.12.2017 02:04:58,tp 1.17042,-6.23,-109.86999999996624,0.0,0.0,1.17152,20.12.2017 20:50:00,15350,-0.0427371389004336,39.47,IS,0.41,0.0,Phase3-EA-SA2v2-EURCHF-M5-43,EURCHFMT4,7814,5h 14m,Sell
167019.05,1.1709,21.12.2017 02:19:59,tp 1.17090,0.0,-64.13999999995576,0.0,0.0,1.1698,21.12.2017 02:10:00,15351,-0.024949122499979635,45.73,IS,0.41,0.0,Phase3-EA-SA2v2-EURCHF-M5-43,EURCHFMT4,7816,9m 59s,Buy
166975.45,1.33604,21.12.2017 05:29:57,sl 1.33604,-1.6,-107.73999999996158,0.0,0.0,1.33904,20.12.2017 04:30:00,15352,-0.04190861331694265,-43.6,IS,0.14,0.0,Phase3-EA-B1v1-GBPUSD-M30-14,GBPUSDMT4,996,1d 0h 59m,Buy
166977.88,151536,21.12.2017 07:55:00,,0.0,-105.30999999996857,0.0,0.0,151524,21.12.2017 02:30:00,15353,-0.04096339398930283,2.43,IS,0.23,0.0,Phase3-EA-S4v1-GBPJPY-M5-194,GBPJPYMT4,3340,5h 25m,Buy
167033.04,1.1702,21.12.2017 09:45:00,,0.0,-50.149999999965075,0.0,0.0,1.1718,21.12.2017 01:00:00,15354,-0.019507304230963054,55.16,IS,0.34,0.0,Phase3-EA-S4v1-EURCHF-M15-221,EURCHFMT4,3976,8h 45m,Sell
166970.37,134786,21.12.2017 11:59:58,sl 134.786,-0.83,-112.81999999997788,0.0,0.0,134006,20.12.2017 13:00:00,15355,-0.04388462738461322,-62.67,IS,0.09,0.0,Phase3-EA-TR1v1-EURJPY-M30-91,EURJPYMT4,2718,22h 59m,Sell
166935.89,134451,21.12.2017 18:14:57,sl 134.451,0.0,-147.29999999998836,0.0,0.0,134681,21.12.2017 07:30:00,15356,-0.05729662837931469,-34.48,IS,0.17,0.0,Phase3-EA-T1v2-EURJPY-M15-322,EURJPYMT4,3008,10h 44m,Buy
166994.53,0.98909,22.12.2017 04:14:58,tp 0.98909,0.0,-88.65999999997439,0.0,0.0,0.98809,22.12.2017 01:15:00,15357,-0.03448689118879141,58.64,IS,0.58,0.0,Phase3-EA-SA2v2-USDCHF-M15-107,USDCHFMT4,3030,2h 59m,Buy
166917.4,1.17151,22.12.2017 08:25:00,,0.0,-165.78999999997905,0.0,0.0,1.17337,22.12.2017 00:05:00,15358,-0.06448885281063227,-77.13,IS,0.41,0.0,Phase3-EA-SA2v2-EURCHF-M5-43,EURCHFMT4,7818,8h 20m,Buy
166928.05,1.17305,22.12.2017 12:30:00,,0.0,-155.13999999998487,0.0,0.0,1.17274,22.12.2017 03:45:00,15359,-0.060346224893188846,10.65,IS,0.34,0.0,Phase3-EA-S4v1-EURCHF-M15-221,EURCHFMT4,3978,8h 45m,Buy
166873.28,1.17439,26.12.2017 08:00:00,,-2.07,-209.9099999999744,0.0,0.0,1.17312,22.12.2017 22:35:00,15360,-0.08165061278412376,-54.77,IS,0.41,0.0,Phase3-EA-SA2v2-EURCHF-M5-43,EURCHFMT4,7820,3d 9h 25m,Sell
166830.75,1.33531,26.12.2017 17:29:58,sl 1.33531,-0.53,-252.43999999997322,0.0,0.0,1.33831,22.12.2017 07:00:00,15361,-0.0981938959136036,-42.53,IS,0.14,0.0,Phase3-EA-B1v1-GBPUSD-M30-14,GBPUSDMT4,998,4d 10h 29m,Buy
166814.52,134.29,26.12.2017 23:00:00,,0.0,-268.6699999999837,0.0,0.0,134398,26.12.2017 19:30:00,15362,-0.1045070274723066,-16.23,IS,0.17,0.0,Phase3-EA-T1v2-EURJPY-M15-322,EURJPYMT4,3010,3h 30m,Buy
166819.16,1.17372,27.12.2017 05:10:00,,-1.99,-264.02999999996973,0.0,0.0,1.17356,26.12.2017 20:50:00,15363,-0.10270216422939525,4.64,IS,0.41,0.0,Phase3-EA-SA2v2-EURCHF-M5-43,EURCHFMT4,7822,8h 20m,Buy
166800.99,0.98955,27.12.2017 05:45:00,,0.0,-282.19999999998254,0.0,0.0,0.98924,27.12.2017 01:30:00,15364,-0.10976991533362447,-18.17,IS,0.58,0.0,Phase3-EA-SA2v2-USDCHF-M15-107,USDCHFMT4,3032,4h 15m,Sell
166886.93,1.17509,27.12.2017 11:15:00,,0.0,-196.2599999999802,0.0,0.0,1.17259,27.12.2017 02:30:00,15365,-0.07634104742514634,85.94,IS,0.34,0.0,Phase3-EA-S4v1-EURCHF-M15-221,EURCHFMT4,3980,8h 45m,Buy
166837.35,1.17333,28.12.2017 05:15:00,,-2.99,-245.8399999999674,0.0,0.0,1.17445,27.12.2017 20:55:00,15366,-0.09562663354222654,-49.58,IS,0.41,0.0,Phase3-EA-SA2v2-EURCHF-M5-43,EURCHFMT4,7824,8h 20m,Buy
166815.55,1.17215,28.12.2017 11:00:00,,0.0,-267.63999999995576,0.0,0.0,1.17278,28.12.2017 02:15:00,15367,-0.10410637895070239,-21.8,IS,0.34,0.0,Phase3-EA-S4v1-EURCHF-M15-221,EURCHFMT4,3982,8h 45m,Buy
166861.66,1.16934,28.12.2017 21:44:59,tp 1.16934,0.0,-221.52999999996973,0.0,0.0,1.16824,28.12.2017 21:00:00,15368,-0.0861705504743303,46.11,IS,0.41,0.0,Phase3-EA-SA2v2-EURCHF-M5-43,EURCHFMT4,7826,44m 59s,Buy
166905.63,1.16879,29.12.2017 01:04:57,tp 1.16879,-2.1,-177.55999999996857,0.0,0.0,1.16989,28.12.2017 22:40:00,15369,-0.06906713737291324,43.97,IS,0.41,0.0,Phase3-EA-SA2v2-EURCHF-M5-43,EURCHFMT4,7828,2h 24m,Sell
166951.63,1.16996,29.12.2017 02:09:57,tp 1.16996,0.0,-131.55999999996857,0.0,0.0,1.16886,29.12.2017 01:20:00,15370,-0.051174096602725296,46.0,IS,0.41,0.0,Phase3-EA-SA2v2-EURCHF-M5-43,EURCHFMT4,7830,49m 57s,Buy
167010.97,0.9775,29.12.2017 02:14:57,tp 0.97750,0.0,-72.21999999997206,0.0,0.0,0.9785,29.12.2017 01:15:00,15371,-0.028092074009184204,59.34,IS,0.58,0.0,Phase3-EA-SA2v2-USDCHF-M15-107,USDCHFMT4,3034,59m 57s,Sell
167070.18,0.97953,29.12.2017 02:44:57,tp 0.97953,0.0,-13.00999999998021,0.0,0.0,0.97853,29.12.2017 02:30:00,15372,-0.005060618704778066,59.21,IS,0.58,0.0,Phase3-EA-SA2v2-USDCHF-M15-107,USDCHFMT4,3036,14m 57s,Buy
167084.78,1.1691,29.12.2017 11:15:00,,0.0,-0.0,0.0,0.0,1.16868,29.12.2017 02:30:00,15373,-0.0,14.6,IS,0.34,0.0,Phase3-EA-S4v1-EURCHF-M15-221,EURCHFMT4,3984,8h 45m,Buy
167092.7,112508,29.12.2017 19:15:00,,0.0,-0.0,0.0,0.0,112541,29.12.2017 18:30:00,15374,-0.0,7.92,IS,0.27,0.0,Phase3-EA-S1v2-USDJPY-M15-0,USDJPYMT4,4424,45m 0s,Sell
167028.14,135454,29.12.2017 20:59:58,sl 135.454,-2.23,-64.55999999999767,0.0,0.0,134674,21.12.2017 16:30:00,15375,-0.025111564816891842,-64.56,IS,0.09,0.0,Phase3-EA-TR1v1-EURJPY-M30-91,EURJPYMT4,2720,8d 4h 29m,Sell
167023.09,1.17064,02.01.2018 10:30:00,,0.0,-69.60999999998603,0.0,0.0,1.17076,02.01.2018 02:10:00,15376,-0.02707583684794847,-5.05,IS,0.41,0.0,Phase3-EA-SA2v2-EURCHF-M5-43,EURCHFMT4,7832,8h 20m,Buy
167283.97,1.35682,02.01.2018 19:59:58,tp 1.35682,-3.72,-0.0,0.0,0.0,1.33792,26.12.2017 21:30:00,15377,-0.0,260.88,IS,0.14,0.0,Phase3-EA-B1v1-GBPUSD-M30-14,GBPUSDMT4,1000,6d 22h 29m,Buy
167309.74,112122,02.01.2018 20:15:00,,0.0,-0.0,0.0,0.0,112229,02.01.2018 19:00:00,15378,-0.0,25.77,IS,0.27,0.0,Phase3-EA-S1v2-USDJPY-M15-0,USDJPYMT4,4426,1h 15m,Sell
167304.49,152711,03.01.2018 04:35:00,,-2.38,-5.25,0.0,0.0,152697,02.01.2018 23:10:00,15379,-0.0020403425070500514,-5.25,IS,0.23,0.0,Phase3-EA-S4v1-GBPJPY-M5-194,GBPJPYMT4,3342,5h 25m,Sell
167308.7,1.17119,03.01.2018 07:00:00,,-4.22,-1.040000000008149,0.0,0.0,1.17139,02.01.2018 22:40:00,15380,-4.04182134733082E-4,4.21,IS,0.41,0.0,Phase3-EA-SA2v2-EURCHF-M5-43,EURCHFMT4,7834,8h 20m,Sell
167313.25,1.17168,03.01.2018 09:45:00,,0.0,-0.0,0.0,0.0,1.17181,03.01.2018 01:00:00,15381,-0.0,4.55,IS,0.34,0.0,Phase3-EA-S4v1-EURCHF-M15-221,EURCHFMT4,3986,8h 45m,Sell
167278.46,135188,03.01.2018 12:14:58,sl 135.188,0.0,-34.79000000000815,0.0,0.0,135418,03.01.2018 09:45:00,15382,-0.013520485245127464,-34.79,IS,0.17,0.0,Phase3-EA-T1v2-EURJPY-M15-322,EURJPYMT4,3012,2h 29m,Buy
167324.6,1.17469,04.01.2018 06:29:57,tp 1.17469,0.0,-0.0,0.0,0.0,1.17359,04.01.2018 01:05:00,15383,-0.0,46.14,IS,0.41,0.0,Phase3-EA-SA2v2-EURCHF-M5-43,EURCHFMT4,7836,5h 24m,Buy
167373.29,1.17507,04.01.2018 10:00:00,,0.0,-0.0,0.0,0.0,1.17367,04.01.2018 01:15:00,15384,-0.0,48.69,IS,0.34,0.0,Phase3-EA-S4v1-EURCHF-M15-221,EURCHFMT4,3988,8h 45m,Buy
167469.34,135727,04.01.2018 15:29:58,tp 135.727,-4.7,-0.0,0.0,0.0,134467,26.12.2017 09:30:00,15385,-0.0,96.05,IS,0.09,0.0,Phase3-EA-TR1v1-EURJPY-M30-91,EURJPYMT4,2721,9d 5h 59m,Buy
167440.13,1.17584,05.01.2018 05:40:00,,-1.01,-29.20999999999185,0.0,0.0,1.17651,04.01.2018 21:20:00,15386,-0.011345040151185256,-29.21,IS,0.41,0.0,Phase3-EA-SA2v2-EURCHF-M5-43,EURCHFMT4,7838,8h 20m,Buy
167436.57,112818,05.01.2018 06:15:00,,-0.69,-32.76999999998952,0.0,0.0,112.83,04.01.2018 23:15:00,15387,-0.012727729056977942,-3.56,IS,0.27,0.0,Phase3-EA-S1v2-USDJPY-M15-0,USDJPYMT4,4428,7h 0m,Buy
167578.9,153282,05.01.2018 09:29:57,tp 153.282,-5.18,-0.0,0.0,0.0,151432,20.12.2017 12:00:00,15388,-0.0,142.33,IS,0.09,0.0,Phase3-EA-B1v1-GBPJPY-M30-1,GBPJPYMT4,1410,15d 21h 29m,Buy
167600.85,1.17651,05.01.2018 11:00:00,,0.0,-0.0,0.0,0.0,1.17588,05.01.2018 02:15:00,15389,-0.0,21.95,IS,0.34,0.0,Phase3-EA-S4v1-EURCHF-M15-221,EURCHFMT4,3990,8h 45m,Buy
167614.51,136.25,05.01.2018 19:00:00,,0.0,-0.0,0.0,0.0,136159,05.01.2018 04:30:00,15390,-0.0,13.66,IS,0.17,0.0,Phase3-EA-T1v2-EURJPY-M15-322,EURJPYMT4,3014,14h 30m,Buy
167660.74,1.17521,05.01.2018 21:44:58,tp 1.17521,0.0,-0.0,0.0,0.0,1.17411,05.01.2018 20:05:00,15391,-0.0,46.23,IS,0.41,0.0,Phase3-EA-SA2v2-EURCHF-M5-43,EURCHFMT4,7840,1h 39m,Buy
167704.91,1.1742,08.01.2018 02:00:00,tp 1.17420,-2.1,-0.0,0.0,0.0,1.1753,05.01.2018 23:10:00,15392,-0.0,44.17,IS,0.41,0.0,Phase3-EA-SA2v2-EURCHF-M5-43,EURCHFMT4,7842,2d 2h 50m,Sell
167751.16,1.17392,08.01.2018 04:49:58,tp 1.17392,0.0,-0.0,0.0,0.0,1.17282,08.01.2018 02:00:00,15393,-0.0,46.25,IS,0.41,0.0,Phase3-EA-SA2v2-EURCHF-M5-43,EURCHFMT4,7844,2h 49m,Buy
167771.07,153497,08.01.2018 08:55:00,,0.0,-0.0,0.0,0.0,153595,08.01.2018 03:30:00,15394,-0.0,19.91,IS,0.23,0.0,Phase3-EA-S4v1-GBPJPY-M5-194,GBPJPYMT4,3344,5h 25m,Sell
167741.81,1.17221,08.01.2018 11:15:00,,0.0,-29.260000000009313,0.0,0.0,1.17305,08.01.2018 02:30:00,15395,-0.011351157443699612,-29.26,IS,0.34,0.0,Phase3-EA-S4v1-EURCHF-M15-221,EURCHFMT4,3992,8h 45m,Buy
167699.81,1.35393,08.01.2018 11:59:58,sl 1.35393,0.0,-71.26000000000931,0.0,0.0,1.35693,08.01.2018 02:00:00,15396,-0.027644684874842194,-42.0,IS,0.14,0.0,Phase3-EA-B1v1-GBPUSD-M30-14,GBPUSDMT4,1002,9h 59m,Buy
167745.93,1.16975,08.01.2018 23:55:00,tp 1.16975,0.0,-25.14000000001397,0.0,0.0,1.16865,08.01.2018 22:55:00,15397,-0.009752839990932193,46.12,IS,0.41,0.0,Phase3-EA-SA2v2-EURCHF-M5-43,EURCHFMT4,7846,1h 0m,Buy
167802.21,0.97608,09.01.2018 02:14:57,tp 0.97608,-3.14,-0.0,0.0,0.0,0.97708,08.01.2018 23:00:00,15398,-0.0,56.28,IS,0.58,0.0,Phase3-EA-SA2v2-USDCHF-M15-107,USDCHFMT4,3038,3h 14m,Sell
167848.36,1.16986,09.01.2018 03:54:57,tp 1.16986,0.0,-0.0,0.0,0.0,1.16876,09.01.2018 02:10:00,15399,-0.0,46.15,IS,0.41,0.0,Phase3-EA-SA2v2-EURCHF-M5-43,EURCHFMT4,7848,1h 44m,Buy
167927.76,153135,09.01.2018 05:39:58,tp 153.135,0.0,-0.0,0.0,0.0,153525,09.01.2018 03:05:00,15400,-0.0,79.4,IS,0.23,0.0,Phase3-EA-S4v1-GBPJPY-M5-194,GBPJPYMT4,3346,2h 34m,Sell
167869.26,134991,09.01.2018 05:59:58,sl 134.991,-1.17,-58.5,0.0,0.0,135711,04.01.2018 15:30:00,15401,-0.022680769220032638,-58.5,IS,0.09,0.0,Phase3-EA-TR1v1-EURJPY-M30-91,EURJPYMT4,2724,4d 14h 29m,Buy
167815.16,152724,09.01.2018 06:29:58,sl 152.724,-0.58,-112.60000000000582,0.0,0.0,153394,05.01.2018 12:30:00,15402,-0.04365563443035567,-54.1,IS,0.09,0.0,Phase3-EA-B1v1-GBPJPY-M30-1,GBPJPYMT4,1412,3d 17h 59m,Buy
167725.12,1.17241,09.01.2018 13:15:00,,0.0,-202.64000000001397,0.0,0.0,1.16981,09.01.2018 04:30:00,15403,-0.07856463375637146,-90.04,IS,0.34,0.0,Phase3-EA-S4v1-EURCHF-M15-221,EURCHFMT4,3994,8h 45m,Sell
167980.75,134475,09.01.2018 15:14:59,tp 134.475,-0.53,-0.0,0.0,0.0,136175,08.01.2018 07:30:00,15404,-0.0,255.63,IS,0.17,0.0,Phase3-EA-T1v2-EURJPY-M15-322,EURJPYMT4,3016,1d 7h 44m,Sell
168026.6,1.17276,09.01.2018 22:39:57,tp 1.17276,0.0,-0.0,0.0,0.0,1.17166,09.01.2018 20:35:00,15405,-0.0,45.85,IS,0.41,0.0,Phase3-EA-SA2v2-EURCHF-M5-43,EURCHFMT4,7850,2h 4m,Buy
168087.51,112379,10.01.2018 05:00:00,,-1.08,-0.0,0.0,0.0,112637,09.01.2018 21:15:00,15406,-0.0,60.91,IS,0.27,0.0,Phase3-EA-S1v2-USDJPY-M15-0,USDJPYMT4,4430,7h 45m,Sell
168085.15,0.98319,10.01.2018 06:30:00,,0.0,-2.35999999998603,0.0,0.0,0.98323,10.01.2018 02:15:00,15407,-9.144185241610554E-4,-2.36,IS,0.58,0.0,Phase3-EA-SA2v2-USDCHF-M15-107,USDCHFMT4,3040,4h 15m,Buy
168024.7,1.17438,10.01.2018 07:50:00,,-2.08,-62.80999999999767,0.0,0.0,1.17298,09.01.2018 23:30:00,15408,-0.02433670656902277,-60.45,IS,0.41,0.0,Phase3-EA-SA2v2-EURCHF-M5-43,EURCHFMT4,7852,8h 20m,Sell
168005.35,1.1738,10.01.2018 10:00:00,,0.0,-82.16000000000349,0.0,0.0,1.17324,10.01.2018 01:15:00,15409,-0.03183416353623738,-19.35,IS,0.34,0.0,Phase3-EA-S4v1-EURCHF-M15-221,EURCHFMT4,3996,8h 45m,Sell
167942.36,133516,10.01.2018 11:29:58,sl 133.516,-0.39,-145.14999999999418,0.0,0.0,134296,09.01.2018 21:30:00,15410,-0.05624061389099896,-62.99,IS,0.09,0.0,Phase3-EA-TR1v1-EURJPY-M30-91,EURJPYMT4,2726,13h 59m,Buy
167900.36,1.35106,10.01.2018 18:59:58,sl 1.35106,0.0,-187.14999999999418,0.0,0.0,1.35406,10.01.2018 15:00:00,15411,-0.07251416389735135,-42.0,IS,0.14,0.0,Phase3-EA-B1v1-GBPUSD-M30-14,GBPUSDMT4,1004,3h 59m,Buy
167948.6,111378,10.01.2018 23:45:00,,0.0,-138.9100000000035,0.0,0.0,111577,10.01.2018 18:00:00,15412,-0.05382282931863021,48.24,IS,0.27,0.0,Phase3-EA-S1v2-USDJPY-M15-0,USDJPYMT4,4432,5h 45m,Sell
167998.5,0.97758,11.01.2018 00:44:58,tp 0.97758,-9.43,-89.01000000000931,0.0,0.0,0.97858,10.01.2018 22:00:00,15413,-0.03448830204918044,49.9,IS,0.58,0.0,Phase3-EA-SA2v2-USDCHF-M15-107,USDCHFMT4,3042,2h 44m,Sell
167979.13,1.16935,11.01.2018 05:25:00,,-3.02,-108.38000000000466,0.0,0.0,1.16974,10.01.2018 21:05:00,15414,-0.04199350832591783,-19.37,IS,0.41,0.0,Phase3-EA-SA2v2-EURCHF-M5-43,EURCHFMT4,7854,8h 20m,Buy
168013.5,1.16995,11.01.2018 10:30:00,,0.0,-74.01000000000931,0.0,0.0,1.16896,11.01.2018 01:45:00,15415,-0.02867631990405459,34.37,IS,0.34,0.0,Phase3-EA-S4v1-EURCHF-M15-221,EURCHFMT4,3998,8h 45m,Buy
168059.75,1.17403,11.01.2018 20:44:58,tp 1.17403,0.0,-27.760000000009313,0.0,0.0,1.17513,11.01.2018 20:30:00,15416,-0.010756041623249862,46.25,IS,0.41,0.0,Phase3-EA-SA2v2-EURCHF-M5-43,EURCHFMT4,7856,14m 58s,Sell
168024.58,133712,11.01.2018 22:44:58,sl 133.712,0.0,-62.93000000002212,0.0,0.0,133942,11.01.2018 16:45:00,15417,-0.02438320242619325,-35.17,IS,0.17,0.0,Phase3-EA-T1v2-EURJPY-M15-322,EURJPYMT4,3018,5h 59m,Buy
168068.7,1.17395,12.01.2018 01:14:58,tp 1.17395,-2.1,-18.810000000026776,0.0,0.0,1.17505,11.01.2018 23:35:00,15418,-0.0072882256099982,44.12,IS,0.41,0.0,Phase3-EA-SA2v2-EURCHF-M5-43,EURCHFMT4,7858,1h 39m,Sell
168125.04,0.97494,12.01.2018 02:59:57,tp 0.97494,-3.15,-0.0,0.0,0.0,0.97594,11.01.2018 23:00:00,15419,-0.0,56.34,IS,0.58,0.0,Phase3-EA-SA2v2-USDCHF-M15-107,USDCHFMT4,3044,3h 59m,Sell
168204.87,150746,12.01.2018 03:54:57,tp 150.746,-0.75,-0.0,0.0,0.0,150356,11.01.2018 23:10:00,15420,-0.0,79.83,IS,0.23,0.0,Phase3-EA-S4v1-GBPJPY-M5-194,GBPJPYMT4,3348,4h 44m,Buy
168205.84,111212,12.01.2018 05:00:00,,0.0,-0.0,0.0,0.0,111216,12.01.2018 01:15:00,15421,-0.0,0.97,IS,0.27,0.0,Phase3-EA-S1v2-USDJPY-M15-0,USDJPYMT4,4434,3h 45m,Sell
168090.41,1.17858,12.01.2018 13:15:00,,0.0,-115.42999999999302,0.0,0.0,1.17528,12.01.2018 04:30:00,15422,-0.04470464339613401,-115.43,IS,0.34,0.0,Phase3-EA-S4v1-EURCHF-M15-221,EURCHFMT4,4000,8h 45m,Sell
168034.19,151353,12.01.2018 15:29:58,sl 151.353,-1.88,-171.64999999999418,0.0,0.0,150683,10.01.2018 17:00:00,15423,-0.06647796966946727,-56.22,IS,0.09,0.0,Phase3-EA-B1v1-GBPJPY-M30-1,GBPJPYMT4,1414,1d 22h 29m,Sell
168137.05,135041,12.01.2018 17:59:58,tp 135.041,-1.59,-68.79000000000815,0.0,0.0,133751,10.01.2018 16:30:00,15424,-0.02664153529602884,102.86,IS,0.09,0.0,Phase3-EA-TR1v1-EURJPY-M30-91,EURJPYMT4,2728,2d 1h 29m,Buy
168183.52,1.17876,12.01.2018 20:34:58,tp 1.17876,0.0,-22.320000000006985,0.0,0.0,1.17986,12.01.2018 20:05:00,15425,-0.008644266140536115,46.47,IS,0.41,0.0,Phase3-EA-SA2v2-EURCHF-M5-43,EURCHFMT4,7860,29m 58s,Sell
168264.42,152233,15.01.2018 04:44:58,tp 152.233,0.0,-0.0,0.0,0.0,152623,15.01.2018 02:40:00,15426,-0.0,80.9,IS,0.23,0.0,Phase3-EA-S4v1-GBPJPY-M5-194,GBPJPYMT4,3350,2h 4m,Sell
168257.21,1.17986,15.01.2018 07:55:00,,-2.12,-7.209999999991851,0.0,0.0,1.17974,12.01.2018 23:35:00,15427,-0.0027917124627510866,-7.21,IS,0.41,0.0,Phase3-EA-SA2v2-EURCHF-M5-43,EURCHFMT4,7862,2d 8h 20m,Sell
168298.06,1.17956,15.01.2018 12:15:00,,0.0,-0.0,0.0,0.0,1.18072,15.01.2018 03:30:00,15428,-0.0,40.85,IS,0.34,0.0,Phase3-EA-S4v1-EURCHF-M15-221,EURCHFMT4,4002,8h 45m,Sell
168314.67,110551,15.01.2018 18:00:00,,0.0,-0.0,0.0,0.0,110619,15.01.2018 17:45:00,15429,-0.0,16.61,IS,0.27,0.0,Phase3-EA-S1v2-USDJPY-M15-0,USDJPYMT4,4436,15m 0s,Sell
168341.06,110512,15.01.2018 20:00:00,,0.0,-0.0,0.0,0.0,110.62,15.01.2018 18:45:00,15430,-0.0,26.39,IS,0.27,0.0,Phase3-EA-S1v2-USDJPY-M15-0,USDJPYMT4,4438,1h 15m,Sell
168387.9,1.18087,15.01.2018 20:39:57,tp 1.18087,0.0,-0.0,0.0,0.0,1.18197,15.01.2018 20:05:00,15431,-0.0,46.84,IS,0.41,0.0,Phase3-EA-SA2v2-EURCHF-M5-43,EURCHFMT4,7864,34m 57s,Sell
168412.69,135507,15.01.2018 22:30:00,,0.0,-0.0,0.0,0.0,135346,15.01.2018 10:30:00,15432,-0.0,24.79,IS,0.17,0.0,Phase3-EA-T1v2-EURJPY-M15-322,EURJPYMT4,3020,12h 0m,Buy
168458.51,1.18191,16.01.2018 00:54:58,tp 1.18191,-1.02,-0.0,0.0,0.0,1.18081,15.01.2018 23:55:00,15433,-0.0,45.82,IS,0.41,0.0,Phase3-EA-SA2v2-EURCHF-M5-43,EURCHFMT4,7866,59m 58s,Buy
168423.25,135459,16.01.2018 11:14:58,sl 135.459,0.0,-35.26000000000931,0.0,0.0,135689,16.01.2018 04:00:00,15434,-0.013642421756594168,-35.26,IS,0.17,0.0,Phase3-EA-T1v2-EURJPY-M15-322,EURJPYMT4,3022,7h 14m,Buy
168470.11,1.17859,16.01.2018 21:54:58,tp 1.17859,0.0,-0.0,0.0,0.0,1.17749,16.01.2018 20:05:00,15435,-0.0,46.86,IS,0.41,0.0,Phase3-EA-SA2v2-EURCHF-M5-43,EURCHFMT4,7868,1h 49m,Buy
168491.34,110629,16.01.2018 22:30:00,,0.0,-0.0,0.0,0.0,110716,16.01.2018 17:00:00,15436,-0.0,21.23,IS,0.27,0.0,Phase3-EA-S1v2-USDJPY-M15-0,USDJPYMT4,4440,5h 30m,Sell
168538.29,1.17809,16.01.2018 23:04:58,tp 1.17809,0.0,-0.0,0.0,0.0,1.17919,16.01.2018 22:35:00,15437,-0.0,46.95,IS,0.41,0.0,Phase3-EA-SA2v2-EURCHF-M5-43,EURCHFMT4,7870,29m 58s,Sell
168507.93,0.95925,17.01.2018 03:30:00,,-0.73,-30.35999999998603,0.0,0.0,0.95974,16.01.2018 23:15:00,15438,-0.011742941442053265,-30.36,IS,0.58,0.0,Phase3-EA-SA2v2-USDCHF-M15-107,USDCHFMT4,3046,4h 15m,Buy
168553.9,1.17763,17.01.2018 04:29:58,tp 1.17763,-1.03,-0.0,0.0,0.0,1.17653,16.01.2018 23:35:00,15439,-0.0,45.97,IS,0.41,0.0,Phase3-EA-SA2v2-EURCHF-M5-43,EURCHFMT4,7872,4h 54m,Buy
168518.42,135.59,17.01.2018 04:59:58,sl 135.590,0.0,-35.48000000001048,0.0,0.0,135.36,17.01.2018 03:00:00,15440,-0.013722477208818072,-35.48,IS,0.17,0.0,Phase3-EA-T1v2-EURJPY-M15-322,EURJPYMT4,3024,1h 59m,Sell
168598.96,152.55,17.01.2018 05:09:58,tp 152.550,-0.75,-0.0,0.0,0.0,152.16,16.01.2018 23:55:00,15441,-0.0,80.54,IS,0.23,0.0,Phase3-EA-S4v1-GBPJPY-M5-194,GBPJPYMT4,3352,5h 14m,Buy
168666.78,1.17834,17.01.2018 10:15:00,,0.0,-0.0,0.0,0.0,1.17642,17.01.2018 01:30:00,15442,-0.0,67.82,IS,0.34,0.0,Phase3-EA-S4v1-EURCHF-M15-221,EURCHFMT4,4004,8h 45m,Buy
168726.93,0.96429,18.01.2018 02:14:58,tp 0.96429,0.0,-0.0,0.0,0.0,0.96529,18.01.2018 02:00:00,15443,-0.0,60.15,IS,0.58,0.0,Phase3-EA-SA2v2-USDCHF-M15-107,USDCHFMT4,3048,14m 58s,Sell
168767.36,1.17551,18.01.2018 02:14:59,tp 1.17551,-6.4,-0.0,0.0,0.0,1.17661,17.01.2018 22:20:00,15444,-0.0,40.43,IS,0.41,0.0,Phase3-EA-SA2v2-EURCHF-M5-43,EURCHFMT4,7874,3h 54m,Sell
168791.05,153875,18.01.2018 04:25:00,,-3.6,-0.0,0.0,0.0,154007,17.01.2018 23:00:00,15445,-0.0,23.69,IS,0.23,0.0,Phase3-EA-S4v1-GBPJPY-M5-194,GBPJPYMT4,3354,5h 25m,Sell
168815.3,1.17626,18.01.2018 10:40:00,,0.0,-0.0,0.0,0.0,1.17569,18.01.2018 02:20:00,15446,-0.0,24.25,IS,0.41,0.0,Phase3-EA-SA2v2-EURCHF-M5-43,EURCHFMT4,7876,8h 20m,Buy
168963.52,154449,18.01.2018 15:59:58,tp 154.449,-1.45,-0.0,0.0,0.0,152599,15.01.2018 02:30:00,15447,-0.0,148.22,IS,0.09,0.0,Phase3-EA-B1v1-GBPJPY-M30-1,GBPJPYMT4,1416,3d 13h 29m,Buy
168955.7,135701,18.01.2018 21:00:00,,0.0,-7.820000000006985,0.0,0.0,135752,18.01.2018 04:30:00,15448,-0.0030197303465781355,-7.82,IS,0.17,0.0,Phase3-EA-T1v2-EURJPY-M15-322,EURJPYMT4,3026,16h 30m,Buy
168960.45,110998,19.01.2018 04:15:00,,-1.09,-3.070000000006985,0.0,0.0,111022,18.01.2018 22:15:00,15449,-0.0011854951616378118,4.75,IS,0.27,0.0,Phase3-EA-S1v2-USDJPY-M15-0,USDJPYMT4,4442,6h 0m,Sell
168968.4,1.17373,19.01.2018 04:40:00,,-1.03,-0.0,0.0,0.0,1.17352,18.01.2018 20:20:00,15450,-0.0,7.95,IS,0.41,0.0,Phase3-EA-SA2v2-EURCHF-M5-43,EURCHFMT4,7878,8h 20m,Buy
168975.86,1.17332,19.01.2018 11:00:00,,0.0,-0.0,0.0,0.0,1.17311,19.01.2018 02:15:00,15451,-0.0,7.46,IS,0.34,0.0,Phase3-EA-S4v1-EURCHF-M15-221,EURCHFMT4,4006,8h 45m,Buy
168940.78,153655,22.01.2018 04:40:00,,-1.21,-35.079999999987194,0.0,0.0,153492,19.01.2018 23:15:00,15452,-0.01354566406304703,-35.08,IS,0.23,0.0,Phase3-EA-S4v1-GBPJPY-M5-194,GBPJPYMT4,3356,2d 5h 25m,Sell
168881.18,1.17791,22.01.2018 05:30:00,,-2.13,-94.67999999999302,0.0,0.0,1.17656,19.01.2018 21:10:00,15453,-0.03655939206070885,-59.6,IS,0.41,0.0,Phase3-EA-SA2v2-EURCHF-M5-43,EURCHFMT4,7880,2d 8h 20m,Sell
168946.89,1.17575,22.01.2018 11:00:00,,0.0,-28.970000000001164,0.0,0.0,1.17761,22.01.2018 02:15:00,15454,-0.011186370806916519,65.71,IS,0.34,0.0,Phase3-EA-S4v1-EURCHF-M15-221,EURCHFMT4,4008,8h 45m,Sell
168892.0,153845,22.01.2018 11:29:58,sl 153.845,-0.47,-83.86000000001513,0.0,0.0,153175,19.01.2018 20:00:00,15455,-0.032381396474565095,-54.89,IS,0.09,0.0,Phase3-EA-B1v1-GBPJPY-M30-1,GBPJPYMT4,1418,2d 15h 29m,Sell
168856.72,135586,22.01.2018 11:44:57,sl 135.586,0.0,-119.14000000001397,0.0,0.0,135356,22.01.2018 08:15:00,15456,-0.04600428781277655,-35.28,IS,0.17,0.0,Phase3-EA-T1v2-EURJPY-M15-322,EURJPYMT4,3028,3h 29m,Sell
169117.6,1.39452,22.01.2018 19:29:58,tp 1.39452,-3.72,-0.0,0.0,0.0,1.37562,15.01.2018 13:30:00,15457,-0.0,260.88,IS,0.14,0.0,Phase3-EA-B1v1-GBPUSD-M30-14,GBPUSDMT4,1006,7d 5h 59m,Buy
169114.47,0.96207,23.01.2018 04:00:00,,-0.72,-3.1300000000046566,0.0,0.0,0.96211,22.01.2018 23:45:00,15458,-0.0012079457358375651,-3.13,IS,0.58,0.0,Phase3-EA-SA2v2-USDCHF-M15-107,USDCHFMT4,3050,4h 15m,Buy
169006.65,1.17929,23.01.2018 04:20:00,,-2.13,-110.95000000001164,0.0,0.0,1.17681,22.01.2018 20:00:00,15459,-0.0428183959715631,-107.82,IS,0.41,0.0,Phase3-EA-SA2v2-EURCHF-M5-43,EURCHFMT4,7882,8h 20m,Sell
169014.92,110984,23.01.2018 06:00:00,,0.0,-102.68000000002212,0.0,0.0,110.95,23.01.2018 00:45:00,15460,-0.03962679493790523,8.27,IS,0.27,0.0,Phase3-EA-S1v2-USDJPY-M15-0,USDJPYMT4,4444,5h 15m,Buy
168972.92,1.39589,23.01.2018 12:29:58,sl 1.39589,0.0,-144.68000000002212,0.0,0.0,1.39889,23.01.2018 10:30:00,15461,-0.05583565145710723,-42.0,IS,0.14,0.0,Phase3-EA-B1v1-GBPUSD-M30-14,GBPUSDMT4,1008,1h 59m,Buy
168937.71,135804,23.01.2018 12:29:58,sl 135.804,0.0,-179.89000000001397,0.0,0.0,136034,23.01.2018 11:15:00,15462,-0.06942407617236843,-35.21,IS,0.17,0.0,Phase3-EA-T1v2-EURJPY-M15-322,EURJPYMT4,3030,1h 14m,Buy
168984.78,1.17697,23.01.2018 21:34:57,tp 1.17697,0.0,-132.82000000000698,0.0,0.0,1.17807,23.01.2018 20:35:00,15463,-0.05125857911620292,47.07,IS,0.41,0.0,Phase3-EA-SA2v2-EURCHF-M5-43,EURCHFMT4,7884,59m 57s,Sell
168997.75,110301,23.01.2018 23:30:00,,0.0,-119.85000000000582,0.0,0.0,110354,23.01.2018 20:30:00,15464,-0.046253129853010805,12.97,IS,0.27,0.0,Phase3-EA-S1v2-USDJPY-M15-0,USDJPYMT4,4446,3h 0m,Sell
168858.43,1.17336,24.01.2018 14:29:58,sl 1.17336,0.0,-259.1700000000128,0.0,0.0,1.17726,24.01.2018 05:45:00,15465,-0.10002022247813784,-139.32,IS,0.34,0.0,Phase3-EA-S4v1-EURCHF-M15-221,EURCHFMT4,4010,8h 44m,Buy
169122.5,1.41823,24.01.2018 17:29:58,tp 1.41823,-0.53,-0.0,0.0,0.0,1.39933,23.01.2018 19:00:00,15466,-0.0,264.07,IS,0.14,0.0,Phase3-EA-B1v1-GBPUSD-M30-14,GBPUSDMT4,1010,22h 29m,Buy
169163.76,1.17182,25.01.2018 01:59:59,tp 1.17182,-6.51,-0.0,0.0,0.0,1.17292,24.01.2018 22:25:00,15467,-0.0,41.26,IS,0.41,0.0,Phase3-EA-SA2v2-EURCHF-M5-43,EURCHFMT4,7886,3h 34m,Sell
169167.22,109138,25.01.2018 06:45:00,,0.0,-0.0,0.0,0.0,109152,25.01.2018 00:45:00,15468,-0.0,3.46,IS,0.27,0.0,Phase3-EA-S1v2-USDJPY-M15-0,USDJPYMT4,4448,6h 0m,Sell
169089.75,155806,25.01.2018 07:35:00,,0.0,-77.47000000000116,0.0,0.0,155439,25.01.2018 02:10:00,15469,-0.02989189759414818,-77.47,IS,0.23,0.0,Phase3-EA-S4v1-GBPJPY-M5-194,GBPJPYMT4,3358,5h 25m,Sell
169026.98,1.17123,25.01.2018 10:25:00,,0.0,-140.2399999999907,0.0,0.0,1.17267,25.01.2018 02:05:00,15470,-0.054111781574841866,-62.77,IS,0.41,0.0,Phase3-EA-SA2v2-EURCHF-M5-43,EURCHFMT4,7888,8h 20m,Buy
168988.88,135955,25.01.2018 17:59:57,sl 135.955,-2.18,-178.3399999999965,0.0,0.0,135725,23.01.2018 12:30:00,15471,-0.06881271481786758,-38.1,IS,0.17,0.0,Phase3-EA-T1v2-EURJPY-M15-322,EURJPYMT4,3032,2d 5h 29m,Sell
169140.04,156033,25.01.2018 18:59:57,tp 156.033,-1.47,-27.179999999993015,0.0,0.0,154183,22.01.2018 18:00:00,15472,-0.01048743741588649,151.16,IS,0.09,0.0,Phase3-EA-B1v1-GBPJPY-M30-1,GBPJPYMT4,1420,3d 0h 59m,Buy
169104.06,135674,25.01.2018 22:14:57,sl 135.674,0.0,-63.16000000000349,0.0,0.0,135904,25.01.2018 18:00:00,15473,-0.0243703659745253,-35.98,IS,0.17,0.0,Phase3-EA-T1v2-EURJPY-M15-322,EURJPYMT4,3034,4h 14m,Buy
169186.37,155003,25.01.2018 23:09:58,tp 155.003,0.0,-0.0,0.0,0.0,154613,25.01.2018 23:05:00,15474,-0.0,82.31,IS,0.23,0.0,Phase3-EA-S4v1-GBPJPY-M5-194,GBPJPYMT4,3360,4m 58s,Buy
169178.59,135626,26.01.2018 01:30:00,,0.0,-7.779999999998836,0.0,0.0,135676,26.01.2018 00:30:00,15475,-0.0030017010539554185,-7.78,IS,0.17,0.0,Phase3-EA-T1v2-EURJPY-M15-322,EURJPYMT4,3036,1h 0m,Buy
169226.49,1.16742,26.01.2018 04:04:58,tp 1.16742,0.0,-0.0,0.0,0.0,1.16632,26.01.2018 02:10:00,15476,-0.0,47.9,IS,0.41,0.0,Phase3-EA-SA2v2-EURCHF-M5-43,EURCHFMT4,7890,1h 54m,Buy
169204.02,135756,26.01.2018 12:45:00,,0.0,-22.470000000001164,0.0,0.0,135.9,26.01.2018 04:00:00,15477,-0.00866809561013654,-22.47,IS,0.17,0.0,Phase3-EA-T1v2-EURJPY-M15-322,EURJPYMT4,3038,8h 45m,Buy
169138.65,134572,26.01.2018 20:59:57,sl 134.572,-5.6,-87.83999999999651,0.0,0.0,135292,12.01.2018 18:30:00,15478,-0.033885425829742945,-65.37,IS,0.09,0.0,Phase3-EA-TR1v1-EURJPY-M30-91,EURJPYMT4,2730,14d 2h 29m,Buy
169186.94,1.16098,26.01.2018 21:04:58,tp 1.16098,0.0,-39.54999999998836,0.0,0.0,1.15988,26.01.2018 20:40:00,15479,-0.015256928410359657,48.29,IS,0.41,0.0,Phase3-EA-SA2v2-EURCHF-M5-43,EURCHFMT4,7892,24m 58s,Buy
169249.02,0.93428,26.01.2018 23:29:58,tp 0.93428,0.0,-0.0,0.0,0.0,0.93328,26.01.2018 23:15:00,15480,-0.0,62.08,IS,0.58,0.0,Phase3-EA-SA2v2-USDCHF-M15-107,USDCHFMT4,3052,14m 58s,Buy
169330.4,153834,29.01.2018 02:00:00,tp 153.834,-1.23,-0.0,0.0,0.0,154224,26.01.2018 23:30:00,15481,-0.0,81.38,IS,0.23,0.0,Phase3-EA-S4v1-GBPJPY-M5-194,GBPJPYMT4,3362,2d 2h 30m,Sell
169378.68,1.16024,29.01.2018 03:04:57,tp 1.16024,0.0,-0.0,0.0,0.0,1.15914,29.01.2018 02:35:00,15482,-0.0,48.28,IS,0.41,0.0,Phase3-EA-SA2v2-EURCHF-M5-43,EURCHFMT4,7894,29m 57s,Buy
169440.69,0.93526,29.01.2018 05:14:58,tp 0.93526,0.0,-0.0,0.0,0.0,0.93426,29.01.2018 02:15:00,15483,-0.0,62.01,IS,0.58,0.0,Phase3-EA-SA2v2-USDCHF-M15-107,USDCHFMT4,3054,2h 59m,Buy
169458.7,108689,29.01.2018 14:15:00,,-1.12,-0.0,0.0,0.0,108766,26.01.2018 23:30:00,15484,-0.0,18.01,IS,0.27,0.0,Phase3-EA-S1v2-USDJPY-M15-0,USDJPYMT4,4450,2d 14h 45m,Sell
169499.75,1.16046,29.01.2018 15:30:00,,0.0,-0.0,0.0,0.0,1.16159,29.01.2018 06:45:00,15485,-0.0,41.05,IS,0.34,0.0,Phase3-EA-S4v1-EURCHF-M15-221,EURCHFMT4,4012,8h 45m,Sell
169401.36,1.16017,30.01.2018 04:40:00,,-2.19,-98.39000000001397,0.0,0.0,1.15797,29.01.2018 20:20:00,15486,-0.037915258107190236,-98.39,IS,0.41,0.0,Phase3-EA-SA2v2-EURCHF-M5-43,EURCHFMT4,7896,8h 20m,Sell
169431.82,109.04,30.01.2018 04:45:00,,0.0,-67.93000000002212,0.0,0.0,108917,30.01.2018 00:45:00,15487,-0.026177289188148246,30.46,IS,0.27,0.0,Phase3-EA-S1v2-USDJPY-M15-0,USDJPYMT4,4452,4h 0m,Buy
169396.0,134981,30.01.2018 06:59:57,sl 134.981,0.0,-103.7500000000291,0.0,0.0,134751,30.01.2018 05:15:00,15488,-0.03998077069439508,-35.82,IS,0.17,0.0,Phase3-EA-T1v2-EURJPY-M15-322,EURJPYMT4,3040,1h 44m,Sell
169428.62,1.15981,30.01.2018 10:00:00,,0.0,-71.13000000003376,0.0,0.0,1.16071,30.01.2018 01:15:00,15489,-0.02741043103125662,32.62,IS,0.34,0.0,Phase3-EA-S4v1-EURCHF-M15-221,EURCHFMT4,4014,8h 45m,Sell
169475.8,1.15968,31.01.2018 03:49:58,tp 1.15968,-1.05,-23.950000000040745,0.0,0.0,1.15858,30.01.2018 22:40:00,15490,-0.009229295981996363,47.18,IS,0.41,0.0,Phase3-EA-SA2v2-EURCHF-M5-43,EURCHFMT4,7898,5h 9m,Buy
169484.98,108826,31.01.2018 04:15:00,,0.0,-14.77000000004773,0.0,0.0,108789,31.01.2018 01:30:00,15491,-0.005691720319594776,9.18,IS,0.27,0.0,Phase3-EA-S1v2-USDJPY-M15-0,USDJPYMT4,4454,2h 45m,Buy
169518.9,1.15946,31.01.2018 11:15:00,,0.0,-0.0,0.0,0.0,1.15853,31.01.2018 02:30:00,15492,-0.0,33.92,IS,0.34,0.0,Phase3-EA-S4v1-EURCHF-M15-221,EURCHFMT4,4016,8h 45m,Buy
169501.61,109313,31.01.2018 23:30:00,,0.0,-17.29000000000815,0.0,0.0,109383,31.01.2018 23:15:00,15493,-0.006662327868994533,-17.29,IS,0.27,0.0,Phase3-EA-S1v2-USDJPY-M15-0,USDJPYMT4,4456,15m 0s,Buy
169579.52,135543,01.02.2018 01:00:00,,-2.29,-0.0,0.0,0.0,135028,31.01.2018 04:15:00,15494,-0.0,77.91,IS,0.17,0.0,Phase3-EA-T1v2-EURJPY-M15-322,EURJPYMT4,3042,20h 45m,Buy
169516.88,0.93142,01.02.2018 03:30:00,,-2.24,-62.64000000001397,0.0,0.0,0.93239,31.01.2018 23:15:00,15495,-0.02413133362755799,-62.64,IS,0.58,0.0,Phase3-EA-SA2v2-USDCHF-M15-107,USDCHFMT4,3056,4h 15m,Buy
169422.97,1.15655,01.02.2018 04:25:00,,-3.17,-156.55000000001746,0.0,0.0,1.15861,31.01.2018 20:05:00,15496,-0.060309072148687456,-93.91,IS,0.41,0.0,Phase3-EA-SA2v2-EURCHF-M5-43,EURCHFMT4,7900,8h 20m,Buy
169469.99,155062,01.02.2018 04:40:00,,-2.28,-109.53000000002794,0.0,0.0,154828,31.01.2018 23:15:00,15497,-0.0421951623918664,47.02,IS,0.23,0.0,Phase3-EA-S4v1-GBPJPY-M5-194,GBPJPYMT4,3364,5h 25m,Buy
169524.33,109315,01.02.2018 05:15:00,,0.0,-55.19000000003143,0.0,0.0,109095,01.02.2018 00:15:00,15498,-0.021261307517646662,54.34,IS,0.27,0.0,Phase3-EA-S1v2-USDJPY-M15-0,USDJPYMT4,4458,5h 0m,Buy
169567.04,1.15682,01.02.2018 10:00:00,,0.0,-12.480000000039581,0.0,0.0,1.15565,01.02.2018 01:15:00,15499,-0.004807775282133009,42.71,IS,0.34,0.0,Phase3-EA-S4v1-EURCHF-M15-221,EURCHFMT4,4018,8h 45m,Buy
169829.51,1.42616,01.02.2018 12:29:57,tp 1.42616,-2.13,-0.0,0.0,0.0,1.40726,30.01.2018 14:00:00,15500,-0.0,262.47,IS,0.14,0.0,Phase3-EA-B1v1-GBPUSD-M30-14,GBPUSDMT4,1012,1d 22h 29m,Buy
169875.96,1158,02.02.2018 02:04:58,tp 1.15800,-2.21,-0.0,0.0,0.0,1.1591,01.02.2018 21:30:00,15501,-0.0,46.45,IS,0.41,0.0,Phase3-EA-SA2v2-EURCHF-M5-43,EURCHFMT4,7902,4h 34m,Sell
169860.2,109532,02.02.2018 05:15:00,,-0.72,-15.760000000009313,0.0,0.0,109593,01.02.2018 17:00:00,15502,-0.006064431661939499,-15.76,IS,0.27,0.0,Phase3-EA-S1v2-USDJPY-M15-0,USDJPYMT4,4460,12h 15m,Buy
169962.01,137256,02.02.2018 11:59:58,tp 137.256,-1.61,-0.0,0.0,0.0,135996,31.01.2018 20:00:00,15503,-0.0,101.81,IS,0.09,0.0,Phase3-EA-TR1v1-EURJPY-M30-91,EURJPYMT4,2732,1d 15h 59m,Buy
170224.3,137443,02.02.2018 17:44:58,tp 137.443,-0.76,-0.0,0.0,0.0,135743,01.02.2018 05:30:00,15504,-0.0,262.29,IS,0.17,0.0,Phase3-EA-T1v2-EURJPY-M15-322,EURJPYMT4,3044,1d 12h 14m,Buy
170272.72,1.15928,02.02.2018 21:29:57,tp 1.15928,0.0,-0.0,0.0,0.0,1.16038,02.02.2018 21:15:00,15505,-0.0,48.42,IS,0.41,0.0,Phase3-EA-SA2v2-EURCHF-M5-43,EURCHFMT4,7904,14m 57s,Sell
170306.17,155.31,05.02.2018 08:45:00,,0.0,-0.0,0.0,0.0,155.15,05.02.2018 03:20:00,15506,-0.0,33.45,IS,0.23,0.0,Phase3-EA-S4v1-GBPJPY-M5-194,GBPJPYMT4,3366,5h 25m,Buy
170276.26,110.04,05.02.2018 09:30:00,,-0.71,-29.910000000003492,0.0,0.0,110159,02.02.2018 21:30:00,15507,-0.011490315423565768,-29.91,IS,0.27,0.0,Phase3-EA-S1v2-USDJPY-M15-0,USDJPYMT4,4462,2d 12h 0m,Buy
170216.9,136622,05.02.2018 12:29:57,sl 136.622,-0.4,-89.26999999998952,0.0,0.0,137342,02.02.2018 12:30:00,15508,-0.034294231289250285,-59.36,IS,0.09,0.0,Phase3-EA-TR1v1-EURJPY-M30-91,EURJPYMT4,2734,2d 23h 59m,Buy
170265.06,1.16242,05.02.2018 21:24:58,tp 1.16242,0.0,-41.10999999998603,0.0,0.0,1.16352,05.02.2018 20:35:00,15509,-0.015792941058594887,48.16,IS,0.41,0.0,Phase3-EA-SA2v2-EURCHF-M5-43,EURCHFMT4,7906,49m 58s,Sell
170278.34,109788,05.02.2018 22:45:00,,0.0,-27.829999999987194,0.0,0.0,109842,05.02.2018 18:00:00,15510,-0.010691256377052854,13.28,IS,0.27,0.0,Phase3-EA-S1v2-USDJPY-M15-0,USDJPYMT4,4464,4h 45m,Sell
170110.11,152721,06.02.2018 00:59:58,sl 152.721,0.0,-196.05999999999767,0.0,0.0,153521,06.02.2018 00:15:00,15511,-0.07531899839331377,-168.23,IS,0.23,0.0,Phase3-EA-S4v1-GBPJPY-M5-194,GBPJPYMT4,3368,44m 58s,Buy
169894.26,1.15764,06.02.2018 00:59:58,sl 1.15764,-1.05,-411.9100000000035,0.0,0.0,1.16254,05.02.2018 22:25:00,15512,-0.1582405826185377,-215.85,IS,0.41,0.0,Phase3-EA-SA2v2-EURCHF-M5-43,EURCHFMT4,7908,2h 34m,Buy
170158.1,135271,06.02.2018 01:14:58,tp 135.271,-0.54,-148.07000000000698,0.0,0.0,136971,05.02.2018 10:30:00,15513,-0.05688301587319508,263.84,IS,0.17,0.0,Phase3-EA-T1v2-EURJPY-M15-322,EURJPYMT4,3046,14h 44m,Sell
169951.93,109074,06.02.2018 01:14:58,sl 109.074,-0.71,-354.2400000000198,0.0,0.0,109904,05.02.2018 23:00:00,15514,-0.13608590222814074,-206.17,IS,0.27,0.0,Phase3-EA-S1v2-USDJPY-M15-0,USDJPYMT4,4466,2h 14m,Buy
169736.09,1.15211,06.02.2018 01:44:58,sl 1.15211,0.0,-570.0800000000163,0.0,0.0,1.15701,06.02.2018 01:15:00,15515,-0.21900364482332985,-215.84,IS,0.41,0.0,Phase3-EA-SA2v2-EURCHF-M5-43,EURCHFMT4,7910,29m 58s,Buy
169887.96,152347,06.02.2018 01:59:58,tp 152.347,-0.48,-418.21000000002095,0.0,0.0,154197,05.02.2018 16:00:00,15516,-0.16066080953825207,151.87,IS,0.09,0.0,Phase3-EA-B1v1-GBPJPY-M30-1,GBPJPYMT4,1422,9h 59m,Sell
169936.39,1.1536,06.02.2018 02:24:58,tp 1.15360,0.0,-369.78000000002794,0.0,0.0,1.1525,06.02.2018 01:45:00,15517,-0.14205579529675608,48.43,IS,0.41,0.0,Phase3-EA-SA2v2-EURCHF-M5-43,EURCHFMT4,7912,39m 58s,Buy
170040.95,134104,06.02.2018 08:59:58,tp 134.104,0.0,-265.22000000003027,0.0,0.0,135364,06.02.2018 01:30:00,15518,-0.10188771168967252,104.56,IS,0.09,0.0,Phase3-EA-TR1v1-EURJPY-M30-91,EURJPYMT4,2736,7h 29m,Sell
169985.54,152285,06.02.2018 10:59:58,sl 152.285,0.0,-320.63000000003376,0.0,0.0,151615,06.02.2018 06:00:00,15519,-0.12317418369300735,-55.41,IS,0.09,0.0,Phase3-EA-B1v1-GBPJPY-M30-1,GBPJPYMT4,1424,4h 59m,Sell
169926.02,134974,06.02.2018 11:29:58,sl 134.974,0.0,-380.1500000000233,0.0,0.0,134254,06.02.2018 09:00:00,15520,-0.1460395656391937,-59.52,IS,0.09,0.0,Phase3-EA-TR1v1-EURJPY-M30-91,EURJPYMT4,2738,2h 29m,Sell
170071.82,1.15772,06.02.2018 11:29:58,tp 1.15772,0.0,-234.35000000003492,0.0,0.0,1.15372,06.02.2018 02:45:00,15521,-0.0900285997831068,145.8,IS,0.34,0.0,Phase3-EA-S4v1-EURCHF-M15-221,EURCHFMT4,4020,8h 44m,Buy
170036.07,135324,06.02.2018 22:14:57,sl 135.324,0.0,-270.1000000000349,0.0,0.0,135554,06.02.2018 21:45:00,15522,-0.10376242714493991,-35.75,IS,0.17,0.0,Phase3-EA-T1v2-EURJPY-M15-322,EURJPYMT4,3048,29m 57s,Buy
170104.65,109476,07.02.2018 00:30:00,,-0.72,-201.52000000004773,0.0,0.0,109195,06.02.2018 20:45:00,15523,-0.07741652839041296,68.58,IS,0.27,0.0,Phase3-EA-S1v2-USDJPY-M15-0,USDJPYMT4,4468,3h 45m,Buy
170062.12,1.39449,07.02.2018 00:59:58,sl 1.39449,-0.53,-244.05000000004657,0.0,0.0,1.39749,06.02.2018 22:30:00,15524,-0.09375498091345481,-42.53,IS,0.14,0.0,Phase3-EA-B1v1-GBPUSD-M30-14,GBPUSDMT4,1014,2h 29m,Buy
170108.12,1.15808,07.02.2018 02:04:57,tp 1.15808,-2.19,-198.05000000004657,0.0,0.0,1.15918,06.02.2018 20:35:00,15525,-0.07608348276955766,46.0,IS,0.41,0.0,Phase3-EA-SA2v2-EURCHF-M5-43,EURCHFMT4,7914,5h 29m,Sell
170156.3,1.1591,07.02.2018 02:24:57,tp 1.15910,0.0,-149.87000000005355,0.0,0.0,1158,07.02.2018 02:05:00,15526,-0.05757450927884373,48.18,IS,0.41,0.0,Phase3-EA-SA2v2-EURCHF-M5-43,EURCHFMT4,7916,19m 57s,Buy
170238.26,152684,07.02.2018 04:19:58,tp 152.684,0.0,-67.9100000000617,0.0,0.0,153074,07.02.2018 03:05:00,15527,-0.026088509542459684,81.96,IS,0.23,0.0,Phase3-EA-S4v1-GBPJPY-M5-194,GBPJPYMT4,3370,1h 14m,Sell
170173.57,134368,07.02.2018 19:59:58,sl 134.368,-0.4,-132.60000000006403,0.0,0.0,135148,06.02.2018 11:30:00,15528,-0.05094001421482376,-64.69,IS,0.09,0.0,Phase3-EA-TR1v1-EURJPY-M30-91,EURJPYMT4,2740,1d 8h 29m,Buy
170102.6,1157,08.02.2018 04:50:00,,-3.13,-203.5700000000652,0.0,0.0,1.15856,07.02.2018 20:30:00,15529,-0.07820406254683247,-70.97,IS,0.41,0.0,Phase3-EA-SA2v2-EURCHF-M5-43,EURCHFMT4,7918,8h 20m,Buy
170145.29,151888,08.02.2018 07:20:00,,0.0,-160.88000000006286,0.0,0.0,151685,08.02.2018 01:55:00,15530,-0.06180414394328877,42.69,IS,0.23,0.0,Phase3-EA-S4v1-GBPJPY-M5-194,GBPJPYMT4,3372,5h 25m,Buy
170202.21,1.15776,08.02.2018 12:00:00,,0.0,-103.96000000005006,0.0,0.0,1.15618,08.02.2018 03:15:00,15531,-0.03993758580522678,56.92,IS,0.34,0.0,Phase3-EA-S4v1-EURCHF-M15-221,EURCHFMT4,4022,8h 45m,Buy
170166.54,134422,08.02.2018 17:29:57,sl 134.422,0.0,-139.63000000006286,0.0,0.0,134192,08.02.2018 13:30:00,15532,-0.05364068012681455,-35.67,IS,0.17,0.0,Phase3-EA-T1v2-EURJPY-M15-322,EURJPYMT4,3050,3h 59m,Sell
170130.81,134276,08.02.2018 18:59:57,sl 134.276,0.0,-175.36000000007334,0.0,0.0,134506,08.02.2018 18:15:00,15533,-0.06736682422858911,-35.73,IS,0.17,0.0,Phase3-EA-T1v2-EURJPY-M15-322,EURJPYMT4,3052,44m 57s,Buy
170233.71,133366,08.02.2018 20:29:58,tp 133.366,-0.86,-72.46000000007916,0.0,0.0,134626,07.02.2018 15:00:00,15534,-0.027836451206699697,102.9,IS,0.09,0.0,Phase3-EA-TR1v1-EURJPY-M30-91,EURJPYMT4,2741,1d 5h 29m,Sell
170019.56,1.14668,08.02.2018 20:29:58,sl 1.14668,0.0,-286.61000000007334,0.0,0.0,1.15158,08.02.2018 20:00:00,15535,-0.11010495832660123,-214.15,IS,0.41,0.0,Phase3-EA-SA2v2-EURCHF-M5-43,EURCHFMT4,7920,29m 58s,Buy
170067.7,1.14843,08.02.2018 20:34:58,tp 1.14843,0.0,-238.47000000005937,0.0,0.0,1.14733,08.02.2018 20:30:00,15536,-0.09161135135600437,48.14,IS,0.41,0.0,Phase3-EA-SA2v2-EURCHF-M5-43,EURCHFMT4,7922,4m 58s,Buy
170115.86,1.14767,09.02.2018 04:24:57,tp 1.14767,0.0,-190.31000000005588,0.0,0.0,1.14657,09.02.2018 01:05:00,15537,-0.07311006112534899,48.16,IS,0.41,0.0,Phase3-EA-SA2v2-EURCHF-M5-43,EURCHFMT4,7924,3h 19m,Buy
170210.54,1.14917,09.02.2018 10:30:00,,0.0,-95.63000000006286,0.0,0.0,1.14656,09.02.2018 01:45:00,15538,-0.0367375079891738,94.68,IS,0.34,0.0,Phase3-EA-S4v1-EURCHF-M15-221,EURCHFMT4,4024,8h 45m,Buy
170258.52,1.15056,09.02.2018 20:09:59,tp 1.15056,0.0,-47.65000000005239,0.0,0.0,1.15166,09.02.2018 20:00:00,15539,-0.018305367099078797,47.98,IS,0.41,0.0,Phase3-EA-SA2v2-EURCHF-M5-43,EURCHFMT4,7926,9m 59s,Sell
170193.98,132817,09.02.2018 20:29:58,sl 132.817,0.0,-112.19000000006054,0.0,0.0,133597,09.02.2018 07:30:00,15540,-0.04309924732097588,-64.54,IS,0.09,0.0,Phase3-EA-TR1v1-EURJPY-M30-91,EURJPYMT4,2744,12h 59m,Buy
170459.85,132496,09.02.2018 21:14:58,tp 132.496,-0.55,-0.0,0.0,0.0,134196,08.02.2018 19:45:00,15541,-0.0,265.87,IS,0.17,0.0,Phase3-EA-T1v2-EURJPY-M15-322,EURJPYMT4,3054,1d 1h 29m,Sell
170507.89,1.1487,09.02.2018 23:09:58,tp 1.14870,0.0,-0.0,0.0,0.0,1.1476,09.02.2018 21:20:00,15542,-0.0,48.04,IS,0.41,0.0,Phase3-EA-SA2v2-EURCHF-M5-43,EURCHFMT4,7928,1h 49m,Buy
170412.64,1.15262,12.02.2018 10:35:00,,0.0,-95.25,0.0,0.0,1.15044,12.02.2018 02:15:00,15543,-0.03656319200159331,-95.25,IS,0.41,0.0,Phase3-EA-SA2v2-EURCHF-M5-43,EURCHFMT4,7930,8h 20m,Sell
170368.1,1.15201,12.02.2018 12:00:00,,0.0,-139.79000000000815,0.0,0.0,1.15078,12.02.2018 03:15:00,15544,-0.05366056283362758,-44.54,IS,0.34,0.0,Phase3-EA-S4v1-EURCHF-M15-221,EURCHFMT4,4026,8h 45m,Sell
170429.11,0.93929,13.02.2018 01:14:58,tp 0.93929,-0.74,-78.77999999999884,0.0,0.0,0.93829,12.02.2018 22:45:00,15545,-0.03024092667596303,61.01,IS,0.58,0.0,Phase3-EA-SA2v2-USDCHF-M15-107,USDCHFMT4,3058,2h 29m,Buy
170370.14,1.15376,13.02.2018 04:25:00,,-2.18,-137.75,0.0,0.0,1.15246,12.02.2018 20:05:00,15546,-0.052877477146661196,-58.97,IS,0.41,0.0,Phase3-EA-SA2v2-EURCHF-M5-43,EURCHFMT4,7932,8h 20m,Sell
170431.95,0.9384,13.02.2018 04:29:58,tp 0.93840,0.0,-75.94000000000233,0.0,0.0,0.9394,13.02.2018 01:15:00,15547,-0.02915074856274101,61.81,IS,0.58,0.0,Phase3-EA-SA2v2-USDCHF-M15-107,USDCHFMT4,3060,3h 14m,Sell
170514.59,150177,13.02.2018 08:19:57,tp 150.177,0.0,-0.0,0.0,0.0,150567,13.02.2018 03:35:00,15548,-0.0,82.64,IS,0.23,0.0,Phase3-EA-S4v1-GBPJPY-M5-194,GBPJPYMT4,3374,4h 44m,Sell
170529.83,1.15395,13.02.2018 10:15:00,,0.0,-0.0,0.0,0.0,1.15437,13.02.2018 01:30:00,15549,-0.0,15.24,IS,0.34,0.0,Phase3-EA-S4v1-EURCHF-M15-221,EURCHFMT4,4028,8h 45m,Sell
170562.21,107567,13.02.2018 19:45:00,,0.0,-0.0,0.0,0.0,107696,13.02.2018 17:15:00,15550,-0.0,32.38,IS,0.27,0.0,Phase3-EA-S1v2-USDJPY-M15-0,USDJPYMT4,4470,2h 30m,Sell
170610.46,1.15349,14.02.2018 02:04:57,tp 1.15349,0.0,-0.0,0.0,0.0,1.15459,14.02.2018 00:05:00,15551,-0.0,48.25,IS,0.41,0.0,Phase3-EA-SA2v2-EURCHF-M5-43,EURCHFMT4,7934,1h 59m,Sell
170550.06,133283,14.02.2018 04:59:57,sl 133.283,-0.29,-60.39999999999418,0.0,0.0,133462,13.02.2018 08:00:00,15552,-0.023176352936867484,-60.4,IS,0.09,0.0,Phase3-EA-TR1v1-EURJPY-M30-91,EURJPYMT4,2746,20h 59m,Sell
170565.65,149583,14.02.2018 06:10:00,,0.0,-44.80999999999767,0.0,0.0,149656,14.02.2018 00:45:00,15553,-0.017194244620878776,15.59,IS,0.23,0.0,Phase3-EA-S4v1-GBPJPY-M5-194,GBPJPYMT4,3376,5h 25m,Sell
170579.14,1.15465,14.02.2018 10:00:00,,0.0,-31.320000000006985,0.0,0.0,1.15502,14.02.2018 01:15:00,15554,-0.012017936655346381,13.49,IS,0.34,0.0,Phase3-EA-S4v1-EURCHF-M15-221,EURCHFMT4,4030,8h 45m,Sell
170537.14,1.38857,14.02.2018 12:29:58,sl 1.38857,0.0,-73.32000000000698,0.0,0.0,1.39157,14.02.2018 07:00:00,15555,-0.028133943664427973,-42.0,IS,0.14,0.0,Phase3-EA-B1v1-GBPUSD-M30-14,GBPUSDMT4,1016,5h 29m,Buy
170644.81,132172,14.02.2018 17:59:58,tp 132.172,-0.29,-0.0,0.0,0.0,132563,13.02.2018 14:00:00,15556,-0.0,107.67,IS,0.09,0.0,Phase3-EA-TR1v1-EURJPY-M30-91,EURJPYMT4,2747,1d 3h 59m,Sell
170707.24,0.9291,15.02.2018 00:59:58,tp 0.92910,0.0,-0.0,0.0,0.0,0.9301,15.02.2018 00:30:00,15557,-0.0,62.43,IS,0.58,0.0,Phase3-EA-SA2v2-USDCHF-M15-107,USDCHFMT4,3062,29m 58s,Sell
170733.66,106.84,15.02.2018 03:15:00,,-3.4,-0.0,0.0,0.0,106958,14.02.2018 23:30:00,15558,-0.0,26.42,IS,0.27,0.0,Phase3-EA-S1v2-USDJPY-M15-0,USDJPYMT4,4472,3h 45m,Sell
170661.24,1.15647,15.02.2018 05:10:00,,-6.61,-72.4200000000128,0.0,0.0,1.15498,14.02.2018 20:50:00,15559,-0.027775470186707927,-72.42,IS,0.41,0.0,Phase3-EA-SA2v2-EURCHF-M5-43,EURCHFMT4,7936,8h 20m,Sell
170538.05,0.9275,15.02.2018 05:30:00,,0.0,-195.61000000001513,0.0,0.0,0.92947,15.02.2018 01:15:00,15560,-0.07502291802294114,-123.19,IS,0.58,0.0,Phase3-EA-SA2v2-USDCHF-M15-107,USDCHFMT4,3064,4h 15m,Buy
170472.84,149.28,15.02.2018 08:40:00,,0.0,-260.820000000007,0.0,0.0,149582,15.02.2018 03:15:00,15561,-0.10003311425153376,-65.21,IS,0.23,0.0,Phase3-EA-S4v1-GBPJPY-M5-194,GBPJPYMT4,3378,5h 25m,Buy
170519.39,1.15633,15.02.2018 10:15:00,,0.0,-214.27000000001863,0.0,0.0,1.1576,15.02.2018 01:30:00,15562,-0.08217964646375825,46.55,IS,0.34,0.0,Phase3-EA-S4v1-EURCHF-M15-221,EURCHFMT4,4032,8h 45m,Sell
170482.63,132811,15.02.2018 13:14:57,sl 132.811,0.0,-251.03000000002794,0.0,0.0,133041,15.02.2018 12:30:00,15563,-0.09627832478554038,-36.76,IS,0.17,0.0,Phase3-EA-T1v2-EURJPY-M15-322,EURJPYMT4,3056,44m 57s,Buy
170531.45,1.15349,15.02.2018 22:59:58,tp 1.15349,0.0,-202.21000000002095,0.0,0.0,1.15459,15.02.2018 21:45:00,15564,-0.07755423676406792,48.82,IS,0.41,0.0,Phase3-EA-SA2v2-EURCHF-M5-43,EURCHFMT4,7938,1h 14m,Sell
170493.88,132853,16.02.2018 00:14:58,sl 132.853,-0.78,-239.78000000002794,0.0,0.0,133083,15.02.2018 22:15:00,15565,-0.09196357693135081,-37.57,IS,0.17,0.0,Phase3-EA-T1v2-EURJPY-M15-322,EURJPYMT4,3058,1h 59m,Buy
170522.19,0.92207,16.02.2018 04:45:00,,0.0,-211.47000000003027,0.0,0.0,0.92162,16.02.2018 00:30:00,15566,-0.08110575366449775,28.31,IS,0.58,0.0,Phase3-EA-SA2v2-USDCHF-M15-107,USDCHFMT4,3066,4h 15m,Buy
170571.09,1.1535,16.02.2018 05:19:57,tp 1.15350,0.0,-162.5700000000361,0.0,0.0,1.1524,16.02.2018 00:50:00,15567,-0.06235098299162264,48.9,IS,0.41,0.0,Phase3-EA-SA2v2-EURCHF-M5-43,EURCHFMT4,7940,4h 29m,Buy
170618.05,1.15357,16.02.2018 09:45:00,,0.0,-115.61000000004424,0.0,0.0,1.1523,16.02.2018 01:00:00,15568,-0.044340266615382,46.96,IS,0.34,0.0,Phase3-EA-S4v1-EURCHF-M15-221,EURCHFMT4,4034,8h 45m,Buy
170581.16,132872,16.02.2018 13:44:58,sl 132.872,0.0,-152.5000000000582,0.0,0.0,132642,16.02.2018 09:00:00,15569,-0.05848880424570321,-36.89,IS,0.17,0.0,Phase3-EA-T1v2-EURJPY-M15-322,EURJPYMT4,3060,4h 44m,Sell
170610.38,106279,16.02.2018 23:15:00,,0.0,-123.28000000005704,0.0,0.0,106164,16.02.2018 19:30:00,15570,-0.04728196581908771,29.22,IS,0.27,0.0,Phase3-EA-S1v2-USDJPY-M15-0,USDJPYMT4,4474,3h 45m,Buy
170669.64,0.92691,19.02.2018 02:14:57,tp 0.92691,-3.31,-64.02000000004773,0.0,0.0,0.92791,16.02.2018 23:00:00,15571,-0.02455379178892644,59.26,IS,0.58,0.0,Phase3-EA-SA2v2-USDCHF-M15-107,USDCHFMT4,3068,2d 3h 14m,Sell
170632.91,132151,19.02.2018 09:59:57,sl 132.151,0.0,-100.75000000005821,0.0,0.0,131921,19.02.2018 07:00:00,15572,-0.03864096411643117,-36.73,IS,0.17,0.0,Phase3-EA-T1v2-EURJPY-M15-322,EURJPYMT4,3062,2h 59m,Sell
170634.01,1.15179,19.02.2018 14:30:00,,0.0,-99.65000000005239,0.0,0.0,1.15182,19.02.2018 05:45:00,15573,-0.03821907765957485,1.1,IS,0.34,0.0,Phase3-EA-S4v1-EURCHF-M15-221,EURCHFMT4,4036,8h 45m,Sell
170680.37,1.1519,20.02.2018 02:29:57,tp 1.15190,-2.21,-53.29000000006636,0.0,0.0,1153,19.02.2018 21:15:00,15574,-0.020438481168893217,46.36,IS,0.41,0.0,Phase3-EA-SA2v2-EURCHF-M5-43,EURCHFMT4,7942,5h 14m,Sell
170591.21,0.93023,20.02.2018 06:30:00,,0.0,-142.45000000006985,0.0,0.0,0.9288,20.02.2018 02:15:00,15575,-0.05463429616263166,-89.16,IS,0.58,0.0,Phase3-EA-SA2v2-USDCHF-M15-107,USDCHFMT4,3070,4h 15m,Sell
170595.69,132305,20.02.2018 09:15:00,,-0.78,-137.97000000005937,0.0,0.0,132272,19.02.2018 22:00:00,15576,-0.052916067683803705,4.48,IS,0.17,0.0,Phase3-EA-T1v2-EURJPY-M15-322,EURJPYMT4,3064,11h 15m,Buy
170634.43,107.32,20.02.2018 18:00:00,,0.0,-99.23000000006869,0.0,0.0,107166,20.02.2018 17:45:00,15577,-0.038057993739691355,38.74,IS,0.27,0.0,Phase3-EA-S1v2-USDJPY-M15-0,USDJPYMT4,4476,15m 0s,Buy
170597.92,132162,20.02.2018 19:59:58,sl 132.162,0.0,-135.740000000078,0.0,0.0,132392,20.02.2018 18:45:00,15578,-0.052060788775824825,-36.51,IS,0.17,0.0,Phase3-EA-T1v2-EURJPY-M15-322,EURJPYMT4,3066,1h 14m,Buy
170624.11,107226,20.02.2018 20:15:00,,0.0,-109.55000000007567,0.0,0.0,107122,20.02.2018 18:30:00,15579,-0.042016055771270606,26.19,IS,0.27,0.0,Phase3-EA-S1v2-USDJPY-M15-0,USDJPYMT4,4478,1h 45m,Buy
170587.67,132411,20.02.2018 20:44:57,sl 132.411,0.0,-145.990000000078,0.0,0.0,132181,20.02.2018 20:00:00,15580,-0.05599200348741977,-36.44,IS,0.17,0.0,Phase3-EA-T1v2-EURJPY-M15-322,EURJPYMT4,3068,44m 57s,Sell
170635.87,1.15432,20.02.2018 23:14:58,tp 1.15432,0.0,-97.79000000006636,0.0,0.0,1.15542,20.02.2018 21:45:00,15581,-0.0375057060143542,48.2,IS,0.41,0.0,Phase3-EA-SA2v2-EURCHF-M5-43,EURCHFMT4,7944,1h 29m,Sell
170601.01,0.93658,21.02.2018 03:15:00,,-3.28,-132.6500000000524,0.0,0.0,0.93607,20.02.2018 23:00:00,15582,-0.0508756713651976,-34.86,IS,0.58,0.0,Phase3-EA-SA2v2-USDCHF-M15-107,USDCHFMT4,3072,4h 15m,Sell
170649.18,1.1554,21.02.2018 05:29:58,tp 1.15540,0.0,-84.48000000003958,0.0,0.0,1.1543,21.02.2018 00:35:00,15583,-0.03240087988640942,48.17,IS,0.41,0.0,Phase3-EA-SA2v2-EURCHF-M5-43,EURCHFMT4,7946,4h 54m,Buy
170494.17,150902,21.02.2018 07:25:00,,0.0,-239.4900000000489,0.0,0.0,150175,21.02.2018 02:00:00,15584,-0.0918523523200064,-155.01,IS,0.23,0.0,Phase3-EA-S4v1-GBPJPY-M5-194,GBPJPYMT4,3380,5h 25m,Sell
170433.91,132307,21.02.2018 16:29:58,sl 132.307,0.0,-299.7500000000582,0.0,0.0,131.98,19.02.2018 06:30:00,15585,-0.1149640594927623,-60.26,IS,0.09,0.0,Phase3-EA-TR1v1-EURJPY-M30-91,EURJPYMT4,2750,2d 9h 59m,Buy
170459.29,107439,21.02.2018 18:15:00,,0.0,-274.37000000005355,0.0,0.0,107.54,21.02.2018 17:00:00,15586,-0.10522998833370883,25.38,IS,0.27,0.0,Phase3-EA-S1v2-USDJPY-M15-0,USDJPYMT4,4480,1h 15m,Sell
170479.9,107445,21.02.2018 23:15:00,,0.0,-253.76000000006752,0.0,0.0,107527,21.02.2018 19:00:00,15587,-0.0973253702648389,20.61,IS,0.27,0.0,Phase3-EA-S1v2-USDJPY-M15-0,USDJPYMT4,4482,4h 15m,Sell
170521.35,1.15375,22.02.2018 00:14:58,tp 1.15375,-6.55,-212.31000000005588,0.0,0.0,1.15485,21.02.2018 23:30:00,15588,-0.08142792150428707,41.45,IS,0.41,0.0,Phase3-EA-SA2v2-EURCHF-M5-43,EURCHFMT4,7948,44m 58s,Sell
170474.04,149397,22.02.2018 09:00:00,,0.0,-259.62000000005355,0.0,0.0,149618,22.02.2018 03:35:00,15589,-0.09957287448043806,-47.31,IS,0.23,0.0,Phase3-EA-S4v1-GBPJPY-M5-194,GBPJPYMT4,3382,5h 25m,Buy
170457.45,1.15299,22.02.2018 09:10:00,,0.0,-276.21000000005006,0.0,0.0,1.15337,22.02.2018 00:50:00,15590,-0.10593568931608162,-16.59,IS,0.41,0.0,Phase3-EA-SA2v2-EURCHF-M5-43,EURCHFMT4,7950,8h 20m,Buy
170446.59,1.15319,22.02.2018 10:15:00,,0.0,-287.0700000000361,0.0,0.0,1.15349,22.02.2018 01:30:00,15591,-0.11010085924465392,-10.86,IS,0.34,0.0,Phase3-EA-S4v1-EURCHF-M15-221,EURCHFMT4,4038,8h 45m,Buy
170426.51,107566,22.02.2018 11:00:00,,0.0,-307.1500000000233,0.0,0.0,107646,22.02.2018 01:15:00,15592,-0.11780220474794915,-20.08,IS,0.27,0.0,Phase3-EA-S1v2-USDJPY-M15-0,USDJPYMT4,4484,9h 45m,Buy
170489.51,106716,22.02.2018 23:15:00,,0.0,-244.15000000002328,0.0,0.0,106965,22.02.2018 21:00:00,15593,-0.09363961676448754,63.0,IS,0.27,0.0,Phase3-EA-S1v2-USDJPY-M15-0,USDJPYMT4,4486,2h 15m,Sell
170551.63,0.93375,23.02.2018 06:29:58,tp 0.93375,0.0,-182.03000000002794,0.0,0.0,0.93275,23.02.2018 02:15:00,15594,-0.06981453794651099,62.12,IS,0.58,0.0,Phase3-EA-SA2v2-USDCHF-M15-107,USDCHFMT4,3074,4h 14m,Buy
170510.19,1.15041,23.02.2018 06:45:00,,-1.05,-223.47000000003027,0.0,0.0,1.15133,22.02.2018 22:25:00,15595,-0.0857081513756333,-41.44,IS,0.41,0.0,Phase3-EA-SA2v2-EURCHF-M5-43,EURCHFMT4,7952,8h 20m,Buy
170502.55,1.15013,23.02.2018 10:30:00,,0.0,-231.11000000004424,0.0,0.0,1.15034,23.02.2018 01:45:00,15596,-0.08863834458506162,-7.64,IS,0.34,0.0,Phase3-EA-S4v1-EURCHF-M15-221,EURCHFMT4,4040,8h 45m,Buy
170538.48,106703,23.02.2018 19:15:00,,0.0,-195.18000000005122,0.0,0.0,106845,23.02.2018 18:30:00,15597,-0.07485799877163929,35.93,IS,0.27,0.0,Phase3-EA-S1v2-USDJPY-M15-0,USDJPYMT4,4488,45m 0s,Sell
170470.11,131.2,23.02.2018 19:59:58,sl 131.200,-2.46,-263.55000000004657,0.0,0.0,133027,21.02.2018 07:30:00,15598,-0.10108015973083227,-68.37,IS,0.09,0.0,Phase3-EA-TR1v1-EURJPY-M30-91,EURJPYMT4,2751,2d 12h 29m,Buy
170518.29,1.15124,23.02.2018 22:34:58,tp 1.15124,0.0,-215.37000000005355,0.0,0.0,1.15014,23.02.2018 20:25:00,15599,-0.08260153292062573,48.18,IS,0.41,0.0,Phase3-EA-SA2v2-EURCHF-M5-43,EURCHFMT4,7954,2h 9m,Buy
170564.33,1.15004,26.02.2018 02:04:57,tp 1.15004,-2.19,-169.3300000000454,0.0,0.0,1.15114,23.02.2018 22:45:00,15600,-0.06494366703556591,46.04,IS,0.41,0.0,Phase3-EA-SA2v2-EURCHF-M5-43,EURCHFMT4,7956,2d 3h 19m,Sell
170648.37,149.2,26.02.2018 05:24:58,tp 149.200,0.0,-85.29000000003725,0.0,0.0,149.59,26.02.2018 02:10:00,15601,-0.032711541731910175,84.04,IS,0.23,0.0,Phase3-EA-S4v1-GBPJPY-M5-194,GBPJPYMT4,3384,3h 14m,Sell
170734.67,1.15238,26.02.2018 15:15:00,,0.0,-0.0,0.0,0.0,1.15001,26.02.2018 06:30:00,15602,-0.0,86.3,IS,0.34,0.0,Phase3-EA-S4v1-EURCHF-M15-221,EURCHFMT4,4042,8h 45m,Buy
170755.38,107027,27.02.2018 03:15:00,,-0.73,-0.0,0.0,0.0,106942,26.02.2018 23:45:00,15603,-0.0,20.71,IS,0.27,0.0,Phase3-EA-S1v2-USDJPY-M15-0,USDJPYMT4,4490,3h 30m,Buy
170706.36,1.15557,27.02.2018 05:15:00,,-2.19,-49.01999999998952,0.0,0.0,1.1545,26.02.2018 20:55:00,15604,-0.018799228610350924,-49.02,IS,0.41,0.0,Phase3-EA-SA2v2-EURCHF-M5-43,EURCHFMT4,7958,8h 20m,Sell
170703.82,1.15518,27.02.2018 10:45:00,,0.0,-51.55999999999767,0.0,0.0,1.15511,27.02.2018 02:00:00,15605,-0.019773321647283907,-2.54,IS,0.34,0.0,Phase3-EA-S4v1-EURCHF-M15-221,EURCHFMT4,4044,8h 45m,Sell
170710.88,107098,27.02.2018 18:15:00,,0.0,-44.5,0.0,0.0,107.07,27.02.2018 17:45:00,15606,-0.017065803206054567,7.06,IS,0.27,0.0,Phase3-EA-S1v2-USDJPY-M15-0,USDJPYMT4,4492,30m 0s,Buy
170741.82,107.43,28.02.2018 04:00:00,,-0.73,-13.559999999997672,0.0,0.0,107304,27.02.2018 23:00:00,15607,-0.00520027621290023,30.94,IS,0.27,0.0,Phase3-EA-S1v2-USDJPY-M15-0,USDJPYMT4,4494,5h 0m,Buy
170667.89,1.14911,28.02.2018 04:20:00,,-1.05,-87.48999999999069,0.0,0.0,1.15078,27.02.2018 20:00:00,15608,-0.033552519606686634,-73.93,IS,0.41,0.0,Phase3-EA-SA2v2-EURCHF-M5-43,EURCHFMT4,7960,8h 20m,Buy
170935.6,130604,28.02.2018 16:44:58,tp 130.604,-2.23,-0.0,0.0,0.0,132304,22.02.2018 01:00:00,15609,-0.0,267.71,IS,0.17,0.0,Phase3-EA-T1v2-EURJPY-M15-322,EURJPYMT4,3070,6d 15h 44m,Sell
171043.83,130.5,28.02.2018 19:29:58,tp 130.500,-0.29,-0.0,0.0,0.0,131.79,27.02.2018 07:30:00,15610,-0.0,108.23,IS,0.09,0.0,Phase3-EA-TR1v1-EURJPY-M30-91,EURJPYMT4,2754,1d 11h 59m,Sell
171056.49,106661,01.03.2018 02:15:00,,0.0,-0.0,0.0,0.0,106711,01.03.2018 01:15:00,15611,-0.0,12.66,IS,0.27,0.0,Phase3-EA-S1v2-USDJPY-M15-0,USDJPYMT4,4496,1h 0m,Sell
171161.92,130013,01.03.2018 03:29:58,tp 130.013,-0.89,-0.0,0.0,0.0,131273,28.02.2018 02:00:00,15612,-0.0,105.43,IS,0.09,0.0,Phase3-EA-TR1v1-EURJPY-M30-91,EURJPYMT4,2755,1d 1h 29m,Sell
171126.79,146679,01.03.2018 05:35:00,,0.0,-35.13000000000466,0.0,0.0,146842,01.03.2018 00:10:00,15613,-0.013451425077593422,-35.13,IS,0.23,0.0,Phase3-EA-S4v1-GBPJPY-M5-194,GBPJPYMT4,3386,5h 25m,Buy
171153.68,1.15227,01.03.2018 10:15:00,,0.0,-8.239999999990687,0.0,0.0,1.15165,01.03.2018 01:55:00,15614,-0.0031551307326851646,26.89,IS,0.41,0.0,Phase3-EA-SA2v2-EURCHF-M5-43,EURCHFMT4,7962,8h 20m,Buy
171117.12,130367,01.03.2018 18:44:57,sl 130.367,0.0,-44.79999999998836,0.0,0.0,130137,01.03.2018 14:15:00,15615,-0.017154108837914853,-36.56,IS,0.17,0.0,Phase3-EA-T1v2-EURJPY-M15-322,EURJPYMT4,3072,4h 29m,Sell
171060.74,147429,01.03.2018 18:59:57,sl 147.429,0.0,-101.17999999999302,0.0,0.0,146759,01.03.2018 02:00:00,15616,-0.038742248487065985,-56.38,IS,0.09,0.0,Phase3-EA-B1v1-GBPJPY-M30-1,GBPJPYMT4,1426,16h 59m,Sell
171108.37,1.15418,01.03.2018 23:14:58,tp 1.15418,0.0,-53.54999999998836,0.0,0.0,1.15528,01.03.2018 20:40:00,15617,-0.02050452072032097,47.63,IS,0.41,0.0,Phase3-EA-SA2v2-EURCHF-M5-43,EURCHFMT4,7964,2h 34m,Sell
171071.61,130009,01.03.2018 23:29:58,sl 130.009,0.0,-90.30999999999767,0.0,0.0,129779,01.03.2018 23:15:00,15618,-0.034580079668581544,-36.76,IS,0.17,0.0,Phase3-EA-T1v2-EURJPY-M15-322,EURJPYMT4,3074,14m 58s,Sell
171119.59,1.15443,02.03.2018 07:54:58,tp 1.15443,0.0,-42.329999999987194,0.0,0.0,1.15553,02.03.2018 01:00:00,15619,-0.016208335426538056,47.98,IS,0.41,0.0,Phase3-EA-SA2v2-EURCHF-M5-43,EURCHFMT4,7966,6h 54m,Sell
171099.88,130243,02.03.2018 09:00:00,,0.0,-62.039999999979045,0.0,0.0,130366,02.03.2018 08:30:00,15620,-0.023755377506789167,-19.71,IS,0.17,0.0,Phase3-EA-T1v2-EURJPY-M15-322,EURJPYMT4,3076,30m 0s,Buy
171244.64,1.15171,02.03.2018 11:44:58,tp 1.15171,0.0,-0.0,0.0,0.0,1.15571,02.03.2018 05:15:00,15621,-0.0,144.76,IS,0.34,0.0,Phase3-EA-S4v1-EURCHF-M15-221,EURCHFMT4,4046,6h 29m,Sell
171290.53,1.1541,05.03.2018 03:29:58,tp 1.15410,-2.19,-0.0,0.0,0.0,1.1552,02.03.2018 21:30:00,15622,-0.0,45.89,IS,0.41,0.0,Phase3-EA-SA2v2-EURCHF-M5-43,EURCHFMT4,7968,2d 5h 59m,Sell
171308.07,105463,05.03.2018 05:00:00,,-1.15,-0.0,0.0,0.0,105536,02.03.2018 19:45:00,15623,-0.0,17.54,IS,0.27,0.0,Phase3-EA-S1v2-USDJPY-M15-0,USDJPYMT4,4498,2d 9h 15m,Sell
171266.07,1.37742,05.03.2018 11:29:58,sl 1.37742,0.0,-42.0,0.0,0.0,1.38042,05.03.2018 05:30:00,15624,-0.01607298236139426,-42.0,IS,0.14,0.0,Phase3-EA-B1v1-GBPUSD-M30-14,GBPUSDMT4,1018,5h 59m,Buy
171250.48,1.15392,05.03.2018 12:45:00,,0.0,-57.58999999999651,0.0,0.0,1.15435,05.03.2018 04:00:00,15625,-0.022039120337919986,-15.59,IS,0.34,0.0,Phase3-EA-S4v1-EURCHF-M15-221,EURCHFMT4,4048,8h 45m,Buy
171213.47,130062,05.03.2018 17:59:58,sl 130.062,0.0,-94.60000000000582,0.0,0.0,129832,05.03.2018 16:30:00,15626,-0.036202479318761686,-37.01,IS,0.17,0.0,Phase3-EA-T1v2-EURJPY-M15-322,EURJPYMT4,3078,1h 29m,Sell
171261.47,1.15793,05.03.2018 21:24:57,tp 1.15793,0.0,-46.60000000000582,0.0,0.0,1.15903,05.03.2018 20:20:00,15627,-0.017833356620025387,48.0,IS,0.41,0.0,Phase3-EA-SA2v2-EURCHF-M5-43,EURCHFMT4,7970,1h 4m,Sell
171369.38,131402,06.03.2018 04:59:57,tp 131.402,-1.26,-0.0,0.0,0.0,130112,01.03.2018 07:00:00,15628,-0.0,107.91,IS,0.09,0.0,Phase3-EA-TR1v1-EURJPY-M30-91,EURJPYMT4,2758,4d 21h 59m,Buy
171332.32,0.93913,06.03.2018 06:15:00,,0.0,-37.05999999999767,0.0,0.0,0.93973,06.03.2018 02:00:00,15629,-0.014179166664433864,-37.06,IS,0.58,0.0,Phase3-EA-SA2v2-USDCHF-M15-107,USDCHFMT4,3076,4h 15m,Buy
171276.53,147303,06.03.2018 07:25:00,,0.0,-92.85000000000582,0.0,0.0,147045,06.03.2018 02:00:00,15630,-0.03552443671864138,-55.79,IS,0.23,0.0,Phase3-EA-S4v1-GBPJPY-M5-194,GBPJPYMT4,3388,5h 25m,Sell
171248.17,1.16023,06.03.2018 09:25:00,,0.0,-121.20999999999185,0.0,0.0,1.15958,06.03.2018 01:05:00,15631,-0.04637498087954725,-28.36,IS,0.41,0.0,Phase3-EA-SA2v2-EURCHF-M5-43,EURCHFMT4,7972,8h 20m,Sell
171232.97,1.16019,06.03.2018 10:00:00,,0.0,-136.4100000000035,0.0,0.0,1.15977,06.03.2018 01:15:00,15632,-0.05219050525352387,-15.2,IS,0.34,0.0,Phase3-EA-S4v1-EURCHF-M15-221,EURCHFMT4,4050,8h 45m,Sell
171176.05,147276,06.03.2018 15:29:58,sl 147.276,0.0,-193.3300000000163,0.0,0.0,146606,06.03.2018 14:00:00,15633,-0.07396811363290347,-56.92,IS,0.09,0.0,Phase3-EA-B1v1-GBPJPY-M30-1,GBPJPYMT4,1428,1h 29m,Sell
171139.25,131616,06.03.2018 17:59:58,sl 131.616,0.0,-230.13000000000466,0.0,0.0,131846,06.03.2018 16:00:00,15634,-0.08804780422251582,-36.8,IS,0.17,0.0,Phase3-EA-T1v2-EURJPY-M15-322,EURJPYMT4,3080,1h 59m,Buy
171157.97,106023,07.03.2018 02:30:00,,-1.14,-211.4100000000035,0.0,0.0,106101,06.03.2018 23:00:00,15635,-0.08088552683562335,18.72,IS,0.27,0.0,Phase3-EA-S1v2-USDJPY-M15-0,USDJPYMT4,4500,3h 30m,Sell
171100.79,146816,07.03.2018 02:59:58,sl 146.816,-0.31,-268.5899999999965,0.0,0.0,147486,06.03.2018 15:30:00,15636,-0.10276261128981332,-57.18,IS,0.09,0.0,Phase3-EA-B1v1-GBPJPY-M30-1,GBPJPYMT4,1430,11h 29m,Buy
171068.46,1.16504,07.03.2018 04:20:00,,-2.18,-300.9199999999837,0.0,0.0,1.16435,06.03.2018 20:00:00,15637,-0.1151320785931321,-32.33,IS,0.41,0.0,Phase3-EA-SA2v2-EURCHF-M5-43,EURCHFMT4,7974,8h 20m,Sell
171068.02,146847,07.03.2018 08:10:00,,0.0,-301.35999999998603,0.0,0.0,146849,07.03.2018 02:45:00,15638,-0.11530042271974797,-0.44,IS,0.23,0.0,Phase3-EA-S4v1-GBPJPY-M5-194,GBPJPYMT4,3390,5h 25m,Buy
171085.79,1.16467,07.03.2018 14:00:00,,0.0,-283.5899999999965,0.0,0.0,1.16418,07.03.2018 05:15:00,15639,-0.10850161560623321,17.77,IS,0.34,0.0,Phase3-EA-S4v1-EURCHF-M15-221,EURCHFMT4,4052,8h 45m,Buy
171048.79,131399,07.03.2018 14:44:57,sl 131.399,0.0,-320.5899999999965,0.0,0.0,131169,07.03.2018 13:30:00,15640,-0.12265782625340228,-37.0,IS,0.17,0.0,Phase3-EA-T1v2-EURJPY-M15-322,EURJPYMT4,3082,1h 14m,Sell
171011.85,131362,07.03.2018 17:14:58,sl 131.362,0.0,-357.52999999999884,0.0,0.0,131132,07.03.2018 16:00:00,15641,-0.13679108088330658,-36.94,IS,0.17,0.0,Phase3-EA-T1v2-EURJPY-M15-322,EURJPYMT4,3084,1h 14m,Sell
171061.3,106101,08.03.2018 00:15:00,,-2.21,-308.0799999999872,0.0,0.0,105898,07.03.2018 21:45:00,15642,-0.11787149665350452,49.45,IS,0.27,0.0,Phase3-EA-S1v2-USDJPY-M15-0,USDJPYMT4,4502,2h 30m,Buy
171034.22,147592,08.03.2018 05:40:00,,0.0,-335.1599999999744,0.0,0.0,147467,08.03.2018 00:15:00,15643,-0.12823231244607636,-27.08,IS,0.23,0.0,Phase3-EA-S4v1-GBPJPY-M5-194,GBPJPYMT4,3392,5h 25m,Sell
171062.92,1.16951,08.03.2018 06:25:00,,-6.52,-306.45999999996275,0.0,0.0,1.17032,07.03.2018 22:05:00,15644,-0.11725168418732182,28.7,IS,0.41,0.0,Phase3-EA-SA2v2-EURCHF-M5-43,EURCHFMT4,7976,8h 20m,Sell
171077.88,131553,08.03.2018 08:30:00,,-2.36,-291.4999999999709,0.0,0.0,131445,07.03.2018 22:45:00,15645,-0.1115279838824155,14.96,IS,0.17,0.0,Phase3-EA-T1v2-EURJPY-M15-322,EURJPYMT4,3086,9h 45m,Buy
171096.23,1.17048,08.03.2018 13:30:00,,0.0,-273.1499999999651,0.0,0.0,1.17099,08.03.2018 04:45:00,15646,-0.10450726860199293,18.35,IS,0.34,0.0,Phase3-EA-S4v1-EURCHF-M15-221,EURCHFMT4,4054,8h 45m,Sell
171059.4,131594,08.03.2018 17:59:58,sl 131.594,0.0,-309.97999999995227,0.0,0.0,131824,08.03.2018 17:15:00,15647,-0.11859843720023769,-36.83,IS,0.17,0.0,Phase3-EA-T1v2-EURJPY-M15-322,EURJPYMT4,3088,44m 58s,Buy
171058.38,106127,08.03.2018 19:00:00,,0.0,-310.9999999999418,0.0,0.0,106131,08.03.2018 18:45:00,15648,-0.11898868949375023,-1.02,IS,0.27,0.0,Phase3-EA-S1v2-USDJPY-M15-0,USDJPYMT4,4504,15m 0s,Buy
171069.82,106174,08.03.2018 19:15:00,,0.0,-299.55999999993946,0.0,0.0,106129,08.03.2018 19:00:00,15649,-0.11461174220175976,11.44,IS,0.27,0.0,Phase3-EA-S1v2-USDJPY-M15-0,USDJPYMT4,4506,15m 0s,Buy
171007.09,130577,08.03.2018 20:59:58,sl 130.577,-1.67,-362.28999999994994,0.0,0.0,131297,06.03.2018 04:30:00,15650,-0.13861225825303178,-62.73,IS,0.09,0.0,Phase3-EA-TR1v1-EURJPY-M30-91,EURJPYMT4,2759,2d 16h 29m,Buy
170969.87,131373,09.03.2018 05:14:58,sl 131.373,-0.56,-399.5099999999511,0.0,0.0,131143,08.03.2018 19:15:00,15651,-0.15285264096350878,-37.22,IS,0.17,0.0,Phase3-EA-T1v2-EURJPY-M15-322,EURJPYMT4,3090,9h 59m,Sell
170921.64,1.17181,09.03.2018 07:25:00,,-2.15,-447.7399999999616,0.0,0.0,1.17074,08.03.2018 23:05:00,15652,-0.17130545284224158,-48.23,IS,0.41,0.0,Phase3-EA-SA2v2-EURCHF-M5-43,EURCHFMT4,7978,8h 20m,Sell
170824.2,147287,09.03.2018 08:20:00,,0.0,-545.1799999999639,0.0,0.0,146835,09.03.2018 02:55:00,15653,-0.2085860248817061,-97.44,IS,0.23,0.0,Phase3-EA-S4v1-GBPJPY-M5-194,GBPJPYMT4,3394,5h 25m,Sell
170949.06,1.16833,09.03.2018 15:00:00,,0.0,-420.3199999999779,0.0,0.0,1.17182,09.03.2018 06:15:00,15654,-0.16081455295183222,124.86,IS,0.34,0.0,Phase3-EA-S4v1-EURCHF-M15-221,EURCHFMT4,4056,8h 45m,Sell
170994.31,1.16977,12.03.2018 02:04:58,tp 1.16977,-2.16,-375.0699999999779,0.0,0.0,1.17087,09.03.2018 23:05:00,15655,-0.1435018899306322,45.25,IS,0.41,0.0,Phase3-EA-SA2v2-EURCHF-M5-43,EURCHFMT4,7980,2d 2h 59m,Sell
170956.92,131258,12.03.2018 05:44:58,sl 131.258,-0.78,-412.45999999999185,0.0,0.0,131488,09.03.2018 18:30:00,15656,-0.15780731469003356,-37.39,IS,0.17,0.0,Phase3-EA-T1v2-EURJPY-M15-322,EURJPYMT4,3092,2d 11h 14m,Buy
171017.97,0.95005,12.03.2018 05:59:58,tp 0.95005,0.0,-351.4100000000035,0.0,0.0,0.95105,12.03.2018 02:15:00,15657,-0.13444956712220904,61.05,IS,0.58,0.0,Phase3-EA-SA2v2-USDCHF-M15-107,USDCHFMT4,3078,3h 44m,Sell
171065.63,1.16747,12.03.2018 22:59:57,tp 1.16747,0.0,-303.75,0.0,0.0,1.16857,12.03.2018 20:20:00,15658,-0.11621483740750288,47.66,IS,0.41,0.0,Phase3-EA-SA2v2-EURCHF-M5-43,EURCHFMT4,7982,2h 39m,Sell
171112.19,1.16889,13.03.2018 00:54:57,tp 1.16889,-1.04,-257.1900000000023,0.0,0.0,1.16779,12.03.2018 23:00:00,15659,-0.09840096800933641,46.56,IS,0.41,0.0,Phase3-EA-SA2v2-EURCHF-M5-43,EURCHFMT4,7984,1h 54m,Buy
171159.85,1.16758,13.03.2018 01:09:57,tp 1.16758,0.0,-209.52999999999884,0.0,0.0,1.16868,13.03.2018 01:00:00,15660,-0.08016623829463027,47.66,IS,0.41,0.0,Phase3-EA-SA2v2-EURCHF-M5-43,EURCHFMT4,7986,9m 57s,Sell
171099.2,0.94667,13.03.2018 05:15:00,,0.0,-270.179999999993,0.0,0.0,0.94568,13.03.2018 01:00:00,15661,-0.10337094574735249,-60.65,IS,0.58,0.0,Phase3-EA-SA2v2-USDCHF-M15-107,USDCHFMT4,3080,4h 15m,Sell
171094.9,1.16913,13.03.2018 11:15:00,,0.0,-274.4799999999814,0.0,0.0,1.16901,13.03.2018 02:30:00,15662,-0.10501612698472174,-4.3,IS,0.34,0.0,Phase3-EA-S4v1-EURCHF-M15-221,EURCHFMT4,4058,8h 45m,Sell
171052.9,1.38749,13.03.2018 13:29:58,sl 1.38749,0.0,-316.4799999999814,0.0,0.0,1.39049,13.03.2018 06:00:00,15663,-0.12108533907069745,-42.0,IS,0.14,0.0,Phase3-EA-B1v1-GBPUSD-M30-14,GBPUSDMT4,1020,7h 29m,Buy
171160.44,132274,13.03.2018 14:59:58,tp 132.274,-0.82,-208.93999999997322,0.0,0.0,130984,09.03.2018 04:30:00,15664,-0.07994050412484129,107.54,IS,0.09,0.0,Phase3-EA-TR1v1-EURJPY-M30-91,EURJPYMT4,2762,4d 10h 29m,Buy
171208.23,1.16944,13.03.2018 23:44:58,tp 1.16944,0.0,-161.14999999996508,0.0,0.0,1.17054,13.03.2018 21:00:00,15665,-0.061656036372724383,47.79,IS,0.41,0.0,Phase3-EA-SA2v2-EURCHF-M5-43,EURCHFMT4,7988,2h 44m,Sell
171136.12,106676,14.03.2018 04:15:00,,-0.73,-233.2599999999511,0.0,0.0,106958,13.03.2018 17:00:00,15666,-0.08924534312318828,-72.11,IS,0.27,0.0,Phase3-EA-S1v2-USDJPY-M15-0,USDJPYMT4,4508,11h 15m,Buy
171219.42,149119,14.03.2018 04:44:58,tp 149.119,-0.78,-149.95999999996275,0.0,0.0,148729,13.03.2018 23:30:00,15667,-0.05737473915267425,83.3,IS,0.23,0.0,Phase3-EA-S4v1-GBPJPY-M5-194,GBPJPYMT4,3396,5h 14m,Buy
171178.82,0.94283,14.03.2018 06:00:00,,0.0,-190.55999999996857,0.0,0.0,0.94349,14.03.2018 01:45:00,15668,-0.07290831083578633,-40.6,IS,0.58,0.0,Phase3-EA-SA2v2-USDCHF-M15-107,USDCHFMT4,3082,4h 15m,Buy
171142.07,132026,14.03.2018 07:14:58,sl 132.026,0.0,-227.30999999996857,0.0,0.0,132256,14.03.2018 04:45:00,15669,-0.08696887141101507,-36.75,IS,0.17,0.0,Phase3-EA-T1v2-EURJPY-M15-322,EURJPYMT4,3094,2h 29m,Buy
171136.25,1.16948,14.03.2018 08:15:00,,-1.04,-233.12999999997555,0.0,0.0,1.16959,13.03.2018 23:55:00,15670,-0.08919560508578867,-5.82,IS,0.41,0.0,Phase3-EA-SA2v2-EURCHF-M5-43,EURCHFMT4,7990,8h 20m,Buy
171079.28,148119,14.03.2018 19:29:58,sl 148.119,-0.3,-290.0999999999767,0.0,0.0,148789,13.03.2018 13:30:00,15671,-0.11099234347955186,-56.97,IS,0.09,0.0,Phase3-EA-B1v1-GBPJPY-M30-1,GBPJPYMT4,1432,1d 5h 59m,Buy
171017.88,131062,14.03.2018 19:59:57,sl 131.062,-0.41,-351.4999999999709,0.0,0.0,131782,13.03.2018 12:00:00,15672,-0.13448400114809508,-61.4,IS,0.09,0.0,Phase3-EA-TR1v1-EURJPY-M30-91,EURJPYMT4,2763,1d 7h 59m,Buy
171035.92,106236,15.03.2018 03:30:00,,0.0,-333.45999999996275,0.0,0.0,106307,15.03.2018 00:15:00,15673,-0.12758189195687764,18.04,IS,0.27,0.0,Phase3-EA-S1v2-USDJPY-M15-0,USDJPYMT4,4510,3h 15m,Sell
171027.57,0.94441,15.03.2018 04:00:00,,-2.21,-341.80999999996857,0.0,0.0,0.94451,14.03.2018 23:45:00,15674,-0.13077660435968694,-8.35,IS,0.58,0.0,Phase3-EA-SA2v2-USDCHF-M15-107,USDCHFMT4,3084,4h 15m,Buy
171044.84,1.16924,15.03.2018 08:00:00,,-3.13,-324.53999999997905,0.0,0.0,1.16877,14.03.2018 23:40:00,15675,-0.12416909739005284,17.27,IS,0.41,0.0,Phase3-EA-SA2v2-EURCHF-M5-43,EURCHFMT4,7992,8h 20m,Buy
171058.87,1.16875,15.03.2018 10:15:00,,0.0,-310.5099999999802,0.0,0.0,1.16836,15.03.2018 01:30:00,15676,-0.11880121535276188,14.03,IS,0.34,0.0,Phase3-EA-S4v1-EURCHF-M15-221,EURCHFMT4,4060,8h 45m,Buy
171016.87,1.39523,15.03.2018 13:29:57,sl 1.39523,0.0,-352.5099999999802,0.0,0.0,1.39823,15.03.2018 08:00:00,15677,-0.1348704274387376,-42.0,IS,0.14,0.0,Phase3-EA-B1v1-GBPUSD-M30-14,GBPUSDMT4,1022,5h 29m,Buy
170949.33,130797,15.03.2018 14:59:57,sl 130.797,-1.25,-420.04999999998836,0.0,0.0,131577,14.03.2018 22:30:00,15678,-0.16071125087414068,-67.54,IS,0.09,0.0,Phase3-EA-TR1v1-EURJPY-M30-91,EURJPYMT4,2766,16h 29m,Buy
170907.33,1.39509,15.03.2018 19:59:58,sl 1.39509,0.0,-462.04999999998836,0.0,0.0,1.39809,15.03.2018 19:00:00,15679,-0.1767804629601164,-42.0,IS,0.14,0.0,Phase3-EA-B1v1-GBPUSD-M30-14,GBPUSDMT4,1024,59m 58s,Buy
170918.73,0.95136,16.03.2018 04:00:00,,-3.23,-450.6499999999942,0.0,0.0,0.9516,15.03.2018 23:45:00,15680,-0.1724188196796395,11.4,IS,0.58,0.0,Phase3-EA-SA2v2-USDCHF-M15-107,USDCHFMT4,3086,4h 15m,Sell
170925.63,1.17061,16.03.2018 04:20:00,,-2.15,-443.75,0.0,0.0,1.17082,15.03.2018 20:00:00,15681,-0.1697788776940886,6.9,IS,0.41,0.0,Phase3-EA-SA2v2-EURCHF-M5-43,EURCHFMT4,7994,8h 20m,Sell
170915.24,1.17004,16.03.2018 14:45:00,,0.0,-454.14000000001397,0.0,0.0,1.17033,16.03.2018 06:00:00,15682,-0.1737540946839341,-10.39,IS,0.34,0.0,Phase3-EA-S4v1-EURCHF-M15-221,EURCHFMT4,4062,8h 45m,Buy
170922.9,106089,19.03.2018 04:15:00,,-0.74,-446.4800000000105,0.0,0.0,106056,16.03.2018 22:45:00,15683,-0.17082337647968102,7.66,IS,0.27,0.0,Phase3-EA-S1v2-USDJPY-M15-0,USDJPYMT4,4512,2d 5h 30m,Buy
170968.07,1.16981,19.03.2018 04:29:58,tp 1.16981,-2.15,-401.3099999999977,0.0,0.0,1.17091,16.03.2018 20:45:00,15684,-0.153541321481497,45.17,IS,0.41,0.0,Phase3-EA-SA2v2-EURCHF-M5-43,EURCHFMT4,7996,2d 7h 44m,Sell
171028.9,0.95349,19.03.2018 05:14:57,tp 0.95349,0.0,-340.4800000000105,0.0,0.0,0.95249,19.03.2018 02:15:00,15685,-0.1302677459769804,60.83,IS,0.58,0.0,Phase3-EA-SA2v2-USDCHF-M15-107,USDCHFMT4,3088,2h 59m,Buy
170961.8,129925,19.03.2018 05:29:58,sl 129.925,-0.83,-407.5800000000163,0.0,0.0,130705,15.03.2018 20:30:00,15686,-0.15594022528576765,-67.1,IS,0.09,0.0,Phase3-EA-TR1v1-EURJPY-M30-91,EURJPYMT4,2768,3d 8h 59m,Buy
171012.08,1.17132,19.03.2018 13:30:00,,0.0,-357.30000000001746,0.0,0.0,1.16991,19.03.2018 04:45:00,15687,-0.1367030828171286,50.28,IS,0.34,0.0,Phase3-EA-S4v1-EURCHF-M15-221,EURCHFMT4,4064,8h 45m,Buy
170974.7,130923,19.03.2018 16:14:58,sl 130.923,-0.56,-394.6800000000221,0.0,0.0,130693,16.03.2018 04:45:00,15688,-0.15100468157364874,-37.38,IS,0.17,0.0,Phase3-EA-T1v2-EURJPY-M15-322,EURJPYMT4,3096,3d 11h 29m,Sell
171034.98,0.95072,20.03.2018 00:14:58,tp 0.95072,-0.73,-334.4000000000233,0.0,0.0,0.94972,19.03.2018 23:15:00,15689,-0.12794153622739646,60.28,IS,0.58,0.0,Phase3-EA-SA2v2-USDCHF-M15-107,USDCHFMT4,3090,59m 58s,Buy
171047.98,106.15,20.03.2018 00:15:00,,-0.74,-321.4000000000233,0.0,0.0,106096,19.03.2018 18:00:00,15690,-0.1229677324864992,13.0,IS,0.27,0.0,Phase3-EA-S1v2-USDJPY-M15-0,USDJPYMT4,4514,6h 15m,Buy
170999.69,1.17437,20.03.2018 05:55:00,,-2.16,-369.69000000003143,0.0,0.0,1.1733,19.03.2018 21:35:00,15691,-0.14144350038249678,-48.29,IS,0.41,0.0,Phase3-EA-SA2v2-EURCHF-M5-43,EURCHFMT4,7998,8h 20m,Sell
171108.58,131353,20.03.2018 11:29:59,tp 131.353,-0.42,-260.80000000001746,0.0,0.0,130063,19.03.2018 13:00:00,15692,-0.0997821550481606,108.89,IS,0.09,0.0,Phase3-EA-TR1v1-EURJPY-M30-91,EURJPYMT4,2770,22h 29m,Buy
171068.9,1.17469,20.03.2018 11:45:00,,0.0,-300.4800000000105,0.0,0.0,1.17358,20.03.2018 03:00:00,15693,-0.11496373446652736,-39.68,IS,0.34,0.0,Phase3-EA-S4v1-EURCHF-M15-221,EURCHFMT4,4066,8h 45m,Sell
171077.77,106492,20.03.2018 23:15:00,,0.0,-291.61000000001513,0.0,0.0,106457,20.03.2018 20:30:00,15694,-0.11157006991408618,8.87,IS,0.27,0.0,Phase3-EA-S1v2-USDJPY-M15-0,USDJPYMT4,4516,2h 45m,Buy
171070.31,1.17091,21.03.2018 04:45:00,,-1.03,-299.070000000007,0.0,0.0,1.17106,20.03.2018 20:25:00,15695,-0.11442426806078256,-7.46,IS,0.41,0.0,Phase3-EA-SA2v2-EURCHF-M5-43,EURCHFMT4,8000,8h 20m,Buy
171081.0,1.17083,21.03.2018 15:30:00,,0.0,-288.38000000000466,0.0,0.0,1.17113,21.03.2018 06:45:00,15696,-0.11033427098461308,10.69,IS,0.34,0.0,Phase3-EA-S4v1-EURCHF-M15-221,EURCHFMT4,4068,8h 45m,Sell
171044.24,130371,21.03.2018 15:44:58,sl 130.371,0.0,-325.14000000001397,0.0,0.0,130601,21.03.2018 15:00:00,15697,-0.124398657562723,-36.76,IS,0.17,0.0,Phase3-EA-T1v2-EURJPY-M15-322,EURJPYMT4,3098,44m 58s,Buy
171091.6,1.17114,21.03.2018 22:04:57,tp 1.17114,0.0,-277.78000000002794,0.0,0.0,1.17004,21.03.2018 20:35:00,15698,-0.10627870793435193,47.36,IS,0.41,0.0,Phase3-EA-SA2v2-EURCHF-M5-43,EURCHFMT4,8002,1h 29m,Buy
171054.72,130635,21.03.2018 22:14:58,sl 130.635,0.0,-314.6600000000326,0.0,0.0,130405,21.03.2018 20:00:00,15699,-0.12038900654699143,-36.88,IS,0.17,0.0,Phase3-EA-T1v2-EURJPY-M15-322,EURJPYMT4,3100,2h 14m,Sell
171318.26,1.41353,21.03.2018 23:29:57,tp 1.41353,-1.06,-51.12000000002445,0.0,0.0,1.39463,19.03.2018 13:00:00,15700,-0.019558526710368358,263.54,IS,0.14,0.0,Phase3-EA-B1v1-GBPUSD-M30-14,GBPUSDMT4,1026,2d 10h 29m,Buy
171359.28,1.17046,22.03.2018 01:00:00,tp 1.17046,-6.48,-10.100000000034925,0.0,0.0,1.17156,21.03.2018 22:20:00,15701,-0.0038642629064027587,41.02,IS,0.41,0.0,Phase3-EA-SA2v2-EURCHF-M5-43,EURCHFMT4,8004,2h 40m,Sell
171319.94,130665,22.03.2018 04:44:58,sl 130.665,-2.36,-49.44000000003143,0.0,0.0,130895,21.03.2018 22:30:00,15702,-0.018915758226932002,-39.34,IS,0.17,0.0,Phase3-EA-T1v2-EURJPY-M15-322,EURJPYMT4,3102,6h 14m,Buy
171293.62,149697,22.03.2018 08:45:00,,0.0,-75.76000000003842,0.0,0.0,149818,22.03.2018 03:20:00,15703,-0.028985797800812785,-26.32,IS,0.23,0.0,Phase3-EA-S4v1-GBPJPY-M5-194,GBPJPYMT4,3398,5h 25m,Buy
171402.48,129789,22.03.2018 16:59:58,tp 129.789,-1.19,-0.0,0.0,0.0,131079,20.03.2018 13:30:00,15704,-0.0,108.86,IS,0.09,0.0,Phase3-EA-TR1v1-EURJPY-M30-91,EURJPYMT4,2772,2d 3h 29m,Sell
171447.8,1.16827,23.03.2018 00:49:58,tp 1.16827,-2.16,-0.0,0.0,0.0,1.16937,22.03.2018 20:40:00,15705,-0.0,45.32,IS,0.41,0.0,Phase3-EA-SA2v2-EURCHF-M5-43,EURCHFMT4,8006,4h 9m,Sell
171272.42,147818,23.03.2018 02:44:58,sl 147.818,0.0,-175.38000000000466,0.0,0.0,148618,23.03.2018 00:30:00,15706,-0.06708031201639629,-175.38,IS,0.23,0.0,Phase3-EA-S4v1-GBPJPY-M5-194,GBPJPYMT4,3400,2h 14m,Buy
171357.84,148191,23.03.2018 04:04:59,tp 148.191,0.0,-89.95999999999185,0.0,0.0,147801,23.03.2018 02:55:00,15707,-0.03440839815825238,85.42,IS,0.23,0.0,Phase3-EA-S4v1-GBPJPY-M5-194,GBPJPYMT4,3402,1h 9m,Buy
171282.81,1.16612,23.03.2018 09:25:00,,0.0,-164.9899999999907,0.0,0.0,1.16785,23.03.2018 01:05:00,15708,-0.06310628737361333,-75.03,IS,0.41,0.0,Phase3-EA-SA2v2-EURCHF-M5-43,EURCHFMT4,8008,8h 20m,Buy
171328.06,1.16797,23.03.2018 13:15:00,,0.0,-119.73999999999069,0.0,0.0,1.16671,23.03.2018 04:30:00,15709,-0.04579881720174737,45.25,IS,0.34,0.0,Phase3-EA-S4v1-EURCHF-M15-221,EURCHFMT4,4070,8h 45m,Buy
171266.38,129801,23.03.2018 16:29:57,sl 129.801,0.0,-181.4199999999837,0.0,0.0,129081,23.03.2018 03:30:00,15710,-0.0693905246094948,-61.68,IS,0.09,0.0,Phase3-EA-TR1v1-EURJPY-M30-91,EURJPYMT4,2774,12h 59m,Sell
171311.82,1.16923,26.03.2018 02:00:00,tp 1.16923,-2.17,-135.97999999998137,0.0,0.0,1.17033,23.03.2018 20:35:00,15711,-0.05201038218718255,45.44,IS,0.41,0.0,Phase3-EA-SA2v2-EURCHF-M5-43,EURCHFMT4,8010,2d 5h 25m,Sell
171333.86,148302,26.03.2018 04:40:00,,-0.79,-113.93999999997322,0.0,0.0,148198,23.03.2018 23:15:00,15712,-0.04358040113551257,22.04,IS,0.23,0.0,Phase3-EA-S4v1-GBPJPY-M5-194,GBPJPYMT4,3404,2d 5h 25m,Buy
171434.65,1.17228,26.03.2018 11:45:00,,0.0,-13.149999999965075,0.0,0.0,1.16947,26.03.2018 03:00:00,15713,-0.00502968470186592,100.79,IS,0.34,0.0,Phase3-EA-S4v1-EURCHF-M15-221,EURCHFMT4,4072,8h 45m,Buy
171396.37,130696,26.03.2018 18:29:58,sl 130.696,-1.13,-51.42999999996391,0.0,0.0,130466,22.03.2018 13:15:00,15714,-0.019671230738971084,-38.28,IS,0.17,0.0,Phase3-EA-T1v2-EURJPY-M15-322,EURJPYMT4,3104,4d 5h 14m,Sell
171457.78,0.94452,27.03.2018 02:14:57,tp 0.94452,0.0,-0.0,0.0,0.0,0.94552,27.03.2018 01:30:00,15715,-0.0,61.41,IS,0.58,0.0,Phase3-EA-SA2v2-USDCHF-M15-107,USDCHFMT4,3092,44m 57s,Sell
171382.31,1.17691,27.03.2018 05:55:00,,-2.17,-75.47000000000116,0.0,0.0,1.17522,26.03.2018 21:35:00,15716,-0.028865081008490456,-75.47,IS,0.41,0.0,Phase3-EA-SA2v2-EURCHF-M5-43,EURCHFMT4,8012,8h 20m,Sell
171320.91,150344,27.03.2018 06:20:00,,0.0,-136.86999999999534,0.0,0.0,150062,27.03.2018 00:55:00,15717,-0.052348796046533634,-61.4,IS,0.23,0.0,Phase3-EA-S4v1-GBPJPY-M5-194,GBPJPYMT4,3406,5h 25m,Sell
171427.9,131709,27.03.2018 11:59:58,tp 131.709,-0.42,-29.880000000004657,0.0,0.0,130449,26.03.2018 17:30:00,15718,-0.0114282313572786,106.99,IS,0.09,0.0,Phase3-EA-TR1v1-EURJPY-M30-91,EURJPYMT4,2776,18h 29m,Buy
171370.78,149275,27.03.2018 14:59:58,sl 149.275,0.0,-87.0,0.0,0.0,149945,27.03.2018 00:30:00,15719,-0.033274970819380294,-57.12,IS,0.09,0.0,Phase3-EA-B1v1-GBPJPY-M30-1,GBPJPYMT4,1434,14h 29m,Buy
171327.72,1.41082,27.03.2018 15:59:58,sl 1.41082,-1.06,-130.05999999999767,0.0,0.0,1.41382,23.03.2018 16:30:00,15720,-0.04974416902032786,-43.06,IS,0.14,0.0,Phase3-EA-B1v1-GBPUSD-M30-14,GBPUSDMT4,1028,3d 23h 29m,Buy
171352.23,0.94668,28.03.2018 07:00:00,,0.0,-105.54999999998836,0.0,0.0,0.94628,28.03.2018 02:45:00,15721,-0.040369806551554054,24.51,IS,0.58,0.0,Phase3-EA-SA2v2-USDCHF-M15-107,USDCHFMT4,3094,4h 15m,Buy
171361.15,1.17535,28.03.2018 07:30:00,,-1.04,-96.62999999997555,0.0,0.0,1.17512,27.03.2018 23:10:00,15722,-0.03695816586524028,8.92,IS,0.41,0.0,Phase3-EA-SA2v2-EURCHF-M5-43,EURCHFMT4,8014,8h 20m,Buy
171407.44,1.17569,28.03.2018 10:00:00,,0.0,-50.339999999967404,0.0,0.0,1.1744,28.03.2018 01:15:00,15723,-0.019253586563753096,46.29,IS,0.34,0.0,Phase3-EA-S4v1-EURCHF-M15-221,EURCHFMT4,4074,8h 45m,Buy
171365.44,1.41665,28.03.2018 12:59:58,sl 1.41665,0.0,-92.3399999999674,0.0,0.0,1.41365,28.03.2018 12:30:00,15724,-0.03531736558000565,-42.0,IS,0.14,0.0,Phase3-EA-B1v1-GBPUSD-M30-14,GBPUSDMT4,1030,29m 58s,Sell
171327.94,131222,28.03.2018 15:59:58,sl 131.222,-0.56,-129.8399999999674,0.0,0.0,130992,27.03.2018 23:45:00,15725,-0.049660025415945434,-37.5,IS,0.17,0.0,Phase3-EA-T1v2-EURJPY-M15-322,EURJPYMT4,3106,16h 14m,Sell
171375.19,1.17899,28.03.2018 21:14:57,tp 1.17899,0.0,-82.5899999999674,0.0,0.0,1.17789,28.03.2018 20:05:00,15726,-0.03158827402266131,47.25,IS,0.41,0.0,Phase3-EA-SA2v2-EURCHF-M5-43,EURCHFMT4,8016,1h 9m,Buy
171315.22,0.95648,29.03.2018 03:00:00,,-9.64,-142.55999999996857,0.0,0.0,0.95565,28.03.2018 22:45:00,15727,-0.054525055632296655,-59.97,IS,0.58,0.0,Phase3-EA-SA2v2-USDCHF-M15-107,USDCHFMT4,3096,4h 15m,Sell
171318.99,1.17799,29.03.2018 06:20:00,,-3.09,-138.78999999997905,0.0,0.0,1.17783,28.03.2018 22:00:00,15728,-0.053083140230127515,3.77,IS,0.41,0.0,Phase3-EA-SA2v2-EURCHF-M5-43,EURCHFMT4,8018,8h 20m,Buy
171295.21,1.17883,29.03.2018 14:45:00,,0.0,-162.56999999997788,0.0,0.0,1.17816,29.03.2018 06:00:00,15729,-0.062178298920757685,-23.78,IS,0.34,0.0,Phase3-EA-S4v1-EURCHF-M15-221,EURCHFMT4,4076,8h 45m,Sell
171342.36,1.17676,29.03.2018 22:59:58,tp 1.17676,0.0,-115.4199999999837,0.0,0.0,1.17566,29.03.2018 21:10:00,15730,-0.04414479462037162,47.15,IS,0.41,0.0,Phase3-EA-SA2v2-EURCHF-M5-43,EURCHFMT4,8020,1h 49m,Buy
171340.97,106424,30.03.2018 05:45:00,,-1.14,-116.80999999999767,0.0,0.0,106423,29.03.2018 22:00:00,15731,-0.044676429211629134,-1.39,IS,0.27,0.0,Phase3-EA-S1v2-USDJPY-M15-0,USDJPYMT4,4518,7h 45m,Sell
171304.16,130944,30.03.2018 08:44:58,sl 130.944,0.0,-153.61999999999534,0.0,0.0,130714,30.03.2018 06:00:00,15732,-0.058755184106586734,-36.81,IS,0.17,0.0,Phase3-EA-T1v2-EURJPY-M15-322,EURJPYMT4,3108,2h 44m,Sell
171262.41,1.17495,30.03.2018 13:30:00,,0.0,-195.36999999999534,0.0,0.0,1.17612,30.03.2018 04:45:00,15733,-0.07472334539059969,-41.75,IS,0.34,0.0,Phase3-EA-S4v1-EURCHF-M15-221,EURCHFMT4,4078,8h 45m,Buy
171309.69,1.17536,30.03.2018 23:54:57,tp 1.17536,0.0,-148.0899999999965,0.0,0.0,1.17426,30.03.2018 22:40:00,15734,-0.05664011986944726,47.28,IS,0.41,0.0,Phase3-EA-SA2v2-EURCHF-M5-43,EURCHFMT4,8022,1h 14m,Buy
171354.07,0.95401,02.04.2018 07:00:00,,0.0,-103.70999999999185,0.0,0.0,0.95474,02.04.2018 02:45:00,15735,-0.039666060042271946,44.38,IS,0.58,0.0,Phase3-EA-SA2v2-USDCHF-M15-107,USDCHFMT4,3098,4h 15m,Sell
171359.22,1.17574,02.04.2018 10:35:00,,0.0,-98.55999999999767,0.0,0.0,1.17586,02.04.2018 02:15:00,15736,-0.03769633475813844,5.15,IS,0.41,0.0,Phase3-EA-SA2v2-EURCHF-M5-43,EURCHFMT4,8024,8h 20m,Sell
171466.87,130326,02.04.2018 19:59:58,tp 130.326,-1.78,-0.0,0.0,0.0,131616,27.03.2018 12:30:00,15737,-0.0,107.65,IS,0.09,0.0,Phase3-EA-TR1v1-EURJPY-M30-91,EURJPYMT4,2778,6d 7h 29m,Sell
171526.85,0.95544,03.04.2018 01:29:58,tp 0.95544,-0.73,-0.0,0.0,0.0,0.95444,02.04.2018 22:15:00,15738,-0.0,59.98,IS,0.58,0.0,Phase3-EA-SA2v2-USDCHF-M15-107,USDCHFMT4,3100,3h 14m,Buy
171573.02,1.17533,03.04.2018 01:29:58,tp 1.17533,-1.03,-0.0,0.0,0.0,1.17423,02.04.2018 22:35:00,15739,-0.0,46.17,IS,0.41,0.0,Phase3-EA-SA2v2-EURCHF-M5-43,EURCHFMT4,8026,2h 54m,Buy
171597.78,105764,03.04.2018 03:45:00,,0.0,-0.0,0.0,0.0,105861,03.04.2018 01:30:00,15740,-0.0,24.76,IS,0.27,0.0,Phase3-EA-S1v2-USDJPY-M15-0,USDJPYMT4,4520,2h 15m,Sell
171555.25,1.40259,03.04.2018 15:29:57,sl 1.40259,-0.53,-42.529999999998836,0.0,0.0,1.40559,02.04.2018 05:30:00,15741,-0.016257783227364774,-42.53,IS,0.14,0.0,Phase3-EA-B1v1-GBPUSD-M30-14,GBPUSDMT4,1032,1d 9h 59m,Buy
171593.0,106.57,03.04.2018 23:00:00,,0.0,-4.779999999998836,0.0,0.0,106421,03.04.2018 22:45:00,15742,-0.0018272326317137744,37.75,IS,0.27,0.0,Phase3-EA-S1v2-USDJPY-M15-0,USDJPYMT4,4522,15m 0s,Buy
171590.47,106562,03.04.2018 23:15:00,,0.0,-7.309999999997672,0.0,0.0,106572,03.04.2018 23:00:00,15743,-0.002794366221302655,-2.53,IS,0.27,0.0,Phase3-EA-S1v2-USDJPY-M15-0,USDJPYMT4,4524,15m 0s,Buy
171647.77,0.9586,04.04.2018 00:59:58,tp 0.95860,-3.2,-0.0,0.0,0.0,0.9596,03.04.2018 22:00:00,15744,-0.0,57.3,IS,0.58,0.0,Phase3-EA-SA2v2-USDCHF-M15-107,USDCHFMT4,3102,2h 59m,Sell
171692.68,1.17574,04.04.2018 01:09:58,tp 1.17574,-2.14,-0.0,0.0,0.0,1.17684,03.04.2018 21:50:00,15745,-0.0,44.91,IS,0.41,0.0,Phase3-EA-SA2v2-EURCHF-M5-43,EURCHFMT4,8028,3h 19m,Sell
171650.68,1.40536,04.04.2018 13:59:58,sl 1.40536,0.0,-42.0,0.0,0.0,1.40836,04.04.2018 12:00:00,15746,-0.016049359882744817,-42.0,IS,0.14,0.0,Phase3-EA-B1v1-GBPUSD-M30-14,GBPUSDMT4,1034,1h 59m,Buy
171694.57,1.1801,05.04.2018 01:04:57,tp 1.18010,-3.07,-0.0,0.0,0.0,1179,04.04.2018 21:25:00,15747,-0.0,43.89,IS,0.41,0.0,Phase3-EA-SA2v2-EURCHF-M5-43,EURCHFMT4,8030,3h 39m,Buy
171673.5,0.96044,05.04.2018 02:30:00,,-9.6,-21.070000000006985,0.0,0.0,0.96025,04.04.2018 22:15:00,15748,-0.008051370725807139,-21.07,IS,0.58,0.0,Phase3-EA-SA2v2-USDCHF-M15-107,USDCHFMT4,3104,4h 15m,Sell
171513.95,106866,05.04.2018 05:00:00,,-3.41,-180.61999999999534,0.0,0.0,106248,04.04.2018 17:00:00,15749,-0.06901939157545163,-159.55,IS,0.27,0.0,Phase3-EA-S1v2-USDJPY-M15-0,USDJPYMT4,4526,12h 0m,Sell
171470.35,1.40545,05.04.2018 10:59:58,sl 1.40545,-1.6,-224.22000000000116,0.0,0.0,1.40845,04.04.2018 18:30:00,15750,-0.08568003531750772,-43.6,IS,0.14,0.0,Phase3-EA-B1v1-GBPUSD-M30-14,GBPUSDMT4,1036,16h 29m,Buy
171495.12,1.17957,05.04.2018 15:15:00,,0.0,-199.45000000001164,0.0,0.0,1.18027,05.04.2018 06:30:00,15751,-0.07621480262277149,24.77,IS,0.34,0.0,Phase3-EA-S4v1-EURCHF-M15-221,EURCHFMT4,4080,8h 45m,Sell
171490.68,131238,05.04.2018 17:30:00,,0.0,-203.89000000001397,0.0,0.0,131266,05.04.2018 11:30:00,15752,-0.07791143698549528,-4.44,IS,0.17,0.0,Phase3-EA-T1v2-EURJPY-M15-322,EURJPYMT4,3110,6h 0m,Buy
171453.43,131181,06.04.2018 03:14:58,sl 131.181,-0.78,-241.14000000001397,0.0,0.0,131411,05.04.2018 19:00:00,15753,-0.0921455878889702,-37.25,IS,0.17,0.0,Phase3-EA-T1v2-EURJPY-M15-322,EURJPYMT4,3112,8h 14m,Buy
171428.72,1.17913,06.04.2018 06:25:00,,-2.13,-265.8500000000058,0.0,0.0,1.1786,05.04.2018 22:05:00,15754,-0.10158789309231918,-24.71,IS,0.41,0.0,Phase3-EA-SA2v2-EURCHF-M5-43,EURCHFMT4,8032,8h 20m,Sell
171399.07,107347,06.04.2018 08:30:00,,-0.73,-295.5,0.0,0.0,107462,05.04.2018 23:45:00,15755,-0.11291789508662652,-29.65,IS,0.27,0.0,Phase3-EA-S1v2-USDJPY-M15-0,USDJPYMT4,4528,8h 45m,Buy
171447.71,150222,06.04.2018 09:05:00,,0.0,-246.85999999998603,0.0,0.0,149995,06.04.2018 03:40:00,15756,-0.09433134206796293,48.64,IS,0.23,0.0,Phase3-EA-S4v1-GBPJPY-M5-194,GBPJPYMT4,3408,5h 25m,Buy
171463.6,1.17907,06.04.2018 14:15:00,,0.0,-230.96999999997206,0.0,0.0,1.17862,06.04.2018 05:30:00,15757,-0.08825937809866319,15.89,IS,0.34,0.0,Phase3-EA-S4v1-EURCHF-M15-221,EURCHFMT4,4082,8h 45m,Buy
171427.1,131176,06.04.2018 19:14:57,sl 131.176,0.0,-267.46999999997206,0.0,0.0,131406,06.04.2018 09:15:00,15758,-0.10220693535978626,-36.5,IS,0.17,0.0,Phase3-EA-T1v2-EURJPY-M15-322,EURJPYMT4,3114,9h 59m,Buy
171390.56,131.23,06.04.2018 21:59:58,sl 131.230,0.0,-304.0099999999802,0.0,0.0,131.46,06.04.2018 20:45:00,15759,-0.11616977761517121,-36.54,IS,0.17,0.0,Phase3-EA-T1v2-EURJPY-M15-322,EURJPYMT4,3116,1h 14m,Buy
171437.57,1.17771,06.04.2018 21:59:58,tp 1.17771,0.0,-256.9999999999709,0.0,0.0,1.17881,06.04.2018 20:45:00,15760,-0.09820608811255407,47.01,IS,0.41,0.0,Phase3-EA-SA2v2-EURCHF-M5-43,EURCHFMT4,8034,1h 14m,Sell
171484.6,1.17767,09.04.2018 02:14:58,tp 1.17767,0.0,-209.96999999997206,0.0,0.0,1.17657,09.04.2018 01:15:00,15761,-0.08023475611281156,47.03,IS,0.41,0.0,Phase3-EA-SA2v2-EURCHF-M5-43,EURCHFMT4,8036,59m 58s,Buy
171495.97,106.89,09.04.2018 03:15:00,,0.0,-198.59999999997672,0.0,0.0,106935,09.04.2018 01:00:00,15762,-0.07588999649475937,11.37,IS,0.27,0.0,Phase3-EA-S1v2-USDJPY-M15-0,USDJPYMT4,4530,2h 15m,Sell
171529.62,1.1783,09.04.2018 10:30:00,,0.0,-164.94999999998254,0.0,0.0,1.17735,09.04.2018 01:45:00,15763,-0.06303149507457553,33.65,IS,0.34,0.0,Phase3-EA-S4v1-EURCHF-M15-221,EURCHFMT4,4084,8h 45m,Buy
171635.62,131716,09.04.2018 16:59:58,tp 131.716,-2.47,-58.94999999998254,0.0,0.0,130426,03.04.2018 08:30:00,15764,-0.02252626028884826,106.0,IS,0.09,0.0,Phase3-EA-TR1v1-EURJPY-M30-91,EURJPYMT4,2780,6d 8h 29m,Buy
171682.76,1.1785,09.04.2018 22:09:57,tp 1.17850,0.0,-11.809999999968568,0.0,0.0,1.1796,09.04.2018 20:20:00,15765,-0.004512894554888358,47.14,IS,0.41,0.0,Phase3-EA-SA2v2-EURCHF-M5-43,EURCHFMT4,8038,1h 49m,Sell
171662.01,0.95608,10.04.2018 03:15:00,,-0.73,-32.55999999996857,0.0,0.0,0.95641,09.04.2018 23:00:00,15766,-0.012441985326622707,-20.75,IS,0.58,0.0,Phase3-EA-SA2v2-USDCHF-M15-107,USDCHFMT4,3106,4h 15m,Buy
171672.11,1.17885,10.04.2018 06:30:00,,-1.03,-22.459999999962747,0.0,0.0,1.17859,09.04.2018 22:10:00,15767,-0.008582524276282318,10.1,IS,0.41,0.0,Phase3-EA-SA2v2-EURCHF-M5-43,EURCHFMT4,8040,8h 20m,Buy
171675.66,1.1782,10.04.2018 10:00:00,,0.0,-18.90999999997439,0.0,0.0,1.1781,10.04.2018 01:15:00,15768,-0.007225981035821372,3.55,IS,0.34,0.0,Phase3-EA-S4v1-EURCHF-M15-221,EURCHFMT4,4086,8h 45m,Buy
171768.22,132301,11.04.2018 06:00:00,,-0.78,-0.0,0.0,0.0,131713,10.04.2018 06:15:00,15769,-0.0,92.56,IS,0.17,0.0,Phase3-EA-T1v2-EURJPY-M15-322,EURJPYMT4,3118,23h 45m,Buy
171746.37,1.18261,11.04.2018 07:10:00,,-2.14,-21.85000000000582,0.0,0.0,1.18215,10.04.2018 22:50:00,15770,-0.008347078954047859,-21.85,IS,0.41,0.0,Phase3-EA-SA2v2-EURCHF-M5-43,EURCHFMT4,8042,8h 20m,Sell
171680.95,106895,11.04.2018 20:30:00,,0.0,-87.27000000001863,0.0,0.0,107154,11.04.2018 00:30:00,15771,-0.03333865356154316,-65.42,IS,0.27,0.0,Phase3-EA-S1v2-USDJPY-M15-0,USDJPYMT4,4532,20h 0m,Buy
171728.02,1.18484,11.04.2018 21:59:58,tp 1.18484,0.0,-40.20000000001164,0.0,0.0,1.18594,11.04.2018 20:10:00,15772,-0.015357097206074678,47.07,IS,0.41,0.0,Phase3-EA-SA2v2-EURCHF-M5-43,EURCHFMT4,8044,1h 49m,Sell
171718.33,0.95754,12.04.2018 05:00:00,,0.0,-49.89000000001397,0.0,0.0,0.9577,12.04.2018 00:45:00,15773,-0.019058845263956674,-9.69,IS,0.58,0.0,Phase3-EA-SA2v2-USDCHF-M15-107,USDCHFMT4,3108,4h 15m,Buy
171701.13,1.18482,12.04.2018 06:20:00,,-3.08,-67.09000000002561,0.0,0.0,1.18515,11.04.2018 22:00:00,15774,-0.025629543571035945,-17.2,IS,0.41,0.0,Phase3-EA-SA2v2-EURCHF-M5-43,EURCHFMT4,8046,8h 20m,Buy
171775.58,1.18631,12.04.2018 10:30:00,,0.0,-0.0,0.0,0.0,1.18421,12.04.2018 01:45:00,15775,-0.0,74.45,IS,0.34,0.0,Phase3-EA-S4v1-EURCHF-M15-221,EURCHFMT4,4088,8h 45m,Buy
171731.98,1.41577,12.04.2018 12:59:58,sl 1.41577,-1.6,-43.60000000000582,0.0,0.0,1.41877,11.04.2018 09:30:00,15776,-0.016655487880116848,-43.6,IS,0.14,0.0,Phase3-EA-B1v1-GBPUSD-M30-14,GBPUSDMT4,1038,1d 3h 29m,Buy
171694.98,132337,13.04.2018 00:59:58,sl 132.337,-0.55,-80.60000000000582,0.0,0.0,132107,12.04.2018 08:45:00,15777,-0.03078973218204898,-37.0,IS,0.17,0.0,Phase3-EA-T1v2-EURJPY-M15-322,EURJPYMT4,3120,16h 14m,Sell
171691.23,107292,13.04.2018 01:00:00,,-0.73,-84.35000000000582,0.0,0.0,107304,12.04.2018 20:30:00,15778,-0.03222225694237994,-3.75,IS,0.27,0.0,Phase3-EA-S1v2-USDJPY-M15-0,USDJPYMT4,4534,4h 30m,Buy
171735.99,1.18554,13.04.2018 01:04:58,tp 1.18554,-2.13,-39.58999999999651,0.0,0.0,1.18664,12.04.2018 23:40:00,15779,-0.01512364140306605,44.76,IS,0.41,0.0,Phase3-EA-SA2v2-EURCHF-M5-43,EURCHFMT4,8048,1h 24m,Sell
171744.85,0.96234,13.04.2018 04:00:00,,-3.19,-30.730000000010477,0.0,0.0,0.96254,12.04.2018 23:45:00,15780,-0.011739062902662772,8.86,IS,0.58,0.0,Phase3-EA-SA2v2-USDCHF-M15-107,USDCHFMT4,3110,4h 15m,Sell
171791.69,1.18698,13.04.2018 04:49:58,tp 1.18698,0.0,-0.0,0.0,0.0,1.18588,13.04.2018 01:10:00,15781,-0.0,46.84,IS,0.41,0.0,Phase3-EA-SA2v2-EURCHF-M5-43,EURCHFMT4,8050,3h 39m,Buy
171875.16,153013,13.04.2018 05:34:57,tp 153.013,0.0,-0.0,0.0,0.0,152623,13.04.2018 03:10:00,15782,-0.0,83.47,IS,0.23,0.0,Phase3-EA-S4v1-GBPJPY-M5-194,GBPJPYMT4,3410,2h 24m,Buy
171899.91,1.18613,13.04.2018 14:45:00,,0.0,-0.0,0.0,0.0,1.18683,13.04.2018 06:00:00,15783,-0.0,24.75,IS,0.34,0.0,Phase3-EA-S4v1-EURCHF-M15-221,EURCHFMT4,4090,8h 45m,Sell
171944.65,1.18576,16.04.2018 01:00:00,tp 1.18576,-2.13,-0.0,0.0,0.0,1.18686,13.04.2018 20:30:00,15784,-0.0,44.74,IS,0.41,0.0,Phase3-EA-SA2v2-EURCHF-M5-43,EURCHFMT4,8052,2d 4h 30m,Sell
171991.55,1.18607,16.04.2018 01:04:57,tp 1.18607,0.0,-0.0,0.0,0.0,1.18497,16.04.2018 01:00:00,15785,-0.0,46.9,IS,0.41,0.0,Phase3-EA-SA2v2-EURCHF-M5-43,EURCHFMT4,8054,4m 57s,Buy
172033.82,153046,16.04.2018 04:35:00,,-0.77,-0.0,0.0,0.0,152845,13.04.2018 23:10:00,15786,-0.0,42.27,IS,0.23,0.0,Phase3-EA-S4v1-GBPJPY-M5-194,GBPJPYMT4,3412,2d 5h 25m,Buy
171997.38,132351,16.04.2018 06:59:58,sl 132.351,0.0,-36.44000000000233,0.0,0.0,132581,16.04.2018 02:45:00,15787,-0.013906601827200065,-36.44,IS,0.17,0.0,Phase3-EA-T1v2-EURJPY-M15-322,EURJPYMT4,3122,4h 14m,Buy
172053.89,1.18762,16.04.2018 10:30:00,,0.0,-0.0,0.0,0.0,1.18602,16.04.2018 01:45:00,15788,-0.0,56.51,IS,0.34,0.0,Phase3-EA-S4v1-EURCHF-M15-221,EURCHFMT4,4092,8h 45m,Buy
172069.22,1.18714,16.04.2018 11:10:00,,0.0,-0.0,0.0,0.0,1.1875,16.04.2018 02:50:00,15789,-0.0,15.33,IS,0.41,0.0,Phase3-EA-SA2v2-EURCHF-M5-43,EURCHFMT4,8056,8h 20m,Sell
172015.83,1.18883,17.04.2018 05:45:00,,-2.14,-53.39000000001397,0.0,0.0,1.18763,16.04.2018 21:25:00,15790,-0.020372480217254695,-53.39,IS,0.41,0.0,Phase3-EA-SA2v2-EURCHF-M5-43,EURCHFMT4,8058,8h 20m,Sell
171979.28,132434,17.04.2018 13:14:57,sl 132.434,0.0,-89.94000000000233,0.0,0.0,132664,17.04.2018 11:15:00,15791,-0.03431917720058916,-36.55,IS,0.17,0.0,Phase3-EA-T1v2-EURJPY-M15-322,EURJPYMT4,3124,1h 59m,Buy
171896.22,1.19094,17.04.2018 13:45:00,,0.0,-173.0,0.0,0.0,1.18859,17.04.2018 05:00:00,15792,-0.06601309379254804,-83.06,IS,0.34,0.0,Phase3-EA-S4v1-EURCHF-M15-221,EURCHFMT4,4094,8h 45m,Sell
171854.22,1.4309,17.04.2018 14:29:58,sl 1.43090,0.0,-215.0,0.0,0.0,1.4339,17.04.2018 07:00:00,15793,-0.08203939401964062,-42.0,IS,0.14,0.0,Phase3-EA-B1v1-GBPUSD-M30-14,GBPUSDMT4,1040,7h 29m,Buy
171913.5,0.96674,18.04.2018 02:14:58,tp 0.96674,-0.72,-155.72000000000116,0.0,0.0,0.96574,17.04.2018 22:30:00,15794,-0.059419415984830394,59.28,IS,0.58,0.0,Phase3-EA-SA2v2-USDCHF-M15-107,USDCHFMT4,3112,3h 44m,Buy
171784.17,1.19625,18.04.2018 04:20:00,,-2.12,-285.04999999998836,0.0,0.0,1.19325,17.04.2018 20:00:00,15795,-0.10876897332696561,-129.33,IS,0.41,0.0,Phase3-EA-SA2v2-EURCHF-M5-43,EURCHFMT4,8060,8h 20m,Sell
171747.16,132.77,18.04.2018 05:59:58,sl 132.770,-0.56,-322.0599999999977,0.0,0.0,132.54,17.04.2018 13:30:00,15796,-0.12289119645565243,-37.01,IS,0.17,0.0,Phase3-EA-T1v2-EURJPY-M15-322,EURJPYMT4,3126,16h 29m,Sell
171676.16,1.19697,18.04.2018 09:45:00,,0.0,-393.0599999999977,0.0,0.0,1.19495,18.04.2018 01:00:00,15797,-0.14998327541097561,-71.0,IS,0.34,0.0,Phase3-EA-S4v1-EURCHF-M15-221,EURCHFMT4,4096,8h 45m,Sell
171619.05,152058,18.04.2018 13:29:57,sl 152.058,-0.9,-450.1699999999837,0.0,0.0,152728,13.04.2018 01:30:00,15798,-0.17177522793404784,-57.11,IS,0.09,0.0,Phase3-EA-B1v1-GBPJPY-M30-1,GBPJPYMT4,1436,5d 11h 59m,Buy
171597.54,132698,19.04.2018 00:45:00,,-2.33,-471.679999999993,0.0,0.0,132819,18.04.2018 16:15:00,15799,-0.17998298312178382,-21.51,IS,0.17,0.0,Phase3-EA-T1v2-EURJPY-M15-322,EURJPYMT4,3128,8h 30m,Buy
171529.39,1.1988,19.04.2018 04:40:00,,-6.35,-539.8299999999872,0.0,0.0,1.19734,18.04.2018 20:20:00,15800,-0.2059875631331235,-68.15,IS,0.41,0.0,Phase3-EA-SA2v2-EURCHF-M5-43,EURCHFMT4,8062,8h 20m,Sell
171507.25,1.19945,19.04.2018 11:30:00,,0.0,-561.9700000000012,0.0,0.0,1.19882,19.04.2018 02:45:00,15801,-0.21443571282426763,-22.14,IS,0.34,0.0,Phase3-EA-S4v1-EURCHF-M15-221,EURCHFMT4,4098,8h 45m,Sell
171551.57,1.19886,20.04.2018 01:04:59,tp 1.19886,-2.11,-517.6499999999942,0.0,0.0,1.19996,19.04.2018 22:15:00,15802,-0.19752415029891393,44.32,IS,0.41,0.0,Phase3-EA-SA2v2-EURCHF-M5-43,EURCHFMT4,8064,2h 49m,Sell
171597.95,1.20008,20.04.2018 09:24:57,tp 1.20008,0.0,-471.2699999999895,0.0,0.0,1.19898,20.04.2018 01:10:00,15803,-0.17982653590527992,46.38,IS,0.41,0.0,Phase3-EA-SA2v2-EURCHF-M5-43,EURCHFMT4,8066,8h 14m,Buy
171558.04,1.19781,23.04.2018 04:45:00,,-2.1,-511.179999999993,0.0,0.0,1.19691,20.04.2018 20:25:00,15804,-0.19505533690678756,-39.91,IS,0.41,0.0,Phase3-EA-SA2v2-EURCHF-M5-43,EURCHFMT4,8068,2d 8h 20m,Sell
171615.08,151052,23.04.2018 05:05:00,,-0.77,-454.13999999998487,0.0,0.0,150781,20.04.2018 23:40:00,15805,-0.17329009488408537,57.04,IS,0.23,0.0,Phase3-EA-S4v1-GBPJPY-M5-194,GBPJPYMT4,3414,2d 5h 25m,Buy
171588.25,1.19717,23.04.2018 09:45:00,,0.0,-480.96999999997206,0.0,0.0,1.1964,23.04.2018 01:00:00,15806,-0.18352784810057796,-26.83,IS,0.34,0.0,Phase3-EA-S4v1-EURCHF-M15-221,EURCHFMT4,4100,8h 45m,Sell
171576.23,107809,23.04.2018 09:45:00,,0.0,-492.9899999999616,0.0,0.0,107761,23.04.2018 01:00:00,15807,-0.18811442259413713,-12.02,IS,0.27,0.0,Phase3-EA-S1v2-USDJPY-M15-0,USDJPYMT4,4536,8h 45m,Sell
171540.0,132154,23.04.2018 12:29:58,sl 132.154,0.0,-529.2199999999721,0.0,0.0,132384,23.04.2018 10:30:00,15808,-0.20193901443289267,-36.23,IS,0.17,0.0,Phase3-EA-T1v2-EURJPY-M15-322,EURJPYMT4,3130,1h 59m,Buy
171503.86,132409,23.04.2018 14:14:58,sl 132.409,0.0,-565.359999999986,0.0,0.0,132179,23.04.2018 12:30:00,15809,-0.21572926419973432,-36.14,IS,0.17,0.0,Phase3-EA-T1v2-EURJPY-M15-322,EURJPYMT4,3132,1h 44m,Sell
171447.77,151417,23.04.2018 19:29:58,sl 151.417,-0.48,-621.4499999999825,0.0,0.0,150747,20.04.2018 23:30:00,15810,-0.2371320065744383,-56.09,IS,0.09,0.0,Phase3-EA-B1v1-GBPJPY-M30-1,GBPJPYMT4,1438,2d 19h 59m,Sell
171710.99,1.39357,23.04.2018 21:29:57,tp 1.39357,-1.38,-358.2299999999814,0.0,0.0,1.41247,19.04.2018 21:30:00,15811,-0.13669289357978762,263.22,IS,0.14,0.0,Phase3-EA-B1v1-GBPUSD-M30-14,GBPUSDMT4,1042,3d 23h 59m,Sell
171748.3,1.19377,24.04.2018 05:10:00,,-2.09,-320.9199999999837,0.0,0.0,1.19471,23.04.2018 20:50:00,15812,-0.12245619687805458,37.31,IS,0.41,0.0,Phase3-EA-SA2v2-EURCHF-M5-43,EURCHFMT4,8070,8h 20m,Sell
171734.56,151672,24.04.2018 09:20:00,,0.0,-334.6599999999744,0.0,0.0,151607,24.04.2018 03:55:00,15813,-0.12769908652377132,-13.74,IS,0.23,0.0,Phase3-EA-S4v1-GBPJPY-M5-194,GBPJPYMT4,3416,5h 25m,Sell
171727.6,1.19337,24.04.2018 14:15:00,,0.0,-341.61999999996624,0.0,0.0,1.19357,24.04.2018 05:30:00,15814,-0.13035487341854354,-6.96,IS,0.34,0.0,Phase3-EA-S4v1-EURCHF-M15-221,EURCHFMT4,4102,8h 45m,Buy
171734.32,132912,24.04.2018 15:00:00,,0.0,-334.8999999999651,0.0,0.0,132869,24.04.2018 14:15:00,15815,-0.1277906653822083,6.72,IS,0.17,0.0,Phase3-EA-T1v2-EURJPY-M15-322,EURJPYMT4,3134,45m 0s,Buy
171832.25,133142,24.04.2018 17:29:58,tp 133.142,-6.16,-236.96999999997206,0.0,0.0,131882,09.04.2018 20:30:00,15816,-0.09042267535270673,97.93,IS,0.09,0.0,Phase3-EA-TR1v1-EURJPY-M30-91,EURJPYMT4,2782,14d 20h 59m,Buy
171820.44,152337,25.04.2018 09:15:00,,0.0,-248.77999999996973,0.0,0.0,152281,25.04.2018 03:50:00,15817,-0.09492911834513355,-11.81,IS,0.23,0.0,Phase3-EA-S4v1-GBPJPY-M5-194,GBPJPYMT4,3418,5h 25m,Sell
171790.32,1.19917,25.04.2018 14:30:00,,0.0,-278.8999999999651,0.0,0.0,1.1983,25.04.2018 05:45:00,15818,-0.10642226507941817,-30.12,IS,0.34,0.0,Phase3-EA-S4v1-EURCHF-M15-221,EURCHFMT4,4104,8h 45m,Sell
171787.98,133161,25.04.2018 14:45:00,,0.0,-281.2399999999616,0.0,0.0,133176,25.04.2018 02:30:00,15819,-0.107315158949212,-2.34,IS,0.17,0.0,Phase3-EA-T1v2-EURJPY-M15-322,EURJPYMT4,3136,12h 15m,Buy
171659.9,109297,26.04.2018 04:15:00,,-3.33,-409.3199999999488,0.0,0.0,108792,25.04.2018 00:45:00,15820,-0.15618774307030278,-128.08,IS,0.27,0.0,Phase3-EA-S1v2-USDJPY-M15-0,USDJPYMT4,4538,1d 3h 30m,Sell
171664.03,0.98277,26.04.2018 04:30:00,,0.0,-405.1899999999441,0.0,0.0,0.98284,26.04.2018 00:15:00,15821,-0.15461182354797023,4.13,IS,0.58,0.0,Phase3-EA-SA2v2-USDCHF-M15-107,USDCHFMT4,3114,4h 15m,Sell
171668.54,1.19639,26.04.2018 07:00:00,,-3.0,-400.6799999999348,0.0,0.0,1.19621,25.04.2018 22:40:00,15822,-0.1528909041664384,4.51,IS,0.41,0.0,Phase3-EA-SA2v2-EURCHF-M5-43,EURCHFMT4,8072,8h 20m,Buy
171718.34,1.19726,26.04.2018 11:00:00,,0.0,-350.87999999994645,0.0,0.0,1.19582,26.04.2018 02:15:00,15823,-0.13388829104003308,49.8,IS,0.34,0.0,Phase3-EA-S4v1-EURCHF-M15-221,EURCHFMT4,4106,8h 45m,Buy
171763.96,1.19663,26.04.2018 22:44:58,tp 1.19663,0.0,-305.2599999999511,0.0,0.0,1.19773,26.04.2018 21:10:00,15824,-0.11648067636479761,45.62,IS,0.41,0.0,Phase3-EA-SA2v2-EURCHF-M5-43,EURCHFMT4,8074,1h 34m,Sell
171819.57,0.98782,27.04.2018 01:14:57,tp 0.98782,-3.11,-249.64999999996508,0.0,0.0,0.98882,26.04.2018 22:45:00,15825,-0.09526109170697869,55.61,IS,0.58,0.0,Phase3-EA-SA2v2-USDCHF-M15-107,USDCHFMT4,3116,2h 29m,Sell
171799.13,152008,27.04.2018 06:35:00,,0.0,-270.0899999999674,0.0,0.0,152105,27.04.2018 01:10:00,15826,-0.10306055781749797,-20.44,IS,0.23,0.0,Phase3-EA-S4v1-GBPJPY-M5-194,GBPJPYMT4,3420,5h 25m,Buy
171813.21,1.1973,27.04.2018 10:30:00,,0.0,-256.0099999999802,0.0,0.0,1.19764,27.04.2018 02:10:00,15827,-0.09768793145565849,14.08,IS,0.41,0.0,Phase3-EA-SA2v2-EURCHF-M5-43,EURCHFMT4,8076,8h 20m,Sell
171756.91,151757,27.04.2018 11:59:58,sl 151.757,-1.19,-312.30999999996857,0.0,0.0,152427,25.04.2018 08:00:00,15828,-0.11917080533149482,-56.3,IS,0.09,0.0,Phase3-EA-B1v1-GBPJPY-M30-1,GBPJPYMT4,1440,2d 3h 59m,Buy
171780.27,0.98828,30.04.2018 03:15:00,,-0.7,-288.94999999998254,0.0,0.0,0.98787,27.04.2018 23:00:00,15829,-0.11025712977662198,23.36,IS,0.58,0.0,Phase3-EA-SA2v2-USDCHF-M15-107,USDCHFMT4,3118,2d 4h 15m,Buy
171721.36,1.19841,30.04.2018 06:40:00,,-2.08,-347.85999999998603,0.0,0.0,1.19704,27.04.2018 22:20:00,15830,-0.13273592373800486,-58.91,IS,0.41,0.0,Phase3-EA-SA2v2-EURCHF-M5-43,EURCHFMT4,8078,2d 8h 20m,Sell
171760.16,1.19716,30.04.2018 15:15:00,,0.0,-309.0599999999977,0.0,0.0,1.19829,30.04.2018 06:30:00,15831,-0.11793067495679042,38.8,IS,0.34,0.0,Phase3-EA-S4v1-EURCHF-M15-221,EURCHFMT4,4108,8h 45m,Sell
171771.73,150.49,01.05.2018 09:15:00,,0.0,-297.4899999999907,0.0,0.0,150545,01.05.2018 03:50:00,15832,-0.11351581082280059,11.57,IS,0.23,0.0,Phase3-EA-S4v1-GBPJPY-M5-194,GBPJPYMT4,3422,5h 25m,Sell
171793.63,1.19628,01.05.2018 12:45:00,,0.0,-275.5899999999965,0.0,0.0,1.19692,01.05.2018 04:00:00,15833,-0.10515923999010453,21.9,IS,0.34,0.0,Phase3-EA-S4v1-EURCHF-M15-221,EURCHFMT4,4110,8h 45m,Sell
171897.51,131811,01.05.2018 16:29:57,tp 131.811,-2.02,-171.70999999999185,0.0,0.0,133101,24.04.2018 20:30:00,15834,-0.06552085742842709,103.88,IS,0.09,0.0,Phase3-EA-TR1v1-EURJPY-M30-91,EURJPYMT4,2784,6d 19h 59m,Sell
171899.72,109742,01.05.2018 18:30:00,,0.0,-169.5,0.0,0.0,109733,01.05.2018 18:15:00,15835,-0.06467756877362366,2.21,IS,0.27,0.0,Phase3-EA-S1v2-USDJPY-M15-0,USDJPYMT4,4540,15m 0s,Buy
171942.9,1.19412,02.05.2018 01:04:58,tp 1.19412,-2.06,-126.32000000000698,0.0,0.0,1.19522,01.05.2018 22:35:00,15836,-0.0482010058258678,43.18,IS,0.41,0.0,Phase3-EA-SA2v2-EURCHF-M5-43,EURCHFMT4,8080,2h 29m,Sell
171929.34,0.99649,02.05.2018 02:45:00,,-3.08,-139.88000000000466,0.0,0.0,0.99631,01.05.2018 22:30:00,15837,-0.05337521132775681,-13.56,IS,0.58,0.0,Phase3-EA-SA2v2-USDCHF-M15-107,USDCHFMT4,3120,4h 15m,Sell
172190.47,131.33,02.05.2018 23:44:57,tp 131.330,-2.17,-0.0,0.0,0.0,133.03,26.04.2018 01:15:00,15838,-0.0,261.13,IS,0.17,0.0,Phase3-EA-T1v2-EURJPY-M15-322,EURJPYMT4,3138,6d 22h 29m,Sell
172248.57,0.99827,03.05.2018 01:14:57,tp 0.99827,0.0,-0.0,0.0,0.0,0.99927,03.05.2018 00:15:00,15839,-0.0,58.1,IS,0.58,0.0,Phase3-EA-SA2v2-USDCHF-M15-107,USDCHFMT4,3122,59m 57s,Sell
172250.71,149084,03.05.2018 04:55:00,,-2.26,-0.0,0.0,0.0,149063,02.05.2018 23:30:00,15840,-0.0,2.14,IS,0.23,0.0,Phase3-EA-S4v1-GBPJPY-M5-194,GBPJPYMT4,3424,5h 25m,Buy
172286.4,1.19499,03.05.2018 08:05:00,,-2.95,-0.0,0.0,0.0,1.19405,02.05.2018 23:45:00,15841,-0.0,35.69,IS,0.41,0.0,Phase3-EA-SA2v2-EURCHF-M5-43,EURCHFMT4,8082,8h 20m,Buy
172221.06,130998,03.05.2018 15:59:58,sl 130.998,-1.2,-65.34000000002561,0.0,0.0,131778,02.05.2018 01:00:00,15842,-0.02491169957726564,-65.34,IS,0.09,0.0,Phase3-EA-TR1v1-EURJPY-M30-91,EURJPYMT4,2786,1d 14h 59m,Buy
172212.53,109153,04.05.2018 03:15:00,,-1.11,-73.87000000005355,0.0,0.0,109123,03.05.2018 21:30:00,15843,-0.02816386972410814,-8.53,IS,0.27,0.0,Phase3-EA-S1v2-USDJPY-M15-0,USDJPYMT4,4542,5h 45m,Sell
172226.51,1.19595,04.05.2018 06:40:00,,-2.05,-59.89000000007218,0.0,0.0,1.19634,03.05.2018 22:20:00,15844,-0.022833818299413108,13.98,IS,0.41,0.0,Phase3-EA-SA2v2-EURCHF-M5-43,EURCHFMT4,8084,8h 20m,Sell
172230.99,109142,07.05.2018 03:15:00,,-0.72,-55.410000000090804,0.0,0.0,109121,04.05.2018 23:15:00,15845,-0.021125761762748857,4.48,IS,0.27,0.0,Phase3-EA-S1v2-USDJPY-M15-0,USDJPYMT4,4544,2d 4h 0m,Buy
172199.41,1.19599,07.05.2018 04:50:00,,-2.05,-86.9900000001071,0.0,0.0,1.19527,04.05.2018 20:30:00,15846,-0.03316603529580895,-31.58,IS,0.41,0.0,Phase3-EA-SA2v2-EURCHF-M5-43,EURCHFMT4,8086,2d 8h 20m,Sell
172281.86,147383,07.05.2018 05:19:58,tp 147.383,0.0,-4.540000000095461,0.0,0.0,147773,07.05.2018 03:35:00,15847,-0.0017309322938953132,82.45,IS,0.23,0.0,Phase3-EA-S4v1-GBPJPY-M5-194,GBPJPYMT4,3426,1h 44m,Sell
172241.23,0.99917,07.05.2018 05:45:00,,0.0,-45.17000000010012,0.0,0.0,0.99987,07.05.2018 01:30:00,15848,-0.017221632536075025,-40.63,IS,0.58,0.0,Phase3-EA-SA2v2-USDCHF-M15-107,USDCHFMT4,3124,4h 15m,Buy
172199.23,1.35489,07.05.2018 16:59:58,sl 1.35489,0.0,-87.17000000010012,0.0,0.0,1.35189,07.05.2018 16:00:00,15849,-0.033234662567368976,-42.0,IS,0.14,0.0,Phase3-EA-B1v1-GBPUSD-M30-14,GBPUSDMT4,1044,59m 58s,Sell
172213.6,109009,08.05.2018 03:45:00,,0.0,-72.80000000010477,0.0,0.0,109067,08.05.2018 01:15:00,15850,-0.027755918720949464,14.37,IS,0.27,0.0,Phase3-EA-S1v2-USDJPY-M15-0,USDJPYMT4,4546,2h 30m,Sell
172167.86,1.00185,08.05.2018 05:00:00,,0.0,-118.54000000009546,0.0,0.0,1.00264,08.05.2018 00:45:00,15851,-0.045194870950264615,-45.74,IS,0.58,0.0,Phase3-EA-SA2v2-USDCHF-M15-107,USDCHFMT4,3126,4h 15m,Buy
172202.86,147788,08.05.2018 08:30:00,,0.0,-83.54000000009546,0.0,0.0,147954,08.05.2018 03:05:00,15852,-0.03185067925751965,35.0,IS,0.23,0.0,Phase3-EA-S4v1-GBPJPY-M5-194,GBPJPYMT4,3428,5h 25m,Sell
172200.41,1.19538,08.05.2018 08:55:00,,0.0,-85.9900000001071,0.0,0.0,1.19544,08.05.2018 00:35:00,15853,-0.03278477267601624,-2.45,IS,0.41,0.0,Phase3-EA-SA2v2-EURCHF-M5-43,EURCHFMT4,8088,8h 20m,Buy
172303.64,129661,08.05.2018 12:29:57,tp 129.661,-0.87,-0.0,0.0,0.0,130921,03.05.2018 18:00:00,15854,-0.0,103.23,IS,0.09,0.0,Phase3-EA-TR1v1-EURJPY-M30-91,EURJPYMT4,2788,4d 18h 29m,Sell
172567.27,129586,08.05.2018 12:29:58,tp 129.586,-1.64,-0.0,0.0,0.0,131286,03.05.2018 14:15:00,15855,-0.0,263.63,IS,0.17,0.0,Phase3-EA-T1v2-EURJPY-M15-322,EURJPYMT4,3140,4d 22h 14m,Sell
172435.11,1.19145,08.05.2018 13:44:58,sl 1.19145,0.0,-132.1599999999744,0.0,0.0,1.19535,08.05.2018 06:15:00,15856,-0.050333767799761855,-132.16,IS,0.34,0.0,Phase3-EA-S4v1-EURCHF-M15-221,EURCHFMT4,4112,7h 29m,Buy
172480.12,1.18914,08.05.2018 21:59:59,tp 1.18914,0.0,-87.14999999996508,0.0,0.0,1.19024,08.05.2018 20:50:00,15857,-0.033191494126425074,45.01,IS,0.41,0.0,Phase3-EA-SA2v2-EURCHF-M5-43,EURCHFMT4,8090,1h 9m,Sell
172420.76,130.15,09.05.2018 12:59:58,sl 130.150,-0.29,-146.5099999999511,0.0,0.0,129.43,08.05.2018 15:00:00,15858,-0.05579903390089344,-59.36,IS,0.09,0.0,Phase3-EA-TR1v1-EURJPY-M30-91,EURJPYMT4,2790,21h 59m,Sell
172459.51,1.19045,10.05.2018 01:04:58,tp 1.19045,-6.12,-107.7599999999511,0.0,0.0,1.19155,09.05.2018 22:00:00,15859,-0.041040911153911376,38.75,IS,0.41,0.0,Phase3-EA-SA2v2-EURCHF-M5-43,EURCHFMT4,8092,3h 4m,Sell
172480.74,1.19107,10.05.2018 09:30:00,,0.0,-86.52999999996973,0.0,0.0,1.19055,10.05.2018 01:10:00,15860,-0.03295536416247513,21.23,IS,0.41,0.0,Phase3-EA-SA2v2-EURCHF-M5-43,EURCHFMT4,8094,8h 20m,Buy
172523.18,109426,10.05.2018 21:15:00,,0.0,-44.089999999967404,0.0,0.0,109598,10.05.2018 19:00:00,15861,-0.01679188727519892,42.44,IS,0.27,0.0,Phase3-EA-S1v2-USDJPY-M15-0,USDJPYMT4,4548,2h 15m,Sell
172539.54,130242,11.05.2018 05:00:00,,-0.76,-27.729999999981374,0.0,0.0,130132,10.05.2018 04:00:00,15862,-0.010561103065123556,16.36,IS,0.17,0.0,Phase3-EA-T1v2-EURJPY-M15-322,EURJPYMT4,3142,1d 1h 0m,Buy
172516.63,1.19509,11.05.2018 05:10:00,,-2.05,-50.63999999995576,0.0,0.0,1.19458,10.05.2018 20:50:00,15863,-0.019286486087910167,-22.91,IS,0.41,0.0,Phase3-EA-SA2v2-EURCHF-M5-43,EURCHFMT4,8096,8h 20m,Sell
172506.8,1.00267,11.05.2018 05:15:00,,0.0,-60.46999999997206,0.0,0.0,1.0025,11.05.2018 01:00:00,15864,-0.023030288580892726,-9.83,IS,0.58,0.0,Phase3-EA-SA2v2-USDCHF-M15-107,USDCHFMT4,3128,4h 15m,Sell
172471.08,130241,11.05.2018 10:29:58,sl 130.241,0.0,-96.18999999994412,0.0,0.0,130471,11.05.2018 08:00:00,15865,-0.0366344213427453,-35.72,IS,0.17,0.0,Phase3-EA-T1v2-EURJPY-M15-322,EURJPYMT4,3144,2h 29m,Buy
172514.12,1.19365,14.05.2018 01:00:00,tp 1.19365,-2.05,-53.149999999965075,0.0,0.0,1.19475,11.05.2018 20:05:00,15866,-0.020242431587137583,43.04,IS,0.41,0.0,Phase3-EA-SA2v2-EURCHF-M5-43,EURCHFMT4,8098,2d 4h 55m,Sell
172448.45,130831,14.05.2018 07:29:58,sl 130.831,-1.44,-118.81999999994878,0.0,0.0,130051,09.05.2018 20:30:00,15867,-0.04525316502698459,-65.67,IS,0.09,0.0,Phase3-EA-TR1v1-EURJPY-M30-91,EURJPYMT4,2792,4d 10h 59m,Sell
172504.55,1.19595,14.05.2018 10:45:00,,0.0,-62.71999999997206,0.0,0.0,1.1943,14.05.2018 02:00:00,15868,-0.023887211837169107,56.1,IS,0.34,0.0,Phase3-EA-S4v1-EURCHF-M15-221,EURCHFMT4,4114,8h 45m,Buy
172525.98,109596,14.05.2018 18:30:00,,0.0,-41.289999999979045,0.0,0.0,109509,14.05.2018 17:00:00,15869,-0.015725493889614976,21.43,IS,0.27,0.0,Phase3-EA-S1v2-USDJPY-M15-0,USDJPYMT4,4550,1h 30m,Buy
172569.02,1.19378,15.05.2018 00:14:57,tp 1.19378,-2.05,-0.0,0.0,0.0,1.19488,14.05.2018 20:25:00,15870,-0.0,43.04,IS,0.41,0.0,Phase3-EA-SA2v2-EURCHF-M5-43,EURCHFMT4,8100,3h 49m,Sell
172554.93,1.00032,15.05.2018 02:30:00,,-3.07,-14.090000000025611,0.0,0.0,1.00013,14.05.2018 22:15:00,15871,-0.005366208092647619,-14.09,IS,0.58,0.0,Phase3-EA-SA2v2-USDCHF-M15-107,USDCHFMT4,3130,4h 15m,Sell
172548.38,1.19363,15.05.2018 08:40:00,,0.0,-20.64000000001397,0.0,0.0,1.19379,15.05.2018 00:20:00,15872,-0.007860790279071717,-6.55,IS,0.41,0.0,Phase3-EA-SA2v2-EURCHF-M5-43,EURCHFMT4,8102,8h 20m,Buy
172566.39,1.19376,15.05.2018 11:00:00,,0.0,-2.6300000000046566,0.0,0.0,1.19323,15.05.2018 02:15:00,15873,-0.0010016413969952146,18.01,IS,0.34,0.0,Phase3-EA-S4v1-EURCHF-M15-221,EURCHFMT4,4116,8h 45m,Buy
172611.53,1.18641,15.05.2018 20:39:58,tp 1.18641,0.0,-0.0,0.0,0.0,1.18531,15.05.2018 20:10:00,15874,-0.0,45.14,IS,0.41,0.0,Phase3-EA-SA2v2-EURCHF-M5-43,EURCHFMT4,8104,29m 58s,Buy
172552.0,130425,16.05.2018 02:59:58,sl 130.425,-0.8,-59.53000000002794,0.0,0.0,131145,14.05.2018 12:30:00,15875,-0.02266846394749981,-59.53,IS,0.09,0.0,Phase3-EA-TR1v1-EURJPY-M30-91,EURJPYMT4,2794,1d 14h 29m,Buy
172547.86,110324,16.05.2018 05:45:00,,-0.71,-63.67000000004191,0.0,0.0,110338,15.05.2018 22:45:00,15876,-0.024244936998783564,-4.14,IS,0.27,0.0,Phase3-EA-S1v2-USDJPY-M15-0,USDJPYMT4,4552,7h 0m,Buy
172458.09,1.18366,16.05.2018 09:05:00,,0.0,-153.44000000006054,0.0,0.0,1.18585,16.05.2018 00:45:00,15877,-0.05842850845127013,-89.77,IS,0.41,0.0,Phase3-EA-SA2v2-EURCHF-M5-43,EURCHFMT4,8106,8h 20m,Buy
172506.87,1.00012,17.05.2018 01:29:57,tp 1.00012,-9.21,-104.6600000000326,0.0,0.0,1.00112,16.05.2018 23:15:00,15878,-0.0398535433688049,48.78,IS,0.58,0.0,Phase3-EA-SA2v2-USDCHF-M15-107,USDCHFMT4,3132,2h 14m,Sell
172457.3,1.18194,17.05.2018 05:25:00,,-6.14,-154.23000000003958,0.0,0.0,1.18088,16.05.2018 21:05:00,15879,-0.058729333019018184,-49.57,IS,0.41,0.0,Phase3-EA-SA2v2-EURCHF-M5-43,EURCHFMT4,8108,8h 20m,Sell
172325.99,149474,17.05.2018 05:30:00,,0.0,-285.54000000003725,0.0,0.0,148844,17.05.2018 00:05:00,15880,-0.10873094566717457,-131.31,IS,0.23,0.0,Phase3-EA-S4v1-GBPJPY-M5-194,GBPJPYMT4,3430,5h 25m,Sell
172320.55,1.1822,17.05.2018 09:45:00,,0.0,-290.9800000000396,0.0,0.0,1.18204,17.05.2018 01:00:00,15881,-0.11080244648817901,-5.44,IS,0.34,0.0,Phase3-EA-S4v1-EURCHF-M15-221,EURCHFMT4,4118,8h 45m,Sell
172337.19,1.18145,18.05.2018 06:30:00,,-0.98,-274.3400000000256,0.0,0.0,1.18102,17.05.2018 22:10:00,15882,-0.10446609103569227,16.64,IS,0.41,0.0,Phase3-EA-SA2v2-EURCHF-M5-43,EURCHFMT4,8110,8h 20m,Buy
172319.78,149892,18.05.2018 07:50:00,,0.0,-291.75,0.0,0.0,149808,18.05.2018 02:25:00,15883,-0.11109565524407805,-17.41,IS,0.23,0.0,Phase3-EA-S4v1-GBPJPY-M5-194,GBPJPYMT4,3432,5h 25m,Sell
172281.79,131007,18.05.2018 11:14:58,sl 131.007,-2.7,-329.7399999999907,0.0,0.0,130777,15.05.2018 15:15:00,15884,-0.12556188983781066,-37.99,IS,0.17,0.0,Phase3-EA-T1v2-EURJPY-M15-322,EURJPYMT4,3146,2d 19h 59m,Sell
172222.25,131093,18.05.2018 12:59:57,sl 131.093,-1.14,-389.27999999996973,0.0,0.0,130373,16.05.2018 03:30:00,15885,-0.1482341616912128,-59.54,IS,0.09,0.0,Phase3-EA-TR1v1-EURJPY-M30-91,EURJPYMT4,2796,2d 9h 29m,Sell
172267.51,1.17451,18.05.2018 20:54:57,tp 1.17451,0.0,-344.0199999999604,0.0,0.0,1.17341,18.05.2018 20:25:00,15886,-0.13099957949293345,45.26,IS,0.41,0.0,Phase3-EA-SA2v2-EURCHF-M5-43,EURCHFMT4,8112,29m 57s,Buy
172254.79,1.1734,21.05.2018 10:10:00,,0.0,-356.7399999999325,0.0,0.0,1.17371,21.05.2018 01:50:00,15887,-0.13584323582438698,-12.72,IS,0.41,0.0,Phase3-EA-SA2v2-EURCHF-M5-43,EURCHFMT4,8114,8h 20m,Buy
172211.25,1.17267,21.05.2018 10:45:00,,0.0,-400.2799999999115,0.0,0.0,1.17395,21.05.2018 02:00:00,15888,-0.1524228582042493,-43.54,IS,0.34,0.0,Phase3-EA-S4v1-EURCHF-M15-221,EURCHFMT4,4120,8h 45m,Buy
172156.48,149047,21.05.2018 13:59:57,sl 149.047,-0.58,-455.04999999993015,0.0,0.0,149717,17.05.2018 12:30:00,15889,-0.17327875893336744,-54.77,IS,0.09,0.0,Phase3-EA-B1v1-GBPJPY-M30-1,GBPJPYMT4,1442,4d 1h 29m,Buy
172020.96,111276,21.05.2018 15:45:00,,-1.1,-590.5699999999197,0.0,0.0,110722,18.05.2018 23:45:00,15890,-0.22488349997424592,-135.52,IS,0.27,0.0,Phase3-EA-S1v2-USDJPY-M15-0,USDJPYMT4,4554,2d 16h 0m,Sell
171991.87,0.99674,22.05.2018 04:30:00,,0.0,-619.6599999999162,0.0,0.0,0.99724,22.05.2018 00:15:00,15891,-0.23596069829832422,-29.09,IS,0.58,0.0,Phase3-EA-SA2v2-USDCHF-M15-107,USDCHFMT4,3134,4h 15m,Buy
171995.57,1.17459,22.05.2018 05:45:00,,-2.06,-615.9599999999045,0.0,0.0,1.17473,21.05.2018 21:25:00,15892,-0.2345517731075637,3.7,IS,0.41,0.0,Phase3-EA-SA2v2-EURCHF-M5-43,EURCHFMT4,8116,8h 20m,Sell
171972.13,130662,22.05.2018 06:15:00,,-0.75,-639.3999999999069,0.0,0.0,130.81,21.05.2018 22:45:00,15893,-0.24347750458630046,-23.44,IS,0.17,0.0,Phase3-EA-T1v2-EURJPY-M15-322,EURJPYMT4,3148,7h 30m,Buy
172008.29,1.17436,22.05.2018 10:00:00,,0.0,-603.2399999999034,0.0,0.0,1.17542,22.05.2018 01:15:00,15894,-0.2297081167760991,36.16,IS,0.34,0.0,Phase3-EA-S4v1-EURCHF-M15-221,EURCHFMT4,4122,8h 45m,Sell
171973.03,130855,22.05.2018 16:14:58,sl 130.855,0.0,-638.4999999999127,0.0,0.0,131085,22.05.2018 11:30:00,15895,-0.24313479305341604,-35.26,IS,0.17,0.0,Phase3-EA-T1v2-EURJPY-M15-322,EURJPYMT4,3150,4h 44m,Buy
171981.8,110892,22.05.2018 23:45:00,,0.0,-629.7299999999232,0.0,0.0,110928,22.05.2018 17:45:00,15896,-0.23979525956073602,8.77,IS,0.27,0.0,Phase3-EA-S1v2-USDJPY-M15-0,USDJPYMT4,4556,6h 0m,Sell
171878.8,1.16695,23.05.2018 07:25:00,,-0.99,-732.7299999999232,0.0,0.0,1.16942,22.05.2018 23:05:00,15897,-0.27901669054664874,-103.0,IS,0.41,0.0,Phase3-EA-SA2v2-EURCHF-M5-43,EURCHFMT4,8118,8h 20m,Buy
171836.27,1.34033,23.05.2018 07:29:58,sl 1.34033,-0.53,-775.259999999922,0.0,0.0,1.34333,22.05.2018 04:30:00,15898,-0.2952117144285014,-42.53,IS,0.14,0.0,Phase3-EA-B1v1-GBPUSD-M30-14,GBPUSDMT4,1046,1d 2h 59m,Buy
171773.25,1.16735,23.05.2018 10:15:00,,0.0,-838.2799999999115,0.0,0.0,1.16919,23.05.2018 01:30:00,15899,-0.31920913754240243,-63.02,IS,0.34,0.0,Phase3-EA-S4v1-EURCHF-M15-221,EURCHFMT4,4124,8h 45m,Buy
171877.72,129398,23.05.2018 11:59:57,tp 129.398,-0.84,-733.8099999999104,0.0,0.0,130688,18.05.2018 14:00:00,15900,-0.2794279443861078,104.47,IS,0.09,0.0,Phase3-EA-TR1v1-EURJPY-M30-91,EURJPYMT4,2798,4d 21h 59m,Sell
171980.82,128584,23.05.2018 12:29:57,tp 128.584,0.0,-630.7099999999045,0.0,0.0,129844,23.05.2018 07:30:00,15901,-0.24016843434098323,103.1,IS,0.09,0.0,Phase3-EA-TR1v1-EURJPY-M30-91,EURJPYMT4,2799,4h 59m,Sell
172132.53,146076,23.05.2018 15:59:58,tp 146.076,0.0,-478.9999999999127,0.0,0.0,147926,23.05.2018 10:30:00,15902,-0.18239869361406574,151.71,IS,0.09,0.0,Phase3-EA-B1v1-GBPJPY-M30-1,GBPJPYMT4,1444,5h 29m,Sell
172177.8,1.16433,23.05.2018 21:09:58,tp 1.16433,0.0,-433.72999999992317,0.0,0.0,1.16543,23.05.2018 20:45:00,15903,-0.16516030350987296,45.27,IS,0.41,0.0,Phase3-EA-SA2v2-EURCHF-M5-43,EURCHFMT4,8120,24m 58s,Sell
172216.94,1.16437,24.05.2018 00:19:57,tp 1.16437,-6.18,-394.5899999999092,0.0,0.0,1.16547,23.05.2018 22:35:00,15904,-0.1502561597352208,39.14,IS,0.41,0.0,Phase3-EA-SA2v2-EURCHF-M5-43,EURCHFMT4,8122,1h 44m,Sell
172199.88,109.96,24.05.2018 01:30:00,,-3.31,-411.64999999990687,0.0,0.0,109904,23.05.2018 17:00:00,15905,-0.15675244723638176,-17.06,IS,0.27,0.0,Phase3-EA-S1v2-USDJPY-M15-0,USDJPYMT4,4558,8h 30m,Sell
172281.55,146679,24.05.2018 04:09:58,tp 146.679,0.0,-329.97999999992317,0.0,0.0,147069,24.05.2018 03:35:00,15906,-0.12565327957988806,81.67,IS,0.23,0.0,Phase3-EA-S4v1-GBPJPY-M5-194,GBPJPYMT4,3434,34m 58s,Sell
172211.57,0.9945,24.05.2018 04:45:00,,0.0,-399.95999999990454,0.0,0.0,0.9957,24.05.2018 00:30:00,15907,-0.15230100521477583,-69.98,IS,0.58,0.0,Phase3-EA-SA2v2-USDCHF-M15-107,USDCHFMT4,3136,4h 15m,Buy
172235.51,1.16472,24.05.2018 11:00:00,,0.0,-376.0199999999022,0.0,0.0,1.16402,24.05.2018 02:15:00,15908,-0.14318487843999098,23.94,IS,0.34,0.0,Phase3-EA-S4v1-EURCHF-M15-221,EURCHFMT4,4126,8h 45m,Buy
172293.98,0.99197,24.05.2018 22:29:57,tp 0.99197,0.0,-317.54999999993015,0.0,0.0,0.99097,24.05.2018 22:00:00,15909,-0.12092005252013445,58.47,IS,0.58,0.0,Phase3-EA-SA2v2-USDCHF-M15-107,USDCHFMT4,3138,29m 57s,Buy
172337.41,1.16179,25.05.2018 00:59:58,tp 1.16179,-2.07,-274.11999999993714,0.0,0.0,1.16289,24.05.2018 20:10:00,15910,-0.1043823171053974,43.43,IS,0.41,0.0,Phase3-EA-SA2v2-EURCHF-M5-43,EURCHFMT4,8124,4h 49m,Sell
172353.35,109.28,25.05.2018 01:15:00,,-1.11,-258.1799999999348,0.0,0.0,109349,24.05.2018 21:30:00,15911,-0.09831251506738244,15.94,IS,0.27,0.0,Phase3-EA-S1v2-USDJPY-M15-0,USDJPYMT4,4560,3h 45m,Sell
172357.3,109296,25.05.2018 03:45:00,,0.0,-254.22999999992317,0.0,0.0,109.28,25.05.2018 01:15:00,15912,-0.09680839222859786,3.95,IS,0.27,0.0,Phase3-EA-S1v2-USDJPY-M15-0,USDJPYMT4,4562,2h 30m,Buy
172402.8,1.16201,25.05.2018 03:54:57,tp 1.16201,0.0,-208.72999999992317,0.0,0.0,1.16091,25.05.2018 01:00:00,15913,-0.07948242028821893,45.5,IS,0.41,0.0,Phase3-EA-SA2v2-EURCHF-M5-43,EURCHFMT4,8126,2h 54m,Buy
172399.37,1.16145,25.05.2018 10:15:00,,0.0,-212.15999999991618,0.0,0.0,1.16155,25.05.2018 01:30:00,15914,-0.08078853201910638,-3.43,IS,0.34,0.0,Phase3-EA-S4v1-EURCHF-M15-221,EURCHFMT4,4128,8h 45m,Buy
172501.9,127248,25.05.2018 17:29:58,tp 127.248,-1.15,-109.62999999988824,0.0,0.0,128508,23.05.2018 14:00:00,15915,-0.041746072611468246,102.53,IS,0.09,0.0,Phase3-EA-TR1v1-EURJPY-M30-91,EURJPYMT4,2802,2d 3h 29m,Sell
172314.17,1.16103,28.05.2018 05:30:00,,-2.07,-297.3599999998696,0.0,0.0,1.15654,25.05.2018 21:10:00,15916,-0.11323189046568831,-187.73,IS,0.41,0.0,Phase3-EA-SA2v2-EURCHF-M5-43,EURCHFMT4,8128,2d 8h 20m,Sell
172180.48,1.16227,28.05.2018 08:59:58,sl 1.16227,0.0,-431.04999999987194,0.0,0.0,1.15837,28.05.2018 02:15:00,15917,-0.16413978472303553,-133.69,IS,0.34,0.0,Phase3-EA-S4v1-EURCHF-M15-221,EURCHFMT4,4130,6h 44m,Sell
172443.75,126979,28.05.2018 16:44:58,tp 126.979,-1.08,-167.77999999985332,0.0,0.0,128679,24.05.2018 01:30:00,15918,-0.0638890455418513,263.27,IS,0.17,0.0,Phase3-EA-T1v2-EURJPY-M15-322,EURJPYMT4,3152,4d 15h 14m,Sell
172443.34,1.15478,29.05.2018 09:35:00,,0.0,-168.1899999998277,0.0,0.0,1.15479,29.05.2018 01:15:00,15919,-0.06404516968460101,-0.41,IS,0.41,0.0,Phase3-EA-SA2v2-EURCHF-M5-43,EURCHFMT4,8130,8h 20m,Buy
172309.92,1.15066,29.05.2018 11:44:59,sl 1.15066,0.0,-301.6099999998114,0.0,0.0,1.15456,29.05.2018 05:45:00,15920,-0.11485025048207516,-133.42,IS,0.34,0.0,Phase3-EA-S4v1-EURCHF-M15-221,EURCHFMT4,4132,5h 59m,Buy
172245.47,126068,29.05.2018 11:59:57,sl 126.068,0.0,-366.05999999982305,0.0,0.0,126848,29.05.2018 09:00:00,15921,-0.13939220414268227,-64.45,IS,0.09,0.0,Phase3-EA-TR1v1-EURJPY-M30-91,EURJPYMT4,2804,2h 59m,Buy
172512.02,125297,29.05.2018 12:44:58,tp 125.297,0.0,-99.50999999983469,0.0,0.0,126997,29.05.2018 04:30:00,15922,-0.0378924718194339,266.55,IS,0.17,0.0,Phase3-EA-T1v2-EURJPY-M15-322,EURJPYMT4,3154,8h 14m,Sell
172452.49,126074,29.05.2018 16:59:58,sl 126.074,0.0,-159.03999999986263,0.0,0.0,125354,29.05.2018 13:00:00,15923,-0.060560935766933714,-59.53,IS,0.09,0.0,Phase3-EA-TR1v1-EURJPY-M30-91,EURJPYMT4,2806,3h 59m,Sell
172249.59,1.14204,29.05.2018 22:04:57,sl 1.14204,0.0,-361.9399999998859,0.0,0.0,1.14694,29.05.2018 20:10:00,15924,-0.1378233469032697,-202.9,IS,0.41,0.0,Phase3-EA-SA2v2-EURCHF-M5-43,EURCHFMT4,8132,1h 54m,Buy
172308.26,0.98853,29.05.2018 23:14:58,tp 0.98853,0.0,-303.2699999999022,0.0,0.0,0.98753,29.05.2018 22:45:00,15925,-0.1154823628649895,58.67,IS,0.58,0.0,Phase3-EA-SA2v2-USDCHF-M15-107,USDCHFMT4,3140,29m 58s,Buy
172353.81,1.14266,29.05.2018 23:39:58,tp 1.14266,0.0,-257.71999999991385,0.0,0.0,1.14156,29.05.2018 22:10:00,15926,-0.09813735139501019,45.55,IS,0.41,0.0,Phase3-EA-SA2v2-EURCHF-M5-43,EURCHFMT4,8134,1h 29m,Buy
172412.39,0.99018,30.05.2018 01:44:58,tp 0.99018,0.0,-199.13999999989755,0.0,0.0,0.99118,30.05.2018 01:15:00,15927,-0.07583063851000624,58.58,IS,0.58,0.0,Phase3-EA-SA2v2-USDCHF-M15-107,USDCHFMT4,3142,29m 58s,Sell
172457.89,1.14228,30.05.2018 01:44:58,tp 1.14228,0.0,-153.63999999989755,0.0,0.0,1.14338,30.05.2018 00:55:00,15928,-0.058504666569627314,45.5,IS,0.41,0.0,Phase3-EA-SA2v2-EURCHF-M5-43,EURCHFMT4,8136,49m 58s,Sell
172540.47,144159,30.05.2018 05:39:58,tp 144.159,0.0,-71.05999999988126,0.0,0.0,143769,30.05.2018 03:35:00,15929,-0.027058979474313606,82.58,IS,0.23,0.0,Phase3-EA-S4v1-GBPJPY-M5-194,GBPJPYMT4,3436,2h 4m,Buy
172511.43,108.68,30.05.2018 05:45:00,,-0.72,-100.0999999998603,0.0,0.0,108794,29.05.2018 19:15:00,15930,-0.03811713826878044,-29.04,IS,0.27,0.0,Phase3-EA-S1v2-USDJPY-M15-0,USDJPYMT4,4564,10h 30m,Buy
172363.2,1.14727,30.05.2018 10:05:00,,0.0,-248.32999999984168,0.0,0.0,1.14368,30.05.2018 01:45:00,15931,-0.09456172773519901,-148.23,IS,0.41,0.0,Phase3-EA-SA2v2-EURCHF-M5-43,EURCHFMT4,8138,8h 20m,Sell
172229.63,1.1484,30.05.2018 10:14:58,sl 1.14840,0.0,-381.89999999984866,0.0,0.0,1.1445,30.05.2018 06:00:00,15932,-0.14542392712149646,-133.57,IS,0.34,0.0,Phase3-EA-S4v1-EURCHF-M15-221,EURCHFMT4,4134,4h 14m,Sell
172193.12,125944,30.05.2018 10:29:58,sl 125.944,-0.55,-418.409999999858,0.0,0.0,125714,29.05.2018 19:15:00,15933,-0.15932659163893373,-36.51,IS,0.17,0.0,Phase3-EA-T1v2-EURJPY-M15-322,EURJPYMT4,3156,15h 14m,Sell
172299.77,126701,30.05.2018 15:29:58,tp 126.701,0.0,-311.7599999998347,0.0,0.0,125411,30.05.2018 01:30:00,15934,-0.11871527499186087,106.65,IS,0.09,0.0,Phase3-EA-TR1v1-EURJPY-M30-91,EURJPYMT4,2808,13h 59m,Buy
172345.39,1.15296,31.05.2018 04:04:58,tp 1.15296,0.0,-266.13999999983935,0.0,0.0,1.15406,31.05.2018 00:45:00,15935,-0.10134360818043216,45.62,IS,0.41,0.0,Phase3-EA-SA2v2-EURCHF-M5-43,EURCHFMT4,8140,3h 19m,Sell
172284.93,0.98814,31.05.2018 05:00:00,,0.0,-326.5999999998603,0.0,0.0,0.98917,31.05.2018 00:45:00,15936,-0.12436620737857881,-60.46,IS,0.58,0.0,Phase3-EA-SA2v2-USDCHF-M15-107,USDCHFMT4,3144,4h 15m,Buy
172422.71,1.15645,31.05.2018 11:44:58,tp 1.15645,0.0,-188.81999999983236,0.0,0.0,1.15245,31.05.2018 05:00:00,15937,-0.07190087959954822,137.78,IS,0.34,0.0,Phase3-EA-S4v1-EURCHF-M15-221,EURCHFMT4,4136,6h 44m,Buy
172386.78,126638,31.05.2018 17:14:58,sl 126.638,0.0,-224.74999999982538,0.0,0.0,126868,31.05.2018 08:30:00,15938,-0.08558268557356347,-35.93,IS,0.17,0.0,Phase3-EA-T1v2-EURJPY-M15-322,EURJPYMT4,3158,8h 44m,Buy
172346.92,144.86,01.06.2018 05:50:00,,0.0,-264.6099999998114,0.0,0.0,144671,01.06.2018 00:25:00,15939,-0.10076099857451427,-39.86,IS,0.23,0.0,Phase3-EA-S4v1-GBPJPY-M5-194,GBPJPYMT4,3438,5h 25m,Sell
172239.36,1.15361,01.06.2018 07:15:00,,-2.08,-372.1699999998091,0.0,0.0,1.15107,31.05.2018 22:55:00,15940,-0.14171883466038498,-107.56,IS,0.41,0.0,Phase3-EA-SA2v2-EURCHF-M5-43,EURCHFMT4,8142,8h 20m,Sell
172211.47,1153,01.06.2018 09:45:00,,0.0,-400.05999999982305,0.0,0.0,1.15219,01.06.2018 01:00:00,15941,-0.15233908427395443,-27.89,IS,0.34,0.0,Phase3-EA-S4v1-EURCHF-M15-221,EURCHFMT4,4138,8h 45m,Sell
172313.47,128063,01.06.2018 16:59:58,tp 128.063,-1.62,-298.05999999982305,0.0,0.0,126803,30.05.2018 16:00:00,15942,-0.11349844388013794,102.0,IS,0.09,0.0,Phase3-EA-TR1v1-EURJPY-M30-91,EURJPYMT4,2810,2d 0h 59m,Buy
172402.57,127671,01.06.2018 22:00:00,,-0.77,-208.95999999984633,0.0,0.0,127092,31.05.2018 23:45:00,15943,-0.07957000212437182,89.1,IS,0.17,0.0,Phase3-EA-T1v2-EURJPY-M15-322,EURJPYMT4,3160,22h 15m,Buy
172448.2,1.15211,01.06.2018 23:54:59,tp 1.15211,0.0,-163.32999999984168,0.0,0.0,1.15321,01.06.2018 21:50:00,15944,-0.062194527407018606,45.63,IS,0.41,0.0,Phase3-EA-SA2v2-EURCHF-M5-43,EURCHFMT4,8144,2h 4m,Sell
172493.82,1.15209,04.06.2018 01:04:59,tp 1.15209,0.0,-117.70999999984633,0.0,0.0,1.15099,04.06.2018 01:00:00,15945,-0.0448228605955899,45.62,IS,0.41,0.0,Phase3-EA-SA2v2-EURCHF-M5-43,EURCHFMT4,8146,4m 59s,Buy
172549.42,0.98792,04.06.2018 01:14:59,tp 0.98792,-3.11,-62.109999999869615,0.0,0.0,0.98892,01.06.2018 22:00:00,15946,-0.023650903675047824,55.6,IS,0.58,0.0,Phase3-EA-SA2v2-USDCHF-M15-107,USDCHFMT4,3146,2d 3h 14m,Sell
172631.29,146366,04.06.2018 03:59:58,tp 146.366,0.0,-0.0,0.0,0.0,145976,04.06.2018 01:10:00,15947,-0.0,81.87,IS,0.23,0.0,Phase3-EA-S4v1-GBPJPY-M5-194,GBPJPYMT4,3440,2h 49m,Buy
172668.52,109603,04.06.2018 04:00:00,,-0.71,-0.0,0.0,0.0,109449,01.06.2018 19:45:00,15948,-0.0,37.23,IS,0.27,0.0,Phase3-EA-S1v2-USDJPY-M15-0,USDJPYMT4,4566,2d 8h 15m,Buy
172639.03,1.15357,04.06.2018 11:10:00,,0.0,-29.489999999990687,0.0,0.0,1.15286,04.06.2018 02:50:00,15949,-0.011227078143962791,-29.49,IS,0.41,0.0,Phase3-EA-SA2v2-EURCHF-M5-43,EURCHFMT4,8148,8h 20m,Sell
172574.63,128553,04.06.2018 13:29:58,sl 128.553,-0.29,-93.89000000001397,0.0,0.0,127773,01.06.2018 19:00:00,15950,-0.035744671649276236,-64.4,IS,0.09,0.0,Phase3-EA-TR1v1-EURJPY-M30-91,EURJPYMT4,2812,2d 18h 29m,Sell
172613.34,1.15393,04.06.2018 15:30:00,,0.0,-55.179999999993015,0.0,0.0,1.15505,04.06.2018 06:45:00,15951,-0.021007465987927573,38.71,IS,0.34,0.0,Phase3-EA-S4v1-EURCHF-M15-221,EURCHFMT4,4140,8h 45m,Sell
172613.76,1.15592,05.06.2018 04:20:00,,-2.07,-54.76000000000931,0.0,0.0,1.15598,04.06.2018 20:00:00,15952,-0.02084756863898614,0.42,IS,0.41,0.0,Phase3-EA-SA2v2-EURCHF-M5-43,EURCHFMT4,8150,8h 20m,Sell
172646.63,0.98812,05.06.2018 05:30:00,,0.0,-21.89000000001397,0.0,0.0,0.98756,05.06.2018 01:15:00,15953,-0.008333697543966767,32.87,IS,0.58,0.0,Phase3-EA-SA2v2-USDCHF-M15-107,USDCHFMT4,3148,4h 15m,Buy
172662.75,146209,05.06.2018 08:05:00,,0.0,-5.7700000000186265,0.0,0.0,146286,05.06.2018 02:40:00,15954,-0.0021966850081686974,16.12,IS,0.23,0.0,Phase3-EA-S4v1-GBPJPY-M5-194,GBPJPYMT4,3442,5h 25m,Sell
172627.12,128392,05.06.2018 13:14:57,sl 128.392,0.0,-41.40000000002328,0.0,0.0,128622,05.06.2018 12:30:00,15955,-0.01576131011056181,-35.63,IS,0.17,0.0,Phase3-EA-T1v2-EURJPY-M15-322,EURJPYMT4,3162,44m 57s,Buy
172672.85,1.15324,05.06.2018 20:14:58,tp 1.15324,0.0,-0.0,0.0,0.0,1.15214,05.06.2018 20:05:00,15956,-0.0,45.73,IS,0.41,0.0,Phase3-EA-SA2v2-EURCHF-M5-43,EURCHFMT4,8152,9m 58s,Buy
172661.19,1.15376,06.06.2018 04:40:00,,-2.08,-11.659999999974389,0.0,0.0,1.15353,05.06.2018 20:20:00,15957,-0.004438981798070995,-11.66,IS,0.41,0.0,Phase3-EA-SA2v2-EURCHF-M5-43,EURCHFMT4,8154,8h 20m,Sell
172596.71,129075,06.06.2018 10:29:58,sl 129.075,-0.58,-76.13999999995576,0.0,0.0,128295,04.06.2018 17:00:00,15958,-0.02898662728179002,-64.48,IS,0.09,0.0,Phase3-EA-TR1v1-EURJPY-M30-91,EURJPYMT4,2814,1d 17h 29m,Sell
172461.95,1.15781,06.06.2018 11:29:58,sl 1.15781,0.0,-210.89999999996508,0.0,0.0,1.15391,06.06.2018 04:15:00,15959,-0.0802899880973477,-134.76,IS,0.34,0.0,Phase3-EA-S4v1-EURCHF-M15-221,EURCHFMT4,4142,7h 14m,Sell
172507.73,1.1603,06.06.2018 20:29:59,tp 1.16030,0.0,-165.11999999993714,0.0,0.0,1.1592,06.06.2018 20:10:00,15960,-0.06286146436524989,45.78,IS,0.41,0.0,Phase3-EA-SA2v2-EURCHF-M5-43,EURCHFMT4,8156,19m 59s,Buy
172529.78,110181,06.06.2018 21:45:00,,0.0,-143.06999999994878,0.0,0.0,110091,06.06.2018 17:00:00,15961,-0.05446699192548756,22.05,IS,0.27,0.0,Phase3-EA-S1v2-USDJPY-M15-0,USDJPYMT4,4568,4h 45m,Buy
172575.52,1.16016,06.06.2018 23:04:57,tp 1.16016,0.0,-97.32999999995809,0.0,0.0,1.16126,06.06.2018 21:10:00,15962,-0.037053696261321864,45.74,IS,0.41,0.0,Phase3-EA-SA2v2-EURCHF-M5-43,EURCHFMT4,8158,1h 54m,Sell
172621.23,1.16061,07.06.2018 00:59:58,tp 1.16061,0.0,-51.619999999937136,0.0,0.0,1.16171,07.06.2018 00:55:00,15963,-0.019651821648083108,45.71,IS,0.41,0.0,Phase3-EA-SA2v2-EURCHF-M5-43,EURCHFMT4,8160,4m 58s,Sell
172670.77,0.98497,07.06.2018 01:14:57,tp 0.98497,-9.35,-2.0799999999580905,0.0,0.0,0.98597,06.06.2018 22:15:00,15964,-7.918595317171455E-4,49.54,IS,0.58,0.0,Phase3-EA-SA2v2-USDCHF-M15-107,USDCHFMT4,3150,2h 59m,Sell
172665.38,110136,07.06.2018 04:30:00,,0.0,-7.46999999997206,0.0,0.0,110158,07.06.2018 01:15:00,15965,-0.00284384168366545,-5.39,IS,0.27,0.0,Phase3-EA-S1v2-USDJPY-M15-0,USDJPYMT4,4570,3h 15m,Buy
172646.71,147881,07.06.2018 04:35:00,,-3.63,-26.139999999955762,0.0,0.0,147809,06.06.2018 23:10:00,15966,-0.00995154238435972,-18.67,IS,0.23,0.0,Phase3-EA-S4v1-GBPJPY-M5-194,GBPJPYMT4,3444,5h 25m,Sell
172598.39,1.16263,07.06.2018 10:55:00,,0.0,-74.45999999996275,0.0,0.0,1.16147,07.06.2018 02:35:00,15967,-0.02834704842923902,-48.32,IS,0.41,0.0,Phase3-EA-SA2v2-EURCHF-M5-43,EURCHFMT4,8162,8h 20m,Sell
172747.9,148098,07.06.2018 11:29:58,tp 148.098,-1.78,-0.0,0.0,0.0,146248,01.06.2018 20:00:00,15968,-0.0,149.51,IS,0.09,0.0,Phase3-EA-B1v1-GBPJPY-M30-1,GBPJPYMT4,1446,5d 15h 29m,Buy
172849.8,130099,07.06.2018 11:59:57,tp 130.099,-1.2,-0.0,0.0,0.0,128839,06.06.2018 06:00:00,15969,-0.0,101.9,IS,0.09,0.0,Phase3-EA-TR1v1-EURJPY-M30-91,EURJPYMT4,2815,1d 5h 59m,Buy
172925.02,1.16003,07.06.2018 14:30:00,,0.0,-0.0,0.0,0.0,1.1622,07.06.2018 05:45:00,15970,-0.0,75.22,IS,0.34,0.0,Phase3-EA-S4v1-EURCHF-M15-221,EURCHFMT4,4144,8h 45m,Sell
172915.24,1.15813,08.06.2018 05:15:00,,-1.0,-9.78000000002794,0.0,0.0,1.15834,07.06.2018 20:55:00,15971,-0.003719691644419344,-9.78,IS,0.41,0.0,Phase3-EA-SA2v2-EURCHF-M5-43,EURCHFMT4,8164,8h 20m,Buy
172852.82,1.15455,08.06.2018 11:15:00,,0.0,-72.20000000001164,0.0,0.0,1.15635,08.06.2018 02:30:00,15972,-0.02746030027876817,-62.42,IS,0.34,0.0,Phase3-EA-S4v1-EURCHF-M15-221,EURCHFMT4,4146,8h 45m,Buy
172958.56,128756,08.06.2018 11:29:58,tp 128.756,-0.29,-0.0,0.0,0.0,130046,07.06.2018 19:30:00,15973,-0.0,105.74,IS,0.09,0.0,Phase3-EA-TR1v1-EURJPY-M30-91,EURJPYMT4,2818,15h 59m,Sell
173004.31,1.16027,08.06.2018 20:59:57,tp 1.16027,0.0,-0.0,0.0,0.0,1.16137,08.06.2018 20:35:00,15974,-0.0,45.75,IS,0.41,0.0,Phase3-EA-SA2v2-EURCHF-M5-43,EURCHFMT4,8166,24m 57s,Sell
173037.52,109356,11.06.2018 01:15:00,,-1.11,-0.0,0.0,0.0,109495,08.06.2018 17:00:00,15975,-0.0,33.21,IS,0.27,0.0,Phase3-EA-S1v2-USDJPY-M15-0,USDJPYMT4,4572,2d 8h 15m,Sell
173003.23,0.98458,11.06.2018 02:15:00,,-0.71,-34.289999999979045,0.0,0.0,0.98515,08.06.2018 22:00:00,15976,-0.01303616305384071,-34.29,IS,0.58,0.0,Phase3-EA-SA2v2-USDCHF-M15-107,USDCHFMT4,3152,2d 4h 15m,Buy
173048.02,1.1604,11.06.2018 03:49:58,tp 1.16040,-1.0,-0.0,0.0,0.0,1.1593,08.06.2018 22:05:00,15977,-0.0,44.79,IS,0.41,0.0,Phase3-EA-SA2v2-EURCHF-M5-43,EURCHFMT4,8168,2d 5h 44m,Buy
172992.45,146.96,11.06.2018 06:59:58,sl 146.960,-0.48,-55.570000000006985,0.0,0.0,146.29,08.06.2018 15:00:00,15978,-0.021125420370017117,-55.57,IS,0.09,0.0,Phase3-EA-B1v1-GBPJPY-M30-1,GBPJPYMT4,1448,2d 15h 59m,Sell
172857.9,1.16518,11.06.2018 10:29:58,sl 1.16518,0.0,-190.11999999999534,0.0,0.0,1.16128,11.06.2018 05:30:00,15979,-0.07227577687146033,-134.55,IS,0.34,0.0,Phase3-EA-S4v1-EURCHF-M15-221,EURCHFMT4,4148,4h 59m,Sell
172798.74,130.02,11.06.2018 11:29:58,sl 130.020,-0.29,-249.27999999996973,0.0,0.0,129.3,08.06.2018 03:30:00,15980,-0.09476596706562111,-59.16,IS,0.09,0.0,Phase3-EA-TR1v1-EURJPY-M30-91,EURJPYMT4,2819,3d 7h 59m,Sell
172792.88,129657,12.06.2018 00:45:00,,-0.76,-255.13999999995576,0.0,0.0,129.69,11.06.2018 17:45:00,15981,-0.09699369719641092,-5.86,IS,0.17,0.0,Phase3-EA-T1v2-EURJPY-M15-322,EURJPYMT4,3164,7h 0m,Buy
172757.46,129644,12.06.2018 04:14:57,sl 129.644,0.0,-290.55999999993946,0.0,0.0,129874,12.06.2018 03:15:00,15982,-0.11045891924977727,-35.42,IS,0.17,0.0,Phase3-EA-T1v2-EURJPY-M15-322,EURJPYMT4,3166,59m 57s,Buy
172684.16,1.15944,12.06.2018 05:10:00,,-1.0,-363.8599999999278,0.0,0.0,1.16118,11.06.2018 20:50:00,15983,-0.1383245538209814,-73.3,IS,0.41,0.0,Phase3-EA-SA2v2-EURCHF-M5-43,EURCHFMT4,8170,8h 20m,Buy
172671.86,147382,12.06.2018 08:15:00,,0.0,-376.1599999999162,0.0,0.0,147323,12.06.2018 02:50:00,15984,-0.14300050614329438,-12.3,IS,0.23,0.0,Phase3-EA-S4v1-GBPJPY-M5-194,GBPJPYMT4,3446,5h 25m,Sell
172686.2,129856,12.06.2018 20:30:00,,0.0,-361.81999999989057,0.0,0.0,129763,12.06.2018 08:00:00,15985,-0.13754903002116825,14.34,IS,0.17,0.0,Phase3-EA-T1v2-EURJPY-M15-322,EURJPYMT4,3168,12h 30m,Buy
172695.17,1.15971,13.06.2018 04:55:00,,-1.0,-352.8499999999185,0.0,0.0,1.15947,12.06.2018 20:35:00,15986,-0.13413900625441572,8.97,IS,0.41,0.0,Phase3-EA-SA2v2-EURCHF-M5-43,EURCHFMT4,8172,8h 20m,Buy
172651.14,1.16092,13.06.2018 13:45:00,,0.0,-396.87999999994645,0.0,0.0,1.15964,13.06.2018 05:00:00,15987,-0.15087739493342106,-44.03,IS,0.34,0.0,Phase3-EA-S4v1-EURCHF-M15-221,EURCHFMT4,4150,8h 45m,Sell
172609.14,1.33362,13.06.2018 22:29:57,sl 1.33362,0.0,-438.87999999994645,0.0,0.0,1.33662,13.06.2018 19:00:00,15988,-0.1668440613998707,-42.0,IS,0.14,0.0,Phase3-EA-B1v1-GBPUSD-M30-14,GBPUSDMT4,1048,3h 29m,Buy
172648.68,1.16066,14.06.2018 01:04:57,tp 1.16066,-6.24,-399.3399999999674,0.0,0.0,1.16176,13.06.2018 23:15:00,15989,-0.1518125853978925,39.54,IS,0.41,0.0,Phase3-EA-SA2v2-EURCHF-M5-43,EURCHFMT4,8174,1h 49m,Sell
172643.74,130068,14.06.2018 09:00:00,,0.0,-404.27999999996973,0.0,0.0,130.1,14.06.2018 06:00:00,15990,-0.15369056950132817,-4.94,IS,0.17,0.0,Phase3-EA-T1v2-EURJPY-M15-322,EURJPYMT4,3170,3h 0m,Buy
172617.85,1.16216,14.06.2018 09:45:00,,0.0,-430.1699999999837,0.0,0.0,1.16141,14.06.2018 01:00:00,15991,-0.16353287890172352,-25.89,IS,0.34,0.0,Phase3-EA-S4v1-EURCHF-M15-221,EURCHFMT4,4152,8h 45m,Sell
172557.03,129236,14.06.2018 16:29:58,sl 129.236,-2.0,-490.9899999999907,0.0,0.0,129956,11.06.2018 11:30:00,15992,-0.18665413258004684,-60.82,IS,0.09,0.0,Phase3-EA-TR1v1-EURJPY-M30-91,EURJPYMT4,2822,3d 4h 59m,Buy
172515.03,1.33446,14.06.2018 16:59:58,sl 1.33446,0.0,-532.9899999999907,0.0,0.0,1.33746,14.06.2018 01:00:00,15993,-0.2026207990464965,-42.0,IS,0.14,0.0,Phase3-EA-B1v1-GBPUSD-M30-14,GBPUSDMT4,1050,15h 59m,Buy
172385.29,1.15296,15.06.2018 06:30:00,,-0.99,-662.7299999999814,0.0,0.0,1.15609,14.06.2018 22:10:00,15994,-0.2519425920788067,-129.74,IS,0.41,0.0,Phase3-EA-SA2v2-EURCHF-M5-43,EURCHFMT4,8176,8h 20m,Buy
172386.65,1.15342,15.06.2018 10:15:00,,0.0,-661.3699999999953,0.0,0.0,1.15338,15.06.2018 01:30:00,15995,-0.2514255762122794,1.36,IS,0.34,0.0,Phase3-EA-S4v1-EURCHF-M15-221,EURCHFMT4,4154,8h 45m,Buy
172403.5,110534,15.06.2018 18:45:00,,0.0,-644.5200000000186,0.0,0.0,110603,15.06.2018 17:45:00,15996,-0.2450199016894388,16.85,IS,0.27,0.0,Phase3-EA-S1v2-USDJPY-M15-0,USDJPYMT4,4574,1h 0m,Sell
172458.64,0.9963,18.06.2018 01:00:00,tp 0.99630,-3.08,-589.3800000000047,0.0,0.0,0.9973,15.06.2018 23:15:00,15997,-0.22405794957133743,55.14,IS,0.58,0.0,Phase3-EA-SA2v2-USDCHF-M15-107,USDCHFMT4,3154,2d 1h 45m,Sell
172501.79,1.1564,18.06.2018 01:00:00,tp 1.15640,-2.06,-546.2299999999814,0.0,0.0,1.1575,15.06.2018 23:00:00,15998,-0.2076541005706785,43.15,IS,0.41,0.0,Phase3-EA-SA2v2-EURCHF-M5-43,EURCHFMT4,8178,2d 2h 0m,Sell
172547.03,1.1563,18.06.2018 01:19:58,tp 1.15630,0.0,-500.9899999999907,0.0,0.0,1.1552,18.06.2018 01:10:00,15999,-0.19045571983396342,45.24,IS,0.41,0.0,Phase3-EA-SA2v2-EURCHF-M5-43,EURCHFMT4,8180,9m 58s,Buy
172525.89,1.15577,18.06.2018 10:15:00,,0.0,-522.1300000000047,0.0,0.0,1.15639,18.06.2018 01:30:00,16000,-0.1984922752887484,-21.14,IS,0.34,0.0,Phase3-EA-S4v1-EURCHF-M15-221,EURCHFMT4,4156,8h 45m,Buy
172497.0,1.15546,19.06.2018 04:50:00,,-2.06,-551.0200000000186,0.0,0.0,1.15481,18.06.2018 20:30:00,16001,-0.20947506086531872,-28.89,IS,0.41,0.0,Phase3-EA-SA2v2-EURCHF-M5-43,EURCHFMT4,8182,8h 20m,Sell
172357.98,145486,19.06.2018 09:10:00,,0.0,-690.0400000000373,0.0,0.0,146149,19.06.2018 03:45:00,16002,-0.26232472686927416,-139.02,IS,0.23,0.0,Phase3-EA-S4v1-GBPJPY-M5-194,GBPJPYMT4,3448,5h 25m,Buy
172477.26,1.15276,19.06.2018 10:00:00,,0.0,-570.7600000000093,0.0,0.0,1.15624,19.06.2018 01:15:00,16003,-0.21697939410454653,119.28,IS,0.34,0.0,Phase3-EA-S4v1-EURCHF-M15-221,EURCHFMT4,4158,8h 45m,Sell
172580.11,126928,19.06.2018 11:29:57,tp 126.928,-0.56,-467.9100000000326,0.0,0.0,128188,15.06.2018 00:30:00,16004,-0.1778800691980233,102.85,IS,0.09,0.0,Phase3-EA-TR1v1-EURJPY-M30-91,EURJPYMT4,2824,4d 10h 59m,Sell
172623.41,1.1509,20.06.2018 00:59:57,tp 1.15090,-2.06,-424.61000000004424,0.0,0.0,1152,19.06.2018 20:15:00,16005,-0.16141919638856891,43.3,IS,0.41,0.0,Phase3-EA-SA2v2-EURCHF-M5-43,EURCHFMT4,8184,4h 44m,Sell
172704.95,144.63,20.06.2018 05:04:58,tp 144.630,0.0,-343.0700000000652,0.0,0.0,145.02,20.06.2018 00:40:00,16006,-0.13042105392014106,81.54,IS,0.23,0.0,Phase3-EA-S4v1-GBPJPY-M5-194,GBPJPYMT4,3450,4h 24m,Sell
172699.12,0.99409,20.06.2018 05:30:00,,0.0,-348.9000000000815,0.0,0.0,0.99419,20.06.2018 01:15:00,16007,-0.13263737928918062,-5.83,IS,0.58,0.0,Phase3-EA-SA2v2-USDCHF-M15-107,USDCHFMT4,3156,4h 15m,Buy
172680.91,127469,20.06.2018 08:00:00,,0.0,-367.11000000010245,0.0,0.0,127587,20.06.2018 06:15:00,16008,-0.13956006967857068,-18.21,IS,0.17,0.0,Phase3-EA-T1v2-EURJPY-M15-322,EURJPYMT4,3172,1h 45m,Buy
172625.68,145128,20.06.2018 09:29:58,sl 145.128,-0.47,-422.3400000000838,0.0,0.0,144458,19.06.2018 15:30:00,16009,-0.1605562360819449,-55.23,IS,0.09,0.0,Phase3-EA-B1v1-GBPJPY-M30-1,GBPJPYMT4,1450,17h 59m,Sell
172624.6,127536,20.06.2018 10:45:00,,0.0,-423.4200000001001,0.0,0.0,127543,20.06.2018 10:00:00,16010,-0.1609668075053741,-1.08,IS,0.17,0.0,Phase3-EA-T1v2-EURJPY-M15-322,EURJPYMT4,3174,45m 0s,Buy
172669.93,1.15329,20.06.2018 21:44:57,tp 1.15329,0.0,-378.0900000000838,0.0,0.0,1.15439,20.06.2018 20:10:00,16011,-0.14373421248336402,45.33,IS,0.41,0.0,Phase3-EA-SA2v2-EURCHF-M5-43,EURCHFMT4,8186,1h 34m,Sell
172610.85,127836,20.06.2018 22:29:58,sl 127.836,-0.29,-437.1700000001001,0.0,0.0,127116,19.06.2018 11:30:00,16012,-0.16619398997950938,-59.08,IS,0.09,0.0,Phase3-EA-TR1v1-EURJPY-M30-91,EURJPYMT4,2826,1d 10h 59m,Sell
172567.25,1.31718,21.06.2018 00:59:58,sl 1.31718,-1.6,-480.77000000007683,0.0,0.0,1.32018,20.06.2018 19:30:00,16013,-0.18276891040657683,-43.6,IS,0.14,0.0,Phase3-EA-B1v1-GBPUSD-M30-14,GBPUSDMT4,1052,5h 29m,Buy
172629.45,145629,21.06.2018 06:30:00,,0.0,-418.5700000000652,0.0,0.0,145.33,21.06.2018 01:05:00,16014,-0.15912303768721126,62.2,IS,0.23,0.0,Phase3-EA-S4v1-GBPJPY-M5-194,GBPJPYMT4,3452,5h 25m,Buy
172648.76,1.15371,21.06.2018 09:10:00,,0.0,-399.2600000000675,0.0,0.0,1.15324,21.06.2018 00:50:00,16015,-0.15178217269989921,19.31,IS,0.41,0.0,Phase3-EA-SA2v2-EURCHF-M5-43,EURCHFMT4,8188,8h 20m,Buy
172620.81,1.15212,21.06.2018 11:15:00,,0.0,-427.21000000007916,0.0,0.0,1.15294,21.06.2018 02:30:00,16016,-0.1624076090746005,-27.95,IS,0.34,0.0,Phase3-EA-S4v1-EURCHF-M15-221,EURCHFMT4,4160,8h 45m,Buy
172641.58,109887,22.06.2018 01:45:00,,-1.1,-406.44000000006054,0.0,0.0,109976,21.06.2018 23:30:00,16017,-0.15451171234820868,20.77,IS,0.27,0.0,Phase3-EA-S1v2-USDJPY-M15-0,USDJPYMT4,4576,2h 15m,Sell
172631.65,1.15077,22.06.2018 08:55:00,,0.0,-416.37000000005355,0.0,0.0,1.15101,22.06.2018 00:35:00,16018,-0.1582866884913452,-9.93,IS,0.41,0.0,Phase3-EA-SA2v2-EURCHF-M5-43,EURCHFMT4,8190,8h 20m,Buy
172686.61,1.15184,22.06.2018 10:30:00,,0.0,-361.4100000000326,0.0,0.0,1.15024,22.06.2018 01:45:00,16019,-0.13739316494381168,54.96,IS,0.34,0.0,Phase3-EA-S4v1-EURCHF-M15-221,EURCHFMT4,4162,8h 45m,Buy
172622.58,128568,22.06.2018 11:59:57,sl 128.568,-0.29,-425.44000000006054,0.0,0.0,127788,21.06.2018 04:00:00,16020,-0.16173472813065018,-64.03,IS,0.09,0.0,Phase3-EA-TR1v1-EURJPY-M30-91,EURJPYMT4,2828,1d 7h 59m,Sell
172648.41,127892,22.06.2018 19:00:00,,0.0,-399.61000000004424,0.0,0.0,127725,22.06.2018 05:00:00,16021,-0.15191522825377746,25.83,IS,0.17,0.0,Phase3-EA-T1v2-EURJPY-M15-322,EURJPYMT4,3176,14h 0m,Buy
172591.91,109855,25.06.2018 01:00:00,,-0.71,-456.11000000004424,0.0,0.0,110082,22.06.2018 17:15:00,16022,-0.17339419623840616,-56.5,IS,0.27,0.0,Phase3-EA-S1v2-USDJPY-M15-0,USDJPYMT4,4578,2d 7h 45m,Buy
172532.43,127669,25.06.2018 05:29:58,sl 127.669,-0.4,-515.5900000000256,0.0,0.0,128389,22.06.2018 12:30:00,16023,-0.19600603722469492,-59.48,IS,0.09,0.0,Phase3-EA-TR1v1-EURJPY-M30-91,EURJPYMT4,2830,2d 16h 59m,Buy
172507.65,1.15055,25.06.2018 09:45:00,,0.0,-540.3700000000536,0.0,0.0,1.15127,25.06.2018 01:00:00,16024,-0.20542637043991083,-24.78,IS,0.34,0.0,Phase3-EA-S4v1-EURCHF-M15-221,EURCHFMT4,4164,8h 45m,Buy
172471.97,128066,25.06.2018 15:29:58,sl 128.066,0.0,-576.0500000000466,0.0,0.0,127836,25.06.2018 04:30:00,16025,-0.21899043376188257,-35.68,IS,0.17,0.0,Phase3-EA-T1v2-EURJPY-M15-322,EURJPYMT4,3178,10h 59m,Sell
172517.72,1.15523,25.06.2018 23:39:58,tp 1.15523,0.0,-530.3000000000466,0.0,0.0,1.15413,25.06.2018 21:35:00,16026,-0.2015981720752142,45.75,IS,0.41,0.0,Phase3-EA-SA2v2-EURCHF-M5-43,EURCHFMT4,8192,2h 4m,Buy
172576.49,0.98696,25.06.2018 23:44:58,tp 0.98696,0.0,-471.53000000002794,0.0,0.0,0.98596,25.06.2018 22:30:00,16027,-0.17925624378393934,58.77,IS,0.58,0.0,Phase3-EA-SA2v2-USDCHF-M15-107,USDCHFMT4,3158,1h 14m,Buy
172682.55,128825,25.06.2018 23:59:58,tp 128.825,0.0,-365.47000000003027,0.0,0.0,127535,25.06.2018 14:30:00,16028,-0.13893660936890093,106.06,IS,0.09,0.0,Phase3-EA-TR1v1-EURJPY-M30-91,EURJPYMT4,2832,9h 29m,Buy
172763.17,145492,26.06.2018 04:09:58,tp 145.492,-1.21,-284.8500000000349,0.0,0.0,145882,25.06.2018 23:45:00,16029,-0.10828821292782718,80.62,IS,0.23,0.0,Phase3-EA-S4v1-GBPJPY-M5-194,GBPJPYMT4,3454,4h 24m,Sell
172780.58,110128,27.06.2018 04:15:00,,0.0,-267.44000000006054,0.0,0.0,110057,27.06.2018 00:45:00,16030,-0.10166964951876815,17.41,IS,0.27,0.0,Phase3-EA-S1v2-USDJPY-M15-0,USDJPYMT4,4580,3h 30m,Buy
172808.0,145.52,27.06.2018 04:30:00,,-1.21,-240.02000000007683,0.0,0.0,145657,26.06.2018 23:05:00,16031,-0.09124569726853507,27.42,IS,0.23,0.0,Phase3-EA-S4v1-GBPJPY-M5-194,GBPJPYMT4,3456,5h 25m,Sell
172772.4,128032,27.06.2018 05:44:58,sl 128.032,0.0,-275.62000000005355,0.0,0.0,128262,27.06.2018 03:15:00,16032,-0.10477934789246926,-35.6,IS,0.17,0.0,Phase3-EA-T1v2-EURJPY-M15-322,EURJPYMT4,3180,2h 29m,Buy
172745.75,1.15421,27.06.2018 05:45:00,,-0.99,-302.27000000007683,0.0,0.0,1.15483,26.06.2018 21:25:00,16033,-0.11491057792416581,-26.65,IS,0.41,0.0,Phase3-EA-SA2v2-EURCHF-M5-43,EURCHFMT4,8194,8h 20m,Buy
172785.9,1.15452,27.06.2018 10:00:00,,0.0,-262.12000000005355,0.0,0.0,1.15335,27.06.2018 01:15:00,16034,-0.09964720509968188,40.15,IS,0.34,0.0,Phase3-EA-S4v1-EURCHF-M15-221,EURCHFMT4,4166,8h 45m,Buy
172741.78,1.31803,27.06.2018 15:29:58,sl 1.31803,-2.12,-306.2400000000489,0.0,0.0,1.32103,21.06.2018 15:30:00,16035,-0.11641980806396007,-44.12,IS,0.14,0.0,Phase3-EA-B1v1-GBPUSD-M30-14,GBPUSDMT4,1054,5d 23h 59m,Buy
172790.74,0.99641,28.06.2018 01:14:58,tp 0.99641,-9.25,-257.28000000002794,0.0,0.0,0.99741,27.06.2018 23:30:00,16036,-0.09780723686877651,48.96,IS,0.58,0.0,Phase3-EA-SA2v2-USDCHF-M15-107,USDCHFMT4,3160,1h 44m,Sell
172778.73,1.15258,28.06.2018 06:15:00,,-2.96,-269.29000000003725,0.0,0.0,1.1528,27.06.2018 21:55:00,16037,-0.10237294316073386,-12.01,IS,0.41,0.0,Phase3-EA-SA2v2-EURCHF-M5-43,EURCHFMT4,8196,8h 20m,Buy
172790.07,110276,28.06.2018 08:15:00,,-2.13,-257.95000000001164,0.0,0.0,110221,27.06.2018 21:15:00,16038,-0.09806194321478273,11.34,IS,0.27,0.0,Phase3-EA-S1v2-USDJPY-M15-0,USDJPYMT4,4582,11h 0m,Buy
172832.33,1.15296,28.06.2018 10:15:00,,0.0,-215.69000000000233,0.0,0.0,1.15172,28.06.2018 01:30:00,16039,-0.0819964354797277,42.26,IS,0.34,0.0,Phase3-EA-S4v1-EURCHF-M15-221,EURCHFMT4,4168,8h 45m,Buy
172804.21,1.15386,29.06.2018 06:00:00,,-0.99,-243.80999999999767,0.0,0.0,1.15452,28.06.2018 21:40:00,16040,-0.09268649883773937,-28.12,IS,0.41,0.0,Phase3-EA-SA2v2-EURCHF-M5-43,EURCHFMT4,8198,8h 20m,Buy
172763.5,0.99736,29.06.2018 06:30:00,,0.0,-284.5200000000186,0.0,0.0,0.99806,29.06.2018 02:15:00,16041,-0.10816276054844175,-40.71,IS,0.58,0.0,Phase3-EA-SA2v2-USDCHF-M15-107,USDCHFMT4,3162,4h 15m,Buy
172725.98,128083,29.06.2018 06:44:58,sl 128.083,-2.16,-322.04000000003725,0.0,0.0,127853,27.06.2018 20:30:00,16042,-0.12242631592514386,-37.52,IS,0.17,0.0,Phase3-EA-T1v2-EURJPY-M15-322,EURJPYMT4,3182,1d 10h 14m,Sell
172670.92,145012,29.06.2018 06:59:58,sl 145.012,-0.47,-377.1000000000349,0.0,0.0,144342,28.06.2018 04:30:00,16043,-0.14335785534520767,-55.06,IS,0.09,0.0,Phase3-EA-B1v1-GBPJPY-M30-1,GBPJPYMT4,1452,1d 2h 29m,Sell
172605.93,128914,29.06.2018 06:59:58,sl 128.914,-1.44,-442.0900000000256,0.0,0.0,128134,26.06.2018 06:00:00,16044,-0.16806437090840803,-64.99,IS,0.09,0.0,Phase3-EA-TR1v1-EURJPY-M30-91,EURJPYMT4,2834,3d 0h 59m,Sell
172546.98,128144,29.06.2018 06:59:58,sl 128.144,-0.29,-501.04000000003725,0.0,0.0,127424,28.06.2018 00:30:00,16045,-0.1904747277702507,-58.95,IS,0.09,0.0,Phase3-EA-TR1v1-EURJPY-M30-91,EURJPYMT4,2835,1d 6h 29m,Sell
172483.58,129369,29.06.2018 19:29:58,sl 129.369,0.0,-564.4400000000605,0.0,0.0,128589,29.06.2018 12:00:00,16046,-0.21457679096009072,-63.4,IS,0.09,0.0,Phase3-EA-TR1v1-EURJPY-M30-91,EURJPYMT4,2838,7h 29m,Sell
172451.84,0.99025,02.07.2018 02:30:00,,-0.7,-596.1800000000512,0.0,0.0,0.99078,29.06.2018 22:15:00,16047,-0.2266430289040184,-31.74,IS,0.58,0.0,Phase3-EA-SA2v2-USDCHF-M15-107,USDCHFMT4,3164,2d 4h 15m,Buy
172419.84,1.15642,02.07.2018 06:30:00,,-0.99,-628.1800000000512,0.0,0.0,1.15717,29.06.2018 22:10:00,16048,-0.23880810811655148,-32.0,IS,0.41,0.0,Phase3-EA-SA2v2-EURCHF-M5-43,EURCHFMT4,8200,2d 8h 20m,Buy
172384.6,129244,02.07.2018 07:59:58,sl 129.244,0.0,-663.4200000000419,0.0,0.0,129474,02.07.2018 05:15:00,16049,-0.25220490159935,-35.24,IS,0.17,0.0,Phase3-EA-T1v2-EURJPY-M15-322,EURJPYMT4,3184,2h 44m,Buy
172363.36,1.15536,02.07.2018 10:30:00,,0.0,-684.6600000000326,0.0,0.0,1.15598,02.07.2018 01:45:00,16050,-0.26027947292666526,-21.24,IS,0.34,0.0,Phase3-EA-S4v1-EURCHF-M15-221,EURCHFMT4,4170,8h 45m,Buy
172304.68,129207,03.07.2018 05:29:57,sl 129.207,-0.28,-743.3400000000256,0.0,0.0,129216,02.07.2018 01:30:00,16051,-0.2825871869326451,-58.68,IS,0.09,0.0,Phase3-EA-TR1v1-EURJPY-M30-91,EURJPYMT4,2840,1d 3h 59m,Sell
172234.19,1.15687,03.07.2018 07:55:00,,-2.06,-813.8300000000163,0.0,0.0,1.15521,02.07.2018 23:35:00,16052,-0.3093845754854996,-70.49,IS,0.41,0.0,Phase3-EA-SA2v2-EURCHF-M5-43,EURCHFMT4,8202,8h 20m,Sell
172184.97,1.15762,03.07.2018 09:45:00,,0.0,-863.0499999999884,0.0,0.0,1.15618,03.07.2018 01:00:00,16053,-0.3280959879492664,-49.22,IS,0.34,0.0,Phase3-EA-S4v1-EURCHF-M15-221,EURCHFMT4,4172,8h 45m,Sell
172149.65,128921,03.07.2018 16:59:58,sl 128.921,0.0,-898.3699999999953,0.0,0.0,129151,03.07.2018 09:45:00,16054,-0.34152319413010246,-35.32,IS,0.17,0.0,Phase3-EA-T1v2-EURJPY-M15-322,EURJPYMT4,3186,7h 14m,Buy
172193.02,1.15575,04.07.2018 01:34:57,tp 1.15575,-2.07,-855.0,0.0,0.0,1.15685,03.07.2018 23:35:00,16055,-0.325035710209868,43.37,IS,0.41,0.0,Phase3-EA-SA2v2-EURCHF-M5-43,EURCHFMT4,8204,1h 59m,Sell
172250.74,0.99282,04.07.2018 01:44:58,tp 0.99282,-0.7,-797.2800000000279,0.0,0.0,0.99182,03.07.2018 22:30:00,16056,-0.3030929485802721,57.72,IS,0.58,0.0,Phase3-EA-SA2v2-USDCHF-M15-107,USDCHFMT4,3166,3h 14m,Buy
172270.57,145774,04.07.2018 04:30:00,,-1.21,-777.4500000000116,0.0,0.0,145875,03.07.2018 23:05:00,16057,-0.2955544010557493,19.83,IS,0.23,0.0,Phase3-EA-S4v1-GBPJPY-M5-194,GBPJPYMT4,3458,5h 25m,Sell
172228.45,1.15499,04.07.2018 14:15:00,,0.0,-819.570000000007,0.0,0.0,1.15622,04.07.2018 05:30:00,16058,-0.3115666865692442,-42.12,IS,0.34,0.0,Phase3-EA-S4v1-EURCHF-M15-221,EURCHFMT4,4174,8h 45m,Buy
172193.07,128871,04.07.2018 20:29:58,sl 128.871,0.0,-854.9500000000116,0.0,0.0,128641,04.07.2018 20:15:00,16059,-0.32501670227360285,-35.38,IS,0.17,0.0,Phase3-EA-T1v2-EURJPY-M15-322,EURJPYMT4,3188,14m 58s,Sell
172238.51,1.15745,05.07.2018 04:09:58,tp 1.15745,0.0,-809.5100000000093,0.0,0.0,1.15635,05.07.2018 01:10:00,16060,-0.30774228979180496,45.44,IS,0.41,0.0,Phase3-EA-SA2v2-EURCHF-M5-43,EURCHFMT4,8206,2h 59m,Buy
172375.39,1.16035,05.07.2018 09:59:57,tp 1.16035,0.0,-672.6300000000047,0.0,0.0,1.15635,05.07.2018 01:15:00,16061,-0.255706163460193,136.88,IS,0.34,0.0,Phase3-EA-S4v1-EURCHF-M15-221,EURCHFMT4,4176,8h 44m,Buy
172410.11,129347,05.07.2018 21:30:00,,0.0,-637.9100000000326,0.0,0.0,129121,05.07.2018 09:45:00,16062,-0.24250705251460525,34.72,IS,0.17,0.0,Phase3-EA-T1v2-EURJPY-M15-322,EURJPYMT4,3190,11h 45m,Buy
172455.5,1.16014,06.07.2018 00:59:57,tp 1.16014,0.0,-592.5200000000186,0.0,0.0,1.16124,06.07.2018 00:05:00,16063,-0.22525164796907254,45.39,IS,0.41,0.0,Phase3-EA-SA2v2-EURCHF-M5-43,EURCHFMT4,8208,54m 57s,Sell
172500.96,1.1593,06.07.2018 01:04:57,tp 1.15930,0.0,-547.0599999999977,0.0,0.0,1.1604,06.07.2018 01:00:00,16064,-0.2079696323127598,45.46,IS,0.41,0.0,Phase3-EA-SA2v2-EURCHF-M5-43,EURCHFMT4,8210,4m 57s,Sell
172559.37,0.99306,06.07.2018 01:29:58,tp 0.99306,0.0,-488.6500000000233,0.0,0.0,0.99206,06.07.2018 01:15:00,16065,-0.18576456116264276,58.41,IS,0.58,0.0,Phase3-EA-SA2v2-USDCHF-M15-107,USDCHFMT4,3168,14m 58s,Buy
172640.58,146617,09.07.2018 05:29:57,tp 146.617,0.0,-407.4400000000023,0.0,0.0,147007,09.07.2018 01:20:00,16066,-0.1548918710735782,81.21,IS,0.23,0.0,Phase3-EA-S4v1-GBPJPY-M5-194,GBPJPYMT4,3460,4h 9m,Sell
172575.05,129996,09.07.2018 09:59:58,sl 129.996,-1.99,-472.97000000003027,0.0,0.0,128487,02.07.2018 20:00:00,16067,-0.1798036723485042,-65.53,IS,0.09,0.0,Phase3-EA-TR1v1-EURJPY-M30-91,EURJPYMT4,2841,6d 13h 59m,Sell
172552.66,1.16172,09.07.2018 10:45:00,,0.0,-495.36000000004424,0.0,0.0,1.16237,09.07.2018 02:00:00,16068,-0.18831542621002875,-22.39,IS,0.34,0.0,Phase3-EA-S4v1-EURCHF-M15-221,EURCHFMT4,4178,8h 45m,Buy
172539.84,1.16549,10.07.2018 04:30:00,,-2.07,-508.1800000000512,0.0,0.0,1.16523,09.07.2018 20:10:00,16069,-0.19318906106955247,-12.82,IS,0.41,0.0,Phase3-EA-SA2v2-EURCHF-M5-43,EURCHFMT4,8212,8h 20m,Sell
172512.11,147144,10.07.2018 09:00:00,,0.0,-535.9100000000326,0.0,0.0,147.01,10.07.2018 03:35:00,16070,-0.20373086252465608,-27.73,IS,0.23,0.0,Phase3-EA-S4v1-GBPJPY-M5-194,GBPJPYMT4,3462,5h 25m,Sell
172649.34,130329,10.07.2018 13:00:00,,-1.5,-398.6800000000512,0.0,0.0,129422,06.07.2018 05:00:00,16071,-0.15156168063916586,137.23,IS,0.17,0.0,Phase3-EA-T1v2-EURJPY-M15-322,EURJPYMT4,3192,4d 8h 0m,Buy
172686.31,1.16449,10.07.2018 13:45:00,,0.0,-361.71000000007916,0.0,0.0,1.16557,10.07.2018 05:00:00,16072,-0.13750721256144688,36.97,IS,0.34,0.0,Phase3-EA-S4v1-EURCHF-M15-221,EURCHFMT4,4180,8h 45m,Sell
172767.05,147341,11.07.2018 00:59:58,tp 147.341,0.0,-280.9700000000885,0.0,0.0,147731,11.07.2018 00:35:00,16073,-0.10681319707332791,80.74,IS,0.23,0.0,Phase3-EA-S4v1-GBPJPY-M5-194,GBPJPYMT4,3464,24m 58s,Sell
172731.08,130229,11.07.2018 01:14:58,sl 130.229,-0.75,-316.94000000006054,0.0,0.0,130459,10.07.2018 19:30:00,16074,-0.12048750642565524,-35.97,IS,0.17,0.0,Phase3-EA-T1v2-EURJPY-M15-322,EURJPYMT4,3194,5h 44m,Buy
172676.48,146973,11.07.2018 02:29:58,sl 146.973,-0.29,-371.54000000003725,0.0,0.0,147643,10.07.2018 17:30:00,16075,-0.14124417283203095,-54.6,IS,0.09,0.0,Phase3-EA-B1v1-GBPJPY-M30-1,GBPJPYMT4,1454,8h 59m,Buy
172618.04,129987,11.07.2018 03:59:58,sl 129.987,0.0,-429.9800000000396,0.0,0.0,130121,09.07.2018 21:30:00,16076,-0.16346064874392036,-58.44,IS,0.09,0.0,Phase3-EA-TR1v1-EURJPY-M30-91,EURJPYMT4,2844,1d 6h 29m,Sell
172631.25,1.16405,11.07.2018 05:05:00,,-2.07,-416.7700000000186,0.0,0.0,1.16442,10.07.2018 20:45:00,16077,-0.15843875198148857,13.21,IS,0.41,0.0,Phase3-EA-SA2v2-EURCHF-M5-43,EURCHFMT4,8214,8h 20m,Sell
172633.0,0.99218,11.07.2018 05:30:00,,0.0,-415.0200000000186,0.0,0.0,0.99215,11.07.2018 01:15:00,16078,-0.15777347421205318,1.75,IS,0.58,0.0,Phase3-EA-SA2v2-USDCHF-M15-107,USDCHFMT4,3170,4h 15m,Buy
172628.86,147311,11.07.2018 06:30:00,,0.0,-419.1600000000326,0.0,0.0,147331,11.07.2018 01:05:00,16079,-0.15934733133517995,-4.14,IS,0.23,0.0,Phase3-EA-S4v1-GBPJPY-M5-194,GBPJPYMT4,3466,5h 25m,Buy
172648.01,1.16432,11.07.2018 14:30:00,,0.0,-400.0100000000093,0.0,0.0,1.16376,11.07.2018 05:45:00,16080,-0.15206729174392083,19.15,IS,0.34,0.0,Phase3-EA-S4v1-EURCHF-M15-221,EURCHFMT4,4182,8h 45m,Buy
172612.87,130419,11.07.2018 16:14:58,sl 130.419,0.0,-435.1500000000233,0.0,0.0,130189,11.07.2018 01:45:00,16081,-0.16542606935418902,-35.14,IS,0.17,0.0,Phase3-EA-T1v2-EURJPY-M15-322,EURJPYMT4,3196,14h 29m,Sell
172624.52,111258,11.07.2018 18:45:00,,0.0,-423.5,0.0,0.0,111.21,11.07.2018 18:15:00,16082,-0.16099722020336735,11.65,IS,0.27,0.0,Phase3-EA-S1v2-USDJPY-M15-0,USDJPYMT4,4584,30m 0s,Buy
172561.1,130901,11.07.2018 20:59:58,sl 130.901,-0.56,-486.9199999999837,0.0,0.0,130707,11.07.2018 00:30:00,16083,-0.18510688656770014,-63.42,IS,0.09,0.0,Phase3-EA-TR1v1-EURJPY-M30-91,EURJPYMT4,2845,20h 29m,Buy
172592.9,112077,12.07.2018 04:15:00,,0.0,-455.11999999999534,0.0,0.0,111945,12.07.2018 01:45:00,16084,-0.17301783910024982,31.8,IS,0.27,0.0,Phase3-EA-S1v2-USDJPY-M15-0,USDJPYMT4,4586,2h 30m,Buy
172567.71,1.16239,12.07.2018 06:55:00,,-2.96,-480.3099999999977,0.0,0.0,1.16293,11.07.2018 22:35:00,16085,-0.1825940373928666,-25.19,IS,0.41,0.0,Phase3-EA-SA2v2-EURCHF-M5-43,EURCHFMT4,8216,8h 20m,Buy
172562.12,131319,13.07.2018 02:15:00,,0.0,-485.9000000000233,0.0,0.0,131356,13.07.2018 00:45:00,16086,-0.1847191246678157,-5.59,IS,0.17,0.0,Phase3-EA-T1v2-EURJPY-M15-322,EURJPYMT4,3198,1h 30m,Buy
172605.11,1.16869,13.07.2018 06:54:58,tp 1.16869,-2.04,-442.9100000000326,0.0,0.0,1.16979,12.07.2018 23:25:00,16087,-0.16837610106323184,42.99,IS,0.41,0.0,Phase3-EA-SA2v2-EURCHF-M5-43,EURCHFMT4,8218,7h 29m,Sell
172617.73,1.00217,16.07.2018 02:45:00,,-0.69,-430.29000000003725,0.0,0.0,1.00194,13.07.2018 22:30:00,16088,-0.16357849794879087,12.62,IS,0.58,0.0,Phase3-EA-SA2v2-USDCHF-M15-107,USDCHFMT4,3172,2d 4h 15m,Buy
172524.7,148865,16.07.2018 06:25:00,,0.0,-523.3200000000652,0.0,0.0,148.41,16.07.2018 01:00:00,16089,-0.1989446641719875,-93.03,IS,0.23,0.0,Phase3-EA-S4v1-GBPJPY-M5-194,GBPJPYMT4,3468,5h 25m,Sell
172539.84,1.17021,16.07.2018 08:10:00,,-2.05,-508.1800000000512,0.0,0.0,1.17063,13.07.2018 23:50:00,16090,-0.19318906106955247,15.14,IS,0.41,0.0,Phase3-EA-SA2v2-EURCHF-M5-43,EURCHFMT4,8220,2d 8h 20m,Sell
172481.91,131.65,16.07.2018 14:59:58,sl 131.650,-0.28,-566.1100000000442,0.0,0.0,131105,12.07.2018 16:00:00,16091,-0.2152116560314886,-57.93,IS,0.09,0.0,Phase3-EA-TR1v1-EURJPY-M30-91,EURJPYMT4,2848,3d 22h 59m,Sell
172500.99,0.99692,17.07.2018 03:15:00,,-0.7,-547.0300000000279,0.0,0.0,0.99658,16.07.2018 23:00:00,16092,-0.20795822755100954,19.08,IS,0.58,0.0,Phase3-EA-SA2v2-USDCHF-M15-107,USDCHFMT4,3174,4h 15m,Buy
172479.84,1.16749,17.07.2018 04:20:00,,-0.99,-568.1800000000512,0.0,0.0,1.16798,16.07.2018 20:00:00,16093,-0.215998584593052,-21.15,IS,0.41,0.0,Phase3-EA-SA2v2-EURCHF-M5-43,EURCHFMT4,8222,8h 20m,Buy
172461.42,148845,17.07.2018 09:20:00,,0.0,-586.6000000000349,0.0,0.0,148755,17.07.2018 03:55:00,16094,-0.22300110831476014,-18.42,IS,0.23,0.0,Phase3-EA-S4v1-GBPJPY-M5-194,GBPJPYMT4,3470,5h 25m,Sell
172398.12,131885,17.07.2018 12:59:58,sl 131.885,-0.84,-649.9000000000233,0.0,0.0,130.93,13.07.2018 13:30:00,16095,-0.24706515563204767,-63.3,IS,0.09,0.0,Phase3-EA-TR1v1-EURJPY-M30-91,EURJPYMT4,2849,3d 23h 29m,Sell
172337.54,1.16514,17.07.2018 14:00:00,,0.0,-710.4800000000396,0.0,0.0,1.16691,17.07.2018 05:15:00,16096,-0.27009517121628057,-60.58,IS,0.34,0.0,Phase3-EA-S4v1-EURCHF-M15-221,EURCHFMT4,4184,8h 45m,Buy
172295.01,1.32163,17.07.2018 15:29:57,sl 1.32163,-0.53,-753.0100000000675,0.0,0.0,1.32463,16.07.2018 12:30:00,16097,-0.2862633218071984,-42.53,IS,0.14,0.0,Phase3-EA-B1v1-GBPUSD-M30-14,GBPUSDMT4,1056,1d 2h 59m,Buy
172302.9,112899,18.07.2018 02:00:00,,0.0,-745.1200000000536,0.0,0.0,112866,18.07.2018 00:15:00,16098,-0.2832638694638529,7.89,IS,0.27,0.0,Phase3-EA-S1v2-USDJPY-M15-0,USDJPYMT4,4588,1h 45m,Buy
172293.89,1.16595,18.07.2018 08:40:00,,0.0,-754.1300000000629,0.0,0.0,1.16573,18.07.2018 00:20:00,16099,-0.2866890995796353,-9.01,IS,0.41,0.0,Phase3-EA-SA2v2-EURCHF-M5-43,EURCHFMT4,8224,8h 20m,Sell
172295.86,131574,18.07.2018 08:45:00,,-0.74,-752.1600000000908,0.0,0.0,131556,17.07.2018 03:45:00,16100,-0.28594018689062434,1.97,IS,0.17,0.0,Phase3-EA-T1v2-EURJPY-M15-322,EURJPYMT4,3200,1d 5h 0m,Buy
172241.34,147319,18.07.2018 12:29:59,sl 147.319,-1.16,-806.6800000001094,0.0,0.0,147989,12.07.2018 04:30:00,16101,-0.3066664405989846,-54.52,IS,0.09,0.0,Phase3-EA-B1v1-GBPJPY-M30-1,GBPJPYMT4,1456,6d 7h 59m,Buy
172377.39,1.16225,18.07.2018 14:29:58,tp 1.16225,0.0,-670.6300000001211,0.0,0.0,1.16625,18.07.2018 06:45:00,16102,-0.2549458460094539,136.05,IS,0.34,0.0,Phase3-EA-S4v1-EURCHF-M15-221,EURCHFMT4,4186,7h 44m,Sell
172319.24,130912,18.07.2018 16:29:58,sl 130.912,-0.78,-728.7800000001444,0.0,0.0,131632,16.07.2018 15:00:00,16103,-0.27705207589098774,-58.15,IS,0.09,0.0,Phase3-EA-TR1v1-EURJPY-M30-91,EURJPYMT4,2851,2d 1h 29m,Buy
172316.49,112801,19.07.2018 04:00:00,,-3.23,-731.5300000001444,0.0,0.0,112803,18.07.2018 22:00:00,16104,-0.2780975123858148,-2.75,IS,0.27,0.0,Phase3-EA-S1v2-USDJPY-M15-0,USDJPYMT4,4590,6h 0m,Sell
172282.79,0.99835,19.07.2018 05:15:00,,0.0,-765.230000000156,0.0,0.0,0.99893,19.07.2018 01:00:00,16105,-0.2909088614315181,-33.7,IS,0.58,0.0,Phase3-EA-SA2v2-USDCHF-M15-107,USDCHFMT4,3176,4h 15m,Buy
172311.55,147373,19.07.2018 05:30:00,,0.0,-736.4700000001467,0.0,0.0,147514,19.07.2018 00:05:00,16106,-0.27997549648925046,28.76,IS,0.23,0.0,Phase3-EA-S4v1-GBPJPY-M5-194,GBPJPYMT4,3472,5h 25m,Sell
172309.83,1.16355,19.07.2018 07:50:00,,-2.95,-738.1900000001187,0.0,0.0,1.16352,18.07.2018 23:30:00,16107,-0.2806293694969135,-1.72,IS,0.41,0.0,Phase3-EA-SA2v2-EURCHF-M5-43,EURCHFMT4,8226,8h 20m,Buy
172297.93,1.16243,19.07.2018 10:45:00,,0.0,-750.090000000142,0.0,0.0,1.16278,19.07.2018 02:00:00,16108,-0.2851532583290831,-11.9,IS,0.34,0.0,Phase3-EA-S4v1-EURCHF-M15-221,EURCHFMT4,4188,8h 45m,Buy
172343.2,1.16307,19.07.2018 21:24:58,tp 1.16307,0.0,-704.8200000001234,0.0,0.0,1.16197,19.07.2018 20:40:00,16109,-0.2679434728305956,45.27,IS,0.41,0.0,Phase3-EA-SA2v2-EURCHF-M5-43,EURCHFMT4,8228,44m 58s,Buy
172143.35,112133,19.07.2018 21:29:58,sl 112.133,0.0,-904.6700000001292,0.0,0.0,112963,19.07.2018 17:15:00,16110,-0.3439181941001208,-199.85,IS,0.27,0.0,Phase3-EA-S1v2-USDJPY-M15-0,USDJPYMT4,4592,4h 14m,Buy
172114.21,1.16413,20.07.2018 10:45:00,,0.0,-933.8100000001432,0.0,0.0,1.16342,20.07.2018 02:25:00,16111,-0.35499601935803904,-29.14,IS,0.41,0.0,Phase3-EA-SA2v2-EURCHF-M5-43,EURCHFMT4,8230,8h 20m,Sell
172151.32,1.16306,20.07.2018 14:15:00,,0.0,-896.7000000001281,0.0,0.0,1.16415,20.07.2018 05:30:00,16112,-0.34088832905874883,37.11,IS,0.34,0.0,Phase3-EA-S4v1-EURCHF-M15-221,EURCHFMT4,4190,8h 45m,Sell
172117.22,1.16354,23.07.2018 04:35:00,,-0.99,-930.8000000001339,0.0,0.0,1.16434,20.07.2018 20:15:00,16113,-0.3538517415946066,-34.1,IS,0.41,0.0,Phase3-EA-SA2v2-EURCHF-M5-43,EURCHFMT4,8232,2d 8h 20m,Buy
172123.74,1.16292,23.07.2018 09:45:00,,0.0,-924.2800000001444,0.0,0.0,1.16273,23.07.2018 01:00:00,16114,-0.35137310670505695,6.52,IS,0.34,0.0,Phase3-EA-S4v1-EURCHF-M15-221,EURCHFMT4,4192,8h 45m,Buy
172116.15,0.99277,24.07.2018 05:00:00,,0.0,-931.8700000001409,0.0,0.0,0.9929,24.07.2018 00:45:00,16115,-0.3542585114307783,-7.59,IS,0.58,0.0,Phase3-EA-SA2v2-USDCHF-M15-107,USDCHFMT4,3178,4h 15m,Buy
172196.8,145528,24.07.2018 05:19:58,tp 145.528,0.0,-851.2200000001467,0.0,0.0,145918,24.07.2018 02:55:00,16116,-0.3235987102279433,80.65,IS,0.23,0.0,Phase3-EA-S4v1-GBPJPY-M5-194,GBPJPYMT4,3474,2h 24m,Sell
172178.05,1.16056,24.07.2018 06:50:00,,-0.99,-869.9700000001467,0.0,0.0,1.16099,23.07.2018 22:30:00,16117,-0.3307266863290369,-18.75,IS,0.41,0.0,Phase3-EA-SA2v2-EURCHF-M5-43,EURCHFMT4,8234,8h 20m,Buy
172175.31,1.16073,24.07.2018 10:00:00,,0.0,-872.7100000001374,0.0,0.0,1.16081,24.07.2018 01:15:00,16118,-0.3317683212366065,-2.74,IS,0.34,0.0,Phase3-EA-S4v1-EURCHF-M15-221,EURCHFMT4,4194,8h 45m,Buy
172215.93,111002,24.07.2018 18:00:00,,0.0,-832.090000000142,0.0,0.0,111169,24.07.2018 17:00:00,16119,-0.3163262738111991,40.62,IS,0.27,0.0,Phase3-EA-S1v2-USDJPY-M15-0,USDJPYMT4,4594,1h 0m,Sell
172219.33,111.21,25.07.2018 03:15:00,,0.0,-828.6900000001187,0.0,0.0,111196,25.07.2018 01:00:00,16120,-0.3150337341448586,3.4,IS,0.27,0.0,Phase3-EA-S1v2-USDJPY-M15-0,USDJPYMT4,4596,2h 15m,Buy
172218.16,0.99359,25.07.2018 04:30:00,,0.0,-829.8600000001024,0.0,0.0,0.99361,25.07.2018 00:15:00,16121,-0.3154785198535606,-1.17,IS,0.58,0.0,Phase3-EA-SA2v2-USDCHF-M15-107,USDCHFMT4,3180,4h 15m,Buy
172206.85,1.16112,25.07.2018 05:05:00,,-0.99,-841.1700000001001,0.0,0.0,1.16137,24.07.2018 20:45:00,16122,-0.3197781150377394,-11.31,IS,0.41,0.0,Phase3-EA-SA2v2-EURCHF-M5-43,EURCHFMT4,8236,8h 20m,Buy
172307.23,129.7,25.07.2018 18:59:58,tp 129.700,-1.96,-740.7900000000955,0.0,0.0,130.96,18.07.2018 16:30:00,16123,-0.28161778218292294,100.38,IS,0.09,0.0,Phase3-EA-TR1v1-EURJPY-M30-91,EURJPYMT4,2854,7d 2h 29m,Sell
172565.24,129603,25.07.2018 18:59:58,tp 129.603,-2.13,-482.78000000008615,0.0,0.0,131303,19.07.2018 04:15:00,16124,-0.18353302944461763,258.01,IS,0.17,0.0,Phase3-EA-T1v2-EURJPY-M15-322,EURJPYMT4,3202,6d 14h 44m,Sell
172569.72,146312,26.07.2018 05:15:00,,-3.61,-478.3000000001048,0.0,0.0,146351,25.07.2018 23:50:00,16125,-0.18182991835487008,4.48,IS,0.23,0.0,Phase3-EA-S4v1-GBPJPY-M5-194,GBPJPYMT4,3476,5h 25m,Sell
172573.03,1.16297,26.07.2018 09:05:00,,0.0,-474.9900000001071,0.0,0.0,1.16305,26.07.2018 00:45:00,16126,-0.18057159297382458,3.31,IS,0.41,0.0,Phase3-EA-SA2v2-EURCHF-M5-43,EURCHFMT4,8238,8h 20m,Sell
172555.54,1.16329,26.07.2018 10:00:00,,0.0,-492.4800000000978,0.0,0.0,1.16278,26.07.2018 01:15:00,16127,-0.18722056908092113,-17.49,IS,0.34,0.0,Phase3-EA-S4v1-EURCHF-M15-221,EURCHFMT4,4196,8h 45m,Sell
172520.51,0.9935,27.07.2018 05:30:00,,0.0,-527.5100000001257,0.0,0.0,0.9941,27.07.2018 01:15:00,16128,-0.20053752923140156,-35.03,IS,0.58,0.0,Phase3-EA-SA2v2-USDCHF-M15-107,USDCHFMT4,3182,4h 15m,Buy
172506.73,1.15762,27.07.2018 07:55:00,,-0.99,-541.2900000001537,0.0,0.0,1.15793,26.07.2018 23:35:00,16129,-0.20577611646730923,-13.78,IS,0.41,0.0,Phase3-EA-SA2v2-EURCHF-M5-43,EURCHFMT4,8240,8h 20m,Buy
172554.58,1.15862,27.07.2018 11:15:00,,0.0,-493.44000000017695,0.0,0.0,1.15722,27.07.2018 02:30:00,16130,-0.1875855214573272,47.85,IS,0.34,0.0,Phase3-EA-S4v1-EURCHF-M15-221,EURCHFMT4,4198,8h 45m,Buy
172566.63,110919,30.07.2018 03:45:00,,-1.09,-481.3900000001886,0.0,0.0,110973,27.07.2018 22:45:00,16131,-0.18300460881636216,12.05,IS,0.27,0.0,Phase3-EA-S1v2-USDJPY-M15-0,USDJPYMT4,4598,2d 5h 0m,Sell
172550.56,1.15956,30.07.2018 07:40:00,,-2.06,-497.4600000001956,0.0,0.0,1.15922,27.07.2018 23:20:00,16132,-0.18911375953340878,-16.07,IS,0.41,0.0,Phase3-EA-SA2v2-EURCHF-M5-43,EURCHFMT4,8242,2d 8h 20m,Sell
172570.52,0.9881,31.07.2018 04:30:00,,0.0,-477.5000000001746,0.0,0.0,0.98844,31.07.2018 00:15:00,16133,-0.1815257913745833,19.96,IS,0.58,0.0,Phase3-EA-SA2v2-USDCHF-M15-107,USDCHFMT4,3184,4h 15m,Sell
172537.14,1.1564,31.07.2018 06:40:00,,-1.0,-510.8800000001793,0.0,0.0,1.15718,30.07.2018 22:20:00,16134,-0.19421548962815863,-33.38,IS,0.41,0.0,Phase3-EA-SA2v2-EURCHF-M5-43,EURCHFMT4,8244,8h 20m,Buy
172501.92,129797,31.07.2018 07:59:58,sl 129.797,0.0,-546.1000000001513,0.0,0.0,130027,31.07.2018 06:15:00,16135,-0.20760467993644222,-35.22,IS,0.17,0.0,Phase3-EA-T1v2-EURJPY-M15-322,EURJPYMT4,3204,1h 44m,Buy
172442.88,130478,31.07.2018 10:59:57,sl 130.478,-0.84,-605.1400000001304,0.0,0.0,129758,26.07.2018 11:00:00,16136,-0.23004925108355775,-59.04,IS,0.09,0.0,Phase3-EA-TR1v1-EURJPY-M30-91,EURJPYMT4,2856,4d 23h 59m,Sell
172539.24,1.15912,31.07.2018 14:45:00,,0.0,-508.78000000014435,0.0,0.0,1.15632,31.07.2018 06:00:00,16137,-0.19341715630482287,96.36,IS,0.34,0.0,Phase3-EA-S4v1-EURCHF-M15-221,EURCHFMT4,4200,8h 45m,Buy
172560.26,111871,01.08.2018 02:15:00,,-0.7,-487.76000000012573,0.0,0.0,111781,31.07.2018 22:30:00,16138,-0.18542621989708313,21.02,IS,0.27,0.0,Phase3-EA-S1v2-USDJPY-M15-0,USDJPYMT4,4600,3h 45m,Buy
172605.74,1.15857,01.08.2018 06:44:58,tp 1.15857,0.0,-442.28000000014435,0.0,0.0,1.15747,01.08.2018 01:45:00,16139,-0.1681366010662776,45.48,IS,0.41,0.0,Phase3-EA-SA2v2-EURCHF-M5-43,EURCHFMT4,8246,4h 59m,Buy
172669.08,1.15948,01.08.2018 10:15:00,,0.0,-378.94000000011874,0.0,0.0,1.15763,01.08.2018 01:30:00,16140,-0.1440573473999602,63.34,IS,0.34,0.0,Phase3-EA-S4v1-EURCHF-M15-221,EURCHFMT4,4202,8h 45m,Buy
172648.33,1.15685,02.08.2018 04:40:00,,-2.98,-399.69000000011874,0.0,0.0,1.15728,01.08.2018 20:20:00,16141,-0.1519456409518371,-20.75,IS,0.41,0.0,Phase3-EA-SA2v2-EURCHF-M5-43,EURCHFMT4,8248,8h 20m,Buy
172688.02,111558,02.08.2018 05:45:00,,0.0,-360.0000000001164,0.0,0.0,111722,02.08.2018 00:45:00,16142,-0.1368571411410413,39.69,IS,0.27,0.0,Phase3-EA-S1v2-USDJPY-M15-0,USDJPYMT4,4602,5h 0m,Sell
172776.6,1.15421,02.08.2018 13:45:00,,0.0,-271.4200000001001,0.0,0.0,1.1568,02.08.2018 05:00:00,16143,-0.103182681245842,88.58,IS,0.34,0.0,Phase3-EA-S4v1-EURCHF-M15-221,EURCHFMT4,4204,8h 45m,Sell
172879.51,129523,02.08.2018 13:59:58,tp 129.523,-1.13,-168.51000000012573,0.0,0.0,130813,31.07.2018 21:30:00,16144,-0.06406054681579616,102.91,IS,0.09,0.0,Phase3-EA-TR1v1-EURJPY-M30-91,EURJPYMT4,2858,1d 16h 29m,Sell
172868.23,1.15358,03.08.2018 05:40:00,,-0.99,-179.79000000015367,0.0,0.0,1.15383,02.08.2018 21:20:00,16145,-0.0683487372382247,-11.28,IS,0.41,0.0,Phase3-EA-SA2v2-EURCHF-M5-43,EURCHFMT4,8250,8h 20m,Buy
172888.04,1.15377,03.08.2018 10:00:00,,0.0,-159.980000000156,0.0,0.0,1.15319,03.08.2018 01:15:00,16146,-0.06081779288821682,19.81,IS,0.34,0.0,Phase3-EA-S4v1-EURCHF-M15-221,EURCHFMT4,4206,8h 45m,Buy
173030.44,144.75,03.08.2018 17:59:58,tp 144.750,-7.03,-17.580000000132713,0.0,0.0,146.6,19.07.2018 18:00:00,16147,-0.006683190392435808,142.4,IS,0.09,0.0,Phase3-EA-B1v1-GBPJPY-M30-1,GBPJPYMT4,1458,14d 23h 59m,Sell
173131.09,128854,03.08.2018 17:59:58,tp 128.854,-1.13,-0.0,0.0,0.0,130114,01.08.2018 23:00:00,16148,-0.0,100.65,IS,0.09,0.0,Phase3-EA-TR1v1-EURJPY-M30-91,EURJPYMT4,2859,1d 18h 59m,Sell
173186.4,0.99307,06.08.2018 01:00:00,tp 0.99307,-3.09,-0.0,0.0,0.0,0.99407,03.08.2018 23:00:00,16149,-0.0,55.31,IS,0.58,0.0,Phase3-EA-SA2v2-USDCHF-M15-107,USDCHFMT4,3186,2d 2h 0m,Sell
173229.69,1.14965,06.08.2018 01:00:00,tp 1.14965,-2.06,-0.0,0.0,0.0,1.15075,03.08.2018 21:40:00,16150,-0.0,43.29,IS,0.41,0.0,Phase3-EA-SA2v2-EURCHF-M5-43,EURCHFMT4,8252,2d 3h 20m,Sell
173248.27,111167,06.08.2018 01:15:00,,-1.09,-0.0,0.0,0.0,111248,03.08.2018 22:45:00,16151,-0.0,18.58,IS,0.27,0.0,Phase3-EA-S1v2-USDJPY-M15-0,USDJPYMT4,4604,2d 2h 30m,Sell
173222.04,0.99487,06.08.2018 07:00:00,,0.0,-26.229999999981374,0.0,0.0,0.99442,06.08.2018 02:45:00,16152,-0.00996397811084618,-26.23,IS,0.58,0.0,Phase3-EA-SA2v2-USDCHF-M15-107,USDCHFMT4,3188,4h 15m,Sell
173248.68,1.15013,06.08.2018 09:45:00,,0.0,-0.0,0.0,0.0,1.14935,06.08.2018 01:00:00,16153,-0.0,26.64,IS,0.34,0.0,Phase3-EA-S4v1-EURCHF-M15-221,EURCHFMT4,4208,8h 45m,Buy
173256.33,1.15175,07.08.2018 06:40:00,,-0.99,-0.0,0.0,0.0,1.15154,06.08.2018 22:20:00,16154,-0.0,7.65,IS,0.41,0.0,Phase3-EA-SA2v2-EURCHF-M5-43,EURCHFMT4,8254,8h 20m,Buy
173235.01,111322,07.08.2018 11:15:00,,-0.7,-21.320000000006985,0.0,0.0,111407,06.08.2018 19:45:00,16155,-0.00809857069723903,-21.32,IS,0.27,0.0,Phase3-EA-S1v2-USDJPY-M15-0,USDJPYMT4,4606,15h 30m,Buy
173170.8,1.15354,07.08.2018 13:30:00,,0.0,-85.53000000002794,0.0,0.0,1.15166,07.08.2018 04:45:00,16156,-0.032489247267113205,-64.21,IS,0.34,0.0,Phase3-EA-S4v1-EURCHF-M15-221,EURCHFMT4,4210,8h 45m,Sell
173133.31,1.15494,08.08.2018 07:00:00,,-2.06,-123.02000000001863,0.0,0.0,1.15408,07.08.2018 22:40:00,16157,-0.04673012041154643,-37.49,IS,0.41,0.0,Phase3-EA-SA2v2-EURCHF-M5-43,EURCHFMT4,8256,8h 20m,Sell
173074.55,129359,08.08.2018 07:29:58,sl 129.359,-0.56,-181.78000000002794,0.0,0.0,128963,03.08.2018 21:00:00,16158,-0.06905057135759168,-58.76,IS,0.09,0.0,Phase3-EA-TR1v1-EURJPY-M30-91,EURJPYMT4,2862,4d 10h 29m,Buy
173052.33,1.15544,08.08.2018 11:30:00,,0.0,-204.0,0.0,0.0,1.15479,08.08.2018 02:45:00,16159,-0.07749101417618295,-22.22,IS,0.34,0.0,Phase3-EA-S4v1-EURCHF-M15-221,EURCHFMT4,4212,8h 45m,Sell
172993.91,128.67,08.08.2018 12:29:58,sl 128.670,0.0,-262.4199999999837,0.0,0.0,128639,06.08.2018 02:30:00,16160,-0.09968231343192485,-58.42,IS,0.09,0.0,Phase3-EA-TR1v1-EURJPY-M30-91,EURJPYMT4,2863,2d 9h 59m,Sell
173001.09,110949,09.08.2018 01:30:00,,-3.28,-255.2399999999907,0.0,0.0,110992,08.08.2018 23:15:00,16161,-0.09695493361925596,7.18,IS,0.27,0.0,Phase3-EA-S1v2-USDJPY-M15-0,USDJPYMT4,4608,2h 15m,Sell
173078.45,142636,09.08.2018 04:14:58,tp 142.636,-3.61,-177.88000000000466,0.0,0.0,143026,08.08.2018 23:05:00,16162,-0.06756912549833229,77.36,IS,0.23,0.0,Phase3-EA-S4v1-GBPJPY-M5-194,GBPJPYMT4,3478,5h 9m,Sell
173069.7,1.15296,09.08.2018 04:40:00,,-2.97,-186.63000000000466,0.0,0.0,1.1531,08.08.2018 20:20:00,16163,-0.07089288223383032,-8.75,IS,0.41,0.0,Phase3-EA-SA2v2-EURCHF-M5-43,EURCHFMT4,8258,8h 20m,Buy
173092.3,1.15345,09.08.2018 10:15:00,,0.0,-164.03000000002794,0.0,0.0,1.15279,09.08.2018 01:30:00,16164,-0.06230809340843851,22.6,IS,0.34,0.0,Phase3-EA-S4v1-EURCHF-M15-221,EURCHFMT4,4214,8h 45m,Buy
173137.75,1.14681,09.08.2018 21:54:57,tp 1.14681,0.0,-118.5800000000163,0.0,0.0,1.14571,09.08.2018 20:00:00,16165,-0.04504355127947568,45.45,IS,0.41,0.0,Phase3-EA-SA2v2-EURCHF-M5-43,EURCHFMT4,8260,1h 54m,Buy
173072.12,128183,09.08.2018 22:29:58,sl 128.183,-2.39,-184.21000000002095,0.0,0.0,129.39,08.08.2018 07:30:00,16166,-0.06997362608527592,-65.63,IS,0.09,0.0,Phase3-EA-TR1v1-EURJPY-M30-91,EURJPYMT4,2865,1d 14h 59m,Buy
173127.49,0.99211,10.08.2018 01:14:58,tp 0.99211,-3.09,-128.8400000000256,0.0,0.0,0.99311,09.08.2018 23:15:00,16167,-0.048940893463046066,55.37,IS,0.58,0.0,Phase3-EA-SA2v2-USDCHF-M15-107,USDCHFMT4,3190,1h 59m,Sell
173074.27,142262,10.08.2018 05:20:00,,-0.75,-182.05999999999767,0.0,0.0,142515,09.08.2018 23:55:00,16168,-0.06915693157311613,-53.22,IS,0.23,0.0,Phase3-EA-S4v1-GBPJPY-M5-194,GBPJPYMT4,3480,5h 25m,Buy
173102.57,1.14587,10.08.2018 08:05:00,,-0.99,-153.7600000000093,0.0,0.0,1.14516,09.08.2018 23:45:00,16169,-0.0584069526457383,28.3,IS,0.41,0.0,Phase3-EA-SA2v2-EURCHF-M5-43,EURCHFMT4,8262,8h 20m,Buy
173358.97,127733,10.08.2018 08:29:58,tp 127.733,-4.27,-0.0,0.0,0.0,129433,02.08.2018 22:45:00,16170,-0.0,256.4,IS,0.17,0.0,Phase3-EA-T1v2-EURJPY-M15-322,EURJPYMT4,3206,7d 9h 44m,Sell
173225.55,1.14127,10.08.2018 09:14:58,sl 1.14127,0.0,-133.4199999999837,0.0,0.0,1.14517,10.08.2018 01:30:00,16171,-0.05066089072264485,-133.42,IS,0.34,0.0,Phase3-EA-S4v1-EURCHF-M15-221,EURCHFMT4,4216,7h 44m,Buy
173326.81,127339,10.08.2018 09:29:58,tp 127.339,-1.13,-32.15999999997439,0.0,0.0,128599,08.08.2018 12:30:00,16172,-0.012211469387192024,101.26,IS,0.09,0.0,Phase3-EA-TR1v1-EURJPY-M30-91,EURJPYMT4,2867,1d 20h 59m,Sell
173476.18,140984,10.08.2018 17:29:58,tp 140.984,-0.47,-0.0,0.0,0.0,142834,09.08.2018 03:00:00,16173,-0.0,149.37,IS,0.09,0.0,Phase3-EA-B1v1-GBPJPY-M30-1,GBPJPYMT4,1460,1d 14h 29m,Sell
173521.52,1.13519,10.08.2018 23:19:58,tp 1.13519,0.0,-0.0,0.0,0.0,1.13409,10.08.2018 21:25:00,16174,-0.0,45.34,IS,0.41,0.0,Phase3-EA-SA2v2-EURCHF-M5-43,EURCHFMT4,8264,1h 54m,Buy
173467.21,141679,10.08.2018 23:29:58,sl 141.679,0.0,-54.30999999999767,0.0,0.0,141009,10.08.2018 17:30:00,16175,-0.020609322532747,-54.31,IS,0.09,0.0,Phase3-EA-B1v1-GBPJPY-M30-1,GBPJPYMT4,1462,5h 59m,Sell
173512.53,1.1354,10.08.2018 23:39:58,tp 1.13540,0.0,-8.989999999990687,0.0,0.0,1.1365,10.08.2018 23:25:00,16176,-0.003411486090392405,45.32,IS,0.41,0.0,Phase3-EA-SA2v2-EURCHF-M5-43,EURCHFMT4,8266,14m 58s,Sell
173614.59,125725,13.08.2018 01:00:00,tp 125.725,-0.28,-0.0,0.0,0.0,126985,10.08.2018 09:30:00,16177,-0.0,102.06,IS,0.09,0.0,Phase3-EA-TR1v1-EURJPY-M30-91,EURJPYMT4,2870,2d 15h 30m,Sell
173694.34,141209,13.08.2018 01:00:00,tp 141.209,-1.2,-0.0,0.0,0.0,141599,10.08.2018 23:30:00,16178,-0.0,79.75,IS,0.23,0.0,Phase3-EA-S4v1-GBPJPY-M5-194,GBPJPYMT4,3482,2d 1h 30m,Sell
173791.0,110472,13.08.2018 01:00:00,tp 110.472,-1.1,-0.0,0.0,0.0,110872,10.08.2018 23:30:00,16179,-0.0,96.66,IS,0.27,0.0,Phase3-EA-S1v2-USDJPY-M15-0,USDJPYMT4,4610,2d 1h 30m,Sell
173872.0,141236,13.08.2018 02:19:58,tp 141.236,0.0,-0.0,0.0,0.0,140846,13.08.2018 01:10:00,16180,-0.0,81.0,IS,0.23,0.0,Phase3-EA-S4v1-GBPJPY-M5-194,GBPJPYMT4,3484,1h 9m,Buy
173815.88,0.99427,13.08.2018 03:45:00,,-0.7,-56.11999999999534,0.0,0.0,0.99522,10.08.2018 23:30:00,16181,-0.02126788746058508,-56.12,IS,0.58,0.0,Phase3-EA-SA2v2-USDCHF-M15-107,USDCHFMT4,3192,2d 4h 15m,Buy
173906.15,1.13373,13.08.2018 10:45:00,,0.0,-0.0,0.0,0.0,1.13109,13.08.2018 02:00:00,16182,-0.0,90.27,IS,0.34,0.0,Phase3-EA-S4v1-EURCHF-M15-221,EURCHFMT4,4218,8h 45m,Buy
173910.07,110732,14.08.2018 01:45:00,,-0.71,-0.0,0.0,0.0,110713,13.08.2018 20:15:00,16183,-0.0,3.92,IS,0.27,0.0,Phase3-EA-S1v2-USDJPY-M15-0,USDJPYMT4,4612,5h 30m,Buy
173938.79,1.13296,14.08.2018 04:25:00,,-0.99,-0.0,0.0,0.0,1.13224,13.08.2018 20:05:00,16184,-0.0,28.72,IS,0.41,0.0,Phase3-EA-SA2v2-EURCHF-M5-43,EURCHFMT4,8268,8h 20m,Buy
173980.22,0.99388,14.08.2018 05:00:00,,0.0,-0.0,0.0,0.0,0.99317,14.08.2018 00:45:00,16185,-0.0,41.43,IS,0.58,0.0,Phase3-EA-SA2v2-USDCHF-M15-107,USDCHFMT4,3194,4h 15m,Buy
174067.68,1.13087,14.08.2018 14:15:00,,0.0,-0.0,0.0,0.0,1.13342,14.08.2018 05:30:00,16186,-0.0,87.46,IS,0.34,0.0,Phase3-EA-S4v1-EURCHF-M15-221,EURCHFMT4,4220,8h 45m,Sell
174032.4,126092,14.08.2018 17:59:58,sl 126.092,0.0,-35.28000000002794,0.0,0.0,126322,14.08.2018 05:00:00,16187,-0.013360211291297656,-35.28,IS,0.17,0.0,Phase3-EA-T1v2-EURJPY-M15-322,EURJPYMT4,3208,12h 59m,Buy
174077.77,1.12789,14.08.2018 21:59:58,tp 1.12789,0.0,-0.0,0.0,0.0,1.12679,14.08.2018 20:45:00,16188,-0.0,45.37,IS,0.41,0.0,Phase3-EA-SA2v2-EURCHF-M5-43,EURCHFMT4,8270,1h 14m,Buy
174123.14,1.12697,15.08.2018 01:34:57,tp 1.12697,0.0,-0.0,0.0,0.0,1.12807,15.08.2018 00:30:00,16189,-0.0,45.37,IS,0.41,0.0,Phase3-EA-SA2v2-EURCHF-M5-43,EURCHFMT4,8272,1h 4m,Sell
174137.7,111239,15.08.2018 03:45:00,,0.0,-0.0,0.0,0.0,111179,15.08.2018 01:15:00,16190,-0.0,14.56,IS,0.27,0.0,Phase3-EA-S1v2-USDJPY-M15-0,USDJPYMT4,4614,2h 30m,Buy
174076.39,1.12944,15.08.2018 10:45:00,,0.0,-61.30999999999767,0.0,0.0,1.12795,15.08.2018 02:25:00,16191,-0.02321137800472911,-61.31,IS,0.41,0.0,Phase3-EA-SA2v2-EURCHF-M5-43,EURCHFMT4,8274,8h 20m,Sell
174041.25,126247,15.08.2018 11:29:58,sl 126.247,0.0,-96.45000000001164,0.0,0.0,126017,15.08.2018 07:15:00,16192,-0.03651504499358144,-35.14,IS,0.17,0.0,Phase3-EA-T1v2-EURJPY-M15-322,EURJPYMT4,3210,4h 14m,Sell
174029.32,1.12917,15.08.2018 15:00:00,,0.0,-108.38000000000466,0.0,0.0,1.12882,15.08.2018 06:15:00,16193,-0.04103162857858008,-11.93,IS,0.34,0.0,Phase3-EA-S4v1-EURCHF-M15-221,EURCHFMT4,4222,8h 45m,Sell
173965.07,124954,15.08.2018 18:59:58,sl 124.954,-0.8,-172.63000000000466,0.0,0.0,125734,13.08.2018 10:30:00,16194,-0.06535606238715784,-64.25,IS,0.09,0.0,Phase3-EA-TR1v1-EURJPY-M30-91,EURJPYMT4,2872,2d 8h 29m,Buy
174004.28,1.12611,16.08.2018 01:04:58,tp 1.12611,-6.19,-133.4199999999837,0.0,0.0,1.12721,15.08.2018 20:50:00,16195,-0.05051153243175171,39.21,IS,0.41,0.0,Phase3-EA-SA2v2-EURCHF-M5-43,EURCHFMT4,8276,4h 14m,Sell
174060.55,0.99371,16.08.2018 01:14:57,tp 0.99371,-2.1,-77.14999999996508,0.0,0.0,0.99271,15.08.2018 23:15:00,16196,-0.029208250090753684,56.27,IS,0.58,0.0,Phase3-EA-SA2v2-USDCHF-M15-107,USDCHFMT4,3196,1h 59m,Buy
174069.22,110577,16.08.2018 03:45:00,,-3.29,-68.47999999998137,0.0,0.0,110626,15.08.2018 23:15:00,16197,-0.025925871240637378,8.67,IS,0.27,0.0,Phase3-EA-S1v2-USDJPY-M15-0,USDJPYMT4,4616,4h 30m,Sell
174033.83,125584,16.08.2018 05:29:58,sl 125.584,0.0,-103.86999999999534,0.0,0.0,125354,16.08.2018 04:15:00,16198,-0.03932418583185771,-35.39,IS,0.17,0.0,Phase3-EA-T1v2-EURJPY-M15-322,EURJPYMT4,3212,1h 14m,Sell
174114.72,140809,16.08.2018 05:39:58,tp 140.809,0.0,-22.979999999981374,0.0,0.0,140419,16.08.2018 03:15:00,16199,-0.008700007609660136,80.89,IS,0.23,0.0,Phase3-EA-S4v1-GBPJPY-M5-194,GBPJPYMT4,3486,2h 24m,Buy
174159.98,1.13312,16.08.2018 20:34:58,tp 1.13312,0.0,-0.0,0.0,0.0,1.13422,16.08.2018 20:05:00,16200,-0.0,45.26,IS,0.41,0.0,Phase3-EA-SA2v2-EURCHF-M5-43,EURCHFMT4,8278,29m 58s,Sell
174204.25,1.13342,17.08.2018 00:19:57,tp 1.13342,-0.99,-0.0,0.0,0.0,1.13232,16.08.2018 20:50:00,16201,-0.0,44.27,IS,0.41,0.0,Phase3-EA-SA2v2-EURCHF-M5-43,EURCHFMT4,8280,3h 29m,Buy
174205.48,126162,17.08.2018 00:30:00,,0.0,-0.0,0.0,0.0,126154,17.08.2018 00:15:00,16202,-0.0,1.23,IS,0.17,0.0,Phase3-EA-T1v2-EURJPY-M15-322,EURJPYMT4,3214,15m 0s,Buy
174212.78,110934,17.08.2018 02:45:00,,0.0,-0.0,0.0,0.0,110904,17.08.2018 00:45:00,16203,-0.0,7.3,IS,0.27,0.0,Phase3-EA-S1v2-USDJPY-M15-0,USDJPYMT4,4618,2h 0m,Buy
174164.66,1.13455,17.08.2018 08:40:00,,0.0,-48.11999999999534,0.0,0.0,1.13338,17.08.2018 00:20:00,16204,-0.018212593652735157,-48.12,IS,0.41,0.0,Phase3-EA-SA2v2-EURCHF-M5-43,EURCHFMT4,8282,8h 20m,Sell
174167.77,141071,17.08.2018 09:20:00,,0.0,-45.01000000000931,0.0,0.0,141086,17.08.2018 03:55:00,16205,-0.01703551205963962,3.11,IS,0.23,0.0,Phase3-EA-S4v1-GBPJPY-M5-194,GBPJPYMT4,3488,5h 25m,Sell
174157.53,1.13434,17.08.2018 11:45:00,,0.0,-55.25,0.0,0.0,1.13404,17.08.2018 03:00:00,16206,-0.020911176211839463,-10.24,IS,0.34,0.0,Phase3-EA-S4v1-EURCHF-M15-221,EURCHFMT4,4224,8h 45m,Sell
174122.22,126098,17.08.2018 13:14:58,sl 126.098,0.0,-90.55999999999767,0.0,0.0,126328,17.08.2018 12:30:00,16207,-0.03427540484604766,-35.31,IS,0.17,0.0,Phase3-EA-T1v2-EURJPY-M15-322,EURJPYMT4,3216,44m 58s,Buy
174148.16,110343,17.08.2018 21:30:00,,0.0,-64.61999999999534,0.0,0.0,110449,17.08.2018 19:00:00,16208,-0.024457560304234727,25.94,IS,0.27,0.0,Phase3-EA-S1v2-USDJPY-M15-0,USDJPYMT4,4620,2h 30m,Sell
174112.74,126165,17.08.2018 22:14:58,sl 126.165,0.0,-100.03999999997905,0.0,0.0,125935,17.08.2018 21:45:00,16209,-0.03786342204944763,-35.42,IS,0.17,0.0,Phase3-EA-T1v2-EURJPY-M15-322,EURJPYMT4,3218,29m 58s,Sell
174136.72,140843,20.08.2018 04:25:00,,-1.21,-76.05999999999767,0.0,0.0,140964,17.08.2018 23:00:00,16210,-0.028787403849275306,23.98,IS,0.23,0.0,Phase3-EA-S4v1-GBPJPY-M5-194,GBPJPYMT4,3490,2d 5h 25m,Sell
174093.43,1.13677,20.08.2018 06:30:00,,-2.06,-119.34999999997672,0.0,0.0,1.13577,17.08.2018 22:10:00,16211,-0.04517192544583806,-43.29,IS,0.41,0.0,Phase3-EA-SA2v2-EURCHF-M5-43,EURCHFMT4,8284,2d 8h 20m,Sell
174080.15,1.13827,21.08.2018 04:35:00,,-2.07,-132.63000000000466,0.0,0.0,1138,20.08.2018 20:15:00,16212,-0.05019817739323738,-13.28,IS,0.41,0.0,Phase3-EA-SA2v2-EURCHF-M5-43,EURCHFMT4,8286,8h 20m,Sell
173922.28,0.98831,21.08.2018 06:45:00,,0.0,-290.5,0.0,0.0,991,21.08.2018 02:30:00,16213,-0.10994926134912875,-157.87,IS,0.58,0.0,Phase3-EA-SA2v2-USDCHF-M15-107,USDCHFMT4,3198,4h 15m,Buy
174025.4,126888,21.08.2018 07:59:58,tp 126.888,-2.4,-187.38000000000466,0.0,0.0,125598,15.08.2018 21:00:00,16214,-0.07092011219139503,103.12,IS,0.09,0.0,Phase3-EA-TR1v1-EURJPY-M30-91,EURJPYMT4,2874,5d 10h 59m,Buy
174040.88,1138,21.08.2018 11:00:00,,0.0,-171.90000000002328,0.0,0.0,1.13845,21.08.2018 02:15:00,16215,-0.0650611980238134,15.48,IS,0.34,0.0,Phase3-EA-S4v1-EURCHF-M15-221,EURCHFMT4,4226,8h 45m,Sell
173977.36,127532,21.08.2018 20:59:58,sl 127.532,0.0,-235.4200000000419,0.0,0.0,126752,21.08.2018 11:30:00,16216,-0.08910242721795697,-63.52,IS,0.09,0.0,Phase3-EA-TR1v1-EURJPY-M30-91,EURJPYMT4,2876,9h 29m,Sell
173983.62,1.13893,22.08.2018 04:20:00,,-2.08,-229.1600000000326,0.0,0.0,1.13913,21.08.2018 20:00:00,16217,-0.08673312471865724,6.26,IS,0.41,0.0,Phase3-EA-SA2v2-EURCHF-M5-43,EURCHFMT4,8288,8h 20m,Sell
174246.63,1.29322,22.08.2018 17:29:57,tp 1.29322,-1.59,-0.0,0.0,0.0,1.27432,17.08.2018 22:30:00,16218,-0.0,263.01,IS,0.14,0.0,Phase3-EA-B1v1-GBPUSD-M30-14,GBPUSDMT4,1058,4d 18h 59m,Buy
174292.5,1.13927,22.08.2018 22:39:58,tp 1.13927,0.0,-0.0,0.0,0.0,1.14037,22.08.2018 20:00:00,16219,-0.0,45.87,IS,0.41,0.0,Phase3-EA-SA2v2-EURCHF-M5-43,EURCHFMT4,8290,2h 39m,Sell
174351.47,0.98355,22.08.2018 22:44:57,tp 0.98355,0.0,-0.0,0.0,0.0,0.98255,22.08.2018 22:15:00,16220,-0.0,58.97,IS,0.58,0.0,Phase3-EA-SA2v2-USDCHF-M15-107,USDCHFMT4,3200,29m 57s,Buy
174306.89,1.1373,23.08.2018 14:00:00,,0.0,-44.5800000000163,0.0,0.0,1.13859,23.08.2018 05:15:00,16221,-0.01686391227558375,-44.58,IS,0.34,0.0,Phase3-EA-S4v1-EURCHF-M15-221,EURCHFMT4,4228,8h 45m,Buy
174242.74,128509,23.08.2018 17:59:58,sl 128.509,-0.86,-108.73000000003958,0.0,0.0,127729,22.08.2018 00:30:00,16222,-0.04113084750390798,-64.15,IS,0.09,0.0,Phase3-EA-TR1v1-EURJPY-M30-91,EURJPYMT4,2878,1d 17h 29m,Sell
174342.88,128399,24.08.2018 00:15:00,,-3.01,-8.590000000025611,0.0,0.0,127724,22.08.2018 06:30:00,16223,-0.0032494617866227755,100.14,IS,0.17,0.0,Phase3-EA-T1v2-EURJPY-M15-322,EURJPYMT4,3220,1d 17h 45m,Buy
174349.92,111239,24.08.2018 01:00:00,,0.0,-1.5500000000465661,0.0,0.0,111.21,24.08.2018 00:30:00,16224,-5.863406017929686E-4,7.04,IS,0.27,0.0,Phase3-EA-S1v2-USDJPY-M15-0,USDJPYMT4,4622,30m 0s,Buy
174345.18,1.13833,24.08.2018 04:40:00,,-1.0,-6.290000000037253,0.0,0.0,1.13842,23.08.2018 20:20:00,16225,-0.002379407990444397,-4.74,IS,0.41,0.0,Phase3-EA-SA2v2-EURCHF-M5-43,EURCHFMT4,8292,8h 20m,Buy
174368.13,0.98575,24.08.2018 07:00:00,,0.0,-0.0,0.0,0.0,0.98614,24.08.2018 02:45:00,16226,-0.0,22.95,IS,0.58,0.0,Phase3-EA-SA2v2-USDCHF-M15-107,USDCHFMT4,3202,4h 15m,Sell
174467.53,1.14003,24.08.2018 10:30:00,,0.0,-0.0,0.0,0.0,1.13715,24.08.2018 01:45:00,16227,-0.0,99.4,IS,0.34,0.0,Phase3-EA-S4v1-EURCHF-M15-221,EURCHFMT4,4230,8h 45m,Buy
174526.57,0.98244,27.08.2018 03:59:58,tp 0.98244,0.0,-0.0,0.0,0.0,0.98344,27.08.2018 01:15:00,16228,-0.0,59.04,IS,0.58,0.0,Phase3-EA-SA2v2-USDCHF-M15-107,USDCHFMT4,3204,2h 44m,Sell
174622.26,129115,27.08.2018 08:00:00,,-0.75,-0.0,0.0,0.0,128485,24.08.2018 02:15:00,16229,-0.0,95.69,IS,0.17,0.0,Phase3-EA-T1v2-EURJPY-M15-322,EURJPYMT4,3222,3d 5h 45m,Buy
174607.26,1.14309,27.08.2018 09:55:00,,0.0,-15.0,0.0,0.0,1.14273,27.08.2018 01:35:00,16230,-0.005668457370139583,-15.0,IS,0.41,0.0,Phase3-EA-SA2v2-EURCHF-M5-43,EURCHFMT4,8294,8h 20m,Sell
174661.55,1.14181,27.08.2018 13:30:00,,0.0,-0.0,0.0,0.0,1.14338,27.08.2018 04:45:00,16231,-0.0,54.29,IS,0.34,0.0,Phase3-EA-S4v1-EURCHF-M15-221,EURCHFMT4,4232,8h 45m,Sell
174636.85,1.14513,28.08.2018 04:50:00,,-2.09,-24.70000000001164,0.0,0.0,1.14459,27.08.2018 20:30:00,16232,-0.009332674126638919,-24.7,IS,0.41,0.0,Phase3-EA-SA2v2-EURCHF-M5-43,EURCHFMT4,8296,8h 20m,Sell
174623.24,129871,28.08.2018 12:00:00,,0.0,-38.30999999999767,0.0,0.0,129.96,28.08.2018 11:15:00,16233,-0.01447509092272659,-13.61,IS,0.17,0.0,Phase3-EA-T1v2-EURJPY-M15-322,EURJPYMT4,3224,45m 0s,Buy
174654.88,1.14336,28.08.2018 12:15:00,,0.0,-6.669999999983702,0.0,0.0,1.14427,28.08.2018 03:30:00,16234,-0.002520199855242921,31.64,IS,0.34,0.0,Phase3-EA-S4v1-EURCHF-M15-221,EURCHFMT4,4234,8h 45m,Sell
174756.15,130125,28.08.2018 15:59:58,tp 130.125,-0.8,-0.0,0.0,0.0,128865,24.08.2018 10:30:00,16235,-0.0,101.27,IS,0.09,0.0,Phase3-EA-TR1v1-EURJPY-M30-91,EURJPYMT4,2880,4d 5h 29m,Buy
174815.52,0.9769,29.08.2018 04:29:57,tp 0.97690,0.0,-0.0,0.0,0.0,0.9759,29.08.2018 01:15:00,16236,-0.0,59.37,IS,0.58,0.0,Phase3-EA-SA2v2-USDCHF-M15-107,USDCHFMT4,3206,3h 14m,Buy
174803.18,1.14195,29.08.2018 04:50:00,,-1.01,-12.340000000025611,0.0,0.0,1.14222,28.08.2018 20:30:00,16237,-0.004659847730988559,-12.34,IS,0.41,0.0,Phase3-EA-SA2v2-EURCHF-M5-43,EURCHFMT4,8298,8h 20m,Buy
174768.03,129965,29.08.2018 09:14:58,sl 129.965,0.0,-47.490000000048894,0.0,0.0,130195,29.08.2018 06:30:00,16238,-0.01793323895821841,-35.15,IS,0.17,0.0,Phase3-EA-T1v2-EURJPY-M15-322,EURJPYMT4,3226,2h 44m,Buy
174753.76,1.14094,29.08.2018 10:30:00,,0.0,-61.76000000006752,0.0,0.0,1.14135,29.08.2018 01:45:00,16239,-0.023321895937242362,-14.27,IS,0.34,0.0,Phase3-EA-S4v1-EURCHF-M15-221,EURCHFMT4,4236,8h 45m,Buy
174800.15,1.13695,29.08.2018 20:29:57,tp 1.13695,0.0,-15.370000000053551,0.0,0.0,1.13805,29.08.2018 20:05:00,16240,-0.005804040488281608,46.39,IS,0.41,0.0,Phase3-EA-SA2v2-EURCHF-M5-43,EURCHFMT4,8300,24m 57s,Sell
174814.41,111736,30.08.2018 02:45:00,,0.0,-1.1100000000442378,0.0,0.0,111677,30.08.2018 00:30:00,16241,-4.1915972298158075E-4,14.26,IS,0.27,0.0,Phase3-EA-S1v2-USDJPY-M15-0,USDJPYMT4,4624,2h 15m,Buy
174818.59,0.97064,30.08.2018 04:45:00,,0.0,-0.0,0.0,0.0,0.97057,30.08.2018 00:30:00,16242,-0.0,4.18,IS,0.58,0.0,Phase3-EA-SA2v2-USDCHF-M15-107,USDCHFMT4,3208,4h 15m,Buy
174801.01,145538,30.08.2018 04:55:00,,-3.58,-17.580000000016298,0.0,0.0,145.47,29.08.2018 23:30:00,16243,-0.006638506760426532,-17.58,IS,0.23,0.0,Phase3-EA-S4v1-GBPJPY-M5-194,GBPJPYMT4,3492,5h 25m,Sell
174782.34,1.13589,30.08.2018 06:55:00,,-3.04,-36.25,0.0,0.0,1.13626,29.08.2018 22:35:00,16244,-0.013688616044666592,-18.67,IS,0.41,0.0,Phase3-EA-SA2v2-EURCHF-M5-43,EURCHFMT4,8302,8h 20m,Buy
174745.93,1.1351,30.08.2018 10:00:00,,0.0,-72.65999999997439,0.0,0.0,1.13614,30.08.2018 01:15:00,16245,-0.027437650808417213,-36.41,IS,0.34,0.0,Phase3-EA-S4v1-EURCHF-M15-221,EURCHFMT4,4238,8h 45m,Buy
175007.34,1.30405,30.08.2018 11:29:58,tp 1.30405,-3.19,-0.0,0.0,0.0,1.28515,24.08.2018 14:30:00,16246,-0.0,261.41,IS,0.14,0.0,Phase3-EA-B1v1-GBPUSD-M30-14,GBPUSDMT4,1060,5d 20h 59m,Buy
174953.21,144.89,30.08.2018 17:29:58,sl 144.890,0.0,-54.13000000000466,0.0,0.0,145.56,30.08.2018 02:00:00,16247,-0.020425849336853995,-54.13,IS,0.09,0.0,Phase3-EA-B1v1-GBPJPY-M30-1,GBPJPYMT4,1464,15h 29m,Buy
174999.67,1.13173,30.08.2018 21:09:57,tp 1.13173,0.0,-7.669999999983702,0.0,0.0,1.13063,30.08.2018 20:05:00,16248,-0.002894259457109251,46.46,IS,0.41,0.0,Phase3-EA-SA2v2-EURCHF-M5-43,EURCHFMT4,8304,1h 4m,Buy
174936.08,0.96869,31.08.2018 02:45:00,,-0.72,-71.26000000000931,0.0,0.0,0.96974,30.08.2018 22:30:00,16249,-0.026889821240426392,-63.59,IS,0.58,0.0,Phase3-EA-SA2v2-USDCHF-M15-107,USDCHFMT4,3210,4h 15m,Buy
174914.47,1.12978,31.08.2018 10:10:00,,0.0,-92.86999999999534,0.0,0.0,1.13029,31.08.2018 01:50:00,16250,-0.03504431235753505,-21.61,IS,0.41,0.0,Phase3-EA-SA2v2-EURCHF-M5-43,EURCHFMT4,8306,8h 20m,Buy
174874.69,1.12874,31.08.2018 12:15:00,,0.0,-132.65000000002328,0.0,0.0,1.12987,31.08.2018 03:30:00,16251,-0.05005521733851699,-39.78,IS,0.34,0.0,Phase3-EA-S4v1-EURCHF-M15-221,EURCHFMT4,4240,8h 45m,Buy
174879.57,110753,31.08.2018 17:15:00,,0.0,-127.77000000001863,0.0,0.0,110773,31.08.2018 17:00:00,16252,-0.04821375890947702,4.88,IS,0.27,0.0,Phase3-EA-S1v2-USDJPY-M15-0,USDJPYMT4,4626,15m 0s,Sell
174982.97,128862,31.08.2018 17:29:57,tp 128.862,-1.41,-24.369999999995343,0.0,0.0,130152,28.08.2018 21:00:00,16253,-0.00919597170402723,103.4,IS,0.09,0.0,Phase3-EA-TR1v1-EURJPY-M30-91,EURJPYMT4,2882,2d 20h 29m,Sell
175042.05,0.96989,03.09.2018 01:29:57,tp 0.96989,-0.72,-0.0,0.0,0.0,0.96889,31.08.2018 22:45:00,16254,-0.0,59.08,IS,0.58,0.0,Phase3-EA-SA2v2-USDCHF-M15-107,USDCHFMT4,3212,2d 2h 44m,Buy
175053.29,1.12453,03.09.2018 04:40:00,,-1.02,-0.0,0.0,0.0,1.12424,31.08.2018 20:20:00,16255,-0.0,11.24,IS,0.41,0.0,Phase3-EA-SA2v2-EURCHF-M5-43,EURCHFMT4,8308,2d 8h 20m,Buy
175005.5,111005,03.09.2018 04:45:00,,-1.09,-47.789999999979045,0.0,0.0,110813,31.08.2018 17:30:00,16256,-0.018030336465538244,-47.79,IS,0.27,0.0,Phase3-EA-S1v2-USDJPY-M15-0,USDJPYMT4,4628,2d 11h 15m,Sell
174983.1,143376,03.09.2018 06:35:00,,0.0,-70.19000000000233,0.0,0.0,143484,03.09.2018 01:10:00,16257,-0.026481467179676213,-22.4,IS,0.23,0.0,Phase3-EA-S4v1-GBPJPY-M5-194,GBPJPYMT4,3494,5h 25m,Buy
174947.84,128934,03.09.2018 11:44:58,sl 128.934,0.0,-105.45000000001164,0.0,0.0,128704,03.09.2018 05:00:00,16258,-0.03978445240200986,-35.26,IS,0.17,0.0,Phase3-EA-T1v2-EURJPY-M15-322,EURJPYMT4,3228,6h 44m,Sell
174934.8,142881,04.09.2018 06:35:00,,0.0,-118.48999999999069,0.0,0.0,142944,04.09.2018 01:10:00,16259,-0.044704217782012876,-13.04,IS,0.23,0.0,Phase3-EA-S4v1-GBPJPY-M5-194,GBPJPYMT4,3496,5h 25m,Buy
174925.92,1.12523,04.09.2018 09:30:00,,0.0,-127.36999999999534,0.0,0.0,1.12544,04.09.2018 01:10:00,16260,-0.048054487457972986,-8.88,IS,0.41,0.0,Phase3-EA-SA2v2-EURCHF-M5-43,EURCHFMT4,8310,8h 20m,Buy
174906.0,1.12482,04.09.2018 13:15:00,,0.0,-147.28999999997905,0.0,0.0,1.12539,04.09.2018 04:30:00,16261,-0.055569957271603146,-19.92,IS,0.34,0.0,Phase3-EA-S4v1-EURCHF-M15-221,EURCHFMT4,4242,8h 45m,Buy
174898.01,1.12809,05.09.2018 04:20:00,,-2.1,-155.27999999996973,0.0,0.0,1.12795,04.09.2018 20:00:00,16262,-0.05858444541471982,-7.99,IS,0.41,0.0,Phase3-EA-SA2v2-EURCHF-M5-43,EURCHFMT4,8312,8h 20m,Sell
174908.83,1.12854,05.09.2018 14:45:00,,0.0,-144.45999999996275,0.0,0.0,1.12885,05.09.2018 06:00:00,16263,-0.054502247453695855,10.82,IS,0.34,0.0,Phase3-EA-S4v1-EURCHF-M15-221,EURCHFMT4,4244,8h 45m,Sell
174873.77,129087,05.09.2018 16:29:57,sl 129.087,0.0,-179.51999999996042,0.0,0.0,129317,05.09.2018 14:45:00,16264,-0.06772977615179182,-35.06,IS,0.17,0.0,Phase3-EA-T1v2-EURJPY-M15-322,EURJPYMT4,3230,1h 44m,Buy
174818.73,144094,05.09.2018 17:29:57,sl 144.094,-0.94,-234.55999999993946,0.0,0.0,143424,03.09.2018 05:00:00,16265,-0.08849541162078706,-55.04,IS,0.09,0.0,Phase3-EA-B1v1-GBPJPY-M30-1,GBPJPYMT4,1466,2d 12h 29m,Sell
174776.73,1.29365,05.09.2018 19:29:58,sl 1.29365,0.0,-276.55999999993946,0.0,0.0,1.29665,05.09.2018 17:30:00,16266,-0.10434128170977927,-42.0,IS,0.14,0.0,Phase3-EA-B1v1-GBPUSD-M30-14,GBPUSDMT4,1062,1h 59m,Buy
174816.82,1.12882,06.09.2018 01:04:57,tp 1.12882,-6.33,-236.46999999991385,0.0,0.0,1.12992,05.09.2018 21:20:00,16267,-0.08921602142720537,40.09,IS,0.41,0.0,Phase3-EA-SA2v2-EURCHF-M5-43,EURCHFMT4,8314,3h 44m,Sell
174827.72,111488,06.09.2018 01:15:00,,0.0,-225.56999999989057,0.0,0.0,111533,06.09.2018 00:30:00,16268,-0.08510364085648194,10.9,IS,0.27,0.0,Phase3-EA-S1v2-USDJPY-M15-0,USDJPYMT4,4630,45m 0s,Sell
174877.95,0.97128,06.09.2018 01:29:57,tp 0.97128,-9.49,-175.3399999999092,0.0,0.0,0.97228,05.09.2018 22:15:00,16269,-0.0661527347952966,50.23,IS,0.58,0.0,Phase3-EA-SA2v2-USDCHF-M15-107,USDCHFMT4,3214,3h 14m,Sell
174852.73,143758,06.09.2018 06:35:00,,0.0,-200.55999999988126,0.0,0.0,143.88,06.09.2018 01:10:00,16270,-0.07566780250110472,-25.22,IS,0.23,0.0,Phase3-EA-S4v1-GBPJPY-M5-194,GBPJPYMT4,3498,5h 25m,Buy
174789.62,1.12722,06.09.2018 14:15:00,,0.0,-263.6699999998673,0.0,0.0,1.12902,06.09.2018 05:30:00,16271,-0.0994781087229161,-63.11,IS,0.34,0.0,Phase3-EA-S4v1-EURCHF-M15-221,EURCHFMT4,4246,8h 45m,Buy
174886.23,110.53,07.09.2018 00:14:58,tp 110.530,-1.1,-167.05999999988126,0.0,0.0,110.93,06.09.2018 23:15:00,16272,-0.0630288346920276,96.61,IS,0.27,0.0,Phase3-EA-S1v2-USDJPY-M15-0,USDJPYMT4,4632,59m 58s,Sell
174885.5,110714,07.09.2018 00:30:00,,0.0,-167.78999999986263,0.0,0.0,110711,07.09.2018 00:15:00,16273,-0.0633042510054721,-0.73,IS,0.27,0.0,Phase3-EA-S1v2-USDJPY-M15-0,USDJPYMT4,4634,15m 0s,Sell
174833.09,0.96501,07.09.2018 03:00:00,,-0.72,-220.19999999983702,0.0,0.0,0.96587,06.09.2018 22:45:00,16274,-0.08307763318079772,-52.41,IS,0.58,0.0,Phase3-EA-SA2v2-USDCHF-M15-107,USDCHFMT4,3216,4h 15m,Buy
174747.53,1.12155,07.09.2018 05:05:00,,-1.02,-305.7599999998347,0.0,0.0,1.12354,06.09.2018 20:45:00,16275,-0.115357934247801,-85.56,IS,0.41,0.0,Phase3-EA-SA2v2-EURCHF-M5-43,EURCHFMT4,8316,8h 20m,Buy
174705.94,142967,07.09.2018 05:40:00,,0.0,-347.3499999998603,0.0,0.0,143167,07.09.2018 00:15:00,16276,-0.13104911846212464,-41.59,IS,0.23,0.0,Phase3-EA-S4v1-GBPJPY-M5-194,GBPJPYMT4,3500,5h 25m,Buy
174710.87,1.12224,07.09.2018 10:00:00,,0.0,-342.4199999998673,0.0,0.0,1.1221,07.09.2018 01:15:00,16277,-0.12918911513977652,4.93,IS,0.34,0.0,Phase3-EA-S4v1-EURCHF-M15-221,EURCHFMT4,4248,8h 45m,Buy
174675.71,128.82,07.09.2018 18:59:57,sl 128.820,0.0,-377.5799999998417,0.0,0.0,128.59,07.09.2018 16:45:00,16278,-0.14245437209998033,-35.16,IS,0.17,0.0,Phase3-EA-T1v2-EURJPY-M15-322,EURJPYMT4,3232,2h 14m,Sell
174722.28,1.11982,10.09.2018 01:09:57,tp 1.11982,0.0,-331.0099999998347,0.0,0.0,1.11872,10.09.2018 01:05:00,16279,-0.12488432043225466,46.57,IS,0.41,0.0,Phase3-EA-SA2v2-EURCHF-M5-43,EURCHFMT4,8318,4m 57s,Buy
174705.56,143362,10.09.2018 05:15:00,,-0.75,-347.72999999980675,0.0,0.0,143439,07.09.2018 23:50:00,16280,-0.1311924858581477,-16.72,IS,0.23,0.0,Phase3-EA-S4v1-GBPJPY-M5-194,GBPJPYMT4,3502,2d 5h 25m,Buy
174639.08,127979,10.09.2018 10:59:58,sl 127.979,-3.19,-414.2099999997881,0.0,0.0,128759,31.08.2018 23:30:00,16281,-0.15627423451328834,-66.48,IS,0.09,0.0,Phase3-EA-TR1v1-EURJPY-M30-91,EURJPYMT4,2884,9d 11h 29m,Buy
174620.58,1.13033,11.09.2018 04:25:00,,-2.1,-432.7099999997881,0.0,0.0,1.12994,10.09.2018 20:05:00,16282,-0.16325396300486825,-18.5,IS,0.41,0.0,Phase3-EA-SA2v2-EURCHF-M5-43,EURCHFMT4,8320,8h 20m,Sell
174759.96,1.13391,11.09.2018 10:44:58,tp 1.13391,0.0,-293.32999999978347,0.0,0.0,1.12991,11.09.2018 02:45:00,16283,-0.1106683112666823,139.38,IS,0.34,0.0,Phase3-EA-S4v1-EURCHF-M15-221,EURCHFMT4,4250,7h 59m,Buy
174696.97,129626,11.09.2018 11:29:58,sl 129.626,0.0,-356.31999999977415,0.0,0.0,128846,11.09.2018 04:00:00,16284,-0.13443334357395548,-62.99,IS,0.09,0.0,Phase3-EA-TR1v1-EURJPY-M30-91,EURJPYMT4,2886,7h 29m,Sell
174756.58,0.97291,12.09.2018 01:44:58,tp 0.97291,0.0,-296.7099999997881,0.0,0.0,0.97191,12.09.2018 01:00:00,16285,-0.11194352652622677,59.61,IS,0.58,0.0,Phase3-EA-SA2v2-USDCHF-M15-107,USDCHFMT4,3218,44m 58s,Buy
174766.94,1.12839,12.09.2018 05:30:00,,-1.01,-286.3499999998021,0.0,0.0,1.12812,11.09.2018 21:10:00,16286,-0.1080348785709473,10.36,IS,0.41,0.0,Phase3-EA-SA2v2-EURCHF-M5-43,EURCHFMT4,8322,8h 20m,Buy
174830.49,145025,12.09.2018 05:50:00,,0.0,-222.79999999981374,0.0,0.0,145333,12.09.2018 00:25:00,16287,-0.0840585679958218,63.55,IS,0.23,0.0,Phase3-EA-S4v1-GBPJPY-M5-194,GBPJPYMT4,3504,5h 25m,Sell
174794.66,129156,12.09.2018 07:44:58,sl 129.156,-0.75,-258.62999999983003,0.0,0.0,129386,11.09.2018 20:45:00,16288,-0.09757660431222298,-35.83,IS,0.17,0.0,Phase3-EA-T1v2-EURJPY-M15-322,EURJPYMT4,3234,10h 59m,Buy
174846.53,1.12708,13.09.2018 13:30:00,,0.0,-206.7599999998347,0.0,0.0,1.12856,13.09.2018 04:45:00,16289,-0.07800695475231934,51.87,IS,0.34,0.0,Phase3-EA-S4v1-EURCHF-M15-221,EURCHFMT4,4252,8h 45m,Sell
174782.51,129973,13.09.2018 16:59:58,sl 129.973,-1.13,-270.7799999998533,0.0,0.0,129193,11.09.2018 13:30:00,16290,-0.10216058815940451,-64.02,IS,0.09,0.0,Phase3-EA-TR1v1-EURJPY-M30-91,EURJPYMT4,2888,2d 3h 29m,Sell
174731.92,0.9654,14.09.2018 02:15:00,,-0.72,-321.3699999998789,0.0,0.0,0.96623,13.09.2018 22:00:00,16291,-0.12124731596422647,-50.59,IS,0.58,0.0,Phase3-EA-SA2v2-USDCHF-M15-107,USDCHFMT4,3220,4h 15m,Buy
174726.66,1.12906,14.09.2018 06:00:00,,-1.02,-326.62999999988824,0.0,0.0,1.12916,13.09.2018 21:40:00,16292,-0.12323182255156567,-5.26,IS,0.41,0.0,Phase3-EA-SA2v2-EURCHF-M5-43,EURCHFMT4,8324,8h 20m,Buy
174879.62,130729,14.09.2018 08:15:00,,-0.74,-173.6699999998673,0.0,0.0,129718,13.09.2018 15:15:00,16293,-0.06552267281793277,152.96,IS,0.17,0.0,Phase3-EA-T1v2-EURJPY-M15-322,EURJPYMT4,3236,17h 0m,Buy
174922.61,146625,14.09.2018 08:20:00,,0.0,-130.6799999998766,0.0,0.0,146834,14.09.2018 02:55:00,16294,-0.04930329293398924,42.99,IS,0.23,0.0,Phase3-EA-S4v1-GBPJPY-M5-194,GBPJPYMT4,3506,5h 25m,Sell
174954.0,1.12856,14.09.2018 13:00:00,,0.0,-99.28999999986263,0.0,0.0,1.12945,14.09.2018 04:15:00,16295,-0.037460391455568114,31.39,IS,0.34,0.0,Phase3-EA-S4v1-EURCHF-M15-221,EURCHFMT4,4254,8h 45m,Sell
174919.03,130.78,14.09.2018 13:29:58,sl 130.780,0.0,-134.2599999998347,0.0,0.0,131.01,14.09.2018 11:00:00,16296,-0.05065396471774943,-34.97,IS,0.17,0.0,Phase3-EA-T1v2-EURJPY-M15-322,EURJPYMT4,3238,2h 29m,Buy
174860.42,130184,17.09.2018 01:00:00,sl 130.184,-0.78,-192.86999999982072,0.0,0.0,130904,13.09.2018 23:30:00,16297,-0.07276649914431164,-58.61,IS,0.09,0.0,Phase3-EA-TR1v1-EURJPY-M30-91,EURJPYMT4,2890,3d 1h 30m,Buy
174867.92,111999,17.09.2018 02:15:00,,-0.7,-185.36999999982072,0.0,0.0,111965,14.09.2018 21:15:00,16298,-0.06993687948556303,7.5,IS,0.27,0.0,Phase3-EA-S1v2-USDJPY-M15-0,USDJPYMT4,4636,2d 5h 0m,Buy
174870.72,1.12477,17.09.2018 04:50:00,,-1.02,-182.56999999983236,0.0,0.0,1.12468,14.09.2018 20:30:00,16299,-0.06888048814630127,2.8,IS,0.41,0.0,Phase3-EA-SA2v2-EURCHF-M5-43,EURCHFMT4,8326,2d 8h 20m,Buy
174889.31,0.96702,17.09.2018 06:00:00,,0.0,-163.97999999980675,0.0,0.0,0.96671,17.09.2018 01:45:00,16300,-0.06186680421880672,18.59,IS,0.58,0.0,Phase3-EA-SA2v2-USDCHF-M15-107,USDCHFMT4,3222,4h 15m,Buy
174854.38,130424,17.09.2018 12:29:58,sl 130.424,0.0,-198.90999999979977,0.0,0.0,130194,17.09.2018 11:45:00,16301,-0.07504528617614928,-34.93,IS,0.17,0.0,Phase3-EA-T1v2-EURJPY-M15-322,EURJPYMT4,3240,44m 58s,Sell
174805.5,146907,18.09.2018 04:55:00,,-0.74,-247.78999999980442,0.0,0.0,147141,17.09.2018 23:30:00,16302,-0.09348686069876866,-48.88,IS,0.23,0.0,Phase3-EA-S4v1-GBPJPY-M5-194,GBPJPYMT4,3508,5h 25m,Buy
174851.36,1.12499,18.09.2018 07:14:58,tp 1.12499,-1.02,-201.9299999998184,0.0,0.0,1.12389,17.09.2018 23:25:00,16303,-0.07618467969207908,45.86,IS,0.41,0.0,Phase3-EA-SA2v2-EURCHF-M5-43,EURCHFMT4,8328,7h 49m,Buy
174829.78,1.12288,18.09.2018 12:00:00,,0.0,-223.5099999998347,0.0,0.0,1.12349,18.09.2018 03:15:00,16304,-0.0843264386568579,-21.58,IS,0.34,0.0,Phase3-EA-S4v1-EURCHF-M15-221,EURCHFMT4,4256,8h 45m,Buy
174856.62,130979,18.09.2018 15:15:00,,0.0,-196.66999999980908,0.0,0.0,130802,18.09.2018 07:00:00,16305,-0.07420017310473988,26.84,IS,0.17,0.0,Phase3-EA-T1v2-EURJPY-M15-322,EURJPYMT4,3242,8h 15m,Buy
174903.35,1.12508,18.09.2018 21:39:58,tp 1.12508,0.0,-149.9399999998277,0.0,0.0,1.12398,18.09.2018 20:30:00,16306,-0.056569756217637227,46.73,IS,0.41,0.0,Phase3-EA-SA2v2-EURCHF-M5-43,EURCHFMT4,8330,1h 9m,Buy
174947.99,1.12455,19.09.2018 01:34:58,tp 1.12455,-2.12,-105.29999999981374,0.0,0.0,1.12565,18.09.2018 23:00:00,16307,-0.039727860008760225,44.64,IS,0.41,0.0,Phase3-EA-SA2v2-EURCHF-M5-43,EURCHFMT4,8332,2h 34m,Sell
175004.97,964,19.09.2018 01:44:57,tp 0.96400,-3.19,-48.31999999983236,0.0,0.0,965,18.09.2018 23:45:00,16308,-0.01823029625470114,56.98,IS,0.58,0.0,Phase3-EA-SA2v2-USDCHF-M15-107,USDCHFMT4,3224,1h 59m,Sell
175015.06,112382,19.09.2018 07:30:00,,0.0,-38.22999999980675,0.0,0.0,112.34,19.09.2018 00:15:00,16309,-0.014423514607121676,10.09,IS,0.27,0.0,Phase3-EA-S1v2-USDJPY-M15-0,USDJPYMT4,4638,7h 15m,Buy
175052.72,147723,19.09.2018 08:10:00,,0.0,-0.5699999998323619,0.0,0.0,147907,19.09.2018 02:45:00,16310,-2.1505109400164751E-4,37.66,IS,0.23,0.0,Phase3-EA-S4v1-GBPJPY-M5-194,GBPJPYMT4,3510,5h 25m,Sell
175155.31,131596,19.09.2018 12:29:58,tp 131.596,-0.78,-0.0,0.0,0.0,130306,17.09.2018 07:00:00,16311,-0.0,102.59,IS,0.09,0.0,Phase3-EA-TR1v1-EURJPY-M30-91,EURJPYMT4,2892,2d 5h 29m,Buy
175120.5,130942,19.09.2018 16:14:58,sl 130.942,0.0,-34.80999999999767,0.0,0.0,131172,19.09.2018 08:00:00,16312,-0.013128154966988024,-34.81,IS,0.17,0.0,Phase3-EA-T1v2-EURJPY-M15-322,EURJPYMT4,3244,8h 14m,Buy
175150.52,1.12967,20.09.2018 05:30:00,,-3.05,-4.789999999979045,0.0,0.0,1.12889,19.09.2018 21:10:00,16313,-0.0018064884312439455,30.02,IS,0.41,0.0,Phase3-EA-SA2v2-EURCHF-M5-43,EURCHFMT4,8334,8h 20m,Buy
175115.68,131216,20.09.2018 11:14:58,sl 131.216,0.0,-39.63000000000466,0.0,0.0,130986,20.09.2018 06:45:00,16314,-0.014945957522029053,-34.84,IS,0.17,0.0,Phase3-EA-T1v2-EURJPY-M15-322,EURJPYMT4,3246,4h 29m,Sell
175262.25,148632,20.09.2018 15:29:58,tp 148.632,-1.74,-0.0,0.0,0.0,146782,14.09.2018 00:30:00,16315,-0.0,146.57,IS,0.09,0.0,Phase3-EA-B1v1-GBPJPY-M30-1,GBPJPYMT4,1468,6d 14h 59m,Buy
175524.19,1.3274,20.09.2018 15:59:58,tp 1.32740,-2.66,-0.0,0.0,0.0,1.3085,17.09.2018 12:00:00,16316,-0.0,261.94,IS,0.14,0.0,Phase3-EA-B1v1-GBPUSD-M30-14,GBPUSDMT4,1064,3d 3h 59m,Buy
175623.11,132.2,20.09.2018 19:29:58,tp 132.200,-1.96,-0.0,0.0,0.0,130.94,17.09.2018 18:00:00,16317,-0.0,98.92,IS,0.09,0.0,Phase3-EA-TR1v1-EURJPY-M30-91,EURJPYMT4,2893,3d 1h 29m,Buy
175668.02,1.12893,21.09.2018 01:04:58,tp 1.12893,-2.14,-0.0,0.0,0.0,1.13003,20.09.2018 21:05:00,16318,-0.0,44.91,IS,0.41,0.0,Phase3-EA-SA2v2-EURCHF-M5-43,EURCHFMT4,8336,3h 59m,Sell
175687.72,112.48,21.09.2018 04:15:00,,-0.7,-0.0,0.0,0.0,112395,20.09.2018 23:45:00,16319,-0.0,19.7,IS,0.27,0.0,Phase3-EA-S1v2-USDJPY-M15-0,USDJPYMT4,4640,4h 30m,Buy
175664.04,149307,21.09.2018 04:30:00,,-1.19,-23.679999999993015,0.0,0.0,149197,20.09.2018 23:05:00,16320,-0.008912719037218918,-23.68,IS,0.23,0.0,Phase3-EA-S4v1-GBPJPY-M5-194,GBPJPYMT4,3512,5h 25m,Sell
175642.86,0.95855,21.09.2018 05:30:00,,0.0,-44.85999999998603,0.0,0.0,0.9589,21.09.2018 01:15:00,16321,-0.016884483784190628,-21.18,IS,0.58,0.0,Phase3-EA-SA2v2-USDCHF-M15-107,USDCHFMT4,3226,4h 15m,Buy
175656.55,1.12957,21.09.2018 09:25:00,,0.0,-31.169999999983702,0.0,0.0,1.12925,21.09.2018 01:05:00,16322,-0.011731818090796046,13.69,IS,0.41,0.0,Phase3-EA-SA2v2-EURCHF-M5-43,EURCHFMT4,8338,8h 20m,Buy
175688.46,1.1301,21.09.2018 10:45:00,,0.0,-0.0,0.0,0.0,1.1292,21.09.2018 02:00:00,16323,-0.0,31.91,IS,0.34,0.0,Phase3-EA-S4v1-EURCHF-M15-221,EURCHFMT4,4258,8h 45m,Buy
175634.67,148547,21.09.2018 15:59:58,sl 148.547,-0.29,-53.789999999979045,0.0,0.0,149217,20.09.2018 23:00:00,16324,-0.02024551612063948,-53.79,IS,0.09,0.0,Phase3-EA-B1v1-GBPJPY-M30-1,GBPJPYMT4,1470,16h 59m,Buy
175679.6,1.12526,24.09.2018 01:09:58,tp 1.12526,-2.14,-8.85999999998603,0.0,0.0,1.12636,21.09.2018 20:50:00,16325,-0.003334732716650917,44.93,IS,0.41,0.0,Phase3-EA-SA2v2-EURCHF-M5-43,EURCHFMT4,8340,2d 4h 19m,Sell
175726.61,1.12661,24.09.2018 01:19:57,tp 1.12661,0.0,-0.0,0.0,0.0,1.12551,24.09.2018 01:10:00,16326,-0.0,47.01,IS,0.41,0.0,Phase3-EA-SA2v2-EURCHF-M5-43,EURCHFMT4,8342,9m 57s,Buy
175688.52,0.95935,24.09.2018 05:45:00,,0.0,-38.09000000002561,0.0,0.0,0.95872,24.09.2018 01:30:00,16327,-0.014334281387936802,-38.09,IS,0.58,0.0,Phase3-EA-SA2v2-USDCHF-M15-107,USDCHFMT4,3228,4h 15m,Sell
175653.8,132425,24.09.2018 12:29:59,sl 132.425,0.0,-72.80999999999767,0.0,0.0,132195,24.09.2018 06:30:00,16328,-0.027400342028221145,-34.72,IS,0.17,0.0,Phase3-EA-T1v2-EURJPY-M15-322,EURJPYMT4,3248,5h 59m,Sell
175589.27,1.12851,24.09.2018 14:30:00,,0.0,-137.3400000000256,0.0,0.0,1.12669,24.09.2018 05:45:00,16329,-0.051684699548917926,-64.53,IS,0.34,0.0,Phase3-EA-S4v1-EURCHF-M15-221,EURCHFMT4,4260,8h 45m,Sell
175636.01,1.13234,25.09.2018 00:59:59,tp 1.13234,0.0,-90.60000000003492,0.0,0.0,1.13344,25.09.2018 00:20:00,16330,-0.034095192799860896,46.74,IS,0.41,0.0,Phase3-EA-SA2v2-EURCHF-M5-43,EURCHFMT4,8344,39m 59s,Sell
175693.1,0.96214,25.09.2018 01:14:58,tp 0.96214,-3.19,-33.51000000000931,0.0,0.0,0.96314,24.09.2018 23:00:00,16331,-0.012610705416371035,57.09,IS,0.58,0.0,Phase3-EA-SA2v2-USDCHF-M15-107,USDCHFMT4,3230,2h 14m,Sell
175734.21,132882,26.09.2018 01:15:00,,-0.74,-0.0,0.0,0.0,132604,25.09.2018 09:30:00,16332,-0.0,41.11,IS,0.17,0.0,Phase3-EA-T1v2-EURJPY-M15-322,EURJPYMT4,3250,15h 45m,Buy
175718.4,0.96524,26.09.2018 04:00:00,,-3.19,-15.809999999997672,0.0,0.0,0.96503,25.09.2018 23:45:00,16333,-0.0059495538794186835,-15.81,IS,0.58,0.0,Phase3-EA-SA2v2-USDCHF-M15-107,USDCHFMT4,3232,4h 15m,Sell
175723.75,1.1354,26.09.2018 04:45:00,,-1.02,-10.460000000020955,0.0,0.0,1.13525,25.09.2018 20:25:00,16334,-0.00393626398348218,5.35,IS,0.41,0.0,Phase3-EA-SA2v2-EURCHF-M5-43,EURCHFMT4,8346,8h 20m,Buy
175803.8,1.13713,26.09.2018 15:30:00,,0.0,-0.0,0.0,0.0,1.13485,26.09.2018 06:45:00,16335,-0.0,80.05,IS,0.34,0.0,Phase3-EA-S4v1-EURCHF-M15-221,EURCHFMT4,4262,8h 45m,Buy
175769.18,132875,26.09.2018 21:59:58,sl 132.875,0.0,-34.61999999999534,0.0,0.0,132645,26.09.2018 20:45:00,16336,-0.013024644493417765,-34.62,IS,0.17,0.0,Phase3-EA-T1v2-EURJPY-M15-322,EURJPYMT4,3252,1h 14m,Sell
175697.32,1.13459,27.09.2018 04:40:00,,-3.06,-106.47999999998137,0.0,0.0,1.13621,26.09.2018 20:20:00,16337,-0.040059622924871974,-71.86,IS,0.41,0.0,Phase3-EA-SA2v2-EURCHF-M5-43,EURCHFMT4,8348,8h 20m,Buy
175754.37,148646,27.09.2018 05:30:00,,0.0,-49.429999999993015,0.0,0.0,148366,27.09.2018 00:05:00,16338,-0.01859642337693922,57.05,IS,0.23,0.0,Phase3-EA-S4v1-GBPJPY-M5-194,GBPJPYMT4,3514,5h 25m,Buy
175700.59,1.13222,27.09.2018 10:15:00,,0.0,-103.21000000002095,0.0,0.0,1.13375,27.09.2018 01:30:00,16339,-0.038829392205837705,-53.78,IS,0.34,0.0,Phase3-EA-S4v1-EURCHF-M15-221,EURCHFMT4,4264,8h 45m,Buy
175746.74,1.13985,27.09.2018 21:44:58,tp 1.13985,0.0,-57.05999999999767,0.0,0.0,1.14095,27.09.2018 20:00:00,16340,-0.021466961721389004,46.15,IS,0.41,0.0,Phase3-EA-SA2v2-EURCHF-M5-43,EURCHFMT4,8350,1h 44m,Sell
175747.69,113396,28.09.2018 03:30:00,,0.0,-56.10999999998603,0.0,0.0,113392,28.09.2018 00:45:00,16341,-0.021109555243373403,0.95,IS,0.27,0.0,Phase3-EA-S1v2-USDJPY-M15-0,USDJPYMT4,4642,2h 45m,Buy
175773.69,0.97698,28.09.2018 04:00:00,,-0.71,-30.10999999998603,0.0,0.0,0.97653,27.09.2018 23:45:00,16342,-0.01132790426622414,26.0,IS,0.58,0.0,Phase3-EA-SA2v2-USDCHF-M15-107,USDCHFMT4,3234,4h 15m,Buy
175697.55,1.1376,28.09.2018 06:35:00,,-1.01,-106.25,0.0,0.0,1.13939,27.09.2018 22:15:00,16343,-0.039973092935465734,-76.14,IS,0.41,0.0,Phase3-EA-SA2v2-EURCHF-M5-43,EURCHFMT4,8352,8h 20m,Buy
175683.27,1.13688,28.09.2018 09:45:00,,0.0,-120.53000000002794,0.0,0.0,1.13729,28.09.2018 01:00:00,16344,-0.04534547662600284,-14.28,IS,0.34,0.0,Phase3-EA-S4v1-EURCHF-M15-221,EURCHFMT4,4266,8h 45m,Buy
175623.03,131473,28.09.2018 14:29:58,sl 131.473,-3.12,-180.77000000001863,0.0,0.0,132193,20.09.2018 19:30:00,16345,-0.06800880950536363,-60.24,IS,0.09,0.0,Phase3-EA-TR1v1-EURJPY-M30-91,EURJPYMT4,2896,7d 18h 59m,Buy
175565.74,132076,01.10.2018 01:00:00,sl 132.076,-0.28,-238.05999999999767,0.0,0.0,131356,28.09.2018 15:00:00,16346,-0.08956230121615887,-57.29,IS,0.09,0.0,Phase3-EA-TR1v1-EURJPY-M30-91,EURJPYMT4,2898,2d 10h 0m,Sell
175405.38,0.98121,01.10.2018 03:00:00,,-3.13,-398.4199999999837,0.0,0.0,0.97855,28.09.2018 22:45:00,16347,-0.14989251470444806,-160.36,IS,0.58,0.0,Phase3-EA-SA2v2-USDCHF-M15-107,USDCHFMT4,3236,2d 4h 15m,Sell
175273.77,1.13825,01.10.2018 05:50:00,,-2.09,-530.0299999999697,0.0,0.0,1.13515,28.09.2018 21:30:00,16348,-0.1994064795160818,-131.61,IS,0.41,0.0,Phase3-EA-SA2v2-EURCHF-M5-43,EURCHFMT4,8354,2d 8h 20m,Sell
175226.73,148511,01.10.2018 06:40:00,,0.0,-577.0699999999488,0.0,0.0,148278,01.10.2018 01:15:00,16349,-0.2171037434378086,-47.04,IS,0.23,0.0,Phase3-EA-S4v1-GBPJPY-M5-194,GBPJPYMT4,3516,5h 25m,Sell
175286.33,1137,01.10.2018 10:00:00,,0.0,-517.4699999999721,0.0,0.0,1.13872,01.10.2018 01:15:00,16350,-0.19468118965942904,59.6,IS,0.34,0.0,Phase3-EA-S4v1-EURCHF-M15-221,EURCHFMT4,4268,8h 45m,Sell
175229.72,149104,01.10.2018 16:59:58,sl 149.104,-3.69,-574.0799999999581,0.0,0.0,148434,21.09.2018 16:00:00,16351,-0.21597885357543994,-56.61,IS,0.09,0.0,Phase3-EA-B1v1-GBPJPY-M30-1,GBPJPYMT4,1472,10d 0h 59m,Sell
175482.44,130805,02.10.2018 13:14:58,tp 130.805,-1.56,-321.35999999998603,0.0,0.0,132505,27.09.2018 06:45:00,16352,-0.12090120607755962,252.72,IS,0.17,0.0,Phase3-EA-T1v2-EURJPY-M15-322,EURJPYMT4,3254,5d 6h 29m,Sell
175584.34,130728,02.10.2018 13:29:57,tp 130.728,-0.28,-219.45999999996275,0.0,0.0,132018,01.10.2018 11:30:00,16353,-0.08256465859403125,101.9,IS,0.09,0.0,Phase3-EA-TR1v1-EURJPY-M30-91,EURJPYMT4,2900,1d 1h 59m,Sell
175580.09,0.98386,03.10.2018 04:00:00,,-0.71,-223.70999999996275,0.0,0.0,0.98392,02.10.2018 23:45:00,16354,-0.0841635823114499,-4.25,IS,0.58,0.0,Phase3-EA-SA2v2-USDCHF-M15-107,USDCHFMT4,3238,4h 15m,Buy
175554.05,147371,03.10.2018 04:35:00,,-0.73,-249.7499999999418,0.0,0.0,147496,02.10.2018 23:10:00,16355,-0.09396028198240226,-26.04,IS,0.23,0.0,Phase3-EA-S4v1-GBPJPY-M5-194,GBPJPYMT4,3518,5h 25m,Buy
175598.85,1.1382,03.10.2018 05:59:58,tp 1.13820,-1.0,-204.94999999995343,0.0,0.0,1.1371,02.10.2018 23:00:00,16356,-0.07710574491408792,44.8,IS,0.41,0.0,Phase3-EA-SA2v2-EURCHF-M5-43,EURCHFMT4,8356,6h 59m,Buy
175564.46,131556,03.10.2018 08:29:58,sl 131.556,0.0,-239.3399999999674,0.0,0.0,131786,03.10.2018 06:15:00,16357,-0.09004385941809945,-34.39,IS,0.17,0.0,Phase3-EA-T1v2-EURJPY-M15-322,EURJPYMT4,3256,2h 14m,Buy
175702.63,1.14032,03.10.2018 09:29:57,tp 1.14032,0.0,-101.1699999999837,0.0,0.0,1.13632,03.10.2018 02:00:00,16358,-0.03806190882146275,138.17,IS,0.34,0.0,Phase3-EA-S4v1-EURCHF-M15-221,EURCHFMT4,4270,7h 29m,Buy
175748.14,1.13915,04.10.2018 00:39:58,tp 1.13915,0.0,-55.65999999997439,0.0,0.0,1.14025,04.10.2018 00:20:00,16359,-0.020940257437995286,45.51,IS,0.41,0.0,Phase3-EA-SA2v2-EURCHF-M5-43,EURCHFMT4,8358,19m 58s,Sell
175684.55,147808,04.10.2018 06:20:00,,0.0,-119.25,0.0,0.0,148124,04.10.2018 00:55:00,16360,-0.04486391842404037,-63.59,IS,0.23,0.0,Phase3-EA-S4v1-GBPJPY-M5-194,GBPJPYMT4,3520,5h 25m,Buy
175683.72,1.1378,04.10.2018 09:45:00,,0.0,-120.0800000000163,0.0,0.0,1.13782,04.10.2018 01:25:00,16361,-0.045176178820624725,-0.83,IS,0.41,0.0,Phase3-EA-SA2v2-EURCHF-M5-43,EURCHFMT4,8360,8h 20m,Buy
175696.75,1.13817,04.10.2018 11:15:00,,0.0,-107.04999999998836,0.0,0.0,1.13779,04.10.2018 02:30:00,16362,-0.04027406681168133,13.03,IS,0.34,0.0,Phase3-EA-S4v1-EURCHF-M15-221,EURCHFMT4,4272,8h 45m,Buy
175692.83,113852,05.10.2018 09:45:00,,-1.07,-110.96999999997206,0.0,0.0,113.84,04.10.2018 22:45:00,16363,-0.04174883880515309,-3.92,IS,0.27,0.0,Phase3-EA-S1v2-USDJPY-M15-0,USDJPYMT4,4644,11h 0m,Sell
175686.33,1.14254,05.10.2018 14:15:00,,0.0,-117.46999999997206,0.0,0.0,1.14235,05.10.2018 05:30:00,16364,-0.04419425154944041,-6.5,IS,0.34,0.0,Phase3-EA-S4v1-EURCHF-M15-221,EURCHFMT4,4274,8h 45m,Sell
175731.8,1.14254,05.10.2018 21:19:57,tp 1.14254,0.0,-72.0,0.0,0.0,1.14144,05.10.2018 20:10:00,16365,-0.027087648859797957,45.47,IS,0.41,0.0,Phase3-EA-SA2v2-EURCHF-M5-43,EURCHFMT4,8362,1h 9m,Buy
175747.92,1.14248,08.10.2018 06:20:00,,-2.07,-55.88000000000466,0.0,0.0,1.14292,05.10.2018 22:00:00,16366,-0.021023025253967167,16.12,IS,0.41,0.0,Phase3-EA-SA2v2-EURCHF-M5-43,EURCHFMT4,8364,2d 8h 20m,Sell
175760.78,0.99206,08.10.2018 06:30:00,,0.0,-43.02000000001863,0.0,0.0,0.99184,08.10.2018 02:15:00,16367,-0.016184870193736288,12.86,IS,0.58,0.0,Phase3-EA-SA2v2-USDCHF-M15-107,USDCHFMT4,3240,4h 15m,Buy
175696.66,130449,08.10.2018 12:59:58,sl 130.449,-2.33,-107.14000000001397,0.0,0.0,131229,02.10.2018 16:00:00,16368,-0.040307926372765715,-64.12,IS,0.09,0.0,Phase3-EA-TR1v1-EURJPY-M30-91,EURJPYMT4,2902,5d 20h 59m,Buy
175796.12,129811,08.10.2018 17:29:58,tp 129.811,-0.56,-7.679999999993015,0.0,0.0,131071,04.10.2018 08:00:00,16369,-0.0028893492117091544,99.46,IS,0.09,0.0,Phase3-EA-TR1v1-EURJPY-M30-91,EURJPYMT4,2903,4d 9h 29m,Sell
176050.3,129663,08.10.2018 17:29:58,tp 129.663,-1.04,-0.0,0.0,0.0,131363,04.10.2018 01:15:00,16370,-0.0,254.18,IS,0.17,0.0,Phase3-EA-T1v2-EURJPY-M15-322,EURJPYMT4,3258,4d 16h 14m,Sell
176108.0,0.99319,09.10.2018 01:14:57,tp 0.99319,-0.7,-0.0,0.0,0.0,0.99219,08.10.2018 22:00:00,16371,-0.0,57.7,IS,0.58,0.0,Phase3-EA-SA2v2-USDCHF-M15-107,USDCHFMT4,3242,3h 14m,Buy
176108.12,113003,09.10.2018 04:30:00,,-1.07,-0.0,0.0,0.0,113008,08.10.2018 23:30:00,16372,-0.0,0.12,IS,0.27,0.0,Phase3-EA-S1v2-USDJPY-M15-0,USDJPYMT4,4646,5h 0m,Sell
176125.86,147975,09.10.2018 05:20:00,,-1.18,-0.0,0.0,0.0,148068,08.10.2018 23:55:00,16373,-0.0,17.74,IS,0.23,0.0,Phase3-EA-S4v1-GBPJPY-M5-194,GBPJPYMT4,3522,5h 25m,Sell
176091.29,130001,09.10.2018 06:29:58,sl 130.001,0.0,-34.570000000006985,0.0,0.0,129771,09.10.2018 05:45:00,16374,-0.012990094235865245,-34.57,IS,0.17,0.0,Phase3-EA-T1v2-EURJPY-M15-322,EURJPYMT4,3260,44m 58s,Sell
176099.55,1.14037,09.10.2018 07:15:00,,-2.07,-26.30999999999767,0.0,0.0,1.14062,08.10.2018 22:55:00,16375,-0.009886299662872876,8.26,IS,0.41,0.0,Phase3-EA-SA2v2-EURCHF-M5-43,EURCHFMT4,8366,8h 20m,Sell
176045.85,148268,09.10.2018 11:29:58,sl 148.268,-0.46,-80.01000000000931,0.0,0.0,147598,08.10.2018 17:30:00,16376,-0.03006472200785332,-53.7,IS,0.09,0.0,Phase3-EA-B1v1-GBPJPY-M30-1,GBPJPYMT4,1474,17h 59m,Sell
176091.33,1.13927,09.10.2018 23:44:58,tp 1.13927,0.0,-34.53000000002794,0.0,0.0,1.14037,09.10.2018 21:50:00,16377,-0.012975063753679468,45.48,IS,0.41,0.0,Phase3-EA-SA2v2-EURCHF-M5-43,EURCHFMT4,8368,1h 54m,Sell
176136.79,1.14041,10.10.2018 03:09:58,tp 1.14041,0.0,-0.0,0.0,0.0,1.13931,10.10.2018 01:15:00,16378,-0.0,45.46,IS,0.41,0.0,Phase3-EA-SA2v2-EURCHF-M5-43,EURCHFMT4,8370,1h 54m,Buy
176099.97,148843,10.10.2018 09:20:00,,0.0,-36.820000000006985,0.0,0.0,148662,10.10.2018 03:55:00,16379,-0.013834990645226765,-36.82,IS,0.23,0.0,Phase3-EA-S4v1-GBPJPY-M5-194,GBPJPYMT4,3524,5h 25m,Sell
176107.85,1.14057,10.10.2018 13:00:00,,0.0,-28.94000000000233,0.0,0.0,1.1408,10.10.2018 04:15:00,16380,-0.010874107258903282,7.88,IS,0.34,0.0,Phase3-EA-S4v1-EURCHF-M15-221,EURCHFMT4,4276,8h 45m,Sell
176050.08,130379,10.10.2018 17:29:58,sl 130.379,-0.56,-86.71000000002095,0.0,0.0,129659,08.10.2018 17:30:00,16381,-0.03258098964822583,-57.77,IS,0.09,0.0,Phase3-EA-TR1v1-EURJPY-M30-91,EURJPYMT4,2906,1d 23h 59m,Sell
176015.39,129824,10.10.2018 19:14:58,sl 129.824,0.0,-121.40000000002328,0.0,0.0,130054,10.10.2018 14:15:00,16382,-0.04561563998724966,-34.69,IS,0.17,0.0,Phase3-EA-T1v2-EURJPY-M15-322,EURJPYMT4,3262,4h 59m,Buy
175980.71,129875,10.10.2018 22:14:58,sl 129.875,0.0,-156.0800000000163,0.0,0.0,130105,10.10.2018 21:30:00,16383,-0.058646532860043704,-34.68,IS,0.17,0.0,Phase3-EA-T1v2-EURJPY-M15-322,EURJPYMT4,3264,44m 58s,Buy
176026.19,1.14285,10.10.2018 23:09:58,tp 1.14285,0.0,-110.60000000003492,0.0,0.0,1.14395,10.10.2018 21:20:00,16384,-0.0415575764628537,45.48,IS,0.41,0.0,Phase3-EA-SA2v2-EURCHF-M5-43,EURCHFMT4,8372,1h 49m,Sell
176075.43,0.99074,11.10.2018 00:29:57,tp 0.99074,-9.3,-61.36000000004424,0.0,0.0,0.99174,10.10.2018 22:45:00,16385,-0.023055812764572657,49.24,IS,0.58,0.0,Phase3-EA-SA2v2-USDCHF-M15-107,USDCHFMT4,3244,1h 44m,Sell
175873.9,112366,11.10.2018 00:29:57,sl 112.366,-2.09,-262.8900000000722,0.0,0.0,113196,10.10.2018 17:30:00,16386,-0.09878002962313887,-201.53,IS,0.27,0.0,Phase3-EA-S1v2-USDJPY-M15-0,USDJPYMT4,4648,6h 59m,Buy
175856.12,148293,11.10.2018 04:50:00,,-2.21,-280.6700000001001,0.0,0.0,148369,10.10.2018 23:25:00,16387,-0.10546080457350474,-17.78,IS,0.23,0.0,Phase3-EA-S4v1-GBPJPY-M5-194,GBPJPYMT4,3526,5h 25m,Buy
176117.53,1.32367,11.10.2018 05:59:58,tp 1.32367,-3.19,-19.26000000012573,0.0,0.0,1.30477,05.10.2018 11:00:00,16388,-0.007236879951894525,261.41,IS,0.14,0.0,Phase3-EA-B1v1-GBPUSD-M30-14,GBPUSDMT4,1066,5d 18h 59m,Buy
175949.95,0.98639,11.10.2018 06:15:00,,0.0,-186.84000000014203,0.0,0.0,0.98924,11.10.2018 02:00:00,16389,-0.07020449897217934,-167.58,IS,0.58,0.0,Phase3-EA-SA2v2-USDCHF-M15-107,USDCHFMT4,3246,4h 15m,Buy
175866.7,1.14034,11.10.2018 07:45:00,,-2.98,-270.090000000142,0.0,0.0,1.14227,10.10.2018 23:25:00,16390,-0.10148540530609866,-83.25,IS,0.41,0.0,Phase3-EA-SA2v2-EURCHF-M5-43,EURCHFMT4,8374,8h 20m,Buy
175890.43,1.14131,11.10.2018 11:00:00,,0.0,-246.36000000016065,0.0,0.0,1.14062,11.10.2018 02:15:00,16391,-0.0925689379511038,23.73,IS,0.34,0.0,Phase3-EA-S4v1-EURCHF-M15-221,EURCHFMT4,4278,8h 45m,Buy
175832.74,130116,11.10.2018 16:59:58,sl 130.116,0.0,-304.050000000163,0.0,0.0,130069,10.10.2018 18:30:00,16392,-0.11424576061060986,-57.69,IS,0.09,0.0,Phase3-EA-TR1v1-EURJPY-M30-91,EURJPYMT4,2908,22h 29m,Sell
175878.24,1.14695,11.10.2018 20:54:57,tp 1.14695,0.0,-258.550000000163,0.0,0.0,1.14805,11.10.2018 20:20:00,16393,-0.09714928928096024,45.5,IS,0.41,0.0,Phase3-EA-SA2v2-EURCHF-M5-43,EURCHFMT4,8376,34m 57s,Sell
175863.38,129925,12.10.2018 01:45:00,,0.0,-273.410000000149,0.0,0.0,130023,12.10.2018 00:15:00,16394,-0.10273288409323177,-14.86,IS,0.17,0.0,Phase3-EA-T1v2-EURJPY-M15-322,EURJPYMT4,3266,1h 30m,Buy
175821.06,112294,12.10.2018 12:45:00,,0.0,-315.730000000156,0.0,0.0,112118,12.10.2018 01:00:00,16395,-0.11863448116292168,-42.32,IS,0.27,0.0,Phase3-EA-S1v2-USDJPY-M15-0,USDJPYMT4,4650,11h 45m,Sell
175779.06,1.32047,12.10.2018 15:59:58,sl 1.32047,0.0,-357.730000000156,0.0,0.0,1.32347,12.10.2018 02:30:00,16396,-0.13441583931336745,-42.0,IS,0.14,0.0,Phase3-EA-B1v1-GBPUSD-M30-14,GBPUSDMT4,1068,13h 29m,Buy
175721.38,129704,12.10.2018 16:59:58,sl 129.704,0.0,-415.410000000149,0.0,0.0,129396,11.10.2018 02:00:00,16397,-0.15608890450664373,-57.68,IS,0.09,0.0,Phase3-EA-TR1v1-EURJPY-M30-91,EURJPYMT4,2909,1d 14h 59m,Sell
175686.52,129615,15.10.2018 03:29:58,sl 129.615,0.0,-450.27000000013504,0.0,0.0,129385,15.10.2018 01:00:00,16398,-0.16918743177150847,-34.86,IS,0.17,0.0,Phase3-EA-T1v2-EURJPY-M15-322,EURJPYMT4,3268,2h 29m,Sell
175704.24,112005,15.10.2018 04:45:00,,-1.08,-432.550000000163,0.0,0.0,112083,12.10.2018 23:15:00,16399,-0.16252920161852136,17.72,IS,0.27,0.0,Phase3-EA-S1v2-USDJPY-M15-0,USDJPYMT4,4652,2d 5h 30m,Sell
175724.34,146.97,15.10.2018 06:35:00,,0.0,-412.45000000018626,0.0,0.0,146872,15.10.2018 01:10:00,16400,-0.1549766945036739,20.1,IS,0.23,0.0,Phase3-EA-S4v1-GBPJPY-M5-194,GBPJPYMT4,3528,5h 25m,Buy
175707.85,1.14395,15.10.2018 10:15:00,,0.0,-428.94000000017695,0.0,0.0,1.14443,15.10.2018 01:30:00,16401,-0.16117275631083353,-16.49,IS,0.34,0.0,Phase3-EA-S4v1-EURCHF-M15-221,EURCHFMT4,4280,8h 45m,Buy
175672.86,129635,15.10.2018 14:59:57,sl 129.635,0.0,-463.93000000016764,0.0,0.0,129405,15.10.2018 04:45:00,16402,-0.1743201306366419,-34.99,IS,0.17,0.0,Phase3-EA-T1v2-EURJPY-M15-322,EURJPYMT4,3270,10h 14m,Sell
175717.54,1.14395,16.10.2018 06:04:58,tp 1.14395,-1.0,-419.2500000001746,0.0,0.0,1.14285,15.10.2018 23:35:00,16403,-0.15753177153755124,44.68,IS,0.41,0.0,Phase3-EA-SA2v2-EURCHF-M5-43,EURCHFMT4,8378,6h 29m,Buy
175677.32,147302,16.10.2018 09:20:00,,0.0,-459.4700000001467,0.0,0.0,147106,16.10.2018 03:55:00,16404,-0.17264430069970574,-40.22,IS,0.23,0.0,Phase3-EA-S4v1-GBPJPY-M5-194,GBPJPYMT4,3530,5h 25m,Sell
175740.89,1.14472,16.10.2018 09:45:00,,0.0,-395.9000000001397,0.0,0.0,1.14287,16.10.2018 01:00:00,16405,-0.14875808789913553,63.57,IS,0.34,0.0,Phase3-EA-S4v1-EURCHF-M15-221,EURCHFMT4,4282,8h 45m,Buy
175686.59,147579,16.10.2018 10:59:58,sl 147.579,-0.47,-450.20000000012806,0.0,0.0,146909,15.10.2018 01:30:00,16406,-0.16916112950792178,-54.3,IS,0.09,0.0,Phase3-EA-B1v1-GBPJPY-M30-1,GBPJPYMT4,1476,1d 9h 29m,Sell
175628.26,130138,16.10.2018 17:29:58,sl 130.138,-0.56,-508.53000000014435,0.0,0.0,130424,12.10.2018 09:30:00,16407,-0.19107843000591607,-58.33,IS,0.09,0.0,Phase3-EA-TR1v1-EURJPY-M30-91,EURJPYMT4,2911,4d 7h 59m,Buy
175673.8,1.14624,16.10.2018 21:54:59,tp 1.14624,0.0,-462.9900000001653,0.0,0.0,1.14734,16.10.2018 20:20:00,16408,-0.17396692881136913,45.54,IS,0.41,0.0,Phase3-EA-SA2v2-EURCHF-M5-43,EURCHFMT4,8380,1h 34m,Sell
175661.33,0.9904,17.10.2018 02:30:00,,-3.1,-475.46000000013737,0.0,0.0,0.99024,16.10.2018 22:15:00,16409,-0.17865248919555052,-12.47,IS,0.58,0.0,Phase3-EA-SA2v2-USDCHF-M15-107,USDCHFMT4,3248,4h 15m,Sell
175661.58,1.14608,17.10.2018 07:25:00,,-0.99,-475.21000000013737,0.0,0.0,1.14605,16.10.2018 23:05:00,16410,-0.1785585525398931,0.25,IS,0.41,0.0,Phase3-EA-SA2v2-EURCHF-M5-43,EURCHFMT4,8382,8h 20m,Buy
175697.65,129778,17.10.2018 08:45:00,,-0.74,-439.1400000001304,0.0,0.0,129535,16.10.2018 04:15:00,16411,-0.16500537186163858,36.07,IS,0.17,0.0,Phase3-EA-T1v2-EURJPY-M15-322,EURJPYMT4,3272,1d 4h 30m,Buy
175709.31,1.14626,17.10.2018 10:45:00,,0.0,-427.480000000156,0.0,0.0,1.14592,17.10.2018 02:00:00,16412,-0.16062416624178635,11.66,IS,0.34,0.0,Phase3-EA-S4v1-EURCHF-M15-221,EURCHFMT4,4284,8h 45m,Buy
175655.3,147312,17.10.2018 12:59:58,sl 147.312,-0.29,-481.4900000001653,0.0,0.0,147982,16.10.2018 14:00:00,16413,-0.18091824133001788,-54.01,IS,0.09,0.0,Phase3-EA-B1v1-GBPJPY-M30-1,GBPJPYMT4,1478,22h 59m,Buy
175620.97,0.99512,18.10.2018 02:15:00,,-9.27,-515.8200000001816,0.0,0.0,0.99469,17.10.2018 22:00:00,16414,-0.1938176228849003,-34.33,IS,0.58,0.0,Phase3-EA-SA2v2-USDCHF-M15-107,USDCHFMT4,3250,4h 15m,Sell
175596.67,1.14373,18.10.2018 09:30:00,,0.0,-540.12000000017,0.0,0.0,1.14432,18.10.2018 01:10:00,16415,-0.2029482658147967,-24.3,IS,0.41,0.0,Phase3-EA-SA2v2-EURCHF-M5-43,EURCHFMT4,8384,8h 20m,Buy
175566.27,1.14341,18.10.2018 11:00:00,,0.0,-570.5200000001932,0.0,0.0,1.1443,18.10.2018 02:15:00,16416,-0.21437096314274715,-30.4,IS,0.34,0.0,Phase3-EA-S4v1-EURCHF-M15-221,EURCHFMT4,4286,8h 45m,Buy
175531.54,129.62,18.10.2018 11:59:58,sl 129.620,0.0,-605.2500000001746,0.0,0.0,129.39,18.10.2018 06:15:00,16417,-0.2274206433466683,-34.73,IS,0.17,0.0,Phase3-EA-T1v2-EURJPY-M15-322,EURJPYMT4,3274,5h 44m,Sell
175632.32,128779,18.10.2018 20:29:58,tp 128.779,-2.8,-504.4700000001467,0.0,0.0,129418,12.10.2018 20:30:00,16418,-0.1895528987180405,100.78,IS,0.09,0.0,Phase3-EA-TR1v1-EURJPY-M30-91,EURJPYMT4,2913,5d 23h 59m,Sell
175600.06,1.14178,19.10.2018 04:25:00,,-0.99,-536.730000000156,0.0,0.0,1.14254,18.10.2018 20:05:00,16419,-0.2016744847640769,-32.26,IS,0.41,0.0,Phase3-EA-SA2v2-EURCHF-M5-43,EURCHFMT4,8386,8h 20m,Buy
175560.77,112361,19.10.2018 14:00:00,,-1.08,-576.020000000135,0.0,0.0,112202,18.10.2018 23:45:00,16420,-0.2164375695671884,-39.29,IS,0.27,0.0,Phase3-EA-S1v2-USDJPY-M15-0,USDJPYMT4,4654,14h 15m,Sell
175596.29,1.14085,19.10.2018 14:15:00,,0.0,-540.5000000001164,0.0,0.0,1.14189,19.10.2018 05:30:00,16421,-0.20309104953137583,35.52,IS,0.34,0.0,Phase3-EA-S4v1-EURCHF-M15-221,EURCHFMT4,4288,8h 45m,Sell
175538.35,129587,19.10.2018 19:59:58,sl 129.587,-0.28,-598.4400000001187,0.0,0.0,128867,18.10.2018 20:00:00,16422,-0.2248618088465393,-57.94,IS,0.09,0.0,Phase3-EA-TR1v1-EURJPY-M30-91,EURJPYMT4,2915,23h 59m,Sell
175581.57,1.14676,22.10.2018 02:00:00,tp 1.14676,-2.06,-555.2200000001467,0.0,0.0,1.14786,19.10.2018 20:05:00,16423,-0.20862203981649582,43.22,IS,0.41,0.0,Phase3-EA-SA2v2-EURCHF-M5-43,EURCHFMT4,8388,2d 5h 55m,Sell
175639.8,0.99603,22.10.2018 02:14:59,tp 0.99603,0.0,-496.9900000001653,0.0,0.0,0.99503,22.10.2018 02:00:00,16424,-0.18674231398077765,58.23,IS,0.58,0.0,Phase3-EA-SA2v2-USDCHF-M15-107,USDCHFMT4,3252,14m 59s,Buy
175685.11,1.14689,22.10.2018 02:14:59,tp 1.14689,0.0,-451.68000000016764,0.0,0.0,1.14579,22.10.2018 02:10:00,16425,-0.16971723450942855,45.31,IS,0.41,0.0,Phase3-EA-SA2v2-EURCHF-M5-43,EURCHFMT4,8390,4m 59s,Buy
175780.72,1.14858,22.10.2018 11:30:00,,0.0,-356.0700000001816,0.0,0.0,1.14578,22.10.2018 02:45:00,16426,-0.13379209991981184,95.61,IS,0.34,0.0,Phase3-EA-S4v1-EURCHF-M15-221,EURCHFMT4,4290,8h 45m,Buy
175718.43,130114,22.10.2018 11:59:58,sl 130.114,0.0,-418.36000000016065,0.0,0.0,129334,22.10.2018 06:00:00,16427,-0.1571973570434056,-62.29,IS,0.09,0.0,Phase3-EA-TR1v1-EURJPY-M30-91,EURJPYMT4,2918,5h 59m,Sell
175675.9,1.30114,22.10.2018 16:59:58,sl 1.30114,-0.53,-460.8900000001886,0.0,0.0,1.30414,19.10.2018 14:30:00,16428,-0.1731778609038556,-42.53,IS,0.14,0.0,Phase3-EA-B1v1-GBPUSD-M30-14,GBPUSDMT4,1070,3d 2h 29m,Buy
175676.65,129592,22.10.2018 17:45:00,,0.0,-460.1400000001886,0.0,0.0,129587,22.10.2018 08:00:00,16429,-0.17289605093688334,0.75,IS,0.17,0.0,Phase3-EA-T1v2-EURJPY-M15-322,EURJPYMT4,3276,9h 45m,Buy
175699.83,0.99595,23.10.2018 03:30:00,,-0.7,-436.9600000001956,0.0,0.0,0.99554,22.10.2018 23:15:00,16430,-0.16418624422433042,23.18,IS,0.58,0.0,Phase3-EA-SA2v2-USDCHF-M15-107,USDCHFMT4,3254,4h 15m,Buy
175643.27,1.14182,23.10.2018 04:40:00,,-0.99,-493.52000000019325,0.0,0.0,1.14317,22.10.2018 20:20:00,16431,-0.18543847320026322,-56.56,IS,0.41,0.0,Phase3-EA-SA2v2-EURCHF-M5-43,EURCHFMT4,8392,8h 20m,Buy
175601.27,1.29882,23.10.2018 12:59:58,sl 1.29882,0.0,-535.5200000001932,0.0,0.0,1.29582,23.10.2018 09:30:00,16432,-0.201219831350709,-42.0,IS,0.14,0.0,Phase3-EA-B1v1-GBPUSD-M30-14,GBPUSDMT4,1072,3h 29m,Sell
175704.5,128556,23.10.2018 18:29:58,tp 128.556,-0.28,-432.2900000002119,0.0,0.0,129846,22.10.2018 14:00:00,16433,-0.16243150749665602,103.23,IS,0.09,0.0,Phase3-EA-TR1v1-EURJPY-M30-91,EURJPYMT4,2920,1d 4h 29m,Sell
175749.87,1.14119,23.10.2018 22:59:58,tp 1.14119,0.0,-386.92000000021653,0.0,0.0,1.14229,23.10.2018 22:20:00,16434,-0.14538388322795004,45.37,IS,0.41,0.0,Phase3-EA-SA2v2-EURCHF-M5-43,EURCHFMT4,8394,39m 58s,Sell
175767.92,145918,24.10.2018 05:10:00,,-1.19,-368.8700000002282,0.0,0.0,146012,23.10.2018 23:45:00,16435,-0.138601656689489,18.05,IS,0.23,0.0,Phase3-EA-S4v1-GBPJPY-M5-194,GBPJPYMT4,3532,5h 25m,Sell
175707.19,1.13903,24.10.2018 13:00:00,,0.0,-429.60000000020955,0.0,0.0,1.14081,24.10.2018 04:15:00,16436,-0.16142074908178136,-60.73,IS,0.34,0.0,Phase3-EA-S4v1-EURCHF-M15-221,EURCHFMT4,4292,8h 45m,Buy
175672.15,1.13603,25.10.2018 04:35:00,,-2.96,-464.6400000001886,0.0,0.0,1.13681,24.10.2018 20:15:00,16437,-0.17458691073871682,-35.04,IS,0.41,0.0,Phase3-EA-SA2v2-EURCHF-M5-43,EURCHFMT4,8396,8h 20m,Buy
175772.3,127662,25.10.2018 04:59:58,tp 127.662,-1.12,-364.4900000001653,0.0,0.0,128922,23.10.2018 10:00:00,16438,-0.13695588648234747,100.15,IS,0.09,0.0,Phase3-EA-TR1v1-EURJPY-M30-91,EURJPYMT4,2921,1d 18h 59m,Sell
175919.05,144219,25.10.2018 05:29:58,tp 144.219,-1.85,-217.7400000001653,0.0,0.0,146069,23.10.2018 07:00:00,16439,-0.08181506961144464,146.75,IS,0.09,0.0,Phase3-EA-B1v1-GBPJPY-M30-1,GBPJPYMT4,1480,1d 22h 29m,Sell
175840.36,1.13916,25.10.2018 14:45:00,,0.0,-296.43000000016764,0.0,0.0,1.13685,25.10.2018 06:00:00,16440,-0.11138257134617358,-78.69,IS,0.34,0.0,Phase3-EA-S4v1-EURCHF-M15-221,EURCHFMT4,4294,8h 45m,Sell
175782.71,128377,25.10.2018 17:59:58,sl 128.377,0.0,-354.0800000001909,0.0,0.0,127657,25.10.2018 05:00:00,16441,-0.13304436414078233,-57.65,IS,0.09,0.0,Phase3-EA-TR1v1-EURJPY-M30-91,EURJPYMT4,2924,12h 59m,Sell
175810.82,112392,25.10.2018 18:45:00,,0.0,-325.9700000002049,0.0,0.0,112275,25.10.2018 18:15:00,16442,-0.12248212657866778,28.11,IS,0.27,0.0,Phase3-EA-S1v2-USDJPY-M15-0,USDJPYMT4,4656,30m 0s,Buy
175829.54,112472,25.10.2018 19:00:00,,0.0,-307.25000000023283,0.0,0.0,112394,25.10.2018 18:45:00,16443,-0.11544814980305101,18.72,IS,0.27,0.0,Phase3-EA-S1v2-USDJPY-M15-0,USDJPYMT4,4658,15m 0s,Buy
175775.94,144215,25.10.2018 19:59:58,sl 144.215,0.0,-360.85000000020955,0.0,0.0,144885,25.10.2018 14:00:00,16444,-0.1355881687759921,-53.6,IS,0.09,0.0,Phase3-EA-B1v1-GBPJPY-M30-1,GBPJPYMT4,1482,5h 59m,Buy
175810.17,0.99985,26.10.2018 05:30:00,,0.0,-326.6200000002282,0.0,0.0,0.99926,26.10.2018 01:15:00,16445,-0.1227263618833858,34.23,IS,0.58,0.0,Phase3-EA-SA2v2-USDCHF-M15-107,USDCHFMT4,3256,4h 15m,Buy
175791.97,1.13722,26.10.2018 05:45:00,,-0.98,-344.8200000002398,0.0,0.0,1.13764,25.10.2018 21:25:00,16446,-0.12956495041525,-18.2,IS,0.41,0.0,Phase3-EA-SA2v2-EURCHF-M5-43,EURCHFMT4,8398,8h 20m,Buy
175708.21,112184,26.10.2018 17:45:00,,0.0,-428.58000000024913,0.0,0.0,112532,26.10.2018 00:45:00,16447,-0.16103748752671398,-83.76,IS,0.27,0.0,Phase3-EA-S1v2-USDJPY-M15-0,USDJPYMT4,4660,17h 0m,Buy
175753.39,1.1372,26.10.2018 22:14:58,tp 1.13720,0.0,-383.4000000002561,0.0,0.0,1.1383,26.10.2018 21:35:00,16448,-0.1440612551163085,45.18,IS,0.41,0.0,Phase3-EA-SA2v2-EURCHF-M5-43,EURCHFMT4,8400,39m 58s,Sell
175718.47,127334,29.10.2018 13:14:59,sl 127.334,0.0,-418.3200000002398,0.0,0.0,127564,29.10.2018 09:45:00,16449,-0.15718232717853015,-34.92,IS,0.17,0.0,Phase3-EA-T1v2-EURJPY-M15-322,EURJPYMT4,3278,3h 29m,Buy
175683.57,127508,29.10.2018 13:44:58,sl 127.508,0.0,-453.2200000002631,0.0,0.0,127278,29.10.2018 13:15:00,16450,-0.17029588430831408,-34.9,IS,0.17,0.0,Phase3-EA-T1v2-EURJPY-M15-322,EURJPYMT4,3280,29m 58s,Sell
175625.53,128196,29.10.2018 15:29:58,sl 128.196,-0.28,-511.26000000024214,0.0,0.0,127476,26.10.2018 09:00:00,16451,-0.19210421828573176,-58.04,IS,0.09,0.0,Phase3-EA-TR1v1-EURJPY-M30-91,EURJPYMT4,2926,3d 6h 29m,Sell
175583.53,1.28029,29.10.2018 19:29:57,sl 1.28029,0.0,-553.2600000002421,0.0,0.0,1.28329,29.10.2018 02:30:00,16452,-0.20788557643617755,-42.0,IS,0.14,0.0,Phase3-EA-B1v1-GBPUSD-M30-14,GBPUSDMT4,1074,16h 59m,Buy
175620.49,112491,29.10.2018 21:00:00,,0.0,-516.3000000002212,0.0,0.0,112337,29.10.2018 20:15:00,16453,-0.1939979812637774,36.96,IS,0.27,0.0,Phase3-EA-S1v2-USDJPY-M15-0,USDJPYMT4,4662,45m 0s,Buy
175605.35,1.13994,30.10.2018 04:25:00,,-2.05,-531.4400000002352,0.0,0.0,1.13962,29.10.2018 20:05:00,16454,-0.19968678513039573,-15.14,IS,0.41,0.0,Phase3-EA-SA2v2-EURCHF-M5-43,EURCHFMT4,8402,8h 20m,Sell
175624.02,128146,30.10.2018 15:45:00,,0.0,-512.7700000002515,0.0,0.0,128022,30.10.2018 05:15:00,16455,-0.19267159568590606,18.67,IS,0.17,0.0,Phase3-EA-T1v2-EURJPY-M15-322,EURJPYMT4,3282,10h 30m,Buy
175589.36,128118,30.10.2018 18:44:58,sl 128.118,0.0,-547.4300000002258,0.0,0.0,128348,30.10.2018 17:00:00,16456,-0.2056949736262405,-34.66,IS,0.17,0.0,Phase3-EA-T1v2-EURJPY-M15-322,EURJPYMT4,3284,1h 44m,Buy
175634.3,1.1405,30.10.2018 20:24:58,tp 1.14050,0.0,-502.4900000002235,0.0,0.0,1.1416,30.10.2018 20:00:00,16457,-0.18880892040526265,44.94,IS,0.41,0.0,Phase3-EA-SA2v2-EURCHF-M5-43,EURCHFMT4,8404,24m 58s,Sell
175617.39,1.00516,31.10.2018 03:30:00,,-3.06,-519.4000000001979,0.0,0.0,1.00492,30.10.2018 23:15:00,16458,-0.1951627957939206,-16.91,IS,0.58,0.0,Phase3-EA-SA2v2-USDCHF-M15-107,USDCHFMT4,3258,4h 15m,Sell
175575.14,143744,31.10.2018 04:45:00,,-1.18,-561.6500000001979,0.0,0.0,143542,30.10.2018 23:20:00,16459,-0.2110380906000238,-42.25,IS,0.23,0.0,Phase3-EA-S4v1-GBPJPY-M5-194,GBPJPYMT4,3534,5h 25m,Sell
175594.97,1.14025,31.10.2018 06:30:00,,-0.98,-541.8200000001816,0.0,0.0,1.13974,30.10.2018 22:10:00,16460,-0.2035870350732715,19.83,IS,0.41,0.0,Phase3-EA-SA2v2-EURCHF-M5-43,EURCHFMT4,8406,8h 20m,Buy
175540.31,144733,31.10.2018 19:29:58,sl 144.733,-1.39,-596.480000000156,0.0,0.0,144063,26.10.2018 01:30:00,16461,-0.22412534546619917,-54.66,IS,0.09,0.0,Phase3-EA-B1v1-GBPJPY-M30-1,GBPJPYMT4,1484,5d 17h 59m,Sell
175597.84,1.00815,31.10.2018 22:29:58,tp 1.00815,0.0,-538.9500000001281,0.0,0.0,1.00915,31.10.2018 22:00:00,16462,-0.20250864226630425,57.53,IS,0.58,0.0,Phase3-EA-SA2v2-USDCHF-M15-107,USDCHFMT4,3260,29m 58s,Sell
175655.35,1.00859,01.11.2018 01:14:57,tp 1.00859,0.0,-481.44000000011874,0.0,0.0,1.00759,01.11.2018 00:15:00,16463,-0.1808994539988689,57.51,IS,0.58,0.0,Phase3-EA-SA2v2-USDCHF-M15-107,USDCHFMT4,3262,59m 57s,Buy
175685.73,112853,01.11.2018 04:00:00,,0.0,-451.0600000001141,0.0,0.0,112.98,01.11.2018 01:00:00,16464,-0.16948427160337803,30.38,IS,0.27,0.0,Phase3-EA-S1v2-USDJPY-M15-0,USDJPYMT4,4664,3h 0m,Sell
175612.5,1.14174,01.11.2018 04:45:00,,-6.11,-524.2900000000955,0.0,0.0,1.14009,31.10.2018 20:25:00,16465,-0.19700019677854114,-73.23,IS,0.41,0.0,Phase3-EA-SA2v2-EURCHF-M5-43,EURCHFMT4,8408,8h 20m,Sell
175600.98,1.14166,01.11.2018 13:45:00,,0.0,-535.8100000001141,0.0,0.0,1.14132,01.11.2018 05:00:00,16466,-0.20132879787124186,-11.52,IS,0.34,0.0,Phase3-EA-S4v1-EURCHF-M15-221,EURCHFMT4,4296,8h 45m,Sell
175537.44,128.7,01.11.2018 15:59:58,sl 128.700,-1.4,-599.3500000000931,0.0,0.0,127.92,29.10.2018 18:00:00,16467,-0.22520373827312268,-63.54,IS,0.09,0.0,Phase3-EA-TR1v1-EURJPY-M30-91,EURJPYMT4,2928,2d 21h 59m,Sell
175502.76,128413,02.11.2018 05:59:58,sl 128.413,0.0,-634.0300000000861,0.0,0.0,128643,02.11.2018 04:30:00,16468,-0.23823463114591673,-34.68,IS,0.17,0.0,Phase3-EA-T1v2-EURJPY-M15-322,EURJPYMT4,3286,1h 29m,Buy
175547.9,1.14392,02.11.2018 10:30:00,,0.0,-588.8900000000722,0.0,0.0,1.14259,02.11.2018 01:45:00,16469,-0.22127342860040855,45.14,IS,0.34,0.0,Phase3-EA-S4v1-EURCHF-M15-221,EURCHFMT4,4298,8h 45m,Buy
175592.84,1.1427,02.11.2018 21:29:58,tp 1.14270,0.0,-543.9500000000698,0.0,0.0,1.1416,02.11.2018 21:10:00,16470,-0.20438737537943066,44.94,IS,0.41,0.0,Phase3-EA-SA2v2-EURCHF-M5-43,EURCHFMT4,8410,19m 58s,Buy
175550.15,1.3014,05.11.2018 02:00:00,sl 1.30140,-0.69,-586.6400000000722,0.0,0.0,1.2984,02.11.2018 19:00:00,16471,-0.2204279986994918,-42.69,IS,0.14,0.0,Phase3-EA-B1v1-GBPUSD-M30-14,GBPUSDMT4,1076,2d 7h 0m,Sell
175593.06,1.14237,05.11.2018 02:00:00,tp 1.14237,-2.04,-543.7300000000978,0.0,0.0,1.14347,02.11.2018 22:45:00,16472,-0.20430471112246265,42.91,IS,0.41,0.0,Phase3-EA-SA2v2-EURCHF-M5-43,EURCHFMT4,8412,2d 3h 15m,Sell
175637.99,1.14341,05.11.2018 06:34:57,tp 1.14341,0.0,-498.8000000001048,0.0,0.0,1.14231,05.11.2018 02:25:00,16473,-0.18742241536771456,44.93,IS,0.41,0.0,Phase3-EA-SA2v2-EURCHF-M5-43,EURCHFMT4,8414,4h 9m,Buy
175676.8,147003,05.11.2018 07:40:00,,0.0,-459.9900000001071,0.0,0.0,147194,05.11.2018 02:15:00,16474,-0.17283968894345828,38.81,IS,0.23,0.0,Phase3-EA-S4v1-GBPJPY-M5-194,GBPJPYMT4,3536,5h 25m,Sell
175642.26,128783,05.11.2018 12:14:58,sl 128.783,0.0,-494.53000000008615,0.0,0.0,129013,05.11.2018 09:45:00,16475,-0.18581797728907892,-34.54,IS,0.17,0.0,Phase3-EA-T1v2-EURJPY-M15-322,EURJPYMT4,3288,2h 29m,Buy
175700.02,1.00409,05.11.2018 23:44:58,tp 1.00409,0.0,-436.77000000007683,0.0,0.0,1.00309,05.11.2018 23:00:00,16476,-0.16411485236598616,57.76,IS,0.58,0.0,Phase3-EA-SA2v2-USDCHF-M15-107,USDCHFMT4,3264,44m 58s,Buy
175742.89,1.14462,06.11.2018 02:04:57,tp 1.14462,-2.04,-393.9000000000815,0.0,0.0,1.14572,05.11.2018 20:05:00,16477,-0.14800659465385432,42.87,IS,0.41,0.0,Phase3-EA-SA2v2-EURCHF-M5-43,EURCHFMT4,8416,5h 59m,Sell
175800.7,1.00326,06.11.2018 02:44:57,tp 1.00326,0.0,-336.0900000000838,0.0,0.0,1.00426,06.11.2018 02:00:00,16478,-0.12628468239963447,57.81,IS,0.58,0.0,Phase3-EA-SA2v2-USDCHF-M15-107,USDCHFMT4,3266,44m 57s,Sell
175946.96,147796,06.11.2018 02:59:58,tp 147.796,-0.87,-189.8300000000745,0.0,0.0,145946,01.11.2018 19:30:00,16479,-0.07132798137381666,146.26,IS,0.09,0.0,Phase3-EA-B1v1-GBPJPY-M30-1,GBPJPYMT4,1486,4d 7h 29m,Buy
175872.49,147936,06.11.2018 04:30:00,,-1.18,-264.30000000004657,0.0,0.0,147575,05.11.2018 23:05:00,16480,-0.09930983236103706,-74.47,IS,0.23,0.0,Phase3-EA-S4v1-GBPJPY-M5-194,GBPJPYMT4,3538,5h 25m,Sell
175840.16,1.00457,06.11.2018 07:00:00,,0.0,-296.63000000006286,0.0,0.0,1.00401,06.11.2018 02:45:00,16481,-0.11145772067066015,-32.33,IS,0.58,0.0,Phase3-EA-SA2v2-USDCHF-M15-107,USDCHFMT4,3268,4h 15m,Sell
175885.1,1145,06.11.2018 22:34:58,tp 1.14500,0.0,-251.69000000006054,0.0,0.0,1.1461,06.11.2018 21:10:00,16482,-0.09457166744968228,44.94,IS,0.41,0.0,Phase3-EA-SA2v2-EURCHF-M5-43,EURCHFMT4,8418,1h 24m,Sell
175831.89,113.4,07.11.2018 02:15:00,,-1.07,-304.9000000000815,0.0,0.0,113181,06.11.2018 18:00:00,16483,-0.11456514523981444,-53.21,IS,0.27,0.0,Phase3-EA-S1v2-USDJPY-M15-0,USDJPYMT4,4666,8h 15m,Sell
175724.61,1.00125,07.11.2018 04:00:00,,-0.69,-412.18000000010943,0.0,0.0,1.00309,06.11.2018 23:45:00,16484,-0.15487524291553503,-107.28,IS,0.58,0.0,Phase3-EA-SA2v2-USDCHF-M15-107,USDCHFMT4,3270,4h 15m,Buy
175732.16,148535,07.11.2018 04:25:00,,-1.18,-404.6300000001211,0.0,0.0,148578,06.11.2018 23:00:00,16485,-0.15203835591468545,7.55,IS,0.23,0.0,Phase3-EA-S4v1-GBPJPY-M5-194,GBPJPYMT4,3540,5h 25m,Sell
175776.3,1.14622,07.11.2018 04:44:58,tp 1.14622,-0.98,-360.4900000001071,0.0,0.0,1.14512,06.11.2018 22:40:00,16486,-0.13545289999180696,44.14,IS,0.41,0.0,Phase3-EA-SA2v2-EURCHF-M5-43,EURCHFMT4,8420,6h 4m,Buy
175805.94,129487,07.11.2018 12:00:00,,-0.73,-330.85000000009313,0.0,0.0,129285,06.11.2018 17:30:00,16487,-0.12431577009705853,29.64,IS,0.17,0.0,Phase3-EA-T1v2-EURJPY-M15-322,EURJPYMT4,3290,18h 30m,Buy
175807.99,1.14553,07.11.2018 13:45:00,,0.0,-328.8000000001048,0.0,0.0,1.14559,07.11.2018 05:00:00,16488,-0.1235454895206721,2.05,IS,0.34,0.0,Phase3-EA-S4v1-EURCHF-M15-221,EURCHFMT4,4300,8h 45m,Sell
175906.69,129907,07.11.2018 13:59:58,tp 129.907,-1.56,-230.10000000009313,0.0,0.0,128647,01.11.2018 16:00:00,16489,-0.08645929786712013,98.7,IS,0.09,0.0,Phase3-EA-TR1v1-EURJPY-M30-91,EURJPYMT4,2930,5d 21h 59m,Buy
175863.09,1.31229,08.11.2018 01:59:59,sl 1.31229,-1.6,-273.70000000006985,0.0,0.0,1.31529,07.11.2018 19:30:00,16490,-0.10284185061376462,-43.6,IS,0.14,0.0,Phase3-EA-B1v1-GBPUSD-M30-14,GBPUSDMT4,1078,6h 29m,Buy
175908.1,1.1448,08.11.2018 02:00:00,tp 1.14480,0.0,-228.69000000006054,0.0,0.0,1.1459,08.11.2018 00:35:00,16491,-0.08592949512920006,45.01,IS,0.41,0.0,Phase3-EA-SA2v2-EURCHF-M5-43,EURCHFMT4,8422,1h 25m,Sell
175847.93,1.0017,08.11.2018 02:45:00,,-9.22,-288.86000000004424,0.0,0.0,1.00082,07.11.2018 22:30:00,16492,-0.10853816941282067,-60.17,IS,0.58,0.0,Phase3-EA-SA2v2-USDCHF-M15-107,USDCHFMT4,3272,4h 15m,Sell
175878.69,149146,08.11.2018 07:30:00,,0.0,-258.1000000000349,0.0,0.0,148994,08.11.2018 02:05:00,16493,-0.09698020330072878,30.76,IS,0.23,0.0,Phase3-EA-S4v1-GBPJPY-M5-194,GBPJPYMT4,3542,5h 25m,Buy
175880.39,1.14516,08.11.2018 11:45:00,,0.0,-256.4000000000233,0.0,0.0,1.14511,08.11.2018 03:00:00,16494,-0.09634143404225398,1.7,IS,0.34,0.0,Phase3-EA-S4v1-EURCHF-M15-221,EURCHFMT4,4302,8h 45m,Buy
175843.87,129587,08.11.2018 23:44:58,sl 129.587,-2.2,-292.9200000000419,0.0,0.0,129817,07.11.2018 13:00:00,16495,-0.11006370070069622,-36.52,IS,0.17,0.0,Phase3-EA-T1v2-EURJPY-M15-322,EURJPYMT4,3292,1d 10h 44m,Buy
175855.05,148805,09.11.2018 05:15:00,,-0.73,-281.7400000000489,0.0,0.0,148746,08.11.2018 23:50:00,16496,-0.10586285345969923,11.18,IS,0.23,0.0,Phase3-EA-S4v1-GBPJPY-M5-194,GBPJPYMT4,3544,5h 25m,Buy
175842.43,1.14266,09.11.2018 09:10:00,,0.0,-294.36000000004424,0.0,0.0,1.14297,09.11.2018 00:50:00,16497,-0.11060477583728381,-12.62,IS,0.41,0.0,Phase3-EA-SA2v2-EURCHF-M5-43,EURCHFMT4,8424,8h 20m,Buy
175824.54,1.1427,09.11.2018 10:15:00,,0.0,-312.2500000000582,0.0,0.0,1.14323,09.11.2018 01:30:00,16498,-0.1173268829161337,-17.89,IS,0.34,0.0,Phase3-EA-S4v1-EURCHF-M15-221,EURCHFMT4,4304,8h 45m,Buy
175770.42,147915,09.11.2018 12:59:58,sl 147.915,-1.14,-366.37000000005355,0.0,0.0,148585,07.11.2018 01:00:00,16499,-0.13766229013284925,-54.12,IS,0.09,0.0,Phase3-EA-B1v1-GBPJPY-M30-1,GBPJPYMT4,1488,2d 11h 59m,Buy
175721.74,1.13897,12.11.2018 05:05:00,,-0.98,-415.05000000004657,0.0,0.0,1.14014,09.11.2018 20:45:00,16500,-0.15595363572245854,-48.68,IS,0.41,0.0,Phase3-EA-SA2v2-EURCHF-M5-43,EURCHFMT4,8426,2d 8h 20m,Buy
175789.53,147522,12.11.2018 07:35:00,,0.0,-347.2600000000675,0.0,0.0,147186,12.11.2018 02:10:00,16501,-0.13048177217440166,67.79,IS,0.23,0.0,Phase3-EA-S4v1-GBPJPY-M5-194,GBPJPYMT4,3546,5h 25m,Buy
175889.86,128559,12.11.2018 11:59:58,tp 128.559,-1.39,-246.93000000005122,0.0,0.0,129849,07.11.2018 21:00:00,16502,-0.09278311352596158,100.33,IS,0.09,0.0,Phase3-EA-TR1v1-EURJPY-M30-91,EURJPYMT4,2932,4d 14h 59m,Sell
175809.68,1.13642,12.11.2018 12:00:00,,0.0,-327.11000000004424,0.0,0.0,1.1388,12.11.2018 03:15:00,16503,-0.12291047772840523,-80.18,IS,0.34,0.0,Phase3-EA-S4v1-EURCHF-M15-221,EURCHFMT4,4306,8h 45m,Buy
175909.07,127978,12.11.2018 20:29:58,tp 127.978,-0.28,-227.72000000003027,0.0,0.0,129238,09.11.2018 08:00:00,16504,-0.08556502090523792,99.39,IS,0.09,0.0,Phase3-EA-TR1v1-EURJPY-M30-91,EURJPYMT4,2933,3d 12h 29m,Sell
175966.51,1.00979,13.11.2018 02:29:58,tp 1.00979,0.0,-170.28000000002794,0.0,0.0,1.01079,13.11.2018 01:15:00,16505,-0.06398213490138928,57.44,IS,0.58,0.0,Phase3-EA-SA2v2-USDCHF-M15-107,USDCHFMT4,3274,1h 14m,Sell
175898.96,1.1337,13.11.2018 04:25:00,,-0.97,-237.8300000000163,0.0,0.0,1.13534,12.11.2018 20:05:00,16506,-0.08936381926001855,-67.55,IS,0.41,0.0,Phase3-EA-SA2v2-EURCHF-M5-43,EURCHFMT4,8428,8h 20m,Buy
176044.46,145997,13.11.2018 04:29:58,tp 145.997,-0.92,-92.3300000000163,0.0,0.0,147847,09.11.2018 20:30:00,16507,-0.03469268566740278,145.5,IS,0.09,0.0,Phase3-EA-B1v1-GBPJPY-M30-1,GBPJPYMT4,1490,3d 7h 59m,Sell
175991.5,146712,13.11.2018 07:59:58,sl 146.712,0.0,-145.29000000003725,0.0,0.0,146042,13.11.2018 04:30:00,16508,-0.05459222680187753,-52.96,IS,0.09,0.0,Phase3-EA-B1v1-GBPJPY-M30-1,GBPJPYMT4,1492,3h 29m,Sell
176057.09,1.13576,13.11.2018 11:45:00,,0.0,-79.70000000001164,0.0,0.0,1.13381,13.11.2018 03:00:00,16509,-0.029947005823588405,65.59,IS,0.34,0.0,Phase3-EA-S4v1-EURCHF-M15-221,EURCHFMT4,4308,8h 45m,Buy
176101.75,1.13693,13.11.2018 22:49:58,tp 1.13693,0.0,-35.04000000003725,0.0,0.0,1.13803,13.11.2018 20:20:00,16510,-0.01316616165695734,44.66,IS,0.41,0.0,Phase3-EA-SA2v2-EURCHF-M5-43,EURCHFMT4,8430,2h 29m,Sell
176145.56,1.13801,14.11.2018 03:04:57,tp 1.13801,-0.98,-0.0,0.0,0.0,1.13691,13.11.2018 22:55:00,16511,-0.0,43.81,IS,0.41,0.0,Phase3-EA-SA2v2-EURCHF-M5-43,EURCHFMT4,8432,4h 9m,Buy
176092.54,1.00639,14.11.2018 06:30:00,,0.0,-53.02000000001863,0.0,0.0,1.00731,14.11.2018 02:15:00,16512,-0.019921429461388862,-53.02,IS,0.58,0.0,Phase3-EA-SA2v2-USDCHF-M15-107,USDCHFMT4,3276,4h 15m,Buy
176068.51,148.09,14.11.2018 08:05:00,,0.0,-77.05000000004657,0.0,0.0,147971,14.11.2018 02:40:00,16513,-0.028950323274243683,-24.03,IS,0.23,0.0,Phase3-EA-S4v1-GBPJPY-M5-194,GBPJPYMT4,3548,5h 25m,Sell
176099.89,1.13694,14.11.2018 12:30:00,,0.0,-45.67000000004191,0.0,0.0,1.13787,14.11.2018 03:45:00,16514,-0.01715978278955384,31.38,IS,0.34,0.0,Phase3-EA-S4v1-EURCHF-M15-221,EURCHFMT4,4310,8h 45m,Sell
176201.35,129.06,14.11.2018 18:59:58,tp 129.060,-0.39,-0.0,0.0,0.0,127.77,13.11.2018 06:00:00,16515,-0.0,101.46,IS,0.09,0.0,Phase3-EA-TR1v1-EURJPY-M30-91,EURJPYMT4,2936,1d 12h 59m,Buy
176259.05,1.00525,15.11.2018 01:14:57,tp 1.00525,0.0,-0.0,0.0,0.0,1.00425,15.11.2018 00:30:00,16516,-0.0,57.7,IS,0.58,0.0,Phase3-EA-SA2v2-USDCHF-M15-107,USDCHFMT4,3278,44m 57s,Buy
176208.84,1.13813,15.11.2018 04:50:00,,-2.94,-50.210000000020955,0.0,0.0,1.13929,14.11.2018 20:30:00,16517,-0.018857574981966142,-50.21,IS,0.41,0.0,Phase3-EA-SA2v2-EURCHF-M5-43,EURCHFMT4,8434,8h 20m,Buy
176250.48,113465,15.11.2018 06:15:00,,0.0,-8.570000000006985,0.0,0.0,113.64,15.11.2018 01:45:00,16518,-0.0032186699381699683,41.64,IS,0.27,0.0,Phase3-EA-S1v2-USDJPY-M15-0,USDJPYMT4,4668,4h 30m,Sell
176295.32,1.1385,15.11.2018 21:04:58,tp 1.13850,0.0,-0.0,0.0,0.0,1.1396,15.11.2018 20:45:00,16519,-0.0,44.84,IS,0.41,0.0,Phase3-EA-SA2v2-EURCHF-M5-43,EURCHFMT4,8436,19m 58s,Sell
176352.99,1.0058,15.11.2018 23:29:57,tp 1.00580,0.0,-0.0,0.0,0.0,1.0068,15.11.2018 23:15:00,16520,-0.0,57.67,IS,0.58,0.0,Phase3-EA-SA2v2-USDCHF-M15-107,USDCHFMT4,3280,14m 57s,Sell
176395.75,1.13898,16.11.2018 02:04:57,tp 1.13898,-2.04,-0.0,0.0,0.0,1.14008,15.11.2018 22:30:00,16521,-0.0,42.76,IS,0.41,0.0,Phase3-EA-SA2v2-EURCHF-M5-43,EURCHFMT4,8438,3h 34m,Sell
176374.15,1.14176,16.11.2018 14:15:00,,0.0,-21.599999999976717,0.0,0.0,1.14112,16.11.2018 05:30:00,16522,-0.008108237462488278,-21.6,IS,0.34,0.0,Phase3-EA-S4v1-EURCHF-M15-221,EURCHFMT4,4312,8h 45m,Sell
176419.24,1.14257,16.11.2018 21:39:58,tp 1.14257,0.0,-0.0,0.0,0.0,1.14147,16.11.2018 20:30:00,16523,-0.0,45.09,IS,0.41,0.0,Phase3-EA-SA2v2-EURCHF-M5-43,EURCHFMT4,8440,1h 9m,Buy
176463.22,112656,19.11.2018 03:30:00,,-1.08,-0.0,0.0,0.0,112844,16.11.2018 22:00:00,16524,-0.0,43.98,IS,0.27,0.0,Phase3-EA-S1v2-USDJPY-M15-0,USDJPYMT4,4670,2d 5h 30m,Sell
176440.09,1.1407,19.11.2018 06:20:00,,-0.98,-23.130000000004657,0.0,0.0,1.14124,16.11.2018 22:00:00,16525,-0.008680372473170796,-23.13,IS,0.41,0.0,Phase3-EA-SA2v2-EURCHF-M5-43,EURCHFMT4,8442,2d 8h 20m,Buy
176441.11,144569,19.11.2018 09:05:00,,0.0,-22.10999999998603,0.0,0.0,144564,19.11.2018 03:40:00,16526,-0.008297580431545456,1.02,IS,0.23,0.0,Phase3-EA-S4v1-GBPJPY-M5-194,GBPJPYMT4,3550,5h 25m,Buy
176471.38,112398,20.11.2018 03:30:00,,0.0,-0.0,0.0,0.0,112524,20.11.2018 00:30:00,16527,-0.0,30.27,IS,0.27,0.0,Phase3-EA-S1v2-USDJPY-M15-0,USDJPYMT4,4672,3h 0m,Sell
176449.76,1.13713,20.11.2018 05:35:00,,-0.99,-21.619999999995343,0.0,0.0,1.13763,19.11.2018 21:15:00,16528,-0.008113441676173717,-21.62,IS,0.41,0.0,Phase3-EA-SA2v2-EURCHF-M5-43,EURCHFMT4,8444,8h 20m,Buy
176366.87,1.13485,20.11.2018 14:15:00,,0.0,-104.51000000000931,0.0,0.0,1.13727,20.11.2018 05:30:00,16529,-0.0392199717658267,-82.89,IS,0.34,0.0,Phase3-EA-S4v1-EURCHF-M15-221,EURCHFMT4,4314,8h 45m,Buy
176398.46,112809,21.11.2018 04:45:00,,0.0,-72.9199999999837,0.0,0.0,112677,21.11.2018 01:00:00,16530,-0.027365040102987168,31.59,IS,0.27,0.0,Phase3-EA-S1v2-USDJPY-M15-0,USDJPYMT4,4674,3h 45m,Buy
176368.21,1.1312,21.11.2018 06:15:00,,-0.99,-103.1699999999837,0.0,0.0,1.13191,20.11.2018 21:55:00,16531,-0.03871710350281639,-30.25,IS,0.41,0.0,Phase3-EA-SA2v2-EURCHF-M5-43,EURCHFMT4,8446,8h 20m,Buy
176324.62,1.27742,21.11.2018 14:29:57,sl 1.27742,-1.59,-146.7600000000093,0.0,0.0,1.28042,16.11.2018 10:30:00,16532,-0.055075333043274124,-43.59,IS,0.14,0.0,Phase3-EA-B1v1-GBPUSD-M30-14,GBPUSDMT4,1080,5d 3h 59m,Buy
176306.4,1.13267,22.11.2018 05:40:00,,-2.97,-164.97999999998137,0.0,0.0,1.13304,21.11.2018 21:20:00,16533,-0.061912840320780614,-18.22,IS,0.41,0.0,Phase3-EA-SA2v2-EURCHF-M5-43,EURCHFMT4,8448,8h 20m,Buy
176326.58,1.1328,22.11.2018 10:15:00,,0.0,-144.79999999998836,0.0,0.0,1.13221,22.11.2018 01:30:00,16534,-0.05433979438992196,20.18,IS,0.34,0.0,Phase3-EA-S4v1-EURCHF-M15-221,EURCHFMT4,4316,8h 45m,Buy
176284.58,1.28779,22.11.2018 15:29:58,sl 1.28779,0.0,-186.79999999998836,0.0,0.0,1.29079,22.11.2018 14:30:00,16535,-0.07010133696158567,-42.0,IS,0.14,0.0,Phase3-EA-B1v1-GBPUSD-M30-14,GBPUSDMT4,1082,59m 58s,Buy
176329.95,1.13448,23.11.2018 01:49:57,tp 1.13448,0.0,-141.42999999999302,0.0,0.0,1.13338,23.11.2018 01:45:00,16536,-0.05307511823595926,45.37,IS,0.41,0.0,Phase3-EA-SA2v2-EURCHF-M5-43,EURCHFMT4,8450,4m 57s,Buy
176375.3,1.1336,23.11.2018 02:19:58,tp 1.13360,0.0,-96.0800000000163,0.0,0.0,1.1325,23.11.2018 02:10:00,16537,-0.03605640500680254,45.35,IS,0.41,0.0,Phase3-EA-SA2v2-EURCHF-M5-43,EURCHFMT4,8452,9m 58s,Buy
176428.65,1.13515,23.11.2018 10:45:00,,0.0,-42.73000000003958,0.0,0.0,1.13359,23.11.2018 02:00:00,16538,-0.01603549319256701,53.35,IS,0.34,0.0,Phase3-EA-S4v1-EURCHF-M15-221,EURCHFMT4,4318,8h 45m,Buy
176486.76,0.99808,26.11.2018 05:29:59,tp 0.99808,0.0,-0.0,0.0,0.0,0.99708,26.11.2018 02:15:00,16539,-0.0,58.11,IS,0.58,0.0,Phase3-EA-SA2v2-USDCHF-M15-107,USDCHFMT4,3282,3h 14m,Buy
176489.47,1.13064,26.11.2018 05:50:00,,-0.99,-0.0,0.0,0.0,1.13055,23.11.2018 21:30:00,16540,-0.0,2.71,IS,0.41,0.0,Phase3-EA-SA2v2-EURCHF-M5-43,EURCHFMT4,8454,2d 8h 20m,Buy
176435.75,145017,26.11.2018 06:29:57,sl 145.017,-0.46,-53.71999999997206,0.0,0.0,144347,23.11.2018 20:00:00,16541,-0.020158395001487976,-53.72,IS,0.09,0.0,Phase3-EA-B1v1-GBPJPY-M30-1,GBPJPYMT4,1494,2d 10h 29m,Sell
176393.75,1.28298,26.11.2018 11:29:58,sl 1.28298,0.0,-95.71999999997206,0.0,0.0,1.27998,26.11.2018 06:00:00,16542,-0.03591886763854932,-42.0,IS,0.14,0.0,Phase3-EA-B1v1-GBPUSD-M30-14,GBPUSDMT4,1084,5h 29m,Sell
176336.24,128733,26.11.2018 12:29:58,sl 128.733,-0.28,-153.22999999998137,0.0,0.0,128593,19.11.2018 06:00:00,16543,-0.057499457670871806,-57.51,IS,0.09,0.0,Phase3-EA-TR1v1-EURJPY-M30-91,EURJPYMT4,2938,7d 6h 29m,Sell
176294.24,1.28049,26.11.2018 21:29:57,sl 1.28049,0.0,-195.22999999998137,0.0,0.0,1.28349,26.11.2018 12:30:00,16544,-0.07325993030793315,-42.0,IS,0.14,0.0,Phase3-EA-B1v1-GBPUSD-M30-14,GBPUSDMT4,1086,8h 59m,Buy
176243.98,1.13138,27.11.2018 04:25:00,,-0.98,-245.4899999999907,0.0,0.0,1.13258,26.11.2018 20:05:00,16545,-0.09211996256362005,-50.26,IS,0.41,0.0,Phase3-EA-SA2v2-EURCHF-M5-43,EURCHFMT4,8456,8h 20m,Buy
176252.12,0.99815,27.11.2018 06:30:00,,0.0,-237.34999999997672,0.0,0.0,0.99801,27.11.2018 02:15:00,16546,-0.08906543286681293,8.14,IS,0.58,0.0,Phase3-EA-SA2v2-USDCHF-M15-107,USDCHFMT4,3284,4h 15m,Buy
176242.13,113525,27.11.2018 11:00:00,,0.0,-247.3399999999674,0.0,0.0,113567,27.11.2018 01:15:00,16547,-0.09281417385833901,-9.99,IS,0.27,0.0,Phase3-EA-S1v2-USDJPY-M15-0,USDJPYMT4,4676,9h 45m,Buy
176247.58,1.13106,27.11.2018 11:45:00,,0.0,-241.88999999995576,0.0,0.0,1.1309,27.11.2018 03:00:00,16548,-0.09076906490900169,5.45,IS,0.34,0.0,Phase3-EA-S4v1-EURCHF-M15-221,EURCHFMT4,4320,8h 45m,Buy
176194.21,144752,27.11.2018 12:29:58,sl 144.752,-0.29,-295.2599999999511,0.0,0.0,145422,26.11.2018 12:30:00,16549,-0.11079612263852288,-53.37,IS,0.09,0.0,Phase3-EA-B1v1-GBPJPY-M30-1,GBPJPYMT4,1496,23h 59m,Buy
176198.24,113791,28.11.2018 04:00:00,,0.0,-291.22999999992317,0.0,0.0,113774,28.11.2018 01:00:00,16550,-0.10928386776405152,4.03,IS,0.27,0.0,Phase3-EA-S1v2-USDJPY-M15-0,USDJPYMT4,4678,3h 0m,Buy
176200.53,1.12796,28.11.2018 04:20:00,,-0.99,-288.9399999999441,0.0,0.0,1.12788,27.11.2018 20:00:00,16551,-0.10842454675599104,2.29,IS,0.41,0.0,Phase3-EA-SA2v2-EURCHF-M5-43,EURCHFMT4,8458,8h 20m,Buy
176164.54,0.9991,28.11.2018 06:30:00,,0.0,-324.9299999999348,0.0,0.0,0.99848,28.11.2018 02:15:00,16552,-0.1219297708085551,-35.99,IS,0.58,0.0,Phase3-EA-SA2v2-USDCHF-M15-107,USDCHFMT4,3286,4h 15m,Sell
176220.81,0.99374,29.11.2018 01:59:58,tp 0.99374,-2.1,-268.6599999999162,0.0,0.0,0.99274,28.11.2018 23:45:00,16553,-0.10081448996837093,56.27,IS,0.58,0.0,Phase3-EA-SA2v2-USDCHF-M15-107,USDCHFMT4,3288,2h 14m,Buy
176214.61,1.12943,29.11.2018 10:35:00,,0.0,-274.8599999999278,0.0,0.0,1.12958,29.11.2018 02:15:00,16554,-0.10314103592908436,-6.2,IS,0.41,0.0,Phase3-EA-SA2v2-EURCHF-M5-43,EURCHFMT4,8460,8h 20m,Buy
176249.51,1.13001,29.11.2018 14:00:00,,0.0,-239.95999999990454,0.0,0.0,1.12899,29.11.2018 05:15:00,16555,-0.09004483366637465,34.9,IS,0.34,0.0,Phase3-EA-S4v1-EURCHF-M15-221,EURCHFMT4,4322,8h 45m,Buy
176223.16,1.13486,30.11.2018 04:35:00,,-2.06,-266.30999999988126,0.0,0.0,1.13427,29.11.2018 20:15:00,16556,-0.0999326539993794,-26.35,IS,0.41,0.0,Phase3-EA-SA2v2-EURCHF-M5-43,EURCHFMT4,8462,8h 20m,Sell
176234.75,1.13449,30.11.2018 15:15:00,,0.0,-254.71999999985565,0.0,0.0,1.13483,30.11.2018 06:30:00,16557,-0.09558351405023786,11.59,IS,0.34,0.0,Phase3-EA-S4v1-EURCHF-M15-221,EURCHFMT4,4324,8h 45m,Sell
176278.93,1.13182,03.12.2018 02:00:00,tp 1.13182,-0.98,-210.53999999986263,0.0,0.0,1.13072,30.11.2018 21:00:00,16558,-0.07900499783344596,44.18,IS,0.41,0.0,Phase3-EA-SA2v2-EURCHF-M5-43,EURCHFMT4,8464,2d 5h 0m,Buy
176324.07,1.13197,03.12.2018 02:39:58,tp 1.13197,0.0,-165.39999999984866,0.0,0.0,1.13307,03.12.2018 02:15:00,16559,-0.06206624224208478,45.14,IS,0.41,0.0,Phase3-EA-SA2v2-EURCHF-M5-43,EURCHFMT4,8466,24m 58s,Sell
176336.84,144932,03.12.2018 09:05:00,,0.0,-152.62999999983003,0.0,0.0,144995,03.12.2018 03:40:00,16560,-0.057274308061714144,12.77,IS,0.23,0.0,Phase3-EA-S4v1-GBPJPY-M5-194,GBPJPYMT4,3552,5h 25m,Sell
176282.94,1.13417,03.12.2018 11:45:00,,0.0,-206.52999999985332,0.0,0.0,1.13259,03.12.2018 03:00:00,16561,-0.0775002479459516,-53.9,IS,0.34,0.0,Phase3-EA-S4v1-EURCHF-M15-221,EURCHFMT4,4326,8h 45m,Sell
176286.83,0.99792,04.12.2018 02:15:00,,-3.08,-202.63999999983935,0.0,0.0,0.99804,03.12.2018 22:00:00,16562,-0.07604052798027568,3.89,IS,0.58,0.0,Phase3-EA-SA2v2-USDCHF-M15-107,USDCHFMT4,3290,4h 15m,Sell
176272.04,1.13302,04.12.2018 04:30:00,,-2.05,-217.4299999998184,0.0,0.0,1.13271,03.12.2018 20:10:00,16563,-0.08159046584460442,-14.79,IS,0.41,0.0,Phase3-EA-SA2v2-EURCHF-M5-43,EURCHFMT4,8468,8h 20m,Sell
176211.53,128.13,04.12.2018 20:59:58,sl 128.130,-3.12,-277.9399999998277,0.0,0.0,128013,23.11.2018 16:00:00,16564,-0.10429680392243129,-60.51,IS,0.09,0.0,Phase3-EA-TR1v1-EURJPY-M30-91,EURJPYMT4,2939,11d 4h 59m,Sell
176169.53,1.27119,04.12.2018 21:29:58,sl 1.27119,0.0,-319.9399999998277,0.0,0.0,1.27419,04.12.2018 10:30:00,16565,-0.12005727655949262,-42.0,IS,0.14,0.0,Phase3-EA-B1v1-GBPUSD-M30-14,GBPUSDMT4,1088,10h 59m,Buy
176198.5,112768,04.12.2018 22:00:00,,0.0,-290.96999999985565,0.0,0.0,112889,04.12.2018 17:45:00,16566,-0.1091863029334158,28.97,IS,0.27,0.0,Phase3-EA-S1v2-USDJPY-M15-0,USDJPYMT4,4680,4h 15m,Sell
176177.37,1.13162,05.12.2018 04:25:00,,-0.99,-312.0999999998603,0.0,0.0,1.13211,04.12.2018 20:05:00,16567,-0.11711532166725341,-21.13,IS,0.41,0.0,Phase3-EA-SA2v2-EURCHF-M5-43,EURCHFMT4,8470,8h 20m,Buy
176173.28,1.13216,05.12.2018 15:00:00,,0.0,-316.1899999998859,0.0,0.0,1.13204,05.12.2018 06:15:00,16568,-0.11865009150263399,-4.09,IS,0.34,0.0,Phase3-EA-S4v1-EURCHF-M15-221,EURCHFMT4,4328,8h 45m,Sell
176133.31,1.13135,06.12.2018 04:20:00,,-2.96,-356.159999999858,0.0,0.0,1.13225,05.12.2018 20:00:00,16569,-0.1336488079622269,-39.97,IS,0.41,0.0,Phase3-EA-SA2v2-EURCHF-M5-43,EURCHFMT4,8472,8h 20m,Buy
175997.42,143383,06.12.2018 08:05:00,,0.0,-492.04999999987194,0.0,0.0,144049,06.12.2018 02:40:00,16570,-0.1846414419300956,-135.89,IS,0.23,0.0,Phase3-EA-S4v1-GBPJPY-M5-194,GBPJPYMT4,3554,5h 25m,Buy
175993.67,1.13131,06.12.2018 12:45:00,,0.0,-495.79999999987194,0.0,0.0,1.13142,06.12.2018 04:00:00,16571,-0.18604862698697608,-3.75,IS,0.34,0.0,Phase3-EA-S4v1-EURCHF-M15-221,EURCHFMT4,4330,8h 45m,Buy
176039.11,1.13014,06.12.2018 21:39:57,tp 1.13014,0.0,-450.3599999998696,0.0,0.0,1.12904,06.12.2018 20:10:00,16572,-0.16899729659106885,45.44,IS,0.41,0.0,Phase3-EA-SA2v2-EURCHF-M5-43,EURCHFMT4,8474,1h 29m,Buy
176001.61,112698,07.12.2018 06:15:00,,-1.08,-487.8599999998696,0.0,0.0,112546,06.12.2018 21:45:00,16573,-0.1830691471598736,-37.5,IS,0.27,0.0,Phase3-EA-S1v2-USDJPY-M15-0,USDJPYMT4,4682,8h 30m,Sell
176033.65,143942,07.12.2018 06:30:00,,0.0,-455.81999999989057,0.0,0.0,144099,07.12.2018 01:05:00,16574,-0.17104615803389467,32.04,IS,0.23,0.0,Phase3-EA-S4v1-GBPJPY-M5-194,GBPJPYMT4,3556,5h 25m,Sell
176002.26,1.12907,07.12.2018 08:50:00,,0.0,-487.20999999990454,0.0,0.0,1.12983,07.12.2018 00:30:00,16575,-0.18282523508336077,-31.39,IS,0.41,0.0,Phase3-EA-SA2v2-EURCHF-M5-43,EURCHFMT4,8476,8h 20m,Buy
176066.65,1.12834,07.12.2018 10:00:00,,0.0,-422.81999999989057,0.0,0.0,1.13022,07.12.2018 01:15:00,16576,-0.1586629295333465,64.39,IS,0.34,0.0,Phase3-EA-S4v1-EURCHF-M15-221,EURCHFMT4,4332,8h 45m,Sell
176008.0,128.53,07.12.2018 17:59:58,sl 128.530,-1.11,-481.46999999991385,0.0,0.0,128.85,26.11.2018 12:30:00,16577,-0.18067130382296587,-58.65,IS,0.09,0.0,Phase3-EA-TR1v1-EURJPY-M30-91,EURJPYMT4,2941,11d 5h 29m,Buy
175979.18,0.99017,10.12.2018 03:00:00,,-0.7,-510.28999999992084,0.0,0.0,0.99065,07.12.2018 22:45:00,16578,-0.1914859900467806,-28.82,IS,0.58,0.0,Phase3-EA-SA2v2-USDCHF-M15-107,USDCHFMT4,3292,2d 4h 15m,Buy
175936.35,1.12874,10.12.2018 04:20:00,,-0.99,-553.1199999999371,0.0,0.0,1.12975,07.12.2018 20:00:00,16579,-0.20755791964310427,-42.83,IS,0.41,0.0,Phase3-EA-SA2v2-EURCHF-M5-43,EURCHFMT4,8478,2d 8h 20m,Buy
175947.81,143238,10.12.2018 07:35:00,,0.0,-541.6599999999162,0.0,0.0,143182,10.12.2018 02:10:00,16580,-0.20325756210926965,11.46,IS,0.23,0.0,Phase3-EA-S4v1-GBPJPY-M5-194,GBPJPYMT4,3558,5h 25m,Buy
175993.56,1.12987,10.12.2018 11:30:00,,0.0,-495.9099999999162,0.0,0.0,1.12854,10.12.2018 02:45:00,16581,-0.18608990441532783,45.75,IS,0.34,0.0,Phase3-EA-S4v1-EURCHF-M15-221,EURCHFMT4,4334,8h 45m,Buy
176138.33,142304,10.12.2018 19:59:58,tp 142.304,-2.76,-351.13999999989755,0.0,0.0,144154,04.12.2018 09:00:00,16582,-0.1317650562327644,144.77,IS,0.09,0.0,Phase3-EA-B1v1-GBPJPY-M30-1,GBPJPYMT4,1498,6d 10h 59m,Sell
176102.13,1.12389,11.12.2018 04:30:00,,-0.99,-387.3399999999092,0.0,0.0,1.12474,10.12.2018 20:10:00,16583,-0.14534908264852164,-36.2,IS,0.41,0.0,Phase3-EA-SA2v2-EURCHF-M5-43,EURCHFMT4,8480,8h 20m,Buy
176180.05,141721,12.12.2018 00:34:57,tp 141.721,-1.18,-309.4199999999255,0.0,0.0,142111,11.12.2018 23:50:00,16584,-0.11610965341329396,77.92,IS,0.23,0.0,Phase3-EA-S4v1-GBPJPY-M5-194,GBPJPYMT4,3560,44m 57s,Sell
176146.59,1.12466,12.12.2018 06:10:00,,-2.06,-342.87999999994645,0.0,0.0,1.1239,11.12.2018 21:50:00,16585,-0.12866549661416068,-33.46,IS,0.41,0.0,Phase3-EA-SA2v2-EURCHF-M5-43,EURCHFMT4,8482,8h 20m,Sell
176202.34,141907,12.12.2018 06:20:00,,0.0,-287.12999999994645,0.0,0.0,141632,12.12.2018 00:55:00,16586,-0.10774534543520427,55.75,IS,0.23,0.0,Phase3-EA-S4v1-GBPJPY-M5-194,GBPJPYMT4,3562,5h 25m,Buy
176184.54,1.12524,12.12.2018 13:45:00,,0.0,-304.9299999999348,0.0,0.0,1.12472,12.12.2018 05:00:00,16587,-0.1144247838385259,-17.8,IS,0.34,0.0,Phase3-EA-S4v1-EURCHF-M15-221,EURCHFMT4,4336,8h 45m,Sell
176230.01,1.12855,12.12.2018 22:04:58,tp 1.12855,0.0,-259.45999999996275,0.0,0.0,1.12745,12.12.2018 20:25:00,16588,-0.09736219596217498,45.47,IS,0.41,0.0,Phase3-EA-SA2v2-EURCHF-M5-43,EURCHFMT4,8484,1h 39m,Buy
176307.03,143336,13.12.2018 00:59:58,tp 143.336,-2.19,-182.43999999994412,0.0,0.0,142946,12.12.2018 23:15:00,16589,-0.06846049114058549,77.02,IS,0.23,0.0,Phase3-EA-S4v1-GBPJPY-M5-194,GBPJPYMT4,3564,1h 44m,Buy
176264.95,1.12967,13.12.2018 06:30:00,,-6.19,-224.51999999996042,0.0,0.0,1.1288,12.12.2018 22:10:00,16590,-0.08425098372553307,-42.08,IS,0.41,0.0,Phase3-EA-SA2v2-EURCHF-M5-43,EURCHFMT4,8486,8h 20m,Sell
176239.29,1.12956,13.12.2018 10:00:00,,0.0,-250.1799999999348,0.0,0.0,1.12881,13.12.2018 01:15:00,16591,-0.09387988200807093,-25.66,IS,0.34,0.0,Phase3-EA-S4v1-EURCHF-M15-221,EURCHFMT4,4338,8h 45m,Sell
176318.26,143427,14.12.2018 04:44:58,tp 143.427,0.0,-171.20999999996275,0.0,0.0,143817,14.12.2018 00:10:00,16592,-0.06424644095692107,78.97,IS,0.23,0.0,Phase3-EA-S4v1-GBPJPY-M5-194,GBPJPYMT4,3566,4h 34m,Sell
176299.28,1.12885,14.12.2018 05:10:00,,-2.06,-190.18999999994412,0.0,0.0,1.12844,13.12.2018 20:50:00,16593,-0.07136867359147181,-18.98,IS,0.41,0.0,Phase3-EA-SA2v2-EURCHF-M5-43,EURCHFMT4,8488,8h 20m,Sell
176354.39,0.9967,17.12.2018 02:00:00,tp 0.99670,-3.08,-135.0799999999581,0.0,0.0,0.9977,14.12.2018 22:45:00,16594,-0.05068868199556156,55.11,IS,0.58,0.0,Phase3-EA-SA2v2-USDCHF-M15-107,USDCHFMT4,3294,2d 3h 15m,Sell
176397.68,1.12597,17.12.2018 02:04:59,tp 1.12597,-2.05,-91.78999999997905,0.0,0.0,1.12707,14.12.2018 22:20:00,16595,-0.034444137698941196,43.29,IS,0.41,0.0,Phase3-EA-SA2v2-EURCHF-M5-43,EURCHFMT4,8490,2d 3h 44m,Sell
176442.87,1.12784,17.12.2018 02:14:57,tp 1.12784,0.0,-46.59999999997672,0.0,0.0,1.12674,17.12.2018 02:10:00,16596,-0.017486619640159323,45.19,IS,0.41,0.0,Phase3-EA-SA2v2-EURCHF-M5-43,EURCHFMT4,8492,4m 57s,Buy
176363.45,1.1284,17.12.2018 10:45:00,,0.0,-126.01999999996042,0.0,0.0,1.12607,17.12.2018 02:00:00,16597,-0.047288922898139206,-79.42,IS,0.34,0.0,Phase3-EA-S4v1-EURCHF-M15-221,EURCHFMT4,4340,8h 45m,Sell
176358.49,1.1267,18.12.2018 04:25:00,,-2.07,-130.97999999998137,0.0,0.0,1.12663,17.12.2018 20:05:00,16598,-0.04915015966671431,-4.96,IS,0.41,0.0,Phase3-EA-SA2v2-EURCHF-M5-43,EURCHFMT4,8494,8h 20m,Sell
176389.63,112704,18.12.2018 04:45:00,,0.0,-99.8399999999674,0.0,0.0,112834,18.12.2018 01:15:00,16599,-0.037464894954373586,31.14,IS,0.27,0.0,Phase3-EA-S1v2-USDJPY-M15-0,USDJPYMT4,4684,3h 30m,Sell
176329.04,127825,18.12.2018 04:59:57,sl 127.825,-3.12,-160.42999999999302,0.0,0.0,127.81,05.12.2018 04:00:00,16600,-0.06020125298008669,-60.59,IS,0.09,0.0,Phase3-EA-TR1v1-EURJPY-M30-91,EURJPYMT4,2943,13d 0h 59m,Sell
176276.55,1.1285,18.12.2018 15:00:00,,0.0,-212.9199999999837,0.0,0.0,1.12697,18.12.2018 06:15:00,16601,-0.07989809128292485,-52.49,IS,0.34,0.0,Phase3-EA-S4v1-EURCHF-M15-221,EURCHFMT4,4342,8h 45m,Sell
176253.14,112.47,19.12.2018 02:45:00,,-1.08,-236.3299999999581,0.0,0.0,112377,18.12.2018 17:15:00,16602,-0.08868267853133444,-23.41,IS,0.27,0.0,Phase3-EA-S1v2-USDJPY-M15-0,USDJPYMT4,4686,9h 30m,Sell
176297.63,1.12906,19.12.2018 04:14:58,tp 1.12906,-0.99,-191.8399999999674,0.0,0.0,1.12796,18.12.2018 22:15:00,16603,-0.07198783501650796,44.49,IS,0.41,0.0,Phase3-EA-SA2v2-EURCHF-M5-43,EURCHFMT4,8496,5h 59m,Buy
176377.43,142514,19.12.2018 05:39:58,tp 142.514,0.0,-112.03999999997905,0.0,0.0,142124,19.12.2018 02:10:00,16604,-0.04204293700609577,79.8,IS,0.23,0.0,Phase3-EA-S4v1-GBPJPY-M5-194,GBPJPYMT4,3568,3h 29m,Buy
176310.33,1.13106,19.12.2018 14:00:00,,0.0,-179.13999999995576,0.0,0.0,1.1291,19.12.2018 05:15:00,16605,-0.06722216829053504,-67.1,IS,0.34,0.0,Phase3-EA-S4v1-EURCHF-M15-221,EURCHFMT4,4344,8h 45m,Sell
176352.73,1.13244,20.12.2018 03:29:57,tp 1.13244,-2.97,-136.73999999993248,0.0,0.0,1.13134,19.12.2018 23:40:00,16606,-0.051311595914064374,42.4,IS,0.41,0.0,Phase3-EA-SA2v2-EURCHF-M5-43,EURCHFMT4,8498,3h 49m,Buy
176374.73,111692,20.12.2018 17:30:00,,0.0,-114.73999999993248,0.0,0.0,111783,20.12.2018 17:00:00,16607,-0.043056110247032243,22.0,IS,0.27,0.0,Phase3-EA-S1v2-USDJPY-M15-0,USDJPYMT4,4688,30m 0s,Sell
176611.86,127391,20.12.2018 19:59:58,tp 127.391,-21.55,-0.0,0.0,0.0,129091,09.11.2018 20:00:00,16608,-0.0,237.13,IS,0.17,0.0,Phase3-EA-T1v2-EURJPY-M15-322,EURJPYMT4,3294,40d 23h 59m,Sell
176706.77,127303,20.12.2018 20:59:57,tp 127.303,-9.21,-0.0,0.0,0.0,128545,10.12.2018 11:00:00,16609,-0.0,94.91,IS,0.09,0.0,Phase3-EA-TR1v1-EURJPY-M30-91,EURJPYMT4,2945,10d 9h 59m,Buy
176853.8,140763,20.12.2018 21:59:57,tp 140.763,-2.77,-0.0,0.0,0.0,142613,14.12.2018 16:00:00,16610,-0.0,147.03,IS,0.09,0.0,Phase3-EA-B1v1-GBPJPY-M30-1,GBPJPYMT4,1500,6d 5h 59m,Sell
176899.39,1.13287,20.12.2018 22:14:57,tp 1.13287,0.0,-0.0,0.0,0.0,1.13397,20.12.2018 21:25:00,16611,-0.0,45.59,IS,0.41,0.0,Phase3-EA-SA2v2-EURCHF-M5-43,EURCHFMT4,8500,49m 57s,Sell
176958.25,0.98547,20.12.2018 23:44:58,tp 0.98547,0.0,-0.0,0.0,0.0,0.98447,20.12.2018 23:15:00,16612,-0.0,58.86,IS,0.58,0.0,Phase3-EA-SA2v2-USDCHF-M15-107,USDCHFMT4,3296,29m 58s,Buy
177017.03,0.98668,21.12.2018 02:44:58,tp 0.98668,0.0,-0.0,0.0,0.0,0.98768,21.12.2018 01:30:00,16613,-0.0,58.78,IS,0.58,0.0,Phase3-EA-SA2v2-USDCHF-M15-107,USDCHFMT4,3298,1h 14m,Sell
177053.1,140803,21.12.2018 04:35:00,,-0.75,-0.0,0.0,0.0,140625,20.12.2018 23:10:00,16614,-0.0,36.07,IS,0.23,0.0,Phase3-EA-S4v1-GBPJPY-M5-194,GBPJPYMT4,3570,5h 25m,Buy
177089.54,111147,21.12.2018 06:15:00,,0.0,-0.0,0.0,0.0,111297,21.12.2018 01:15:00,16615,-0.0,36.44,IS,0.27,0.0,Phase3-EA-S1v2-USDJPY-M15-0,USDJPYMT4,4690,5h 0m,Sell
176983.0,1.13,21.12.2018 06:45:00,,-1.0,-106.53999999997905,0.0,0.0,1.13254,20.12.2018 22:25:00,16616,-0.039889244633083895,-106.54,IS,0.41,0.0,Phase3-EA-SA2v2-EURCHF-M5-43,EURCHFMT4,8502,8h 20m,Buy
176994.37,1.13084,21.12.2018 11:30:00,,0.0,-95.1699999999837,0.0,0.0,1.13051,21.12.2018 02:45:00,16617,-0.035632245276240766,11.37,IS,0.34,0.0,Phase3-EA-S4v1-EURCHF-M15-221,EURCHFMT4,4346,8h 45m,Buy
177028.88,111087,21.12.2018 18:30:00,,0.0,-60.65999999997439,0.0,0.0,111229,21.12.2018 17:00:00,16618,-0.02271148469534751,34.51,IS,0.27,0.0,Phase3-EA-S1v2-USDJPY-M15-0,USDJPYMT4,4692,1h 30m,Sell
177130.3,126251,24.12.2018 02:29:57,tp 126.251,-0.56,-0.0,0.0,0.0,127511,20.12.2018 20:00:00,16619,-0.0,101.42,IS,0.09,0.0,Phase3-EA-TR1v1-EURJPY-M30-91,EURJPYMT4,2947,3d 6h 29m,Sell
177121.96,0.99351,24.12.2018 02:30:00,,-3.09,-8.340000000025611,0.0,0.0,0.99342,21.12.2018 22:15:00,16620,-0.0031220718877737067,-8.34,IS,0.58,0.0,Phase3-EA-SA2v2-USDCHF-M15-107,USDCHFMT4,3300,2d 4h 15m,Sell
177167.36,1.13079,24.12.2018 05:24:58,tp 1.13079,0.0,-0.0,0.0,0.0,1.12969,24.12.2018 02:35:00,16621,-0.0,45.4,IS,0.41,0.0,Phase3-EA-SA2v2-EURCHF-M5-43,EURCHFMT4,8504,2h 49m,Buy
177248.11,140731,24.12.2018 06:44:57,tp 140.731,0.0,-0.0,0.0,0.0,140341,24.12.2018 02:10:00,16622,-0.0,80.75,IS,0.23,0.0,Phase3-EA-S4v1-GBPJPY-M5-194,GBPJPYMT4,3572,4h 34m,Buy
177311.4,1.13154,24.12.2018 11:30:00,,0.0,-0.0,0.0,0.0,1.12969,24.12.2018 02:45:00,16623,-0.0,63.29,IS,0.34,0.0,Phase3-EA-S4v1-EURCHF-M15-221,EURCHFMT4,4348,8h 45m,Buy
177357.01,1.12904,24.12.2018 20:44:58,tp 1.12904,0.0,-0.0,0.0,0.0,1.12794,24.12.2018 20:30:00,16624,-0.0,45.61,IS,0.41,0.0,Phase3-EA-SA2v2-EURCHF-M5-43,EURCHFMT4,8506,14m 58s,Buy
177265.42,1.12524,26.12.2018 08:00:00,,-1.0,-91.59000000002561,0.0,0.0,1.12742,24.12.2018 21:45:00,16625,-0.03425756444539275,-91.59,IS,0.41,0.0,Phase3-EA-SA2v2-EURCHF-M5-43,EURCHFMT4,8508,1d 10h 15m,Buy
177310.81,1.12944,26.12.2018 21:44:58,tp 1.12944,0.0,-46.20000000001164,0.0,0.0,1.13054,26.12.2018 21:15:00,16626,-0.017280265065805232,45.39,IS,0.41,0.0,Phase3-EA-SA2v2-EURCHF-M5-43,EURCHFMT4,8510,29m 58s,Sell
177369.2,0.99324,26.12.2018 22:29:58,tp 0.99324,0.0,-0.0,0.0,0.0,0.99424,26.12.2018 22:15:00,16627,-0.0,58.39,IS,0.58,0.0,Phase3-EA-SA2v2-USDCHF-M15-107,USDCHFMT4,3302,14m 58s,Sell
177410.53,1.13011,27.12.2018 00:04:58,tp 1.13011,-3.96,-0.0,0.0,0.0,1.12901,26.12.2018 22:30:00,16628,-0.0,41.33,IS,0.41,0.0,Phase3-EA-SA2v2-EURCHF-M5-43,EURCHFMT4,8512,1h 34m,Buy
177455.83,1.12907,27.12.2018 02:04:58,tp 1.12907,0.0,-0.0,0.0,0.0,1.13017,27.12.2018 00:45:00,16629,-0.0,45.3,IS,0.41,0.0,Phase3-EA-SA2v2-EURCHF-M5-43,EURCHFMT4,8514,1h 19m,Sell
177485.85,140581,27.12.2018 05:30:00,,0.0,-0.0,0.0,0.0,140726,27.12.2018 00:05:00,16630,-0.0,30.02,IS,0.23,0.0,Phase3-EA-S4v1-GBPJPY-M5-194,GBPJPYMT4,3574,5h 25m,Sell
177508.79,1.12969,27.12.2018 10:15:00,,0.0,-0.0,0.0,0.0,1.13036,27.12.2018 01:30:00,16631,-0.0,22.94,IS,0.34,0.0,Phase3-EA-S4v1-EURCHF-M15-221,EURCHFMT4,4350,8h 45m,Sell
177544.88,110718,27.12.2018 18:00:00,,0.0,-0.0,0.0,0.0,110866,27.12.2018 17:15:00,16632,-0.0,36.09,IS,0.27,0.0,Phase3-EA-S1v2-USDJPY-M15-0,USDJPYMT4,4694,45m 0s,Sell
177485.11,126749,27.12.2018 23:59:58,sl 126.749,-1.13,-59.77000000001863,0.0,0.0,126323,24.12.2018 05:30:00,16633,-0.02234017709478062,-59.77,IS,0.09,0.0,Phase3-EA-TR1v1-EURJPY-M30-91,EURJPYMT4,2950,3d 18h 29m,Buy
177541.27,140065,28.12.2018 06:20:00,,0.0,-3.610000000044238,0.0,0.0,140335,28.12.2018 00:55:00,16634,-0.0013493063294816997,56.16,IS,0.23,0.0,Phase3-EA-S4v1-GBPJPY-M5-194,GBPJPYMT4,3576,5h 25m,Sell
177541.62,1.12877,28.12.2018 12:15:00,,0.0,-3.260000000067521,0.0,0.0,1.12876,28.12.2018 03:30:00,16635,-0.001218487156273558,0.35,IS,0.34,0.0,Phase3-EA-S4v1-EURCHF-M15-221,EURCHFMT4,4352,8h 45m,Buy
177553.36,110.35,28.12.2018 18:45:00,,0.0,-0.0,0.0,0.0,110398,28.12.2018 17:30:00,16636,-0.0,11.74,IS,0.27,0.0,Phase3-EA-S1v2-USDJPY-M15-0,USDJPYMT4,4696,1h 15m,Sell
177609.15,0.98461,31.12.2018 02:00:00,tp 0.98461,-3.12,-0.0,0.0,0.0,0.98561,28.12.2018 23:30:00,16637,-0.0,55.79,IS,0.58,0.0,Phase3-EA-SA2v2-USDCHF-M15-107,USDCHFMT4,3304,2d 2h 30m,Sell
177652.9,1.12505,31.12.2018 02:00:00,tp 1.12505,-2.08,-0.0,0.0,0.0,1.12615,28.12.2018 20:05:00,16638,-0.0,43.75,IS,0.41,0.0,Phase3-EA-SA2v2-EURCHF-M5-43,EURCHFMT4,8516,2d 5h 55m,Sell
177698.73,1.12586,31.12.2018 02:19:57,tp 1.12586,0.0,-0.0,0.0,0.0,1.12476,31.12.2018 02:15:00,16639,-0.0,45.83,IS,0.41,0.0,Phase3-EA-SA2v2-EURCHF-M5-43,EURCHFMT4,8518,4m 57s,Buy
177632.13,125543,31.12.2018 19:59:58,sl 125.543,-2.78,-66.59999999997672,0.0,0.0,126029,26.12.2018 07:30:00,16640,-0.024878713470167145,-66.6,IS,0.09,0.0,Phase3-EA-TR1v1-EURJPY-M30-91,EURJPYMT4,2951,5d 12h 29m,Sell
177890.8,125444,31.12.2018 19:59:58,tp 125.444,-4.29,-0.0,0.0,0.0,127144,21.12.2018 13:00:00,16641,-0.0,258.67,IS,0.17,0.0,Phase3-EA-T1v2-EURJPY-M15-322,EURJPYMT4,3296,10d 6h 59m,Sell
177950.81,109775,31.12.2018 20:00:00,,0.0,-0.0,0.0,0.0,110019,31.12.2018 18:00:00,16642,-0.0,60.01,IS,0.27,0.0,Phase3-EA-S1v2-USDJPY-M15-0,USDJPYMT4,4698,2h 0m,Sell
177971.8,0.98367,02.01.2019 08:00:00,,-1.42,-0.0,0.0,0.0,0.98329,31.12.2018 22:15:00,16643,-0.0,20.99,IS,0.58,0.0,Phase3-EA-SA2v2-USDCHF-M15-107,USDCHFMT4,3306,1d 9h 45m,Buy
177919.06,139312,02.01.2019 08:00:00,,-1.52,-52.73999999999069,0.0,0.0,139556,31.12.2018 23:40:00,16644,-0.019681175407259426,-52.74,IS,0.23,0.0,Phase3-EA-S4v1-GBPJPY-M5-194,GBPJPYMT4,3578,1d 8h 20m,Buy
177922.9,1.1258,02.01.2019 08:00:00,,-2.0,-48.899999999965075,0.0,0.0,1.12566,31.12.2018 21:50:00,16645,-0.0182481888019429,3.84,IS,0.41,0.0,Phase3-EA-SA2v2-EURCHF-M5-43,EURCHFMT4,8520,1d 10h 10m,Buy
178070.02,138892,02.01.2019 12:29:58,tp 138.892,-5.19,-0.0,0.0,0.0,140742,20.12.2018 23:00:00,16646,-0.0,147.12,IS,0.09,0.0,Phase3-EA-B1v1-GBPJPY-M30-1,GBPJPYMT4,1502,12d 13h 29m,Sell
178005.68,124692,02.01.2019 12:59:57,sl 124.692,0.0,-64.34000000002561,0.0,0.0,125472,02.01.2019 10:00:00,16647,-0.024001191927402125,-64.34,IS,0.09,0.0,Phase3-EA-TR1v1-EURJPY-M30-91,EURJPYMT4,2954,2h 59m,Buy
178051.17,1.12359,02.01.2019 23:14:57,tp 1.12359,0.0,-18.850000000034925,0.0,0.0,1.12249,02.01.2019 20:05:00,16648,-0.007031744915016914,45.49,IS,0.41,0.0,Phase3-EA-SA2v2-EURCHF-M5-43,EURCHFMT4,8522,3h 9m,Buy
178109.72,0.99055,02.01.2019 23:59:58,tp 0.99055,0.0,-0.0,0.0,0.0,0.99155,02.01.2019 23:15:00,16649,-0.0,58.55,IS,0.58,0.0,Phase3-EA-SA2v2-USDCHF-M15-107,USDCHFMT4,3308,44m 58s,Sell
178155.33,1.12274,03.01.2019 02:29:58,tp 1.12274,0.0,-0.0,0.0,0.0,1.12164,03.01.2019 02:25:00,16650,-0.0,45.61,IS,0.41,0.0,Phase3-EA-SA2v2-EURCHF-M5-43,EURCHFMT4,8524,4m 58s,Buy
177946.62,108492,03.01.2019 02:44:58,sl 108.492,-2.15,-208.71000000002095,0.0,0.0,109322,02.01.2019 23:45:00,16651,-0.07783175519950317,-208.71,IS,0.27,0.0,Phase3-EA-S1v2-USDJPY-M15-0,USDJPYMT4,4700,2h 59m,Buy
178031.02,132908,03.01.2019 02:54:57,tp 132.908,0.0,-124.30999999999767,0.0,0.0,132518,03.01.2019 02:45:00,16652,-0.04635746005868951,84.4,IS,0.23,0.0,Phase3-EA-S4v1-GBPJPY-M5-194,GBPJPYMT4,3580,9m 57s,Buy
178182.83,135708,03.01.2019 02:59:57,tp 135.708,-1.43,-0.0,0.0,0.0,137558,02.01.2019 20:30:00,16653,-0.0,151.81,IS,0.09,0.0,Phase3-EA-B1v1-GBPJPY-M30-1,GBPJPYMT4,1504,6h 29m,Sell
178287.19,122563,03.01.2019 02:59:58,tp 122.563,0.0,-0.0,0.0,0.0,123823,03.01.2019 00:30:00,16654,-0.0,104.36,IS,0.09,0.0,Phase3-EA-TR1v1-EURJPY-M30-91,EURJPYMT4,2956,2h 29m,Sell
178226.34,121545,03.01.2019 03:29:59,sl 121.545,0.0,-60.84999999997672,0.0,0.0,120825,03.01.2019 03:00:00,16655,-0.022680918906331837,-60.85,IS,0.09,0.0,Phase3-EA-TR1v1-EURJPY-M30-91,EURJPYMT4,2958,29m 59s,Sell
178321.11,1.12258,03.01.2019 12:30:00,,0.0,-0.0,0.0,0.0,1.11983,03.01.2019 03:45:00,16656,-0.0,94.77,IS,0.34,0.0,Phase3-EA-S4v1-EURCHF-M15-221,EURCHFMT4,4354,8h 45m,Buy
178260.99,122696,03.01.2019 12:59:57,sl 122.696,0.0,-60.11999999999534,0.0,0.0,121976,03.01.2019 03:30:00,16657,-0.022405989599549227,-60.12,IS,0.09,0.0,Phase3-EA-TR1v1-EURJPY-M30-91,EURJPYMT4,2960,9h 29m,Sell
178308.8,107862,03.01.2019 17:30:00,,0.0,-12.309999999997672,0.0,0.0,107671,03.01.2019 17:15:00,16658,-0.0045877866262544935,47.81,IS,0.27,0.0,Phase3-EA-S1v2-USDJPY-M15-0,USDJPYMT4,4702,15m 0s,Buy
178409.3,107462,03.01.2019 19:14:57,tp 107.462,0.0,-0.0,0.0,0.0,107862,03.01.2019 17:30:00,16659,-0.0,100.5,IS,0.27,0.0,Phase3-EA-S1v2-USDJPY-M15-0,USDJPYMT4,4704,1h 44m,Sell
178452.88,1.12582,04.01.2019 01:04:58,tp 1.12582,-2.07,-0.0,0.0,0.0,1.12692,03.01.2019 20:05:00,16660,-0.0,43.58,IS,0.41,0.0,Phase3-EA-SA2v2-EURCHF-M5-43,EURCHFMT4,8526,4h 59m,Sell
178536.13,136147,04.01.2019 03:14:58,tp 136.147,0.0,-0.0,0.0,0.0,135757,04.01.2019 00:20:00,16661,-0.0,83.25,IS,0.23,0.0,Phase3-EA-S4v1-GBPJPY-M5-194,GBPJPYMT4,3582,2h 54m,Buy
178619.41,135.85,04.01.2019 04:09:58,tp 135.850,0.0,-0.0,0.0,0.0,136.24,04.01.2019 03:20:00,16662,-0.0,83.28,IS,0.23,0.0,Phase3-EA-S4v1-GBPJPY-M5-194,GBPJPYMT4,3584,49m 58s,Sell
178583.18,122694,04.01.2019 04:14:58,sl 122.694,0.0,-36.22999999998137,0.0,0.0,122924,04.01.2019 03:15:00,16663,-0.01348748402060044,-36.23,IS,0.17,0.0,Phase3-EA-T1v2-EURJPY-M15-322,EURJPYMT4,3298,59m 58s,Buy
178543.78,0.98617,04.01.2019 06:00:00,,0.0,-75.63000000000466,0.0,0.0,0.98684,04.01.2019 01:45:00,16664,-0.028155076358779976,-39.4,IS,0.58,0.0,Phase3-EA-SA2v2-USDCHF-M15-107,USDCHFMT4,3310,4h 15m,Buy
178535.47,1.12431,04.01.2019 10:00:00,,0.0,-83.94000000000233,0.0,0.0,1.12451,04.01.2019 01:40:00,16665,-0.03124867261081464,-8.31,IS,0.41,0.0,Phase3-EA-SA2v2-EURCHF-M5-43,EURCHFMT4,8528,8h 20m,Buy
178559.59,1.1249,04.01.2019 11:45:00,,0.0,-59.820000000006985,0.0,0.0,1.1242,04.01.2019 03:00:00,16666,-0.02226942572765187,24.12,IS,0.34,0.0,Phase3-EA-S4v1-EURCHF-M15-221,EURCHFMT4,4356,8h 45m,Buy
178580.22,123102,04.01.2019 14:45:00,,0.0,-39.19000000000233,0.0,0.0,122971,04.01.2019 06:00:00,16667,-0.014589414815557119,20.63,IS,0.17,0.0,Phase3-EA-T1v2-EURJPY-M15-322,EURJPYMT4,3300,8h 45m,Buy
178515.57,123803,04.01.2019 22:29:58,sl 123.803,0.0,-103.84000000002561,0.0,0.0,123023,04.01.2019 12:00:00,16668,-0.038656923563351236,-64.65,IS,0.09,0.0,Phase3-EA-TR1v1-EURJPY-M30-91,EURJPYMT4,2962,10h 29m,Sell
178561.35,1124,07.01.2019 02:34:59,tp 1.12400,0.0,-58.05999999999767,0.0,0.0,1.1229,07.01.2019 02:15:00,16669,-0.02161422363335448,45.78,IS,0.41,0.0,Phase3-EA-SA2v2-EURCHF-M5-43,EURCHFMT4,8530,19m 59s,Buy
178468.05,108371,07.01.2019 03:15:00,,-1.12,-151.35999999998603,0.0,0.0,108001,04.01.2019 17:00:00,16670,-0.05634738010927253,-93.3,IS,0.27,0.0,Phase3-EA-S1v2-USDJPY-M15-0,USDJPYMT4,4706,2d 10h 15m,Sell
178550.97,137801,07.01.2019 07:19:58,tp 137.801,0.0,-68.44000000000233,0.0,0.0,138191,07.01.2019 03:35:00,16671,-0.025478426894021532,82.92,IS,0.23,0.0,Phase3-EA-S4v1-GBPJPY-M5-194,GBPJPYMT4,3586,3h 44m,Sell
178581.49,123585,07.01.2019 08:15:00,,-0.77,-37.9199999999837,0.0,0.0,123386,04.01.2019 19:45:00,16672,-0.014116626940690363,30.52,IS,0.17,0.0,Phase3-EA-T1v2-EURJPY-M15-322,EURJPYMT4,3302,2d 12h 30m,Buy
178612.95,1.12452,07.01.2019 12:15:00,,0.0,-6.459999999962747,0.0,0.0,1.12543,07.01.2019 03:30:00,16673,-0.002404889505178614,31.46,IS,0.34,0.0,Phase3-EA-S4v1-EURCHF-M15-221,EURCHFMT4,4358,8h 45m,Sell
178548.2,124381,07.01.2019 19:59:57,sl 124.381,0.0,-71.20999999996275,0.0,0.0,123601,07.01.2019 07:00:00,16674,-0.026509625644685307,-64.75,IS,0.09,0.0,Phase3-EA-TR1v1-EURJPY-M30-91,EURJPYMT4,2964,12h 59m,Sell
178525.1,0.97931,08.01.2019 04:30:00,,0.0,-94.30999999993946,0.0,0.0,0.9797,08.01.2019 00:15:00,16675,-0.03510915313228443,-23.1,IS,0.58,0.0,Phase3-EA-SA2v2-USDCHF-M15-107,USDCHFMT4,3312,4h 15m,Buy
178566.63,138563,08.01.2019 06:00:00,,0.0,-52.779999999911524,0.0,0.0,138759,08.01.2019 00:35:00,16676,-0.019648617350440628,41.53,IS,0.23,0.0,Phase3-EA-S4v1-GBPJPY-M5-194,GBPJPYMT4,3588,5h 25m,Sell
178645.37,124.34,08.01.2019 06:15:00,,-0.77,-0.0,0.0,0.0,123832,07.01.2019 13:15:00,16677,-0.0,78.74,IS,0.17,0.0,Phase3-EA-T1v2-EURJPY-M15-322,EURJPYMT4,3304,17h 0m,Buy
178592.32,1.12287,08.01.2019 08:55:00,,0.0,-53.04999999998836,0.0,0.0,1.12414,08.01.2019 00:35:00,16678,-0.019747222890901885,-53.05,IS,0.41,0.0,Phase3-EA-SA2v2-EURCHF-M5-43,EURCHFMT4,8532,8h 20m,Buy
178570.14,1.12261,08.01.2019 15:15:00,,0.0,-75.22999999998137,0.0,0.0,1.12325,08.01.2019 06:30:00,16679,-0.0280034604728088,-22.18,IS,0.34,0.0,Phase3-EA-S4v1-EURCHF-M15-221,EURCHFMT4,4360,8h 45m,Buy
178514.66,138538,08.01.2019 15:29:58,sl 138.538,0.0,-130.70999999996275,0.0,0.0,139208,08.01.2019 11:30:00,16680,-0.048655221565874006,-55.48,IS,0.09,0.0,Phase3-EA-B1v1-GBPJPY-M30-1,GBPJPYMT4,1506,3h 59m,Buy
178447.23,138598,09.01.2019 06:10:00,,0.0,-198.13999999995576,0.0,0.0,138279,09.01.2019 00:45:00,16681,-0.07375522608111752,-67.43,IS,0.23,0.0,Phase3-EA-S4v1-GBPJPY-M5-194,GBPJPYMT4,3590,5h 25m,Sell
178425.5,1.12375,09.01.2019 06:20:00,,-2.09,-219.86999999993714,0.0,0.0,1.12328,08.01.2019 22:00:00,16682,-0.08184395658854493,-21.73,IS,0.41,0.0,Phase3-EA-SA2v2-EURCHF-M5-43,EURCHFMT4,8534,8h 20m,Sell
178401.69,108854,09.01.2019 12:15:00,,0.0,-243.6799999999348,0.0,0.0,108758,09.01.2019 01:00:00,16683,-0.09070694201799698,-23.81,IS,0.27,0.0,Phase3-EA-S1v2-USDJPY-M15-0,USDJPYMT4,4708,11h 15m,Sell
178415.92,1.1232,09.01.2019 13:15:00,,0.0,-229.44999999995343,0.0,0.0,1.12361,09.01.2019 04:30:00,16684,-0.08540999608515575,14.23,IS,0.34,0.0,Phase3-EA-S4v1-EURCHF-M15-221,EURCHFMT4,4362,8h 45m,Sell
178470.39,108053,10.01.2019 00:45:00,,0.0,-174.97999999998137,0.0,0.0,108271,10.01.2019 00:15:00,16685,-0.06513419531480494,54.47,IS,0.27,0.0,Phase3-EA-S1v2-USDJPY-M15-0,USDJPYMT4,4710,30m 0s,Sell
178529.91,0.97452,10.01.2019 02:14:58,tp 0.97452,0.0,-115.45999999996275,0.0,0.0,0.97352,10.01.2019 01:15:00,16686,-0.04297859293088212,59.52,IS,0.58,0.0,Phase3-EA-SA2v2-USDCHF-M15-107,USDCHFMT4,3314,59m 58s,Buy
178532.02,1.12456,10.01.2019 04:35:00,,-6.31,-113.34999999997672,0.0,0.0,1.12476,09.01.2019 20:15:00,16687,-0.0421931708705704,2.11,IS,0.41,0.0,Phase3-EA-SA2v2-EURCHF-M5-43,EURCHFMT4,8536,8h 20m,Sell
178593.98,1.12572,10.01.2019 14:45:00,,0.0,-51.38999999995576,0.0,0.0,1.12394,10.01.2019 06:00:00,16688,-0.01912930790504801,61.96,IS,0.34,0.0,Phase3-EA-S4v1-EURCHF-M15-221,EURCHFMT4,4364,8h 45m,Buy
178617.19,108181,10.01.2019 19:45:00,,0.0,-28.179999999934807,0.0,0.0,108088,10.01.2019 18:30:00,16689,-0.01048966524155419,23.21,IS,0.27,0.0,Phase3-EA-S1v2-USDJPY-M15-0,USDJPYMT4,4712,1h 15m,Buy
178581.13,124749,10.01.2019 23:59:57,sl 124.749,0.0,-64.23999999993248,0.0,0.0,124519,10.01.2019 22:45:00,16690,-0.023912565476163657,-36.06,IS,0.17,0.0,Phase3-EA-T1v2-EURJPY-M15-322,EURJPYMT4,3306,1h 14m,Sell
178462.35,1.13261,11.01.2019 04:30:00,,-2.08,-183.01999999996042,0.0,0.0,1.12981,10.01.2019 20:10:00,16691,-0.06812698837875351,-118.78,IS,0.41,0.0,Phase3-EA-SA2v2-EURCHF-M5-43,EURCHFMT4,8538,8h 20m,Sell
178467.54,1.13218,11.01.2019 13:45:00,,0.0,-177.8299999999581,0.0,0.0,1.13233,11.01.2019 05:00:00,16692,-0.06619507345313902,5.19,IS,0.34,0.0,Phase3-EA-S4v1-EURCHF-M15-221,EURCHFMT4,4366,8h 45m,Sell
178497.45,0.98332,14.01.2019 03:00:00,,-3.12,-147.9199999999837,0.0,0.0,0.98388,11.01.2019 22:45:00,16693,-0.055061436569698884,29.91,IS,0.58,0.0,Phase3-EA-SA2v2-USDCHF-M15-107,USDCHFMT4,3316,2d 4h 15m,Sell
178489.78,1.12784,14.01.2019 04:25:00,,-1.0,-155.5899999999674,0.0,0.0,1128,11.01.2019 20:05:00,16694,-0.05791650159463628,-7.67,IS,0.41,0.0,Phase3-EA-SA2v2-EURCHF-M5-43,EURCHFMT4,8540,2d 8h 20m,Buy
178427.05,123953,14.01.2019 07:29:58,sl 123.953,-2.86,-218.31999999994878,0.0,0.0,124673,07.01.2019 22:30:00,16695,-0.08126698777646812,-62.73,IS,0.09,0.0,Phase3-EA-TR1v1-EURJPY-M30-91,EURJPYMT4,2966,6d 8h 59m,Buy
178687.4,1.28713,14.01.2019 15:59:58,tp 1.28713,-4.25,-0.0,0.0,0.0,1.26823,04.01.2019 19:30:00,16696,-0.0,260.35,IS,0.14,0.0,Phase3-EA-B1v1-GBPUSD-M30-14,GBPUSDMT4,1090,9d 20h 29m,Buy
178731.29,1.12463,15.01.2019 02:04:58,tp 1.12463,-2.09,-0.0,0.0,0.0,1.12573,14.01.2019 22:45:00,16697,-0.0,43.89,IS,0.41,0.0,Phase3-EA-SA2v2-EURCHF-M5-43,EURCHFMT4,8542,3h 19m,Sell
178777.26,1.12576,15.01.2019 04:29:57,tp 1.12576,0.0,-0.0,0.0,0.0,1.12466,15.01.2019 02:05:00,16698,-0.0,45.97,IS,0.41,0.0,Phase3-EA-SA2v2-EURCHF-M5-43,EURCHFMT4,8544,2h 24m,Buy
178859.28,139.56,15.01.2019 04:29:59,tp 139.560,-0.77,-0.0,0.0,0.0,139.17,14.01.2019 23:10:00,16699,-0.0,82.02,IS,0.23,0.0,Phase3-EA-S4v1-GBPJPY-M5-194,GBPJPYMT4,3592,5h 19m,Buy
178840.96,124119,15.01.2019 14:00:00,,0.0,-18.320000000006985,0.0,0.0,124236,15.01.2019 04:15:00,16700,-0.006813973465973308,-18.32,IS,0.17,0.0,Phase3-EA-T1v2-EURJPY-M15-322,EURJPYMT4,3308,9h 45m,Buy
178820.94,1.12641,15.01.2019 14:15:00,,0.0,-38.34000000002561,0.0,0.0,1.12583,15.01.2019 05:30:00,16701,-0.014260247963181852,-20.02,IS,0.34,0.0,Phase3-EA-S4v1-EURCHF-M15-221,EURCHFMT4,4368,8h 45m,Sell
178761.24,123916,15.01.2019 15:59:58,sl 123.916,0.0,-98.04000000003725,0.0,0.0,124068,14.01.2019 12:30:00,16702,-0.03646517241288331,-59.7,IS,0.09,0.0,Phase3-EA-TR1v1-EURJPY-M30-91,EURJPYMT4,2968,1d 3h 29m,Buy
178805.9,1.12736,16.01.2019 00:19:58,tp 1.12736,-1.0,-53.380000000062864,0.0,0.0,1.12626,15.01.2019 20:20:00,16703,-0.019854252380673846,44.66,IS,0.41,0.0,Phase3-EA-SA2v2-EURCHF-M5-43,EURCHFMT4,8546,3h 59m,Buy
178763.9,1.28529,16.01.2019 04:29:58,sl 1.28529,0.0,-95.38000000006286,0.0,0.0,1.28829,16.01.2019 01:00:00,16704,-0.035475807269908004,-42.0,IS,0.14,0.0,Phase3-EA-B1v1-GBPUSD-M30-14,GBPUSDMT4,1092,3h 29m,Buy
178788.56,0.9879,16.01.2019 05:30:00,,0.0,-70.72000000008848,0.0,0.0,0.98748,16.01.2019 01:15:00,16705,-0.026303722899238616,24.66,IS,0.58,0.0,Phase3-EA-SA2v2-USDCHF-M15-107,USDCHFMT4,3318,4h 15m,Buy
178834.2,1.12605,16.01.2019 05:59:58,tp 1.12605,0.0,-25.080000000074506,0.0,0.0,1.12715,16.01.2019 00:25:00,16706,-0.009328299919598968,45.64,IS,0.41,0.0,Phase3-EA-SA2v2-EURCHF-M5-43,EURCHFMT4,8548,5h 34m,Sell
178798.21,123956,16.01.2019 12:29:58,sl 123.956,0.0,-61.07000000006519,0.0,0.0,123726,16.01.2019 05:15:00,16707,-0.02271448469253687,-35.99,IS,0.17,0.0,Phase3-EA-T1v2-EURJPY-M15-322,EURJPYMT4,3310,7h 14m,Sell
178813.0,1.1267,16.01.2019 15:00:00,,0.0,-46.28000000008615,0.0,0.0,1.12627,16.01.2019 06:15:00,16708,-0.017213465720835777,14.79,IS,0.34,0.0,Phase3-EA-S4v1-EURCHF-M15-221,EURCHFMT4,4370,8h 45m,Buy
178846.24,108841,16.01.2019 20:45:00,,0.0,-13.04000000009546,0.0,0.0,108707,16.01.2019 19:45:00,16709,-0.004850120851359636,33.24,IS,0.27,0.0,Phase3-EA-S1v2-USDJPY-M15-0,USDJPYMT4,4714,1h 0m,Buy
178891.78,1.12926,16.01.2019 23:49:57,tp 1.12926,0.0,-0.0,0.0,0.0,1.12816,16.01.2019 21:40:00,16710,-0.0,45.54,IS,0.41,0.0,Phase3-EA-SA2v2-EURCHF-M5-43,EURCHFMT4,8550,2h 9m,Buy
178931.11,1128,17.01.2019 01:59:58,tp 1.12800,-6.21,-0.0,0.0,0.0,1.1291,16.01.2019 23:55:00,16711,-0.0,39.33,IS,0.41,0.0,Phase3-EA-SA2v2-EURCHF-M5-43,EURCHFMT4,8552,2h 4m,Sell
178911.2,0.99023,17.01.2019 04:30:00,,0.0,-19.90999999997439,0.0,0.0,0.98989,17.01.2019 00:15:00,16712,-0.007403382970447072,-19.91,IS,0.58,0.0,Phase3-EA-SA2v2-USDCHF-M15-107,USDCHFMT4,3320,4h 15m,Sell
178903.31,140.3,17.01.2019 05:15:00,,-3.67,-27.79999999998836,0.0,0.0,140.28,16.01.2019 23:50:00,16713,-0.010337219818111861,-7.89,IS,0.23,0.0,Phase3-EA-S4v1-GBPJPY-M5-194,GBPJPYMT4,3594,5h 25m,Sell
178919.86,1.12863,17.01.2019 10:20:00,,0.0,-11.25,0.0,0.0,1.12823,17.01.2019 02:00:00,16714,-0.004183227444381552,16.55,IS,0.41,0.0,Phase3-EA-SA2v2-EURCHF-M5-43,EURCHFMT4,8554,8h 20m,Buy
178883.97,124176,17.01.2019 19:29:57,sl 124.176,0.0,-47.14000000001397,0.0,0.0,123946,17.01.2019 17:45:00,16715,-0.017528652598062647,-35.89,IS,0.17,0.0,Phase3-EA-T1v2-EURJPY-M15-322,EURJPYMT4,3312,1h 44m,Sell
178929.34,1.13235,17.01.2019 23:49:58,tp 1.13235,0.0,-1.7700000000186265,0.0,0.0,1.13125,17.01.2019 23:10:00,16716,-6.581611179229569E-4,45.37,IS,0.41,0.0,Phase3-EA-SA2v2-EURCHF-M5-43,EURCHFMT4,8556,39m 58s,Buy
178869.87,124633,17.01.2019 23:59:58,sl 124.633,0.0,-61.23999999999069,0.0,0.0,124636,15.01.2019 07:30:00,16717,-0.022771630995012202,-59.47,IS,0.09,0.0,Phase3-EA-TR1v1-EURJPY-M30-91,EURJPYMT4,2969,2d 16h 29m,Buy
178950.85,141618,18.01.2019 00:19:58,tp 141.618,-1.22,-0.0,0.0,0.0,142008,17.01.2019 23:55:00,16718,-0.0,80.98,IS,0.23,0.0,Phase3-EA-S4v1-GBPJPY-M5-194,GBPJPYMT4,3596,24m 58s,Sell
179019.4,141982,18.01.2019 08:45:00,,0.0,-0.0,0.0,0.0,141656,18.01.2019 03:20:00,16719,-0.0,68.55,IS,0.23,0.0,Phase3-EA-S4v1-GBPJPY-M5-194,GBPJPYMT4,3598,5h 25m,Buy
178964.35,141326,18.01.2019 18:59:58,sl 141.326,0.0,-55.04999999998836,0.0,0.0,141996,18.01.2019 06:00:00,16720,-0.02046320822958793,-55.05,IS,0.09,0.0,Phase3-EA-B1v1-GBPJPY-M30-1,GBPJPYMT4,1508,12h 59m,Buy
179007.59,1.13009,21.01.2019 02:00:00,tp 1.13009,-2.06,-11.809999999997672,0.0,0.0,1.13119,18.01.2019 23:20:00,16721,-0.004390017968963432,43.24,IS,0.41,0.0,Phase3-EA-SA2v2-EURCHF-M5-43,EURCHFMT4,8558,2d 2h 40m,Sell
178973.71,141096,21.01.2019 04:50:00,,-0.75,-45.69000000000233,0.0,0.0,141254,18.01.2019 23:25:00,16722,-0.01698390524995673,-33.88,IS,0.23,0.0,Phase3-EA-S4v1-GBPJPY-M5-194,GBPJPYMT4,3600,2d 5h 25m,Buy
178943.75,124537,21.01.2019 05:15:00,,0.0,-75.65000000002328,0.0,0.0,124.73,21.01.2019 02:45:00,16723,-0.028120648548031438,-29.96,IS,0.17,0.0,Phase3-EA-T1v2-EURJPY-M15-322,EURJPYMT4,3314,2h 30m,Buy
178927.92,124664,21.01.2019 11:00:00,,0.0,-91.48000000003958,0.0,0.0,124766,21.01.2019 07:15:00,16724,-0.03400498254030717,-15.83,IS,0.17,0.0,Phase3-EA-T1v2-EURJPY-M15-322,EURJPYMT4,3316,3h 45m,Buy
179003.1,1.13258,21.01.2019 11:30:00,,0.0,-16.300000000046566,0.0,0.0,1.13038,21.01.2019 02:45:00,16725,-0.0060590425820764154,75.18,IS,0.34,0.0,Phase3-EA-S4v1-EURCHF-M15-221,EURCHFMT4,4372,8h 45m,Buy
178994.02,109622,21.01.2019 13:00:00,,-0.71,-25.380000000062864,0.0,0.0,109656,18.01.2019 23:45:00,16726,-0.009434263848652823,-9.08,IS,0.27,0.0,Phase3-EA-S1v2-USDJPY-M15-0,USDJPYMT4,4716,2d 13h 15m,Buy
178949.36,1.28303,21.01.2019 13:59:58,sl 1.28303,-2.66,-70.04000000003725,0.0,0.0,1.28603,16.01.2019 11:30:00,16727,-0.026035297082677638,-44.66,IS,0.14,0.0,Phase3-EA-B1v1-GBPUSD-M30-14,GBPUSDMT4,1094,5d 2h 29m,Buy
178912.93,124517,22.01.2019 02:14:58,sl 124.517,-0.76,-106.47000000003027,0.0,0.0,124747,21.01.2019 12:00:00,16728,-0.03957707139337524,-36.43,IS,0.17,0.0,Phase3-EA-T1v2-EURJPY-M15-322,EURJPYMT4,3318,14h 14m,Buy
178928.67,141.27,22.01.2019 06:00:00,,0.0,-90.73000000003958,0.0,0.0,141345,22.01.2019 00:35:00,16729,-0.033726192237451685,15.74,IS,0.23,0.0,Phase3-EA-S4v1-GBPJPY-M5-194,GBPJPYMT4,3602,5h 25m,Sell
178901.14,1.13301,22.01.2019 10:20:00,,0.0,-118.26000000006752,0.0,0.0,1.13368,22.01.2019 02:00:00,16730,-0.04395965495427724,-27.53,IS,0.41,0.0,Phase3-EA-SA2v2-EURCHF-M5-43,EURCHFMT4,8560,8h 20m,Buy
178961.87,1.1323,22.01.2019 15:00:00,,0.0,-57.53000000008615,0.0,0.0,1.13408,22.01.2019 06:15:00,16731,-0.0213850748310664,60.73,IS,0.34,0.0,Phase3-EA-S4v1-EURCHF-M15-221,EURCHFMT4,4374,8h 45m,Sell
178906.21,141607,22.01.2019 19:29:58,sl 141.607,-0.48,-113.19000000006054,0.0,0.0,140937,21.01.2019 04:00:00,16732,-0.042075032506971595,-55.66,IS,0.09,0.0,Phase3-EA-B1v1-GBPJPY-M30-1,GBPJPYMT4,1510,1d 15h 29m,Sell
178964.42,0.99636,23.01.2019 02:29:58,tp 0.99636,0.0,-54.98000000003958,0.0,0.0,0.99736,23.01.2019 01:15:00,16733,-0.02043718780134046,58.21,IS,0.58,0.0,Phase3-EA-SA2v2-USDCHF-M15-107,USDCHFMT4,3322,1h 14m,Sell
178998.95,1.13353,23.01.2019 08:35:00,,0.0,-20.45000000001164,0.0,0.0,1.13269,23.01.2019 00:15:00,16734,-0.007601682257863758,34.53,IS,0.41,0.0,Phase3-EA-SA2v2-EURCHF-M5-43,EURCHFMT4,8562,8h 20m,Buy
178982.25,1.13376,23.01.2019 13:30:00,,0.0,-37.15000000002328,0.0,0.0,1.13327,23.01.2019 04:45:00,16735,-0.013809413001450114,-16.7,IS,0.34,0.0,Phase3-EA-S4v1-EURCHF-M15-221,EURCHFMT4,4376,8h 45m,Sell
178946.1,124866,23.01.2019 18:14:58,sl 124.866,-0.54,-73.30000000004657,0.0,0.0,124636,22.01.2019 05:45:00,16736,-0.027247105599092922,-36.15,IS,0.17,0.0,Phase3-EA-T1v2-EURJPY-M15-322,EURJPYMT4,3320,1d 12h 29m,Sell
178969.28,109498,24.01.2019 04:00:00,,0.0,-50.12000000005355,0.0,0.0,109592,24.01.2019 00:45:00,16737,-0.01863062663884214,23.18,IS,0.27,0.0,Phase3-EA-S1v2-USDJPY-M15-0,USDJPYMT4,4718,3h 15m,Sell
178992.61,0.9944,24.01.2019 06:15:00,,0.0,-26.790000000037253,0.0,0.0,0.9948,24.01.2019 02:00:00,16738,-0.009958389618011605,23.33,IS,0.58,0.0,Phase3-EA-SA2v2-USDCHF-M15-107,USDCHFMT4,3324,4h 15m,Sell
178952.52,1.13184,24.01.2019 06:55:00,,-2.97,-66.88000000006286,0.0,0.0,1.13274,23.01.2019 22:35:00,16739,-0.02486066060665607,-40.09,IS,0.41,0.0,Phase3-EA-SA2v2-EURCHF-M5-43,EURCHFMT4,8564,8h 20m,Buy
178916.28,1.1309,24.01.2019 11:45:00,,0.0,-103.12000000005355,0.0,0.0,1.13196,24.01.2019 03:00:00,16740,-0.03833180804062942,-36.24,IS,0.34,0.0,Phase3-EA-S4v1-EURCHF-M15-221,EURCHFMT4,4378,8h 45m,Buy
178880.64,124487,24.01.2019 12:29:58,sl 124.487,0.0,-138.76000000006752,0.0,0.0,124717,24.01.2019 08:45:00,16741,-0.05157992323232703,-35.64,IS,0.17,0.0,Phase3-EA-T1v2-EURJPY-M15-322,EURJPYMT4,3322,3h 44m,Buy
178805.13,1.12621,25.01.2019 05:25:00,,-0.99,-214.27000000007683,0.0,0.0,1.12802,24.01.2019 21:05:00,16742,-0.07964853092382025,-75.51,IS,0.41,0.0,Phase3-EA-SA2v2-EURCHF-M5-43,EURCHFMT4,8566,8h 20m,Buy
178771.92,0.99562,25.01.2019 05:45:00,,0.0,-247.4800000000978,0.0,0.0,0.99619,25.01.2019 01:30:00,16743,-0.09199336553426872,-33.21,IS,0.58,0.0,Phase3-EA-SA2v2-USDCHF-M15-107,USDCHFMT4,3326,4h 15m,Buy
178638.64,143804,25.01.2019 05:50:00,,0.0,-380.76000000012573,0.0,0.0,143168,25.01.2019 00:25:00,16744,-0.141536260953717,-133.28,IS,0.23,0.0,Phase3-EA-S4v1-GBPJPY-M5-194,GBPJPYMT4,3604,5h 25m,Sell
178602.53,124743,25.01.2019 17:29:58,sl 124.743,-0.54,-416.87000000011176,0.0,0.0,124513,24.01.2019 12:30:00,16745,-0.15495908473519365,-36.11,IS,0.17,0.0,Phase3-EA-T1v2-EURJPY-M15-322,EURJPYMT4,3324,1d 4h 59m,Sell
178542.01,125001,25.01.2019 19:29:58,sl 125.001,-1.44,-477.3900000001304,0.0,0.0,123913,17.01.2019 11:00:00,16746,-0.1774556035736188,-60.52,IS,0.09,0.0,Phase3-EA-TR1v1-EURJPY-M30-91,EURJPYMT4,2971,8d 8h 29m,Sell
178528.8,1.13333,28.01.2019 07:45:00,,-2.06,-490.60000000015134,0.0,0.0,1.13306,25.01.2019 23:25:00,16747,-0.18236603010792113,-13.21,IS,0.41,0.0,Phase3-EA-SA2v2-EURCHF-M5-43,EURCHFMT4,8568,2d 8h 20m,Sell
178502.73,144.37,28.01.2019 09:20:00,,0.0,-516.6700000001583,0.0,0.0,144494,28.01.2019 03:55:00,16748,-0.19205678103518023,-26.07,IS,0.23,0.0,Phase3-EA-S4v1-GBPJPY-M5-194,GBPJPYMT4,3606,5h 25m,Buy
178468.45,1.13154,28.01.2019 14:00:00,,0.0,-550.9500000001863,0.0,0.0,1.13254,28.01.2019 05:15:00,16749,-0.20479935647770509,-34.28,IS,0.34,0.0,Phase3-EA-S4v1-EURCHF-M15-221,EURCHFMT4,4380,8h 45m,Buy
178475.25,109254,29.01.2019 04:00:00,,-1.11,-544.1500000001979,0.0,0.0,109286,28.01.2019 23:00:00,16750,-0.20227165773181974,6.8,IS,0.27,0.0,Phase3-EA-S1v2-USDJPY-M15-0,USDJPYMT4,4720,5h 0m,Sell
178479.79,1.13356,29.01.2019 05:00:00,,-2.07,-539.6100000002189,0.0,0.0,1.13372,28.01.2019 20:40:00,16751,-0.20058404709854236,4.54,IS,0.41,0.0,Phase3-EA-SA2v2-EURCHF-M5-43,EURCHFMT4,8570,8h 20m,Sell
178449.05,143598,29.01.2019 07:50:00,,0.0,-570.3500000002095,0.0,0.0,143744,29.01.2019 02:25:00,16752,-0.21201073231157552,-30.74,IS,0.23,0.0,Phase3-EA-S4v1-GBPJPY-M5-194,GBPJPYMT4,3608,5h 25m,Buy
178408.24,1.13479,29.01.2019 12:30:00,,0.0,-611.1600000002072,0.0,0.0,1.1336,29.01.2019 03:45:00,16753,-0.22718064199095084,-40.81,IS,0.34,0.0,Phase3-EA-S4v1-EURCHF-M15-221,EURCHFMT4,4382,8h 45m,Sell
178404.8,109372,30.01.2019 01:45:00,,-0.72,-614.6000000002095,0.0,0.0,109383,29.01.2019 18:30:00,16754,-0.22845936018004884,-3.44,IS,0.27,0.0,Phase3-EA-S1v2-USDJPY-M15-0,USDJPYMT4,4722,7h 15m,Buy
178403.15,1.13737,30.01.2019 05:00:00,,-2.06,-616.2500000002328,0.0,0.0,1.13738,29.01.2019 20:40:00,16755,-0.22907269884633957,-1.65,IS,0.41,0.0,Phase3-EA-SA2v2-EURCHF-M5-43,EURCHFMT4,8572,8h 20m,Sell
178375.99,142965,30.01.2019 05:40:00,,0.0,-643.4100000002072,0.0,0.0,143094,30.01.2019 00:15:00,16756,-0.2391686250137365,-27.16,IS,0.23,0.0,Phase3-EA-S4v1-GBPJPY-M5-194,GBPJPYMT4,3610,5h 25m,Buy
178356.08,124951,30.01.2019 12:00:00,,0.0,-663.3200000001816,0.0,0.0,125079,30.01.2019 07:30:00,16757,-0.24656957825353046,-19.91,IS,0.17,0.0,Phase3-EA-T1v2-EURJPY-M15-322,EURJPYMT4,3326,4h 30m,Buy
178307.65,1.13945,30.01.2019 15:30:00,,0.0,-711.7500000001746,0.0,0.0,1.13803,30.01.2019 06:45:00,16758,-0.26457199740991577,-48.43,IS,0.34,0.0,Phase3-EA-S4v1-EURCHF-M15-221,EURCHFMT4,4384,8h 45m,Sell
178407.2,125358,30.01.2019 23:29:58,tp 125.358,-6.44,-612.2000000001863,0.0,0.0,124281,22.01.2019 10:00:00,16759,-0.22756723121090267,99.55,IS,0.09,0.0,Phase3-EA-TR1v1-EURJPY-M30-91,EURJPYMT4,2973,8d 13h 29m,Sell
178384.09,1.14093,31.01.2019 05:00:00,,-6.18,-635.3100000001723,0.0,0.0,1.14052,30.01.2019 20:40:00,16760,-0.23615768974288434,-23.11,IS,0.41,0.0,Phase3-EA-SA2v2-EURCHF-M5-43,EURCHFMT4,8574,8h 20m,Sell
178326.51,142653,31.01.2019 12:59:58,sl 142.653,-2.09,-692.8900000001886,0.0,0.0,143323,24.01.2019 04:30:00,16761,-0.2575613505941151,-57.58,IS,0.09,0.0,Phase3-EA-B1v1-GBPJPY-M30-1,GBPJPYMT4,1512,7d 8h 29m,Buy
178271.03,143063,31.01.2019 19:59:58,sl 143.063,0.0,-748.37000000017,0.0,0.0,142393,31.01.2019 14:00:00,16762,-0.2781843985973376,-55.48,IS,0.09,0.0,Phase3-EA-B1v1-GBPJPY-M30-1,GBPJPYMT4,1514,5h 59m,Sell
178316.5,1.13927,31.01.2019 20:04:57,tp 1.13927,0.0,-702.9000000001979,0.0,0.0,1.13817,31.01.2019 20:00:00,16763,-0.26128227183622976,45.47,IS,0.41,0.0,Phase3-EA-SA2v2-EURCHF-M5-43,EURCHFMT4,8576,4m 57s,Buy
178336.08,108913,01.02.2019 01:00:00,,0.0,-683.3200000001816,0.0,0.0,108834,01.02.2019 00:30:00,16764,-0.25400398632967663,19.58,IS,0.27,0.0,Phase3-EA-S1v2-USDJPY-M15-0,USDJPYMT4,4724,30m 0s,Buy
178380.43,1.13855,01.02.2019 01:29:59,tp 1.13855,-0.99,-638.9700000002049,0.0,0.0,1.13745,31.01.2019 21:25:00,16765,-0.2375181864208312,44.35,IS,0.41,0.0,Phase3-EA-SA2v2-EURCHF-M5-43,EURCHFMT4,8578,4h 4m,Buy
178336.3,1.30803,01.02.2019 06:29:58,sl 1.30803,-2.13,-683.1000000002095,0.0,0.0,1.31103,30.01.2019 23:30:00,16766,-0.2539222078408494,-44.13,IS,0.14,0.0,Phase3-EA-B1v1-GBPUSD-M30-14,GBPUSDMT4,1096,1d 6h 59m,Buy
178337.14,142643,01.02.2019 07:40:00,,0.0,-682.2600000001839,0.0,0.0,142639,01.02.2019 02:15:00,16767,-0.2536099627016417,0.84,IS,0.23,0.0,Phase3-EA-S4v1-GBPJPY-M5-194,GBPJPYMT4,3612,5h 25m,Buy
178347.85,1.13818,01.02.2019 09:55:00,,0.0,-671.550000000163,0.0,0.0,1.13844,01.02.2019 01:35:00,16768,-0.2496288371768577,10.71,IS,0.41,0.0,Phase3-EA-SA2v2-EURCHF-M5-43,EURCHFMT4,8580,8h 20m,Sell
178311.96,124771,01.02.2019 13:29:58,sl 124.771,0.0,-707.440000000177,0.0,0.0,124541,01.02.2019 08:45:00,16769,-0.26296988246950714,-35.89,IS,0.17,0.0,Phase3-EA-T1v2-EURJPY-M15-322,EURJPYMT4,3328,4h 44m,Sell
178357.25,1.14115,04.02.2019 06:24:57,tp 1.14115,0.0,-662.1500000001979,0.0,0.0,1.14005,04.02.2019 02:05:00,16770,-0.24613466538108197,45.29,IS,0.41,0.0,Phase3-EA-SA2v2-EURCHF-M5-43,EURCHFMT4,8582,4h 19m,Buy
178312.95,1.14205,04.02.2019 15:00:00,,0.0,-706.4500000001863,0.0,0.0,1.14075,04.02.2019 06:15:00,16771,-0.2626018792697414,-44.3,IS,0.34,0.0,Phase3-EA-S4v1-EURCHF-M15-221,EURCHFMT4,4386,8h 45m,Sell
178340.79,125667,04.02.2019 22:15:00,,0.0,-678.6100000001607,0.0,0.0,125487,04.02.2019 08:00:00,16772,-0.2522531832277364,27.84,IS,0.17,0.0,Phase3-EA-T1v2-EURJPY-M15-322,EURJPYMT4,3330,14h 15m,Buy
178347.01,0.99791,05.02.2019 03:15:00,,-3.08,-672.3900000001886,0.0,0.0,0.99807,04.02.2019 23:00:00,16773,-0.24994108231606535,6.22,IS,0.58,0.0,Phase3-EA-SA2v2-USDCHF-M15-107,USDCHFMT4,3328,4h 15m,Sell
178391.21,1.14138,05.02.2019 04:24:57,tp 1.14138,-0.99,-628.190000000177,0.0,0.0,1.14028,04.02.2019 20:15:00,16774,-0.23351104046777804,44.2,IS,0.41,0.0,Phase3-EA-SA2v2-EURCHF-M5-43,EURCHFMT4,8584,8h 9m,Buy
178427.6,143385,05.02.2019 07:40:00,,0.0,-591.800000000163,0.0,0.0,143211,05.02.2019 02:15:00,16775,-0.21998413497322494,36.39,IS,0.23,0.0,Phase3-EA-S4v1-GBPJPY-M5-194,GBPJPYMT4,3614,5h 25m,Buy
178409.58,1.1418,05.02.2019 13:30:00,,0.0,-609.8200000001816,0.0,0.0,1.14127,05.02.2019 04:45:00,16776,-0.22668253664983953,-18.02,IS,0.34,0.0,Phase3-EA-S4v1-EURCHF-M15-221,EURCHFMT4,4388,8h 45m,Sell
178380.31,1.14057,06.02.2019 04:25:00,,-0.98,-639.0900000002002,0.0,0.0,1.14126,05.02.2019 20:05:00,16777,-0.23756279286928633,-29.27,IS,0.41,0.0,Phase3-EA-SA2v2-EURCHF-M5-43,EURCHFMT4,8586,8h 20m,Buy
178343.22,142133,06.02.2019 07:40:00,,0.0,-676.1800000002258,0.0,0.0,142.31,06.02.2019 02:15:00,16778,-0.25134990264650886,-37.09,IS,0.23,0.0,Phase3-EA-S4v1-GBPJPY-M5-194,GBPJPYMT4,3616,5h 25m,Buy
178320.46,1.1397,06.02.2019 12:00:00,,0.0,-698.9400000002352,0.0,0.0,1.14037,06.02.2019 03:15:00,16779,-0.25981025903716665,-22.76,IS,0.34,0.0,Phase3-EA-S4v1-EURCHF-M15-221,EURCHFMT4,4390,8h 45m,Buy
178303.74,1.0021,07.02.2019 02:45:00,,-9.2,-715.6600000002072,0.0,0.0,1.00197,06.02.2019 22:30:00,16780,-0.2660254241888144,-16.72,IS,0.58,0.0,Phase3-EA-SA2v2-USDCHF-M15-107,USDCHFMT4,3330,4h 15m,Sell
178301.7,1.13889,07.02.2019 10:25:00,,0.0,-717.7000000001863,0.0,0.0,1.13894,07.02.2019 02:05:00,16781,-0.2667837338125736,-2.04,IS,0.41,0.0,Phase3-EA-SA2v2-EURCHF-M5-43,EURCHFMT4,8588,8h 20m,Buy
178318.43,109725,07.02.2019 20:45:00,,0.0,-700.9700000002049,0.0,0.0,109793,07.02.2019 19:30:00,16782,-0.26056485145688424,16.73,IS,0.27,0.0,Phase3-EA-S1v2-USDJPY-M15-0,USDJPYMT4,4726,1h 15m,Sell
178361.38,1.13587,08.02.2019 02:04:57,tp 1.13587,-2.05,-658.0200000001932,0.0,0.0,1.13697,07.02.2019 23:45:00,16783,-0.24459946011335607,42.95,IS,0.41,0.0,Phase3-EA-SA2v2-EURCHF-M5-43,EURCHFMT4,8590,2h 19m,Sell
178306.99,1.00241,08.02.2019 04:30:00,,0.0,-712.4100000002072,0.0,0.0,1.00147,08.02.2019 00:15:00,16784,-0.2648173328764407,-54.39,IS,0.58,0.0,Phase3-EA-SA2v2-USDCHF-M15-107,USDCHFMT4,3332,4h 15m,Sell
178290.02,1.13585,08.02.2019 11:15:00,,0.0,-729.3800000001793,0.0,0.0,1.13635,08.02.2019 02:30:00,16785,-0.27112542812904034,-16.97,IS,0.34,0.0,Phase3-EA-S4v1-EURCHF-M15-221,EURCHFMT4,4392,8h 45m,Buy
178225.35,124266,08.02.2019 20:29:58,sl 124.266,-5.62,-794.050000000163,0.0,0.0,124986,25.01.2019 19:30:00,16786,-0.2951645866432528,-64.67,IS,0.09,0.0,Phase3-EA-TR1v1-EURJPY-M30-91,EURJPYMT4,2975,14d 0h 59m,Buy
178269.14,1.13417,11.02.2019 02:09:58,tp 1.13417,-0.98,-750.2600000001839,0.0,0.0,1.13307,08.02.2019 20:15:00,16787,-0.2788869501605386,43.79,IS,0.41,0.0,Phase3-EA-SA2v2-EURCHF-M5-43,EURCHFMT4,8592,2d 5h 54m,Buy
178404.44,1.13334,11.02.2019 02:44:58,tp 1.13334,0.0,-614.9600000001956,0.0,0.0,1.13734,11.02.2019 02:30:00,16788,-0.22859317952541428,135.3,IS,0.34,0.0,Phase3-EA-S4v1-EURCHF-M15-221,EURCHFMT4,4394,14m 58s,Sell
178413.02,110428,12.02.2019 03:15:00,,-0.71,-606.3800000001793,0.0,0.0,110.39,11.02.2019 23:30:00,16789,-0.22540381846074153,8.58,IS,0.27,0.0,Phase3-EA-S1v2-USDJPY-M15-0,USDJPYMT4,4728,3h 45m,Buy
178456.95,1.13295,12.02.2019 05:59:58,tp 1.13295,-0.98,-562.4500000001863,0.0,0.0,1.13185,11.02.2019 23:20:00,16790,-0.20907414112148912,43.93,IS,0.41,0.0,Phase3-EA-SA2v2-EURCHF-M5-43,EURCHFMT4,8594,6h 39m,Buy
178365.77,1.13517,12.02.2019 13:45:00,,0.0,-653.6300000001793,0.0,0.0,1.13247,12.02.2019 05:00:00,16791,-0.2429676075406368,-91.18,IS,0.34,0.0,Phase3-EA-S4v1-EURCHF-M15-221,EURCHFMT4,4396,8h 45m,Sell
178327.14,125136,12.02.2019 21:44:58,sl 125.136,-3.24,-692.2600000001839,0.0,0.0,124906,06.02.2019 19:00:00,16792,-0.2573271667397148,-38.63,IS,0.17,0.0,Phase3-EA-T1v2-EURJPY-M15-322,EURJPYMT4,3332,6d 2h 44m,Sell
178369.94,1.13909,13.02.2019 02:19:57,tp 1.13909,-2.04,-649.4600000001956,0.0,0.0,1.14019,12.02.2019 22:20:00,16793,-0.2414175334567664,42.8,IS,0.41,0.0,Phase3-EA-SA2v2-EURCHF-M5-43,EURCHFMT4,8596,3h 59m,Sell
178363.02,1.00598,13.02.2019 06:30:00,,0.0,-656.3800000001793,0.0,0.0,1.00586,13.02.2019 02:15:00,16794,-0.24398983865110688,-6.92,IS,0.58,0.0,Phase3-EA-SA2v2-USDCHF-M15-107,USDCHFMT4,3334,4h 15m,Sell
178305.18,142735,13.02.2019 07:29:58,sl 142.735,-3.32,-714.2200000002049,0.0,0.0,142065,06.02.2019 06:30:00,16795,-0.2654901468073311,-57.84,IS,0.09,0.0,Phase3-EA-B1v1-GBPJPY-M30-1,GBPJPYMT4,1516,7d 0h 59m,Sell
178301.51,1.13956,13.02.2019 10:45:00,,0.0,-717.8900000001886,0.0,0.0,1.13965,13.02.2019 02:25:00,16796,-0.2668543606892978,-3.67,IS,0.41,0.0,Phase3-EA-SA2v2-EURCHF-M5-43,EURCHFMT4,8598,8h 20m,Buy
178340.11,1.13645,14.02.2019 01:54:58,tp 1.13645,-6.1,-679.2900000002119,0.0,0.0,1.13755,13.02.2019 22:35:00,16797,-0.2525059531023444,38.6,IS,0.41,0.0,Phase3-EA-SA2v2-EURCHF-M5-43,EURCHFMT4,8600,3h 19m,Sell
178306.83,1.00908,14.02.2019 03:45:00,,-9.14,-712.5700000002398,0.0,0.0,1.00866,13.02.2019 23:30:00,16798,-0.26487680814106196,-33.28,IS,0.58,0.0,Phase3-EA-SA2v2-USDCHF-M15-107,USDCHFMT4,3336,4h 15m,Sell
178341.86,142724,14.02.2019 07:45:00,,0.0,-677.5400000002119,0.0,0.0,142555,14.02.2019 02:20:00,16799,-0.25185544239568164,35.03,IS,0.23,0.0,Phase3-EA-S4v1-GBPJPY-M5-194,GBPJPYMT4,3618,5h 25m,Buy
178386.6,1.13728,14.02.2019 07:49:58,tp 1.13728,0.0,-632.8000000002212,0.0,0.0,1.13618,14.02.2019 02:05:00,16800,-0.23522467152934617,44.74,IS,0.41,0.0,Phase3-EA-SA2v2-EURCHF-M5-43,EURCHFMT4,8602,5h 44m,Buy
178403.12,1.13709,14.02.2019 11:00:00,,0.0,-616.2800000002026,0.0,0.0,1.1366,14.02.2019 02:15:00,16801,-0.22908385045844254,16.52,IS,0.34,0.0,Phase3-EA-S4v1-EURCHF-M15-221,EURCHFMT4,4398,8h 45m,Buy
178367.82,124.98,14.02.2019 17:59:58,sl 124.980,0.0,-651.5800000001909,0.0,0.0,125.21,14.02.2019 15:45:00,16802,-0.24220558071283615,-35.3,IS,0.17,0.0,Phase3-EA-T1v2-EURJPY-M15-322,EURJPYMT4,3334,2h 14m,Buy
178352.12,1.00462,15.02.2019 02:15:00,,-0.69,-667.2800000002026,0.0,0.0,1.00488,14.02.2019 22:00:00,16803,-0.2480415910526152,-15.7,IS,0.58,0.0,Phase3-EA-SA2v2-USDCHF-M15-107,USDCHFMT4,3338,4h 15m,Buy
178328.29,1.13515,15.02.2019 04:20:00,,-0.98,-691.1100000002189,0.0,0.0,1.13571,14.02.2019 20:00:00,16804,-0.25689968827534937,-23.83,IS,0.41,0.0,Phase3-EA-SA2v2-EURCHF-M5-43,EURCHFMT4,8604,8h 20m,Buy
178283.7,141212,15.02.2019 05:30:00,,0.0,-735.7000000002445,0.0,0.0,141426,15.02.2019 00:05:00,16805,-0.2734747010811267,-44.59,IS,0.23,0.0,Phase3-EA-S4v1-GBPJPY-M5-194,GBPJPYMT4,3620,5h 25m,Buy
178248.34,124668,15.02.2019 22:14:58,sl 124.668,0.0,-771.0600000002305,0.0,0.0,124438,15.02.2019 17:15:00,16806,-0.2866187345597479,-35.36,IS,0.17,0.0,Phase3-EA-T1v2-EURJPY-M15-322,EURJPYMT4,3336,4h 59m,Sell
178252.84,1.00483,18.02.2019 03:15:00,,-0.69,-766.5600000002305,0.0,0.0,1.00474,15.02.2019 23:00:00,16807,-0.284945992742615,4.5,IS,0.58,0.0,Phase3-EA-SA2v2-USDCHF-M15-107,USDCHFMT4,3340,2d 4h 15m,Buy
178215.65,1.13543,18.02.2019 06:10:00,,-2.04,-803.7500000002328,0.0,0.0,1.13457,15.02.2019 21:50:00,16808,-0.29877027456020966,-37.19,IS,0.41,0.0,Phase3-EA-SA2v2-EURCHF-M5-43,EURCHFMT4,8606,2d 8h 20m,Sell
178175.69,142711,18.02.2019 07:45:00,,0.0,-843.7100000002538,0.0,0.0,142519,18.02.2019 02:20:00,16809,-0.3136242218963574,-39.96,IS,0.23,0.0,Phase3-EA-S4v1-GBPJPY-M5-194,GBPJPYMT4,3622,5h 25m,Sell
178149.58,1.13612,19.02.2019 05:15:00,,-2.04,-869.8200000002398,0.0,0.0,1.13553,18.02.2019 20:55:00,16810,-0.32332984163976103,-26.11,IS,0.41,0.0,Phase3-EA-SA2v2-EURCHF-M5-43,EURCHFMT4,8608,8h 20m,Sell
178083.17,142527,19.02.2019 07:40:00,,0.0,-936.2300000002142,0.0,0.0,142846,19.02.2019 02:15:00,16811,-0.3480157936565948,-66.41,IS,0.23,0.0,Phase3-EA-S4v1-GBPJPY-M5-194,GBPJPYMT4,3624,5h 25m,Buy
178082.83,1.13578,19.02.2019 10:00:00,,0.0,-936.5700000002398,0.0,0.0,1.13577,19.02.2019 01:15:00,16812,-0.3481421785938988,-0.34,IS,0.34,0.0,Phase3-EA-S4v1-EURCHF-M15-221,EURCHFMT4,4400,8h 45m,Sell
178346.37,1.30212,19.02.2019 19:59:58,tp 1.30212,-1.06,-673.0300000002608,0.0,0.0,1.28322,15.02.2019 18:30:00,16813,-0.2501789833745288,263.54,IS,0.14,0.0,Phase3-EA-B1v1-GBPUSD-M30-14,GBPUSDMT4,1098,4d 1h 29m,Buy
178496.51,144366,19.02.2019 21:29:58,tp 144.366,-0.29,-522.8900000002468,0.0,0.0,142516,18.02.2019 02:30:00,16814,-0.19436888194689456,150.14,IS,0.09,0.0,Phase3-EA-B1v1-GBPJPY-M30-1,GBPJPYMT4,1518,1d 18h 59m,Buy
178451.71,144762,20.02.2019 05:20:00,,-1.21,-567.6900000002352,0.0,0.0,144552,19.02.2019 23:55:00,16815,-0.2110219560374576,-44.8,IS,0.23,0.0,Phase3-EA-S4v1-GBPJPY-M5-194,GBPJPYMT4,3626,5h 25m,Sell
178550.54,125793,20.02.2019 05:29:58,tp 125.793,-3.59,-468.86000000021886,0.0,0.0,124533,11.02.2019 11:30:00,16816,-0.17428482852917537,98.83,IS,0.09,0.0,Phase3-EA-TR1v1-EURJPY-M30-91,EURJPYMT4,2978,8d 17h 59m,Buy
178532.1,1.13616,20.02.2019 06:00:00,,-2.05,-487.3000000002212,0.0,0.0,1.13576,19.02.2019 21:40:00,16817,-0.18113935277538298,-18.44,IS,0.41,0.0,Phase3-EA-SA2v2-EURCHF-M5-43,EURCHFMT4,8610,8h 20m,Sell
178558.59,1.13521,20.02.2019 14:30:00,,0.0,-460.8100000002305,0.0,0.0,1.13599,20.02.2019 05:45:00,16818,-0.1712924792785309,26.49,IS,0.34,0.0,Phase3-EA-S4v1-EURCHF-M15-221,EURCHFMT4,4402,8h 45m,Sell
178616.6,0.99985,21.02.2019 02:14:57,tp 0.99985,0.0,-402.8000000002212,0.0,0.0,1.00085,21.02.2019 01:30:00,16819,-0.14972897865366552,58.01,IS,0.58,0.0,Phase3-EA-SA2v2-USDCHF-M15-107,USDCHFMT4,3342,44m 57s,Sell
178603.61,125694,21.02.2019 03:00:00,,-2.25,-415.7900000002119,0.0,0.0,125764,20.02.2019 19:45:00,16820,-0.154557626699119,-12.99,IS,0.17,0.0,Phase3-EA-T1v2-EURJPY-M15-322,EURJPYMT4,3338,7h 15m,Buy
178547.32,144273,21.02.2019 06:45:00,,0.0,-472.0800000001909,0.0,0.0,144544,21.02.2019 01:20:00,16821,-0.17548176822942452,-56.29,IS,0.23,0.0,Phase3-EA-S4v1-GBPJPY-M5-194,GBPJPYMT4,3628,5h 25m,Buy
178592.37,1.13566,21.02.2019 07:24:58,tp 1.13566,0.0,-427.03000000020256,0.0,0.0,1.13456,21.02.2019 02:20:00,16822,-0.15873576403790965,45.05,IS,0.41,0.0,Phase3-EA-SA2v2-EURCHF-M5-43,EURCHFMT4,8612,5h 4m,Buy
178621.91,1.13511,21.02.2019 11:15:00,,0.0,-397.4900000002235,0.0,0.0,1.13424,21.02.2019 02:30:00,16823,-0.14775514330944958,29.54,IS,0.34,0.0,Phase3-EA-S4v1-EURCHF-M15-221,EURCHFMT4,4404,8h 45m,Buy
178586.59,125739,21.02.2019 12:29:57,sl 125.739,0.0,-432.8100000002305,0.0,0.0,125509,21.02.2019 10:00:00,16824,-0.16088430797192627,-35.32,IS,0.17,0.0,Phase3-EA-T1v2-EURJPY-M15-322,EURJPYMT4,3340,2h 29m,Sell
178551.28,125.67,21.02.2019 15:14:58,sl 125.670,0.0,-468.1200000002282,0.0,0.0,125.44,21.02.2019 13:30:00,16825,-0.17400975543036143,-35.31,IS,0.17,0.0,Phase3-EA-T1v2-EURJPY-M15-322,EURJPYMT4,3342,1h 44m,Sell
178576.52,1.13484,22.02.2019 04:20:00,,-0.98,-442.8800000002375,0.0,0.0,1.1342,21.02.2019 20:00:00,16826,-0.16462753243826847,25.24,IS,0.41,0.0,Phase3-EA-SA2v2-EURCHF-M5-43,EURCHFMT4,8614,8h 20m,Buy
178605.07,1.13528,22.02.2019 11:30:00,,0.0,-414.33000000024913,0.0,0.0,1.13444,22.02.2019 02:45:00,16827,-0.15401491490957417,28.55,IS,0.34,0.0,Phase3-EA-S4v1-EURCHF-M15-221,EURCHFMT4,4406,8h 45m,Buy
178569.23,125.74,22.02.2019 12:59:58,sl 125.740,-0.54,-450.17000000027474,0.0,0.0,125.51,21.02.2019 19:15:00,16828,-0.16733737418203756,-35.84,IS,0.17,0.0,Phase3-EA-T1v2-EURJPY-M15-322,EURJPYMT4,3344,17h 44m,Sell
178513.68,143997,22.02.2019 16:59:58,sl 143.997,-1.17,-505.7200000002631,0.0,0.0,144667,20.02.2019 05:00:00,16829,-0.18798644261352915,-55.55,IS,0.09,0.0,Phase3-EA-B1v1-GBPJPY-M30-1,GBPJPYMT4,1520,2d 11h 59m,Buy
178491.85,144569,25.02.2019 07:45:00,,0.0,-527.5500000002794,0.0,0.0,144464,25.02.2019 02:20:00,16830,-0.19610109902864872,-21.83,IS,0.23,0.0,Phase3-EA-S4v1-GBPJPY-M5-194,GBPJPYMT4,3630,5h 25m,Sell
178489.39,1.13359,25.02.2019 10:45:00,,0.0,-530.0100000003004,0.0,0.0,1.13353,25.02.2019 02:25:00,16831,-0.1970155312220225,-2.46,IS,0.41,0.0,Phase3-EA-SA2v2-EURCHF-M5-43,EURCHFMT4,8616,8h 20m,Sell
178454.04,125671,25.02.2019 11:14:58,sl 125.671,0.0,-565.3600000002771,0.0,0.0,125441,25.02.2019 07:15:00,16832,-0.21015584749660216,-35.35,IS,0.17,0.0,Phase3-EA-T1v2-EURJPY-M15-322,EURJPYMT4,3346,3h 59m,Sell
178438.73,1.13452,25.02.2019 13:45:00,,0.0,-580.6700000002747,0.0,0.0,1.13407,25.02.2019 05:00:00,16833,-0.21584688687889114,-15.31,IS,0.34,0.0,Phase3-EA-S4v1-EURCHF-M15-221,EURCHFMT4,4408,8h 45m,Sell
178476.62,125944,26.02.2019 06:15:00,,-0.75,-542.7800000002608,0.0,0.0,125692,25.02.2019 11:15:00,16834,-0.2017624007786271,37.89,IS,0.17,0.0,Phase3-EA-T1v2-EURJPY-M15-322,EURJPYMT4,3348,19h 0m,Buy
178465.14,1.13612,26.02.2019 07:00:00,,-2.05,-554.2600000002421,0.0,0.0,1.13589,25.02.2019 22:40:00,16835,-0.20602975101432805,-11.48,IS,0.41,0.0,Phase3-EA-SA2v2-EURCHF-M5-43,EURCHFMT4,8618,8h 20m,Sell
178487.56,145575,26.02.2019 07:35:00,,0.0,-531.8400000002584,0.0,0.0,145683,26.02.2019 02:10:00,16836,-0.19769577956097428,22.42,IS,0.23,0.0,Phase3-EA-S4v1-GBPJPY-M5-194,GBPJPYMT4,3632,5h 25m,Sell
178436.88,110809,26.02.2019 12:30:00,,0.0,-582.5200000002515,0.0,0.0,111017,26.02.2019 00:30:00,16837,-0.21653456962592602,-50.68,IS,0.27,0.0,Phase3-EA-S1v2-USDJPY-M15-0,USDJPYMT4,4730,12h 0m,Buy
178402.04,1.13869,27.02.2019 06:30:00,,-2.05,-617.3600000002771,0.0,0.0,1.13789,26.02.2019 22:10:00,16838,-0.22948530849458212,-34.84,IS,0.41,0.0,Phase3-EA-SA2v2-EURCHF-M5-43,EURCHFMT4,8620,8h 20m,Sell
178366.17,126087,27.02.2019 17:59:57,sl 126.087,-0.54,-653.2300000002724,0.0,0.0,125857,26.02.2019 18:30:00,16839,-0.24281891937914848,-35.87,IS,0.17,0.0,Phase3-EA-T1v2-EURJPY-M15-322,EURJPYMT4,3350,23h 29m,Sell
178516.24,147598,27.02.2019 18:59:58,tp 147.598,-0.29,-503.1600000002654,0.0,0.0,145748,26.02.2019 02:30:00,16840,-0.18703483837978332,150.07,IS,0.09,0.0,Phase3-EA-B1v1-GBPJPY-M30-1,GBPJPYMT4,1522,1d 16h 29m,Buy
178565.03,1.00008,28.02.2019 02:14:58,tp 1.00008,-9.21,-454.3700000002864,0.0,0.0,1.00108,27.02.2019 22:30:00,16841,-0.1688985998780326,48.79,IS,0.58,0.0,Phase3-EA-SA2v2-USDCHF-M15-107,USDCHFMT4,3344,3h 44m,Sell
178556.84,1.13776,28.02.2019 05:45:00,,-6.14,-462.5600000002887,0.0,0.0,1.13771,27.02.2019 21:25:00,16842,-0.1719429899852153,-8.19,IS,0.41,0.0,Phase3-EA-SA2v2-EURCHF-M5-43,EURCHFMT4,8622,8h 20m,Sell
178423.67,1.13409,28.02.2019 14:14:58,sl 1.13409,0.0,-595.7300000002724,0.0,0.0,1.13799,28.02.2019 06:00:00,16843,-0.22144499616022834,-133.17,IS,0.34,0.0,Phase3-EA-S4v1-EURCHF-M15-221,EURCHFMT4,4410,8h 14m,Buy
178468.88,1.13417,01.03.2019 02:09:57,tp 1.13417,0.0,-550.5200000002515,0.0,0.0,1.13527,01.03.2019 00:45:00,16844,-0.2046395167040922,45.21,IS,0.41,0.0,Phase3-EA-SA2v2-EURCHF-M5-43,EURCHFMT4,8624,1h 24m,Sell
178546.85,126717,01.03.2019 04:45:00,,-0.75,-472.5500000002794,0.0,0.0,126201,28.02.2019 13:15:00,16845,-0.17565647681924684,77.97,IS,0.17,0.0,Phase3-EA-T1v2-EURJPY-M15-322,EURJPYMT4,3352,15h 30m,Buy
178643.94,127072,01.03.2019 07:29:57,tp 127.072,-4.38,-375.4600000002538,0.0,0.0,125812,20.02.2019 07:00:00,16846,-0.13956614281358587,97.09,IS,0.09,0.0,Phase3-EA-TR1v1-EURJPY-M30-91,EURJPYMT4,2980,9d 0h 29m,Buy
178678.67,1.13543,01.03.2019 12:00:00,,0.0,-340.7300000002724,0.0,0.0,1.13441,01.03.2019 03:15:00,16847,-0.12665629318936503,34.73,IS,0.34,0.0,Phase3-EA-S4v1-EURCHF-M15-221,EURCHFMT4,4412,8h 45m,Buy
178636.67,1.3271,01.03.2019 18:59:58,sl 1.32710,0.0,-382.7300000002724,0.0,0.0,1.3241,01.03.2019 12:30:00,16848,-0.14226855014927192,-42.0,IS,0.14,0.0,Phase3-EA-B1v1-GBPUSD-M30-14,GBPUSDMT4,1100,6h 29m,Sell
178594.67,1.32423,01.03.2019 19:59:58,sl 1.32423,0.0,-424.7300000002724,0.0,0.0,1.32723,01.03.2019 19:00:00,16849,-0.15788080710917882,-42.0,IS,0.14,0.0,Phase3-EA-B1v1-GBPUSD-M30-14,GBPUSDMT4,1102,59m 58s,Buy
178649.7,0.99805,04.03.2019 02:00:00,tp 0.99805,-3.08,-369.7000000002445,0.0,0.0,0.99905,01.03.2019 22:15:00,16850,-0.13742503328765232,55.03,IS,0.58,0.0,Phase3-EA-SA2v2-USDCHF-M15-107,USDCHFMT4,3346,2d 3h 45m,Sell
178658.16,1.13556,04.03.2019 06:00:00,,-0.98,-361.2400000002235,0.0,0.0,1.13533,01.03.2019 21:40:00,16851,-0.13428027867143472,8.46,IS,0.41,0.0,Phase3-EA-SA2v2-EURCHF-M5-43,EURCHFMT4,8626,2d 8h 20m,Buy
178637.96,127211,04.03.2019 09:45:00,,0.0,-381.44000000023516,0.0,0.0,127344,04.03.2019 03:45:00,16852,-0.14178903082834665,-20.2,IS,0.17,0.0,Phase3-EA-T1v2-EURJPY-M15-322,EURJPYMT4,3354,6h 0m,Buy
178673.3,1.13482,04.03.2019 15:15:00,,0.0,-346.10000000020955,0.0,0.0,1.13586,04.03.2019 06:30:00,16853,-0.1286524317577869,35.34,IS,0.34,0.0,Phase3-EA-S4v1-EURCHF-M15-221,EURCHFMT4,4414,8h 45m,Sell
178716.4,1.13175,05.03.2019 02:04:57,tp 1.13175,-2.05,-303.00000000023283,0.0,0.0,1.13285,04.03.2019 22:55:00,16854,-0.11263128235370061,43.1,IS,0.41,0.0,Phase3-EA-SA2v2-EURCHF-M5-43,EURCHFMT4,8628,3h 9m,Sell
178734.39,0.99924,05.03.2019 05:00:00,,0.0,-285.01000000024214,0.0,0.0,0.99893,05.03.2019 00:45:00,16855,-0.10594403228921061,17.99,IS,0.58,0.0,Phase3-EA-SA2v2-USDCHF-M15-107,USDCHFMT4,3348,4h 15m,Buy
178707.25,147361,05.03.2019 06:45:00,,0.0,-312.1500000002561,0.0,0.0,147229,05.03.2019 01:20:00,16856,-0.11603252404854612,-27.14,IS,0.23,0.0,Phase3-EA-S4v1-GBPJPY-M5-194,GBPJPYMT4,3634,5h 25m,Sell
178659.49,111924,05.03.2019 17:15:00,,0.0,-359.9100000002654,0.0,0.0,111726,05.03.2019 01:45:00,16857,-0.13378589053438658,-47.76,IS,0.27,0.0,Phase3-EA-S1v2-USDJPY-M15-0,USDJPYMT4,4732,15h 30m,Sell
178717.25,1.00414,05.03.2019 22:44:58,tp 1.00414,0.0,-302.1500000002561,0.0,0.0,1.00514,05.03.2019 22:00:00,16858,-0.11231532001047305,57.76,IS,0.58,0.0,Phase3-EA-SA2v2-USDCHF-M15-107,USDCHFMT4,3350,44m 58s,Sell
178722.91,1.00437,06.03.2019 03:15:00,,-0.69,-296.4900000002817,0.0,0.0,1.00426,05.03.2019 23:00:00,16859,-0.1102113825249332,5.66,IS,0.58,0.0,Phase3-EA-SA2v2-USDCHF-M15-107,USDCHFMT4,3352,4h 15m,Buy
178672.71,1.13548,06.03.2019 04:25:00,,-2.04,-346.69000000029337,0.0,0.0,1.1343,05.03.2019 20:05:00,16860,-0.12887174679606436,-50.2,IS,0.41,0.0,Phase3-EA-SA2v2-EURCHF-M5-43,EURCHFMT4,8630,8h 20m,Sell
178609.94,146832,06.03.2019 08:30:00,,0.0,-409.460000000312,0.0,0.0,147137,06.03.2019 03:05:00,16861,-0.15220463654305594,-62.77,IS,0.23,0.0,Phase3-EA-S4v1-GBPJPY-M5-194,GBPJPYMT4,3636,5h 25m,Buy
178658.53,1.00392,07.03.2019 02:14:57,tp 1.00392,-9.18,-360.8700000002864,0.0,0.0,1.00492,06.03.2019 23:15:00,16862,-0.13414274212204938,48.59,IS,0.58,0.0,Phase3-EA-SA2v2-USDCHF-M15-107,USDCHFMT4,3354,2h 59m,Sell
178621.26,126237,07.03.2019 04:29:58,sl 126.237,-2.24,-398.140000000305,0.0,0.0,126467,06.03.2019 20:15:00,16863,-0.14799676157195463,-37.27,IS,0.17,0.0,Phase3-EA-T1v2-EURJPY-M15-322,EURJPYMT4,3356,8h 14m,Buy
178634.16,147119,07.03.2019 04:55:00,,-3.58,-385.2400000002817,0.0,0.0,147199,06.03.2019 23:30:00,16864,-0.1432015683628317,12.9,IS,0.23,0.0,Phase3-EA-S4v1-GBPJPY-M5-194,GBPJPYMT4,3638,5h 25m,Sell
178671.32,1.13525,07.03.2019 07:45:00,,-6.12,-348.08000000030734,0.0,0.0,1.13631,06.03.2019 23:25:00,16865,-0.1293884381573617,37.16,IS,0.41,0.0,Phase3-EA-SA2v2-EURCHF-M5-43,EURCHFMT4,8632,8h 20m,Sell
178683.51,1.13588,07.03.2019 15:30:00,,0.0,-335.890000000305,0.0,0.0,1.13552,07.03.2019 06:45:00,16866,-0.12485716643494976,12.19,IS,0.34,0.0,Phase3-EA-S4v1-EURCHF-M15-221,EURCHFMT4,4416,8h 45m,Buy
178785.73,125973,07.03.2019 17:29:58,tp 125.973,-1.69,-233.67000000033295,0.0,0.0,127263,01.03.2019 19:30:00,16867,-0.08685990675777722,102.22,IS,0.09,0.0,Phase3-EA-TR1v1-EURJPY-M30-91,EURJPYMT4,2982,5d 21h 59m,Sell
178885.81,125532,07.03.2019 18:59:58,tp 125.532,-1.41,-133.59000000031665,0.0,0.0,126792,04.03.2019 16:30:00,16868,-0.049658128744735866,100.08,IS,0.09,0.0,Phase3-EA-TR1v1-EURJPY-M30-91,EURJPYMT4,2983,3d 2h 29m,Sell
178930.41,1.1325,07.03.2019 23:39:58,tp 1.13250,0.0,-88.99000000033993,0.0,0.0,1.1336,07.03.2019 21:35:00,16869,-0.03307939873493862,44.6,IS,0.41,0.0,Phase3-EA-SA2v2-EURCHF-M5-43,EURCHFMT4,8634,2h 4m,Sell
178960.2,111473,08.03.2019 05:00:00,,0.0,-59.20000000036089,0.0,0.0,111596,08.03.2019 00:45:00,16870,-0.022005847905526732,29.79,IS,0.27,0.0,Phase3-EA-S1v2-USDJPY-M15-0,USDJPYMT4,4734,4h 15m,Sell
178946.25,1.13188,08.03.2019 08:05:00,,-0.97,-73.15000000037253,0.0,0.0,1.1322,07.03.2019 23:45:00,16871,-0.027191347538642992,-13.95,IS,0.41,0.0,Phase3-EA-SA2v2-EURCHF-M5-43,EURCHFMT4,8636,8h 20m,Buy
179205.56,124433,08.03.2019 09:44:58,tp 124.433,-0.53,-0.0,0.0,0.0,126133,07.03.2019 17:00:00,16872,-0.0,259.31,IS,0.17,0.0,Phase3-EA-T1v2-EURJPY-M15-322,EURJPYMT4,3358,16h 44m,Sell
179181.32,1.13141,08.03.2019 10:00:00,,0.0,-24.239999999990687,0.0,0.0,1.13213,08.03.2019 01:15:00,16873,-0.009004271679972208,-24.24,IS,0.34,0.0,Phase3-EA-S4v1-EURCHF-M15-221,EURCHFMT4,4418,8h 45m,Buy
179204.74,1.13261,11.03.2019 07:40:00,,-0.98,-0.8200000000069849,0.0,0.0,1.13201,08.03.2019 23:20:00,16874,-3.045999495727286E-4,23.42,IS,0.41,0.0,Phase3-EA-SA2v2-EURCHF-M5-43,EURCHFMT4,8638,2d 8h 20m,Buy
179174.31,144096,11.03.2019 07:50:00,,0.0,-31.25,0.0,0.0,144243,11.03.2019 02:25:00,16875,-0.011608229785447179,-30.43,IS,0.23,0.0,Phase3-EA-S4v1-GBPJPY-M5-194,GBPJPYMT4,3640,5h 25m,Buy
179131.48,1.13367,11.03.2019 12:15:00,,0.0,-74.0800000000163,0.0,0.0,1.1324,11.03.2019 03:30:00,16876,-0.02751800520019572,-42.83,IS,0.34,0.0,Phase3-EA-S4v1-EURCHF-M15-221,EURCHFMT4,4420,8h 45m,Sell
179145.79,111287,12.03.2019 02:15:00,,0.0,-59.77000000001863,0.0,0.0,111228,12.03.2019 00:45:00,16877,-0.022202364616844612,14.31,IS,0.27,0.0,Phase3-EA-S1v2-USDJPY-M15-0,USDJPYMT4,4736,1h 30m,Buy
179409.86,1.31955,12.03.2019 02:29:58,tp 1.31955,-0.53,-0.0,0.0,0.0,1.30065,11.03.2019 15:30:00,16878,-0.0,264.07,IS,0.14,0.0,Phase3-EA-B1v1-GBPUSD-M30-14,GBPUSDMT4,1104,10h 59m,Buy
179350.59,1.13707,12.03.2019 05:00:00,,-2.03,-59.27000000001863,0.0,0.0,1.13566,11.03.2019 20:40:00,16879,-0.021999937196069366,-59.27,IS,0.41,0.0,Phase3-EA-SA2v2-EURCHF-M5-43,EURCHFMT4,8640,8h 20m,Sell
179351.21,147154,12.03.2019 07:40:00,,0.0,-58.65000000002328,0.0,0.0,147157,12.03.2019 02:15:00,16880,-0.021769804564696727,0.62,IS,0.23,0.0,Phase3-EA-S4v1-GBPJPY-M5-194,GBPJPYMT4,3642,5h 25m,Sell
179330.69,1.13795,12.03.2019 11:30:00,,0.0,-79.17000000004191,0.0,0.0,1.13734,12.03.2019 02:45:00,16881,-0.029386452299868165,-20.52,IS,0.34,0.0,Phase3-EA-S4v1-EURCHF-M15-221,EURCHFMT4,4422,8h 45m,Sell
179276.54,145991,12.03.2019 15:29:58,sl 145.991,0.0,-133.3200000000652,0.0,0.0,146661,12.03.2019 02:00:00,16882,-0.0494859393787832,-54.15,IS,0.09,0.0,Phase3-EA-B1v1-GBPJPY-M30-1,GBPJPYMT4,1524,13h 29m,Buy
179316.18,125.29,12.03.2019 17:30:00,,-0.75,-93.68000000005122,0.0,0.0,125026,11.03.2019 22:15:00,16883,-0.03477229823735882,39.64,IS,0.17,0.0,Phase3-EA-T1v2-EURJPY-M15-322,EURJPYMT4,3360,19h 15m,Buy
179298.67,1.13717,13.03.2019 05:10:00,,-2.04,-111.19000000006054,0.0,0.0,1.13679,12.03.2019 20:50:00,16884,-0.041271689165370606,-17.51,IS,0.41,0.0,Phase3-EA-SA2v2-EURCHF-M5-43,EURCHFMT4,8642,8h 20m,Sell
179305.58,1.00729,13.03.2019 05:15:00,,0.0,-104.28000000008615,0.0,0.0,1.00741,13.03.2019 01:00:00,16885,-0.03870682387054644,6.91,IS,0.58,0.0,Phase3-EA-SA2v2-USDCHF-M15-107,USDCHFMT4,3356,4h 15m,Sell
179317.73,1.13739,13.03.2019 12:30:00,,0.0,-92.13000000006286,0.0,0.0,1.13703,13.03.2019 03:45:00,16886,-0.03419696665892723,12.15,IS,0.34,0.0,Phase3-EA-S4v1-EURCHF-M15-221,EURCHFMT4,4424,8h 45m,Buy
179148.6,147824,14.03.2019 00:19:58,sl 147.824,-3.6,-261.2600000000675,0.0,0.0,147024,13.03.2019 23:25:00,16887,-0.09697492140787517,-169.13,IS,0.23,0.0,Phase3-EA-S4v1-GBPJPY-M5-194,GBPJPYMT4,3644,54m 58s,Sell
179297.45,148.31,14.03.2019 00:59:58,tp 148.310,-0.87,-112.4100000000908,0.0,0.0,146.46,13.03.2019 14:30:00,16888,-0.04172453079486043,148.85,IS,0.09,0.0,Phase3-EA-B1v1-GBPJPY-M30-1,GBPJPYMT4,1526,10h 29m,Buy
179237.21,126.03,14.03.2019 01:59:58,sl 126.030,-1.97,-172.6500000000815,0.0,0.0,125.31,07.03.2019 20:30:00,16889,-0.06408451420452126,-60.24,IS,0.09,0.0,Phase3-EA-TR1v1-EURJPY-M30-91,EURJPYMT4,2986,6d 5h 29m,Sell
179317.87,147.93,14.03.2019 03:14:58,tp 147.930,0.0,-91.9900000001071,0.0,0.0,148.32,14.03.2019 00:45:00,16890,-0.03414500122605266,80.66,IS,0.23,0.0,Phase3-EA-S4v1-GBPJPY-M5-194,GBPJPYMT4,3646,2h 29m,Sell
179324.74,1.13654,14.03.2019 04:25:00,,-2.94,-85.12000000011176,0.0,0.0,1.1363,13.03.2019 20:05:00,16891,-0.031594983197761,6.87,IS,0.41,0.0,Phase3-EA-SA2v2-EURCHF-M5-43,EURCHFMT4,8644,8h 20m,Buy
179294.86,147.74,14.03.2019 08:55:00,,0.0,-115.00000000011642,0.0,0.0,147885,14.03.2019 03:30:00,16892,-0.04268589130335318,-29.88,IS,0.23,0.0,Phase3-EA-S4v1-GBPJPY-M5-194,GBPJPYMT4,3648,5h 25m,Buy
179374.12,126171,14.03.2019 16:30:00,,-2.25,-35.7400000001071,0.0,0.0,125636,13.03.2019 10:00:00,16893,-0.013266032653781479,79.26,IS,0.17,0.0,Phase3-EA-T1v2-EURJPY-M15-322,EURJPYMT4,3362,1d 6h 30m,Buy
179375.85,1.0038,15.03.2019 05:30:00,,0.0,-34.01000000012573,0.0,0.0,1.00377,15.03.2019 01:15:00,16894,-0.012623888375921207,1.73,IS,0.58,0.0,Phase3-EA-SA2v2-USDCHF-M15-107,USDCHFMT4,3358,4h 15m,Buy
179398.56,1.13501,15.03.2019 05:50:00,,-0.98,-11.300000000104774,0.0,0.0,1.13443,14.03.2019 21:30:00,16895,-0.004194352797668478,22.71,IS,0.41,0.0,Phase3-EA-SA2v2-EURCHF-M5-43,EURCHFMT4,8646,8h 20m,Buy
179354.2,1.13622,15.03.2019 13:45:00,,0.0,-55.660000000090804,0.0,0.0,1.13491,15.03.2019 05:00:00,16896,-0.02065997139083573,-44.36,IS,0.34,0.0,Phase3-EA-S4v1-EURCHF-M15-221,EURCHFMT4,4426,8h 45m,Sell
179337.31,126201,15.03.2019 17:00:00,,-0.75,-72.55000000010477,0.0,0.0,126307,14.03.2019 20:45:00,16897,-0.026929229687474875,-16.89,IS,0.17,0.0,Phase3-EA-T1v2-EURJPY-M15-322,EURJPYMT4,3364,20h 15m,Buy
179340.58,111473,18.03.2019 02:00:00,,-1.09,-69.28000000008615,0.0,0.0,111491,15.03.2019 23:00:00,16898,-0.025715465647799928,3.27,IS,0.27,0.0,Phase3-EA-S1v2-USDJPY-M15-0,USDJPYMT4,4738,2d 3h 0m,Sell
179331.42,1.13492,18.03.2019 05:20:00,,-0.98,-78.44000000006054,0.0,0.0,1.13512,15.03.2019 21:00:00,16899,-0.029115489685514938,-9.16,IS,0.41,0.0,Phase3-EA-SA2v2-EURCHF-M5-43,EURCHFMT4,8648,2d 8h 20m,Buy
179355.34,148189,18.03.2019 09:20:00,,0.0,-54.520000000076834,0.0,0.0,148305,18.03.2019 03:55:00,16900,-0.020236824294432514,23.92,IS,0.23,0.0,Phase3-EA-S4v1-GBPJPY-M5-194,GBPJPYMT4,3650,5h 25m,Sell
179334.95,1.13553,18.03.2019 14:30:00,,0.0,-74.9100000000908,0.0,0.0,1.13493,18.03.2019 05:45:00,16901,-0.02780521841334631,-20.39,IS,0.34,0.0,Phase3-EA-S4v1-EURCHF-M15-221,EURCHFMT4,4428,8h 45m,Sell
179379.03,1.13508,19.03.2019 00:34:58,tp 1.13508,-0.98,-30.830000000074506,0.0,0.0,1.13398,18.03.2019 20:00:00,16902,-0.011443530685949797,44.08,IS,0.41,0.0,Phase3-EA-SA2v2-EURCHF-M5-43,EURCHFMT4,8650,4h 34m,Buy
179411.47,1.00112,19.03.2019 04:30:00,,0.0,-0.0,0.0,0.0,1.00056,19.03.2019 00:15:00,16903,-0.0,32.44,IS,0.58,0.0,Phase3-EA-SA2v2-USDCHF-M15-107,USDCHFMT4,3360,4h 15m,Buy
179395.18,147629,19.03.2019 04:30:00,,-1.2,-16.289999999979045,0.0,0.0,147556,18.03.2019 23:05:00,16904,-0.006046513164409439,-16.29,IS,0.23,0.0,Phase3-EA-S4v1-GBPJPY-M5-194,GBPJPYMT4,3652,5h 25m,Sell
179387.39,1.13523,19.03.2019 09:10:00,,0.0,-24.07999999995809,0.0,0.0,1.13504,19.03.2019 00:50:00,16905,-0.008938001043518305,-7.79,IS,0.41,0.0,Phase3-EA-SA2v2-EURCHF-M5-43,EURCHFMT4,8652,8h 20m,Sell
179444.26,147996,20.03.2019 06:35:00,,0.0,-0.0,0.0,0.0,147.72,20.03.2019 01:10:00,16906,-0.0,56.87,IS,0.23,0.0,Phase3-EA-S4v1-GBPJPY-M5-194,GBPJPYMT4,3654,5h 25m,Buy
179444.67,1.1341,20.03.2019 08:30:00,,0.0,-0.0,0.0,0.0,1.13409,20.03.2019 00:10:00,16907,-0.0,0.41,IS,0.41,0.0,Phase3-EA-SA2v2-EURCHF-M5-43,EURCHFMT4,8654,8h 20m,Buy
179490.21,1.13341,20.03.2019 22:54:57,tp 1.13341,0.0,-0.0,0.0,0.0,1.13231,20.03.2019 20:30:00,16908,-0.0,45.54,IS,0.41,0.0,Phase3-EA-SA2v2-EURCHF-M5-43,EURCHFMT4,8656,2h 24m,Buy
179548.68,0.99197,20.03.2019 23:44:57,tp 0.99197,0.0,-0.0,0.0,0.0,0.99097,20.03.2019 22:45:00,16909,-0.0,58.47,IS,0.58,0.0,Phase3-EA-SA2v2-USDCHF-M15-107,USDCHFMT4,3362,59m 57s,Buy
179587.92,1.13197,21.03.2019 01:34:58,tp 1.13197,-6.21,-0.0,0.0,0.0,1.13307,20.03.2019 22:55:00,16910,-0.0,39.24,IS,0.41,0.0,Phase3-EA-SA2v2-EURCHF-M5-43,EURCHFMT4,8658,2h 39m,Sell
179614.14,146288,21.03.2019 05:05:00,,-2.25,-0.0,0.0,0.0,146151,20.03.2019 23:40:00,16911,-0.0,26.22,IS,0.23,0.0,Phase3-EA-S4v1-GBPJPY-M5-194,GBPJPYMT4,3656,5h 25m,Buy
179613.45,1.13214,21.03.2019 10:45:00,,0.0,-0.6900000000023283,0.0,0.0,1.13216,21.03.2019 02:00:00,16912,-2.559212955234195E-4,-0.69,IS,0.34,0.0,Phase3-EA-S4v1-EURCHF-M15-221,EURCHFMT4,4430,8h 45m,Buy
179552.75,125.78,21.03.2019 12:29:58,sl 125.780,-2.0,-61.39000000001397,0.0,0.0,126213,14.03.2019 14:30:00,16913,-0.022769577292946788,-60.7,IS,0.09,0.0,Phase3-EA-TR1v1-EURJPY-M30-91,EURJPYMT4,2988,6d 21h 59m,Sell
179498.26,145817,21.03.2019 18:29:57,sl 145.817,0.0,-115.88000000000466,0.0,0.0,145147,21.03.2019 14:30:00,16914,-0.04297994163065938,-54.49,IS,0.09,0.0,Phase3-EA-B1v1-GBPJPY-M30-1,GBPJPYMT4,1528,3h 59m,Sell
179543.67,1.12863,21.03.2019 23:49:57,tp 1.12863,0.0,-70.47000000003027,0.0,0.0,1.12753,21.03.2019 20:10:00,16915,-0.026137353181858353,45.41,IS,0.41,0.0,Phase3-EA-SA2v2-EURCHF-M5-43,EURCHFMT4,8660,3h 39m,Buy
179560.25,110844,22.03.2019 02:00:00,,-0.71,-53.89000000001397,0.0,0.0,110773,21.03.2019 23:00:00,16916,-0.019987824080745092,16.58,IS,0.27,0.0,Phase3-EA-S1v2-USDJPY-M15-0,USDJPYMT4,4740,3h 0m,Buy
179569.01,0.99291,22.03.2019 04:30:00,,0.0,-45.13000000000466,0.0,0.0,0.99276,22.03.2019 00:15:00,16917,-0.016738736328890058,8.76,IS,0.58,0.0,Phase3-EA-SA2v2-USDCHF-M15-107,USDCHFMT4,3364,4h 15m,Buy
179538.86,1.12924,22.03.2019 08:55:00,,0.0,-75.28000000002794,0.0,0.0,1.12851,22.03.2019 00:35:00,16918,-0.02792138424194951,-30.15,IS,0.41,0.0,Phase3-EA-SA2v2-EURCHF-M5-43,EURCHFMT4,8662,8h 20m,Sell
179675.96,1.12492,22.03.2019 12:44:57,tp 1.12492,0.0,-0.0,0.0,0.0,1.12892,22.03.2019 06:30:00,16919,-0.0,137.1,IS,0.34,0.0,Phase3-EA-S4v1-EURCHF-M15-221,EURCHFMT4,4432,6h 14m,Sell
179633.96,1.31095,22.03.2019 12:59:57,sl 1.31095,0.0,-42.0,0.0,0.0,1.31395,22.03.2019 07:00:00,16920,-0.015574246959202395,-42.0,IS,0.14,0.0,Phase3-EA-B1v1-GBPUSD-M30-14,GBPUSDMT4,1106,5h 59m,Buy
179736.5,124923,22.03.2019 12:59:57,tp 124.923,-2.25,-0.0,0.0,0.0,126.5,18.03.2019 12:30:00,16921,-0.0,102.54,IS,0.09,0.0,Phase3-EA-TR1v1-EURJPY-M30-91,EURJPYMT4,2989,4d 0h 29m,Buy
179997.74,124719,22.03.2019 15:44:57,tp 124.719,-0.54,-0.0,0.0,0.0,126419,21.03.2019 06:45:00,16922,-0.0,261.24,IS,0.17,0.0,Phase3-EA-T1v2-EURJPY-M15-322,EURJPYMT4,3366,1d 8h 59m,Sell
180043.1,1.12249,22.03.2019 20:54:58,tp 1.12249,0.0,-0.0,0.0,0.0,1.12139,22.03.2019 20:00:00,16923,-0.0,45.36,IS,0.41,0.0,Phase3-EA-SA2v2-EURCHF-M5-43,EURCHFMT4,8664,54m 58s,Buy
180123.83,145458,25.03.2019 03:29:57,tp 145.458,-0.75,-0.0,0.0,0.0,145068,22.03.2019 23:50:00,16924,-0.0,80.73,IS,0.23,0.0,Phase3-EA-S4v1-GBPJPY-M5-194,GBPJPYMT4,3658,2d 3h 39m,Buy
180205.4,145067,25.03.2019 04:24:59,tp 145.067,0.0,-0.0,0.0,0.0,145457,25.03.2019 03:40:00,16925,-0.0,81.57,IS,0.23,0.0,Phase3-EA-S4v1-GBPJPY-M5-194,GBPJPYMT4,3660,44m 59s,Sell
180226.64,109941,25.03.2019 04:45:00,,-1.11,-0.0,0.0,0.0,110032,22.03.2019 22:00:00,16926,-0.0,21.24,IS,0.27,0.0,Phase3-EA-S1v2-USDJPY-M15-0,USDJPYMT4,4742,2d 6h 45m,Sell
180246.04,1.12234,25.03.2019 05:55:00,,-2.06,-0.0,0.0,0.0,1.12286,22.03.2019 21:35:00,16927,-0.0,19.4,IS,0.41,0.0,Phase3-EA-SA2v2-EURCHF-M5-43,EURCHFMT4,8666,2d 8h 20m,Sell
180258.88,0.99382,25.03.2019 06:30:00,,0.0,-0.0,0.0,0.0,0.9936,25.03.2019 02:15:00,16928,-0.0,12.84,IS,0.58,0.0,Phase3-EA-SA2v2-USDCHF-M15-107,USDCHFMT4,3366,4h 15m,Buy
180223.26,124128,25.03.2019 07:59:58,sl 124.128,0.0,-35.61999999999534,0.0,0.0,123898,25.03.2019 05:15:00,16929,-0.013179955456040976,-35.62,IS,0.17,0.0,Phase3-EA-T1v2-EURJPY-M15-322,EURJPYMT4,3368,2h 44m,Sell
180164.11,124761,25.03.2019 13:29:58,sl 124.761,-0.29,-94.77000000001863,0.0,0.0,124041,22.03.2019 20:30:00,16930,-0.03506637783743437,-59.15,IS,0.09,0.0,Phase3-EA-TR1v1-EURJPY-M30-91,EURJPYMT4,2992,2d 16h 59m,Sell
180160.95,110054,26.03.2019 04:00:00,,-0.71,-97.92999999999302,0.0,0.0,110064,25.03.2019 17:15:00,16931,-0.03623562711426641,-3.16,IS,0.27,0.0,Phase3-EA-S1v2-USDJPY-M15-0,USDJPYMT4,4744,10h 45m,Buy
180092.91,145347,26.03.2019 04:35:00,,-1.21,-165.96999999997206,0.0,0.0,145027,25.03.2019 23:10:00,16932,-0.061411488125745047,-68.04,IS,0.23,0.0,Phase3-EA-S4v1-GBPJPY-M5-194,GBPJPYMT4,3662,5h 25m,Sell
180103.91,1.12284,26.03.2019 05:10:00,,-0.99,-154.96999999997206,0.0,0.0,1.12255,25.03.2019 20:50:00,16933,-0.05734131659243596,11.0,IS,0.41,0.0,Phase3-EA-SA2v2-EURCHF-M5-43,EURCHFMT4,8668,8h 20m,Buy
180134.69,110617,27.03.2019 01:00:00,,-0.71,-124.18999999994412,0.0,0.0,110488,26.03.2019 20:00:00,16934,-0.04595223661103892,30.78,IS,0.27,0.0,Phase3-EA-S1v2-USDJPY-M15-0,USDJPYMT4,4746,5h 0m,Buy
180099.87,1.12034,27.03.2019 04:20:00,,-0.99,-159.0099999999511,0.0,0.0,1.12116,26.03.2019 20:00:00,16935,-0.058836179591934455,-34.82,IS,0.41,0.0,Phase3-EA-SA2v2-EURCHF-M5-43,EURCHFMT4,8670,8h 20m,Buy
180064.46,124535,27.03.2019 15:59:59,sl 124.535,0.0,-194.4199999999255,0.0,0.0,124305,27.03.2019 15:15:00,16936,-0.07193843177324087,-35.41,IS,0.17,0.0,Phase3-EA-T1v2-EURJPY-M15-322,EURJPYMT4,3370,44m 59s,Sell
180103.59,1.11928,28.03.2019 00:24:59,tp 1.11928,-6.18,-155.28999999992084,0.0,0.0,1.12038,27.03.2019 22:55:00,16937,-0.057459721582476905,39.13,IS,0.41,0.0,Phase3-EA-SA2v2-EURCHF-M5-43,EURCHFMT4,8672,1h 29m,Sell
180181.13,146044,28.03.2019 00:49:57,tp 146.044,-3.62,-77.74999999994179,0.0,0.0,146434,27.03.2019 23:15:00,16938,-0.028768712428594967,77.54,IS,0.23,0.0,Phase3-EA-S4v1-GBPJPY-M5-194,GBPJPYMT4,3664,1h 34m,Sell
180230.18,0.99459,28.03.2019 01:14:58,tp 0.99459,-9.27,-28.699999999953434,0.0,0.0,0.99559,27.03.2019 23:30:00,16939,-0.010619447545980116,49.05,IS,0.58,0.0,Phase3-EA-SA2v2-USDCHF-M15-107,USDCHFMT4,3368,1h 44m,Sell
180247.09,0.99486,28.03.2019 06:30:00,,0.0,-11.789999999979045,0.0,0.0,0.99457,28.03.2019 02:15:00,16940,-0.0043624838525117135,16.91,IS,0.58,0.0,Phase3-EA-SA2v2-USDCHF-M15-107,USDCHFMT4,3370,4h 15m,Buy
180218.49,145254,28.03.2019 07:30:00,,0.0,-40.38999999995576,0.0,0.0,145391,28.03.2019 02:05:00,16941,-0.014944929839106726,-28.6,IS,0.23,0.0,Phase3-EA-S4v1-GBPJPY-M5-194,GBPJPYMT4,3666,5h 25m,Buy
180254.74,1.12008,28.03.2019 09:05:00,,0.0,-4.139999999955762,0.0,0.0,1.1192,28.03.2019 00:45:00,16942,-0.001531864558883597,36.25,IS,0.41,0.0,Phase3-EA-SA2v2-EURCHF-M5-43,EURCHFMT4,8674,8h 20m,Buy
180219.34,124103,28.03.2019 16:59:58,sl 124.103,0.0,-39.539999999979045,0.0,0.0,123873,28.03.2019 16:00:00,16943,-0.01463041658426873,-35.4,IS,0.17,0.0,Phase3-EA-T1v2-EURJPY-M15-322,EURJPYMT4,3372,59m 58s,Sell
180218.39,110601,29.03.2019 01:00:00,,-0.71,-40.48999999999069,0.0,0.0,110602,28.03.2019 21:30:00,16944,-0.014981931398513369,-0.95,IS,0.27,0.0,Phase3-EA-S1v2-USDJPY-M15-0,USDJPYMT4,4748,3h 30m,Buy
180217.62,124196,29.03.2019 02:00:00,,0.0,-41.26000000000931,0.0,0.0,124201,29.03.2019 00:45:00,16945,-0.015266843405851896,-0.77,IS,0.17,0.0,Phase3-EA-T1v2-EURJPY-M15-322,EURJPYMT4,3374,1h 15m,Buy
180215.18,110611,29.03.2019 04:15:00,,0.0,-43.70000000001164,0.0,0.0,110601,29.03.2019 01:00:00,16946,-0.0161696814550595,-2.44,IS,0.27,0.0,Phase3-EA-S1v2-USDJPY-M15-0,USDJPYMT4,4750,3h 15m,Sell
180236.84,1.11796,29.03.2019 07:15:00,,-0.99,-22.040000000037253,0.0,0.0,1.11741,28.03.2019 22:55:00,16947,-0.008155143690389447,21.66,IS,0.41,0.0,Phase3-EA-SA2v2-EURCHF-M5-43,EURCHFMT4,8676,8h 20m,Buy
180285.66,1.11862,29.03.2019 10:15:00,,0.0,-0.0,0.0,0.0,1.11719,29.03.2019 01:30:00,16948,-0.0,48.82,IS,0.34,0.0,Phase3-EA-S4v1-EURCHF-M15-221,EURCHFMT4,4434,8h 45m,Buy
180250.36,124145,29.03.2019 14:29:57,sl 124.145,0.0,-35.29999999998836,0.0,0.0,124375,29.03.2019 12:45:00,16949,-0.013060256322880118,-35.3,IS,0.17,0.0,Phase3-EA-T1v2-EURJPY-M15-322,EURJPYMT4,3376,1h 44m,Buy
180208.36,1.30549,29.03.2019 14:59:58,sl 1.30549,0.0,-77.29999999998836,0.0,0.0,1.30249,29.03.2019 12:00:00,16950,-0.028599371494583966,-42.0,IS,0.14,0.0,Phase3-EA-B1v1-GBPUSD-M30-14,GBPUSDMT4,1108,2h 59m,Sell
180219.57,110794,29.03.2019 18:15:00,,0.0,-66.0899999999674,0.0,0.0,110748,29.03.2019 18:00:00,16951,-0.024451907659461924,11.21,IS,0.27,0.0,Phase3-EA-S1v2-USDJPY-M15-0,USDJPYMT4,4752,15m 0s,Buy
180242.94,110892,29.03.2019 18:30:00,,0.0,-42.71999999997206,0.0,0.0,110796,29.03.2019 18:15:00,16952,-0.015805500003208434,23.37,IS,0.27,0.0,Phase3-EA-S1v2-USDJPY-M15-0,USDJPYMT4,4754,15m 0s,Buy
180254.72,1.11776,01.04.2019 05:15:00,,-0.99,-30.93999999994412,0.0,0.0,1.11745,29.03.2019 20:55:00,16953,-0.011447148176467827,11.78,IS,0.41,0.0,Phase3-EA-SA2v2-EURCHF-M5-43,EURCHFMT4,8678,2d 8h 20m,Buy
180216.01,144795,01.04.2019 06:45:00,,0.0,-69.64999999996508,0.0,0.0,144608,01.04.2019 01:20:00,16954,-0.025769032659729293,-38.71,IS,0.23,0.0,Phase3-EA-S4v1-GBPJPY-M5-194,GBPJPYMT4,3668,5h 25m,Sell
180215.55,124651,01.04.2019 15:15:00,,0.0,-70.10999999998603,0.0,0.0,124654,01.04.2019 01:30:00,16955,-0.02593922296876047,-0.46,IS,0.17,0.0,Phase3-EA-T1v2-EURJPY-M15-322,EURJPYMT4,3378,13h 45m,Buy
180258.65,1.11876,02.04.2019 01:04:57,tp 1.11876,-2.05,-27.010000000009313,0.0,0.0,1.11986,01.04.2019 22:10:00,16956,-0.009993130971139658,43.1,IS,0.41,0.0,Phase3-EA-SA2v2-EURCHF-M5-43,EURCHFMT4,8680,2h 54m,Sell
180313.68,0.99809,02.04.2019 01:14:57,tp 0.99809,-3.08,-0.0,0.0,0.0,0.99909,01.04.2019 22:00:00,16957,-0.0,55.03,IS,0.58,0.0,Phase3-EA-SA2v2-USDCHF-M15-107,USDCHFMT4,3372,3h 14m,Sell
180326.04,111405,02.04.2019 01:45:00,,0.0,-0.0,0.0,0.0,111354,02.04.2019 01:00:00,16958,-0.0,12.36,IS,0.27,0.0,Phase3-EA-S1v2-USDJPY-M15-0,USDJPYMT4,4756,45m 0s,Buy
180284.04,1.30599,02.04.2019 01:59:58,sl 1.30599,0.0,-42.0,0.0,0.0,1.30299,02.04.2019 01:30:00,16959,-0.01553679401362883,-42.0,IS,0.14,0.0,Phase3-EA-B1v1-GBPUSD-M30-14,GBPUSDMT4,1110,29m 58s,Sell
180364.59,145594,02.04.2019 02:24:59,tp 145.594,0.0,-0.0,0.0,0.0,145204,02.04.2019 01:35:00,16960,-0.0,80.55,IS,0.23,0.0,Phase3-EA-S4v1-GBPJPY-M5-194,GBPJPYMT4,3670,49m 59s,Buy
180358.12,1.11892,02.04.2019 10:45:00,,0.0,-6.46999999997206,0.0,0.0,1.11911,02.04.2019 02:00:00,16961,-0.002393064861035257,-6.47,IS,0.34,0.0,Phase3-EA-S4v1-EURCHF-M15-221,EURCHFMT4,4436,8h 45m,Buy
180345.31,124689,02.04.2019 17:45:00,,-0.75,-19.279999999969732,0.0,0.0,124768,01.04.2019 19:30:00,16962,-0.007131111363351864,-12.81,IS,0.17,0.0,Phase3-EA-T1v2-EURJPY-M15-322,EURJPYMT4,3380,22h 15m,Buy
180390.49,1.11816,02.04.2019 21:09:58,tp 1.11816,0.0,-0.0,0.0,0.0,1.11706,02.04.2019 20:00:00,16963,-0.0,45.18,IS,0.41,0.0,Phase3-EA-SA2v2-EURCHF-M5-43,EURCHFMT4,8682,1h 9m,Buy
180354.82,124893,03.04.2019 04:44:57,sl 124.893,-0.53,-35.6699999999837,0.0,0.0,124663,02.04.2019 18:30:00,16964,-0.013192032012658284,-35.67,IS,0.17,0.0,Phase3-EA-T1v2-EURJPY-M15-322,EURJPYMT4,3382,10h 14m,Sell
180332.12,146412,03.04.2019 05:55:00,,0.0,-58.36999999999534,0.0,0.0,146302,03.04.2019 00:30:00,16965,-0.02158729768935112,-22.7,IS,0.23,0.0,Phase3-EA-S4v1-GBPJPY-M5-194,GBPJPYMT4,3672,5h 25m,Sell
180271.97,125.11,03.04.2019 05:59:58,sl 125.110,-1.98,-118.52000000001863,0.0,0.0,124.39,27.03.2019 08:00:00,16966,-0.04383290255512251,-60.15,IS,0.09,0.0,Phase3-EA-TR1v1-EURJPY-M30-91,EURJPYMT4,2994,6d 21h 59m,Sell
180420.72,147013,03.04.2019 11:29:58,tp 147.013,-0.58,-0.0,0.0,0.0,145163,01.04.2019 12:30:00,16967,-0.0,148.75,IS,0.09,0.0,Phase3-EA-B1v1-GBPJPY-M30-1,GBPJPYMT4,1530,1d 22h 59m,Buy
180459.75,1.1197,04.04.2019 01:09:58,tp 1.11970,-6.16,-0.0,0.0,0.0,1.1208,03.04.2019 20:10:00,16968,-0.0,39.03,IS,0.41,0.0,Phase3-EA-SA2v2-EURCHF-M5-43,EURCHFMT4,8684,4h 59m,Sell
180452.84,0.99738,04.04.2019 02:45:00,,-9.24,-6.909999999974389,0.0,0.0,0.99742,03.04.2019 22:30:00,16969,-0.0025549088172914336,-6.91,IS,0.58,0.0,Phase3-EA-SA2v2-USDCHF-M15-107,USDCHFMT4,3374,4h 15m,Sell
180435.8,125254,04.04.2019 04:00:00,,-2.24,-23.949999999953434,0.0,0.0,125351,03.04.2019 20:30:00,16970,-0.008855291776300674,-17.04,IS,0.17,0.0,Phase3-EA-T1v2-EURJPY-M15-322,EURJPYMT4,3384,7h 30m,Buy
180439.55,1.12151,04.04.2019 13:30:00,,0.0,-20.199999999953434,0.0,0.0,1.12162,04.04.2019 04:45:00,16971,-0.007468763836376161,3.75,IS,0.34,0.0,Phase3-EA-S4v1-EURCHF-M15-221,EURCHFMT4,4438,8h 45m,Sell
180482.67,1.12074,05.04.2019 01:09:58,tp 1.12074,-2.05,-0.0,0.0,0.0,1.12184,04.04.2019 20:00:00,16972,-0.0,43.12,IS,0.41,0.0,Phase3-EA-SA2v2-EURCHF-M5-43,EURCHFMT4,8686,5h 9m,Sell
180428.22,146447,05.04.2019 09:29:58,sl 146.447,-0.47,-54.45000000001164,0.0,0.0,145777,04.04.2019 21:30:00,16973,-0.020130679721555345,-54.45,IS,0.09,0.0,Phase3-EA-B1v1-GBPJPY-M30-1,GBPJPYMT4,1532,11h 59m,Sell
180481.6,1123,05.04.2019 10:15:00,,0.0,-1.070000000006985,0.0,0.0,1.12143,05.04.2019 01:30:00,16974,-3.955891148246139E-4,53.38,IS,0.34,0.0,Phase3-EA-S4v1-EURCHF-M15-221,EURCHFMT4,4440,8h 45m,Buy
180473.24,1.12171,08.04.2019 04:45:00,,-0.98,-9.429999999993015,0.0,0.0,1.12189,05.04.2019 20:25:00,16975,-0.0034863601427747607,-8.36,IS,0.41,0.0,Phase3-EA-SA2v2-EURCHF-M5-43,EURCHFMT4,8688,2d 8h 20m,Buy
180487.53,1.12158,08.04.2019 10:30:00,,0.0,-0.0,0.0,0.0,1.12116,08.04.2019 01:45:00,16976,-0.0,14.29,IS,0.34,0.0,Phase3-EA-S4v1-EURCHF-M15-221,EURCHFMT4,4442,8h 45m,Buy
180502.71,1.1249,09.04.2019 04:25:00,,-2.05,-0.0,0.0,0.0,1.12532,08.04.2019 20:05:00,16977,-0.0,15.18,IS,0.41,0.0,Phase3-EA-SA2v2-EURCHF-M5-43,EURCHFMT4,8690,8h 20m,Sell
180525.93,0.9992,09.04.2019 04:30:00,,0.0,-0.0,0.0,0.0,0.9988,09.04.2019 00:15:00,16978,-0.0,23.22,IS,0.58,0.0,Phase3-EA-SA2v2-USDCHF-M15-107,USDCHFMT4,3376,4h 15m,Buy
180530.29,111512,09.04.2019 04:30:00,,0.0,-0.0,0.0,0.0,111494,09.04.2019 01:00:00,16979,-0.0,4.36,IS,0.27,0.0,Phase3-EA-S1v2-USDJPY-M15-0,USDJPYMT4,4758,3h 30m,Buy
180488.29,1.30522,09.04.2019 16:29:57,sl 1.30522,0.0,-42.0,0.0,0.0,1.30822,09.04.2019 11:00:00,16980,-0.015525063755337666,-42.0,IS,0.14,0.0,Phase3-EA-B1v1-GBPUSD-M30-14,GBPUSDMT4,1112,5h 29m,Buy
180453.14,125342,09.04.2019 16:44:58,sl 125.342,0.0,-77.15000000002328,0.0,0.0,125572,09.04.2019 12:45:00,16981,-0.028518063541063392,-35.15,IS,0.17,0.0,Phase3-EA-T1v2-EURJPY-M15-322,EURJPYMT4,3386,3h 59m,Buy
180457.66,0.99957,10.04.2019 02:30:00,,-0.7,-72.63000000000466,0.0,0.0,0.99948,09.04.2019 22:15:00,16982,-0.026847270965482072,4.52,IS,0.58,0.0,Phase3-EA-SA2v2-USDCHF-M15-107,USDCHFMT4,3378,4h 15m,Buy
180469.21,111064,10.04.2019 03:45:00,,-1.09,-61.0800000000163,0.0,0.0,111116,09.04.2019 22:00:00,16983,-0.022577878432768515,11.55,IS,0.27,0.0,Phase3-EA-S1v2-USDJPY-M15-0,USDJPYMT4,4760,5h 45m,Sell
180441.53,145041,10.04.2019 04:40:00,,-1.2,-88.76000000000931,0.0,0.0,144913,09.04.2019 23:15:00,16984,-0.03280963473628371,-27.68,IS,0.23,0.0,Phase3-EA-S4v1-GBPJPY-M5-194,GBPJPYMT4,3674,5h 25m,Sell
180406.11,1.12574,10.04.2019 05:50:00,,-0.98,-124.17999999999302,0.0,0.0,1.12658,09.04.2019 21:30:00,16985,-0.04590243850327912,-35.42,IS,0.41,0.0,Phase3-EA-SA2v2-EURCHF-M5-43,EURCHFMT4,8692,8h 20m,Buy
180479.86,1.12799,10.04.2019 14:45:00,,0.0,-50.429999999993015,0.0,0.0,1.12582,10.04.2019 06:00:00,16986,-0.018641165837656428,73.75,IS,0.34,0.0,Phase3-EA-S4v1-EURCHF-M15-221,EURCHFMT4,4444,8h 45m,Buy
180488.6,1.00222,11.04.2019 03:00:00,,-9.2,-41.69000000000233,0.0,0.0,1.00253,10.04.2019 22:45:00,16987,-0.015410473999049129,8.74,IS,0.58,0.0,Phase3-EA-SA2v2-USDCHF-M15-107,USDCHFMT4,3380,4h 15m,Sell
180456.28,1.12996,11.04.2019 05:00:00,,-6.13,-74.01000000000931,0.0,0.0,1.12932,10.04.2019 20:40:00,16988,-0.02735738020315917,-32.32,IS,0.41,0.0,Phase3-EA-SA2v2-EURCHF-M5-43,EURCHFMT4,8694,8h 20m,Sell
180419.01,125512,11.04.2019 18:14:58,sl 125.512,-2.15,-111.28000000002794,0.0,0.0,125282,09.04.2019 17:00:00,16989,-0.0411340260641526,-37.27,IS,0.17,0.0,Phase3-EA-T1v2-EURJPY-M15-322,EURJPYMT4,3388,2d 1h 14m,Sell
180266.56,111587,12.04.2019 03:45:00,,-4.37,-263.7300000000396,0.0,0.0,110975,10.04.2019 23:00:00,16990,-0.09748631105228137,-152.45,IS,0.27,0.0,Phase3-EA-S1v2-USDJPY-M15-0,USDJPYMT4,4762,1d 4h 45m,Sell
180310.55,1.13039,12.04.2019 04:39:57,tp 1.13039,-0.98,-219.7400000000489,0.0,0.0,1.12929,11.04.2019 20:20:00,16991,-0.08122565499044423,43.99,IS,0.41,0.0,Phase3-EA-SA2v2-EURCHF-M5-43,EURCHFMT4,8696,8h 19m,Buy
180244.58,125935,12.04.2019 04:59:57,sl 125.935,-3.1,-285.71000000002095,0.0,0.0,125155,03.04.2019 17:30:00,16992,-0.10561109441756786,-65.97,IS,0.09,0.0,Phase3-EA-TR1v1-EURJPY-M30-91,EURJPYMT4,2996,8d 11h 29m,Sell
180343.08,126567,12.04.2019 12:59:58,tp 126.567,-2.78,-187.21000000002095,0.0,0.0,125307,05.04.2019 03:30:00,16993,-0.06920112346754975,98.5,IS,0.09,0.0,Phase3-EA-TR1v1-EURJPY-M30-91,EURJPYMT4,2997,7d 9h 29m,Buy
180387.1,1.13306,15.04.2019 03:29:58,tp 1.13306,-0.98,-143.19000000000233,0.0,0.0,1.13196,12.04.2019 21:35:00,16994,-0.05292937807444849,44.02,IS,0.41,0.0,Phase3-EA-SA2v2-EURCHF-M5-43,EURCHFMT4,8698,2d 5h 54m,Buy
180379.29,146571,15.04.2019 09:15:00,,0.0,-151.0,0.0,0.0,146533,15.04.2019 03:50:00,16995,-0.05581630064419018,-7.81,IS,0.23,0.0,Phase3-EA-S4v1-GBPJPY-M5-194,GBPJPYMT4,3676,5h 25m,Sell
180365.62,126568,15.04.2019 11:00:00,,0.0,-164.6699999999837,0.0,0.0,126658,15.04.2019 03:30:00,16996,-0.06086933925217144,-13.67,IS,0.17,0.0,Phase3-EA-T1v2-EURJPY-M15-322,EURJPYMT4,3390,7h 30m,Buy
180332.02,1.13401,15.04.2019 12:30:00,,0.0,-198.26999999996042,0.0,0.0,1.13302,15.04.2019 03:45:00,16997,-0.07328939025643297,-33.6,IS,0.34,0.0,Phase3-EA-S4v1-EURCHF-M15-221,EURCHFMT4,4446,8h 45m,Sell
180321.55,126586,15.04.2019 20:30:00,,0.0,-208.73999999993248,0.0,0.0,126655,15.04.2019 11:45:00,16998,-0.07715956686400324,-10.47,IS,0.17,0.0,Phase3-EA-T1v2-EURJPY-M15-322,EURJPYMT4,3392,8h 45m,Buy
180311.34,1.13496,16.04.2019 04:20:00,,-2.04,-218.94999999995343,0.0,0.0,1.13476,15.04.2019 20:00:00,16999,-0.08093363593405854,-10.21,IS,0.41,0.0,Phase3-EA-SA2v2-EURCHF-M5-43,EURCHFMT4,8700,8h 20m,Sell
180359.26,1.00468,16.04.2019 06:00:00,,0.0,-171.02999999996973,0.0,0.0,1.00385,16.04.2019 01:45:00,17000,-0.06322027747797455,47.92,IS,0.58,0.0,Phase3-EA-SA2v2-USDCHF-M15-107,USDCHFMT4,3382,4h 15m,Buy
180404.03,1.13787,17.04.2019 05:59:58,tp 1.13787,0.0,-126.2599999999511,0.0,0.0,1.13677,17.04.2019 00:35:00,17001,-0.046671298803527966,44.77,IS,0.41,0.0,Phase3-EA-SA2v2-EURCHF-M5-43,EURCHFMT4,8702,5h 24m,Buy
180368.59,126647,17.04.2019 10:14:58,sl 126.647,-0.53,-161.69999999995343,0.0,0.0,126417,16.04.2019 19:15:00,17002,-0.0597714954580328,-35.44,IS,0.17,0.0,Phase3-EA-T1v2-EURJPY-M15-322,EURJPYMT4,3394,14h 59m,Sell
180369.22,1.01054,18.04.2019 02:30:00,,-9.13,-161.06999999994878,0.0,0.0,1.01071,17.04.2019 22:15:00,17003,-0.059538619501701015,0.63,IS,0.58,0.0,Phase3-EA-SA2v2-USDCHF-M15-107,USDCHFMT4,3384,4h 15m,Sell
180348.12,1.14166,18.04.2019 04:55:00,,-6.09,-182.1699999999255,0.0,0.0,1.14129,17.04.2019 20:35:00,17004,-0.06733811581687395,-21.1,IS,0.41,0.0,Phase3-EA-SA2v2-EURCHF-M5-43,EURCHFMT4,8704,8h 20m,Sell
180378.04,145954,18.04.2019 05:15:00,,-3.57,-152.2499999999418,0.0,0.0,146117,17.04.2019 23:50:00,17005,-0.05627835611307752,29.92,IS,0.23,0.0,Phase3-EA-S4v1-GBPJPY-M5-194,GBPJPYMT4,3678,5h 25m,Sell
180246.77,1.13739,18.04.2019 12:14:58,sl 1.13739,0.0,-283.5199999999604,0.0,0.0,1.14129,18.04.2019 06:15:00,17006,-0.10480157323601716,-131.27,IS,0.34,0.0,Phase3-EA-S4v1-EURCHF-M15-221,EURCHFMT4,4448,5h 59m,Buy
180186.44,125823,18.04.2019 12:29:58,sl 125.823,-2.35,-343.8499999999767,0.0,0.0,126543,12.04.2019 13:00:00,17007,-0.12710221838744035,-60.33,IS,0.09,0.0,Phase3-EA-TR1v1-EURJPY-M30-91,EURJPYMT4,3000,5d 23h 29m,Buy
180228.84,1.13947,19.04.2019 01:04:57,tp 1.13947,-2.02,-301.44999999995343,0.0,0.0,1.14057,18.04.2019 20:05:00,17008,-0.11142929688204326,42.4,IS,0.41,0.0,Phase3-EA-SA2v2-EURCHF-M5-43,EURCHFMT4,8706,4h 59m,Sell
180286.01,1.01444,19.04.2019 01:14:58,tp 1.01444,0.0,-244.27999999996973,0.0,0.0,1.01544,19.04.2019 00:15:00,17009,-0.09029672795603369,57.17,IS,0.58,0.0,Phase3-EA-SA2v2-USDCHF-M15-107,USDCHFMT4,3386,59m 58s,Sell
180321.9,1.13979,19.04.2019 14:15:00,,0.0,-208.38999999995576,0.0,0.0,1.14086,19.04.2019 05:30:00,17010,-0.07703019133271737,35.89,IS,0.34,0.0,Phase3-EA-S4v1-EURCHF-M15-221,EURCHFMT4,4450,8h 45m,Sell
180366.34,1.14053,22.04.2019 02:09:57,tp 1.14053,0.0,-163.94999999995343,0.0,0.0,1.13943,22.04.2019 01:00:00,17011,-0.060603195302068744,44.44,IS,0.41,0.0,Phase3-EA-SA2v2-EURCHF-M5-43,EURCHFMT4,8708,1h 9m,Buy
180393.46,145413,22.04.2019 06:30:00,,0.0,-136.8299999999581,0.0,0.0,145281,22.04.2019 01:05:00,17012,-0.05057843984862386,27.12,IS,0.23,0.0,Phase3-EA-S4v1-GBPJPY-M5-194,GBPJPYMT4,3680,5h 25m,Buy
180417.25,1.14069,22.04.2019 10:00:00,,0.0,-113.03999999997905,0.0,0.0,1.13998,22.04.2019 01:15:00,17013,-0.0417846001643582,23.79,IS,0.34,0.0,Phase3-EA-S4v1-EURCHF-M15-221,EURCHFMT4,4452,8h 45m,Buy
180459.63,1.14212,23.04.2019 01:04:57,tp 1.14212,-2.02,-70.65999999997439,0.0,0.0,1.14322,22.04.2019 20:00:00,17014,-0.02611907154647052,42.38,IS,0.41,0.0,Phase3-EA-SA2v2-EURCHF-M5-43,EURCHFMT4,8710,5h 4m,Sell
180481.73,1.01536,23.04.2019 03:30:00,,-3.03,-48.55999999999767,0.0,0.0,1.0158,22.04.2019 23:15:00,17015,-0.0179499308561705,22.1,IS,0.58,0.0,Phase3-EA-SA2v2-USDCHF-M15-107,USDCHFMT4,3388,4h 15m,Sell
180454.16,145116,23.04.2019 06:35:00,,0.0,-76.13000000000466,0.0,0.0,145.25,23.04.2019 01:10:00,17016,-0.028141026278426875,-27.57,IS,0.23,0.0,Phase3-EA-S4v1-GBPJPY-M5-194,GBPJPYMT4,3682,5h 25m,Buy
180456.18,1.14297,23.04.2019 09:25:00,,0.0,-74.10999999998603,0.0,0.0,1.14292,23.04.2019 01:05:00,17017,-0.027394344640663273,2.02,IS,0.41,0.0,Phase3-EA-SA2v2-EURCHF-M5-43,EURCHFMT4,8712,8h 20m,Buy
180589.68,1.14686,23.04.2019 13:44:58,tp 1.14686,0.0,-0.0,0.0,0.0,1.14286,23.04.2019 05:15:00,17018,-0.0,133.5,IS,0.34,0.0,Phase3-EA-S4v1-EURCHF-M15-221,EURCHFMT4,4454,8h 29m,Buy
180546.62,1.29728,23.04.2019 16:59:58,sl 1.29728,-1.06,-43.05999999999767,0.0,0.0,1.30028,19.04.2019 15:30:00,17019,-0.015913393297186183,-43.06,IS,0.14,0.0,Phase3-EA-B1v1-GBPUSD-M30-14,GBPUSDMT4,1114,4d 1h 29m,Buy
180589.88,1.14514,24.04.2019 01:09:58,tp 1.14514,-0.96,-0.0,0.0,0.0,1.14404,23.04.2019 21:55:00,17020,-0.0,43.26,IS,0.41,0.0,Phase3-EA-SA2v2-EURCHF-M5-43,EURCHFMT4,8714,3h 14m,Buy
180574.42,1.02013,24.04.2019 02:30:00,,-0.68,-15.460000000020955,0.0,0.0,1.02039,23.04.2019 22:15:00,17021,-0.005713443533077034,-15.46,IS,0.58,0.0,Phase3-EA-SA2v2-USDCHF-M15-107,USDCHFMT4,3390,4h 15m,Buy
180556.67,1.13851,25.04.2019 04:55:00,,-2.89,-33.210000000020955,0.0,0.0,1.13888,24.04.2019 20:35:00,17022,-0.012273186269945075,-17.75,IS,0.41,0.0,Phase3-EA-SA2v2-EURCHF-M5-43,EURCHFMT4,8716,8h 20m,Buy
180567.66,1.13846,25.04.2019 10:30:00,,0.0,-22.220000000030268,0.0,0.0,1.13813,25.04.2019 01:45:00,17023,-0.0082116892176567,10.99,IS,0.34,0.0,Phase3-EA-S4v1-EURCHF-M15-221,EURCHFMT4,4456,8h 45m,Buy
180822.29,124753,25.04.2019 11:14:58,tp 124.753,-3.71,-0.0,0.0,0.0,126453,18.04.2019 04:30:00,17024,-0.0,254.63,IS,0.17,0.0,Phase3-EA-T1v2-EURJPY-M15-322,EURJPYMT4,3396,7d 6h 44m,Sell
180922.0,124434,25.04.2019 17:59:58,tp 124.434,-1.96,-0.0,0.0,0.0,125694,18.04.2019 21:30:00,17025,-0.0,99.71,IS,0.09,0.0,Phase3-EA-TR1v1-EURJPY-M30-91,EURJPYMT4,3002,6d 20h 29m,Sell
180931.56,111572,26.04.2019 03:15:00,,-1.09,-0.0,0.0,0.0,111616,25.04.2019 22:30:00,17026,-0.0,9.56,IS,0.27,0.0,Phase3-EA-S1v2-USDJPY-M15-0,USDJPYMT4,4764,4h 45m,Sell
180915.64,1.01979,26.04.2019 06:30:00,,0.0,-15.919999999983702,0.0,0.0,1.02007,26.04.2019 02:15:00,17027,-0.005876022712150498,-15.92,IS,0.58,0.0,Phase3-EA-SA2v2-USDCHF-M15-107,USDCHFMT4,3392,4h 15m,Buy
180928.9,1.13597,26.04.2019 09:25:00,,0.0,-2.6599999999743886,0.0,0.0,1.13564,26.04.2019 01:05:00,17028,-9.817977647101654E-4,13.26,IS,0.41,0.0,Phase3-EA-SA2v2-EURCHF-M5-43,EURCHFMT4,8718,8h 20m,Buy
180950.23,1.13625,26.04.2019 10:15:00,,0.0,-0.0,0.0,0.0,1.13561,26.04.2019 01:30:00,17029,-0.0,21.33,IS,0.34,0.0,Phase3-EA-S4v1-EURCHF-M15-221,EURCHFMT4,4458,8h 45m,Buy
180905.48,1.29397,26.04.2019 18:59:58,sl 1.29397,-2.75,-44.75,0.0,0.0,1.29097,24.04.2019 22:30:00,17030,-0.016515948334865728,-44.75,IS,0.14,0.0,Phase3-EA-B1v1-GBPUSD-M30-14,GBPUSDMT4,1116,1d 20h 29m,Sell
180927.63,111527,29.04.2019 01:00:00,,-1.09,-22.599999999976717,0.0,0.0,111623,26.04.2019 22:45:00,17031,-0.00834101524843756,22.15,IS,0.27,0.0,Phase3-EA-S1v2-USDJPY-M15-0,USDJPYMT4,4766,2d 2h 15m,Sell
180931.08,1.13659,29.04.2019 04:35:00,,-0.97,-19.149999999965075,0.0,0.0,1.13648,26.04.2019 20:15:00,17032,-0.007067718672896131,3.45,IS,0.41,0.0,Phase3-EA-SA2v2-EURCHF-M5-43,EURCHFMT4,8720,2d 8h 20m,Buy
180959.1,1.13706,29.04.2019 10:00:00,,0.0,-0.0,0.0,0.0,1.13622,29.04.2019 01:15:00,17033,-0.0,28.02,IS,0.34,0.0,Phase3-EA-S4v1-EURCHF-M15-221,EURCHFMT4,4460,8h 45m,Buy
180904.19,144669,29.04.2019 12:29:58,sl 144.669,-0.94,-54.90999999997439,0.0,0.0,143999,25.04.2019 16:30:00,17034,-0.020265051072274085,-54.91,IS,0.09,0.0,Phase3-EA-B1v1-GBPJPY-M30-1,GBPJPYMT4,1534,3d 19h 59m,Sell
180845.65,124993,29.04.2019 20:59:58,sl 124.993,-0.56,-113.44999999995343,0.0,0.0,124273,25.04.2019 19:00:00,17035,-0.041869787728093674,-58.54,IS,0.09,0.0,Phase3-EA-TR1v1-EURJPY-M30-91,EURJPYMT4,3004,4d 1h 59m,Sell
180903.05,124953,30.04.2019 03:30:00,,-0.75,-56.04999999993015,0.0,0.0,124571,29.04.2019 07:00:00,17036,-0.020685778776180597,57.4,IS,0.17,0.0,Phase3-EA-T1v2-EURJPY-M15-322,EURJPYMT4,3398,20h 30m,Buy
180873.29,1.14018,30.04.2019 04:40:00,,-2.01,-85.80999999993946,0.0,0.0,1.13949,29.04.2019 20:20:00,17037,-0.031668986204906636,-29.76,IS,0.41,0.0,Phase3-EA-SA2v2-EURCHF-M5-43,EURCHFMT4,8722,8h 20m,Sell
180825.14,144.29,30.04.2019 05:05:00,,-0.74,-133.95999999996275,0.0,0.0,144.52,29.04.2019 23:40:00,17038,-0.04943919580481419,-48.15,IS,0.23,0.0,Phase3-EA-S4v1-GBPJPY-M5-194,GBPJPYMT4,3684,5h 25m,Buy
180838.8,1.0193,30.04.2019 06:15:00,,0.0,-120.29999999998836,0.0,0.0,1.01906,30.04.2019 02:00:00,17039,-0.04439784454553767,13.66,IS,0.58,0.0,Phase3-EA-SA2v2-USDCHF-M15-107,USDCHFMT4,3394,4h 15m,Buy
180803.73,124729,30.04.2019 09:59:58,sl 124.729,0.0,-155.36999999999534,0.0,0.0,124959,30.04.2019 03:45:00,17040,-0.05734075733200872,-35.07,IS,0.17,0.0,Phase3-EA-T1v2-EURJPY-M15-322,EURJPYMT4,3400,6h 14m,Buy
180715.34,1.14308,30.04.2019 15:30:00,,0.0,-243.7600000000093,0.0,0.0,1.14043,30.04.2019 06:45:00,17041,-0.08996191676161033,-88.39,IS,0.34,0.0,Phase3-EA-S4v1-EURCHF-M15-221,EURCHFMT4,4462,8h 45m,Sell
180757.6,1.14218,01.05.2019 01:24:57,tp 1.14218,-2.01,-201.5,0.0,0.0,1.14328,30.04.2019 22:05:00,17042,-0.07436546696530928,42.26,IS,0.41,0.0,Phase3-EA-SA2v2-EURCHF-M5-43,EURCHFMT4,8724,3h 19m,Sell
180801.86,1.14338,01.05.2019 07:14:57,tp 1.14338,0.0,-157.2399999999907,0.0,0.0,1.14228,01.05.2019 01:35:00,17043,-0.05803089839019622,44.26,IS,0.41,0.0,Phase3-EA-SA2v2-EURCHF-M5-43,EURCHFMT4,8726,5h 39m,Buy
180801.92,1.01736,02.05.2019 03:30:00,,-9.06,-157.17999999999302,0.0,0.0,1.01752,01.05.2019 23:15:00,17044,-0.058008754826832716,0.06,IS,0.58,0.0,Phase3-EA-SA2v2-USDCHF-M15-107,USDCHFMT4,3396,4h 15m,Sell
180794.99,1.14035,02.05.2019 06:25:00,,-2.9,-164.10999999998603,0.0,0.0,1.14045,01.05.2019 22:05:00,17045,-0.06056633639541373,-6.93,IS,0.41,0.0,Phase3-EA-SA2v2-EURCHF-M5-43,EURCHFMT4,8728,8h 20m,Buy
180875.36,145699,02.05.2019 06:29:57,tp 145.699,0.0,-83.73999999999069,0.0,0.0,145309,02.05.2019 01:15:00,17046,-0.030905033268855117,80.37,IS,0.23,0.0,Phase3-EA-S4v1-GBPJPY-M5-194,GBPJPYMT4,3686,5h 14m,Buy
180896.08,1.14007,02.05.2019 09:45:00,,0.0,-63.02000000001863,0.0,0.0,1.13945,02.05.2019 01:00:00,17047,-0.02325812272037308,20.72,IS,0.34,0.0,Phase3-EA-S4v1-EURCHF-M15-221,EURCHFMT4,4464,8h 45m,Buy
180861.0,125092,02.05.2019 11:59:57,sl 125.092,0.0,-98.10000000003492,0.0,0.0,124862,02.05.2019 11:30:00,17048,-0.03620472610074162,-35.08,IS,0.17,0.0,Phase3-EA-T1v2-EURJPY-M15-322,EURJPYMT4,3402,29m 57s,Sell
180861.39,1.01924,03.05.2019 03:30:00,,-3.02,-97.71000000002095,0.0,0.0,1.0193,02.05.2019 23:15:00,17049,-0.03606079293886813,0.39,IS,0.58,0.0,Phase3-EA-SA2v2-USDCHF-M15-107,USDCHFMT4,3398,4h 15m,Sell
180877.72,1.13901,03.05.2019 04:25:00,,-0.97,-81.38000000000466,0.0,0.0,1.13858,02.05.2019 20:05:00,17050,-0.03003405310986211,16.33,IS,0.41,0.0,Phase3-EA-SA2v2-EURCHF-M5-43,EURCHFMT4,8730,8h 20m,Buy
181139.13,1.31205,03.05.2019 18:59:58,tp 1.31205,-3.19,-0.0,0.0,0.0,1.29315,29.04.2019 08:00:00,17051,-0.0,261.41,IS,0.14,0.0,Phase3-EA-B1v1-GBPUSD-M30-14,GBPUSDMT4,1118,4d 10h 59m,Buy
181241.95,123632,06.05.2019 01:00:00,tp 123.632,-1.69,-0.0,0.0,0.0,124922,30.04.2019 00:30:00,17052,-0.0,102.82,IS,0.09,0.0,Phase3-EA-TR1v1-EURJPY-M30-91,EURJPYMT4,3006,6d 0h 30m,Sell
181299.0,1.01674,06.05.2019 01:59:58,tp 1.01674,0.0,-0.0,0.0,0.0,1.01574,06.05.2019 01:00:00,17053,-0.0,57.05,IS,0.58,0.0,Phase3-EA-SA2v2-USDCHF-M15-107,USDCHFMT4,3400,59m 58s,Buy
181400.99,123529,06.05.2019 04:59:58,tp 123.529,-0.56,-0.0,0.0,0.0,124789,02.05.2019 02:00:00,17054,-0.0,101.99,IS,0.09,0.0,Phase3-EA-TR1v1-EURJPY-M30-91,EURJPYMT4,3007,4d 2h 59m,Sell
181337.11,145.23,06.05.2019 06:35:00,,0.0,-63.88000000000466,0.0,0.0,145537,06.05.2019 01:10:00,17055,-0.023537128586010116,-63.88,IS,0.23,0.0,Phase3-EA-S4v1-GBPJPY-M5-194,GBPJPYMT4,3688,5h 25m,Buy
181361.54,1.13717,06.05.2019 10:45:00,,0.0,-39.45000000001164,0.0,0.0,1.13644,06.05.2019 02:00:00,17056,-0.014535687581689188,24.43,IS,0.34,0.0,Phase3-EA-S4v1-EURCHF-M15-221,EURCHFMT4,4466,8h 45m,Buy
181441.46,144873,07.05.2019 01:04:58,tp 144.873,-1.2,-0.0,0.0,0.0,145263,06.05.2019 23:00:00,17057,-0.0,79.92,IS,0.23,0.0,Phase3-EA-S4v1-GBPJPY-M5-194,GBPJPYMT4,3690,2h 4m,Sell
181433.23,1.13927,07.05.2019 05:00:00,,-0.97,-8.229999999981374,0.0,0.0,1.13945,06.05.2019 20:40:00,17058,-0.003031961292862685,-8.23,IS,0.41,0.0,Phase3-EA-SA2v2-EURCHF-M5-43,EURCHFMT4,8732,8h 20m,Buy
181493.28,145153,07.05.2019 06:35:00,,0.0,-0.0,0.0,0.0,144864,07.05.2019 01:10:00,17059,-0.0,60.05,IS,0.23,0.0,Phase3-EA-S4v1-GBPJPY-M5-194,GBPJPYMT4,3692,5h 25m,Buy
181500.3,1.13955,07.05.2019 10:45:00,,0.0,-0.0,0.0,0.0,1.13934,07.05.2019 02:00:00,17060,-0.0,7.02,IS,0.34,0.0,Phase3-EA-S4v1-EURCHF-M15-221,EURCHFMT4,4468,8h 45m,Buy
181458.3,1.30829,07.05.2019 13:59:58,sl 1.30829,0.0,-42.0,0.0,0.0,1.31129,07.05.2019 06:00:00,17061,-0.015469596166192031,-42.0,IS,0.14,0.0,Phase3-EA-B1v1-GBPUSD-M30-14,GBPUSDMT4,1120,7h 59m,Buy
181402.02,144697,07.05.2019 13:59:58,sl 144.697,-1.74,-98.28000000002794,0.0,0.0,145367,01.05.2019 06:30:00,17062,-0.03619885502889964,-56.28,IS,0.09,0.0,Phase3-EA-B1v1-GBPJPY-M30-1,GBPJPYMT4,1536,6d 7h 29m,Buy
181342.97,123533,07.05.2019 18:29:57,sl 123.533,-0.4,-157.3300000000163,0.0,0.0,124253,06.05.2019 23:30:00,17063,-0.05794837059112487,-59.05,IS,0.09,0.0,Phase3-EA-TR1v1-EURJPY-M30-91,EURJPYMT4,3010,18h 59m,Buy
181339.45,1.01958,08.05.2019 03:15:00,,-0.68,-160.85000000003492,0.0,0.0,1.01963,07.05.2019 23:00:00,17064,-0.05924487007934592,-3.52,IS,0.58,0.0,Phase3-EA-SA2v2-USDCHF-M15-107,USDCHFMT4,3402,4h 15m,Buy
181368.85,110189,08.05.2019 04:15:00,,0.0,-131.45000000001164,0.0,0.0,110309,08.05.2019 00:30:00,17065,-0.04841615276300292,29.4,IS,0.27,0.0,Phase3-EA-S1v2-USDJPY-M15-0,USDJPYMT4,4768,3h 45m,Sell
181353.0,1.14095,08.05.2019 04:45:00,,-0.97,-147.29999999998836,0.0,0.0,1.14132,07.05.2019 20:25:00,17066,-0.054254083697140625,-15.85,IS,0.41,0.0,Phase3-EA-SA2v2-EURCHF-M5-43,EURCHFMT4,8734,8h 20m,Buy
181409.88,1.01967,09.05.2019 01:14:58,tp 1.01967,0.0,-90.4199999999837,0.0,0.0,1.02067,09.05.2019 00:45:00,17067,-0.03330383060349598,56.88,IS,0.58,0.0,Phase3-EA-SA2v2-USDCHF-M15-107,USDCHFMT4,3404,29m 58s,Sell
181366.97,142903,09.05.2019 06:40:00,,0.0,-133.3299999999581,0.0,0.0,143108,09.05.2019 01:15:00,17068,-0.04910860135327941,-42.91,IS,0.23,0.0,Phase3-EA-S4v1-GBPJPY-M5-194,GBPJPYMT4,3694,5h 25m,Buy
181320.38,1.14218,09.05.2019 06:40:00,,-6.03,-179.9199999999837,0.0,0.0,1.14117,08.05.2019 22:20:00,17069,-0.06626880338621471,-46.59,IS,0.41,0.0,Phase3-EA-SA2v2-EURCHF-M5-43,EURCHFMT4,8736,8h 20m,Sell
181295.06,1.14243,09.05.2019 09:45:00,,0.0,-205.2399999999907,0.0,0.0,1.14167,09.05.2019 01:00:00,17070,-0.07559475993212163,-25.32,IS,0.34,0.0,Phase3-EA-S4v1-EURCHF-M15-221,EURCHFMT4,4470,8h 45m,Sell
181555.21,122678,09.05.2019 11:59:58,tp 122.678,-3.24,-0.0,0.0,0.0,124378,03.05.2019 23:15:00,17071,-0.0,260.15,IS,0.17,0.0,Phase3-EA-T1v2-EURJPY-M15-322,EURJPYMT4,3404,5d 12h 44m,Sell
181597.62,1.13787,10.05.2019 01:04:57,tp 1.13787,-2.02,-0.0,0.0,0.0,1.13897,09.05.2019 21:55:00,17072,-0.0,42.41,IS,0.41,0.0,Phase3-EA-SA2v2-EURCHF-M5-43,EURCHFMT4,8738,3h 9m,Sell
181654.82,1.01406,10.05.2019 01:14:57,tp 1.01406,0.0,-0.0,0.0,0.0,1.01506,10.05.2019 01:00:00,17073,-0.0,57.2,IS,0.58,0.0,Phase3-EA-SA2v2-USDCHF-M15-107,USDCHFMT4,3406,14m 57s,Sell
181699.24,1.13893,10.05.2019 03:14:58,tp 1.13893,0.0,-0.0,0.0,0.0,1.13783,10.05.2019 01:10:00,17074,-0.0,44.42,IS,0.41,0.0,Phase3-EA-SA2v2-EURCHF-M5-43,EURCHFMT4,8740,2h 4m,Buy
181743.28,142966,10.05.2019 04:50:00,,-0.75,-0.0,0.0,0.0,142752,09.05.2019 23:25:00,17075,-0.0,44.04,IS,0.23,0.0,Phase3-EA-S4v1-GBPJPY-M5-194,GBPJPYMT4,3696,5h 25m,Buy
181771.1,1.13857,10.05.2019 10:15:00,,0.0,-0.0,0.0,0.0,1.13774,10.05.2019 01:30:00,17076,-0.0,27.82,IS,0.34,0.0,Phase3-EA-S4v1-EURCHF-M15-221,EURCHFMT4,4472,8h 45m,Buy
181749.38,123202,10.05.2019 19:00:00,,0.0,-21.71999999997206,0.0,0.0,123342,10.05.2019 12:45:00,17077,-0.007992019754849575,-21.72,IS,0.17,0.0,Phase3-EA-T1v2-EURJPY-M15-322,EURJPYMT4,3406,6h 15m,Buy
181806.71,1.0117,13.05.2019 01:29:57,tp 1.01170,0.0,-0.0,0.0,0.0,1.0107,13.05.2019 01:00:00,17078,-0.0,57.33,IS,0.58,0.0,Phase3-EA-SA2v2-USDCHF-M15-107,USDCHFMT4,3408,29m 57s,Buy
181849.25,1.13592,13.05.2019 01:34:58,tp 1.13592,-2.03,-0.0,0.0,0.0,1.13702,10.05.2019 21:30:00,17079,-0.0,42.54,IS,0.41,0.0,Phase3-EA-SA2v2-EURCHF-M5-43,EURCHFMT4,8742,2d 4h 4m,Sell
181864.97,142755,13.05.2019 06:35:00,,0.0,-0.0,0.0,0.0,142.68,13.05.2019 01:10:00,17080,-0.0,15.72,IS,0.23,0.0,Phase3-EA-S4v1-GBPJPY-M5-194,GBPJPYMT4,3698,5h 25m,Buy
181843.11,1.13531,13.05.2019 09:45:00,,0.0,-21.85999999998603,0.0,0.0,1.13596,13.05.2019 01:00:00,17081,-0.008040756409325542,-21.86,IS,0.34,0.0,Phase3-EA-S4v1-EURCHF-M15-221,EURCHFMT4,4474,8h 45m,Buy
181993.23,142077,13.05.2019 17:59:58,tp 142.077,-2.37,-0.0,0.0,0.0,143927,08.05.2019 06:00:00,17082,-0.0,150.12,IS,0.09,0.0,Phase3-EA-B1v1-GBPJPY-M30-1,GBPJPYMT4,1538,5d 11h 59m,Sell
182009.68,109182,14.05.2019 03:45:00,,-1.11,-0.0,0.0,0.0,109253,13.05.2019 21:45:00,17083,-0.0,16.45,IS,0.27,0.0,Phase3-EA-S1v2-USDJPY-M15-0,USDJPYMT4,4770,6h 0m,Sell
181981.79,1.1299,14.05.2019 04:35:00,,-0.98,-27.89000000001397,0.0,0.0,1.13056,13.05.2019 20:15:00,17084,-0.010253311573328525,-27.89,IS,0.41,0.0,Phase3-EA-SA2v2-EURCHF-M5-43,EURCHFMT4,8744,8h 20m,Buy
182063.77,141947,14.05.2019 05:34:58,tp 141.947,0.0,-0.0,0.0,0.0,141557,14.05.2019 01:15:00,17085,-0.0,81.98,IS,0.23,0.0,Phase3-EA-S4v1-GBPJPY-M5-194,GBPJPYMT4,3700,4h 19m,Buy
182121.38,1.00675,14.05.2019 06:29:58,tp 1.00675,0.0,-0.0,0.0,0.0,1.00575,14.05.2019 02:15:00,17086,-0.0,57.61,IS,0.58,0.0,Phase3-EA-SA2v2-USDCHF-M15-107,USDCHFMT4,3410,4h 14m,Buy
182212.49,1.13171,14.05.2019 11:45:00,,0.0,-0.0,0.0,0.0,1.12901,14.05.2019 03:00:00,17087,-0.0,91.11,IS,0.34,0.0,Phase3-EA-S4v1-EURCHF-M15-221,EURCHFMT4,4476,8h 45m,Buy
182255.16,1.13017,15.05.2019 00:54:58,tp 1.13017,-2.03,-0.0,0.0,0.0,1.13127,14.05.2019 20:50:00,17088,-0.0,42.67,IS,0.41,0.0,Phase3-EA-SA2v2-EURCHF-M5-43,EURCHFMT4,8746,4h 4m,Sell
182284.43,1.13067,15.05.2019 09:35:00,,0.0,-0.0,0.0,0.0,1.12995,15.05.2019 01:15:00,17089,-0.0,29.27,IS,0.41,0.0,Phase3-EA-SA2v2-EURCHF-M5-43,EURCHFMT4,8748,8h 20m,Buy
182299.6,1.13044,15.05.2019 10:30:00,,0.0,-0.0,0.0,0.0,1.12999,15.05.2019 01:45:00,17090,-0.0,15.17,IS,0.34,0.0,Phase3-EA-S4v1-EURCHF-M15-221,EURCHFMT4,4478,8h 45m,Buy
182401.16,122075,15.05.2019 16:59:58,tp 122.075,-2.31,-0.0,0.0,0.0,123335,07.05.2019 20:00:00,17091,-0.0,101.56,IS,0.09,0.0,Phase3-EA-TR1v1-EURJPY-M30-91,EURJPYMT4,3012,7d 20h 59m,Sell
182365.43,122973,15.05.2019 18:29:58,sl 122.973,0.0,-35.72999999998137,0.0,0.0,122743,15.05.2019 11:45:00,17092,-0.013116684231440596,-35.73,IS,0.17,0.0,Phase3-EA-T1v2-EURJPY-M15-322,EURJPYMT4,3408,6h 44m,Sell
182404.04,1.12978,16.05.2019 00:34:57,tp 1.12978,-6.1,-0.0,0.0,0.0,1.13088,15.05.2019 20:10:00,17093,-0.0,38.61,IS,0.41,0.0,Phase3-EA-SA2v2-EURCHF-M5-43,EURCHFMT4,8750,4h 24m,Sell
182369.14,109.47,16.05.2019 03:45:00,,-3.33,-34.90000000002328,0.0,0.0,109342,15.05.2019 18:00:00,17094,-0.01281185110177631,-34.9,IS,0.27,0.0,Phase3-EA-S1v2-USDJPY-M15-0,USDJPYMT4,4772,9h 45m,Sell
182382.56,1.13018,16.05.2019 09:00:00,,0.0,-21.48000000003958,0.0,0.0,1.12985,16.05.2019 00:40:00,17095,-0.007885345606489359,13.42,IS,0.41,0.0,Phase3-EA-SA2v2-EURCHF-M5-43,EURCHFMT4,8752,8h 20m,Buy
182436.14,1.13106,16.05.2019 14:15:00,,0.0,-0.0,0.0,0.0,1.12947,16.05.2019 05:30:00,17096,-0.0,53.58,IS,0.34,0.0,Phase3-EA-S4v1-EURCHF-M15-221,EURCHFMT4,4480,8h 45m,Buy
182435.68,109854,17.05.2019 02:00:00,,-0.71,-0.46000000002095476,0.0,0.0,109853,16.05.2019 22:30:00,17097,-1.6884690849787898E-4,-0.46,IS,0.27,0.0,Phase3-EA-S1v2-USDJPY-M15-0,USDJPYMT4,4774,3h 30m,Buy
182442.46,1.00984,17.05.2019 02:30:00,,-0.69,-0.0,0.0,0.0,1.00971,16.05.2019 22:15:00,17098,-0.0,6.78,IS,0.58,0.0,Phase3-EA-SA2v2-USDCHF-M15-107,USDCHFMT4,3412,4h 15m,Buy
182453.67,1.12878,17.05.2019 05:35:00,,-0.97,-0.0,0.0,0.0,1.12848,16.05.2019 21:15:00,17099,-0.0,11.21,IS,0.41,0.0,Phase3-EA-SA2v2-EURCHF-M5-43,EURCHFMT4,8754,8h 20m,Buy
182417.23,122509,17.05.2019 09:44:58,sl 122.509,-0.76,-36.44000000000233,0.0,0.0,122739,16.05.2019 07:45:00,17100,-0.013374751017302216,-36.44,IS,0.17,0.0,Phase3-EA-T1v2-EURJPY-M15-322,EURJPYMT4,3410,1d 1h 59m,Buy
182402.74,1.12771,17.05.2019 10:30:00,,0.0,-50.929999999993015,0.0,0.0,1.12814,17.05.2019 01:45:00,17101,-0.018693086424562706,-14.49,IS,0.34,0.0,Phase3-EA-S4v1-EURCHF-M15-221,EURCHFMT4,4482,8h 45m,Buy
182430.15,1.12885,20.05.2019 05:00:00,,-0.97,-23.520000000018626,0.0,0.0,1.12815,17.05.2019 20:40:00,17102,-0.008632660371217814,27.41,IS,0.41,0.0,Phase3-EA-SA2v2-EURCHF-M5-43,EURCHFMT4,8756,2d 8h 20m,Buy
182527.16,1.12601,20.05.2019 14:30:00,,0.0,-0.0,0.0,0.0,1.12889,20.05.2019 05:45:00,17103,-0.0,97.01,IS,0.34,0.0,Phase3-EA-S4v1-EURCHF-M15-221,EURCHFMT4,4484,8h 45m,Sell
182552.41,1.12609,21.05.2019 14:00:00,,0.0,-0.0,0.0,0.0,1.12684,21.05.2019 05:15:00,17104,-0.0,25.25,IS,0.34,0.0,Phase3-EA-S4v1-EURCHF-M15-221,EURCHFMT4,4486,8h 45m,Sell
182510.41,1.27406,21.05.2019 16:29:58,sl 1.27406,0.0,-42.0,0.0,0.0,1.27106,21.05.2019 10:30:00,17105,-0.015409880250187434,-42.0,IS,0.14,0.0,Phase3-EA-B1v1-GBPUSD-M30-14,GBPUSDMT4,1122,5h 59m,Sell
182454.44,140933,21.05.2019 18:59:58,sl 140.933,-1.42,-97.96999999997206,0.0,0.0,140263,16.05.2019 11:30:00,17106,-0.03594538019310553,-55.97,IS,0.09,0.0,Phase3-EA-B1v1-GBPJPY-M30-1,GBPJPYMT4,1540,5d 7h 29m,Sell
182412.44,1.27096,21.05.2019 22:29:58,sl 1.27096,0.0,-139.96999999997206,0.0,0.0,1.27396,21.05.2019 16:30:00,17107,-0.051355260443292965,-42.0,IS,0.14,0.0,Phase3-EA-B1v1-GBPUSD-M30-14,GBPUSDMT4,1124,5h 59m,Buy
182467.53,123.36,22.05.2019 02:15:00,,-0.75,-84.87999999994645,0.0,0.0,122997,21.05.2019 15:30:00,17108,-0.03114263418178772,55.09,IS,0.17,0.0,Phase3-EA-T1v2-EURJPY-M15-322,EURJPYMT4,3412,10h 45m,Buy
182470.8,1.01092,22.05.2019 02:30:00,,-3.04,-81.60999999992782,0.0,0.0,1.01103,21.05.2019 22:15:00,17109,-0.029942864933730575,3.27,IS,0.58,0.0,Phase3-EA-SA2v2-USDCHF-M15-107,USDCHFMT4,3414,4h 15m,Sell
182462.77,140484,22.05.2019 04:25:00,,-0.75,-89.63999999995576,0.0,0.0,140519,21.05.2019 23:00:00,17110,-0.032889087276812376,-8.03,IS,0.23,0.0,Phase3-EA-S4v1-GBPJPY-M5-194,GBPJPYMT4,3702,5h 25m,Buy
182450.34,110578,22.05.2019 06:00:00,,-0.71,-102.06999999994878,0.0,0.0,110626,21.05.2019 23:00:00,17111,-0.03744967802704386,-12.43,IS,0.27,0.0,Phase3-EA-S1v2-USDJPY-M15-0,USDJPYMT4,4776,7h 0m,Buy
182417.91,1.12905,22.05.2019 07:15:00,,-2.03,-134.4999999999418,0.0,0.0,1.1283,21.05.2019 22:55:00,17112,-0.049348306991650305,-32.43,IS,0.41,0.0,Phase3-EA-SA2v2-EURCHF-M5-43,EURCHFMT4,8758,8h 20m,Sell
182382.52,123241,22.05.2019 08:44:58,sl 123.241,0.0,-169.88999999995576,0.0,0.0,123471,22.05.2019 03:45:00,17113,-0.06233296561199194,-35.39,IS,0.17,0.0,Phase3-EA-T1v2-EURJPY-M15-322,EURJPYMT4,3414,4h 59m,Buy
182416.51,1.12765,22.05.2019 12:45:00,,0.0,-135.89999999996508,0.0,0.0,1.12866,22.05.2019 04:00:00,17114,-0.0498619696666651,33.99,IS,0.34,0.0,Phase3-EA-S4v1-EURCHF-M15-221,EURCHFMT4,4488,8h 45m,Sell
182437.2,1.00929,23.05.2019 05:00:00,,0.0,-115.20999999996275,0.0,0.0,1.00965,23.05.2019 00:45:00,17115,-0.042270769133893334,20.69,IS,0.58,0.0,Phase3-EA-SA2v2-USDCHF-M15-107,USDCHFMT4,3416,4h 15m,Sell
182481.9,1.12484,23.05.2019 06:09:58,tp 1.12484,0.0,-70.5099999999511,0.0,0.0,1.12594,23.05.2019 00:20:00,17116,-0.02587025372476101,44.7,IS,0.41,0.0,Phase3-EA-SA2v2-EURCHF-M5-43,EURCHFMT4,8760,5h 49m,Sell
182413.48,1.12306,23.05.2019 14:45:00,,0.0,-138.9299999999348,0.0,0.0,1.12509,23.05.2019 06:00:00,17117,-0.0509736824561318,-68.42,IS,0.34,0.0,Phase3-EA-S4v1-EURCHF-M15-221,EURCHFMT4,4490,8h 45m,Buy
182450.37,1.00325,24.05.2019 02:45:00,,-0.69,-102.03999999992084,0.0,0.0,1.0026,23.05.2019 22:30:00,17118,-0.03743867096971204,36.89,IS,0.58,0.0,Phase3-EA-SA2v2-USDCHF-M15-107,USDCHFMT4,3418,4h 15m,Buy
182462.21,109499,24.05.2019 03:00:00,,0.0,-90.19999999989523,0.0,0.0,109547,24.05.2019 00:15:00,17119,-0.03309455234679266,11.84,IS,0.27,0.0,Phase3-EA-S1v2-USDJPY-M15-0,USDJPYMT4,4778,2h 45m,Sell
182505.31,138768,24.05.2019 04:30:00,,-0.76,-47.09999999991851,0.0,0.0,138559,23.05.2019 23:05:00,17120,-0.017281079994823152,43.1,IS,0.23,0.0,Phase3-EA-S4v1-GBPJPY-M5-194,GBPJPYMT4,3704,5h 25m,Buy
182549.25,1.12239,24.05.2019 05:04:57,tp 1.12239,-0.98,-3.159999999916181,0.0,0.0,1.12129,23.05.2019 22:15:00,17121,-0.0011594100378404916,43.94,IS,0.41,0.0,Phase3-EA-SA2v2-EURCHF-M5-43,EURCHFMT4,8762,6h 49m,Buy
182532.3,1.12266,24.05.2019 14:15:00,,0.0,-20.109999999927823,0.0,0.0,1.12216,24.05.2019 05:30:00,17122,-0.007378397424527549,-16.95,IS,0.34,0.0,Phase3-EA-S4v1-EURCHF-M15-221,EURCHFMT4,4492,8h 45m,Sell
182532.79,109316,27.05.2019 02:15:00,,0.0,-19.619999999937136,0.0,0.0,109318,27.05.2019 01:15:00,17123,-0.007198615488278779,0.49,IS,0.27,0.0,Phase3-EA-S1v2-USDJPY-M15-0,USDJPYMT4,4780,1h 0m,Sell
182474.29,1.12383,27.05.2019 07:25:00,,-2.05,-78.11999999993714,0.0,0.0,1.12245,24.05.2019 23:05:00,17124,-0.028662377265325563,-58.5,IS,0.41,0.0,Phase3-EA-SA2v2-EURCHF-M5-43,EURCHFMT4,8764,2d 8h 20m,Sell
182424.07,139387,27.05.2019 08:10:00,,0.0,-128.3399999999092,0.0,0.0,139148,27.05.2019 02:45:00,17125,-0.047088191221610856,-50.22,IS,0.23,0.0,Phase3-EA-S4v1-GBPJPY-M5-194,GBPJPYMT4,3706,5h 25m,Sell
182353.03,1.12501,27.05.2019 12:15:00,,0.0,-199.37999999988824,0.0,0.0,1.12291,27.05.2019 03:30:00,17126,-0.07315290295906306,-71.04,IS,0.34,0.0,Phase3-EA-S4v1-EURCHF-M15-221,EURCHFMT4,4494,8h 45m,Sell
182368.79,1.1239,28.05.2019 04:45:00,,-0.98,-183.61999999987893,0.0,0.0,1.12349,27.05.2019 20:25:00,17127,-0.06737052884613216,15.76,IS,0.41,0.0,Phase3-EA-SA2v2-EURCHF-M5-43,EURCHFMT4,8766,8h 20m,Buy
182344.42,138699,28.05.2019 06:35:00,,0.0,-207.98999999987427,0.0,0.0,138815,28.05.2019 01:10:00,17128,-0.07631192841034636,-24.37,IS,0.23,0.0,Phase3-EA-S4v1-GBPJPY-M5-194,GBPJPYMT4,3708,5h 25m,Buy
182351.53,1.12352,28.05.2019 11:30:00,,0.0,-200.87999999988824,0.0,0.0,1.12373,28.05.2019 02:45:00,17129,-0.07370325582514117,7.11,IS,0.34,0.0,Phase3-EA-S4v1-EURCHF-M15-221,EURCHFMT4,4496,8h 45m,Sell
182396.24,1.12623,28.05.2019 21:24:58,tp 1.12623,0.0,-156.1699999998673,0.0,0.0,1.12733,28.05.2019 20:00:00,17130,-0.05729907139689825,44.71,IS,0.41,0.0,Phase3-EA-SA2v2-EURCHF-M5-43,EURCHFMT4,8768,1h 24m,Sell
182348.9,1.0071,29.05.2019 02:30:00,,-0.69,-203.5099999998929,0.0,0.0,1.00791,28.05.2019 22:15:00,17131,-0.0746682078503332,-47.34,IS,0.58,0.0,Phase3-EA-SA2v2-USDCHF-M15-107,USDCHFMT4,3420,4h 15m,Buy
182294.42,138212,29.05.2019 04:45:00,,-0.76,-257.98999999987427,0.0,0.0,138467,28.05.2019 23:20:00,17132,-0.09465702394628378,-54.48,IS,0.23,0.0,Phase3-EA-S4v1-GBPJPY-M5-194,GBPJPYMT4,3710,5h 25m,Buy
182204.64,1.1239,29.05.2019 06:30:00,,-0.98,-347.7699999999022,0.0,0.0,1.12608,28.05.2019 22:10:00,17133,-0.12759747749062325,-89.78,IS,0.41,0.0,Phase3-EA-SA2v2-EURCHF-M5-43,EURCHFMT4,8770,8h 20m,Buy
182134.79,121909,29.05.2019 10:29:58,sl 121.909,-5.61,-417.6199999998789,0.0,0.0,122689,15.05.2019 19:00:00,17134,-0.1532255759543193,-69.85,IS,0.09,0.0,Phase3-EA-TR1v1-EURJPY-M30-91,EURJPYMT4,3014,13d 15h 29m,Buy
182179.54,1.12224,29.05.2019 21:59:58,tp 1.12224,0.0,-372.8699999998789,0.0,0.0,1.12114,29.05.2019 20:00:00,17135,-0.1368067154496553,44.75,IS,0.41,0.0,Phase3-EA-SA2v2-EURCHF-M5-43,EURCHFMT4,8772,1h 59m,Buy
182218.21,1.1213,30.05.2019 01:04:59,tp 1.12130,-6.1,-334.1999999998952,0.0,0.0,1.1224,29.05.2019 23:45:00,17136,-0.12261861856216728,38.67,IS,0.41,0.0,Phase3-EA-SA2v2-EURCHF-M5-43,EURCHFMT4,8774,1h 19m,Sell
182262.96,1.12218,30.05.2019 02:24:57,tp 1.12218,0.0,-289.4499999998952,0.0,0.0,1.12108,30.05.2019 01:10:00,17137,-0.10619975805750329,44.75,IS,0.41,0.0,Phase3-EA-SA2v2-EURCHF-M5-43,EURCHFMT4,8776,1h 14m,Buy
182256.24,138285,30.05.2019 06:35:00,,0.0,-296.1699999998673,0.0,0.0,138317,30.05.2019 01:10:00,17138,-0.10866533889752303,-6.72,IS,0.23,0.0,Phase3-EA-S4v1-GBPJPY-M5-194,GBPJPYMT4,3712,5h 25m,Buy
182222.89,1.12365,30.05.2019 12:15:00,,0.0,-329.519999999844,0.0,0.0,1.12266,30.05.2019 03:30:00,17139,-0.12090151761998474,-33.35,IS,0.34,0.0,Phase3-EA-S4v1-EURCHF-M15-221,EURCHFMT4,4498,8h 45m,Sell
182234.87,1.0075,31.05.2019 03:15:00,,-0.69,-317.53999999986263,0.0,0.0,1.00728,30.05.2019 23:00:00,17140,-0.11650603272958097,11.98,IS,0.58,0.0,Phase3-EA-SA2v2-USDCHF-M15-107,USDCHFMT4,3422,4h 15m,Buy
182266.94,109459,31.05.2019 03:45:00,,0.0,-285.46999999985565,0.0,0.0,109589,31.05.2019 01:15:00,17141,-0.10473948845282814,32.07,IS,0.27,0.0,Phase3-EA-S1v2-USDJPY-M15-0,USDJPYMT4,4782,2h 30m,Sell
182413.66,137829,31.05.2019 03:59:57,tp 137.829,-5.25,-138.74999999988358,0.0,0.0,139679,22.05.2019 15:30:00,17142,-0.05090764011218363,146.72,IS,0.09,0.0,Phase3-EA-B1v1-GBPJPY-M30-1,GBPJPYMT4,1542,8d 12h 29m,Sell
182672.18,121537,31.05.2019 06:44:58,tp 121.537,-5.95,-0.0,0.0,0.0,123237,22.05.2019 17:15:00,17143,-0.0,258.52,IS,0.17,0.0,Phase3-EA-T1v2-EURJPY-M15-322,EURJPYMT4,3416,8d 13h 29m,Sell
182587.2,1.11968,31.05.2019 06:45:00,,-0.98,-84.97999999998137,0.0,0.0,1.12174,30.05.2019 22:25:00,17144,-0.031165628998154882,-84.98,IS,0.41,0.0,Phase3-EA-SA2v2-EURCHF-M5-43,EURCHFMT4,8778,8h 20m,Buy
182572.99,1.12061,31.05.2019 13:15:00,,0.0,-99.19000000000233,0.0,0.0,1.12103,31.05.2019 04:30:00,17145,-0.036377015066224205,-14.21,IS,0.34,0.0,Phase3-EA-S4v1-EURCHF-M15-221,EURCHFMT4,4500,8h 45m,Buy
182517.77,1.00007,03.06.2019 02:15:00,,-0.7,-154.4099999999744,0.0,0.0,1.00101,31.05.2019 22:00:00,17146,-0.05662843932225644,-55.22,IS,0.58,0.0,Phase3-EA-SA2v2-USDCHF-M15-107,USDCHFMT4,3424,2d 4h 15m,Buy
182449.08,1.11691,03.06.2019 04:35:00,,-0.98,-223.09999999997672,0.0,0.0,1.11856,31.05.2019 20:15:00,17147,-0.0818198614908114,-68.69,IS,0.41,0.0,Phase3-EA-SA2v2-EURCHF-M5-43,EURCHFMT4,8780,2d 8h 20m,Buy
182552.51,120839,03.06.2019 08:59:58,tp 120.839,-1.44,-119.6699999999837,0.0,0.0,122099,29.05.2019 02:00:00,17148,-0.04388786564143921,103.43,IS,0.09,0.0,Phase3-EA-TR1v1-EURJPY-M30-91,EURJPYMT4,3015,5d 6h 59m,Sell
182478.64,1.11535,03.06.2019 10:45:00,,0.0,-193.53999999997905,0.0,0.0,1.11752,03.06.2019 02:00:00,17149,-0.07097900489884167,-73.87,IS,0.34,0.0,Phase3-EA-S4v1-EURCHF-M15-221,EURCHFMT4,4502,8h 45m,Buy
182441.99,121.31,03.06.2019 17:29:58,sl 121.310,-0.55,-230.19000000000233,0.0,0.0,121.08,31.05.2019 19:15:00,17150,-0.08442005341359046,-36.65,IS,0.17,0.0,Phase3-EA-T1v2-EURJPY-M15-322,EURJPYMT4,3418,2d 22h 14m,Sell
182380.5,0.99232,04.06.2019 02:15:00,,-0.7,-291.679999999993,0.0,0.0,0.99336,03.06.2019 22:00:00,17151,-0.10697094217678974,-61.49,IS,0.58,0.0,Phase3-EA-SA2v2-USDCHF-M15-107,USDCHFMT4,3426,4h 15m,Buy
182345.22,1.11608,04.06.2019 06:05:00,,-0.99,-326.96000000002095,0.0,0.0,1.11691,03.06.2019 21:45:00,17152,-0.11990955586302197,-35.28,IS,0.41,0.0,Phase3-EA-SA2v2-EURCHF-M5-43,EURCHFMT4,8782,8h 20m,Buy
182299.09,1.26817,04.06.2019 10:29:58,sl 1.26817,-4.13,-373.0900000000256,0.0,0.0,1.26517,29.05.2019 01:00:00,17153,-0.13682730669481,-46.13,IS,0.14,0.0,Phase3-EA-B1v1-GBPUSD-M30-14,GBPUSDMT4,1126,6d 9h 29m,Sell
182341.6,1.11707,04.06.2019 11:00:00,,0.0,-330.5800000000163,0.0,0.0,1.11583,04.06.2019 02:15:00,17154,-0.12123715738071085,42.51,IS,0.34,0.0,Phase3-EA-S4v1-EURCHF-M15-221,EURCHFMT4,4504,8h 45m,Buy
182356.34,108248,05.06.2019 02:30:00,,-0.72,-315.8400000000256,0.0,0.0,108186,04.06.2019 21:30:00,17155,-0.1158313987147587,14.74,IS,0.27,0.0,Phase3-EA-S1v2-USDJPY-M15-0,USDJPYMT4,4784,5h 0m,Buy
182340.45,1.11619,05.06.2019 06:30:00,,-0.99,-331.7300000000396,0.0,0.0,1.11655,04.06.2019 22:10:00,17156,-0.12165890924407413,-15.89,IS,0.41,0.0,Phase3-EA-SA2v2-EURCHF-M5-43,EURCHFMT4,8784,8h 20m,Buy
182374.44,121747,05.06.2019 09:30:00,,-0.77,-297.7400000000489,0.0,0.0,121526,04.06.2019 07:45:00,17157,-0.10919339112631435,33.99,IS,0.17,0.0,Phase3-EA-T1v2-EURJPY-M15-322,EURJPYMT4,3420,1d 1h 45m,Buy
182317.32,137661,05.06.2019 12:59:58,sl 137.661,-1.44,-354.86000000004424,0.0,0.0,136991,31.05.2019 13:30:00,17158,-0.1301416228087673,-57.12,IS,0.09,0.0,Phase3-EA-B1v1-GBPJPY-M30-1,GBPJPYMT4,1544,4d 23h 29m,Sell
182423.77,122224,05.06.2019 13:29:58,tp 122.224,-0.82,-248.4100000000326,0.0,0.0,120934,03.06.2019 11:00:00,17159,-0.09110206989214366,106.45,IS,0.09,0.0,Phase3-EA-TR1v1-EURJPY-M30-91,EURJPYMT4,3018,2d 2h 29m,Buy
182462.93,1.11532,06.06.2019 01:09:58,tp 1.11532,-6.18,-209.2500000000582,0.0,0.0,1.11642,05.06.2019 20:45:00,17160,-0.07674050209304722,39.16,IS,0.41,0.0,Phase3-EA-SA2v2-EURCHF-M5-43,EURCHFMT4,8786,4h 24m,Sell
182419.33,1.26749,06.06.2019 01:29:58,sl 1.26749,-1.6,-252.85000000003492,0.0,0.0,1.27049,05.06.2019 08:00:00,17161,-0.09273039882544455,-43.6,IS,0.14,0.0,Phase3-EA-B1v1-GBPUSD-M30-14,GBPUSDMT4,1128,17h 29m,Buy
182409.13,137.33,06.06.2019 07:30:00,,0.0,-263.05000000004657,0.0,0.0,137378,06.06.2019 02:05:00,17162,-0.09647115448303001,-10.2,IS,0.23,0.0,Phase3-EA-S4v1-GBPJPY-M5-194,GBPJPYMT4,3714,5h 25m,Buy
182397.58,1.11618,06.06.2019 10:00:00,,0.0,-274.6000000000349,0.0,0.0,1.1159,06.06.2019 01:40:00,17163,-0.10070701015411032,-11.55,IS,0.41,0.0,Phase3-EA-SA2v2-EURCHF-M5-43,EURCHFMT4,8788,8h 20m,Sell
182361.46,121756,06.06.2019 15:59:58,sl 121.756,0.0,-310.72000000003027,0.0,0.0,121526,06.06.2019 14:30:00,17164,-0.11395368607095495,-36.12,IS,0.17,0.0,Phase3-EA-T1v2-EURJPY-M15-322,EURJPYMT4,3422,1h 29m,Sell
182299.84,0.99115,07.06.2019 02:45:00,,-3.1,-372.3400000000256,0.0,0.0,0.99015,06.06.2019 22:30:00,17165,-0.13655225113175254,-61.62,IS,0.58,0.0,Phase3-EA-SA2v2-USDCHF-M15-107,USDCHFMT4,3428,4h 15m,Sell
182324.07,137595,07.06.2019 05:10:00,,-1.23,-348.11000000004424,0.0,0.0,137715,06.06.2019 23:45:00,17166,-0.12766612274125033,24.23,IS,0.23,0.0,Phase3-EA-S4v1-GBPJPY-M5-194,GBPJPYMT4,3716,5h 25m,Sell
182309.18,1.11764,07.06.2019 07:10:00,,-2.07,-363.0000000000582,0.0,0.0,1.11733,06.06.2019 22:50:00,17167,-0.13312689251982252,-14.89,IS,0.41,0.0,Phase3-EA-SA2v2-EURCHF-M5-43,EURCHFMT4,8790,8h 20m,Sell
182354.85,1.11947,07.06.2019 21:39:57,tp 1.11947,0.0,-317.3300000000745,0.0,0.0,1.11837,07.06.2019 20:45:00,17168,-0.11637784243338407,45.67,IS,0.41,0.0,Phase3-EA-SA2v2-EURCHF-M5-43,EURCHFMT4,8792,54m 57s,Buy
182457.21,122642,07.06.2019 21:59:58,tp 122.642,-2.45,-214.97000000008848,0.0,0.0,121382,03.06.2019 18:30:00,17169,-0.07883825918730973,102.36,IS,0.09,0.0,Phase3-EA-TR1v1-EURJPY-M30-91,EURJPYMT4,3019,4d 3h 29m,Buy
182414.68,1.27127,10.06.2019 05:29:58,sl 1.27127,-0.53,-257.5000000001164,0.0,0.0,1.27427,07.06.2019 17:00:00,17170,-0.09443574331643056,-42.53,IS,0.14,0.0,Phase3-EA-B1v1-GBPUSD-M30-14,GBPUSDMT4,1130,2d 12h 29m,Buy
182340.3,0.99035,10.06.2019 06:00:00,,0.0,-331.8800000001211,0.0,0.0,0.98908,10.06.2019 01:45:00,17171,-0.12171392035671551,-74.38,IS,0.58,0.0,Phase3-EA-SA2v2-USDCHF-M15-107,USDCHFMT4,3430,4h 15m,Sell
182346.87,137953,10.06.2019 06:35:00,,0.0,-325.3100000001141,0.0,0.0,137984,10.06.2019 01:10:00,17172,-0.11930443362432976,6.57,IS,0.23,0.0,Phase3-EA-S4v1-GBPJPY-M5-194,GBPJPYMT4,3718,5h 25m,Sell
182345.21,1.12004,10.06.2019 10:05:00,,0.0,-326.9700000000885,0.0,0.0,1.12,10.06.2019 01:45:00,17173,-0.11991322327055418,-1.66,IS,0.41,0.0,Phase3-EA-SA2v2-EURCHF-M5-43,EURCHFMT4,8794,8h 20m,Sell
182389.49,1.11907,10.06.2019 13:00:00,,0.0,-282.69000000006054,0.0,0.0,1.12036,10.06.2019 04:15:00,17174,-0.10367394282763265,44.28,IS,0.34,0.0,Phase3-EA-S4v1-EURCHF-M15-221,EURCHFMT4,4506,8h 45m,Sell
182296.57,108535,10.06.2019 13:45:00,,-1.12,-375.61000000004424,0.0,0.0,108166,07.06.2019 21:30:00,17175,-0.13775149338668982,-92.92,IS,0.27,0.0,Phase3-EA-S1v2-USDJPY-M15-0,USDJPYMT4,4786,2d 16h 15m,Sell
182355.07,122667,10.06.2019 23:15:00,,-0.77,-317.11000000004424,0.0,0.0,122289,07.06.2019 13:45:00,17176,-0.11629715946820947,58.5,IS,0.17,0.0,Phase3-EA-T1v2-EURJPY-M15-322,EURJPYMT4,3424,3d 9h 30m,Buy
182413.72,0.98896,11.06.2019 01:14:58,tp 0.98896,0.0,-258.46000000002095,0.0,0.0,0.98996,11.06.2019 00:45:00,17177,-0.09478781443710908,58.65,IS,0.58,0.0,Phase3-EA-SA2v2-USDCHF-M15-107,USDCHFMT4,3432,29m 58s,Sell
182413.56,1.11954,11.06.2019 04:35:00,,-0.99,-258.61999999999534,0.0,0.0,1.11952,10.06.2019 20:15:00,17178,-0.09484649295721861,-0.16,IS,0.41,0.0,Phase3-EA-SA2v2-EURCHF-M5-43,EURCHFMT4,8796,8h 20m,Buy
182397.43,122788,11.06.2019 19:45:00,,0.0,-274.75,0.0,0.0,122891,11.06.2019 05:30:00,17179,-0.10076202126670901,-16.13,IS,0.17,0.0,Phase3-EA-T1v2-EURJPY-M15-322,EURJPYMT4,3426,14h 15m,Buy
182404.52,108475,12.06.2019 04:00:00,,-1.12,-267.6599999999744,0.0,0.0,108508,11.06.2019 23:45:00,17180,-0.09816182934392995,7.09,IS,0.27,0.0,Phase3-EA-S1v2-USDJPY-M15-0,USDJPYMT4,4788,4h 15m,Sell
182379.72,1.12426,12.06.2019 05:05:00,,-2.07,-292.45999999996275,0.0,0.0,1.12371,11.06.2019 20:45:00,17181,-0.10725699996235837,-24.8,IS,0.41,0.0,Phase3-EA-SA2v2-EURCHF-M5-43,EURCHFMT4,8798,8h 20m,Sell
182418.51,1.12301,12.06.2019 11:45:00,,0.0,-253.6699999999837,0.0,0.0,1.12414,12.06.2019 03:00:00,17182,-0.09303112624103524,38.79,IS,0.34,0.0,Phase3-EA-S4v1-EURCHF-M15-221,EURCHFMT4,4508,8h 45m,Sell
182376.51,1.27001,12.06.2019 19:59:58,sl 1.27001,0.0,-295.6699999999837,0.0,0.0,1.27301,12.06.2019 11:30:00,17183,-0.1084342377722519,-42.0,IS,0.14,0.0,Phase3-EA-B1v1-GBPUSD-M30-14,GBPUSDMT4,1132,8h 29m,Buy
182333.58,1.12369,13.06.2019 04:20:00,,-2.96,-338.5999999999767,0.0,0.0,1.12466,12.06.2019 20:00:00,17184,-0.12417841820165723,-42.93,IS,0.41,0.0,Phase3-EA-SA2v2-EURCHF-M5-43,EURCHFMT4,8800,8h 20m,Buy
182379.02,1.12054,13.06.2019 22:19:58,tp 1.12054,0.0,-293.1599999999744,0.0,0.0,1.12164,13.06.2019 21:00:00,17185,-0.10751371848788292,45.44,IS,0.41,0.0,Phase3-EA-SA2v2-EURCHF-M5-43,EURCHFMT4,8802,1h 19m,Sell
182437.42,0.99307,14.06.2019 04:14:58,tp 0.99307,0.0,-234.7599999999511,0.0,0.0,0.99407,14.06.2019 00:30:00,17186,-0.08609605864446836,58.4,IS,0.58,0.0,Phase3-EA-SA2v2-USDCHF-M15-107,USDCHFMT4,3434,3h 44m,Sell
182419.91,1.11991,14.06.2019 06:45:00,,-0.99,-252.26999999996042,0.0,0.0,1.12031,13.06.2019 22:25:00,17187,-0.09251768918998614,-17.51,IS,0.41,0.0,Phase3-EA-SA2v2-EURCHF-M5-43,EURCHFMT4,8804,8h 20m,Buy
182419.23,1.12042,14.06.2019 10:15:00,,0.0,-252.94999999995343,0.0,0.0,1.12044,14.06.2019 01:30:00,17188,-0.092767072900489,-0.68,IS,0.34,0.0,Phase3-EA-S4v1-EURCHF-M15-221,EURCHFMT4,4510,8h 45m,Buy
182442.05,1.12042,17.06.2019 04:55:00,,-0.99,-230.12999999994645,0.0,0.0,1.11984,14.06.2019 20:35:00,17189,-0.08439804896852537,22.82,IS,0.41,0.0,Phase3-EA-SA2v2-EURCHF-M5-43,EURCHFMT4,8806,2d 8h 20m,Buy
182459.47,0.99881,17.06.2019 05:30:00,,0.0,-212.70999999996275,0.0,0.0,0.99851,17.06.2019 01:15:00,17190,-0.07800942509058387,17.42,IS,0.58,0.0,Phase3-EA-SA2v2-USDCHF-M15-107,USDCHFMT4,3436,4h 15m,Buy
182460.49,1.12061,17.06.2019 15:15:00,,0.0,-211.68999999994412,0.0,0.0,1.12064,17.06.2019 06:30:00,17191,-0.07763534952481892,1.02,IS,0.34,0.0,Phase3-EA-S4v1-EURCHF-M15-221,EURCHFMT4,4512,8h 45m,Sell
182453.75,1.12101,18.06.2019 04:45:00,,-0.99,-218.4299999999348,0.0,0.0,1.12115,17.06.2019 20:25:00,17192,-0.08010718218482504,-6.74,IS,0.41,0.0,Phase3-EA-SA2v2-EURCHF-M5-43,EURCHFMT4,8808,8h 20m,Buy
182399.63,135763,18.06.2019 06:25:00,,0.0,-272.54999999993015,0.0,0.0,136018,18.06.2019 01:00:00,17193,-0.09995519161504823,-54.12,IS,0.23,0.0,Phase3-EA-S4v1-GBPJPY-M5-194,GBPJPYMT4,3720,5h 25m,Buy
182504.62,121.43,18.06.2019 12:29:58,tp 121.430,-2.32,-167.55999999993946,0.0,0.0,122.72,10.06.2019 05:00:00,17194,-0.06145108019451742,104.99,IS,0.09,0.0,Phase3-EA-TR1v1-EURJPY-M30-91,EURJPYMT4,3022,8d 7h 29m,Sell
182768.35,121159,18.06.2019 12:29:58,tp 121.159,-3.29,-0.0,0.0,0.0,122859,12.06.2019 06:15:00,17195,-0.0,263.73,IS,0.17,0.0,Phase3-EA-T1v2-EURJPY-M15-322,EURJPYMT4,3428,6d 6h 14m,Sell
182858.8,1.1184,18.06.2019 13:15:00,,0.0,-0.0,0.0,0.0,1.12106,18.06.2019 04:30:00,17196,-0.0,90.45,IS,0.34,0.0,Phase3-EA-S4v1-EURCHF-M15-221,EURCHFMT4,4514,8h 45m,Sell
182862.56,108456,19.06.2019 01:30:00,,-0.72,-0.0,0.0,0.0,108438,18.06.2019 23:00:00,17197,-0.0,3.76,IS,0.27,0.0,Phase3-EA-S1v2-USDJPY-M15-0,USDJPYMT4,4790,2h 30m,Buy
182961.37,1.11794,19.06.2019 14:30:00,,0.0,-0.0,0.0,0.0,1.12084,19.06.2019 05:45:00,17198,-0.0,98.81,IS,0.34,0.0,Phase3-EA-S4v1-EURCHF-M15-221,EURCHFMT4,4516,8h 45m,Sell
183006.67,1.11712,19.06.2019 21:59:57,tp 1.11712,0.0,-0.0,0.0,0.0,1.11602,19.06.2019 20:25:00,17199,-0.0,45.3,IS,0.41,0.0,Phase3-EA-SA2v2-EURCHF-M5-43,EURCHFMT4,8810,1h 34m,Buy
183011.15,1.11571,20.06.2019 07:25:00,,-2.97,-0.0,0.0,0.0,1.11553,19.06.2019 23:05:00,17200,-0.0,4.48,IS,0.41,0.0,Phase3-EA-SA2v2-EURCHF-M5-43,EURCHFMT4,8812,8h 20m,Buy
183000.84,1.1152,20.06.2019 11:00:00,,0.0,-10.309999999997672,0.0,0.0,1.1155,20.06.2019 02:15:00,17201,-0.0037764025388697994,-10.31,IS,0.34,0.0,Phase3-EA-S4v1-EURCHF-M15-221,EURCHFMT4,4518,8h 45m,Buy
182951.96,1.2719,20.06.2019 11:59:58,sl 1.27190,-6.88,-59.19000000000233,0.0,0.0,1.2689,12.06.2019 20:00:00,17202,-0.02168043319842509,-48.88,IS,0.14,0.0,Phase3-EA-B1v1-GBPUSD-M30-14,GBPUSDMT4,1134,7d 15h 59m,Sell
183010.34,0.98162,21.06.2019 00:44:58,tp 0.98162,-0.71,-0.8099999999976717,0.0,0.0,0.98062,20.06.2019 23:15:00,17203,-2.9669117909567755E-4,58.38,IS,0.58,0.0,Phase3-EA-SA2v2-USDCHF-M15-107,USDCHFMT4,3438,1h 29m,Buy
183015.37,107.3,21.06.2019 02:15:00,,0.0,-0.0,0.0,0.0,107.32,21.06.2019 00:45:00,17204,-0.0,5.03,IS,0.27,0.0,Phase3-EA-S1v2-USDJPY-M15-0,USDJPYMT4,4792,1h 30m,Sell
183049.47,1.10841,21.06.2019 04:50:00,,-1.0,-0.0,0.0,0.0,1.10757,20.06.2019 20:30:00,17205,-0.0,34.1,IS,0.41,0.0,Phase3-EA-SA2v2-EURCHF-M5-43,EURCHFMT4,8814,8h 20m,Buy
183007.47,1.26908,21.06.2019 10:29:58,sl 1.26908,0.0,-42.0,0.0,0.0,1.27208,21.06.2019 06:00:00,17206,-0.015381828062145607,-42.0,IS,0.14,0.0,Phase3-EA-B1v1-GBPUSD-M30-14,GBPUSDMT4,1136,4h 29m,Buy
183037.59,107582,21.06.2019 18:00:00,,0.0,-11.880000000004657,0.0,0.0,107462,21.06.2019 17:00:00,17207,-0.004350859937580034,30.12,IS,0.27,0.0,Phase3-EA-S1v2-USDJPY-M15-0,USDJPYMT4,4794,1h 0m,Buy
182995.59,1271,21.06.2019 20:29:58,sl 1.27100,0.0,-53.88000000000466,0.0,0.0,1268,21.06.2019 12:30:00,17208,-0.01973268799972564,-42.0,IS,0.14,0.0,Phase3-EA-B1v1-GBPUSD-M30-14,GBPUSDMT4,1138,7h 59m,Sell
183041.73,1.10978,21.06.2019 21:19:58,tp 1.10978,0.0,-7.739999999990687,0.0,0.0,1.10868,21.06.2019 20:10:00,17209,-0.0028346511714491367,46.14,IS,0.41,0.0,Phase3-EA-SA2v2-EURCHF-M5-43,EURCHFMT4,8816,1h 9m,Buy
183085.83,1.10932,24.06.2019 01:00:00,tp 1.10932,-2.1,-0.0,0.0,0.0,1.11042,21.06.2019 23:05:00,17210,-0.0,44.1,IS,0.41,0.0,Phase3-EA-SA2v2-EURCHF-M5-43,EURCHFMT4,8818,2d 1h 55m,Sell
183047.52,1.11169,24.06.2019 13:15:00,,0.0,-38.30999999999767,0.0,0.0,1.11059,24.06.2019 04:30:00,17211,-0.014028556516461342,-38.31,IS,0.34,0.0,Phase3-EA-S4v1-EURCHF-M15-221,EURCHFMT4,4520,8h 45m,Sell
183026.62,0.97145,25.06.2019 06:00:00,,0.0,-59.210000000020955,0.0,0.0,0.9718,25.06.2019 01:45:00,17212,-0.02168182801722841,-20.9,IS,0.58,0.0,Phase3-EA-SA2v2-USDCHF-M15-107,USDCHFMT4,3440,4h 15m,Buy
183013.73,136519,25.06.2019 06:40:00,,0.0,-72.10000000003492,0.0,0.0,136579,25.06.2019 01:15:00,17213,-0.026401955751433413,-12.89,IS,0.23,0.0,Phase3-EA-S4v1-GBPJPY-M5-194,GBPJPYMT4,3722,5h 25m,Buy
182977.08,122119,25.06.2019 06:45:00,,-0.78,-108.75000000005821,0.0,0.0,122345,24.06.2019 23:15:00,17214,-0.0398226447707147,-36.65,IS,0.17,0.0,Phase3-EA-T1v2-EURJPY-M15-322,EURJPYMT4,3430,7h 30m,Buy
183021.42,1.10719,25.06.2019 07:04:58,tp 1.10719,-2.11,-64.4100000000326,0.0,0.0,1.10829,24.06.2019 23:10:00,17215,-0.023585991261440543,44.34,IS,0.41,0.0,Phase3-EA-SA2v2-EURCHF-M5-43,EURCHFMT4,8820,7h 54m,Sell
182978.36,1.26819,25.06.2019 21:29:58,sl 1.26819,-1.06,-107.47000000003027,0.0,0.0,1.27119,21.06.2019 20:30:00,17216,-0.03935392766443792,-43.06,IS,0.14,0.0,Phase3-EA-B1v1-GBPUSD-M30-14,GBPUSDMT4,1140,4d 0h 59m,Buy
182941.94,122005,25.06.2019 21:44:58,sl 122.005,0.0,-143.89000000001397,0.0,0.0,121775,25.06.2019 18:15:00,17217,-0.05269039407867244,-36.42,IS,0.17,0.0,Phase3-EA-T1v2-EURJPY-M15-322,EURJPYMT4,3432,3h 29m,Sell
182988.17,1.10838,26.06.2019 01:09:58,tp 1.10838,0.0,-97.6600000000326,0.0,0.0,1.10948,26.06.2019 00:30:00,17218,-0.03576165046719277,46.23,IS,0.41,0.0,Phase3-EA-SA2v2-EURCHF-M5-43,EURCHFMT4,8822,39m 58s,Sell
182951.24,122029,26.06.2019 06:29:58,sl 122.029,-0.56,-134.5900000000256,0.0,0.0,121799,25.06.2019 23:15:00,17219,-0.049284871353458784,-36.93,IS,0.17,0.0,Phase3-EA-T1v2-EURJPY-M15-322,EURJPYMT4,3434,7h 14m,Sell
182997.41,1.1093,26.06.2019 07:39:58,tp 1.10930,0.0,-88.42000000004191,0.0,0.0,1.1082,26.06.2019 01:15:00,17220,-0.03237809885633451,46.17,IS,0.41,0.0,Phase3-EA-SA2v2-EURCHF-M5-43,EURCHFMT4,8824,6h 24m,Buy
183005.78,1.10821,26.06.2019 11:30:00,,0.0,-80.05000000004657,0.0,0.0,1.10797,26.06.2019 02:45:00,17221,-0.02931312840364009,8.37,IS,0.34,0.0,Phase3-EA-S4v1-EURCHF-M15-221,EURCHFMT4,4522,8h 45m,Buy
183033.34,107752,26.06.2019 22:00:00,,0.0,-52.490000000048894,0.0,0.0,107642,26.06.2019 17:45:00,17222,-0.019221063209339244,27.56,IS,0.27,0.0,Phase3-EA-S1v2-USDJPY-M15-0,USDJPYMT4,4796,4h 15m,Buy
183021.6,1.11154,27.06.2019 04:25:00,,-6.29,-64.23000000003958,0.0,0.0,1.11141,26.06.2019 20:05:00,17223,-0.023520077918374366,-11.74,IS,0.41,0.0,Phase3-EA-SA2v2-EURCHF-M5-43,EURCHFMT4,8826,8h 20m,Sell
183059.96,136909,27.06.2019 06:10:00,,0.0,-25.87000000005355,0.0,0.0,136729,27.06.2019 00:45:00,17224,-0.00947321213995375,38.36,IS,0.23,0.0,Phase3-EA-S4v1-GBPJPY-M5-194,GBPJPYMT4,3724,5h 25m,Buy
182997.86,137258,27.06.2019 11:29:57,sl 137.258,-6.3,-87.97000000003027,0.0,0.0,136588,14.06.2019 19:30:00,17225,-0.03221331549865841,-62.1,IS,0.09,0.0,Phase3-EA-B1v1-GBPJPY-M30-1,GBPJPYMT4,1546,12d 15h 59m,Sell
182994.39,122661,27.06.2019 16:00:00,,0.0,-91.44000000000233,0.0,0.0,122683,27.06.2019 06:30:00,17226,-0.033483978278917664,-3.47,IS,0.17,0.0,Phase3-EA-T1v2-EURJPY-M15-322,EURJPYMT4,3436,9h 30m,Buy
182958.51,1.10929,28.06.2019 05:25:00,,-1.01,-127.32000000000698,0.0,0.0,1.11012,27.06.2019 21:05:00,17227,-0.04662270466395366,-35.88,IS,0.41,0.0,Phase3-EA-SA2v2-EURCHF-M5-43,EURCHFMT4,8828,8h 20m,Buy
183003.7,1.11103,01.07.2019 01:04:59,tp 1.11103,-1.01,-82.13000000000466,0.0,0.0,1.10993,28.06.2019 20:00:00,17228,-0.03007479370130789,45.19,IS,0.41,0.0,Phase3-EA-SA2v2-EURCHF-M5-43,EURCHFMT4,8830,2d 5h 4m,Buy
182939.0,122896,01.07.2019 01:29:57,sl 122.896,-4.65,-146.8300000000163,0.0,0.0,122176,13.06.2019 22:30:00,17229,-0.05376697868212928,-64.7,IS,0.09,0.0,Phase3-EA-TR1v1-EURJPY-M30-91,EURJPYMT4,3023,17d 2h 59m,Sell
182928.16,137407,01.07.2019 06:55:00,,0.0,-157.6700000000419,0.0,0.0,137356,01.07.2019 01:30:00,17230,-0.057736426675833515,-10.84,IS,0.23,0.0,Phase3-EA-S4v1-GBPJPY-M5-194,GBPJPYMT4,3726,5h 25m,Sell
182961.77,122879,01.07.2019 08:45:00,,0.0,-124.06000000005588,0.0,0.0,122665,01.07.2019 01:00:00,17231,-0.045428940783948935,33.61,IS,0.17,0.0,Phase3-EA-T1v2-EURJPY-M15-322,EURJPYMT4,3438,7h 45m,Buy
182923.8,1.1128,01.07.2019 09:30:00,,0.0,-162.03000000002794,0.0,0.0,1.11189,01.07.2019 01:10:00,17232,-0.05933299431904884,-37.97,IS,0.41,0.0,Phase3-EA-SA2v2-EURCHF-M5-43,EURCHFMT4,8832,8h 20m,Sell
182889.21,1.11378,01.07.2019 12:30:00,,0.0,-196.62000000005355,0.0,0.0,1.11278,01.07.2019 03:45:00,17233,-0.07199934174543325,-34.59,IS,0.34,0.0,Phase3-EA-S4v1-EURCHF-M15-221,EURCHFMT4,4524,8h 45m,Sell
182849.23,108397,02.07.2019 02:15:00,,-1.12,-236.60000000003492,0.0,0.0,108241,01.07.2019 17:45:00,17234,-0.08663942761147077,-39.98,IS,0.27,0.0,Phase3-EA-S1v2-USDJPY-M15-0,USDJPYMT4,4798,8h 30m,Sell
182802.96,1.11393,02.07.2019 06:10:00,,-1.0,-282.87000000005355,0.0,0.0,1.11502,01.07.2019 21:50:00,17235,-0.10358281863253489,-46.27,IS,0.41,0.0,Phase3-EA-SA2v2-EURCHF-M5-43,EURCHFMT4,8834,8h 20m,Buy
182800.61,0.98707,02.07.2019 06:45:00,,0.0,-285.22000000003027,0.0,0.0,0.98711,02.07.2019 02:30:00,17236,-0.10444335394481262,-2.35,IS,0.58,0.0,Phase3-EA-SA2v2-USDCHF-M15-107,USDCHFMT4,3442,4h 15m,Buy
182840.57,1.11495,02.07.2019 11:30:00,,0.0,-245.2600000000093,0.0,0.0,1.11379,02.07.2019 02:45:00,17237,-0.08981059178354603,39.96,IS,0.34,0.0,Phase3-EA-S4v1-EURCHF-M15-221,EURCHFMT4,4526,8h 45m,Buy
182852.59,107836,03.07.2019 02:45:00,,0.0,-233.2399999999907,0.0,0.0,107884,03.07.2019 01:00:00,17238,-0.08540904520750486,12.02,IS,0.27,0.0,Phase3-EA-S1v2-USDJPY-M15-0,USDJPYMT4,4800,1h 45m,Sell
182758.73,1.11183,03.07.2019 04:30:00,,-1.0,-327.0999999999767,0.0,0.0,1.11406,02.07.2019 20:10:00,17239,-0.11977919176545176,-93.86,IS,0.41,0.0,Phase3-EA-SA2v2-EURCHF-M5-43,EURCHFMT4,8836,8h 20m,Buy
182865.89,121597,03.07.2019 04:59:58,tp 121.597,-0.58,-219.94000000000233,0.0,0.0,122887,01.07.2019 05:00:00,17240,-0.08053878152520824,107.16,IS,0.09,0.0,Phase3-EA-TR1v1-EURJPY-M30-91,EURJPYMT4,3026,1d 23h 59m,Sell
182891.04,1.11311,03.07.2019 12:30:00,,0.0,-194.78999999997905,0.0,0.0,1.11238,03.07.2019 03:45:00,17241,-0.0713292227575405,25.15,IS,0.34,0.0,Phase3-EA-S4v1-EURCHF-M15-221,EURCHFMT4,4528,8h 45m,Buy
182930.5,1.11228,04.07.2019 01:04:58,tp 1.11228,-6.23,-155.3299999999581,0.0,0.0,1.11338,03.07.2019 20:45:00,17242,-0.05687955321590928,39.46,IS,0.41,0.0,Phase3-EA-SA2v2-EURCHF-M5-43,EURCHFMT4,8838,4h 19m,Sell
182952.21,1.11303,04.07.2019 10:30:00,,0.0,-133.61999999993714,0.0,0.0,1.1124,04.07.2019 01:45:00,17243,-0.04892967167133376,21.71,IS,0.34,0.0,Phase3-EA-S4v1-EURCHF-M15-221,EURCHFMT4,4530,8h 45m,Buy
182952.63,1.11306,04.07.2019 10:55:00,,0.0,-133.19999999995343,0.0,0.0,1.11307,04.07.2019 02:35:00,17244,-0.04877587387084602,0.42,IS,0.41,0.0,Phase3-EA-SA2v2-EURCHF-M5-43,EURCHFMT4,8840,8h 20m,Sell
182967.44,1.11158,05.07.2019 04:50:00,,-1.0,-118.38999999995576,0.0,0.0,1.1112,04.07.2019 20:30:00,17245,-0.043352670477247154,14.81,IS,0.41,0.0,Phase3-EA-SA2v2-EURCHF-M5-43,EURCHFMT4,8842,8h 20m,Buy
182976.41,1.11128,05.07.2019 10:30:00,,0.0,-109.4199999999837,0.0,0.0,1.11102,05.07.2019 01:45:00,17246,-0.040067988880998814,8.97,IS,0.34,0.0,Phase3-EA-S4v1-EURCHF-M15-221,EURCHFMT4,4532,8h 45m,Buy
183005.28,108497,05.07.2019 23:45:00,,0.0,-80.54999999998836,0.0,0.0,108613,05.07.2019 22:45:00,17247,-0.029496221023254148,28.87,IS,0.27,0.0,Phase3-EA-S1v2-USDJPY-M15-0,USDJPYMT4,4802,1h 0m,Sell
183048.73,1.11234,08.07.2019 04:39:59,tp 1.11234,-2.07,-37.09999999997672,0.0,0.0,1.11344,05.07.2019 21:15:00,17248,-0.013585472376936067,43.45,IS,0.41,0.0,Phase3-EA-SA2v2-EURCHF-M5-43,EURCHFMT4,8844,2d 7h 24m,Sell
183055.97,108529,08.07.2019 05:00:00,,-0.72,-29.85999999998603,0.0,0.0,108497,05.07.2019 23:45:00,17249,-0.010934291244619292,7.24,IS,0.27,0.0,Phase3-EA-S1v2-USDJPY-M15-0,USDJPYMT4,4804,2d 5h 15m,Buy
183110.93,135727,08.07.2019 07:45:00,,0.0,-0.0,0.0,0.0,135986,08.07.2019 02:20:00,17250,-0.0,54.96,IS,0.23,0.0,Phase3-EA-S4v1-GBPJPY-M5-194,GBPJPYMT4,3728,5h 25m,Sell
183116.76,1.11312,08.07.2019 11:45:00,,0.0,-0.0,0.0,0.0,1.11295,08.07.2019 03:00:00,17251,-0.0,5.83,IS,0.34,0.0,Phase3-EA-S4v1-EURCHF-M15-221,EURCHFMT4,4534,8h 45m,Buy
183161.14,1.11503,09.07.2019 03:14:57,tp 1.11503,-0.99,-0.0,0.0,0.0,1.11393,08.07.2019 20:35:00,17252,-0.0,44.38,IS,0.41,0.0,Phase3-EA-SA2v2-EURCHF-M5-43,EURCHFMT4,8846,6h 39m,Buy
183139.38,0.99424,09.07.2019 03:15:00,,-3.09,-21.760000000009313,0.0,0.0,0.99392,08.07.2019 23:00:00,17253,-0.007965993991681698,-21.76,IS,0.58,0.0,Phase3-EA-SA2v2-USDCHF-M15-107,USDCHFMT4,3444,4h 15m,Sell
183197.54,1.11334,09.07.2019 12:30:00,,0.0,-0.0,0.0,0.0,1.11504,09.07.2019 03:45:00,17254,-0.0,58.16,IS,0.34,0.0,Phase3-EA-S4v1-EURCHF-M15-221,EURCHFMT4,4536,8h 45m,Sell
183196.78,0.99365,10.07.2019 03:30:00,,-3.09,-0.7600000000093132,0.0,0.0,0.99369,09.07.2019 23:15:00,17255,-2.781869851424396E-4,-0.76,IS,0.58,0.0,Phase3-EA-SA2v2-USDCHF-M15-107,USDCHFMT4,3446,4h 15m,Sell
183199.31,135593,10.07.2019 06:40:00,,0.0,-0.0,0.0,0.0,135581,10.07.2019 01:15:00,17256,-0.0,2.53,IS,0.23,0.0,Phase3-EA-S4v1-GBPJPY-M5-194,GBPJPYMT4,3730,5h 25m,Buy
183193.54,1.11349,10.07.2019 06:55:00,,-2.06,-5.7700000000186265,0.0,0.0,1.1134,09.07.2019 22:35:00,17257,-0.002112011190664649,-5.77,IS,0.41,0.0,Phase3-EA-SA2v2-EURCHF-M5-43,EURCHFMT4,8848,8h 20m,Sell
183239.14,1.11316,10.07.2019 22:54:57,tp 1.11316,0.0,-0.0,0.0,0.0,1.11426,10.07.2019 21:25:00,17258,-0.0,45.6,IS,0.41,0.0,Phase3-EA-SA2v2-EURCHF-M5-43,EURCHFMT4,8850,1h 29m,Sell
183253.33,108419,11.07.2019 01:15:00,,0.0,-0.0,0.0,0.0,108476,11.07.2019 00:30:00,17259,-0.0,14.19,IS,0.27,0.0,Phase3-EA-S1v2-USDJPY-M15-0,USDJPYMT4,4806,45m 0s,Sell
183259.06,108394,11.07.2019 01:30:00,,0.0,-0.0,0.0,0.0,108417,11.07.2019 01:15:00,17260,-0.0,5.73,IS,0.27,0.0,Phase3-EA-S1v2-USDJPY-M15-0,USDJPYMT4,4808,15m 0s,Sell
183256.57,108402,11.07.2019 01:45:00,,0.0,-2.4899999999906868,0.0,0.0,108392,11.07.2019 01:30:00,17261,-9.112232179934596E-4,-2.49,IS,0.27,0.0,Phase3-EA-S1v2-USDJPY-M15-0,USDJPYMT4,4810,15m 0s,Sell
183124.22,0.98601,11.07.2019 07:00:00,,0.0,-134.8399999999674,0.0,0.0,0.98826,11.07.2019 02:45:00,17262,-0.04934511594966584,-132.35,IS,0.58,0.0,Phase3-EA-SA2v2-USDCHF-M15-107,USDCHFMT4,3448,4h 15m,Buy
183041.37,1.11134,11.07.2019 07:15:00,,-2.98,-217.68999999994412,0.0,0.0,1.11326,10.07.2019 22:55:00,17263,-0.07966433025128002,-82.85,IS,0.41,0.0,Phase3-EA-SA2v2-EURCHF-M5-43,EURCHFMT4,8852,8h 20m,Buy
182994.84,1.11171,11.07.2019 10:00:00,,0.0,-264.21999999997206,0.0,0.0,1.11306,11.07.2019 01:15:00,17264,-0.09669212797554495,-46.53,IS,0.34,0.0,Phase3-EA-S4v1-EURCHF-M15-221,EURCHFMT4,4538,8h 45m,Buy
182934.41,1.11463,12.07.2019 04:20:00,,-2.07,-324.6499999999651,0.0,0.0,1.11322,11.07.2019 20:00:00,17265,-0.1188066737841973,-60.43,IS,0.41,0.0,Phase3-EA-SA2v2-EURCHF-M5-43,EURCHFMT4,8854,8h 20m,Sell
183033.97,1.11171,12.07.2019 13:15:00,,0.0,-225.0899999999674,0.0,0.0,1.1146,12.07.2019 04:30:00,17266,-0.08237238318830734,99.56,IS,0.34,0.0,Phase3-EA-S4v1-EURCHF-M15-221,EURCHFMT4,4540,8h 45m,Sell
183077.79,1.10789,15.07.2019 01:04:58,tp 1.10789,-2.08,-181.26999999996042,0.0,0.0,1.10899,12.07.2019 21:45:00,17267,-0.0663363183639583,43.82,IS,0.41,0.0,Phase3-EA-SA2v2-EURCHF-M5-43,EURCHFMT4,8856,2d 3h 19m,Sell
183062.38,1.10983,15.07.2019 10:05:00,,0.0,-196.6799999999348,0.0,0.0,1.10946,15.07.2019 01:45:00,17268,-0.07197565562874078,-15.41,IS,0.41,0.0,Phase3-EA-SA2v2-EURCHF-M5-43,EURCHFMT4,8858,8h 20m,Sell
183118.18,0.98431,16.07.2019 00:29:58,tp 0.98431,-3.12,-140.87999999994645,0.0,0.0,0.98531,15.07.2019 22:00:00,17269,-0.05155547267122487,55.8,IS,0.58,0.0,Phase3-EA-SA2v2-USDCHF-M15-107,USDCHFMT4,3450,2h 29m,Sell
183161.9,1.10789,16.07.2019 01:39:58,tp 1.10789,-2.08,-97.15999999997439,0.0,0.0,1.10899,15.07.2019 22:05:00,17270,-0.03555600315684833,43.72,IS,0.41,0.0,Phase3-EA-SA2v2-EURCHF-M5-43,EURCHFMT4,8860,3h 34m,Sell
183191.93,0.98492,16.07.2019 05:00:00,,0.0,-67.12999999994645,0.0,0.0,0.98441,16.07.2019 00:45:00,17271,-0.024566431575936118,30.03,IS,0.58,0.0,Phase3-EA-SA2v2-USDCHF-M15-107,USDCHFMT4,3452,4h 15m,Buy
183237.71,1.10915,16.07.2019 05:09:59,tp 1.10915,0.0,-21.34999999991851,0.0,0.0,1.10805,16.07.2019 01:55:00,17272,-0.007813098676369024,45.78,IS,0.41,0.0,Phase3-EA-SA2v2-EURCHF-M5-43,EURCHFMT4,8862,3h 14m,Buy
183226.65,1.10776,16.07.2019 11:00:00,,0.0,-32.40999999991618,0.0,0.0,1.10808,16.07.2019 02:15:00,17273,-0.011860539957912492,-11.06,IS,0.34,0.0,Phase3-EA-S4v1-EURCHF-M15-221,EURCHFMT4,4542,8h 45m,Buy
183481.61,1.2438,16.07.2019 14:59:58,tp 1.24380,-9.64,-0.0,0.0,0.0,1.2627,02.07.2019 08:30:00,17274,-0.0,254.96,IS,0.14,0.0,Phase3-EA-B1v1-GBPUSD-M30-14,GBPUSDMT4,1142,14d 6h 29m,Sell
183582.58,121109,16.07.2019 16:29:57,tp 121.109,-4.07,-0.0,0.0,0.0,122369,02.07.2019 00:30:00,17275,-0.0,100.97,IS,0.09,0.0,Phase3-EA-TR1v1-EURJPY-M30-91,EURJPYMT4,3027,14d 15h 59m,Sell
183601.02,108333,16.07.2019 22:30:00,,0.0,-0.0,0.0,0.0,108259,16.07.2019 21:15:00,17276,-0.0,18.44,IS,0.27,0.0,Phase3-EA-S1v2-USDJPY-M15-0,USDJPYMT4,4812,1h 15m,Buy
183646.65,1.10743,16.07.2019 23:19:58,tp 1.10743,0.0,-0.0,0.0,0.0,1.10853,16.07.2019 20:05:00,17277,-0.0,45.63,IS,0.41,0.0,Phase3-EA-SA2v2-EURCHF-M5-43,EURCHFMT4,8864,3h 14m,Sell
183629.04,1.10706,17.07.2019 07:40:00,,-1.0,-17.60999999998603,0.0,0.0,1.10746,16.07.2019 23:20:00,17278,-0.006435306260824302,-17.61,IS,0.41,0.0,Phase3-EA-SA2v2-EURCHF-M5-43,EURCHFMT4,8866,8h 20m,Buy
183744.42,1.11059,17.07.2019 14:30:00,,0.0,-0.0,0.0,0.0,1.10723,17.07.2019 05:45:00,17279,-0.0,115.38,IS,0.34,0.0,Phase3-EA-S4v1-EURCHF-M15-221,EURCHFMT4,4544,8h 45m,Buy
183716.49,1.10753,18.07.2019 04:45:00,,-2.99,-27.929999999993015,0.0,0.0,1.10813,17.07.2019 20:25:00,17280,-0.010202947698438167,-27.93,IS,0.41,0.0,Phase3-EA-SA2v2-EURCHF-M5-43,EURCHFMT4,8868,8h 20m,Buy
183974.41,120961,18.07.2019 06:14:57,tp 120.961,-10.45,-0.0,0.0,0.0,122661,01.07.2019 19:00:00,17281,-0.0,257.92,IS,0.17,0.0,Phase3-EA-T1v2-EURJPY-M15-322,EURJPYMT4,3440,16d 11h 14m,Sell
183910.98,133933,18.07.2019 06:35:00,,0.0,-63.429999999993015,0.0,0.0,134.23,18.07.2019 01:10:00,17282,-0.02315179727916661,-63.43,IS,0.23,0.0,Phase3-EA-S4v1-GBPJPY-M5-194,GBPJPYMT4,3732,5h 25m,Buy
183956.91,1.1068,18.07.2019 23:34:57,tp 1.10680,0.0,-17.5,0.0,0.0,1.1079,18.07.2019 20:30:00,17283,-0.006387457865134168,45.93,IS,0.41,0.0,Phase3-EA-SA2v2-EURCHF-M5-43,EURCHFMT4,8870,3h 4m,Sell
183954.17,134776,19.07.2019 04:30:00,,-1.24,-20.239999999990687,0.0,0.0,134769,18.07.2019 23:05:00,17284,-0.007387551268014633,-2.74,IS,0.23,0.0,Phase3-EA-S4v1-GBPJPY-M5-194,GBPJPYMT4,3734,5h 25m,Sell
183975.28,1.10712,19.07.2019 08:00:00,,-1.0,-0.0,0.0,0.0,1.10659,18.07.2019 23:40:00,17285,-0.0,21.11,IS,0.41,0.0,Phase3-EA-SA2v2-EURCHF-M5-43,EURCHFMT4,8872,8h 20m,Buy
183938.41,121262,19.07.2019 10:44:57,sl 121.262,-0.55,-36.86999999999534,0.0,0.0,121032,18.07.2019 13:45:00,17286,-0.013457418494104726,-36.87,IS,0.17,0.0,Phase3-EA-T1v2-EURJPY-M15-322,EURJPYMT4,3442,20h 59m,Sell
183982.31,1.10757,19.07.2019 11:30:00,,0.0,-0.0,0.0,0.0,1.1063,19.07.2019 02:45:00,17287,-0.0,43.9,IS,0.34,0.0,Phase3-EA-S4v1-EURCHF-M15-221,EURCHFMT4,4546,8h 45m,Buy
184041.37,0.98212,19.07.2019 23:29:57,tp 0.98212,0.0,-0.0,0.0,0.0,0.98312,19.07.2019 22:30:00,17288,-0.0,59.06,IS,0.58,0.0,Phase3-EA-SA2v2-USDCHF-M15-107,USDCHFMT4,3454,59m 57s,Sell
184085.15,1.10157,22.07.2019 01:24:58,tp 1.10157,-2.09,-0.0,0.0,0.0,1.10267,19.07.2019 22:20:00,17289,-0.0,43.78,IS,0.41,0.0,Phase3-EA-SA2v2-EURCHF-M5-43,EURCHFMT4,8874,2d 3h 4m,Sell
183999.28,1.10333,22.07.2019 09:45:00,,0.0,-85.86999999999534,0.0,0.0,1.10127,22.07.2019 01:25:00,17290,-0.03132967984584171,-85.87,IS,0.41,0.0,Phase3-EA-SA2v2-EURCHF-M5-43,EURCHFMT4,8876,8h 20m,Sell
184040.84,1.10132,22.07.2019 13:00:00,,0.0,-44.30999999999767,0.0,0.0,1.10252,22.07.2019 04:15:00,17291,-0.01616650883858447,41.56,IS,0.34,0.0,Phase3-EA-S4v1-EURCHF-M15-221,EURCHFMT4,4548,8h 45m,Sell
184003.82,120882,23.07.2019 01:14:57,sl 120.882,-0.77,-81.3300000000163,0.0,0.0,121112,22.07.2019 18:00:00,17292,-0.029673260298858212,-37.02,IS,0.17,0.0,Phase3-EA-T1v2-EURJPY-M15-322,EURJPYMT4,3444,7h 14m,Buy
183970.07,1.10167,23.07.2019 07:55:00,,-2.09,-115.0800000000163,0.0,0.0,1.10091,22.07.2019 23:35:00,17293,-0.04198695186514696,-33.75,IS,0.41,0.0,Phase3-EA-SA2v2-EURCHF-M5-43,EURCHFMT4,8878,8h 20m,Sell
183955.91,1.10142,23.07.2019 12:15:00,,0.0,-129.2399999999907,0.0,0.0,1.10101,23.07.2019 03:30:00,17294,-0.047153229571171656,-14.16,IS,0.34,0.0,Phase3-EA-S4v1-EURCHF-M15-221,EURCHFMT4,4550,8h 45m,Sell
183913.91,1.24435,23.07.2019 16:29:58,sl 1.24435,0.0,-171.2399999999907,0.0,0.0,1.24735,23.07.2019 15:30:00,17295,-0.0624769346314421,-42.0,IS,0.14,0.0,Phase3-EA-B1v1-GBPUSD-M30-14,GBPUSDMT4,1144,59m 58s,Buy
183853.16,120502,23.07.2019 19:29:57,sl 120.502,-0.82,-231.9899999999907,0.0,0.0,121089,18.07.2019 13:00:00,17296,-0.08464157945076185,-60.75,IS,0.09,0.0,Phase3-EA-TR1v1-EURJPY-M30-91,EURJPYMT4,3030,5d 6h 29m,Buy
183849.83,1.09886,24.07.2019 04:30:00,,-2.08,-235.32000000000698,0.0,0.0,1.09883,23.07.2019 20:10:00,17297,-0.08585653035197495,-3.33,IS,0.41,0.0,Phase3-EA-SA2v2-EURCHF-M5-43,EURCHFMT4,8880,8h 20m,Sell
183833.89,134515,24.07.2019 05:40:00,,0.0,-251.2600000000093,0.0,0.0,134.59,24.07.2019 00:15:00,17298,-0.09167224127246891,-15.94,IS,0.23,0.0,Phase3-EA-S4v1-GBPJPY-M5-194,GBPJPYMT4,3736,5h 25m,Buy
183767.28,120309,24.07.2019 11:59:57,sl 120.309,-1.64,-317.86999999999534,0.0,0.0,121222,19.07.2019 11:00:00,17299,-0.11597490779781178,-66.61,IS,0.09,0.0,Phase3-EA-TR1v1-EURJPY-M30-91,EURJPYMT4,3031,5d 0h 59m,Buy
183802.48,1.09796,24.07.2019 13:45:00,,0.0,-282.6699999999837,0.0,0.0,1.09898,24.07.2019 05:00:00,17300,-0.10313218355681897,35.2,IS,0.34,0.0,Phase3-EA-S4v1-EURCHF-M15-221,EURCHFMT4,4552,8h 45m,Sell
183773.67,1.09691,25.07.2019 07:55:00,,-3.0,-311.4799999999814,0.0,0.0,1.09753,24.07.2019 23:35:00,17301,-0.11364351552792268,-28.81,IS,0.41,0.0,Phase3-EA-SA2v2-EURCHF-M5-43,EURCHFMT4,8882,8h 20m,Buy
183771.94,1.09713,25.07.2019 10:30:00,,0.0,-313.20999999996275,0.0,0.0,1.09718,25.07.2019 01:45:00,17302,-0.11427470623635083,-1.73,IS,0.34,0.0,Phase3-EA-S4v1-EURCHF-M15-221,EURCHFMT4,4554,8h 45m,Buy
183729.94,1.2503,25.07.2019 15:59:57,sl 1.25030,0.0,-355.20999999996275,0.0,0.0,1.2473,25.07.2019 07:30:00,17303,-0.12959841129662128,-42.0,IS,0.14,0.0,Phase3-EA-B1v1-GBPUSD-M30-14,GBPUSDMT4,1146,8h 29m,Sell
183668.96,121286,25.07.2019 17:59:58,sl 121.286,-1.16,-416.1899999999441,0.0,0.0,120566,23.07.2019 19:30:00,17304,-0.15184697164364525,-60.98,IS,0.09,0.0,Phase3-EA-TR1v1-EURJPY-M30-91,EURJPYMT4,3033,1d 22h 29m,Sell
183714.49,1.10452,25.07.2019 22:39:58,tp 1.10452,0.0,-370.6599999999162,0.0,0.0,1.10342,25.07.2019 21:10:00,17305,-0.13523534565806092,45.53,IS,0.41,0.0,Phase3-EA-SA2v2-EURCHF-M5-43,EURCHFMT4,8884,1h 29m,Buy
183727.66,108682,26.07.2019 04:15:00,,0.0,-357.4899999999325,0.0,0.0,108629,26.07.2019 00:15:00,17306,-0.13043026957131063,13.17,IS,0.27,0.0,Phase3-EA-S1v2-USDJPY-M15-0,USDJPYMT4,4814,4h 0m,Buy
183762.85,1.10381,26.07.2019 07:15:00,,-2.07,-322.29999999993015,0.0,0.0,1.10471,25.07.2019 22:55:00,17307,-0.11759119383152604,35.19,IS,0.41,0.0,Phase3-EA-SA2v2-EURCHF-M5-43,EURCHFMT4,8886,8h 20m,Sell
183796.08,1.10509,26.07.2019 14:15:00,,0.0,-289.0699999999488,0.0,0.0,1.10412,26.07.2019 05:30:00,17308,-0.10546722432789506,33.23,IS,0.34,0.0,Phase3-EA-S4v1-EURCHF-M15-221,EURCHFMT4,4556,8h 45m,Buy
183839.43,1.10472,29.07.2019 01:00:00,tp 1.10472,-2.06,-245.71999999997206,0.0,0.0,1.10582,26.07.2019 21:45:00,17309,-0.08965097160498156,43.35,IS,0.41,0.0,Phase3-EA-SA2v2-EURCHF-M5-43,EURCHFMT4,8888,2d 3h 15m,Sell
183884.82,1.10497,29.07.2019 01:09:58,tp 1.10497,0.0,-200.3299999999581,0.0,0.0,1.10387,29.07.2019 01:00:00,17310,-0.0730904246362699,45.39,IS,0.41,0.0,Phase3-EA-SA2v2-EURCHF-M5-43,EURCHFMT4,8890,9m 58s,Buy
183803.54,0.99184,29.07.2019 05:30:00,,0.0,-281.60999999998603,0.0,0.0,0.99323,29.07.2019 01:15:00,17311,-0.10274544242910823,-81.28,IS,0.58,0.0,Phase3-EA-SA2v2-USDCHF-M15-107,USDCHFMT4,3456,4h 15m,Buy
183743.75,134205,29.07.2019 06:40:00,,0.0,-341.3999999999651,0.0,0.0,134487,29.07.2019 01:15:00,17312,-0.12455983113275701,-59.79,IS,0.23,0.0,Phase3-EA-S4v1-GBPJPY-M5-194,GBPJPYMT4,3738,5h 25m,Buy
183676.52,1.10284,29.07.2019 14:15:00,,0.0,-408.62999999994645,0.0,0.0,1.1048,29.07.2019 05:30:00,17313,-0.1490887047327974,-67.23,IS,0.34,0.0,Phase3-EA-S4v1-EURCHF-M15-221,EURCHFMT4,4558,8h 45m,Buy
183817.22,133833,29.07.2019 14:59:58,tp 133.833,-12.52,-267.9299999999348,0.0,0.0,135683,03.07.2019 04:30:00,17314,-0.09775429278088717,140.7,IS,0.09,0.0,Phase3-EA-B1v1-GBPJPY-M30-1,GBPJPYMT4,1548,26d 10h 29m,Sell
183781.29,120984,29.07.2019 18:59:59,sl 120.984,0.0,-303.8599999999278,0.0,0.0,120754,29.07.2019 15:30:00,17315,-0.1108633576098255,-35.93,IS,0.17,0.0,Phase3-EA-T1v2-EURJPY-M15-322,EURJPYMT4,3446,3h 29m,Sell
183934.07,131957,30.07.2019 08:59:58,tp 131.957,-0.48,-151.07999999989988,0.0,0.0,133807,29.07.2019 15:00:00,17316,-0.055121556202479154,152.78,IS,0.09,0.0,Phase3-EA-B1v1-GBPJPY-M30-1,GBPJPYMT4,1550,17h 59m,Sell
183979.55,1.10424,30.07.2019 11:04:57,tp 1.10424,0.0,-105.59999999991851,0.0,0.0,1.10534,30.07.2019 02:50:00,17317,-0.038528172722935954,45.48,IS,0.41,0.0,Phase3-EA-SA2v2-EURCHF-M5-43,EURCHFMT4,8892,8h 14m,Sell
184016.95,1.10426,30.07.2019 11:45:00,,0.0,-68.19999999989523,0.0,0.0,1.10535,30.07.2019 03:00:00,17318,-0.024882778216877115,37.4,IS,0.34,0.0,Phase3-EA-S4v1-EURCHF-M15-221,EURCHFMT4,4560,8h 45m,Sell
183992.82,0.99007,31.07.2019 02:15:00,,-0.7,-92.32999999989988,0.0,0.0,0.99047,30.07.2019 22:00:00,17319,-0.03368661162412467,-24.13,IS,0.58,0.0,Phase3-EA-SA2v2-USDCHF-M15-107,USDCHFMT4,3458,4h 15m,Buy
183999.44,1.1047,31.07.2019 05:15:00,,-2.07,-85.70999999990454,0.0,0.0,1.10491,30.07.2019 20:55:00,17320,-0.03127130382653136,6.62,IS,0.41,0.0,Phase3-EA-SA2v2-EURCHF-M5-43,EURCHFMT4,8894,8h 20m,Sell
183991.54,1.10511,31.07.2019 11:30:00,,0.0,-93.60999999992782,0.0,0.0,1.10488,31.07.2019 02:45:00,17321,-0.03415361977835262,-7.9,IS,0.34,0.0,Phase3-EA-S4v1-EURCHF-M15-221,EURCHFMT4,4562,8h 45m,Sell
183931.1,120549,31.07.2019 22:59:58,sl 120.549,-0.82,-154.04999999993015,0.0,0.0,121059,26.07.2019 09:30:00,17322,-0.05620516106032361,-60.44,IS,0.09,0.0,Phase3-EA-TR1v1-EURJPY-M30-91,EURJPYMT4,3036,5d 13h 29m,Sell
183908.8,1.1017,01.08.2019 04:45:00,,-2.97,-176.3499999999185,0.0,0.0,1.10217,31.07.2019 20:25:00,17323,-0.064341318747082,-22.3,IS,0.41,0.0,Phase3-EA-SA2v2-EURCHF-M5-43,EURCHFMT4,8896,8h 20m,Buy
184013.91,119769,01.08.2019 17:29:58,tp 119.769,-1.74,-71.23999999993248,0.0,0.0,121269,29.07.2019 23:00:00,17324,-0.025991922583157898,105.11,IS,0.09,0.0,Phase3-EA-TR1v1-EURJPY-M30-91,EURJPYMT4,3037,2d 18h 29m,Buy
184118.95,118988,01.08.2019 21:59:58,tp 118.988,0.0,-0.0,0.0,0.0,120248,01.08.2019 15:00:00,17325,-0.0,105.04,IS,0.09,0.0,Phase3-EA-TR1v1-EURJPY-M30-91,EURJPYMT4,3039,6h 59m,Sell
184387.79,118777,02.08.2019 04:59:58,tp 118.777,-0.55,-0.0,0.0,0.0,120477,01.08.2019 11:45:00,17326,-0.0,268.84,IS,0.17,0.0,Phase3-EA-T1v2-EURJPY-M15-322,EURJPYMT4,3448,17h 14m,Sell
184271.05,1.09582,02.08.2019 05:15:00,,-0.99,-116.73999999999069,0.0,0.0,1.09861,01.08.2019 20:55:00,17327,-0.04254562493469196,-116.74,IS,0.41,0.0,Phase3-EA-SA2v2-EURCHF-M5-43,EURCHFMT4,8898,8h 20m,Buy
184184.11,1.09349,02.08.2019 14:30:00,,0.0,-203.67999999999302,0.0,0.0,1.09601,02.08.2019 05:45:00,17328,-0.07423070829791376,-86.94,IS,0.34,0.0,Phase3-EA-S4v1-EURCHF-M15-221,EURCHFMT4,4564,8h 45m,Buy
184339.72,129137,02.08.2019 18:59:58,tp 129.137,-0.49,-48.070000000006985,0.0,0.0,130987,01.08.2019 21:30:00,17329,-0.01751900111882048,155.61,IS,0.09,0.0,Phase3-EA-B1v1-GBPJPY-M30-1,GBPJPYMT4,1552,21h 29m,Sell
184384.63,1.09241,05.08.2019 01:00:00,tp 1.09241,-1.0,-3.1600000000325963,0.0,0.0,1.09131,02.08.2019 20:00:00,17330,-0.001151654743832655,44.91,IS,0.41,0.0,Phase3-EA-SA2v2-EURCHF-M5-43,EURCHFMT4,8900,2d 5h 0m,Buy
184430.53,1.09173,05.08.2019 01:49:58,tp 1.09173,0.0,-0.0,0.0,0.0,1.09283,05.08.2019 01:10:00,17331,-0.0,45.9,IS,0.41,0.0,Phase3-EA-SA2v2-EURCHF-M5-43,EURCHFMT4,8902,39m 58s,Sell
184492.87,106.33,05.08.2019 04:15:00,,-1.14,-0.0,0.0,0.0,106.58,02.08.2019 23:45:00,17332,-0.0,62.34,IS,0.27,0.0,Phase3-EA-S1v2-USDJPY-M15-0,USDJPYMT4,4816,2d 4h 30m,Sell
184599.23,117825,05.08.2019 05:59:57,tp 117.825,-0.59,-0.0,0.0,0.0,119085,01.08.2019 22:00:00,17333,-0.0,106.36,IS,0.09,0.0,Phase3-EA-TR1v1-EURJPY-M30-91,EURJPYMT4,3042,3d 7h 59m,Sell
184703.47,1.08885,05.08.2019 10:30:00,,0.0,-0.0,0.0,0.0,1.09185,05.08.2019 01:45:00,17334,-0.0,104.24,IS,0.34,0.0,Phase3-EA-S4v1-EURCHF-M15-221,EURCHFMT4,4566,8h 45m,Sell
184642.36,118627,05.08.2019 15:59:58,sl 118.627,0.0,-61.10999999998603,0.0,0.0,117907,05.08.2019 08:00:00,17335,-0.022245805631791172,-61.11,IS,0.09,0.0,Phase3-EA-TR1v1-EURJPY-M30-91,EURJPYMT4,3044,7h 59m,Sell
184686.6,1.08946,06.08.2019 01:09:57,tp 1.08946,-2.1,-16.869999999995343,0.0,0.0,1.09056,05.08.2019 21:30:00,17336,-0.006141167419543434,44.24,IS,0.41,0.0,Phase3-EA-SA2v2-EURCHF-M5-43,EURCHFMT4,8904,3h 39m,Sell
184771.42,128698,06.08.2019 04:44:58,tp 128.698,0.0,-0.0,0.0,0.0,128308,06.08.2019 02:05:00,17337,-0.0,84.82,IS,0.23,0.0,Phase3-EA-S4v1-GBPJPY-M5-194,GBPJPYMT4,3740,2h 39m,Buy
184831.03,0.97294,06.08.2019 05:44:58,tp 0.97294,0.0,-0.0,0.0,0.0,0.97194,06.08.2019 02:15:00,17338,-0.0,59.61,IS,0.58,0.0,Phase3-EA-SA2v2-USDCHF-M15-107,USDCHFMT4,3460,3h 29m,Buy
184937.09,119844,06.08.2019 08:29:58,tp 119.844,-0.42,-0.0,0.0,0.0,118584,05.08.2019 17:00:00,17339,-0.0,106.06,IS,0.09,0.0,Phase3-EA-TR1v1-EURJPY-M30-91,EURJPYMT4,3046,15h 29m,Buy
184910.23,1.09185,06.08.2019 12:45:00,,0.0,-26.85999999998603,0.0,0.0,1.09108,06.08.2019 04:00:00,17340,-0.009769507635359755,-26.86,IS,0.34,0.0,Phase3-EA-S4v1-EURCHF-M15-221,EURCHFMT4,4568,8h 45m,Sell
184956.4,1.09364,06.08.2019 20:49:58,tp 1.09364,0.0,-0.0,0.0,0.0,1.09474,06.08.2019 20:05:00,17341,-0.0,46.17,IS,0.41,0.0,Phase3-EA-SA2v2-EURCHF-M5-43,EURCHFMT4,8906,44m 58s,Sell
185002.55,1.09453,06.08.2019 23:14:58,tp 1.09453,0.0,-0.0,0.0,0.0,1.09343,06.08.2019 21:15:00,17342,-0.0,46.15,IS,0.41,0.0,Phase3-EA-SA2v2-EURCHF-M5-43,EURCHFMT4,8908,1h 59m,Buy
184986.24,119064,07.08.2019 04:45:00,,-0.78,-16.30999999999767,0.0,0.0,119161,06.08.2019 21:00:00,17343,-0.005930854095715695,-16.31,IS,0.17,0.0,Phase3-EA-T1v2-EURJPY-M15-322,EURJPYMT4,3450,7h 45m,Buy
184944.03,0.97564,07.08.2019 05:00:00,,0.0,-58.52000000001863,0.0,0.0,0.97635,07.08.2019 00:45:00,17344,-0.02127980267820003,-42.21,IS,0.58,0.0,Phase3-EA-SA2v2-USDCHF-M15-107,USDCHFMT4,3462,4h 15m,Buy
184990.24,1.09474,07.08.2019 07:44:57,tp 1.09474,0.0,-12.309999999997672,0.0,0.0,1.09364,07.08.2019 01:05:00,17345,-0.004476322128648487,46.21,IS,0.41,0.0,Phase3-EA-SA2v2-EURCHF-M5-43,EURCHFMT4,8910,6h 39m,Buy
185032.01,1.09402,07.08.2019 11:45:00,,0.0,-0.0,0.0,0.0,1.09282,07.08.2019 03:00:00,17346,-0.0,41.77,IS,0.34,0.0,Phase3-EA-S4v1-EURCHF-M15-221,EURCHFMT4,4570,8h 45m,Buy
185078.41,1.09149,07.08.2019 21:34:58,tp 1.09149,0.0,-0.0,0.0,0.0,1.09039,07.08.2019 20:15:00,17347,-0.0,46.4,IS,0.41,0.0,Phase3-EA-SA2v2-EURCHF-M5-43,EURCHFMT4,8912,1h 19m,Buy
185007.29,106099,08.08.2019 04:45:00,,-3.43,-71.11999999999534,0.0,0.0,105833,07.08.2019 21:15:00,17348,-0.025854446374033873,-71.12,IS,0.27,0.0,Phase3-EA-S1v2-USDJPY-M15-0,USDJPYMT4,4818,7h 30m,Sell
185009.67,0.97501,08.08.2019 05:30:00,,0.0,-68.73999999999069,0.0,0.0,0.97505,08.08.2019 01:15:00,17349,-0.024989238522932566,2.38,IS,0.58,0.0,Phase3-EA-SA2v2-USDCHF-M15-107,USDCHFMT4,3464,4h 15m,Sell
184952.51,1.09365,08.08.2019 08:25:00,,0.0,-125.89999999996508,0.0,0.0,1.09229,08.08.2019 00:05:00,17350,-0.04576876825773587,-57.16,IS,0.41,0.0,Phase3-EA-SA2v2-EURCHF-M5-43,EURCHFMT4,8914,8h 20m,Sell
184943.45,1.09319,08.08.2019 15:00:00,,0.0,-134.95999999996275,0.0,0.0,1.09293,08.08.2019 06:15:00,17351,-0.049062374615282296,-9.06,IS,0.34,0.0,Phase3-EA-S4v1-EURCHF-M15-221,EURCHFMT4,4572,8h 45m,Sell
184825.46,1.09005,09.08.2019 04:20:00,,-1.01,-252.94999999995343,0.0,0.0,1.09283,08.08.2019 20:00:00,17352,-0.09195559913260816,-117.99,IS,0.41,0.0,Phase3-EA-SA2v2-EURCHF-M5-43,EURCHFMT4,8916,8h 20m,Buy
184871.67,128668,09.08.2019 06:50:00,,0.0,-206.73999999993248,0.0,0.0,128455,09.08.2019 01:25:00,17353,-0.07515675257826726,46.21,IS,0.23,0.0,Phase3-EA-S4v1-GBPJPY-M5-194,GBPJPYMT4,3742,5h 25m,Buy
184911.44,1.09072,09.08.2019 11:45:00,,0.0,-166.96999999991385,0.0,0.0,1.08958,09.08.2019 03:00:00,17354,-0.0606990566798438,39.77,IS,0.34,0.0,Phase3-EA-S4v1-EURCHF-M15-221,EURCHFMT4,4574,8h 45m,Buy
184857.87,126892,12.08.2019 05:10:00,,-0.78,-220.53999999992084,0.0,0.0,127134,09.08.2019 23:45:00,17355,-0.0801735039837986,-53.57,IS,0.23,0.0,Phase3-EA-S4v1-GBPJPY-M5-194,GBPJPYMT4,3744,2d 5h 25m,Buy
184966.05,117975,12.08.2019 11:29:58,tp 117.975,-1.79,-112.35999999992782,0.0,0.0,119265,06.08.2019 12:30:00,17356,-0.04084653535692871,108.18,IS,0.09,0.0,Phase3-EA-TR1v1-EURJPY-M30-91,EURJPYMT4,3048,5d 22h 59m,Sell
184950.69,1.08842,12.08.2019 13:30:00,,0.0,-127.71999999991385,0.0,0.0,1.08886,12.08.2019 04:45:00,17357,-0.04643039779091107,-15.36,IS,0.34,0.0,Phase3-EA-S4v1-EURCHF-M15-221,EURCHFMT4,4576,8h 45m,Buy
184950.95,105187,12.08.2019 22:45:00,,0.0,-127.45999999990454,0.0,0.0,105188,12.08.2019 17:45:00,17358,-0.046335879286165706,0.26,IS,0.27,0.0,Phase3-EA-S1v2-USDJPY-M15-0,USDJPYMT4,4820,5h 0m,Sell
185010.74,0.97006,13.08.2019 06:14:58,tp 0.97006,0.0,-67.6699999999255,0.0,0.0,0.96906,13.08.2019 02:15:00,17359,-0.024600258522624582,59.79,IS,0.58,0.0,Phase3-EA-SA2v2-USDCHF-M15-107,USDCHFMT4,3466,3h 59m,Buy
185056.16,1.08818,13.08.2019 06:44:58,tp 1.08818,-1.02,-22.249999999941792,0.0,0.0,1.08708,12.08.2019 23:05:00,17360,-0.008088602809628606,45.42,IS,0.41,0.0,Phase3-EA-SA2v2-EURCHF-M5-43,EURCHFMT4,8918,7h 39m,Buy
185102.82,127271,13.08.2019 07:05:00,,0.0,-0.0,0.0,0.0,127057,13.08.2019 01:40:00,17361,-0.0,46.66,IS,0.23,0.0,Phase3-EA-S4v1-GBPJPY-M5-194,GBPJPYMT4,3746,5h 25m,Buy
185044.52,128086,13.08.2019 17:59:58,sl 128.086,-0.99,-58.29999999998836,0.0,0.0,127416,09.08.2019 19:30:00,17362,-0.021192076475256814,-58.3,IS,0.09,0.0,Phase3-EA-B1v1-GBPJPY-M30-1,GBPJPYMT4,1554,3d 22h 29m,Sell
185005.76,118906,13.08.2019 17:59:58,sl 118.906,-1.68,-97.05999999999767,0.0,0.0,118676,08.08.2019 22:15:00,17363,-0.03528135407699464,-38.76,IS,0.17,0.0,Phase3-EA-T1v2-EURJPY-M15-322,EURJPYMT4,3452,4d 19h 44m,Sell
184942.99,119494,13.08.2019 18:29:58,sl 119.494,-1.79,-159.8300000000163,0.0,0.0,118774,07.08.2019 15:30:00,17364,-0.058098277582183847,-62.77,IS,0.09,0.0,Phase3-EA-TR1v1-EURJPY-M30-91,EURJPYMT4,3049,6d 2h 59m,Sell
185027.24,128.29,14.08.2019 04:24:58,tp 128.290,0.0,-75.5800000000163,0.0,0.0,128.68,14.08.2019 01:00:00,17365,-0.02747336432247985,84.25,IS,0.23,0.0,Phase3-EA-S4v1-GBPJPY-M5-194,GBPJPYMT4,3748,3h 24m,Sell
185071.37,1.0897,14.08.2019 06:04:57,tp 1.08970,-2.1,-31.45000000001164,0.0,0.0,1.0908,13.08.2019 23:35:00,17366,-0.01143208928211332,44.13,IS,0.41,0.0,Phase3-EA-SA2v2-EURCHF-M5-43,EURCHFMT4,8920,6h 29m,Sell
185034.57,118722,14.08.2019 14:29:58,sl 118.722,0.0,-68.25,0.0,0.0,118952,14.08.2019 12:30:00,17367,-0.024808905993766145,-36.8,IS,0.17,0.0,Phase3-EA-T1v2-EURJPY-M15-322,EURJPYMT4,3454,1h 59m,Buy
184925.49,1.08646,14.08.2019 15:30:00,,0.0,-177.3300000000163,0.0,0.0,1.08958,14.08.2019 06:45:00,17368,-0.06445953552930336,-109.08,IS,0.34,0.0,Phase3-EA-S4v1-EURCHF-M15-221,EURCHFMT4,4578,8h 45m,Buy
184957.02,105765,15.08.2019 01:30:00,,-3.44,-145.79999999998836,0.0,0.0,105902,14.08.2019 21:30:00,17369,-0.052998366210854436,31.53,IS,0.27,0.0,Phase3-EA-S1v2-USDJPY-M15-0,USDJPYMT4,4822,4h 0m,Sell
185003.34,1.08503,15.08.2019 05:59:57,tp 1.08503,0.0,-99.47999999998137,0.0,0.0,1.08393,15.08.2019 00:25:00,17370,-0.03616102517596182,46.32,IS,0.41,0.0,Phase3-EA-SA2v2-EURCHF-M5-43,EURCHFMT4,8922,5h 34m,Buy
185015.28,127.7,15.08.2019 06:35:00,,0.0,-87.53999999997905,0.0,0.0,127645,15.08.2019 01:10:00,17371,-0.03182082975375485,11.94,IS,0.23,0.0,Phase3-EA-S4v1-GBPJPY-M5-194,GBPJPYMT4,3750,5h 25m,Buy
184953.23,118674,15.08.2019 10:59:58,sl 118.674,-0.89,-149.5899999999674,0.0,0.0,117954,14.08.2019 19:00:00,17372,-0.05437603293196585,-62.05,IS,0.09,0.0,Phase3-EA-TR1v1-EURJPY-M30-91,EURJPYMT4,3052,15h 59m,Sell
184934.72,1.08515,15.08.2019 13:15:00,,0.0,-168.09999999997672,0.0,0.0,1.08462,15.08.2019 04:30:00,17373,-0.06110442633775108,-18.51,IS,0.34,0.0,Phase3-EA-S4v1-EURCHF-M15-221,EURCHFMT4,4580,8h 45m,Sell
184980.89,1.08483,15.08.2019 22:49:58,tp 1.08483,0.0,-121.92999999999302,0.0,0.0,1.08373,15.08.2019 20:10:00,17374,-0.044321610370985094,46.17,IS,0.41,0.0,Phase3-EA-SA2v2-EURCHF-M5-43,EURCHFMT4,8924,2h 39m,Buy
185024.93,1.08383,16.08.2019 01:14:58,tp 1.08383,-2.1,-77.89000000001397,0.0,0.0,1.08493,15.08.2019 23:00:00,17375,-0.02831305037149878,44.04,IS,0.41,0.0,Phase3-EA-SA2v2-EURCHF-M5-43,EURCHFMT4,8926,2h 14m,Sell
185029.02,106113,16.08.2019 01:15:00,,-0.74,-73.79999999998836,0.0,0.0,106094,15.08.2019 20:45:00,17376,-0.026826333514134104,4.09,IS,0.27,0.0,Phase3-EA-S1v2-USDJPY-M15-0,USDJPYMT4,4824,4h 30m,Buy
185075.13,1.08543,16.08.2019 06:29:57,tp 1.08543,0.0,-27.69000000000233,0.0,0.0,1.08433,16.08.2019 01:15:00,17377,-0.010065327574614539,46.11,IS,0.41,0.0,Phase3-EA-SA2v2-EURCHF-M5-43,EURCHFMT4,8928,5h 14m,Buy
185038.34,1.08598,16.08.2019 11:45:00,,0.0,-64.47999999998137,0.0,0.0,1.08492,16.08.2019 03:00:00,17378,-0.02343850928172277,-36.79,IS,0.34,0.0,Phase3-EA-S4v1-EURCHF-M15-221,EURCHFMT4,4582,8h 45m,Sell
185029.72,106276,19.08.2019 01:00:00,,-0.74,-73.09999999997672,0.0,0.0,106307,16.08.2019 17:15:00,17379,-0.026571883196245094,-8.62,IS,0.27,0.0,Phase3-EA-S1v2-USDJPY-M15-0,USDJPYMT4,4826,2d 7h 45m,Buy
185074.82,1.08668,19.08.2019 01:34:57,tp 1.08668,-1.01,-28.0,0.0,0.0,1.08558,16.08.2019 21:40:00,17380,-0.01017801271539124,45.1,IS,0.41,0.0,Phase3-EA-SA2v2-EURCHF-M5-43,EURCHFMT4,8930,2d 3h 54m,Buy
185133.34,0.97918,19.08.2019 01:44:57,tp 0.97918,-0.71,-0.0,0.0,0.0,0.97818,16.08.2019 22:00:00,17381,-0.0,58.52,IS,0.58,0.0,Phase3-EA-SA2v2-USDCHF-M15-107,USDCHFMT4,3468,2d 3h 44m,Buy
185136.38,106.62,19.08.2019 22:45:00,,0.0,-0.0,0.0,0.0,106608,19.08.2019 17:45:00,17382,-0.0,3.04,IS,0.27,0.0,Phase3-EA-S1v2-USDJPY-M15-0,USDJPYMT4,4828,5h 0m,Buy
185134.13,1.08771,20.08.2019 04:50:00,,-1.0,-2.25,0.0,0.0,1.08774,19.08.2019 20:30:00,17383,-8.177762606311786E-4,-2.25,IS,0.41,0.0,Phase3-EA-SA2v2-EURCHF-M5-43,EURCHFMT4,8932,8h 20m,Buy
185076.91,128779,20.08.2019 11:29:57,sl 128.779,-0.6,-59.46999999997206,0.0,0.0,129449,16.08.2019 17:00:00,17384,-0.021614735208761487,-57.22,IS,0.09,0.0,Phase3-EA-B1v1-GBPJPY-M30-1,GBPJPYMT4,1556,3d 18h 29m,Buy
185174.85,1.08482,20.08.2019 13:15:00,,0.0,-0.0,0.0,0.0,1.08764,20.08.2019 04:30:00,17385,-0.0,97.94,IS,0.34,0.0,Phase3-EA-S4v1-EURCHF-M15-221,EURCHFMT4,4584,8h 45m,Sell
185118.07,129037,20.08.2019 17:59:58,sl 129.037,0.0,-56.78000000002794,0.0,0.0,128367,20.08.2019 15:00:00,17386,-0.02063415315753881,-56.78,IS,0.09,0.0,Phase3-EA-B1v1-GBPJPY-M30-1,GBPJPYMT4,1558,2h 59m,Sell
185107.87,0.97779,21.08.2019 02:15:00,,-0.71,-66.98000000003958,0.0,0.0,0.97795,20.08.2019 22:00:00,17387,-0.02434088725769789,-10.2,IS,0.58,0.0,Phase3-EA-SA2v2-USDCHF-M15-107,USDCHFMT4,3470,4h 15m,Buy
185152.94,1.08658,21.08.2019 06:14:58,tp 1.08658,-1.01,-21.910000000032596,0.0,0.0,1.08548,20.08.2019 23:00:00,17388,-0.007962210209266034,45.07,IS,0.41,0.0,Phase3-EA-SA2v2-EURCHF-M5-43,EURCHFMT4,8934,7h 14m,Buy
185108.16,1.08739,21.08.2019 15:30:00,,0.0,-66.69000000006054,0.0,0.0,1.0861,21.08.2019 06:45:00,17389,-0.024235499719563847,-44.78,IS,0.34,0.0,Phase3-EA-S4v1-EURCHF-M15-221,EURCHFMT4,4586,8h 45m,Sell
185098.14,1.08941,22.08.2019 08:05:00,,-6.26,-76.71000000007916,0.0,0.0,1.08932,21.08.2019 23:45:00,17390,-0.02787682086501685,-10.02,IS,0.41,0.0,Phase3-EA-SA2v2-EURCHF-M5-43,EURCHFMT4,8936,8h 20m,Sell
185149.02,1.08808,22.08.2019 14:30:00,,0.0,-25.830000000074506,0.0,0.0,1.08955,22.08.2019 05:45:00,17391,-0.009386759000713325,50.88,IS,0.34,0.0,Phase3-EA-S4v1-EURCHF-M15-221,EURCHFMT4,4588,8h 45m,Sell
185155.98,0.98352,23.08.2019 03:00:00,,-0.71,-18.87000000005355,0.0,0.0,0.98339,22.08.2019 22:45:00,17392,-0.00685745808530593,6.96,IS,0.58,0.0,Phase3-EA-SA2v2-USDCHF-M15-107,USDCHFMT4,3472,4h 15m,Buy
185180.11,1.09056,23.08.2019 09:25:00,,0.0,-0.0,0.0,0.0,1.08998,23.08.2019 01:05:00,17393,-0.0,24.13,IS,0.41,0.0,Phase3-EA-SA2v2-EURCHF-M5-43,EURCHFMT4,8938,8h 20m,Buy
185149.45,1.0914,23.08.2019 14:00:00,,0.0,-30.65999999997439,0.0,0.0,1.09051,23.08.2019 05:15:00,17394,-0.011141793641980249,-30.66,IS,0.34,0.0,Phase3-EA-S4v1-EURCHF-M15-221,EURCHFMT4,4590,8h 45m,Sell
185107.45,1.2245,23.08.2019 19:29:58,sl 1.22450,0.0,-72.65999999997439,0.0,0.0,1.2275,23.08.2019 19:00:00,17395,-0.0264045246584043,-42.0,IS,0.14,0.0,Phase3-EA-B1v1-GBPUSD-M30-14,GBPUSDMT4,1148,29m 58s,Buy
185375.99,117049,26.08.2019 01:14:57,tp 117.049,-6.71,-0.0,0.0,0.0,118749,14.08.2019 14:45:00,17396,-0.0,268.54,IS,0.17,0.0,Phase3-EA-T1v2-EURJPY-M15-322,EURJPYMT4,3456,11d 10h 29m,Sell
185305.82,117048,26.08.2019 01:29:57,sl 117.048,-3.31,-70.1699999999837,0.0,0.0,117828,16.08.2019 09:00:00,17397,-0.02548152436963854,-70.17,IS,0.09,0.0,Phase3-EA-TR1v1-EURJPY-M30-91,EURJPYMT4,3054,9d 16h 29m,Buy
185412.14,116615,26.08.2019 02:29:58,tp 116.615,-1.79,-0.0,0.0,0.0,117875,20.08.2019 12:00:00,17398,-0.0,106.32,IS,0.09,0.0,Phase3-EA-TR1v1-EURJPY-M30-91,EURJPYMT4,3055,5d 14h 29m,Sell
185497.41,129151,26.08.2019 05:19:58,tp 129.151,0.0,-0.0,0.0,0.0,128761,26.08.2019 01:10:00,17399,-0.0,85.27,IS,0.23,0.0,Phase3-EA-S4v1-GBPJPY-M5-194,GBPJPYMT4,3752,4h 9m,Buy
185542.65,1087,26.08.2019 05:19:58,tp 1.08700,-1.01,-0.0,0.0,0.0,1.0859,23.08.2019 21:35:00,17400,-0.0,45.24,IS,0.41,0.0,Phase3-EA-SA2v2-EURCHF-M5-43,EURCHFMT4,8940,2d 7h 44m,Buy
185645.12,105398,26.08.2019 06:59:58,tp 105.398,0.0,-0.0,0.0,0.0,104998,26.08.2019 01:00:00,17401,-0.0,102.47,IS,0.27,0.0,Phase3-EA-S1v2-USDJPY-M15-0,USDJPYMT4,4830,5h 59m,Buy
185757.18,1.08772,26.08.2019 11:00:00,,0.0,-0.0,0.0,0.0,1.0845,26.08.2019 02:15:00,17402,-0.0,112.06,IS,0.34,0.0,Phase3-EA-S4v1-EURCHF-M15-221,EURCHFMT4,4592,8h 45m,Buy
185803.23,1.08706,26.08.2019 22:34:59,tp 1.08706,0.0,-0.0,0.0,0.0,1.08816,26.08.2019 20:50:00,17403,-0.0,46.05,IS,0.41,0.0,Phase3-EA-SA2v2-EURCHF-M5-43,EURCHFMT4,8942,1h 44m,Sell
185790.5,1.08664,27.08.2019 07:40:00,,-1.0,-12.729999999981374,0.0,0.0,1.08692,26.08.2019 23:20:00,17404,-0.004615609469106405,-12.73,IS,0.41,0.0,Phase3-EA-SA2v2-EURCHF-M5-43,EURCHFMT4,8944,8h 20m,Buy
185787.18,105734,28.08.2019 03:30:00,,0.0,-16.04999999998836,0.0,0.0,105721,28.08.2019 01:15:00,17405,-0.005819366219891002,-3.32,IS,0.27,0.0,Phase3-EA-S1v2-USDJPY-M15-0,USDJPYMT4,4832,2h 15m,Sell
185799.97,1.08826,28.08.2019 05:05:00,,-1.0,-3.2600000000093132,0.0,0.0,1.08793,27.08.2019 20:45:00,17406,-0.001182002110711067,12.79,IS,0.41,0.0,Phase3-EA-SA2v2-EURCHF-M5-43,EURCHFMT4,8946,8h 20m,Buy
185741.84,1.09015,28.08.2019 11:45:00,,0.0,-61.39000000001397,0.0,0.0,1.08847,28.08.2019 03:00:00,17407,-0.02225862256943608,-58.13,IS,0.34,0.0,Phase3-EA-S4v1-EURCHF-M15-221,EURCHFMT4,4594,8h 45m,Sell
185699.31,1.2207,28.08.2019 12:59:58,sl 1.22070,-0.53,-103.92000000004191,0.0,0.0,1.2237,27.08.2019 11:30:00,17408,-0.03767903660883212,-42.53,IS,0.14,0.0,Phase3-EA-B1v1-GBPUSD-M30-14,GBPUSDMT4,1150,1d 1h 29m,Buy
185661.86,117501,28.08.2019 22:44:58,sl 117.501,-0.56,-141.37000000005355,0.0,0.0,117271,27.08.2019 20:15:00,17409,-0.05125755778859186,-37.45,IS,0.17,0.0,Phase3-EA-T1v2-EURJPY-M15-322,EURJPYMT4,3458,1d 2h 29m,Sell
185701.61,1.08658,29.08.2019 05:49:57,tp 1.08658,-6.26,-101.62000000005355,0.0,0.0,1.08768,28.08.2019 22:40:00,17410,-0.03684510873931864,39.75,IS,0.41,0.0,Phase3-EA-SA2v2-EURCHF-M5-43,EURCHFMT4,8948,7h 9m,Sell
185632.98,129214,29.08.2019 06:25:00,,0.0,-170.2500000000582,0.0,0.0,129.53,29.08.2019 01:00:00,17411,-0.061728791211059224,-68.63,IS,0.23,0.0,Phase3-EA-S4v1-GBPJPY-M5-194,GBPJPYMT4,3754,5h 25m,Buy
185587.68,1.08908,29.08.2019 13:00:00,,0.0,-215.55000000004657,0.0,0.0,1.08777,29.08.2019 04:15:00,17412,-0.07815354446720787,-45.3,IS,0.34,0.0,Phase3-EA-S4v1-EURCHF-M15-221,EURCHFMT4,4596,8h 45m,Sell
185615.85,106378,29.08.2019 17:45:00,,0.0,-187.38000000006286,0.0,0.0,106267,29.08.2019 17:00:00,17413,-0.06793974095229488,28.17,IS,0.27,0.0,Phase3-EA-S1v2-USDJPY-M15-0,USDJPYMT4,4834,45m 0s,Buy
185658.8,117798,30.08.2019 03:45:00,,-0.78,-144.43000000005122,0.0,0.0,117524,29.08.2019 11:45:00,17414,-0.05236704443238413,42.95,IS,0.17,0.0,Phase3-EA-T1v2-EURJPY-M15-322,EURJPYMT4,3460,16h 0m,Buy
185674.08,0.98687,30.08.2019 04:45:00,,0.0,-129.15000000002328,0.0,0.0,0.98661,30.08.2019 00:30:00,17415,-0.04682686276009992,15.28,IS,0.58,0.0,Phase3-EA-SA2v2-USDCHF-M15-107,USDCHFMT4,3474,4h 15m,Buy
185651.16,129596,30.08.2019 05:35:00,,0.0,-152.07000000000698,0.0,0.0,129702,30.08.2019 00:10:00,17416,-0.05513713526850513,-22.92,IS,0.23,0.0,Phase3-EA-S4v1-GBPJPY-M5-194,GBPJPYMT4,3756,5h 25m,Buy
185647.83,1.09077,30.08.2019 05:45:00,,-2.08,-155.40000000002328,0.0,0.0,1.09074,29.08.2019 21:25:00,17417,-0.05634451779263883,-3.33,IS,0.41,0.0,Phase3-EA-SA2v2-EURCHF-M5-43,EURCHFMT4,8950,8h 20m,Sell
185656.7,106514,30.08.2019 11:45:00,,0.0,-146.53000000002794,0.0,0.0,106479,30.08.2019 00:15:00,17418,-0.0531284568349788,8.87,IS,0.27,0.0,Phase3-EA-S1v2-USDJPY-M15-0,USDJPYMT4,4836,11h 30m,Buy
185671.04,1.08786,02.09.2019 05:40:00,,-0.99,-132.19000000000233,0.0,0.0,1.08749,30.08.2019 21:20:00,17419,-0.047929097857193965,14.34,IS,0.41,0.0,Phase3-EA-SA2v2-EURCHF-M5-43,EURCHFMT4,8952,2d 8h 20m,Buy
185728.66,129044,02.09.2019 06:45:00,,0.0,-74.57000000000698,0.0,0.0,128778,02.09.2019 01:20:00,17420,-0.027037391839104516,57.62,IS,0.23,0.0,Phase3-EA-S4v1-GBPJPY-M5-194,GBPJPYMT4,3758,5h 25m,Buy
185770.54,1.08682,02.09.2019 15:30:00,,0.0,-32.69000000000233,0.0,0.0,1.08804,02.09.2019 06:45:00,17421,-0.011852653067189309,41.88,IS,0.34,0.0,Phase3-EA-S4v1-EURCHF-M15-221,EURCHFMT4,4598,8h 45m,Sell
185701.48,116362,02.09.2019 20:59:57,sl 116.362,-2.92,-101.75,0.0,0.0,117142,26.08.2019 05:00:00,17422,-0.03689224379279371,-69.06,IS,0.09,0.0,Phase3-EA-TR1v1-EURJPY-M30-91,EURJPYMT4,3058,7d 15h 59m,Buy
185696.36,1.08604,03.09.2019 04:40:00,,-0.99,-106.86999999999534,0.0,0.0,1.08614,02.09.2019 20:20:00,17423,-0.03874863974580532,-5.12,IS,0.41,0.0,Phase3-EA-SA2v2-EURCHF-M5-43,EURCHFMT4,8954,8h 20m,Buy
185801.03,116066,03.09.2019 11:29:57,tp 116.066,-2.09,-2.2000000000116415,0.0,0.0,117326,27.08.2019 09:30:00,17424,-7.976701360646255E-4,104.67,IS,0.09,0.0,Phase3-EA-TR1v1-EURJPY-M30-91,EURJPYMT4,3059,7d 1h 59m,Sell
185706.65,1.08299,03.09.2019 14:45:00,,0.0,-96.5800000000163,0.0,0.0,1.08574,03.09.2019 06:00:00,17425,-0.035017718973057665,-94.38,IS,0.34,0.0,Phase3-EA-S4v1-EURCHF-M15-221,EURCHFMT4,4600,8h 45m,Buy
185756.51,105852,04.09.2019 04:00:00,,-1.15,-46.72000000003027,0.0,0.0,106052,03.09.2019 23:30:00,17426,-0.01693961307125738,49.86,IS,0.27,0.0,Phase3-EA-S1v2-USDJPY-M15-0,USDJPYMT4,4838,4h 30m,Sell
185755.26,1.08302,04.09.2019 07:55:00,,-2.08,-47.97000000003027,0.0,0.0,1.08304,03.09.2019 23:35:00,17427,-0.01739283473947352,-1.25,IS,0.41,0.0,Phase3-EA-SA2v2-EURCHF-M5-43,EURCHFMT4,8956,8h 20m,Sell
185693.93,116733,04.09.2019 11:59:58,sl 116.733,-0.3,-109.30000000004657,0.0,0.0,116113,03.09.2019 13:00:00,17428,-0.03962970266883607,-61.33,IS,0.09,0.0,Phase3-EA-TR1v1-EURJPY-M30-91,EURJPYMT4,3062,22h 59m,Buy
185655.98,116901,04.09.2019 12:59:58,sl 116.901,-1.12,-147.2500000000582,0.0,0.0,116671,02.09.2019 12:30:00,17429,-0.05338951251588227,-37.95,IS,0.17,0.0,Phase3-EA-T1v2-EURJPY-M15-322,EURJPYMT4,3462,2d 0h 29m,Sell
185812.33,129873,04.09.2019 22:29:58,tp 129.873,-0.31,-0.0,0.0,0.0,128023,03.09.2019 19:00:00,17430,-0.0,156.35,IS,0.09,0.0,Phase3-EA-B1v1-GBPJPY-M30-1,GBPJPYMT4,1560,1d 3h 29m,Buy
185869.3,0.98137,05.09.2019 00:44:58,tp 0.98137,-2.13,-0.0,0.0,0.0,0.98037,04.09.2019 22:30:00,17431,-0.0,56.97,IS,0.58,0.0,Phase3-EA-SA2v2-USDCHF-M15-107,USDCHFMT4,3476,2h 14m,Buy
185976.81,117403,05.09.2019 00:59:58,tp 117.403,-1.66,-0.0,0.0,0.0,116013,03.09.2019 14:30:00,17432,-0.0,107.51,IS,0.09,0.0,Phase3-EA-TR1v1-EURJPY-M30-91,EURJPYMT4,3063,1d 10h 29m,Sell
186019.75,1.08273,05.09.2019 04:49:58,tp 1.08273,-3.01,-0.0,0.0,0.0,1.08163,04.09.2019 21:45:00,17433,-0.0,42.94,IS,0.41,0.0,Phase3-EA-SA2v2-EURCHF-M5-43,EURCHFMT4,8958,7h 4m,Buy
186022.71,0.98121,05.09.2019 05:00:00,,0.0,-0.0,0.0,0.0,0.98126,05.09.2019 00:45:00,17434,-0.0,2.96,IS,0.58,0.0,Phase3-EA-SA2v2-USDCHF-M15-107,USDCHFMT4,3478,4h 15m,Sell
185953.94,130604,05.09.2019 06:25:00,,0.0,-68.77000000001863,0.0,0.0,130285,05.09.2019 01:00:00,17435,-0.024914616627022587,-68.77,IS,0.23,0.0,Phase3-EA-S4v1-GBPJPY-M5-194,GBPJPYMT4,3760,5h 25m,Sell
185877.46,1.08447,05.09.2019 12:15:00,,0.0,-145.25,0.0,0.0,1.08226,05.09.2019 03:30:00,17436,-0.05262248167913408,-76.48,IS,0.34,0.0,Phase3-EA-S4v1-EURCHF-M15-221,EURCHFMT4,4602,8h 45m,Sell
186032.71,131.82,05.09.2019 15:29:58,tp 131.820,-0.91,-0.0,0.0,0.0,129.97,04.09.2019 22:30:00,17437,-0.0,155.25,IS,0.09,0.0,Phase3-EA-B1v1-GBPJPY-M30-1,GBPJPYMT4,1562,16h 59m,Buy
186137.55,118238,05.09.2019 16:59:57,tp 118.238,-1.24,-0.0,0.0,0.0,116978,04.09.2019 13:30:00,17438,-0.0,104.84,IS,0.09,0.0,Phase3-EA-TR1v1-EURJPY-M30-91,EURJPYMT4,3065,1d 3h 29m,Buy
186229.85,118093,05.09.2019 23:45:00,,0.0,-0.0,0.0,0.0,117512,05.09.2019 12:30:00,17439,-0.0,92.3,IS,0.17,0.0,Phase3-EA-T1v2-EURJPY-M15-322,EURJPYMT4,3464,11h 15m,Buy
186241.24,106956,06.09.2019 01:30:00,,-0.73,-0.0,0.0,0.0,106908,05.09.2019 21:15:00,17440,-0.0,11.39,IS,0.27,0.0,Phase3-EA-S1v2-USDJPY-M15-0,USDJPYMT4,4840,4h 15m,Buy
186247.3,106932,06.09.2019 02:15:00,,0.0,-0.0,0.0,0.0,106956,06.09.2019 01:30:00,17441,-0.0,6.06,IS,0.27,0.0,Phase3-EA-S1v2-USDJPY-M15-0,USDJPYMT4,4842,45m 0s,Sell
186279.05,0.9864,06.09.2019 05:15:00,,0.0,-0.0,0.0,0.0,0.98586,06.09.2019 01:00:00,17442,-0.0,31.75,IS,0.58,0.0,Phase3-EA-SA2v2-USDCHF-M15-107,USDCHFMT4,3480,4h 15m,Buy
186261.43,1.08832,06.09.2019 05:50:00,,-1.0,-17.619999999995343,0.0,0.0,1.08872,05.09.2019 21:30:00,17443,-0.006377609883918187,-17.62,IS,0.41,0.0,Phase3-EA-SA2v2-EURCHF-M5-43,EURCHFMT4,8960,8h 20m,Buy
186310.35,1.08945,06.09.2019 10:30:00,,0.0,-0.0,0.0,0.0,1.08803,06.09.2019 01:45:00,17444,-0.0,48.92,IS,0.34,0.0,Phase3-EA-S4v1-EURCHF-M15-221,EURCHFMT4,4604,8h 45m,Buy
186290.96,117983,06.09.2019 15:00:00,,0.0,-19.39000000001397,0.0,0.0,118105,06.09.2019 06:00:00,17445,-0.00701747147727687,-19.39,IS,0.17,0.0,Phase3-EA-T1v2-EURJPY-M15-322,EURJPYMT4,3466,9h 0m,Buy
186288.72,1.0895,09.09.2019 04:20:00,,-1.0,-21.630000000004657,0.0,0.0,1.08953,06.09.2019 20:00:00,17446,-0.007828154102806704,-2.24,IS,0.41,0.0,Phase3-EA-SA2v2-EURCHF-M5-43,EURCHFMT4,8962,2d 8h 20m,Buy
186294.4,106851,09.09.2019 06:00:00,,-1.14,-15.950000000011642,0.0,0.0,106878,06.09.2019 22:45:00,17447,-0.005772494588064318,5.68,IS,0.27,0.0,Phase3-EA-S1v2-USDJPY-M15-0,USDJPYMT4,4844,2d 7h 15m,Sell
186332.91,131307,09.09.2019 06:35:00,,0.0,-0.0,0.0,0.0,131128,09.09.2019 01:10:00,17448,-0.0,38.51,IS,0.23,0.0,Phase3-EA-S4v1-GBPJPY-M5-194,GBPJPYMT4,3762,5h 25m,Buy
186241.65,1.09286,09.09.2019 14:45:00,,0.0,-91.26000000000931,0.0,0.0,1.0902,09.09.2019 06:00:00,17449,-0.033025382318743336,-91.26,IS,0.34,0.0,Phase3-EA-S4v1-EURCHF-M15-221,EURCHFMT4,4606,8h 45m,Sell
186222.64,1.09623,10.09.2019 04:45:00,,-2.07,-110.27000000001863,0.0,0.0,1.09582,09.09.2019 20:25:00,17450,-0.039904765595968346,-19.01,IS,0.41,0.0,Phase3-EA-SA2v2-EURCHF-M5-43,EURCHFMT4,8964,8h 20m,Sell
186308.78,1.09374,10.09.2019 14:30:00,,0.0,-24.130000000004657,0.0,0.0,1.09625,10.09.2019 05:45:00,17451,-0.008732220856359295,86.14,IS,0.34,0.0,Phase3-EA-S4v1-EURCHF-M15-221,EURCHFMT4,4608,8h 45m,Sell
186266.2,1.09569,11.09.2019 05:20:00,,-2.07,-66.71000000002095,0.0,0.0,1.09471,10.09.2019 21:00:00,17452,-0.024141170879726444,-42.58,IS,0.41,0.0,Phase3-EA-SA2v2-EURCHF-M5-43,EURCHFMT4,8966,8h 20m,Sell
186263.85,132854,11.09.2019 06:15:00,,0.0,-69.05999999999767,0.0,0.0,132843,11.09.2019 00:50:00,17453,-0.024991594377954254,-2.35,IS,0.23,0.0,Phase3-EA-S4v1-GBPJPY-M5-194,GBPJPYMT4,3764,5h 25m,Sell
186230.6,1.09588,11.09.2019 10:00:00,,0.0,-102.30999999999767,0.0,0.0,1.09491,11.09.2019 01:15:00,17454,-0.03702418217214781,-33.25,IS,0.34,0.0,Phase3-EA-S4v1-EURCHF-M15-221,EURCHFMT4,4610,8h 45m,Sell
186257.61,118752,11.09.2019 13:45:00,,-0.77,-75.29999999998836,0.0,0.0,118576,10.09.2019 20:15:00,17455,-0.02724974017752285,27.01,IS,0.17,0.0,Phase3-EA-T1v2-EURJPY-M15-322,EURJPYMT4,3468,17h 30m,Buy
186213.44,1.09393,12.09.2019 05:15:00,,-6.19,-119.46999999997206,0.0,0.0,1.09301,11.09.2019 20:55:00,17456,-0.04323408312096144,-44.17,IS,0.41,0.0,Phase3-EA-SA2v2-EURCHF-M5-43,EURCHFMT4,8968,8h 20m,Sell
186184.07,133244,12.09.2019 09:00:00,,0.0,-148.8399999999674,0.0,0.0,133106,12.09.2019 03:35:00,17457,-0.053862567437214334,-29.37,IS,0.23,0.0,Phase3-EA-S4v1-GBPJPY-M5-194,GBPJPYMT4,3766,5h 25m,Sell
186238.29,1.09253,12.09.2019 13:15:00,,0.0,-94.61999999999534,0.0,0.0,1.09411,12.09.2019 04:30:00,17458,-0.034241306980046265,54.22,IS,0.34,0.0,Phase3-EA-S4v1-EURCHF-M15-221,EURCHFMT4,4612,8h 45m,Sell
186193.63,1.22844,12.09.2019 16:59:58,sl 1.22844,-2.66,-139.27999999996973,0.0,0.0,1.23144,09.09.2019 13:00:00,17459,-0.050402972269922235,-44.66,IS,0.14,0.0,Phase3-EA-B1v1-GBPUSD-M30-14,GBPUSDMT4,1152,3d 3h 59m,Buy
186296.1,119441,12.09.2019 18:29:58,tp 119.441,-2.87,-36.80999999999767,0.0,0.0,118181,05.09.2019 17:00:00,17460,-0.013320888923435692,102.47,IS,0.09,0.0,Phase3-EA-TR1v1-EURJPY-M30-91,EURJPYMT4,3068,7d 1h 29m,Buy
186259.88,119116,12.09.2019 18:59:58,sl 119.116,0.0,-73.02999999996973,0.0,0.0,119346,12.09.2019 18:45:00,17461,-0.02642826726645387,-36.22,IS,0.17,0.0,Phase3-EA-T1v2-EURJPY-M15-322,EURJPYMT4,3470,14m 58s,Buy
186305.48,1.09416,12.09.2019 20:59:57,tp 1.09416,0.0,-27.429999999993015,0.0,0.0,1.09526,12.09.2019 20:00:00,17462,-0.009926432577282563,45.6,IS,0.41,0.0,Phase3-EA-SA2v2-EURCHF-M5-43,EURCHFMT4,8970,59m 57s,Sell
186348.95,1.09558,13.09.2019 00:44:58,tp 1.09558,-2.07,-0.0,0.0,0.0,1.09668,12.09.2019 23:10:00,17463,-0.0,43.47,IS,0.41,0.0,Phase3-EA-SA2v2-EURCHF-M5-43,EURCHFMT4,8972,1h 34m,Sell
186369.67,108177,13.09.2019 02:30:00,,0.0,-0.0,0.0,0.0,108094,13.09.2019 00:45:00,17464,-0.0,20.72,IS,0.27,0.0,Phase3-EA-S1v2-USDJPY-M15-0,USDJPYMT4,4846,1h 45m,Buy
186387.07,0.99048,13.09.2019 03:45:00,,-3.1,-0.0,0.0,0.0,0.99083,12.09.2019 23:30:00,17465,-0.0,17.4,IS,0.58,0.0,Phase3-EA-SA2v2-USDCHF-M15-107,USDCHFMT4,3482,4h 15m,Sell
186409.82,133.43,13.09.2019 06:10:00,,0.0,-0.0,0.0,0.0,133323,13.09.2019 00:45:00,17466,-0.0,22.75,IS,0.23,0.0,Phase3-EA-S4v1-GBPJPY-M5-194,GBPJPYMT4,3768,5h 25m,Buy
186395.72,1.09528,13.09.2019 10:25:00,,0.0,-14.099999999976717,0.0,0.0,1.09562,13.09.2019 02:05:00,17467,-0.005101121226437129,-14.1,IS,0.41,0.0,Phase3-EA-SA2v2-EURCHF-M5-43,EURCHFMT4,8974,8h 20m,Buy
186548.34,134361,13.09.2019 12:59:58,tp 134.361,-1.5,-0.0,0.0,0.0,132511,10.09.2019 04:00:00,17468,-0.0,152.62,IS,0.09,0.0,Phase3-EA-B1v1-GBPJPY-M30-1,GBPJPYMT4,1564,3d 8h 59m,Buy
186597.93,1.0963,13.09.2019 13:45:00,,0.0,-0.0,0.0,0.0,1.09486,13.09.2019 05:00:00,17469,-0.0,49.59,IS,0.34,0.0,Phase3-EA-S4v1-EURCHF-M15-221,EURCHFMT4,4614,8h 45m,Buy
186679.7,134634,16.09.2019 01:04:57,tp 134.634,-1.23,-0.0,0.0,0.0,135024,13.09.2019 23:20:00,17470,-0.0,81.77,IS,0.23,0.0,Phase3-EA-S4v1-GBPJPY-M5-194,GBPJPYMT4,3770,2d 1h 44m,Sell
186723.19,1095,16.09.2019 01:04:57,tp 1.09500,-2.07,-0.0,0.0,0.0,1.0961,13.09.2019 20:00:00,17471,-0.0,43.49,IS,0.41,0.0,Phase3-EA-SA2v2-EURCHF-M5-43,EURCHFMT4,8976,2d 5h 4m,Sell
186667.09,134.07,16.09.2019 01:29:57,sl 134.070,-0.3,-56.09999999997672,0.0,0.0,134.74,13.09.2019 20:00:00,17472,-0.020272966642216173,-56.1,IS,0.09,0.0,Phase3-EA-B1v1-GBPJPY-M30-1,GBPJPYMT4,1566,2d 5h 29m,Buy
186750.37,134782,16.09.2019 02:04:58,tp 134.782,0.0,-0.0,0.0,0.0,134392,16.09.2019 01:10:00,17473,-0.0,83.28,IS,0.23,0.0,Phase3-EA-S4v1-GBPJPY-M5-194,GBPJPYMT4,3772,54m 58s,Buy
186795.99,1.09475,16.09.2019 07:39:58,tp 1.09475,0.0,-0.0,0.0,0.0,1.09365,16.09.2019 01:05:00,17474,-0.0,45.62,IS,0.41,0.0,Phase3-EA-SA2v2-EURCHF-M5-43,EURCHFMT4,8978,6h 34m,Buy
186835.51,1.09535,16.09.2019 11:15:00,,0.0,-0.0,0.0,0.0,1.0942,16.09.2019 02:30:00,17475,-0.0,39.52,IS,0.34,0.0,Phase3-EA-S4v1-EURCHF-M15-221,EURCHFMT4,4616,8h 45m,Buy
186880.97,1.09251,16.09.2019 23:44:57,tp 1.09251,0.0,-0.0,0.0,0.0,1.09141,16.09.2019 21:30:00,17476,-0.0,45.46,IS,0.41,0.0,Phase3-EA-SA2v2-EURCHF-M5-43,EURCHFMT4,8980,2h 14m,Buy
186924.34,1.09181,17.09.2019 01:04:57,tp 1.09181,-2.06,-0.0,0.0,0.0,1.09291,16.09.2019 23:55:00,17477,-0.0,43.37,IS,0.41,0.0,Phase3-EA-SA2v2-EURCHF-M5-43,EURCHFMT4,8982,1h 9m,Sell
186982.8,0.99212,17.09.2019 01:14:57,tp 0.99212,0.0,-0.0,0.0,0.0,0.99312,17.09.2019 00:30:00,17478,-0.0,58.46,IS,0.58,0.0,Phase3-EA-SA2v2-USDCHF-M15-107,USDCHFMT4,3484,44m 57s,Sell
186960.07,134435,17.09.2019 05:50:00,,0.0,-22.729999999981374,0.0,0.0,134328,17.09.2019 00:25:00,17479,-0.008206285733258985,-22.73,IS,0.23,0.0,Phase3-EA-S4v1-GBPJPY-M5-194,GBPJPYMT4,3774,5h 25m,Sell
186923.38,119459,17.09.2019 17:44:58,sl 119.459,-0.55,-59.4199999999837,0.0,0.0,119229,16.09.2019 13:00:00,17480,-0.021452595612429157,-36.69,IS,0.17,0.0,Phase3-EA-T1v2-EURJPY-M15-322,EURJPYMT4,3472,1d 4h 44m,Sell
186863.27,119507,17.09.2019 18:59:58,sl 119.507,-0.29,-119.52999999996973,0.0,0.0,119769,13.09.2019 12:00:00,17481,-0.043154304166168146,-60.11,IS,0.09,0.0,Phase3-EA-TR1v1-EURJPY-M30-91,EURJPYMT4,3070,4d 6h 59m,Sell
186918.6,0.99263,18.09.2019 03:29:58,tp 0.99263,-3.1,-64.19999999995343,0.0,0.0,0.99363,17.09.2019 23:15:00,17482,-0.023178334539167466,55.33,IS,0.58,0.0,Phase3-EA-SA2v2-USDCHF-M15-107,USDCHFMT4,3486,4h 14m,Sell
186893.43,1.09962,18.09.2019 06:05:00,,-2.06,-89.36999999993714,0.0,0.0,1.09906,17.09.2019 21:45:00,17483,-0.0322655413982156,-25.17,IS,0.41,0.0,Phase3-EA-SA2v2-EURCHF-M5-43,EURCHFMT4,8984,8h 20m,Sell
186869.88,1.10031,18.09.2019 14:45:00,,0.0,-112.9199999999255,0.0,0.0,1.09962,18.09.2019 06:00:00,17484,-0.04076787439506171,-23.55,IS,0.34,0.0,Phase3-EA-S4v1-EURCHF-M15-221,EURCHFMT4,4618,8h 45m,Sell
186833.81,119689,18.09.2019 23:59:57,sl 119.689,0.0,-148.98999999993248,0.0,0.0,119459,18.09.2019 22:30:00,17485,-0.05379034366030374,-36.07,IS,0.17,0.0,Phase3-EA-T1v2-EURJPY-M15-322,EURJPYMT4,3474,1h 29m,Sell
186912.82,135161,19.09.2019 00:29:58,tp 135.161,-3.69,-69.97999999992317,0.0,0.0,135551,18.09.2019 23:45:00,17486,-0.02526510671417967,79.01,IS,0.23,0.0,Phase3-EA-S4v1-GBPJPY-M5-194,GBPJPYMT4,3776,44m 58s,Sell
186929.6,1.10006,19.09.2019 07:10:00,,-2.96,-53.199999999895226,0.0,0.0,1.09958,18.09.2019 22:50:00,17487,-0.01920696880813357,16.78,IS,0.41,0.0,Phase3-EA-SA2v2-EURCHF-M5-43,EURCHFMT4,8986,8h 20m,Buy
186856.28,1.09752,19.09.2019 12:15:00,,0.0,-126.51999999990221,0.0,0.0,1.09966,19.09.2019 03:30:00,17488,-0.04567792657157832,-73.32,IS,0.34,0.0,Phase3-EA-S4v1-EURCHF-M15-221,EURCHFMT4,4620,8h 45m,Buy
186901.71,1.09782,19.09.2019 21:09:57,tp 1.09782,0.0,-81.0899999999092,0.0,0.0,1.09672,19.09.2019 20:10:00,17489,-0.029276186102497638,45.43,IS,0.41,0.0,Phase3-EA-SA2v2-EURCHF-M5-43,EURCHFMT4,8988,59m 57s,Buy
187163.12,1.25394,19.09.2019 21:29:58,tp 1.25394,-3.19,-0.0,0.0,0.0,1.23504,13.09.2019 09:30:00,17490,-0.0,261.41,IS,0.14,0.0,Phase3-EA-B1v1-GBPUSD-M30-14,GBPUSDMT4,1154,6d 11h 59m,Buy
187163.12,1.09603,20.09.2019 10:45:00,,0.0,-0.0,0.0,0.0,1.09603,20.09.2019 02:00:00,17491,-0.0,0.0,IS,0.34,0.0,Phase3-EA-S4v1-EURCHF-M15-221,EURCHFMT4,4622,8h 45m,Buy
187101.03,118905,20.09.2019 17:29:58,sl 118.905,-2.04,-62.09000000002561,0.0,0.0,118787,16.09.2019 19:00:00,17492,-0.02240197036316567,-62.09,IS,0.09,0.0,Phase3-EA-TR1v1-EURJPY-M30-91,EURJPYMT4,3071,3d 22h 29m,Sell
187091.08,134255,23.09.2019 04:40:00,,-0.77,-72.04000000003725,0.0,0.0,134298,20.09.2019 23:15:00,17493,-0.02599191407573883,-9.95,IS,0.23,0.0,Phase3-EA-S4v1-GBPJPY-M5-194,GBPJPYMT4,3778,2d 5h 25m,Buy
187122.34,1.09279,23.09.2019 05:50:00,,-0.99,-40.78000000002794,0.0,0.0,1.09201,20.09.2019 21:30:00,17494,-0.014713357246096717,31.26,IS,0.41,0.0,Phase3-EA-SA2v2-EURCHF-M5-43,EURCHFMT4,8990,2d 8h 20m,Buy
187227.75,118479,23.09.2019 11:29:58,tp 118.479,-2.32,-0.0,0.0,0.0,119625,17.09.2019 20:00:00,17495,-0.0,105.41,IS,0.09,0.0,Phase3-EA-TR1v1-EURJPY-M30-91,EURJPYMT4,3073,5d 15h 29m,Buy
187258.36,107599,23.09.2019 11:30:00,,0.0,-0.0,0.0,0.0,107721,23.09.2019 01:30:00,17496,-0.0,30.61,IS,0.27,0.0,Phase3-EA-S1v2-USDJPY-M15-0,USDJPYMT4,4848,10h 0m,Sell
187395.58,1.08854,23.09.2019 11:44:57,tp 1.08854,0.0,-0.0,0.0,0.0,1.09254,23.09.2019 05:00:00,17497,-0.0,137.22,IS,0.34,0.0,Phase3-EA-S4v1-EURCHF-M15-221,EURCHFMT4,4624,6h 44m,Sell
187433.05,107.38,23.09.2019 18:45:00,,0.0,-0.0,0.0,0.0,107529,23.09.2019 17:00:00,17498,-0.0,37.47,IS,0.27,0.0,Phase3-EA-S1v2-USDJPY-M15-0,USDJPYMT4,4850,1h 45m,Sell
187478.6,1.08853,23.09.2019 23:09:58,tp 1.08853,0.0,-0.0,0.0,0.0,1.08743,23.09.2019 20:10:00,17499,-0.0,45.55,IS,0.41,0.0,Phase3-EA-SA2v2-EURCHF-M5-43,EURCHFMT4,8992,2h 59m,Buy
187476.66,0.98944,24.09.2019 02:45:00,,-3.11,-1.9400000000023283,0.0,0.0,0.98946,23.09.2019 22:30:00,17500,-6.991530157649347E-4,-1.94,IS,0.58,0.0,Phase3-EA-SA2v2-USDCHF-M15-107,USDCHFMT4,3488,4h 15m,Sell
187464.24,1.0887,24.09.2019 07:40:00,,-2.07,-14.35999999998603,0.0,0.0,1.08845,23.09.2019 23:20:00,17501,-0.005175173869259095,-12.42,IS,0.41,0.0,Phase3-EA-SA2v2-EURCHF-M5-43,EURCHFMT4,8994,8h 20m,Sell
187407.77,134145,24.09.2019 13:59:57,sl 134.145,-0.49,-70.82999999995809,0.0,0.0,133475,23.09.2019 15:00:00,17502,-0.0255262928384235,-56.47,IS,0.09,0.0,Phase3-EA-B1v1-GBPJPY-M30-1,GBPJPYMT4,1568,22h 59m,Sell
187470.55,107094,24.09.2019 23:15:00,,0.0,-8.04999999993015,0.0,0.0,107343,24.09.2019 22:30:00,17503,-0.002901124627243368,62.78,IS,0.27,0.0,Phase3-EA-S1v2-USDJPY-M15-0,USDJPYMT4,4852,45m 0s,Sell
187466.64,1.08589,25.09.2019 04:20:00,,-1.0,-11.95999999990454,0.0,0.0,1.08596,24.09.2019 20:00:00,17504,-0.004310242303336001,-3.91,IS,0.41,0.0,Phase3-EA-SA2v2-EURCHF-M5-43,EURCHFMT4,8996,8h 20m,Buy
187408.0,1.08401,25.09.2019 14:00:00,,0.0,-70.59999999991851,0.0,0.0,1.08571,25.09.2019 05:15:00,17505,-0.02544340356334442,-58.64,IS,0.34,0.0,Phase3-EA-S4v1-EURCHF-M15-221,EURCHFMT4,4626,8h 45m,Buy
187380.28,1.0854,26.09.2019 04:25:00,,-6.2,-98.31999999989057,0.0,0.0,1.08488,25.09.2019 20:05:00,17506,-0.03543336314940689,-27.72,IS,0.41,0.0,Phase3-EA-SA2v2-EURCHF-M5-43,EURCHFMT4,8998,8h 20m,Sell
187353.45,107675,26.09.2019 11:30:00,,0.0,-125.14999999990687,0.0,0.0,107782,26.09.2019 00:15:00,17507,-0.045102577279799716,-26.83,IS,0.27,0.0,Phase3-EA-S1v2-USDJPY-M15-0,USDJPYMT4,4854,11h 15m,Buy
187618.12,117.59,26.09.2019 14:14:58,tp 117.590,-3.87,-0.0,0.0,0.0,119.29,19.09.2019 19:45:00,17508,-0.0,264.67,IS,0.17,0.0,Phase3-EA-T1v2-EURJPY-M15-322,EURJPYMT4,3476,6d 18h 29m,Sell
187584.27,1.08688,26.09.2019 15:00:00,,0.0,-33.84999999997672,0.0,0.0,1.08589,26.09.2019 06:15:00,17509,-0.01219300815090044,-33.85,IS,0.34,0.0,Phase3-EA-S4v1-EURCHF-M15-221,EURCHFMT4,4628,8h 45m,Sell
187687.51,117497,27.09.2019 04:59:57,tp 117.497,-2.04,-0.0,0.0,0.0,118757,20.09.2019 19:30:00,17510,-0.0,103.24,IS,0.09,0.0,Phase3-EA-TR1v1-EURJPY-M30-91,EURJPYMT4,3075,6d 9h 29m,Sell
187677.47,132775,27.09.2019 06:05:00,,0.0,-10.039999999979045,0.0,0.0,132822,27.09.2019 00:40:00,17511,-0.0036155749316845393,-10.04,IS,0.23,0.0,Phase3-EA-S4v1-GBPJPY-M5-194,GBPJPYMT4,3780,5h 25m,Buy
187681.6,1.08541,27.09.2019 08:45:00,,0.0,-5.909999999974389,0.0,0.0,1.08531,27.09.2019 00:25:00,17512,-0.00212829161814817,4.13,IS,0.41,0.0,Phase3-EA-SA2v2-EURCHF-M5-43,EURCHFMT4,9000,8h 20m,Buy
187697.67,1.0854,27.09.2019 11:00:00,,0.0,-0.0,0.0,0.0,1.08493,27.09.2019 02:15:00,17513,-0.0,16.07,IS,0.34,0.0,Phase3-EA-S4v1-EURCHF-M15-221,EURCHFMT4,4630,8h 45m,Buy
187661.43,117963,27.09.2019 13:59:58,sl 117.963,0.0,-36.23999999999069,0.0,0.0,117733,27.09.2019 01:15:00,17514,-0.013050163510551065,-36.24,IS,0.17,0.0,Phase3-EA-T1v2-EURJPY-M15-322,EURJPYMT4,3478,12h 44m,Sell
187605.64,133097,27.09.2019 16:29:58,sl 133.097,0.0,-92.02999999996973,0.0,0.0,132427,27.09.2019 11:30:00,17515,-0.033140357281344596,-55.79,IS,0.09,0.0,Phase3-EA-B1v1-GBPJPY-M30-1,GBPJPYMT4,1570,4h 59m,Sell
187615.88,108.15,27.09.2019 19:00:00,,0.0,-81.78999999997905,0.0,0.0,108109,27.09.2019 18:30:00,17516,-0.029452893861147144,10.24,IS,0.27,0.0,Phase3-EA-S1v2-USDJPY-M15-0,USDJPYMT4,4856,30m 0s,Buy
187586.13,107944,30.09.2019 02:15:00,,-0.73,-111.53999999997905,0.0,0.0,108.06,27.09.2019 20:00:00,17517,-0.04016598338760945,-29.75,IS,0.27,0.0,Phase3-EA-S1v2-USDJPY-M15-0,USDJPYMT4,4858,2d 6h 15m,Buy
187533.43,1.08407,30.09.2019 04:20:00,,-0.99,-164.2399999999907,0.0,0.0,1.08532,27.09.2019 20:00:00,17518,-0.05914345626306115,-52.7,IS,0.41,0.0,Phase3-EA-SA2v2-EURCHF-M5-43,EURCHFMT4,9002,2d 8h 20m,Buy
187643.47,1.08692,30.09.2019 14:30:00,,0.0,-54.20000000001164,0.0,0.0,1.0837,30.09.2019 05:45:00,17519,-0.01951762864989518,110.04,IS,0.34,0.0,Phase3-EA-S4v1-EURCHF-M15-221,EURCHFMT4,4632,8h 45m,Buy
187686.64,1.08727,01.10.2019 01:09:59,tp 1.08727,-2.05,-11.03000000002794,0.0,0.0,1.08837,30.09.2019 21:20:00,17520,-0.003971945461417766,43.17,IS,0.41,0.0,Phase3-EA-SA2v2-EURCHF-M5-43,EURCHFMT4,9004,3h 49m,Sell
187744.74,0.99833,01.10.2019 05:14:58,tp 0.99833,0.0,-0.0,0.0,0.0,0.99733,01.10.2019 01:15:00,17521,-0.0,58.1,IS,0.58,0.0,Phase3-EA-SA2v2-USDCHF-M15-107,USDCHFMT4,3490,3h 59m,Buy
187767.31,1.08785,01.10.2019 09:35:00,,0.0,-0.0,0.0,0.0,1.0873,01.10.2019 01:15:00,17522,-0.0,22.57,IS,0.41,0.0,Phase3-EA-SA2v2-EURCHF-M5-43,EURCHFMT4,9006,8h 20m,Buy
187779.9,1.08763,01.10.2019 10:30:00,,0.0,-0.0,0.0,0.0,1.08726,01.10.2019 01:45:00,17523,-0.0,12.59,IS,0.34,0.0,Phase3-EA-S4v1-EURCHF-M15-221,EURCHFMT4,4634,8h 45m,Buy
187838.28,0.99343,02.10.2019 02:29:57,tp 0.99343,0.0,-0.0,0.0,0.0,0.99243,02.10.2019 00:30:00,17524,-0.0,58.38,IS,0.58,0.0,Phase3-EA-SA2v2-USDCHF-M15-107,USDCHFMT4,3492,1h 59m,Buy
187807.96,1.08552,02.10.2019 04:20:00,,-0.99,-30.320000000006985,0.0,0.0,1.08623,01.10.2019 20:00:00,17525,-0.010912823099828736,-30.32,IS,0.41,0.0,Phase3-EA-SA2v2-EURCHF-M5-43,EURCHFMT4,9008,8h 20m,Buy
187844.96,132411,02.10.2019 04:45:00,,-1.24,-0.0,0.0,0.0,132.59,01.10.2019 23:20:00,17526,-0.0,37.0,IS,0.23,0.0,Phase3-EA-S4v1-GBPJPY-M5-194,GBPJPYMT4,3782,5h 25m,Sell
187866.76,107776,02.10.2019 07:00:00,,0.0,-0.0,0.0,0.0,107689,02.10.2019 00:15:00,17527,-0.0,21.8,IS,0.27,0.0,Phase3-EA-S1v2-USDJPY-M15-0,USDJPYMT4,4860,6h 45m,Buy
187805.32,117484,02.10.2019 11:59:57,sl 117.484,-1.23,-61.44000000000233,0.0,0.0,118204,27.09.2019 17:00:00,17528,-0.022111316949174505,-61.44,IS,0.09,0.0,Phase3-EA-TR1v1-EURJPY-M30-91,EURJPYMT4,3078,4d 18h 59m,Buy
187811.12,107149,03.10.2019 04:15:00,,0.0,-55.64000000001397,0.0,0.0,107172,03.10.2019 01:15:00,17529,-0.020023985596554876,5.8,IS,0.27,0.0,Phase3-EA-S1v2-USDJPY-M15-0,USDJPYMT4,4862,3h 0m,Sell
187816.39,1.0925,03.10.2019 04:20:00,,-2.96,-50.36999999999534,0.0,0.0,1.0923,02.10.2019 20:00:00,17530,-0.018127393143388258,5.27,IS,0.41,0.0,Phase3-EA-SA2v2-EURCHF-M5-43,EURCHFMT4,9010,8h 20m,Buy
187952.72,1.09614,03.10.2019 10:14:58,tp 1.09614,0.0,-0.0,0.0,0.0,1.09214,03.10.2019 05:00:00,17531,-0.0,136.33,IS,0.34,0.0,Phase3-EA-S4v1-EURCHF-M15-221,EURCHFMT4,4636,5h 14m,Buy
187905.9,1.23745,03.10.2019 16:59:58,sl 1.23745,-4.82,-46.820000000006985,0.0,0.0,1.23445,26.09.2019 12:00:00,17532,-0.01684459141108846,-46.82,IS,0.14,0.0,Phase3-EA-B1v1-GBPUSD-M30-14,GBPUSDMT4,1156,7d 4h 59m,Sell
187949.02,1.09517,04.10.2019 00:04:58,tp 1.09517,-2.05,-3.7000000000116415,0.0,0.0,1.09627,03.10.2019 21:55:00,17533,-0.0013311616450494257,43.12,IS,0.41,0.0,Phase3-EA-SA2v2-EURCHF-M5-43,EURCHFMT4,9012,2h 9m,Sell
187937.27,106884,04.10.2019 03:15:00,,-1.14,-15.450000000011642,0.0,0.0,106842,03.10.2019 21:30:00,17534,-0.005558499301612003,-11.75,IS,0.27,0.0,Phase3-EA-S1v2-USDJPY-M15-0,USDJPYMT4,4864,5h 45m,Sell
187923.37,131907,04.10.2019 04:45:00,,-0.77,-29.350000000034925,0.0,0.0,131968,03.10.2019 23:20:00,17535,-0.010559349805979515,-13.9,IS,0.23,0.0,Phase3-EA-S4v1-GBPJPY-M5-194,GBPJPYMT4,3784,5h 25m,Buy
187968.54,1.09629,04.10.2019 05:09:57,tp 1.09629,0.0,-0.0,0.0,0.0,1.09519,04.10.2019 00:25:00,17536,-0.0,45.17,IS,0.41,0.0,Phase3-EA-SA2v2-EURCHF-M5-43,EURCHFMT4,9014,4h 44m,Buy
188002.92,1.09621,04.10.2019 10:30:00,,0.0,-0.0,0.0,0.0,1.0952,04.10.2019 01:45:00,17537,-0.0,34.38,IS,0.34,0.0,Phase3-EA-S4v1-EURCHF-M15-221,EURCHFMT4,4638,8h 45m,Buy
187941.44,106.67,07.10.2019 01:00:00,,-0.73,-61.47999999998137,0.0,0.0,106.91,04.10.2019 22:15:00,17538,-0.022114875627918258,-61.48,IS,0.27,0.0,Phase3-EA-S1v2-USDJPY-M15-0,USDJPYMT4,4866,2d 2h 45m,Buy
187984.7,1.0916,07.10.2019 01:00:00,tp 1.09160,-2.06,-18.21999999997206,0.0,0.0,1.0927,04.10.2019 20:10:00,17539,-0.006553887995123208,43.26,IS,0.41,0.0,Phase3-EA-SA2v2-EURCHF-M5-43,EURCHFMT4,9016,2d 4h 50m,Sell
188068.72,131729,07.10.2019 02:09:57,tp 131.729,0.0,-0.0,0.0,0.0,131339,07.10.2019 01:10:00,17540,-0.0,84.02,IS,0.23,0.0,Phase3-EA-S4v1-GBPJPY-M5-194,GBPJPYMT4,3786,59m 57s,Buy
188113.45,1.09305,07.10.2019 10:15:00,,0.0,-0.0,0.0,0.0,1.09174,07.10.2019 01:30:00,17541,-0.0,44.73,IS,0.34,0.0,Phase3-EA-S4v1-EURCHF-M15-221,EURCHFMT4,4640,8h 45m,Buy
188071.45,1.23008,07.10.2019 22:29:58,sl 1.23008,0.0,-42.0,0.0,0.0,1.23308,07.10.2019 15:00:00,17542,-0.015101750742367838,-42.0,IS,0.14,0.0,Phase3-EA-B1v1-GBPUSD-M30-14,GBPUSDMT4,1158,7h 29m,Buy
188090.57,107316,08.10.2019 04:15:00,,0.0,-22.880000000004657,0.0,0.0,107.24,08.10.2019 01:45:00,17543,-0.008226858499653487,19.12,IS,0.27,0.0,Phase3-EA-S1v2-USDJPY-M15-0,USDJPYMT4,4868,2h 30m,Buy
188099.06,1.09215,08.10.2019 07:00:00,,-0.99,-14.39000000001397,0.0,0.0,1.09192,07.10.2019 22:40:00,17544,-0.0051741474567353375,8.49,IS,0.41,0.0,Phase3-EA-SA2v2-EURCHF-M5-43,EURCHFMT4,9018,8h 20m,Buy
188154.96,131999,08.10.2019 07:40:00,,0.0,-0.0,0.0,0.0,131738,08.10.2019 02:15:00,17545,-0.0,55.9,IS,0.23,0.0,Phase3-EA-S4v1-GBPJPY-M5-194,GBPJPYMT4,3788,5h 25m,Buy
188115.23,117951,08.10.2019 10:14:58,sl 117.951,-3.33,-39.72999999998137,0.0,0.0,117721,02.10.2019 11:00:00,17546,-0.01428340519255209,-39.73,IS,0.17,0.0,Phase3-EA-T1v2-EURJPY-M15-322,EURJPYMT4,3480,5d 23h 14m,Sell
188147.37,1.09205,08.10.2019 10:30:00,,0.0,-7.589999999967404,0.0,0.0,1.09111,08.10.2019 01:45:00,17547,-0.0027286948253474855,32.14,IS,0.34,0.0,Phase3-EA-S4v1-EURCHF-M15-221,EURCHFMT4,4642,8h 45m,Buy
188192.72,1.08804,08.10.2019 22:59:58,tp 1.08804,0.0,-0.0,0.0,0.0,1.08914,08.10.2019 20:25:00,17548,-0.0,45.35,IS,0.41,0.0,Phase3-EA-SA2v2-EURCHF-M5-43,EURCHFMT4,9020,2h 34m,Sell
188173.43,107022,09.10.2019 02:45:00,,-1.13,-19.289999999979045,0.0,0.0,106.95,08.10.2019 18:30:00,17549,-0.006934041983549732,-19.29,IS,0.27,0.0,Phase3-EA-S1v2-USDJPY-M15-0,USDJPYMT4,4870,8h 15m,Sell
188218.84,1.08872,09.10.2019 05:44:58,tp 1.08872,0.0,-0.0,0.0,0.0,1.08762,09.10.2019 01:25:00,17550,-0.0,45.41,IS,0.41,0.0,Phase3-EA-SA2v2-EURCHF-M5-43,EURCHFMT4,9022,4h 19m,Buy
188237.73,130856,09.10.2019 06:05:00,,0.0,-0.0,0.0,0.0,130768,09.10.2019 00:40:00,17551,-0.0,18.89,IS,0.23,0.0,Phase3-EA-S4v1-GBPJPY-M5-194,GBPJPYMT4,3790,5h 25m,Buy
188285.97,1.08908,09.10.2019 10:45:00,,0.0,-0.0,0.0,0.0,1.08767,09.10.2019 02:00:00,17552,-0.0,48.24,IS,0.34,0.0,Phase3-EA-S4v1-EURCHF-M15-221,EURCHFMT4,4644,8h 45m,Buy
188243.97,1.22035,09.10.2019 20:59:58,sl 1.22035,0.0,-42.0,0.0,0.0,1.22335,09.10.2019 11:30:00,17553,-0.015092388595803016,-42.0,IS,0.14,0.0,Phase3-EA-B1v1-GBPUSD-M30-14,GBPUSDMT4,1160,9h 29m,Buy
188283.15,1.09167,10.10.2019 02:34:58,tp 1.09167,-6.18,-2.820000000006985,0.0,0.0,1.09277,09.10.2019 20:55:00,17554,-0.001013346091434998,39.18,IS,0.41,0.0,Phase3-EA-SA2v2-EURCHF-M5-43,EURCHFMT4,9024,5h 39m,Sell
188328.53,1.09169,10.10.2019 04:14:57,tp 1.09169,0.0,-0.0,0.0,0.0,1.09059,10.10.2019 02:45:00,17555,-0.0,45.38,IS,0.41,0.0,Phase3-EA-SA2v2-EURCHF-M5-43,EURCHFMT4,9026,1h 29m,Buy
188412.12,131207,10.10.2019 05:19:58,tp 131.207,0.0,-0.0,0.0,0.0,130817,10.10.2019 02:50:00,17556,-0.0,83.59,IS,0.23,0.0,Phase3-EA-S4v1-GBPJPY-M5-194,GBPJPYMT4,3792,2h 29m,Buy
188411.44,1.09231,10.10.2019 10:15:00,,0.0,-0.6799999999930151,0.0,0.0,1.09233,10.10.2019 01:30:00,17557,-2.442422406010959E-4,-0.68,IS,0.34,0.0,Phase3-EA-S4v1-EURCHF-M15-221,EURCHFMT4,4646,8h 45m,Buy
188516.42,118746,10.10.2019 17:59:58,tp 118.746,-2.87,-0.0,0.0,0.0,117456,03.10.2019 01:30:00,17558,-0.0,104.98,IS,0.09,0.0,Phase3-EA-TR1v1-EURJPY-M30-91,EURJPYMT4,3080,7d 16h 29m,Buy
188619.72,118858,10.10.2019 17:59:58,tp 118.858,-2.05,-0.0,0.0,0.0,117598,07.10.2019 20:00:00,17559,-0.0,103.3,IS,0.09,0.0,Phase3-EA-TR1v1-EURJPY-M30-91,EURJPYMT4,3081,2d 21h 59m,Buy
188560.84,132385,10.10.2019 18:29:58,sl 132.385,-2.93,-58.88000000000466,0.0,0.0,131715,04.10.2019 08:30:00,17560,-0.021132746813471916,-58.88,IS,0.09,0.0,Phase3-EA-B1v1-GBPJPY-M30-1,GBPJPYMT4,1572,6d 9h 59m,Sell
188577.12,107936,11.10.2019 00:45:00,,-0.73,-42.59999999997672,0.0,0.0,107868,10.10.2019 22:15:00,17561,-0.015289657171422222,16.28,IS,0.27,0.0,Phase3-EA-S1v2-USDJPY-M15-0,USDJPYMT4,4872,2h 30m,Buy
188632.27,0.99603,11.10.2019 01:29:59,tp 0.99603,-3.08,-0.0,0.0,0.0,0.99703,10.10.2019 23:30:00,17562,-0.0,55.15,IS,0.58,0.0,Phase3-EA-SA2v2-USDCHF-M15-107,USDCHFMT4,3494,1h 59m,Sell
188715.79,118.77,11.10.2019 02:30:00,,-0.77,-0.0,0.0,0.0,118235,10.10.2019 05:45:00,17563,-0.0,83.52,IS,0.17,0.0,Phase3-EA-T1v2-EURJPY-M15-322,EURJPYMT4,3482,20h 45m,Buy
188761.03,1.0978,11.10.2019 05:29:57,tp 1.09780,0.0,-0.0,0.0,0.0,1.0967,11.10.2019 01:30:00,17564,-0.0,45.24,IS,0.41,0.0,Phase3-EA-SA2v2-EURCHF-M5-43,EURCHFMT4,9028,3h 59m,Buy
188786.63,0.99674,11.10.2019 06:00:00,,0.0,-0.0,0.0,0.0,0.9963,11.10.2019 01:45:00,17565,-0.0,25.6,IS,0.58,0.0,Phase3-EA-SA2v2-USDCHF-M15-107,USDCHFMT4,3496,4h 15m,Buy
188940.48,136249,11.10.2019 14:59:58,tp 136.249,0.0,-0.0,0.0,0.0,134399,11.10.2019 05:30:00,17566,-0.0,153.85,IS,0.09,0.0,Phase3-EA-B1v1-GBPJPY-M30-1,GBPJPYMT4,1574,9h 29m,Buy
189205.08,1.26878,11.10.2019 18:29:57,tp 1.26878,0.0,-0.0,0.0,0.0,1.24988,11.10.2019 13:00:00,17567,-0.0,264.6,IS,0.14,0.0,Phase3-EA-B1v1-GBPUSD-M30-14,GBPUSDMT4,1162,5h 29m,Buy
189250.34,1.10048,11.10.2019 20:54:57,tp 1.10048,0.0,-0.0,0.0,0.0,1.09938,11.10.2019 20:20:00,17568,-0.0,45.26,IS,0.41,0.0,Phase3-EA-SA2v2-EURCHF-M5-43,EURCHFMT4,9030,34m 57s,Buy
189251.83,108444,11.10.2019 21:30:00,,0.0,-0.0,0.0,0.0,108438,11.10.2019 20:15:00,17569,-0.0,1.49,IS,0.27,0.0,Phase3-EA-S1v2-USDJPY-M15-0,USDJPYMT4,4874,1h 15m,Buy
189251.58,108445,11.10.2019 23:45:00,,0.0,-0.25,0.0,0.0,108446,11.10.2019 21:30:00,17570,-8.952492809089159E-5,-0.25,IS,0.27,0.0,Phase3-EA-S1v2-USDJPY-M15-0,USDJPYMT4,4876,2h 15m,Buy
189296.83,1.10074,14.10.2019 01:39:57,tp 1.10074,0.0,-0.0,0.0,0.0,1.09964,14.10.2019 01:00:00,17571,-0.0,45.25,IS,0.41,0.0,Phase3-EA-SA2v2-EURCHF-M5-43,EURCHFMT4,9032,39m 57s,Buy
189354.95,0.99795,14.10.2019 01:44:57,tp 0.99795,0.0,-0.0,0.0,0.0,0.99695,14.10.2019 01:15:00,17572,-0.0,58.12,IS,0.58,0.0,Phase3-EA-SA2v2-USDCHF-M15-107,USDCHFMT4,3498,29m 57s,Buy
189306.54,136612,14.10.2019 09:20:00,,0.0,-48.40999999997439,0.0,0.0,136.84,14.10.2019 03:55:00,17573,-0.01732920787692295,-48.41,IS,0.23,0.0,Phase3-EA-S4v1-GBPJPY-M5-194,GBPJPYMT4,3794,5h 25m,Buy
189264.54,1.25926,14.10.2019 18:59:58,sl 1.25926,0.0,-90.40999999997439,0.0,0.0,1.26226,14.10.2019 18:30:00,17574,-0.032363843919706446,-42.0,IS,0.14,0.0,Phase3-EA-B1v1-GBPUSD-M30-14,GBPUSDMT4,1164,29m 58s,Buy
189344.41,119456,15.10.2019 04:15:00,,-1.54,-10.539999999979045,0.0,0.0,118937,11.10.2019 05:00:00,17575,-0.0037729777116814996,79.87,IS,0.17,0.0,Phase3-EA-T1v2-EURJPY-M15-322,EURJPYMT4,3484,3d 23h 15m,Buy
189332.09,1.09971,15.10.2019 04:20:00,,-2.05,-22.85999999998603,0.0,0.0,1.09946,14.10.2019 20:00:00,17576,-0.008183137617567157,-12.32,IS,0.41,0.0,Phase3-EA-SA2v2-EURCHF-M5-43,EURCHFMT4,9034,8h 20m,Sell
189386.44,136567,15.10.2019 06:55:00,,0.0,-0.0,0.0,0.0,136823,15.10.2019 01:30:00,17577,-0.0,54.35,IS,0.23,0.0,Phase3-EA-S4v1-GBPJPY-M5-194,GBPJPYMT4,3796,5h 25m,Sell
189350.37,119381,15.10.2019 11:29:58,sl 119.381,0.0,-36.070000000006985,0.0,0.0,119611,15.10.2019 05:45:00,17578,-0.012910433305212243,-36.07,IS,0.17,0.0,Phase3-EA-T1v2-EURJPY-M15-322,EURJPYMT4,3486,5h 44m,Buy
189314.31,119641,15.10.2019 18:29:58,sl 119.641,0.0,-72.13000000000466,0.0,0.0,119411,15.10.2019 12:00:00,17579,-0.02581728733864261,-36.06,IS,0.17,0.0,Phase3-EA-T1v2-EURJPY-M15-322,EURJPYMT4,3488,6h 29m,Sell
189417.3,120107,15.10.2019 19:29:57,tp 120.107,-1.23,-0.0,0.0,0.0,118847,10.10.2019 18:00:00,17580,-0.0,102.99,IS,0.09,0.0,Phase3-EA-TR1v1-EURJPY-M30-91,EURJPYMT4,3084,5d 1h 29m,Buy
189460.41,1.10082,16.10.2019 01:19:58,tp 1.10082,-2.05,-0.0,0.0,0.0,1.10192,15.10.2019 23:05:00,17581,-0.0,43.11,IS,0.41,0.0,Phase3-EA-SA2v2-EURCHF-M5-43,EURCHFMT4,9036,2h 14m,Sell
189463.39,108839,16.10.2019 01:30:00,,0.0,-0.0,0.0,0.0,108851,16.10.2019 00:45:00,17582,-0.0,2.98,IS,0.27,0.0,Phase3-EA-S1v2-USDJPY-M15-0,USDJPYMT4,4878,45m 0s,Sell
189479.51,119942,16.10.2019 05:00:00,,-0.77,-0.0,0.0,0.0,119834,15.10.2019 18:45:00,17583,-0.0,16.12,IS,0.17,0.0,Phase3-EA-T1v2-EURJPY-M15-322,EURJPYMT4,3490,10h 15m,Buy
189443.54,119879,16.10.2019 11:29:58,sl 119.879,0.0,-35.96999999997206,0.0,0.0,120109,16.10.2019 10:45:00,17584,-0.012870353179011909,-35.97,IS,0.17,0.0,Phase3-EA-T1v2-EURJPY-M15-322,EURJPYMT4,3492,44m 58s,Buy
189429.9,1.10033,16.10.2019 14:30:00,,0.0,-49.60999999998603,0.0,0.0,1.10073,16.10.2019 05:45:00,17585,-0.01775085407870717,-13.64,IS,0.34,0.0,Phase3-EA-S4v1-EURCHF-M15-221,EURCHFMT4,4648,8h 45m,Buy
189475.23,1.10174,16.10.2019 21:44:58,tp 1.10174,0.0,-4.279999999969732,0.0,0.0,1.10284,16.10.2019 20:00:00,17586,-0.0015314181708597219,45.33,IS,0.41,0.0,Phase3-EA-SA2v2-EURCHF-M5-43,EURCHFMT4,9038,1h 44m,Sell
189426.44,1.10029,17.10.2019 06:20:00,,-2.97,-53.06999999994878,0.0,0.0,1.1014,16.10.2019 22:00:00,17587,-0.01898886970280882,-48.79,IS,0.41,0.0,Phase3-EA-SA2v2-EURCHF-M5-43,EURCHFMT4,9040,8h 20m,Buy
189361.03,120596,17.10.2019 11:59:57,sl 120.596,-0.87,-118.47999999992317,0.0,0.0,119816,16.10.2019 06:30:00,17588,-0.04239308992631433,-65.41,IS,0.09,0.0,Phase3-EA-TR1v1-EURJPY-M30-91,EURJPYMT4,3086,1d 5h 29m,Sell
189497.94,1.10448,17.10.2019 13:44:58,tp 1.10448,0.0,-0.0,0.0,0.0,1.10048,17.10.2019 06:30:00,17589,-0.0,136.91,IS,0.34,0.0,Phase3-EA-S4v1-EURCHF-M15-221,EURCHFMT4,4650,7h 14m,Buy
189455.94,1.28352,17.10.2019 16:29:58,sl 1.28352,0.0,-42.0,0.0,0.0,1.28652,17.10.2019 13:30:00,17590,-0.015026944384634752,-42.0,IS,0.14,0.0,Phase3-EA-B1v1-GBPUSD-M30-14,GBPUSDMT4,1166,2h 59m,Buy
189499.54,1.09785,18.10.2019 01:14:57,tp 1.09785,-2.08,-0.0,0.0,0.0,1.09895,17.10.2019 23:00:00,17591,-0.0,43.6,IS,0.41,0.0,Phase3-EA-SA2v2-EURCHF-M5-43,EURCHFMT4,9042,2h 14m,Sell
189444.47,139489,18.10.2019 08:55:00,,0.0,-55.070000000006985,0.0,0.0,139749,18.10.2019 03:30:00,17592,-0.01970307357214496,-55.07,IS,0.23,0.0,Phase3-EA-S4v1-GBPJPY-M5-194,GBPJPYMT4,3798,5h 25m,Buy
189402.47,1.28704,18.10.2019 17:29:57,sl 1.28704,0.0,-97.07000000000698,0.0,0.0,1.29004,18.10.2019 12:30:00,17593,-0.03472993193477404,-42.0,IS,0.14,0.0,Phase3-EA-B1v1-GBPUSD-M30-14,GBPUSDMT4,1168,4h 59m,Buy
189425.68,121032,18.10.2019 21:15:00,,-0.77,-73.85999999998603,0.0,0.0,120879,17.10.2019 22:30:00,17594,-0.026425803777704142,23.21,IS,0.17,0.0,Phase3-EA-T1v2-EURJPY-M15-322,EURJPYMT4,3494,22h 45m,Buy
189471.48,1.09901,18.10.2019 23:49:58,tp 1.09901,0.0,-28.05999999999767,0.0,0.0,1.10011,18.10.2019 21:55:00,17595,-0.010039372515603263,45.8,IS,0.41,0.0,Phase3-EA-SA2v2-EURCHF-M5-43,EURCHFMT4,9044,1h 54m,Sell
189554.25,140063,21.10.2019 04:29:58,tp 140.063,0.0,-0.0,0.0,0.0,139673,21.10.2019 02:25:00,17596,-0.0,82.77,IS,0.23,0.0,Phase3-EA-S4v1-GBPJPY-M5-194,GBPJPYMT4,3800,2h 4m,Buy
189600.04,1.09939,21.10.2019 04:29:58,tp 1.09939,0.0,-0.0,0.0,0.0,1.09829,21.10.2019 01:50:00,17597,-0.0,45.79,IS,0.41,0.0,Phase3-EA-SA2v2-EURCHF-M5-43,EURCHFMT4,9046,2h 39m,Buy
189658.89,0.98556,21.10.2019 05:14:58,tp 0.98556,0.0,-0.0,0.0,0.0,0.98456,21.10.2019 01:15:00,17598,-0.0,58.85,IS,0.58,0.0,Phase3-EA-SA2v2-USDCHF-M15-107,USDCHFMT4,3500,3h 59m,Buy
189701.67,1.09982,21.10.2019 10:45:00,,0.0,-0.0,0.0,0.0,1.09858,21.10.2019 02:00:00,17599,-0.0,42.78,IS,0.34,0.0,Phase3-EA-S4v1-EURCHF-M15-221,EURCHFMT4,4652,8h 45m,Buy
189698.54,121069,21.10.2019 18:30:00,,0.0,-3.1300000000046566,0.0,0.0,121089,21.10.2019 05:00:00,17600,-0.0011190494500818112,-3.13,IS,0.17,0.0,Phase3-EA-T1v2-EURJPY-M15-322,EURJPYMT4,3496,13h 30m,Buy
189726.07,0.98594,22.10.2019 02:15:00,,-0.71,-0.0,0.0,0.0,0.98546,21.10.2019 22:00:00,17601,-0.0,27.53,IS,0.58,0.0,Phase3-EA-SA2v2-USDCHF-M15-107,USDCHFMT4,3502,4h 15m,Buy
189770.79,1.10018,22.10.2019 04:24:58,tp 1.10018,-1.0,-0.0,0.0,0.0,1.09908,21.10.2019 21:45:00,17602,-0.0,44.72,IS,0.41,0.0,Phase3-EA-SA2v2-EURCHF-M5-43,EURCHFMT4,9048,6h 39m,Buy
189722.29,1.10077,22.10.2019 12:30:00,,0.0,-48.5,0.0,0.0,1.09936,22.10.2019 03:45:00,17603,-0.01733561963348632,-48.5,IS,0.34,0.0,Phase3-EA-S4v1-EURCHF-M15-221,EURCHFMT4,4654,8h 45m,Sell
189680.29,1.29836,22.10.2019 22:29:57,sl 1.29836,0.0,-90.5,0.0,0.0,1.29536,22.10.2019 11:30:00,17604,-0.03234790880062911,-42.0,IS,0.14,0.0,Phase3-EA-B1v1-GBPUSD-M30-14,GBPUSDMT4,1170,10h 59m,Sell
189725.9,1.10034,22.10.2019 22:34:58,tp 1.10034,0.0,-44.89000000001397,0.0,0.0,1.10144,22.10.2019 20:00:00,17605,-0.016045277636029753,45.61,IS,0.41,0.0,Phase3-EA-SA2v2-EURCHF-M5-43,EURCHFMT4,9050,2h 34m,Sell
189740.45,0.98917,23.10.2019 02:45:00,,-0.7,-30.34000000002561,0.0,0.0,0.98891,22.10.2019 22:30:00,17606,-0.010844591745988019,14.55,IS,0.58,0.0,Phase3-EA-SA2v2-USDCHF-M15-107,USDCHFMT4,3504,4h 15m,Buy
189823.29,139436,23.10.2019 04:19:59,tp 139.436,0.0,-0.0,0.0,0.0,139826,23.10.2019 02:50:00,17607,-0.0,82.84,IS,0.23,0.0,Phase3-EA-S4v1-GBPJPY-M5-194,GBPJPYMT4,3802,1h 29m,Sell
189824.37,1.10039,23.10.2019 07:15:00,,-0.99,-0.0,0.0,0.0,1.10034,22.10.2019 22:55:00,17608,-0.0,1.08,IS,0.41,0.0,Phase3-EA-SA2v2-EURCHF-M5-43,EURCHFMT4,9052,8h 20m,Buy
189807.86,1.09997,23.10.2019 10:30:00,,0.0,-16.510000000009313,0.0,0.0,1.10045,23.10.2019 01:45:00,17609,-0.005900129427615343,-16.51,IS,0.34,0.0,Phase3-EA-S4v1-EURCHF-M15-221,EURCHFMT4,4656,8h 45m,Buy
189823.45,140.3,24.10.2019 05:00:00,,-3.68,-0.9199999999837019,0.0,0.0,140391,23.10.2019 23:35:00,17610,-3.287776543492969E-4,15.59,IS,0.23,0.0,Phase3-EA-S4v1-GBPJPY-M5-194,GBPJPYMT4,3804,5h 25m,Sell
189761.35,1.10299,24.10.2019 05:15:00,,-6.21,-63.01999999996042,0.0,0.0,1.10164,23.10.2019 20:55:00,17611,-0.022521269323311666,-62.1,IS,0.41,0.0,Phase3-EA-SA2v2-EURCHF-M5-43,EURCHFMT4,9054,8h 20m,Sell
189733.81,120851,24.10.2019 15:45:00,,0.0,-90.55999999993946,0.0,0.0,121027,24.10.2019 11:15:00,17612,-0.032363156933021615,-27.54,IS,0.17,0.0,Phase3-EA-T1v2-EURJPY-M15-322,EURJPYMT4,3498,4h 30m,Buy
189777.2,1.1012,25.10.2019 01:09:58,tp 1.10120,-2.07,-47.169999999925494,0.0,0.0,1.1023,24.10.2019 20:50:00,17613,-0.01685700212598541,43.39,IS,0.41,0.0,Phase3-EA-SA2v2-EURCHF-M5-43,EURCHFMT4,9056,4h 19m,Sell
189835.61,0.99298,25.10.2019 05:29:59,tp 0.99298,0.0,-0.0,0.0,0.0,0.99198,25.10.2019 01:45:00,17614,-0.0,58.41,IS,0.58,0.0,Phase3-EA-SA2v2-USDCHF-M15-107,USDCHFMT4,3506,3h 44m,Buy
189871.13,1.10248,25.10.2019 09:35:00,,0.0,-0.0,0.0,0.0,1.10162,25.10.2019 01:15:00,17615,-0.0,35.52,IS,0.41,0.0,Phase3-EA-SA2v2-EURCHF-M5-43,EURCHFMT4,9058,8h 20m,Buy
189862.56,1.10238,25.10.2019 13:45:00,,0.0,-8.570000000006985,0.0,0.0,1.10213,25.10.2019 05:00:00,17616,-0.003062123628116606,-8.57,IS,0.34,0.0,Phase3-EA-S4v1-EURCHF-M15-221,EURCHFMT4,4658,8h 45m,Sell
189845.25,1.10233,28.10.2019 05:05:00,,-2.06,-25.880000000004657,0.0,0.0,1.10196,25.10.2019 20:45:00,17617,-0.009247113126675314,-17.31,IS,0.41,0.0,Phase3-EA-SA2v2-EURCHF-M5-43,EURCHFMT4,9060,2d 8h 20m,Sell
189861.32,139408,28.10.2019 08:00:00,,0.0,-9.809999999997672,0.0,0.0,139484,28.10.2019 02:35:00,17618,-0.0035051846898240717,16.07,IS,0.23,0.0,Phase3-EA-S4v1-GBPJPY-M5-194,GBPJPYMT4,3806,5h 25m,Sell
189838.46,0.99458,29.10.2019 02:30:00,,-0.7,-32.6699999999837,0.0,0.0,0.99496,28.10.2019 22:15:00,17619,-0.01167322974684225,-22.86,IS,0.58,0.0,Phase3-EA-SA2v2-USDCHF-M15-107,USDCHFMT4,3508,4h 15m,Buy
189846.66,108971,29.10.2019 04:15:00,,-0.72,-24.46999999997206,0.0,0.0,108935,28.10.2019 23:30:00,17620,-0.008743309822621555,8.2,IS,0.27,0.0,Phase3-EA-S1v2-USDJPY-M15-0,USDJPYMT4,4880,4h 45m,Buy
189834.13,1.10372,29.10.2019 07:10:00,,-0.99,-37.0,0.0,0.0,1104,28.10.2019 22:50:00,17621,-0.013220370389757536,-12.53,IS,0.41,0.0,Phase3-EA-SA2v2-EURCHF-M5-43,EURCHFMT4,9062,8h 20m,Buy
189791.6,1.28195,29.10.2019 13:29:58,sl 1.28195,-0.53,-79.53000000002794,0.0,0.0,1.28495,28.10.2019 12:00:00,17622,-0.02841665019183206,-42.53,IS,0.14,0.0,Phase3-EA-B1v1-GBPUSD-M30-14,GBPUSDMT4,1172,1d 1h 29m,Buy
189745.82,1.1024,29.10.2019 14:15:00,,0.0,-125.31000000005588,0.0,0.0,1.10374,29.10.2019 05:30:00,17623,-0.04477417874435826,-45.78,IS,0.34,0.0,Phase3-EA-S4v1-EURCHF-M15-221,EURCHFMT4,4660,8h 45m,Buy
189690.47,140509,29.10.2019 19:59:58,sl 140.509,0.0,-180.6600000000326,0.0,0.0,139839,29.10.2019 12:00:00,17624,-0.06455113823281156,-55.35,IS,0.09,0.0,Phase3-EA-B1v1-GBPJPY-M30-1,GBPJPYMT4,1576,7h 59m,Sell
189734.85,1.10478,30.10.2019 02:29:58,tp 1.10478,-0.99,-136.28000000002794,0.0,0.0,1.10368,29.10.2019 22:10:00,17625,-0.04869383991125747,44.38,IS,0.41,0.0,Phase3-EA-SA2v2-EURCHF-M5-43,EURCHFMT4,9064,4h 19m,Buy
189780.25,1.10364,30.10.2019 10:09:58,tp 1.10364,0.0,-90.88000000000466,0.0,0.0,1.10474,30.10.2019 02:30:00,17626,-0.03247208813570882,45.4,IS,0.41,0.0,Phase3-EA-SA2v2-EURCHF-M5-43,EURCHFMT4,9066,7h 39m,Sell
189805.94,1.10387,30.10.2019 11:45:00,,0.0,-65.19000000000233,0.0,0.0,1.10462,30.10.2019 03:00:00,17627,-0.023292863397522286,25.69,IS,0.34,0.0,Phase3-EA-S4v1-EURCHF-M15-221,EURCHFMT4,4662,8h 45m,Sell
189763.94,1.28914,30.10.2019 22:59:58,sl 1.28914,0.0,-107.19000000000233,0.0,0.0,1.28614,30.10.2019 19:00:00,17628,-0.03829977032643624,-42.0,IS,0.14,0.0,Phase3-EA-B1v1-GBPUSD-M30-14,GBPUSDMT4,1174,3h 59m,Sell
189809.55,1.10289,30.10.2019 23:29:58,tp 1.10289,0.0,-61.5800000000163,0.0,0.0,1.10179,30.10.2019 21:40:00,17629,-0.02200298401625634,45.61,IS,0.41,0.0,Phase3-EA-SA2v2-EURCHF-M5-43,EURCHFMT4,9068,1h 49m,Buy
189756.42,0.98901,31.10.2019 03:30:00,,-2.11,-114.71000000002095,0.0,0.0,0.98988,30.10.2019 23:15:00,17630,-0.04098672128133416,-53.13,IS,0.58,0.0,Phase3-EA-SA2v2-USDCHF-M15-107,USDCHFMT4,3510,4h 15m,Buy
189779.71,1.10205,31.10.2019 07:50:00,,-6.21,-91.42000000004191,0.0,0.0,1.10276,30.10.2019 23:30:00,17631,-0.032665034081951025,23.29,IS,0.41,0.0,Phase3-EA-SA2v2-EURCHF-M5-43,EURCHFMT4,9070,8h 20m,Sell
189828.57,121308,31.10.2019 09:15:00,,-2.3,-42.56000000005588,0.0,0.0,120981,30.10.2019 11:00:00,17632,-0.015206999021319445,48.86,IS,0.17,0.0,Phase3-EA-T1v2-EURJPY-M15-322,EURJPYMT4,3500,22h 15m,Buy
189861.63,1.10199,31.10.2019 09:45:00,,0.0,-9.500000000058208,0.0,0.0,1.10295,31.10.2019 01:00:00,17633,-0.0033944194244180034,33.06,IS,0.34,0.0,Phase3-EA-S4v1-EURCHF-M15-221,EURCHFMT4,4664,8h 45m,Sell
189888.86,108079,31.10.2019 18:15:00,,0.0,-0.0,0.0,0.0,108188,31.10.2019 17:45:00,17634,-0.0,27.23,IS,0.27,0.0,Phase3-EA-S1v2-USDJPY-M15-0,USDJPYMT4,4882,30m 0s,Sell
189883.62,108105,31.10.2019 20:15:00,,0.0,-5.239999999990687,0.0,0.0,108084,31.10.2019 20:00:00,17635,-0.0018721716898595618,-5.24,IS,0.27,0.0,Phase3-EA-S1v2-USDJPY-M15-0,USDJPYMT4,4884,15m 0s,Sell
189929.33,1.0997,31.10.2019 21:09:57,tp 1.09970,0.0,-0.0,0.0,0.0,1.1008,31.10.2019 20:10:00,17636,-0.0,45.71,IS,0.41,0.0,Phase3-EA-SA2v2-EURCHF-M5-43,EURCHFMT4,9072,59m 57s,Sell
189936.39,0.98623,01.11.2019 05:30:00,,0.0,-0.0,0.0,0.0,0.98611,01.11.2019 01:15:00,17637,-0.0,7.06,IS,0.58,0.0,Phase3-EA-SA2v2-USDCHF-M15-107,USDCHFMT4,3512,4h 15m,Buy
189981.13,1.10085,01.11.2019 05:49:57,tp 1.10085,-1.0,-0.0,0.0,0.0,1.09975,31.10.2019 21:40:00,17638,-0.0,44.74,IS,0.41,0.0,Phase3-EA-SA2v2-EURCHF-M5-43,EURCHFMT4,9074,8h 9m,Buy
190064.18,140041,01.11.2019 05:59:58,tp 140.041,0.0,-0.0,0.0,0.0,139651,01.11.2019 02:00:00,17639,-0.0,83.05,IS,0.23,0.0,Phase3-EA-S4v1-GBPJPY-M5-194,GBPJPYMT4,3808,3h 59m,Buy
190072.46,1.1002,01.11.2019 13:00:00,,0.0,-0.0,0.0,0.0,1.10044,01.11.2019 04:15:00,17640,-0.0,8.28,IS,0.34,0.0,Phase3-EA-S4v1-EURCHF-M15-221,EURCHFMT4,4666,8h 45m,Sell
190036.29,120656,01.11.2019 18:59:58,sl 120.656,0.0,-36.1699999999837,0.0,0.0,120426,01.11.2019 05:15:00,17641,-0.012914515050849174,-36.17,IS,0.17,0.0,Phase3-EA-T1v2-EURJPY-M15-322,EURJPYMT4,3502,13h 44m,Sell
190069.78,1.10155,04.11.2019 05:30:00,,-1.0,-2.679999999993015,0.0,0.0,1.10072,01.11.2019 21:10:00,17642,-9.568952263257168E-4,33.49,IS,0.41,0.0,Phase3-EA-SA2v2-EURCHF-M5-43,EURCHFMT4,9076,2d 8h 20m,Buy
190092.95,140026,04.11.2019 07:30:00,,0.0,-0.0,0.0,0.0,139917,04.11.2019 02:05:00,17643,-0.0,23.17,IS,0.23,0.0,Phase3-EA-S4v1-GBPJPY-M5-194,GBPJPYMT4,3810,5h 25m,Buy
190080.75,1.09996,05.11.2019 04:20:00,,-1.0,-12.200000000011642,0.0,0.0,1.10023,04.11.2019 20:00:00,17644,-0.004355696921329717,-12.2,IS,0.41,0.0,Phase3-EA-SA2v2-EURCHF-M5-43,EURCHFMT4,9078,8h 20m,Buy
190062.15,140.12,05.11.2019 09:05:00,,0.0,-30.79999999998836,0.0,0.0,140032,05.11.2019 03:40:00,17645,-0.010996349604653817,-18.6,IS,0.23,0.0,Phase3-EA-S4v1-GBPJPY-M5-194,GBPJPYMT4,3812,5h 25m,Sell
190133.32,1.10108,05.11.2019 11:30:00,,0.0,-0.0,0.0,0.0,1.09901,05.11.2019 02:45:00,17646,-0.0,71.17,IS,0.34,0.0,Phase3-EA-S4v1-EURCHF-M15-221,EURCHFMT4,4668,8h 45m,Buy
190120.36,120929,05.11.2019 17:00:00,,0.0,-12.960000000020955,0.0,0.0,121012,05.11.2019 04:45:00,17647,-0.0046263686162077745,-12.96,IS,0.17,0.0,Phase3-EA-T1v2-EURJPY-M15-322,EURJPYMT4,3504,12h 15m,Buy
190165.77,1.09943,05.11.2019 20:54:58,tp 1.09943,0.0,-0.0,0.0,0.0,1.09833,05.11.2019 20:00:00,17648,-0.0,45.41,IS,0.41,0.0,Phase3-EA-SA2v2-EURCHF-M5-43,EURCHFMT4,9080,54m 58s,Buy
190145.31,0.99237,06.11.2019 05:15:00,,0.0,-20.460000000020955,0.0,0.0,0.99272,06.11.2019 01:00:00,17649,-0.0073028193272935745,-20.46,IS,0.58,0.0,Phase3-EA-SA2v2-USDCHF-M15-107,USDCHFMT4,3514,4h 15m,Buy
190143.25,1.09941,06.11.2019 06:45:00,,-2.06,-22.520000000018626,0.0,0.0,1.09941,05.11.2019 22:25:00,17650,-0.008038098301594276,-2.06,IS,0.41,0.0,Phase3-EA-SA2v2-EURCHF-M5-43,EURCHFMT4,9082,8h 20m,Sell
190115.83,140468,06.11.2019 07:00:00,,0.0,-49.94000000000233,0.0,0.0,140598,06.11.2019 01:35:00,17651,-0.01782516115369915,-27.42,IS,0.23,0.0,Phase3-EA-S4v1-GBPJPY-M5-194,GBPJPYMT4,3814,5h 25m,Buy
190186.72,1.10106,06.11.2019 14:15:00,,0.0,-0.0,0.0,0.0,1.09899,06.11.2019 05:30:00,17652,-0.0,70.89,IS,0.34,0.0,Phase3-EA-S4v1-EURCHF-M15-221,EURCHFMT4,4670,8h 45m,Buy
190152.54,109009,06.11.2019 16:30:00,,0.0,-34.179999999993015,0.0,0.0,109147,06.11.2019 01:15:00,17653,-0.012199007861612023,-34.18,IS,0.27,0.0,Phase3-EA-S1v2-USDJPY-M15-0,USDJPYMT4,4886,15h 15m,Buy
190149.16,1.09838,07.11.2019 05:15:00,,-2.97,-37.55999999999767,0.0,0.0,1.09839,06.11.2019 20:55:00,17654,-0.013405346263376618,-3.38,IS,0.41,0.0,Phase3-EA-SA2v2-EURCHF-M5-43,EURCHFMT4,9084,8h 20m,Buy
190231.62,139727,07.11.2019 06:14:58,tp 139.727,0.0,-0.0,0.0,0.0,140117,07.11.2019 01:45:00,17655,-0.0,82.46,IS,0.23,0.0,Phase3-EA-S4v1-GBPJPY-M5-194,GBPJPYMT4,3816,4h 29m,Sell
190264.82,1.09933,07.11.2019 11:30:00,,0.0,-0.0,0.0,0.0,1.09836,07.11.2019 02:45:00,17656,-0.0,33.2,IS,0.34,0.0,Phase3-EA-S4v1-EURCHF-M15-221,EURCHFMT4,4672,8h 45m,Buy
190227.34,120.94,07.11.2019 14:29:58,sl 120.940,-1.64,-37.47999999998137,0.0,0.0,120.71,06.11.2019 05:00:00,17657,-0.01337306623071037,-37.48,IS,0.17,0.0,Phase3-EA-T1v2-EURJPY-M15-322,EURJPYMT4,3506,1d 9h 29m,Sell
190246.62,109235,07.11.2019 19:45:00,,0.0,-18.199999999953434,0.0,0.0,109157,07.11.2019 19:15:00,17658,-0.006493858201665607,19.28,IS,0.27,0.0,Phase3-EA-S1v2-USDJPY-M15-0,USDJPYMT4,4888,30m 0s,Buy
190289.89,1.09874,08.11.2019 00:49:58,tp 1.09874,-2.06,-0.0,0.0,0.0,1.09984,07.11.2019 21:25:00,17659,-0.0,43.27,IS,0.41,0.0,Phase3-EA-SA2v2-EURCHF-M5-43,EURCHFMT4,9086,3h 24m,Sell
190289.89,139991,08.11.2019 05:55:00,,0.0,-0.0,0.0,0.0,139991,08.11.2019 00:30:00,17660,-0.0,0.0,IS,0.23,0.0,Phase3-EA-S4v1-GBPJPY-M5-194,GBPJPYMT4,3818,5h 25m,Buy
190282.89,0.99446,08.11.2019 07:00:00,,0.0,-7.0,0.0,0.0,0.99458,08.11.2019 02:45:00,17661,-0.0024974143733832023,-7.0,IS,0.58,0.0,Phase3-EA-SA2v2-USDCHF-M15-107,USDCHFMT4,3516,4h 15m,Buy
190289.48,1.09914,08.11.2019 09:20:00,,0.0,-0.40999999997438863,0.0,0.0,1.09898,08.11.2019 01:00:00,17662,-1.4627712757473582E-4,6.59,IS,0.41,0.0,Phase3-EA-SA2v2-EURCHF-M5-43,EURCHFMT4,9088,8h 20m,Buy
190253.73,120604,08.11.2019 17:44:57,sl 120.604,0.0,-36.15999999997439,0.0,0.0,120834,08.11.2019 04:15:00,17663,-0.012900929105924662,-35.75,IS,0.17,0.0,Phase3-EA-T1v2-EURJPY-M15-322,EURJPYMT4,3508,13h 29m,Buy
190264.42,1.09876,11.11.2019 05:45:00,,-2.06,-25.46999999997206,0.0,0.0,1.09907,08.11.2019 21:25:00,17664,-0.009087020584285769,10.69,IS,0.41,0.0,Phase3-EA-SA2v2-EURCHF-M5-43,EURCHFMT4,9090,2d 8h 20m,Sell
190226.83,1.09773,11.11.2019 15:00:00,,0.0,-63.05999999999767,0.0,0.0,1.09883,11.11.2019 06:15:00,17665,-0.0224981357693627,-37.59,IS,0.34,0.0,Phase3-EA-S4v1-EURCHF-M15-221,EURCHFMT4,4674,8h 45m,Buy
190222.04,0.99317,12.11.2019 02:30:00,,-0.7,-67.84999999997672,0.0,0.0,0.99324,11.11.2019 22:15:00,17666,-0.02420708074771316,-4.79,IS,0.58,0.0,Phase3-EA-SA2v2-USDCHF-M15-107,USDCHFMT4,3518,4h 15m,Buy
190218.99,1.09644,12.11.2019 06:15:00,,-0.99,-70.89999999996508,0.0,0.0,1.09649,11.11.2019 21:55:00,17667,-0.02529523986754026,-3.05,IS,0.41,0.0,Phase3-EA-SA2v2-EURCHF-M5-43,EURCHFMT4,9092,8h 20m,Buy
190262.41,1.0972,12.11.2019 09:45:00,,0.0,-27.479999999981374,0.0,0.0,1.09593,12.11.2019 01:00:00,17668,-0.009804135282931982,43.42,IS,0.34,0.0,Phase3-EA-S4v1-EURCHF-M15-221,EURCHFMT4,4676,8h 45m,Buy
190255.87,120314,12.11.2019 15:15:00,,0.0,-34.01999999996042,0.0,0.0,120356,12.11.2019 04:30:00,17669,-0.012137433854628241,-6.54,IS,0.17,0.0,Phase3-EA-T1v2-EURJPY-M15-322,EURJPYMT4,3510,10h 45m,Buy
190182.2,1.09307,13.11.2019 04:20:00,,-0.99,-107.68999999994412,0.0,0.0,1.09483,12.11.2019 20:00:00,17670,-0.03842093626707107,-73.67,IS,0.41,0.0,Phase3-EA-SA2v2-EURCHF-M5-43,EURCHFMT4,9094,8h 20m,Buy
190132.22,139888,13.11.2019 04:45:00,,-0.76,-157.6699999999255,0.0,0.0,140121,12.11.2019 23:20:00,17671,-0.05625247489302049,-49.98,IS,0.23,0.0,Phase3-EA-S4v1-GBPJPY-M5-194,GBPJPYMT4,3820,5h 25m,Buy
190063.2,1.09029,13.11.2019 15:15:00,,0.0,-226.68999999994412,0.0,0.0,1.0923,13.11.2019 06:30:00,17672,-0.08087698061458551,-69.02,IS,0.34,0.0,Phase3-EA-S4v1-EURCHF-M15-221,EURCHFMT4,4678,8h 45m,Buy
189992.28,119694,13.11.2019 18:29:58,sl 119.694,-11.37,-297.6099999999278,0.0,0.0,120414,16.10.2019 21:00:00,17673,-0.10617935595177065,-70.92,IS,0.09,0.0,Phase3-EA-TR1v1-EURJPY-M30-91,EURJPYMT4,3087,27d 21h 29m,Buy
190048.78,0.98957,14.11.2019 01:14:57,tp 0.98957,-2.11,-241.10999999992782,0.0,0.0,0.98857,13.11.2019 23:30:00,17674,-0.08602165422374909,56.5,IS,0.58,0.0,Phase3-EA-SA2v2-USDCHF-M15-107,USDCHFMT4,3520,1h 44m,Buy
190091.33,1.08997,14.11.2019 01:34:58,tp 1.08997,-2.98,-198.55999999993946,0.0,0.0,1.08887,13.11.2019 20:20:00,17675,-0.0708409425684025,42.55,IS,0.41,0.0,Phase3-EA-SA2v2-EURCHF-M5-43,EURCHFMT4,9096,5h 14m,Buy
190149.94,0.98958,14.11.2019 02:14:58,tp 0.98958,0.0,-139.94999999995343,0.0,0.0,0.99058,14.11.2019 01:30:00,17676,-0.04993044879355184,58.61,IS,0.58,0.0,Phase3-EA-SA2v2-USDCHF-M15-107,USDCHFMT4,3522,44m 58s,Sell
190195.54,1.08855,14.11.2019 02:19:57,tp 1.08855,0.0,-94.34999999997672,0.0,0.0,1.08965,14.11.2019 01:40:00,17677,-0.03366157801837814,45.6,IS,0.41,0.0,Phase3-EA-SA2v2-EURCHF-M5-43,EURCHFMT4,9098,39m 57s,Sell
190213.78,139689,14.11.2019 04:45:00,,-2.28,-76.10999999998603,0.0,0.0,139592,13.11.2019 23:20:00,17678,-0.02715402970830866,18.24,IS,0.23,0.0,Phase3-EA-S4v1-GBPJPY-M5-194,GBPJPYMT4,3822,5h 25m,Buy
190238.16,1.08882,14.11.2019 10:30:00,,0.0,-51.72999999998137,0.0,0.0,1.08953,14.11.2019 01:45:00,17679,-0.01845589221929522,24.38,IS,0.34,0.0,Phase3-EA-S4v1-EURCHF-M15-221,EURCHFMT4,4680,8h 45m,Sell
190283.83,1.08806,14.11.2019 20:59:58,tp 1.08806,0.0,-6.059999999997672,0.0,0.0,1.08696,14.11.2019 20:15:00,17680,-0.0021620473003851988,45.67,IS,0.41,0.0,Phase3-EA-SA2v2-EURCHF-M5-43,EURCHFMT4,9100,44m 58s,Buy
190342.55,0.98767,15.11.2019 02:14:58,tp 0.98767,0.0,-0.0,0.0,0.0,0.98867,15.11.2019 01:00:00,17681,-0.0,58.72,IS,0.58,0.0,Phase3-EA-SA2v2-USDCHF-M15-107,USDCHFMT4,3524,1h 14m,Sell
190401.21,0.98875,15.11.2019 03:44:57,tp 0.98875,0.0,-0.0,0.0,0.0,0.98775,15.11.2019 02:15:00,17682,-0.0,58.66,IS,0.58,0.0,Phase3-EA-SA2v2-USDCHF-M15-107,USDCHFMT4,3526,1h 29m,Buy
190329.9,1.09011,15.11.2019 05:40:00,,-2.07,-71.30999999999767,0.0,0.0,1.08844,14.11.2019 21:20:00,17683,-0.02543141664759483,-71.31,IS,0.41,0.0,Phase3-EA-SA2v2-EURCHF-M5-43,EURCHFMT4,9102,8h 20m,Sell
190268.46,139893,15.11.2019 05:50:00,,0.0,-132.75,0.0,0.0,139603,15.11.2019 00:25:00,17684,-0.0473428770154021,-61.44,IS,0.23,0.0,Phase3-EA-S4v1-GBPJPY-M5-194,GBPJPYMT4,3824,5h 25m,Sell
190230.31,1.0905,15.11.2019 10:00:00,,0.0,-170.90000000002328,0.0,0.0,1.08939,15.11.2019 01:15:00,17685,-0.06094838178480845,-38.15,IS,0.34,0.0,Phase3-EA-S4v1-EURCHF-M15-221,EURCHFMT4,4682,8h 45m,Sell
190194.5,108.56,15.11.2019 11:30:00,,0.0,-206.71000000002095,0.0,0.0,108416,15.11.2019 01:15:00,17686,-0.07371936804410366,-35.81,IS,0.27,0.0,Phase3-EA-S1v2-USDJPY-M15-0,USDJPYMT4,4890,10h 15m,Sell
190238.01,1.09318,18.11.2019 02:00:00,tp 1.09318,-2.07,-163.20000000001164,0.0,0.0,1.09428,15.11.2019 20:35:00,17687,-0.05820231660199001,43.51,IS,0.41,0.0,Phase3-EA-SA2v2-EURCHF-M5-43,EURCHFMT4,9104,2d 5h 25m,Sell
190234.38,0.98944,18.11.2019 03:15:00,,-0.7,-166.8300000000163,0.0,0.0,0.98949,15.11.2019 23:00:00,17688,-0.05949689018817555,-3.63,IS,0.58,0.0,Phase3-EA-SA2v2-USDCHF-M15-107,USDCHFMT4,3528,2d 4h 15m,Buy
190308.8,120245,18.11.2019 04:45:00,,-0.77,-92.4100000000326,0.0,0.0,119764,15.11.2019 14:15:00,17689,-0.03295634851220227,74.42,IS,0.17,0.0,Phase3-EA-T1v2-EURJPY-M15-322,EURJPYMT4,3512,2d 14h 30m,Buy
190354.38,1.09479,18.11.2019 07:34:58,tp 1.09479,0.0,-46.8300000000163,0.0,0.0,1.09369,18.11.2019 02:05:00,17690,-0.016701069157303593,45.58,IS,0.41,0.0,Phase3-EA-SA2v2-EURCHF-M5-43,EURCHFMT4,9106,5h 29m,Buy
190302.74,1295,18.11.2019 11:29:57,sl 1.29500,-9.64,-98.47000000003027,0.0,0.0,1292,04.11.2019 14:00:00,17691,-0.035117537474260475,-51.64,IS,0.14,0.0,Phase3-EA-B1v1-GBPUSD-M30-14,GBPUSDMT4,1176,13d 21h 29m,Sell
190241.73,120483,18.11.2019 11:29:58,sl 120.483,-1.45,-159.48000000003958,0.0,0.0,119763,13.11.2019 19:00:00,17692,-0.056875646150042945,-61.01,IS,0.09,0.0,Phase3-EA-TR1v1-EURJPY-M30-91,EURJPYMT4,3090,4d 16h 29m,Sell
190269.9,1.0944,18.11.2019 12:00:00,,0.0,-131.31000000005588,0.0,0.0,1.09358,18.11.2019 03:15:00,17693,-0.04682932716305157,28.17,IS,0.34,0.0,Phase3-EA-S4v1-EURCHF-M15-221,EURCHFMT4,4684,8h 45m,Buy
190221.06,0.98932,19.11.2019 04:00:00,,-3.11,-180.1500000000815,0.0,0.0,0.98854,18.11.2019 23:45:00,17694,-0.06424722632262558,-48.84,IS,0.58,0.0,Phase3-EA-SA2v2-USDCHF-M15-107,USDCHFMT4,3530,4h 15m,Sell
190229.39,108599,19.11.2019 04:15:00,,-1.12,-171.8200000000652,0.0,0.0,108637,18.11.2019 23:30:00,17695,-0.061276483079393415,8.33,IS,0.27,0.0,Phase3-EA-S1v2-USDJPY-M15-0,USDJPYMT4,4892,4h 45m,Sell
190209.5,1.0954,19.11.2019 04:50:00,,-2.07,-191.71000000007916,0.0,0.0,1.09497,18.11.2019 20:30:00,17696,-0.06836989041526542,-19.89,IS,0.41,0.0,Phase3-EA-SA2v2-EURCHF-M5-43,EURCHFMT4,9108,8h 20m,Sell
190173.54,120482,19.11.2019 17:29:58,sl 120.482,0.0,-227.67000000010012,0.0,0.0,120252,19.11.2019 04:15:00,17697,-0.08119437145085752,-35.96,IS,0.17,0.0,Phase3-EA-T1v2-EURJPY-M15-322,EURJPYMT4,3514,13h 14m,Sell
190217.0,1.0967,20.11.2019 02:24:58,tp 1.09670,-2.07,-184.21000000007916,0.0,0.0,1.0978,19.11.2019 23:05:00,17698,-0.06569515160083593,43.46,IS,0.41,0.0,Phase3-EA-SA2v2-EURCHF-M5-43,EURCHFMT4,9110,3h 19m,Sell
190247.13,108.43,20.11.2019 03:15:00,,0.0,-154.0800000000745,0.0,0.0,108551,20.11.2019 00:45:00,17699,-0.05494983420366616,30.13,IS,0.27,0.0,Phase3-EA-S1v2-USDJPY-M15-0,USDJPYMT4,4894,2h 30m,Sell
190190.99,140041,20.11.2019 05:29:58,sl 140.041,-0.6,-210.22000000008848,0.0,0.0,140711,18.11.2019 11:00:00,17700,-0.07497114580928074,-56.14,IS,0.09,0.0,Phase3-EA-B1v1-GBPJPY-M30-1,GBPJPYMT4,1578,1d 18h 29m,Buy
190190.99,0.99065,20.11.2019 06:30:00,,0.0,-210.22000000008848,0.0,0.0,0.99065,20.11.2019 02:15:00,17701,-0.07497114580928074,0.0,IS,0.58,0.0,Phase3-EA-SA2v2-USDCHF-M15-107,USDCHFMT4,3532,4h 15m,Buy
190176.79,140089,20.11.2019 08:40:00,,0.0,-224.42000000010012,0.0,0.0,140156,20.11.2019 03:15:00,17702,-0.08003531796460474,-14.2,IS,0.23,0.0,Phase3-EA-S4v1-GBPJPY-M5-194,GBPJPYMT4,3826,5h 25m,Buy
190116.22,119869,20.11.2019 12:29:58,sl 119.869,-0.82,-284.9900000001071,0.0,0.0,120423,18.11.2019 12:00:00,17703,-0.10163650862993985,-60.57,IS,0.09,0.0,Phase3-EA-TR1v1-EURJPY-M30-91,EURJPYMT4,3092,2d 0h 29m,Sell
190051.93,1.09629,21.11.2019 05:25:00,,-2.98,-349.28000000008615,0.0,0.0,1.09777,20.11.2019 21:05:00,17704,-0.12456436974722203,-64.29,IS,0.41,0.0,Phase3-EA-SA2v2-EURCHF-M5-43,EURCHFMT4,9112,8h 20m,Buy
190075.93,0.99065,21.11.2019 06:30:00,,0.0,-325.28000000008615,0.0,0.0,0.99024,21.11.2019 02:15:00,17705,-0.11600520554104764,24.0,IS,0.58,0.0,Phase3-EA-SA2v2-USDCHF-M15-107,USDCHFMT4,3534,4h 15m,Buy
190088.86,140276,21.11.2019 08:05:00,,0.0,-312.35000000009313,0.0,0.0,140215,21.11.2019 02:40:00,17706,-0.11139395582497368,12.93,IS,0.23,0.0,Phase3-EA-S4v1-GBPJPY-M5-194,GBPJPYMT4,3828,5h 25m,Buy
190044.11,1.29673,21.11.2019 17:29:58,sl 1.29673,-2.75,-357.10000000009313,0.0,0.0,1.29373,19.11.2019 14:30:00,17707,-0.1273532307510697,-44.75,IS,0.14,0.0,Phase3-EA-B1v1-GBPUSD-M30-14,GBPUSDMT4,1178,2d 2h 59m,Sell
190035.5,120141,21.11.2019 20:15:00,,0.0,-365.71000000007916,0.0,0.0,120196,21.11.2019 08:00:00,17708,-0.13042383091002976,-8.61,IS,0.17,0.0,Phase3-EA-T1v2-EURJPY-M15-322,EURJPYMT4,3516,12h 15m,Buy
190006.12,0.99301,22.11.2019 02:15:00,,-3.1,-395.0900000000838,0.0,0.0,0.99256,21.11.2019 22:00:00,17709,-0.14090167442575657,-29.38,IS,0.58,0.0,Phase3-EA-SA2v2-USDCHF-M15-107,USDCHFMT4,3536,4h 15m,Sell
190049.47,1.09735,22.11.2019 02:24:58,tp 1.09735,-2.06,-351.7400000001071,0.0,0.0,1.09845,21.11.2019 22:30:00,17710,-0.12544168407836237,43.35,IS,0.41,0.0,Phase3-EA-SA2v2-EURCHF-M5-43,EURCHFMT4,9114,3h 54m,Sell
190042.63,1.09894,22.11.2019 13:45:00,,0.0,-358.5800000001327,0.0,0.0,1.09874,22.11.2019 05:00:00,17711,-0.12788104587713123,-6.84,IS,0.34,0.0,Phase3-EA-S4v1-EURCHF-M15-221,EURCHFMT4,4686,8h 45m,Sell
190087.87,1.09959,22.11.2019 21:19:58,tp 1.09959,0.0,-313.340000000142,0.0,0.0,1.09849,22.11.2019 20:10:00,17712,-0.1117470213484958,45.24,IS,0.41,0.0,Phase3-EA-SA2v2-EURCHF-M5-43,EURCHFMT4,9116,1h 9m,Buy
190131.05,1.09872,25.11.2019 02:00:00,tp 1.09872,-2.05,-270.160000000149,0.0,0.0,1.09982,22.11.2019 22:00:00,17713,-0.09634765841422287,43.18,IS,0.41,0.0,Phase3-EA-SA2v2-EURCHF-M5-43,EURCHFMT4,9118,2d 4h 0m,Sell
190119.63,139699,25.11.2019 07:40:00,,0.0,-281.5800000001327,0.0,0.0,139645,25.11.2019 02:15:00,17714,-0.10042039404898838,-11.42,IS,0.23,0.0,Phase3-EA-S4v1-GBPJPY-M5-194,GBPJPYMT4,3830,5h 25m,Sell
190120.04,1.09954,25.11.2019 10:25:00,,0.0,-281.1700000001583,0.0,0.0,1.09953,25.11.2019 02:05:00,17715,-0.1002741749938087,0.41,IS,0.41,0.0,Phase3-EA-SA2v2-EURCHF-M5-43,EURCHFMT4,9120,8h 20m,Buy
190137.14,1.0977,26.11.2019 04:55:00,,-0.99,-264.0700000001816,0.0,0.0,1.09726,25.11.2019 20:35:00,17716,-0.09417577049691775,17.1,IS,0.41,0.0,Phase3-EA-SA2v2-EURCHF-M5-43,EURCHFMT4,9122,8h 20m,Buy
190138.45,140555,26.11.2019 05:10:00,,-1.22,-262.76000000018394,0.0,0.0,140567,25.11.2019 23:45:00,17717,-0.09370858278399823,1.31,IS,0.23,0.0,Phase3-EA-S4v1-GBPJPY-M5-194,GBPJPYMT4,3832,5h 25m,Sell
190083.26,1.09945,26.11.2019 13:30:00,,0.0,-317.95000000018626,0.0,0.0,1.09783,26.11.2019 04:45:00,17718,-0.11339109413978092,-55.19,IS,0.34,0.0,Phase3-EA-S4v1-EURCHF-M15-221,EURCHFMT4,4688,8h 45m,Sell
190076.27,1.09944,27.11.2019 04:25:00,,-2.06,-324.94000000017695,0.0,0.0,1.09932,26.11.2019 20:05:00,17719,-0.11588395071482589,-6.99,IS,0.41,0.0,Phase3-EA-SA2v2-EURCHF-M5-43,EURCHFMT4,9124,8h 20m,Sell
190094.05,120169,27.11.2019 08:30:00,,-0.76,-307.160000000149,0.0,0.0,120.05,26.11.2019 15:15:00,17720,-0.1095430365654084,17.78,IS,0.17,0.0,Phase3-EA-T1v2-EURJPY-M15-322,EURJPYMT4,3518,17h 15m,Buy
190139.16,1.09978,27.11.2019 20:44:59,tp 1.09978,0.0,-262.050000000163,0.0,0.0,1.09868,27.11.2019 20:25:00,17721,-0.09345537417622476,45.11,IS,0.41,0.0,Phase3-EA-SA2v2-EURCHF-M5-43,EURCHFMT4,9126,19m 59s,Buy
190079.33,120367,27.11.2019 21:59:58,sl 120.367,-0.58,-321.8800000001793,0.0,0.0,120589,18.11.2019 15:00:00,17722,-0.11479265727853948,-59.83,IS,0.09,0.0,Phase3-EA-TR1v1-EURJPY-M30-91,EURJPYMT4,3093,9d 6h 59m,Buy
190118.33,1.09864,28.11.2019 02:04:57,tp 1.09864,-6.15,-282.8800000001793,0.0,0.0,1.09974,27.11.2019 20:50:00,17723,-0.1008840154435061,39.0,IS,0.41,0.0,Phase3-EA-SA2v2-EURCHF-M5-43,EURCHFMT4,9128,5h 14m,Sell
190071.51,1.2948,28.11.2019 02:59:57,sl 1.29480,-4.82,-329.70000000018626,0.0,0.0,1.2918,21.11.2019 19:30:00,17724,-0.11758151828238712,-46.82,IS,0.14,0.0,Phase3-EA-B1v1-GBPUSD-M30-14,GBPUSDMT4,1180,6d 7h 29m,Sell
190013.65,0.99839,28.11.2019 03:45:00,,-2.09,-387.5600000001723,0.0,0.0,0.99935,27.11.2019 23:30:00,17725,-0.13821623665610092,-57.86,IS,0.58,0.0,Phase3-EA-SA2v2-USDCHF-M15-107,USDCHFMT4,3538,4h 15m,Buy
190095.66,141347,28.11.2019 04:34:59,tp 141.347,0.0,-305.550000000163,0.0,0.0,141737,28.11.2019 02:45:00,17726,-0.10896885929991584,82.01,IS,0.23,0.0,Phase3-EA-S4v1-GBPJPY-M5-194,GBPJPYMT4,3834,1h 49m,Sell
190127.3,1.10006,28.11.2019 11:15:00,,0.0,-273.910000000149,0.0,0.0,1.09913,28.11.2019 02:30:00,17727,-0.09768502782143762,31.64,IS,0.34,0.0,Phase3-EA-S4v1-EURCHF-M15-221,EURCHFMT4,4690,8h 45m,Buy
190115.22,1.09925,29.11.2019 08:05:00,,-0.99,-285.9900000001653,0.0,0.0,1.09952,28.11.2019 23:45:00,17728,-0.10199314047188454,-12.08,IS,0.41,0.0,Phase3-EA-SA2v2-EURCHF-M5-43,EURCHFMT4,9130,8h 20m,Buy
190130.88,1.0994,29.11.2019 10:45:00,,0.0,-270.3300000001909,0.0,0.0,1.09894,29.11.2019 02:00:00,17729,-0.09640828582736488,15.66,IS,0.34,0.0,Phase3-EA-S4v1-EURCHF-M15-221,EURCHFMT4,4692,8h 45m,Buy
190128.72,120494,29.11.2019 16:15:00,,-0.76,-272.4900000001653,0.0,0.0,120503,28.11.2019 06:45:00,17730,-0.09717861060591144,-2.16,IS,0.17,0.0,Phase3-EA-T1v2-EURJPY-M15-322,EURJPYMT4,3520,1d 9h 30m,Buy
190166.47,1.10144,02.12.2019 14:15:00,,0.0,-234.7400000001653,0.0,0.0,1.10255,02.12.2019 05:30:00,17731,-0.08371575857328298,37.75,IS,0.34,0.0,Phase3-EA-S4v1-EURCHF-M15-221,EURCHFMT4,4694,8h 45m,Sell
190130.63,120744,02.12.2019 21:44:58,sl 120.744,0.0,-270.5800000001909,0.0,0.0,120974,02.12.2019 18:15:00,17732,-0.09649744378784587,-35.84,IS,0.17,0.0,Phase3-EA-T1v2-EURJPY-M15-322,EURJPYMT4,3522,3h 29m,Buy
190104.19,0.9913,03.12.2019 03:45:00,,-0.7,-297.02000000019325,0.0,0.0,0.99174,02.12.2019 23:30:00,17733,-0.1059267896883155,-26.44,IS,0.58,0.0,Phase3-EA-SA2v2-USDCHF-M15-107,USDCHFMT4,3540,4h 15m,Buy
190078.4,1.09827,03.12.2019 05:15:00,,-0.99,-322.8100000001723,0.0,0.0,1.09887,02.12.2019 20:55:00,17734,-0.11512432489152624,-25.79,IS,0.41,0.0,Phase3-EA-SA2v2-EURCHF-M5-43,EURCHFMT4,9132,8h 20m,Buy
190123.09,1.09403,04.12.2019 03:54:58,tp 1.09403,-1.0,-278.12000000016997,0.0,0.0,1.09293,03.12.2019 20:15:00,17735,-0.09918644787594486,44.69,IS,0.41,0.0,Phase3-EA-SA2v2-EURCHF-M5-43,EURCHFMT4,9134,7h 39m,Buy
190129.93,108559,04.12.2019 04:15:00,,-1.12,-271.28000000014435,0.0,0.0,108591,03.12.2019 23:45:00,17736,-0.09674708607717601,6.84,IS,0.27,0.0,Phase3-EA-S1v2-USDJPY-M15-0,USDJPYMT4,4896,4h 30m,Sell
190136.98,0.98683,04.12.2019 05:00:00,,0.0,-264.230000000156,0.0,0.0,0.98695,04.12.2019 00:45:00,17737,-0.09423283159161644,7.05,IS,0.58,0.0,Phase3-EA-SA2v2-USDCHF-M15-107,USDCHFMT4,3542,4h 15m,Sell
190100.93,120509,04.12.2019 13:14:57,sl 120.509,0.0,-300.28000000014435,0.0,0.0,120279,04.12.2019 05:00:00,17738,-0.10708940949297008,-36.05,IS,0.17,0.0,Phase3-EA-T1v2-EURJPY-M15-322,EURJPYMT4,3524,8h 14m,Sell
190132.69,108807,04.12.2019 19:15:00,,0.0,-268.52000000013504,0.0,0.0,108679,04.12.2019 18:30:00,17739,-0.09576278219346264,31.76,IS,0.27,0.0,Phase3-EA-S1v2-USDJPY-M15-0,USDJPYMT4,4898,45m 0s,Buy
190139.64,108837,04.12.2019 19:30:00,,0.0,-261.5700000001234,0.0,0.0,108809,04.12.2019 19:15:00,17740,-0.09328419089208716,6.95,IS,0.27,0.0,Phase3-EA-S1v2-USDJPY-M15-0,USDJPYMT4,4900,15m 0s,Buy
190120.34,142697,05.12.2019 04:55:00,,-3.67,-280.87000000011176,0.0,0.0,142623,04.12.2019 23:30:00,17741,-0.1001671854412149,-19.3,IS,0.23,0.0,Phase3-EA-S4v1-GBPJPY-M5-194,GBPJPYMT4,3836,5h 25m,Sell
190119.1,108861,05.12.2019 05:30:00,,0.0,-282.11000000010245,0.0,0.0,108866,05.12.2019 01:00:00,17742,-0.10060940892519726,-1.24,IS,0.27,0.0,Phase3-EA-S1v2-USDJPY-M15-0,USDJPYMT4,4902,4h 30m,Buy
190130.25,0.98833,05.12.2019 06:30:00,,0.0,-270.96000000007916,0.0,0.0,0.98814,05.12.2019 02:15:00,17743,-0.09663296388773711,11.15,IS,0.58,0.0,Phase3-EA-SA2v2-USDCHF-M15-107,USDCHFMT4,3544,4h 15m,Buy
190094.54,1.09455,05.12.2019 09:35:00,,0.0,-306.6700000001001,0.0,0.0,1.09541,05.12.2019 01:15:00,17744,-0.10936828696284823,-35.71,IS,0.41,0.0,Phase3-EA-SA2v2-EURCHF-M5-43,EURCHFMT4,9136,8h 20m,Buy
190083.6,120592,05.12.2019 11:00:00,,0.0,-317.61000000010245,0.0,0.0,120662,05.12.2019 04:30:00,17745,-0.11326983931349689,-10.94,IS,0.17,0.0,Phase3-EA-T1v2-EURJPY-M15-322,EURJPYMT4,3526,6h 30m,Buy
190065.01,1.09454,05.12.2019 11:15:00,,0.0,-336.20000000012806,0.0,0.0,1.09508,05.12.2019 02:30:00,17746,-0.11989962525487194,-18.59,IS,0.34,0.0,Phase3-EA-S4v1-EURCHF-M15-221,EURCHFMT4,4696,8h 45m,Buy
190326.95,1.31234,05.12.2019 11:29:58,tp 1.31234,-2.66,-74.26000000012573,0.0,0.0,1.29344,02.12.2019 20:30:00,17747,-0.0264834805813161,261.94,IS,0.14,0.0,Phase3-EA-B1v1-GBPUSD-M30-14,GBPUSDMT4,1182,2d 14h 59m,Buy
190325.7,120643,05.12.2019 20:45:00,,0.0,-75.51000000012573,0.0,0.0,120651,05.12.2019 12:00:00,17748,-0.02692927038372102,-1.25,IS,0.17,0.0,Phase3-EA-T1v2-EURJPY-M15-322,EURJPYMT4,3528,8h 45m,Buy
190332.59,1.09615,06.12.2019 05:05:00,,-1.0,-68.62000000011176,0.0,0.0,1.09596,05.12.2019 20:45:00,17749,-0.024472076992860137,6.89,IS,0.41,0.0,Phase3-EA-SA2v2-EURCHF-M5-43,EURCHFMT4,9138,8h 20m,Buy
190336.7,0.98691,06.12.2019 06:30:00,,0.0,-64.51000000012573,0.0,0.0,0.98684,06.12.2019 02:15:00,17750,-0.023006320122557756,4.11,IS,0.58,0.0,Phase3-EA-SA2v2-USDCHF-M15-107,USDCHFMT4,3546,4h 15m,Buy
190294.17,1.31091,06.12.2019 19:59:58,sl 1.31091,-0.53,-107.04000000015367,0.0,0.0,1.31391,05.12.2019 11:30:00,17751,-0.03817387235959259,-42.53,IS,0.14,0.0,Phase3-EA-B1v1-GBPUSD-M30-14,GBPUSDMT4,1184,1d 8h 29m,Buy
190338.72,1.09615,09.12.2019 02:34:57,tp 1.09615,-0.99,-62.49000000016531,0.0,0.0,1.09505,06.12.2019 20:00:00,17752,-0.022285923801885526,44.55,IS,0.41,0.0,Phase3-EA-SA2v2-EURCHF-M5-43,EURCHFMT4,9140,2d 6h 34m,Buy
190343.8,142714,09.12.2019 09:00:00,,0.0,-57.41000000014901,0.0,0.0,142738,09.12.2019 03:35:00,17753,-0.020474234044906135,5.08,IS,0.23,0.0,Phase3-EA-S4v1-GBPJPY-M5-194,GBPJPYMT4,3838,5h 25m,Sell
190308.77,1.09316,10.12.2019 04:20:00,,-1.0,-92.44000000017695,0.0,0.0,1.09398,09.12.2019 20:00:00,17754,-0.03296704746751147,-35.03,IS,0.41,0.0,Phase3-EA-SA2v2-EURCHF-M5-43,EURCHFMT4,9142,8h 20m,Buy
190335.45,142833,10.12.2019 07:20:00,,0.0,-65.76000000018394,0.0,0.0,142707,10.12.2019 01:55:00,17755,-0.02345210992498343,26.68,IS,0.23,0.0,Phase3-EA-S4v1-GBPJPY-M5-194,GBPJPYMT4,3840,5h 25m,Buy
190298.89,120275,10.12.2019 12:14:58,sl 120.275,-0.55,-102.32000000018161,0.0,0.0,120045,09.12.2019 13:30:00,17756,-0.03649057006572159,-36.56,IS,0.17,0.0,Phase3-EA-T1v2-EURJPY-M15-322,EURJPYMT4,3530,22h 44m,Sell
190350.28,1.09191,10.12.2019 15:00:00,,0.0,-50.93000000016764,0.0,0.0,1.0934,10.12.2019 06:15:00,17757,-0.01816325970924569,51.39,IS,0.34,0.0,Phase3-EA-S4v1-EURCHF-M15-221,EURCHFMT4,4698,8h 45m,Sell
190396.05,1.09221,10.12.2019 21:24:58,tp 1.09221,0.0,-5.160000000149012,0.0,0.0,1.09331,10.12.2019 20:05:00,17758,-0.0018402203043806364,45.77,IS,0.41,0.0,Phase3-EA-SA2v2-EURCHF-M5-43,EURCHFMT4,9144,1h 19m,Sell
190353.52,1.31267,11.12.2019 02:29:58,sl 1.31267,-0.53,-47.69000000017695,0.0,0.0,1.31567,10.12.2019 11:00:00,17759,-0.01700777254141547,-42.53,IS,0.14,0.0,Phase3-EA-B1v1-GBPUSD-M30-14,GBPUSDMT4,1186,15h 29m,Buy
190405.24,0.98451,11.12.2019 04:00:00,,-0.71,-0.0,0.0,0.0,0.98362,10.12.2019 23:45:00,17760,-0.0,51.72,IS,0.58,0.0,Phase3-EA-SA2v2-USDCHF-M15-107,USDCHFMT4,3548,4h 15m,Buy
190392.58,1.09195,11.12.2019 06:35:00,,-1.0,-12.659999999974389,0.0,0.0,1.09223,10.12.2019 22:15:00,17761,-0.004514894229499541,-12.66,IS,0.41,0.0,Phase3-EA-SA2v2-EURCHF-M5-43,EURCHFMT4,9146,8h 20m,Buy
190369.52,142845,11.12.2019 07:35:00,,0.0,-35.71999999997206,0.0,0.0,142954,11.12.2019 02:10:00,17762,-0.012738706309472648,-23.06,IS,0.23,0.0,Phase3-EA-S4v1-GBPJPY-M5-194,GBPJPYMT4,3842,5h 25m,Buy
190382.64,1.09201,11.12.2019 11:30:00,,0.0,-22.599999999976717,0.0,0.0,1.09163,11.12.2019 02:45:00,17763,-0.008059763790425825,13.12,IS,0.34,0.0,Phase3-EA-S4v1-EURCHF-M15-221,EURCHFMT4,4700,8h 45m,Buy
190355.09,1.09439,12.12.2019 07:35:00,,-6.26,-50.149999999965075,0.0,0.0,1.09388,11.12.2019 23:15:00,17764,-0.017884829826990706,-27.55,IS,0.41,0.0,Phase3-EA-SA2v2-EURCHF-M5-43,EURCHFMT4,9148,8h 20m,Sell
190282.92,121203,12.12.2019 18:59:58,sl 121.203,-7.53,-122.31999999994878,0.0,0.0,119647,25.11.2019 02:00:00,17765,-0.04362257994891547,-72.17,IS,0.09,0.0,Phase3-EA-TR1v1-EURJPY-M30-91,EURJPYMT4,3095,17d 16h 59m,Sell
190113.99,144738,13.12.2019 02:04:58,sl 144.738,0.0,-291.2499999999418,0.0,0.0,143938,13.12.2019 00:20:00,17766,-0.10386753114882613,-168.93,IS,0.23,0.0,Phase3-EA-S4v1-GBPJPY-M5-194,GBPJPYMT4,3844,1h 44m,Sell
190158.7,1.09665,13.12.2019 02:04:58,tp 1.09665,-1.0,-246.53999999992084,0.0,0.0,1.09555,12.12.2019 23:05:00,17767,-0.08792275065898193,44.71,IS,0.41,0.0,Phase3-EA-SA2v2-EURCHF-M5-43,EURCHFMT4,9150,2h 59m,Buy
190112.59,109502,13.12.2019 02:15:00,,0.0,-292.64999999990687,0.0,0.0,109315,13.12.2019 01:15:00,17768,-0.10436680855176092,-46.11,IS,0.27,0.0,Phase3-EA-S1v2-USDJPY-M15-0,USDJPYMT4,4904,1h 0m,Sell
190263.05,144535,13.12.2019 02:29:58,tp 144.535,-2.4,-142.1899999998859,0.0,0.0,142685,05.12.2019 01:30:00,17769,-0.050708752803580046,150.46,IS,0.09,0.0,Phase3-EA-B1v1-GBPJPY-M30-1,GBPJPYMT4,1580,8d 0h 59m,Buy
190361.08,121799,13.12.2019 02:29:58,tp 121.799,-6.08,-44.15999999985797,0.0,0.0,120539,28.11.2019 00:30:00,17770,-0.015748635795771078,98.03,IS,0.09,0.0,Phase3-EA-TR1v1-EURJPY-M30-91,EURJPYMT4,3097,15d 1h 59m,Buy
190319.08,1.34639,13.12.2019 02:59:58,sl 1.34639,0.0,-86.15999999985797,0.0,0.0,1.34939,13.12.2019 02:30:00,17771,-0.030726957884188482,-42.0,IS,0.14,0.0,Phase3-EA-B1v1-GBPUSD-M30-14,GBPUSDMT4,1188,29m 58s,Buy
190247.2,0.9844,13.12.2019 06:30:00,,0.0,-158.03999999986263,0.0,0.0,0.98562,13.12.2019 02:15:00,17772,-0.05636128625836736,-71.88,IS,0.58,0.0,Phase3-EA-SA2v2-USDCHF-M15-107,USDCHFMT4,3550,4h 15m,Buy
190242.21,1.10088,13.12.2019 10:45:00,,0.0,-163.02999999985332,0.0,0.0,1.10076,13.12.2019 02:25:00,17773,-0.05814085357315458,-4.99,IS,0.41,0.0,Phase3-EA-SA2v2-EURCHF-M5-43,EURCHFMT4,9152,8h 20m,Sell
190273.26,1.1003,13.12.2019 11:45:00,,0.0,-131.97999999986496,0.0,0.0,1.1012,13.12.2019 03:00:00,17774,-0.04706759402922158,31.05,IS,0.34,0.0,Phase3-EA-S4v1-EURCHF-M15-221,EURCHFMT4,4702,8h 45m,Sell
190424.73,122018,13.12.2019 18:30:00,,-0.76,-0.0,0.0,0.0,121039,12.12.2019 17:45:00,17775,-0.0,151.47,IS,0.17,0.0,Phase3-EA-T1v2-EURJPY-M15-322,EURJPYMT4,3532,1d 0h 45m,Buy
190437.06,1.09481,16.12.2019 04:20:00,,-1.0,-0.0,0.0,0.0,1.09449,13.12.2019 20:00:00,17776,-0.0,12.33,IS,0.41,0.0,Phase3-EA-SA2v2-EURCHF-M5-43,EURCHFMT4,9154,2d 8h 20m,Buy
190365.15,146424,16.12.2019 09:10:00,,0.0,-71.90999999997439,0.0,0.0,146082,16.12.2019 03:45:00,17777,-0.025642117343540143,-71.91,IS,0.23,0.0,Phase3-EA-S4v1-GBPJPY-M5-194,GBPJPYMT4,3846,5h 25m,Sell
190310.07,146086,16.12.2019 13:29:58,sl 146.086,0.0,-126.98999999999069,0.0,0.0,146756,16.12.2019 11:00:00,17778,-0.045282888074775186,-55.08,IS,0.09,0.0,Phase3-EA-B1v1-GBPJPY-M30-1,GBPJPYMT4,1582,2h 29m,Buy
190355.97,1.09515,16.12.2019 23:09:58,tp 1.09515,0.0,-81.0899999999674,0.0,0.0,1.09625,16.12.2019 20:15:00,17779,-0.028915579132075857,45.9,IS,0.41,0.0,Phase3-EA-SA2v2-EURCHF-M5-43,EURCHFMT4,9156,2h 54m,Sell
190436.61,145829,17.12.2019 02:49:58,tp 145.829,-1.22,-0.44999999995343387,0.0,0.0,146219,16.12.2019 23:15:00,17780,-1.6046381314703268E-4,80.64,IS,0.23,0.0,Phase3-EA-S4v1-GBPJPY-M5-194,GBPJPYMT4,3848,3h 34m,Sell
190464.81,0.98308,17.12.2019 03:15:00,,-0.71,-0.0,0.0,0.0,0.98259,16.12.2019 23:00:00,17781,-0.0,28.2,IS,0.58,0.0,Phase3-EA-SA2v2-USDCHF-M15-107,USDCHFMT4,3552,4h 15m,Buy
190474.24,1.09542,17.12.2019 07:40:00,,-1.0,-0.0,0.0,0.0,1.09517,16.12.2019 23:20:00,17782,-0.0,9.43,IS,0.41,0.0,Phase3-EA-SA2v2-EURCHF-M5-43,EURCHFMT4,9158,8h 20m,Buy
190497.42,1.09569,17.12.2019 10:00:00,,0.0,-0.0,0.0,0.0,1.09502,17.12.2019 01:15:00,17783,-0.0,23.18,IS,0.34,0.0,Phase3-EA-S4v1-EURCHF-M15-221,EURCHFMT4,4704,8h 45m,Buy
190543.4,1.09404,17.12.2019 20:44:57,tp 1.09404,0.0,-0.0,0.0,0.0,1.09294,17.12.2019 20:00:00,17784,-0.0,45.98,IS,0.41,0.0,Phase3-EA-SA2v2-EURCHF-M5-43,EURCHFMT4,9160,44m 57s,Buy
190588.42,1.09403,18.12.2019 02:04:57,tp 1.09403,-1.0,-0.0,0.0,0.0,1.09293,17.12.2019 23:35:00,17785,-0.0,45.02,IS,0.41,0.0,Phase3-EA-SA2v2-EURCHF-M5-43,EURCHFMT4,9162,2h 29m,Buy
190566.4,0.9799,18.12.2019 04:00:00,,-0.71,-22.020000000018626,0.0,0.0,0.98026,17.12.2019 23:45:00,17786,-0.007847793576092173,-22.02,IS,0.58,0.0,Phase3-EA-SA2v2-USDCHF-M15-107,USDCHFMT4,3554,4h 15m,Buy
190648.31,143444,18.12.2019 05:44:58,tp 143.444,0.0,-0.0,0.0,0.0,143834,18.12.2019 03:35:00,17787,-0.0,81.91,IS,0.23,0.0,Phase3-EA-S4v1-GBPJPY-M5-194,GBPJPYMT4,3850,2h 9m,Sell
190642.07,1.09263,18.12.2019 11:00:00,,0.0,-6.239999999990687,0.0,0.0,1.09281,18.12.2019 02:15:00,17788,-0.002223423330071241,-6.24,IS,0.34,0.0,Phase3-EA-S4v1-EURCHF-M15-221,EURCHFMT4,4706,8h 45m,Buy
190688.05,1.09038,18.12.2019 20:49:58,tp 1.09038,0.0,-0.0,0.0,0.0,1.09148,18.12.2019 20:05:00,17789,-0.0,45.98,IS,0.41,0.0,Phase3-EA-SA2v2-EURCHF-M5-43,EURCHFMT4,9164,44m 58s,Sell
190681.78,0.98009,19.12.2019 04:00:00,,-2.13,-6.2700000000186265,0.0,0.0,0.98016,18.12.2019 23:45:00,17790,-0.002233796558142963,-6.27,IS,0.58,0.0,Phase3-EA-SA2v2-USDCHF-M15-107,USDCHFMT4,3556,4h 15m,Buy
190683.71,143303,19.12.2019 04:30:00,,-2.27,-4.340000000025611,0.0,0.0,143283,18.12.2019 23:05:00,17791,-0.001546200488416088,1.93,IS,0.23,0.0,Phase3-EA-S4v1-GBPJPY-M5-194,GBPJPYMT4,3852,5h 25m,Buy
190679.86,1.09036,19.12.2019 05:10:00,,-3.01,-8.190000000002328,0.0,0.0,1.09038,18.12.2019 20:50:00,17792,-0.002917829953930099,-3.85,IS,0.41,0.0,Phase3-EA-SA2v2-EURCHF-M5-43,EURCHFMT4,9166,8h 20m,Buy
190629.23,1.09162,19.12.2019 14:45:00,,0.0,-58.820000000006985,0.0,0.0,1.09016,19.12.2019 06:00:00,17793,-0.02095564809403419,-50.63,IS,0.34,0.0,Phase3-EA-S4v1-EURCHF-M15-221,EURCHFMT4,4708,8h 45m,Sell
190687.81,0.97825,20.12.2019 01:44:58,tp 0.97825,-0.71,-0.23999999999068677,0.0,0.0,0.97725,19.12.2019 22:30:00,17794,-8.550417447079979E-5,58.58,IS,0.58,0.0,Phase3-EA-SA2v2-USDCHF-M15-107,USDCHFMT4,3558,3h 14m,Buy
190670.65,109324,20.12.2019 09:00:00,,-1.11,-17.399999999965075,0.0,0.0,109259,19.12.2019 23:45:00,17795,-0.006199052649361097,-17.16,IS,0.27,0.0,Phase3-EA-S1v2-USDJPY-M15-0,USDJPYMT4,4906,9h 15m,Sell
190654.31,1.08836,20.12.2019 09:50:00,,0.0,-33.73999999999069,0.0,0.0,1.08797,20.12.2019 01:30:00,17796,-0.012020461861483074,-16.34,IS,0.41,0.0,Phase3-EA-SA2v2-EURCHF-M5-43,EURCHFMT4,9168,8h 20m,Sell
190680.85,1.08825,23.12.2019 06:50:00,,-1.0,-7.2000000000116415,0.0,0.0,1.08759,20.12.2019 22:30:00,17797,-0.0025651252342276812,26.54,IS,0.41,0.0,Phase3-EA-SA2v2-EURCHF-M5-43,EURCHFMT4,9170,2d 8h 20m,Buy
190709.86,142335,23.12.2019 09:05:00,,0.0,-0.0,0.0,0.0,142473,23.12.2019 03:40:00,17798,-0.0,29.01,IS,0.23,0.0,Phase3-EA-S4v1-GBPJPY-M5-194,GBPJPYMT4,3854,5h 25m,Sell
190647.83,121087,23.12.2019 17:59:57,sl 121.087,-2.81,-62.03000000002794,0.0,0.0,122383,13.12.2019 17:30:00,17799,-0.022097549405648835,-62.03,IS,0.09,0.0,Phase3-EA-TR1v1-EURJPY-M30-91,EURJPYMT4,3100,10d 0h 29m,Sell
190751.63,121093,23.12.2019 17:59:57,tp 121.093,-2.31,-0.0,0.0,0.0,121807,16.12.2019 10:00:00,17800,-0.0,103.8,IS,0.09,0.0,Phase3-EA-TR1v1-EURJPY-M30-91,EURJPYMT4,3101,7d 7h 59m,Buy
190795.49,1.08799,24.12.2019 02:19:59,tp 1.08799,-2.09,-0.0,0.0,0.0,1.08909,23.12.2019 20:20:00,17801,-0.0,43.86,IS,0.41,0.0,Phase3-EA-SA2v2-EURCHF-M5-43,EURCHFMT4,9172,5h 59m,Sell
190798.33,0.98146,24.12.2019 03:30:00,,-0.71,-0.0,0.0,0.0,0.9814,23.12.2019 23:15:00,17802,-0.0,2.84,IS,0.58,0.0,Phase3-EA-SA2v2-USDCHF-M15-107,USDCHFMT4,3560,4h 15m,Buy
190844.24,1.08927,24.12.2019 06:44:57,tp 1.08927,0.0,-0.0,0.0,0.0,1.08817,24.12.2019 02:35:00,17803,-0.0,45.91,IS,0.41,0.0,Phase3-EA-SA2v2-EURCHF-M5-43,EURCHFMT4,9174,4h 9m,Buy
190884.39,141583,24.12.2019 07:55:00,,0.0,-0.0,0.0,0.0,141392,24.12.2019 02:30:00,17804,-0.0,40.15,IS,0.23,0.0,Phase3-EA-S4v1-GBPJPY-M5-194,GBPJPYMT4,3856,5h 25m,Buy
190897.89,1.08863,24.12.2019 11:30:00,,0.0,-0.0,0.0,0.0,1.08824,24.12.2019 02:45:00,17805,-0.0,13.5,IS,0.34,0.0,Phase3-EA-S4v1-EURCHF-M15-221,EURCHFMT4,4710,8h 45m,Buy
190956.3,0.98098,26.12.2019 08:00:00,tp 0.98098,-0.71,-0.0,0.0,0.0,0.97998,24.12.2019 22:15:00,17806,-0.0,58.41,IS,0.58,0.0,Phase3-EA-SA2v2-USDCHF-M15-107,USDCHFMT4,3562,1d 9h 45m,Buy
191001.31,1.08741,26.12.2019 08:00:00,tp 1.08741,-1.0,-0.0,0.0,0.0,1.08631,24.12.2019 22:10:00,17807,-0.0,45.01,IS,0.41,0.0,Phase3-EA-SA2v2-EURCHF-M5-43,EURCHFMT4,9176,1d 9h 50m,Buy
190964.02,121674,26.12.2019 19:59:58,sl 121.674,-1.62,-37.289999999979045,0.0,0.0,121444,20.12.2019 15:15:00,17808,-0.013270400767875029,-37.29,IS,0.17,0.0,Phase3-EA-T1v2-EURJPY-M15-322,EURJPYMT4,3534,6d 4h 44m,Sell
191001.63,1.08809,27.12.2019 02:04:57,tp 1.08809,-8.36,-0.0,0.0,0.0,1.08919,26.12.2019 20:05:00,17809,-0.0,37.61,IS,0.41,0.0,Phase3-EA-SA2v2-EURCHF-M5-43,EURCHFMT4,9178,5h 59m,Sell
191060.79,0.98045,27.12.2019 02:14:58,tp 0.98045,0.0,-0.0,0.0,0.0,0.98145,27.12.2019 01:00:00,17810,-0.0,59.16,IS,0.58,0.0,Phase3-EA-SA2v2-USDCHF-M15-107,USDCHFMT4,3564,1h 14m,Sell
191045.18,1.08989,27.12.2019 10:00:00,,0.0,-15.60999999998603,0.0,0.0,1.08944,27.12.2019 01:15:00,17811,-0.005553958629371947,-15.61,IS,0.34,0.0,Phase3-EA-S4v1-EURCHF-M15-221,EURCHFMT4,4712,8h 45m,Sell
191090.43,1.08942,30.12.2019 02:19:57,tp 1.08942,-1.01,-0.0,0.0,0.0,1.08832,27.12.2019 20:50:00,17812,-0.0,45.25,IS,0.41,0.0,Phase3-EA-SA2v2-EURCHF-M5-43,EURCHFMT4,9180,2d 5h 29m,Buy
191136.69,1.0885,30.12.2019 02:29:58,tp 1.08850,0.0,-0.0,0.0,0.0,1.0896,30.12.2019 02:25:00,17813,-0.0,46.26,IS,0.41,0.0,Phase3-EA-SA2v2-EURCHF-M5-43,EURCHFMT4,9182,4m 58s,Sell
191237.7,122386,30.12.2019 04:15:00,,-0.76,-0.0,0.0,0.0,121731,27.12.2019 03:45:00,17814,-0.0,101.01,IS,0.17,0.0,Phase3-EA-T1v2-EURJPY-M15-322,EURJPYMT4,3536,3d 0h 30m,Buy
191245.77,143.32,30.12.2019 05:15:00,,-0.76,-0.0,0.0,0.0,143278,27.12.2019 23:50:00,17815,-0.0,8.07,IS,0.23,0.0,Phase3-EA-S4v1-GBPJPY-M5-194,GBPJPYMT4,3858,2d 5h 25m,Buy
191190.24,142917,30.12.2019 12:59:58,sl 142.917,-0.3,-55.53000000002794,0.0,0.0,143587,27.12.2019 19:30:00,17816,-0.019744296954236042,-55.53,IS,0.09,0.0,Phase3-EA-B1v1-GBPJPY-M30-1,GBPJPYMT4,1584,2d 17h 29m,Buy
191207.6,0.96869,31.12.2019 05:00:00,,0.0,-38.17000000004191,0.0,0.0,0.96898,31.12.2019 00:45:00,17817,-0.01357175967483591,17.36,IS,0.58,0.0,Phase3-EA-SA2v2-USDCHF-M15-107,USDCHFMT4,3566,4h 15m,Sell
191221.83,1.08548,31.12.2019 05:50:00,,-1.02,-23.940000000060536,0.0,0.0,1.08512,30.12.2019 21:30:00,17818,-0.008512128022426946,14.23,IS,0.41,0.0,Phase3-EA-SA2v2-EURCHF-M5-43,EURCHFMT4,9184,8h 20m,Buy
191212.35,1.08476,31.12.2019 11:30:00,,0.0,-33.42000000004191,0.0,0.0,1.08503,31.12.2019 02:45:00,17819,-0.011882845384676103,-9.48,IS,0.34,0.0,Phase3-EA-S4v1-EURCHF-M15-221,EURCHFMT4,4714,8h 45m,Buy
191473.76,1.31826,31.12.2019 15:29:58,tp 1.31826,-3.19,-0.0,0.0,0.0,1.29936,26.12.2019 17:30:00,17820,-0.0,261.41,IS,0.14,0.0,Phase3-EA-B1v1-GBPUSD-M30-14,GBPUSDMT4,1190,4d 21h 59m,Buy
191532.98,0.96763,01.01.2020 00:14:57,tp 0.96763,-0.72,-0.0,0.0,0.0,0.96663,31.12.2019 22:15:00,17821,-0.0,59.22,IS,0.58,0.0,Phase3-EA-SA2v2-USDCHF-M15-107,USDCHFMT4,3568,1h 59m,Buy
191467.91,143592,02.01.2020 08:00:00,,-3.05,-65.07000000000698,0.0,0.0,143885,31.12.2019 23:25:00,17822,-0.023112745085853436,-65.07,IS,0.23,0.0,Phase3-EA-S4v1-GBPJPY-M5-194,GBPJPYMT4,3860,1d 8h 35m,Buy
191494.35,1.08627,02.01.2020 08:00:00,,-4.07,-38.63000000000466,0.0,0.0,1.08555,31.12.2019 22:20:00,17823,-0.013721305404434147,26.44,IS,0.41,0.0,Phase3-EA-SA2v2-EURCHF-M5-43,EURCHFMT4,9186,1d 9h 40m,Buy
191458.41,121.72,02.01.2020 15:44:58,sl 121.720,0.0,-74.57000000000698,0.0,0.0,121.95,02.01.2020 12:30:00,17824,-0.02648712772478972,-35.94,IS,0.17,0.0,Phase3-EA-T1v2-EURJPY-M15-322,EURJPYMT4,3538,3h 14m,Buy
191396.35,121271,02.01.2020 19:29:58,sl 121.271,-2.44,-136.63000000000466,0.0,0.0,121237,23.12.2019 18:30:00,17825,-0.048530726311355826,-62.06,IS,0.09,0.0,Phase3-EA-TR1v1-EURJPY-M30-91,EURJPYMT4,3104,10d 0h 59m,Buy
191440.65,1.08527,03.01.2020 00:14:58,tp 1.08527,-2.11,-92.3300000000163,0.0,0.0,1.08637,02.01.2020 21:30:00,17826,-0.032795447268741285,44.3,IS,0.41,0.0,Phase3-EA-SA2v2-EURCHF-M5-43,EURCHFMT4,9188,2h 44m,Sell
191440.53,108516,03.01.2020 04:15:00,,-1.12,-92.45000000001164,0.0,0.0,108.52,02.01.2020 23:00:00,17827,-0.03283807104944198,-0.12,IS,0.27,0.0,Phase3-EA-S1v2-USDJPY-M15-0,USDJPYMT4,4908,5h 15m,Sell
191452.47,0.97145,03.01.2020 04:45:00,,0.0,-80.51000000000931,0.0,0.0,0.97125,03.01.2020 00:30:00,17828,-0.028597004869557022,11.94,IS,0.58,0.0,Phase3-EA-SA2v2-USDCHF-M15-107,USDCHFMT4,3570,4h 15m,Buy
191390.76,1.08332,03.01.2020 09:15:00,,0.0,-142.22000000003027,0.0,0.0,1.08478,03.01.2020 00:55:00,17829,-0.050516284095749535,-61.71,IS,0.41,0.0,Phase3-EA-SA2v2-EURCHF-M5-43,EURCHFMT4,9190,8h 20m,Buy
191320.53,120457,03.01.2020 11:59:58,sl 120.457,-5.26,-212.45000000001164,0.0,0.0,121991,27.12.2019 13:30:00,17830,-0.07546185175179505,-70.23,IS,0.09,0.0,Phase3-EA-TR1v1-EURJPY-M30-91,EURJPYMT4,3105,6d 22h 29m,Buy
191364.8,1.08385,06.01.2020 02:00:00,tp 1.08385,-2.11,-168.17999999999302,0.0,0.0,1.08495,03.01.2020 22:35:00,17831,-0.05973722865434535,44.27,IS,0.41,0.0,Phase3-EA-SA2v2-EURCHF-M5-43,EURCHFMT4,9192,2d 3h 25m,Sell
191447.82,141462,06.01.2020 04:44:58,tp 141.462,0.0,-85.15999999997439,0.0,0.0,141072,06.01.2020 02:20:00,17832,-0.0302486763717608,83.02,IS,0.23,0.0,Phase3-EA-S4v1-GBPJPY-M5-194,GBPJPYMT4,3862,2h 24m,Buy
191391.66,142594,06.01.2020 20:29:58,sl 142.594,-0.48,-141.31999999994878,0.0,0.0,141924,03.01.2020 09:00:00,17833,-0.05019660574045294,-56.16,IS,0.09,0.0,Phase3-EA-B1v1-GBPJPY-M30-1,GBPJPYMT4,1586,3d 11h 29m,Sell
191451.52,0.96887,07.01.2020 04:44:57,tp 0.96887,0.0,-81.45999999996275,0.0,0.0,0.96787,07.01.2020 02:00:00,17834,-0.02893444313343411,59.86,IS,0.58,0.0,Phase3-EA-SA2v2-USDCHF-M15-107,USDCHFMT4,3572,2h 44m,Buy
191497.06,1.08459,07.01.2020 05:29:57,tp 1.08459,-1.02,-35.9199999999837,0.0,0.0,1.08349,06.01.2020 21:25:00,17835,-0.012758718356898563,45.54,IS,0.41,0.0,Phase3-EA-SA2v2-EURCHF-M5-43,EURCHFMT4,9194,8h 4m,Buy
191459.88,121417,07.01.2020 05:44:58,sl 121.417,-1.1,-73.09999999997672,0.0,0.0,121187,03.01.2020 05:15:00,17836,-0.025964986411175145,-37.18,IS,0.17,0.0,Phase3-EA-T1v2-EURJPY-M15-322,EURJPYMT4,3540,4d 0h 29m,Sell
191512.81,1.08513,07.01.2020 10:45:00,,0.0,-20.169999999983702,0.0,0.0,1.08362,07.01.2020 02:00:00,17837,-0.007164347139714723,52.93,IS,0.34,0.0,Phase3-EA-S4v1-EURCHF-M15-221,EURCHFMT4,4716,8h 45m,Buy
191470.81,1.31423,07.01.2020 11:59:57,sl 1.31423,0.0,-62.1699999999837,0.0,0.0,1.31723,07.01.2020 07:30:00,17838,-0.022082670385538298,-42.0,IS,0.14,0.0,Phase3-EA-B1v1-GBPUSD-M30-14,GBPUSDMT4,1192,4h 29m,Buy
191428.81,1.31568,07.01.2020 14:29:58,sl 1.31568,0.0,-104.1699999999837,0.0,0.0,1.31868,07.01.2020 12:30:00,17839,-0.037000993631361875,-42.0,IS,0.14,0.0,Phase3-EA-B1v1-GBPUSD-M30-14,GBPUSDMT4,1194,1h 59m,Buy
191373.17,142252,07.01.2020 16:29:58,sl 142.252,0.0,-159.80999999999767,0.0,0.0,142922,07.01.2020 08:30:00,17840,-0.05676421995035788,-55.64,IS,0.09,0.0,Phase3-EA-B1v1-GBPJPY-M30-1,GBPJPYMT4,1588,7h 59m,Buy
191202.66,141447,08.01.2020 03:49:58,sl 141.447,0.0,-330.320000000007,0.0,0.0,142247,08.01.2020 01:45:00,17841,-0.11732906034667971,-170.51,IS,0.23,0.0,Phase3-EA-S4v1-GBPJPY-M5-194,GBPJPYMT4,3864,2h 4m,Buy
191051.52,1.07896,08.01.2020 04:50:00,,-1.01,-481.46000000002095,0.0,0.0,1.0825,07.01.2020 20:30:00,17842,-0.17101371214129837,-151.14,IS,0.41,0.0,Phase3-EA-SA2v2-EURCHF-M5-43,EURCHFMT4,9196,8h 20m,Buy
191134.57,141934,08.01.2020 06:04:58,tp 141.934,0.0,-398.4100000000326,0.0,0.0,141544,08.01.2020 03:55:00,17843,-0.14151450391354897,83.05,IS,0.23,0.0,Phase3-EA-S4v1-GBPJPY-M5-194,GBPJPYMT4,3866,2h 9m,Buy
191199.04,108884,08.01.2020 20:30:00,,0.0,-333.94000000006054,0.0,0.0,108624,08.01.2020 20:00:00,17844,-0.11861487773121972,64.47,IS,0.27,0.0,Phase3-EA-S1v2-USDJPY-M15-0,USDJPYMT4,4910,30m 0s,Buy
191281.17,143224,09.01.2020 04:54:57,tp 143.224,0.0,-251.81000000005588,0.0,0.0,142834,09.01.2020 00:55:00,17845,-0.08944245182218258,82.13,IS,0.23,0.0,Phase3-EA-S4v1-GBPJPY-M5-194,GBPJPYMT4,3868,3h 59m,Buy
191138.43,1.08226,09.01.2020 04:55:00,,-6.32,-394.55000000004657,0.0,0.0,1.07902,08.01.2020 20:35:00,17846,-0.14014343896762824,-142.74,IS,0.41,0.0,Phase3-EA-SA2v2-EURCHF-M5-43,EURCHFMT4,9198,8h 20m,Sell
191174.53,109184,09.01.2020 05:00:00,,0.0,-358.45000000006985,0.0,0.0,109038,09.01.2020 01:00:00,17847,-0.12732078493967863,36.1,IS,0.27,0.0,Phase3-EA-S1v2-USDJPY-M15-0,USDJPYMT4,4912,4h 0m,Buy
191206.66,1.08172,09.01.2020 15:30:00,,0.0,-326.3200000000652,0.0,0.0,1.08264,09.01.2020 06:45:00,17848,-0.11590826765662195,32.13,IS,0.34,0.0,Phase3-EA-S4v1-EURCHF-M15-221,EURCHFMT4,4718,8h 45m,Sell
191192.96,0.97341,10.01.2020 05:15:00,,0.0,-340.02000000007683,0.0,0.0,0.97318,10.01.2020 01:00:00,17849,-0.12077448262014473,-13.7,IS,0.58,0.0,Phase3-EA-SA2v2-USDCHF-M15-107,USDCHFMT4,3574,4h 15m,Sell
191198.42,143039,10.01.2020 05:50:00,,0.0,-334.5600000000559,0.0,0.0,143065,10.01.2020 00:25:00,17850,-0.11883510059818021,5.46,IS,0.23,0.0,Phase3-EA-S4v1-GBPJPY-M5-194,GBPJPYMT4,3870,5h 25m,Sell
191169.77,1.08105,10.01.2020 07:35:00,,-2.11,-363.21000000007916,0.0,0.0,1.08042,09.01.2020 23:15:00,17851,-0.12901152824087528,-28.65,IS,0.41,0.0,Phase3-EA-SA2v2-EURCHF-M5-43,EURCHFMT4,9200,8h 20m,Sell
191173.26,1.08074,10.01.2020 09:45:00,,0.0,-359.7200000000885,0.0,0.0,1.08084,10.01.2020 01:00:00,17852,-0.12777188661878516,3.49,IS,0.34,0.0,Phase3-EA-S4v1-EURCHF-M15-221,EURCHFMT4,4720,8h 45m,Sell
191111.82,121806,10.01.2020 19:59:57,sl 121.806,-2.32,-421.1600000000908,0.0,0.0,121086,02.01.2020 21:00:00,17853,-0.14959526233839077,-61.44,IS,0.09,0.0,Phase3-EA-TR1v1-EURJPY-M30-91,EURJPYMT4,3107,7d 22h 59m,Sell
191156.07,1.08089,13.01.2020 02:00:00,tp 1.08089,-2.11,-376.9100000000908,0.0,0.0,1.08199,10.01.2020 22:50:00,17854,-0.13387774320439805,44.25,IS,0.41,0.0,Phase3-EA-SA2v2-EURCHF-M5-43,EURCHFMT4,9202,2d 3h 10m,Sell
191181.23,1.08163,13.01.2020 14:45:00,,0.0,-351.7500000001164,0.0,0.0,1.08235,13.01.2020 06:00:00,17855,-0.12494095718381379,25.16,IS,0.34,0.0,Phase3-EA-S4v1-EURCHF-M15-221,EURCHFMT4,4722,8h 45m,Sell
191199.9,109906,13.01.2020 19:15:00,,0.0,-333.0800000001327,0.0,0.0,109.83,13.01.2020 18:15:00,17856,-0.11830940730287849,18.67,IS,0.27,0.0,Phase3-EA-S1v2-USDJPY-M15-0,USDJPYMT4,4914,1h 0m,Buy
191244.26,1.07976,14.01.2020 02:04:57,tp 1.07976,-2.11,-288.7200000001467,0.0,0.0,1.08086,13.01.2020 20:45:00,17857,-0.10255281636991359,44.36,IS,0.41,0.0,Phase3-EA-SA2v2-EURCHF-M5-43,EURCHFMT4,9204,5h 19m,Sell
191325.71,143182,14.01.2020 04:59:57,tp 143.182,0.0,-207.27000000013504,0.0,0.0,142792,14.01.2020 01:35:00,17858,-0.0736219252181873,81.45,IS,0.23,0.0,Phase3-EA-S4v1-GBPJPY-M5-194,GBPJPYMT4,3872,3h 24m,Buy
191358.23,1.08159,14.01.2020 10:25:00,,0.0,-174.75000000011642,0.0,0.0,1.08082,14.01.2020 02:05:00,17859,-0.06207088064784301,32.52,IS,0.41,0.0,Phase3-EA-SA2v2-EURCHF-M5-43,EURCHFMT4,9206,8h 20m,Buy
191468.61,122439,14.01.2020 13:15:00,,-1.52,-64.37000000011176,0.0,0.0,121715,10.01.2020 19:15:00,17860,-0.022864106365126924,110.38,IS,0.17,0.0,Phase3-EA-T1v2-EURJPY-M15-322,EURJPYMT4,3542,3d 18h 0m,Buy
191515.22,1.07637,14.01.2020 22:39:58,tp 1.07637,0.0,-17.76000000012573,0.0,0.0,1.07747,14.01.2020 22:00:00,17861,-0.006308319543992913,46.61,IS,0.41,0.0,Phase3-EA-SA2v2-EURCHF-M5-43,EURCHFMT4,9208,39m 58s,Sell
191528.61,1.07641,15.01.2020 07:35:00,,-1.02,-4.370000000111759,0.0,0.0,1.07607,14.01.2020 23:15:00,17862,-0.0015522160139503876,13.39,IS,0.41,0.0,Phase3-EA-SA2v2-EURCHF-M5-43,EURCHFMT4,9210,8h 20m,Buy
191558.13,1.0768,15.01.2020 11:45:00,,0.0,-0.0,0.0,0.0,1.07596,15.01.2020 03:00:00,17863,-0.0,29.52,IS,0.34,0.0,Phase3-EA-S4v1-EURCHF-M15-221,EURCHFMT4,4724,8h 45m,Buy
191522.55,122469,15.01.2020 15:14:58,sl 122.469,0.0,-35.5800000000163,0.0,0.0,122239,15.01.2020 12:15:00,17864,-0.01263682210136009,-35.58,IS,0.17,0.0,Phase3-EA-T1v2-EURJPY-M15-322,EURJPYMT4,3544,2h 59m,Sell
191525.54,122523,16.01.2020 02:00:00,,-2.27,-32.59000000002561,0.0,0.0,122489,15.01.2020 15:15:00,17865,-0.011574874431800459,2.99,IS,0.17,0.0,Phase3-EA-T1v2-EURJPY-M15-322,EURJPYMT4,3546,10h 45m,Buy
191561.59,1.07554,16.01.2020 06:15:00,,-3.06,-0.0,0.0,0.0,1.07462,15.01.2020 21:55:00,17866,-0.0,36.05,IS,0.41,0.0,Phase3-EA-SA2v2-EURCHF-M5-43,EURCHFMT4,9212,8h 20m,Buy
191525.19,143442,16.01.2020 07:25:00,,0.0,-36.40000000002328,0.0,0.0,143268,16.01.2020 02:00:00,17867,-0.012927899718148046,-36.4,IS,0.23,0.0,Phase3-EA-S4v1-GBPJPY-M5-194,GBPJPYMT4,3874,5h 25m,Sell
191567.92,1.07399,16.01.2020 13:45:00,,0.0,-0.0,0.0,0.0,1.0752,16.01.2020 05:00:00,17868,-0.0,42.73,IS,0.34,0.0,Phase3-EA-S4v1-EURCHF-M15-221,EURCHFMT4,4726,8h 45m,Sell
191560.82,122614,16.01.2020 21:00:00,,0.0,-7.099999999976717,0.0,0.0,122.66,16.01.2020 04:30:00,17869,-0.0025215940793172366,-7.1,IS,0.17,0.0,Phase3-EA-T1v2-EURJPY-M15-322,EURJPYMT4,3548,16h 30m,Buy
191543.92,144056,17.01.2020 06:05:00,,0.0,-24.0,0.0,0.0,143975,17.01.2020 00:40:00,17870,-0.008523698296311569,-16.9,IS,0.23,0.0,Phase3-EA-S4v1-GBPJPY-M5-194,GBPJPYMT4,3876,5h 25m,Sell
191540.1,1.07468,17.01.2020 09:20:00,,0.0,-27.820000000006985,0.0,0.0,1.07459,17.01.2020 01:00:00,17871,-0.009880386941810308,-3.82,IS,0.41,0.0,Phase3-EA-SA2v2-EURCHF-M5-43,EURCHFMT4,9214,8h 20m,Sell
191687.93,144194,17.01.2020 10:59:58,tp 144.194,-3.24,-0.0,0.0,0.0,142344,08.01.2020 07:00:00,17872,-0.0,147.83,IS,0.09,0.0,Phase3-EA-B1v1-GBPJPY-M30-1,GBPJPYMT4,1590,9d 3h 59m,Buy
191668.56,1.07524,17.01.2020 12:30:00,,0.0,-19.369999999995343,0.0,0.0,1.07469,17.01.2020 03:45:00,17873,-0.006876403969454879,-19.37,IS,0.34,0.0,Phase3-EA-S4v1-EURCHF-M15-221,EURCHFMT4,4728,8h 45m,Sell
191655.6,122599,17.01.2020 14:00:00,,0.0,-32.3300000000163,0.0,0.0,122683,17.01.2020 02:15:00,17874,-0.011477240079124509,-12.96,IS,0.17,0.0,Phase3-EA-T1v2-EURJPY-M15-322,EURJPYMT4,3550,11h 45m,Buy
191663.05,1.07382,20.01.2020 04:45:00,,-1.02,-24.880000000004657,0.0,0.0,1.07362,17.01.2020 20:25:00,17875,-0.008832469321637094,7.45,IS,0.41,0.0,Phase3-EA-SA2v2-EURCHF-M5-43,EURCHFMT4,9216,2d 8h 20m,Buy
191674.95,143.25,20.01.2020 07:45:00,,0.0,-12.979999999981374,0.0,0.0,143193,20.01.2020 02:20:00,17876,-0.0046079361653803665,11.9,IS,0.23,0.0,Phase3-EA-S4v1-GBPJPY-M5-194,GBPJPYMT4,3878,5h 25m,Buy
191629.76,1.29724,20.01.2020 12:29:58,sl 1.29724,-3.19,-58.1699999999837,0.0,0.0,1.30024,14.01.2020 19:00:00,17877,-0.020650512075538172,-45.19,IS,0.14,0.0,Phase3-EA-B1v1-GBPUSD-M30-14,GBPUSDMT4,1196,5d 17h 29m,Buy
191635.38,1.07366,20.01.2020 13:30:00,,0.0,-52.54999999998836,0.0,0.0,1.07382,20.01.2020 04:45:00,17878,-0.018655396416874585,5.62,IS,0.34,0.0,Phase3-EA-S4v1-EURCHF-M15-221,EURCHFMT4,4730,8h 45m,Sell
191670.11,0.96855,21.01.2020 05:15:00,,0.0,-17.820000000006985,0.0,0.0,0.96797,21.01.2020 01:00:00,17879,-0.0063261496507879935,34.73,IS,0.58,0.0,Phase3-EA-SA2v2-USDCHF-M15-107,USDCHFMT4,3576,4h 15m,Buy
191652.75,143186,21.01.2020 09:10:00,,0.0,-35.179999999993015,0.0,0.0,143269,21.01.2020 03:45:00,17880,-0.012488998019898438,-17.36,IS,0.23,0.0,Phase3-EA-S4v1-GBPJPY-M5-194,GBPJPYMT4,3880,5h 25m,Buy
191672.24,1.07358,21.01.2020 11:00:00,,0.0,-15.690000000002328,0.0,0.0,1.07404,21.01.2020 02:40:00,17881,-0.005569993716096489,19.49,IS,0.41,0.0,Phase3-EA-SA2v2-EURCHF-M5-43,EURCHFMT4,9218,8h 20m,Sell
191684.19,1.07397,21.01.2020 15:00:00,,0.0,-3.7399999999906868,0.0,0.0,1.07363,21.01.2020 06:15:00,17882,-0.001327710420531925,11.95,IS,0.34,0.0,Phase3-EA-S4v1-EURCHF-M15-221,EURCHFMT4,4732,8h 45m,Buy
191621.59,121724,22.01.2020 01:59:57,sl 121.724,-3.6,-66.3399999999674,0.0,0.0,122096,13.01.2020 14:00:00,17883,-0.02355088483910801,-62.6,IS,0.09,0.0,Phase3-EA-TR1v1-EURJPY-M30-91,EURJPYMT4,3110,8d 11h 59m,Sell
191579.59,1.30674,22.01.2020 10:59:58,sl 1.30674,0.0,-108.3399999999674,0.0,0.0,1.30374,22.01.2020 08:00:00,17884,-0.03846100186116141,-42.0,IS,0.14,0.0,Phase3-EA-B1v1-GBPUSD-M30-14,GBPUSDMT4,1198,2h 59m,Sell
191616.75,1.0744,22.01.2020 11:30:00,,0.0,-71.17999999999302,0.0,0.0,1.07334,22.01.2020 02:45:00,17885,-0.025269098324515637,37.16,IS,0.34,0.0,Phase3-EA-S4v1-EURCHF-M15-221,EURCHFMT4,4734,8h 45m,Buy
191661.99,144054,23.01.2020 05:10:00,,-3.64,-25.94000000000233,0.0,0.0,144287,22.01.2020 23:45:00,17886,-0.009208772275049997,45.24,IS,0.23,0.0,Phase3-EA-S4v1-GBPJPY-M5-194,GBPJPYMT4,3882,5h 25m,Sell
191622.1,1.07312,23.01.2020 07:30:00,,-3.05,-65.8300000000163,0.0,0.0,1.07399,22.01.2020 23:10:00,17887,-0.023369833418143294,-39.89,IS,0.41,0.0,Phase3-EA-SA2v2-EURCHF-M5-43,EURCHFMT4,9220,8h 20m,Buy
191600.68,1.07309,23.01.2020 10:15:00,,0.0,-87.25,0.0,0.0,1.0737,23.01.2020 01:30:00,17888,-0.03097399309938474,-21.42,IS,0.34,0.0,Phase3-EA-S4v1-EURCHF-M15-221,EURCHFMT4,4736,8h 45m,Buy
191703.31,120806,23.01.2020 19:59:58,tp 120.806,-3.46,-0.0,0.0,0.0,122444,13.01.2020 21:30:00,17889,-0.0,102.63,IS,0.09,0.0,Phase3-EA-TR1v1-EURJPY-M30-91,EURJPYMT4,3111,9d 22h 29m,Buy
191749.82,1.07182,23.01.2020 23:04:58,tp 1.07182,0.0,-0.0,0.0,0.0,1.07072,23.01.2020 20:05:00,17890,-0.0,46.51,IS,0.41,0.0,Phase3-EA-SA2v2-EURCHF-M5-43,EURCHFMT4,9222,2h 59m,Buy
191794.25,1.07085,24.01.2020 02:04:58,tp 1.07085,-2.11,-0.0,0.0,0.0,1.07195,23.01.2020 23:10:00,17891,-0.0,44.43,IS,0.41,0.0,Phase3-EA-SA2v2-EURCHF-M5-43,EURCHFMT4,9224,2h 54m,Sell
191840.76,1.07201,24.01.2020 03:44:57,tp 1.07201,0.0,-0.0,0.0,0.0,1.07091,24.01.2020 02:05:00,17892,-0.0,46.51,IS,0.41,0.0,Phase3-EA-SA2v2-EURCHF-M5-43,EURCHFMT4,9226,1h 39m,Buy
191862.29,0.96964,24.01.2020 05:00:00,,0.0,-0.0,0.0,0.0,0.96928,24.01.2020 00:45:00,17893,-0.0,21.53,IS,0.58,0.0,Phase3-EA-SA2v2-USDCHF-M15-107,USDCHFMT4,3578,4h 15m,Buy
191827.68,143664,24.01.2020 05:00:00,,-1.22,-34.60999999998603,0.0,0.0,143505,23.01.2020 23:35:00,17894,-0.012279045912805828,-34.61,IS,0.23,0.0,Phase3-EA-S4v1-GBPJPY-M5-194,GBPJPYMT4,3884,5h 25m,Sell
191785.68,1.30984,24.01.2020 13:59:58,sl 1.30984,0.0,-76.60999999998603,0.0,0.0,1.31284,24.01.2020 10:30:00,17895,-0.027179939537135586,-42.0,IS,0.14,0.0,Phase3-EA-B1v1-GBPUSD-M30-14,GBPUSDMT4,1200,3h 29m,Buy
191888.26,120476,24.01.2020 21:29:57,tp 120.476,-1.15,-0.0,0.0,0.0,121736,22.01.2020 02:00:00,17896,-0.0,102.58,IS,0.09,0.0,Phase3-EA-TR1v1-EURJPY-M30-91,EURJPYMT4,3113,2d 19h 29m,Sell
192149.44,120456,24.01.2020 21:29:57,tp 120.456,-3.24,-0.0,0.0,0.0,122156,20.01.2020 12:15:00,17897,-0.0,261.18,IS,0.17,0.0,Phase3-EA-T1v2-EURJPY-M15-322,EURJPYMT4,3552,4d 9h 14m,Sell
192193.8,1.06983,27.01.2020 03:04:58,tp 1.06983,-2.11,-0.0,0.0,0.0,1.07093,24.01.2020 20:45:00,17898,-0.0,44.36,IS,0.41,0.0,Phase3-EA-SA2v2-EURCHF-M5-43,EURCHFMT4,9228,2d 6h 19m,Sell
192171.65,142.37,27.01.2020 07:40:00,,0.0,-22.150000000023283,0.0,0.0,142475,27.01.2020 02:15:00,17899,-0.007849215680863013,-22.15,IS,0.23,0.0,Phase3-EA-S4v1-GBPJPY-M5-194,GBPJPYMT4,3886,5h 25m,Buy
192210.17,1.07142,27.01.2020 11:45:00,,0.0,-0.0,0.0,0.0,1.07032,27.01.2020 03:00:00,17900,-0.0,38.52,IS,0.34,0.0,Phase3-EA-S4v1-EURCHF-M15-221,EURCHFMT4,4738,8h 45m,Buy
192174.27,120167,27.01.2020 17:29:58,sl 120.167,0.0,-35.90000000002328,0.0,0.0,119937,27.01.2020 13:30:00,17901,-0.012721015688422271,-35.9,IS,0.17,0.0,Phase3-EA-T1v2-EURJPY-M15-322,EURJPYMT4,3554,3h 59m,Sell
192132.27,1.30546,27.01.2020 19:59:58,sl 1.30546,0.0,-77.90000000002328,0.0,0.0,1.30846,27.01.2020 13:30:00,17902,-0.027603541006343966,-42.0,IS,0.14,0.0,Phase3-EA-B1v1-GBPUSD-M30-14,GBPUSDMT4,1202,6h 29m,Buy
192176.68,1.06743,28.01.2020 02:44:58,tp 1.06743,-2.11,-33.490000000048894,0.0,0.0,1.06853,27.01.2020 21:20:00,17903,-0.011867042211855363,44.41,IS,0.41,0.0,Phase3-EA-SA2v2-EURCHF-M5-43,EURCHFMT4,9230,5h 24m,Sell
192227.12,1.06937,28.01.2020 11:45:00,,0.0,-0.0,0.0,0.0,1.06793,28.01.2020 03:00:00,17904,-0.0,50.44,IS,0.34,0.0,Phase3-EA-S4v1-EURCHF-M15-221,EURCHFMT4,4740,8h 45m,Buy
192232.07,109164,29.01.2020 01:45:00,,0.0,-0.0,0.0,0.0,109144,29.01.2020 01:15:00,17905,-0.0,4.95,IS,0.27,0.0,Phase3-EA-S1v2-USDJPY-M15-0,USDJPYMT4,4916,30m 0s,Buy
192175.18,1.07282,29.01.2020 04:45:00,,-2.11,-56.89000000001397,0.0,0.0,1.07152,28.01.2020 20:25:00,17906,-0.020157170657471274,-56.89,IS,0.41,0.0,Phase3-EA-SA2v2-EURCHF-M5-43,EURCHFMT4,9232,8h 20m,Sell
192228.2,0.97359,29.01.2020 05:30:00,,0.0,-3.8699999999953434,0.0,0.0,0.9727,29.01.2020 01:15:00,17907,-0.001371211995856931,53.02,IS,0.58,0.0,Phase3-EA-SA2v2-USDCHF-M15-107,USDCHFMT4,3580,4h 15m,Buy
192213.03,142076,29.01.2020 06:05:00,,0.0,-19.039999999979045,0.0,0.0,142004,29.01.2020 00:40:00,17908,-0.0067462212922787205,-15.17,IS,0.23,0.0,Phase3-EA-S4v1-GBPJPY-M5-194,GBPJPYMT4,3888,5h 25m,Sell
192225.24,1.0722,29.01.2020 13:45:00,,0.0,-6.8299999999580905,0.0,0.0,1.07255,29.01.2020 05:00:00,17909,-0.002419994297585695,12.21,IS,0.34,0.0,Phase3-EA-S4v1-EURCHF-M15-221,EURCHFMT4,4742,8h 45m,Sell
192198.85,141836,30.01.2020 05:55:00,,0.0,-33.21999999997206,0.0,0.0,141961,30.01.2020 00:30:00,17910,-0.011770455426972545,-26.39,IS,0.23,0.0,Phase3-EA-S4v1-GBPJPY-M5-194,GBPJPYMT4,3890,5h 25m,Buy
192141.44,1.07115,30.01.2020 07:25:00,,-3.03,-90.62999999994645,0.0,0.0,1.07244,29.01.2020 23:05:00,17911,-0.032111871623925,-57.41,IS,0.41,0.0,Phase3-EA-SA2v2-EURCHF-M5-43,EURCHFMT4,9234,8h 20m,Buy
192111.72,1.07052,30.01.2020 11:00:00,,0.0,-120.34999999991851,0.0,0.0,1.07137,30.01.2020 02:15:00,17912,-0.04264221284275671,-29.72,IS,0.34,0.0,Phase3-EA-S4v1-EURCHF-M15-221,EURCHFMT4,4744,8h 45m,Buy
192069.72,1.29912,30.01.2020 12:29:58,sl 1.29912,0.0,-162.3499999999185,0.0,0.0,1.30212,30.01.2020 05:00:00,17913,-0.057523583340446736,-42.0,IS,0.14,0.0,Phase3-EA-B1v1-GBPUSD-M30-14,GBPUSDMT4,1204,7h 29m,Buy
192033.28,120237,31.01.2020 01:44:57,sl 120.237,-0.55,-198.78999999992084,0.0,0.0,120007,30.01.2020 01:45:00,17914,-0.07043494383891957,-36.44,IS,0.17,0.0,Phase3-EA-T1v2-EURJPY-M15-322,EURJPYMT4,3556,23h 59m,Sell
191906.55,142895,31.01.2020 05:35:00,,0.0,-325.5199999999022,0.0,0.0,142294,31.01.2020 00:10:00,17915,-0.11533770772396672,-126.73,IS,0.23,0.0,Phase3-EA-S4v1-GBPJPY-M5-194,GBPJPYMT4,3892,5h 25m,Sell
191898.1,1.07006,31.01.2020 09:05:00,,0.0,-333.96999999991385,0.0,0.0,1.06986,31.01.2020 00:45:00,17916,-0.118331697740768,-8.45,IS,0.41,0.0,Phase3-EA-SA2v2-EURCHF-M5-43,EURCHFMT4,9236,8h 20m,Sell
191883.74,1.07014,31.01.2020 09:45:00,,0.0,-348.3299999998999,0.0,0.0,1.06973,31.01.2020 01:00:00,17917,-0.1234197091775923,-14.36,IS,0.34,0.0,Phase3-EA-S4v1-EURCHF-M15-221,EURCHFMT4,4746,8h 45m,Sell
191847.76,120086,31.01.2020 19:59:58,sl 120.086,0.0,-384.30999999988126,0.0,0.0,120316,31.01.2020 16:30:00,17918,-0.1361680832372735,-35.98,IS,0.17,0.0,Phase3-EA-T1v2-EURJPY-M15-322,EURJPYMT4,3558,3h 29m,Buy
191845.46,1.06803,03.02.2020 07:10:00,,-1.02,-386.6099999998696,0.0,0.0,1.06806,31.01.2020 22:50:00,17919,-0.13698301543119049,-2.3,IS,0.41,0.0,Phase3-EA-SA2v2-EURCHF-M5-43,EURCHFMT4,9238,2d 8h 20m,Buy
191880.37,1.06751,03.02.2020 14:00:00,,0.0,-351.6999999998952,0.0,0.0,1.0685,03.02.2020 05:15:00,17920,-0.12461376200085769,34.91,IS,0.34,0.0,Phase3-EA-S4v1-EURCHF-M15-221,EURCHFMT4,4748,8h 45m,Sell
191837.31,1.2992,03.02.2020 21:29:58,sl 1.29920,-1.06,-394.7599999998929,0.0,0.0,1.3022,30.01.2020 14:30:00,17921,-0.13987070994444098,-43.06,IS,0.14,0.0,Phase3-EA-B1v1-GBPUSD-M30-14,GBPUSDMT4,1206,4d 6h 59m,Buy
191810.16,1.06899,04.02.2020 05:40:00,,-2.12,-421.9099999999162,0.0,0.0,1.0684,03.02.2020 21:20:00,17922,-0.14949045301617028,-27.15,IS,0.41,0.0,Phase3-EA-SA2v2-EURCHF-M5-43,EURCHFMT4,9240,8h 20m,Sell
191870.16,0.96667,04.02.2020 05:59:58,tp 0.96667,0.0,-361.9099999999162,0.0,0.0,0.96567,04.02.2020 02:15:00,17923,-0.1282313523051845,60.0,IS,0.58,0.0,Phase3-EA-SA2v2-USDCHF-M15-107,USDCHFMT4,3582,3h 44m,Buy
191828.16,1.29964,04.02.2020 13:29:58,sl 1.29964,0.0,-403.9099999999162,0.0,0.0,1.29664,04.02.2020 11:30:00,17924,-0.14311272280287454,-42.0,IS,0.14,0.0,Phase3-EA-B1v1-GBPUSD-M30-14,GBPUSDMT4,1208,1h 59m,Sell
191790.22,1.07001,04.02.2020 15:00:00,,0.0,-441.8499999999185,0.0,0.0,1.06893,04.02.2020 06:15:00,17925,-0.15655556081912203,-37.94,IS,0.34,0.0,Phase3-EA-S4v1-EURCHF-M15-221,EURCHFMT4,4750,8h 45m,Sell
191734.49,142104,04.02.2020 17:29:58,sl 142.104,-0.48,-497.5799999998999,0.0,0.0,141434,03.02.2020 18:30:00,17926,-0.17630172219616935,-55.73,IS,0.09,0.0,Phase3-EA-B1v1-GBPJPY-M30-1,GBPJPYMT4,1592,22h 59m,Sell
191778.93,1.06974,05.02.2020 02:04:57,tp 1.06974,-2.11,-453.13999999989755,0.0,0.0,1.07084,04.02.2020 23:55:00,17927,-0.16055581493623175,44.44,IS,0.41,0.0,Phase3-EA-SA2v2-EURCHF-M5-43,EURCHFMT4,9242,2h 9m,Sell
191716.81,121147,05.02.2020 12:59:58,sl 121.147,-2.9,-515.2599999998929,0.0,0.0,120427,24.01.2020 23:30:00,17928,-0.182566070539004,-62.12,IS,0.09,0.0,Phase3-EA-TR1v1-EURJPY-M30-91,EURJPYMT4,3116,11d 13h 29m,Sell
191740.42,109.79,05.02.2020 23:30:00,,0.0,-491.64999999990687,0.0,0.0,109694,05.02.2020 19:30:00,17929,-0.17420061440923607,23.61,IS,0.27,0.0,Phase3-EA-S1v2-USDJPY-M15-0,USDJPYMT4,4918,4h 0m,Buy
191709.5,0.97357,06.02.2020 03:15:00,,-9.47,-522.5699999998906,0.0,0.0,0.97321,05.02.2020 23:00:00,17930,-0.18515613764229163,-30.92,IS,0.58,0.0,Phase3-EA-SA2v2-USDCHF-M15-107,USDCHFMT4,3584,4h 15m,Sell
191752.79,1.07109,06.02.2020 04:34:58,tp 1.07109,-3.03,-479.2799999999115,0.0,0.0,1.06999,05.02.2020 20:45:00,17931,-0.16981769647932282,43.29,IS,0.41,0.0,Phase3-EA-SA2v2-EURCHF-M5-43,EURCHFMT4,9244,7h 49m,Buy
191837.08,120786,06.02.2020 15:00:00,,-3.04,-394.9899999999325,0.0,0.0,120222,04.02.2020 08:15:00,17932,-0.1399522031638471,84.29,IS,0.17,0.0,Phase3-EA-T1v2-EURJPY-M15-322,EURJPYMT4,3560,2d 6h 45m,Buy
191839.86,1.07009,07.02.2020 04:20:00,,-1.01,-392.20999999990454,0.0,0.0,1.07,06.02.2020 20:00:00,17933,-0.1389671981642282,2.78,IS,0.41,0.0,Phase3-EA-SA2v2-EURCHF-M5-43,EURCHFMT4,9246,8h 20m,Buy
191838.81,1.06996,07.02.2020 11:30:00,,0.0,-393.2599999998929,0.0,0.0,1.06999,07.02.2020 02:45:00,17934,-0.13933923242666632,-1.05,IS,0.34,0.0,Phase3-EA-S4v1-EURCHF-M15-221,EURCHFMT4,4752,8h 45m,Buy
191883.93,1.0709,10.02.2020 06:34:58,tp 1.07090,-1.01,-348.13999999989755,0.0,0.0,1.0698,07.02.2020 22:45:00,17935,-0.1233523886920067,45.12,IS,0.41,0.0,Phase3-EA-SA2v2-EURCHF-M5-43,EURCHFMT4,9248,2d 7h 49m,Buy
191841.93,1.29042,10.02.2020 13:29:58,sl 1.29042,0.0,-390.13999999989755,0.0,0.0,1.28742,10.02.2020 12:00:00,17936,-0.13823375918969671,-42.0,IS,0.14,0.0,Phase3-EA-B1v1-GBPUSD-M30-14,GBPUSDMT4,1210,1h 29m,Sell
191831.84,1.07043,10.02.2020 14:45:00,,0.0,-400.22999999992317,0.0,0.0,1.07014,10.02.2020 06:00:00,17937,-0.14180883129260322,-10.09,IS,0.34,0.0,Phase3-EA-S4v1-EURCHF-M15-221,EURCHFMT4,4754,8h 45m,Sell
191776.92,142007,10.02.2020 15:59:57,sl 142.007,0.0,-455.14999999990687,0.0,0.0,141337,10.02.2020 02:00:00,17938,-0.16126799481005308,-54.92,IS,0.09,0.0,Phase3-EA-B1v1-GBPJPY-M30-1,GBPJPYMT4,1594,13h 59m,Sell
191823.68,0.97748,11.02.2020 03:45:00,,-0.71,-408.38999999989755,0.0,0.0,0.97668,10.02.2020 23:30:00,17939,-0.14470006898928822,46.76,IS,0.58,0.0,Phase3-EA-SA2v2-USDCHF-M15-107,USDCHFMT4,3586,4h 15m,Buy
191774.44,1.06622,11.02.2020 04:20:00,,-1.01,-457.62999999988824,0.0,0.0,1.06737,10.02.2020 20:00:00,17940,-0.16214670430610056,-49.24,IS,0.41,0.0,Phase3-EA-SA2v2-EURCHF-M5-43,EURCHFMT4,9250,8h 20m,Buy
191746.96,1.06503,12.02.2020 05:05:00,,-1.01,-485.1099999998696,0.0,0.0,1.06566,11.02.2020 20:45:00,17941,-0.17188337243172544,-27.48,IS,0.41,0.0,Phase3-EA-SA2v2-EURCHF-M5-43,EURCHFMT4,9252,8h 20m,Buy
191734.19,142332,12.02.2020 08:50:00,,0.0,-497.87999999988824,0.0,0.0,142271,12.02.2020 03:25:00,17942,-0.17640801769972017,-12.77,IS,0.23,0.0,Phase3-EA-S4v1-GBPJPY-M5-194,GBPJPYMT4,3894,5h 25m,Sell
191699.64,1.06395,12.02.2020 14:30:00,,0.0,-532.4299999998766,0.0,0.0,1.06494,12.02.2020 05:45:00,17943,-0.188649716525792,-34.55,IS,0.34,0.0,Phase3-EA-S4v1-EURCHF-M15-221,EURCHFMT4,4756,8h 45m,Buy
191686.65,0.97787,13.02.2020 02:15:00,,-9.43,-545.4199999998673,0.0,0.0,0.97781,12.02.2020 22:00:00,17944,-0.1932523118297171,-12.99,IS,0.58,0.0,Phase3-EA-SA2v2-USDCHF-M15-107,USDCHFMT4,3588,4h 15m,Sell
191682.79,1.0635,13.02.2020 05:40:00,,-3.02,-549.2799999998533,0.0,0.0,1.06352,12.02.2020 21:20:00,17945,-0.1946199806421189,-3.86,IS,0.41,0.0,Phase3-EA-SA2v2-EURCHF-M5-43,EURCHFMT4,9254,8h 20m,Buy
191784.39,118.92,13.02.2020 19:29:58,tp 118.920,-1.73,-447.6799999998766,0.0,0.0,120.18,07.02.2020 14:30:00,17946,-0.15862123677152462,101.6,IS,0.09,0.0,Phase3-EA-TR1v1-EURJPY-M30-91,EURJPYMT4,3118,6d 4h 59m,Sell
192044.6,118995,13.02.2020 19:29:58,tp 118.995,-3.24,-187.46999999985565,0.0,0.0,120695,07.02.2020 08:15:00,17947,-0.06642406017142383,260.21,IS,0.17,0.0,Phase3-EA-T1v2-EURJPY-M15-322,EURJPYMT4,3562,6d 11h 14m,Sell
192017.95,0.97954,14.02.2020 05:00:00,,0.0,-214.11999999987893,0.0,0.0,0.97909,14.02.2020 00:45:00,17948,-0.07586664407056158,-26.65,IS,0.58,0.0,Phase3-EA-SA2v2-USDCHF-M15-107,USDCHFMT4,3590,4h 15m,Sell
192047.08,1.06175,14.02.2020 06:50:00,,-1.0,-184.98999999987427,0.0,0.0,1.06103,13.02.2020 22:30:00,17949,-0.06554535067537635,29.13,IS,0.41,0.0,Phase3-EA-SA2v2-EURCHF-M5-43,EURCHFMT4,9256,8h 20m,Buy
192080.04,1.06208,14.02.2020 11:30:00,,0.0,-152.02999999985332,0.0,0.0,1.06113,14.02.2020 02:45:00,17950,-0.05386701801813409,32.96,IS,0.34,0.0,Phase3-EA-S4v1-EURCHF-M15-221,EURCHFMT4,4758,8h 45m,Buy
192123.87,1.06334,17.02.2020 02:00:00,tp 1.06334,-2.09,-108.19999999983702,0.0,0.0,1.06444,14.02.2020 20:00:00,17951,-0.03833724494875322,43.83,IS,0.41,0.0,Phase3-EA-SA2v2-EURCHF-M5-43,EURCHFMT4,9258,2d 6h 0m,Sell
192161.15,143268,17.02.2020 07:40:00,,0.0,-70.91999999980908,0.0,0.0,143.09,17.02.2020 02:15:00,17952,-0.02512825704031751,37.28,IS,0.23,0.0,Phase3-EA-S4v1-GBPJPY-M5-194,GBPJPYMT4,3896,5h 25m,Buy
192203.73,1.06426,17.02.2020 10:45:00,,0.0,-28.33999999979278,0.0,0.0,1.06303,17.02.2020 02:00:00,17953,-0.010041381902415514,42.58,IS,0.34,0.0,Phase3-EA-S4v1-EURCHF-M15-221,EURCHFMT4,4760,8h 45m,Buy
192194.91,119081,17.02.2020 19:30:00,,0.0,-37.159999999799766,0.0,0.0,119138,17.02.2020 19:00:00,17954,-0.013166469706932894,-8.82,IS,0.17,0.0,Phase3-EA-T1v2-EURJPY-M15-322,EURJPYMT4,3564,30m 0s,Buy
192165.49,1.06249,18.02.2020 04:25:00,,-1.0,-66.57999999978347,0.0,0.0,1.06317,17.02.2020 20:05:00,17955,-0.0235905154222138,-29.42,IS,0.41,0.0,Phase3-EA-SA2v2-EURCHF-M5-43,EURCHFMT4,9260,8h 20m,Buy
192174.36,0.98073,18.02.2020 06:45:00,,0.0,-57.709999999788124,0.0,0.0,0.98058,18.02.2020 02:30:00,17956,-0.02044771170044139,8.87,IS,0.58,0.0,Phase3-EA-SA2v2-USDCHF-M15-107,USDCHFMT4,3592,4h 15m,Buy
192117.54,142592,18.02.2020 06:45:00,,0.0,-114.52999999979511,0.0,0.0,142863,18.02.2020 01:20:00,17957,-0.040580080073747374,-56.82,IS,0.23,0.0,Phase3-EA-S4v1-GBPJPY-M5-194,GBPJPYMT4,3898,5h 25m,Buy
192097.77,1.06193,18.02.2020 09:45:00,,0.0,-134.29999999981374,0.0,0.0,1.0625,18.02.2020 01:00:00,17958,-0.047584953758023775,-19.77,IS,0.34,0.0,Phase3-EA-S4v1-EURCHF-M15-221,EURCHFMT4,4762,8h 45m,Buy
192101.31,0.98299,19.02.2020 05:00:00,,0.0,-130.7599999998347,0.0,0.0,0.98305,19.02.2020 00:45:00,17959,-0.04633066681608304,3.54,IS,0.58,0.0,Phase3-EA-SA2v2-USDCHF-M15-107,USDCHFMT4,3594,4h 15m,Sell
192110.74,1.06145,19.02.2020 05:05:00,,-1.0,-121.32999999984168,0.0,0.0,1.0612,18.02.2020 20:45:00,17960,-0.04298944482100892,9.43,IS,0.41,0.0,Phase3-EA-SA2v2-EURCHF-M5-43,EURCHFMT4,9262,8h 20m,Buy
192072.7,1.06241,19.02.2020 12:45:00,,0.0,-159.36999999982072,0.0,0.0,1.06131,19.02.2020 04:00:00,17961,-0.056467714671766464,-38.04,IS,0.34,0.0,Phase3-EA-S4v1-EURCHF-M15-221,EURCHFMT4,4764,8h 45m,Sell
192017.52,143.48,19.02.2020 13:59:57,sl 143.480,-0.48,-214.54999999981374,0.0,0.0,142.81,18.02.2020 03:30:00,17962,-0.07601900095896721,-55.18,IS,0.09,0.0,Phase3-EA-B1v1-GBPJPY-M30-1,GBPJPYMT4,1596,1d 10h 29m,Sell
191958.63,119482,19.02.2020 17:59:58,sl 119.482,-0.29,-273.4399999998277,0.0,0.0,119.12,13.02.2020 20:00:00,17963,-0.09688480830680468,-58.89,IS,0.09,0.0,Phase3-EA-TR1v1-EURJPY-M30-91,EURJPYMT4,3120,5d 21h 59m,Buy
192004.46,1.06234,19.02.2020 22:54:58,tp 1.06234,0.0,-227.6099999998114,0.0,0.0,1.06124,19.02.2020 20:15:00,17964,-0.08064639854705763,45.83,IS,0.41,0.0,Phase3-EA-SA2v2-EURCHF-M5-43,EURCHFMT4,9264,2h 39m,Buy
192107.07,120.41,19.02.2020 23:59:58,tp 120.410,-1.6,-124.99999999982538,0.0,0.0,118762,18.02.2020 07:00:00,17965,-0.04428979314782511,102.61,IS,0.09,0.0,Phase3-EA-TR1v1-EURJPY-M30-91,EURJPYMT4,3121,1d 16h 59m,Sell
192142.81,143645,20.02.2020 04:25:00,,-3.59,-89.25999999983469,0.0,0.0,143835,19.02.2020 23:00:00,17966,-0.03162645549098456,35.74,IS,0.23,0.0,Phase3-EA-S4v1-GBPJPY-M5-194,GBPJPYMT4,3900,5h 25m,Sell
192182.44,1.06134,20.02.2020 06:24:57,tp 1.06134,-6.25,-49.629999999830034,0.0,0.0,1.06244,19.02.2020 23:00:00,17967,-0.017584819471376825,39.63,IS,0.41,0.0,Phase3-EA-SA2v2-EURCHF-M5-43,EURCHFMT4,9266,7h 24m,Sell
192184.62,111337,20.02.2020 07:00:00,,0.0,-47.44999999983702,0.0,0.0,111328,20.02.2020 01:30:00,17968,-0.01681240547888015,2.18,IS,0.27,0.0,Phase3-EA-S1v2-USDJPY-M15-0,USDJPYMT4,4920,5h 30m,Buy
192222.64,1.06163,20.02.2020 10:45:00,,0.0,-9.429999999818392,0.0,0.0,1.06273,20.02.2020 02:00:00,17969,-0.0033412219950122468,38.02,IS,0.34,0.0,Phase3-EA-S4v1-EURCHF-M15-221,EURCHFMT4,4766,8h 45m,Sell
192322.89,120814,20.02.2020 13:59:58,tp 120.814,-1.19,-0.0,0.0,0.0,119554,19.02.2020 19:00:00,17970,-0.0,100.25,IS,0.09,0.0,Phase3-EA-TR1v1-EURJPY-M30-91,EURJPYMT4,3123,18h 59m,Buy
192371.05,112129,20.02.2020 18:45:00,,0.0,-0.0,0.0,0.0,111929,20.02.2020 17:45:00,17971,-0.0,48.16,IS,0.27,0.0,Phase3-EA-S1v2-USDJPY-M15-0,USDJPYMT4,4922,1h 0m,Buy
192385.26,112092,20.02.2020 20:00:00,,0.0,-0.0,0.0,0.0,112033,20.02.2020 19:30:00,17972,-0.0,14.21,IS,0.27,0.0,Phase3-EA-S1v2-USDJPY-M15-0,USDJPYMT4,4924,30m 0s,Buy
192479.64,120898,20.02.2020 23:15:00,,0.0,-0.0,0.0,0.0,120276,20.02.2020 08:15:00,17973,-0.0,94.38,IS,0.17,0.0,Phase3-EA-T1v2-EURJPY-M15-322,EURJPYMT4,3566,15h 0m,Buy
192479.89,1.06135,21.02.2020 04:20:00,,-1.0,-0.0,0.0,0.0,1.06132,20.02.2020 20:00:00,17974,-0.0,0.25,IS,0.41,0.0,Phase3-EA-SA2v2-EURCHF-M5-43,EURCHFMT4,9268,8h 20m,Buy
192444.09,120701,24.02.2020 02:00:00,sl 120.701,-0.75,-35.79999999998836,0.0,0.0,120931,21.02.2020 16:15:00,17975,-0.012673468543190179,-35.8,IS,0.17,0.0,Phase3-EA-T1v2-EURJPY-M15-322,EURJPYMT4,3568,2d 9h 45m,Buy
192488.1,1.06102,24.02.2020 02:00:00,tp 1.06102,-2.1,-0.0,0.0,0.0,1.06212,21.02.2020 20:20:00,17976,-0.0,44.01,IS,0.41,0.0,Phase3-EA-SA2v2-EURCHF-M5-43,EURCHFMT4,9270,2d 5h 40m,Sell
192498.0,144321,24.02.2020 07:35:00,,0.0,-0.0,0.0,0.0,144273,24.02.2020 02:10:00,17977,-0.0,9.9,IS,0.23,0.0,Phase3-EA-S4v1-GBPJPY-M5-194,GBPJPYMT4,3902,5h 25m,Buy
192500.93,1.06068,24.02.2020 10:45:00,,0.0,-0.0,0.0,0.0,1.06061,24.02.2020 02:25:00,17978,-0.0,2.93,IS,0.41,0.0,Phase3-EA-SA2v2-EURCHF-M5-43,EURCHFMT4,9272,8h 20m,Buy
192509.6,1.06096,24.02.2020 12:00:00,,0.0,-0.0,0.0,0.0,1.06071,24.02.2020 03:15:00,17979,-0.0,8.67,IS,0.34,0.0,Phase3-EA-S4v1-EURCHF-M15-221,EURCHFMT4,4768,8h 45m,Buy
192450.58,120329,24.02.2020 15:29:57,sl 120.329,-0.79,-59.02000000001863,0.0,0.0,121049,20.02.2020 15:00:00,17980,-0.02089132546292883,-59.02,IS,0.09,0.0,Phase3-EA-TR1v1-EURJPY-M30-91,EURJPYMT4,3126,4d 0h 29m,Buy
192532.51,111064,24.02.2020 18:15:00,,0.0,-0.0,0.0,0.0,111401,24.02.2020 17:15:00,17981,-0.0,81.93,IS,0.27,0.0,Phase3-EA-S1v2-USDJPY-M15-0,USDJPYMT4,4926,1h 0m,Sell
192476.72,143158,24.02.2020 18:59:58,sl 143.158,-1.45,-55.789999999979045,0.0,0.0,143828,19.02.2020 20:30:00,17982,-0.019746400157623925,-55.79,IS,0.09,0.0,Phase3-EA-B1v1-GBPJPY-M30-1,GBPJPYMT4,1598,4d 22h 29m,Buy
192404.74,1.06319,25.02.2020 04:20:00,,-2.09,-127.76999999996042,0.0,0.0,1.06152,24.02.2020 20:00:00,17983,-0.04522311432406838,-71.98,IS,0.41,0.0,Phase3-EA-SA2v2-EURCHF-M5-43,EURCHFMT4,9274,8h 20m,Sell
192382.24,0.97942,25.02.2020 04:30:00,,0.0,-150.26999999996042,0.0,0.0,0.97904,25.02.2020 00:15:00,17984,-0.05318679963589317,-22.5,IS,0.58,0.0,Phase3-EA-SA2v2-USDCHF-M15-107,USDCHFMT4,3596,4h 15m,Sell
192346.3,110806,25.02.2020 09:45:00,,-1.1,-186.20999999996275,0.0,0.0,110663,24.02.2020 23:45:00,17985,-0.0659074596406488,-35.94,IS,0.27,0.0,Phase3-EA-S1v2-USDJPY-M15-0,USDJPYMT4,4928,10h 0m,Sell
192403.02,1.06117,25.02.2020 13:15:00,,0.0,-129.4899999999907,0.0,0.0,1.0628,25.02.2020 04:30:00,17986,-0.04583189382347192,56.72,IS,0.34,0.0,Phase3-EA-S4v1-EURCHF-M15-221,EURCHFMT4,4770,8h 45m,Sell
192500.96,110271,25.02.2020 19:29:58,tp 110.271,0.0,-31.54999999998836,0.0,0.0,110671,25.02.2020 17:00:00,17987,-0.011166856515021311,97.94,IS,0.27,0.0,Phase3-EA-S1v2-USDJPY-M15-0,USDJPYMT4,4930,2h 29m,Sell
192461.92,1.06161,26.02.2020 04:25:00,,-2.1,-70.5899999999674,0.0,0.0,1.06073,25.02.2020 20:05:00,17988,-0.024984735384953445,-39.04,IS,0.41,0.0,Phase3-EA-SA2v2-EURCHF-M5-43,EURCHFMT4,9276,8h 20m,Sell
192441.72,143444,26.02.2020 09:05:00,,0.0,-90.78999999997905,0.0,0.0,143347,26.02.2020 03:40:00,17989,-0.032134355087129154,-20.2,IS,0.23,0.0,Phase3-EA-S4v1-GBPJPY-M5-194,GBPJPYMT4,3904,5h 25m,Sell
192440.68,1.06199,26.02.2020 10:00:00,,0.0,-91.82999999995809,0.0,0.0,1.06196,26.02.2020 01:15:00,17990,-0.03250245431931275,-1.04,IS,0.34,0.0,Phase3-EA-S4v1-EURCHF-M15-221,EURCHFMT4,4772,8h 45m,Sell
192376.33,110348,26.02.2020 12:45:00,,0.0,-156.1799999999348,0.0,0.0,110085,26.02.2020 00:15:00,17991,-0.05527859431112342,-64.35,IS,0.27,0.0,Phase3-EA-S1v2-USDJPY-M15-0,USDJPYMT4,4932,12h 30m,Sell
192340.94,119989,26.02.2020 22:44:58,sl 119.989,0.0,-191.56999999994878,0.0,0.0,120219,26.02.2020 18:45:00,17992,-0.06780458645270522,-35.39,IS,0.17,0.0,Phase3-EA-T1v2-EURJPY-M15-322,EURJPYMT4,3570,3h 59m,Buy
192291.74,1.0632,27.02.2020 04:25:00,,-6.31,-240.76999999996042,0.0,0.0,1.06218,26.02.2020 20:05:00,17993,-0.08521851166789955,-49.2,IS,0.41,0.0,Phase3-EA-SA2v2-EURCHF-M5-43,EURCHFMT4,9278,8h 20m,Sell
192210.23,0.97481,27.02.2020 04:30:00,,0.0,-322.27999999996973,0.0,0.0,0.97618,27.02.2020 00:15:00,17994,-0.11406828899087347,-81.51,IS,0.58,0.0,Phase3-EA-SA2v2-USDCHF-M15-107,USDCHFMT4,3598,4h 15m,Buy
192182.42,120034,27.02.2020 10:00:00,,0.0,-350.0899999999674,0.0,0.0,120214,27.02.2020 01:00:00,17995,-0.12391140403628809,-27.81,IS,0.17,0.0,Phase3-EA-T1v2-EURJPY-M15-322,EURJPYMT4,3572,9h 0m,Buy
192140.42,1.29088,27.02.2020 13:59:58,sl 1.29088,0.0,-392.0899999999674,0.0,0.0,1.29388,27.02.2020 12:30:00,17996,-0.13877694995169437,-42.0,IS,0.14,0.0,Phase3-EA-B1v1-GBPUSD-M30-14,GBPUSDMT4,1212,1h 29m,Buy
192071.4,110193,27.02.2020 14:15:00,,-2.13,-461.10999999998603,0.0,0.0,110466,26.02.2020 20:15:00,17997,-0.16320599707268527,-69.02,IS,0.27,0.0,Phase3-EA-S1v2-USDJPY-M15-0,USDJPYMT4,4934,18h 0m,Buy
192073.85,1.0626,27.02.2020 14:30:00,,0.0,-458.6599999999744,0.0,0.0,1.06253,27.02.2020 05:45:00,17998,-0.1623388402276158,2.45,IS,0.34,0.0,Phase3-EA-S4v1-EURCHF-M15-221,EURCHFMT4,4774,8h 45m,Buy
192118.3,1.06535,28.02.2020 01:19:57,tp 1.06535,-2.11,-414.20999999996275,0.0,0.0,1.06645,27.02.2020 21:05:00,17999,-0.14660613746714002,44.45,IS,0.41,0.0,Phase3-EA-SA2v2-EURCHF-M5-43,EURCHFMT4,9280,4h 14m,Sell
192156.81,120.49,28.02.2020 02:45:00,,-0.76,-375.69999999995343,0.0,0.0,120237,27.02.2020 12:15:00,18000,-0.13297584762898684,38.51,IS,0.17,0.0,Phase3-EA-T1v2-EURJPY-M15-322,EURJPYMT4,3574,14h 30m,Buy
192061.53,0.96792,28.02.2020 05:15:00,,0.0,-470.9799999999814,0.0,0.0,0.96951,28.02.2020 01:00:00,18001,-0.16669940036280412,-95.28,IS,0.58,0.0,Phase3-EA-SA2v2-USDCHF-M15-107,USDCHFMT4,3600,4h 15m,Buy
191947.46,140818,28.02.2020 06:55:00,,0.0,-585.0499999999884,0.0,0.0,141.36,28.02.2020 01:30:00,18002,-0.20707351518591122,-114.07,IS,0.23,0.0,Phase3-EA-S4v1-GBPJPY-M5-194,GBPJPYMT4,3906,5h 25m,Buy
192099.64,140388,28.02.2020 07:59:57,tp 140.388,-0.47,-432.86999999999534,0.0,0.0,142238,27.02.2020 10:30:00,18003,-0.15321068715242492,152.18,IS,0.09,0.0,Phase3-EA-B1v1-GBPJPY-M30-1,GBPJPYMT4,1600,21h 29m,Sell
192030.12,1.06384,28.02.2020 09:40:00,,0.0,-502.39000000001397,0.0,0.0,1.06548,28.02.2020 01:20:00,18004,-0.17781670505812305,-69.52,IS,0.41,0.0,Phase3-EA-SA2v2-EURCHF-M5-43,EURCHFMT4,9282,8h 20m,Buy
192011.84,1.06422,28.02.2020 11:00:00,,0.0,-520.6700000000419,0.0,0.0,1.06474,28.02.2020 02:15:00,18005,-0.1842867569470288,-18.28,IS,0.34,0.0,Phase3-EA-S4v1-EURCHF-M15-221,EURCHFMT4,4776,8h 45m,Buy
192114.45,119163,28.02.2020 17:59:57,tp 119.163,-1.72,-418.0600000000559,0.0,0.0,120423,24.02.2020 15:30:00,18006,-0.14796881250941857,102.61,IS,0.09,0.0,Phase3-EA-TR1v1-EURJPY-M30-91,EURJPYMT4,3128,4d 2h 29m,Sell
192143.09,108418,28.02.2020 19:00:00,,0.0,-389.4200000000419,0.0,0.0,108533,28.02.2020 18:45:00,18007,-0.1378319259613842,28.64,IS,0.27,0.0,Phase3-EA-S1v2-USDJPY-M15-0,USDJPYMT4,4936,15m 0s,Sell
192297.01,138163,28.02.2020 19:59:58,tp 138.163,0.0,-235.5000000000582,0.0,0.0,140013,28.02.2020 12:00:00,18008,-0.0833532395971201,153.92,IS,0.09,0.0,Phase3-EA-B1v1-GBPJPY-M30-1,GBPJPYMT4,1602,7h 59m,Sell
192396.27,107576,02.03.2020 02:00:00,tp 107.576,-1.13,-136.2400000000489,0.0,0.0,107976,28.02.2020 23:45:00,18009,-0.04822099941703996,99.26,IS,0.27,0.0,Phase3-EA-S1v2-USDJPY-M15-0,USDJPYMT4,4938,2d 2h 15m,Sell
192440.87,1.06249,02.03.2020 02:00:00,tp 1.06249,-2.12,-91.64000000007218,0.0,0.0,1.06359,28.02.2020 20:15:00,18010,-0.03243520542116439,44.6,IS,0.41,0.0,Phase3-EA-SA2v2-EURCHF-M5-43,EURCHFMT4,9284,2d 5h 45m,Sell
192384.86,138099,02.03.2020 04:29:57,sl 138.099,0.0,-147.6500000000815,0.0,0.0,137429,02.03.2020 03:00:00,18011,-0.0522594727240702,-56.01,IS,0.09,0.0,Phase3-EA-B1v1-GBPJPY-M30-1,GBPJPYMT4,1604,1h 29m,Sell
192468.12,138184,02.03.2020 05:34:58,tp 138.184,0.0,-64.39000000007218,0.0,0.0,137794,02.03.2020 02:15:00,18012,-0.022790297654621032,83.26,IS,0.23,0.0,Phase3-EA-S4v1-GBPJPY-M5-194,GBPJPYMT4,3908,3h 19m,Buy
192426.12,1.28203,02.03.2020 11:59:58,sl 1.28203,0.0,-106.39000000007218,0.0,0.0,1.28503,02.03.2020 10:30:00,18013,-0.03765584357002731,-42.0,IS,0.14,0.0,Phase3-EA-B1v1-GBPUSD-M30-14,GBPUSDMT4,1214,1h 29m,Buy
192366.0,119946,02.03.2020 11:59:58,sl 119.946,-0.29,-166.51000000006752,0.0,0.0,119226,28.02.2020 18:00:00,18014,-0.05893481072322151,-60.12,IS,0.09,0.0,Phase3-EA-TR1v1-EURJPY-M30-91,EURJPYMT4,3130,2d 17h 59m,Sell
192310.4,138445,02.03.2020 12:29:57,sl 138.445,0.0,-222.11000000004424,0.0,0.0,139115,02.03.2020 10:30:00,18015,-0.07861396198265587,-55.6,IS,0.09,0.0,Phase3-EA-B1v1-GBPJPY-M30-1,GBPJPYMT4,1606,1h 59m,Buy
192368.39,107562,02.03.2020 19:00:00,,0.0,-164.12000000005355,0.0,0.0,107793,02.03.2020 18:30:00,18016,-0.058088890372316064,57.99,IS,0.27,0.0,Phase3-EA-S1v2-USDJPY-M15-0,USDJPYMT4,4940,30m 0s,Sell
192455.46,107.91,02.03.2020 20:00:00,,0.0,-77.05000000004657,0.0,0.0,107562,02.03.2020 19:00:00,18017,-0.027271197923398716,87.07,IS,0.27,0.0,Phase3-EA-S1v2-USDJPY-M15-0,USDJPYMT4,4942,1h 0m,Buy
192515.29,0.9578,03.03.2020 00:29:58,tp 0.95780,-0.73,-17.220000000030268,0.0,0.0,0.9568,02.03.2020 22:45:00,18018,-0.006094873825327287,59.83,IS,0.58,0.0,Phase3-EA-SA2v2-USDCHF-M15-107,USDCHFMT4,3602,1h 44m,Buy
192598.14,138021,03.03.2020 02:04:58,tp 138.021,0.0,-0.0,0.0,0.0,138411,03.03.2020 01:00:00,18019,-0.0,82.85,IS,0.23,0.0,Phase3-EA-S4v1-GBPJPY-M5-194,GBPJPYMT4,3910,1h 4m,Sell
192643.0,1.06736,03.03.2020 02:04:58,tp 1.06736,-2.14,-0.0,0.0,0.0,1.06846,02.03.2020 20:25:00,18020,-0.0,44.86,IS,0.41,0.0,Phase3-EA-SA2v2-EURCHF-M5-43,EURCHFMT4,9286,5h 39m,Sell
192703.59,0.95718,03.03.2020 03:14:57,tp 0.95718,0.0,-0.0,0.0,0.0,0.95818,03.03.2020 00:30:00,18021,-0.0,60.59,IS,0.58,0.0,Phase3-EA-SA2v2-USDCHF-M15-107,USDCHFMT4,3604,2h 44m,Sell
192778.41,120265,03.03.2020 07:00:00,,-0.77,-0.0,0.0,0.0,119785,02.03.2020 17:00:00,18022,-0.0,74.82,IS,0.17,0.0,Phase3-EA-T1v2-EURJPY-M15-322,EURJPYMT4,3576,14h 0m,Buy
192809.22,1.06793,03.03.2020 10:30:00,,0.0,-0.0,0.0,0.0,1.06721,03.03.2020 02:10:00,18023,-0.0,30.81,IS,0.41,0.0,Phase3-EA-SA2v2-EURCHF-M5-43,EURCHFMT4,9288,8h 20m,Buy
192764.53,1.06604,03.03.2020 12:00:00,,0.0,-44.69000000000233,0.0,0.0,1.0673,03.03.2020 03:15:00,18024,-0.015802172220552836,-44.69,IS,0.34,0.0,Phase3-EA-S4v1-EURCHF-M15-221,EURCHFMT4,4778,8h 45m,Buy
192848.12,137.43,03.03.2020 23:59:58,tp 137.430,0.0,-0.0,0.0,0.0,137.04,03.03.2020 23:00:00,18025,-0.0,83.59,IS,0.23,0.0,Phase3-EA-S4v1-GBPJPY-M5-194,GBPJPYMT4,3912,59m 58s,Buy
192893.14,1.06823,04.03.2020 00:59:57,tp 1.06823,-2.14,-0.0,0.0,0.0,1.06933,03.03.2020 22:35:00,18026,-0.0,45.02,IS,0.41,0.0,Phase3-EA-SA2v2-EURCHF-M5-43,EURCHFMT4,9290,2h 24m,Sell
192953.78,0.95646,04.03.2020 01:59:58,tp 0.95646,0.0,-0.0,0.0,0.0,0.95546,04.03.2020 01:15:00,18027,-0.0,60.64,IS,0.58,0.0,Phase3-EA-SA2v2-USDCHF-M15-107,USDCHFMT4,3606,44m 58s,Buy
193003.44,107101,04.03.2020 02:15:00,,0.0,-0.0,0.0,0.0,107298,04.03.2020 00:30:00,18028,-0.0,49.66,IS,0.27,0.0,Phase3-EA-S1v2-USDJPY-M15-0,USDJPYMT4,4944,1h 45m,Sell
192984.16,1.06782,04.03.2020 09:45:00,,0.0,-19.28000000002794,0.0,0.0,1.06827,04.03.2020 01:25:00,18029,-0.006812638037201196,-19.28,IS,0.41,0.0,Phase3-EA-SA2v2-EURCHF-M5-43,EURCHFMT4,9292,8h 20m,Buy
193091.92,119111,04.03.2020 18:59:58,tp 119.111,-0.29,-0.0,0.0,0.0,120401,03.03.2020 05:30:00,18030,-0.0,107.76,IS,0.09,0.0,Phase3-EA-TR1v1-EURJPY-M30-91,EURJPYMT4,3132,1d 13h 29m,Sell
193132.65,1.06431,05.03.2020 02:04:57,tp 1.06431,-6.43,-0.0,0.0,0.0,1.06541,04.03.2020 23:20:00,18031,-0.0,40.73,IS,0.41,0.0,Phase3-EA-SA2v2-EURCHF-M5-43,EURCHFMT4,9294,2h 44m,Sell
193179.79,1.06571,05.03.2020 03:49:57,tp 1.06571,0.0,-0.0,0.0,0.0,1.06461,05.03.2020 02:50:00,18032,-0.0,47.14,IS,0.41,0.0,Phase3-EA-SA2v2-EURCHF-M5-43,EURCHFMT4,9296,59m 57s,Buy
193211.4,106767,05.03.2020 19:45:00,,0.0,-0.0,0.0,0.0,106892,05.03.2020 19:15:00,18033,-0.0,31.61,IS,0.27,0.0,Phase3-EA-S1v2-USDJPY-M15-0,USDJPYMT4,4946,30m 0s,Sell
193237.47,106662,05.03.2020 20:00:00,,0.0,-0.0,0.0,0.0,106765,05.03.2020 19:45:00,18034,-0.0,26.07,IS,0.27,0.0,Phase3-EA-S1v2-USDJPY-M15-0,USDJPYMT4,4948,15m 0s,Sell
193180.94,137792,05.03.2020 20:29:57,sl 137.792,0.0,-56.53000000002794,0.0,0.0,138462,05.03.2020 03:30:00,18035,-0.01995851749418173,-56.53,IS,0.09,0.0,Phase3-EA-B1v1-GBPJPY-M30-1,GBPJPYMT4,1608,16h 59m,Buy
193242.09,0.94844,05.03.2020 22:59:58,tp 0.94844,0.0,-0.0,0.0,0.0,0.94744,05.03.2020 22:00:00,18036,-0.0,61.15,IS,0.58,0.0,Phase3-EA-SA2v2-USDCHF-M15-107,USDCHFMT4,3608,59m 58s,Buy
193175.17,1.06158,06.03.2020 04:35:00,,-1.04,-66.9199999999837,0.0,0.0,1.0631,05.03.2020 20:15:00,18037,-0.023626432074407958,-66.92,IS,0.41,0.0,Phase3-EA-SA2v2-EURCHF-M5-43,EURCHFMT4,9298,8h 20m,Buy
193131.03,0.94604,06.03.2020 05:00:00,,0.0,-111.05999999999767,0.0,0.0,0.94676,06.03.2020 00:45:00,18038,-0.03921027415099121,-44.14,IS,0.58,0.0,Phase3-EA-SA2v2-USDCHF-M15-107,USDCHFMT4,3610,4h 15m,Buy
193393.5,1.3018,06.03.2020 15:29:58,tp 1.30180,-2.13,-0.0,0.0,0.0,1.2829,04.03.2020 18:00:00,18039,-0.0,262.47,IS,0.14,0.0,Phase3-EA-B1v1-GBPUSD-M30-14,GBPUSDMT4,1216,1d 21h 29m,Buy
193452.13,0.9368,09.03.2020 02:00:00,tp 0.93680,-3.28,-0.0,0.0,0.0,0.9378,06.03.2020 22:00:00,18040,-0.0,58.63,IS,0.58,0.0,Phase3-EA-SA2v2-USDCHF-M15-107,USDCHFMT4,3612,2d 4h 0m,Sell
193553.95,104874,09.03.2020 02:00:00,tp 104.874,-1.16,-0.0,0.0,0.0,105274,06.03.2020 17:45:00,18041,-0.0,101.82,IS,0.27,0.0,Phase3-EA-S1v2-USDJPY-M15-0,USDJPYMT4,4950,2d 8h 15m,Sell
193486.41,118468,09.03.2020 02:29:58,sl 118.468,-0.42,-67.53999999997905,0.0,0.0,119248,06.03.2020 04:00:00,18042,-0.023819100386356384,-67.54,IS,0.09,0.0,Phase3-EA-TR1v1-EURJPY-M30-91,EURJPYMT4,3134,2d 22h 29m,Buy
193309.32,135879,09.03.2020 02:54:57,sl 135.879,0.0,-244.63000000000466,0.0,0.0,136679,09.03.2020 02:15:00,18043,-0.08627282391940007,-177.09,IS,0.23,0.0,Phase3-EA-S4v1-GBPJPY-M5-194,GBPJPYMT4,3914,39m 57s,Buy
193065.49,0.92768,09.03.2020 02:59:57,sl 0.92768,0.0,-488.46000000002095,0.0,0.0,0.93158,09.03.2020 02:30:00,18044,-0.17226351457986006,-243.83,IS,0.58,0.0,Phase3-EA-SA2v2-USDCHF-M15-107,USDCHFMT4,3614,29m 57s,Buy
193151.69,136332,09.03.2020 03:14:57,tp 136.332,0.0,-402.2600000000093,0.0,0.0,135942,09.03.2020 03:05:00,18045,-0.1418636559286188,86.2,IS,0.23,0.0,Phase3-EA-S4v1-GBPJPY-M5-194,GBPJPYMT4,3916,9m 57s,Buy
193200.21,1.05832,09.03.2020 04:09:58,tp 1.05832,0.0,-353.7399999999907,0.0,0.0,1.05722,09.03.2020 02:30:00,18046,-0.12475227377364673,48.52,IS,0.41,0.0,Phase3-EA-SA2v2-EURCHF-M5-43,EURCHFMT4,9300,1h 39m,Buy
193347.53,1.05965,09.03.2020 06:44:58,tp 1.05965,0.0,-206.4199999999837,0.0,0.0,1.05565,09.03.2020 06:30:00,18047,-0.07279743413907051,147.32,IS,0.34,0.0,Phase3-EA-S4v1-EURCHF-M15-221,EURCHFMT4,4780,14m 58s,Buy
193396.06,1.06162,09.03.2020 20:24:58,tp 1.06162,0.0,-157.88999999995576,0.0,0.0,1.06272,09.03.2020 20:10:00,18048,-0.05568252531835834,48.53,IS,0.41,0.0,Phase3-EA-SA2v2-EURCHF-M5-43,EURCHFMT4,9302,14m 58s,Sell
193458.83,0.92405,10.03.2020 00:44:59,tp 0.92405,0.0,-95.11999999993714,0.0,0.0,0.92305,10.03.2020 00:30:00,18049,-0.03354564448844277,62.77,IS,0.58,0.0,Phase3-EA-SA2v2-USDCHF-M15-107,USDCHFMT4,3616,14m 59s,Buy
193506.5,1.06018,10.03.2020 01:49:58,tp 1.06018,-1.06,-47.449999999953434,0.0,0.0,1.05908,09.03.2020 23:05:00,18050,-0.016734028921111224,47.67,IS,0.41,0.0,Phase3-EA-SA2v2-EURCHF-M5-43,EURCHFMT4,9304,2h 44m,Buy
193555.16,1.05775,10.03.2020 01:54:58,tp 1.05775,0.0,-0.0,0.0,0.0,1.05885,10.03.2020 01:50:00,18051,-0.0,48.66,IS,0.41,0.0,Phase3-EA-SA2v2-EURCHF-M5-43,EURCHFMT4,9306,4m 58s,Sell
193603.89,1.05881,10.03.2020 02:54:57,tp 1.05881,0.0,-0.0,0.0,0.0,1.05991,10.03.2020 02:15:00,18052,-0.0,48.73,IS,0.41,0.0,Phase3-EA-SA2v2-EURCHF-M5-43,EURCHFMT4,9308,39m 57s,Sell
193426.66,135421,10.03.2020 07:54:58,sl 135.421,0.0,-177.22999999998137,0.0,0.0,134621,10.03.2020 03:50:00,18053,-0.062492090640921996,-177.23,IS,0.23,0.0,Phase3-EA-S4v1-GBPJPY-M5-194,GBPJPYMT4,3918,4h 4m,Sell
193572.86,1.06181,10.03.2020 07:59:57,tp 1.06181,0.0,-31.029999999969732,0.0,0.0,1.05781,10.03.2020 01:00:00,18054,-0.010941316778119516,146.2,IS,0.34,0.0,Phase3-EA-S4v1-EURCHF-M15-221,EURCHFMT4,4782,6h 59m,Buy
193684.46,118379,10.03.2020 08:29:58,tp 118.379,-0.43,-0.0,0.0,0.0,117089,09.03.2020 20:30:00,18055,-0.0,111.6,IS,0.09,0.0,Phase3-EA-TR1v1-EURJPY-M30-91,EURJPYMT4,3136,11h 59m,Buy
193622.2,117928,10.03.2020 19:29:58,sl 117.928,0.0,-62.26000000000931,0.0,0.0,118648,10.03.2020 11:00:00,18056,-0.021946919475253977,-62.26,IS,0.09,0.0,Phase3-EA-TR1v1-EURJPY-M30-91,EURJPYMT4,3138,8h 29m,Buy
193408.98,105104,10.03.2020 22:59:58,sl 105.104,0.0,-275.4799999999814,0.0,0.0,104274,10.03.2020 21:00:00,18057,-0.09710789233924916,-213.22,IS,0.27,0.0,Phase3-EA-S1v2-USDJPY-M15-0,USDJPYMT4,4952,1h 59m,Sell
193492.83,135864,11.03.2020 00:14:57,tp 135.864,-1.26,-191.63000000000466,0.0,0.0,136254,10.03.2020 23:30:00,18058,-0.06755040441764203,83.85,IS,0.23,0.0,Phase3-EA-S4v1-GBPJPY-M5-194,GBPJPYMT4,3920,44m 57s,Sell
193538.64,1.05902,11.03.2020 01:04:57,tp 1.05902,-2.18,-145.82000000000698,0.0,0.0,1.06012,10.03.2020 22:25:00,18059,-0.05140218114168341,45.81,IS,0.41,0.0,Phase3-EA-SA2v2-EURCHF-M5-43,EURCHFMT4,9310,2h 39m,Sell
193500.79,118.85,11.03.2020 01:59:58,sl 118.850,-0.79,-183.6699999999837,0.0,0.0,119.08,10.03.2020 23:15:00,18060,-0.06474446996496848,-37.85,IS,0.17,0.0,Phase3-EA-T1v2-EURJPY-M15-322,EURJPYMT4,3578,2h 44m,Buy
193463.64,118737,11.03.2020 13:59:58,sl 118.737,0.0,-220.82000000000698,0.0,0.0,118967,11.03.2020 12:00:00,18061,-0.07784000575851287,-37.15,IS,0.17,0.0,Phase3-EA-T1v2-EURJPY-M15-322,EURJPYMT4,3580,1h 59m,Buy
193421.64,1.29345,11.03.2020 14:59:58,sl 1.29345,0.0,-262.820000000007,0.0,0.0,1.29645,11.03.2020 13:30:00,18062,-0.09264518754393737,-42.0,IS,0.14,0.0,Phase3-EA-B1v1-GBPUSD-M30-14,GBPUSDMT4,1218,1h 29m,Buy
193384.24,118659,11.03.2020 17:29:58,sl 118.659,0.0,-300.22000000003027,0.0,0.0,118429,11.03.2020 17:00:00,18063,-0.10582884941953787,-37.4,IS,0.17,0.0,Phase3-EA-T1v2-EURJPY-M15-322,EURJPYMT4,3582,29m 58s,Sell
193487.25,104845,11.03.2020 17:44:58,tp 104.845,0.0,-197.21000000002095,0.0,0.0,104445,11.03.2020 17:00:00,18064,-0.06951737856913988,103.01,IS,0.27,0.0,Phase3-EA-S1v2-USDJPY-M15-0,USDJPYMT4,4954,44m 58s,Buy
193535.3,1.05771,11.03.2020 23:09:58,tp 1.05771,0.0,-149.1600000000326,0.0,0.0,1.05881,11.03.2020 20:40:00,18065,-0.052579545597961914,48.05,IS,0.41,0.0,Phase3-EA-SA2v2-EURCHF-M5-43,EURCHFMT4,9312,2h 29m,Sell
193638.67,104478,11.03.2020 23:14:58,tp 104.478,0.0,-45.79000000003725,0.0,0.0,104878,11.03.2020 19:45:00,18066,-0.016141173189408078,103.37,IS,0.27,0.0,Phase3-EA-S1v2-USDJPY-M15-0,USDJPYMT4,4956,3h 29m,Sell
193724.5,134282,11.03.2020 23:34:58,tp 134.282,0.0,-0.0,0.0,0.0,133892,11.03.2020 23:20:00,18067,-0.0,85.83,IS,0.23,0.0,Phase3-EA-S4v1-GBPJPY-M5-194,GBPJPYMT4,3922,14m 58s,Buy
193784.03,0.93927,12.03.2020 01:29:57,tp 0.93927,-2.22,-0.0,0.0,0.0,0.93827,11.03.2020 23:30:00,18068,-0.0,59.53,IS,0.58,0.0,Phase3-EA-SA2v2-USDCHF-M15-107,USDCHFMT4,3618,1h 59m,Buy
193869.87,134134,12.03.2020 02:34:58,tp 134.134,0.0,-0.0,0.0,0.0,133744,12.03.2020 01:25:00,18069,-0.0,85.84,IS,0.23,0.0,Phase3-EA-S4v1-GBPJPY-M5-194,GBPJPYMT4,3924,1h 9m,Buy
193783.23,1.05552,12.03.2020 07:40:00,,-3.15,-86.64000000001397,0.0,0.0,1.05742,11.03.2020 23:20:00,18070,-0.030521027117113075,-86.64,IS,0.41,0.0,Phase3-EA-SA2v2-EURCHF-M5-43,EURCHFMT4,9314,8h 20m,Buy
193742.87,1.0558,12.03.2020 10:00:00,,0.0,-127.0,0.0,0.0,1.05691,12.03.2020 01:15:00,18071,-0.04473880937064561,-40.36,IS,0.34,0.0,Phase3-EA-S4v1-EURCHF-M15-221,EURCHFMT4,4784,8h 45m,Buy
193675.2,116347,12.03.2020 15:59:57,sl 116.347,0.0,-194.6699999999837,0.0,0.0,117127,12.03.2020 10:30:00,18072,-0.06857719700931379,-67.67,IS,0.09,0.0,Phase3-EA-TR1v1-EURJPY-M30-91,EURJPYMT4,3140,5h 29m,Buy
193836.05,131369,12.03.2020 16:29:58,tp 131.369,0.0,-33.820000000006985,0.0,0.0,133219,12.03.2020 05:30:00,18073,-0.011913909707996434,160.85,IS,0.09,0.0,Phase3-EA-B1v1-GBPJPY-M30-1,GBPJPYMT4,1610,10h 59m,Sell
193768.94,116.91,12.03.2020 18:29:58,sl 116.910,0.0,-100.92999999999302,0.0,0.0,117.69,12.03.2020 18:00:00,18074,-0.03555502385652716,-67.11,IS,0.09,0.0,Phase3-EA-TR1v1-EURJPY-M30-91,EURJPYMT4,3142,29m 58s,Buy
193816.31,1.05561,12.03.2020 20:49:58,tp 1.05561,0.0,-53.55999999999767,0.0,0.0,1.05671,12.03.2020 20:40:00,18075,-0.018867800235367518,47.37,IS,0.41,0.0,Phase3-EA-SA2v2-EURCHF-M5-43,EURCHFMT4,9316,9m 58s,Sell
193863.89,1.05658,12.03.2020 21:19:57,tp 1.05658,0.0,-5.9799999999813735,0.0,0.0,1.05768,12.03.2020 21:15:00,18076,-0.002106599055398641,47.58,IS,0.41,0.0,Phase3-EA-SA2v2-EURCHF-M5-43,EURCHFMT4,9318,4m 57s,Sell
193965.59,105005,13.03.2020 00:14:58,tp 105.005,-1.15,-0.0,0.0,0.0,105405,12.03.2020 23:30:00,18077,-0.0,101.7,IS,0.27,0.0,Phase3-EA-S1v2-USDJPY-M15-0,USDJPYMT4,4958,44m 58s,Sell
193930.06,104879,13.03.2020 00:30:00,,0.0,-35.53000000002794,0.0,0.0,104743,13.03.2020 00:15:00,18078,-0.012512079368499473,-35.53,IS,0.27,0.0,Phase3-EA-S1v2-USDJPY-M15-0,USDJPYMT4,4960,15m 0s,Buy
193977.79,1.05722,13.03.2020 02:04:58,tp 1.05722,0.0,-0.0,0.0,0.0,1.05612,13.03.2020 00:40:00,18079,-0.0,47.73,IS,0.41,0.0,Phase3-EA-SA2v2-EURCHF-M5-43,EURCHFMT4,9320,1h 24m,Buy
194039.06,0.94665,13.03.2020 04:14:58,tp 0.94665,0.0,-0.0,0.0,0.0,0.94565,13.03.2020 00:30:00,18080,-0.0,61.27,IS,0.58,0.0,Phase3-EA-SA2v2-USDCHF-M15-107,USDCHFMT4,3620,3h 44m,Buy
194141.78,105143,13.03.2020 04:29:58,tp 105.143,0.0,-0.0,0.0,0.0,104741,13.03.2020 00:15:00,18081,-0.0,102.72,IS,0.27,0.0,Phase3-EA-S1v2-USDJPY-M15-0,USDJPYMT4,4961,4h 14m,Sell
194111.35,131785,13.03.2020 05:55:00,,0.0,-30.429999999993015,0.0,0.0,131924,13.03.2020 00:30:00,18082,-0.010709442307285082,-30.43,IS,0.23,0.0,Phase3-EA-S4v1-GBPJPY-M5-194,GBPJPYMT4,3926,5h 25m,Buy
194054.0,132097,13.03.2020 06:59:57,sl 132.097,0.0,-87.77999999996973,0.0,0.0,131427,13.03.2020 01:00:00,18083,-0.03089302812137286,-57.35,IS,0.09,0.0,Phase3-EA-B1v1-GBPJPY-M30-1,GBPJPYMT4,1612,5h 59m,Sell
194086.43,1.05677,13.03.2020 10:00:00,,0.0,-55.34999999997672,0.0,0.0,1.05587,13.03.2020 01:15:00,18084,-0.019479711853700822,32.43,IS,0.34,0.0,Phase3-EA-S4v1-EURCHF-M15-221,EURCHFMT4,4786,8h 45m,Buy
194044.43,1.2586,13.03.2020 14:59:58,sl 1.25860,0.0,-97.34999999997672,0.0,0.0,1.2616,13.03.2020 14:30:00,18085,-0.0342610650218269,-42.0,IS,0.14,0.0,Phase3-EA-B1v1-GBPUSD-M30-14,GBPUSDMT4,1220,29m 58s,Buy
194315.69,119177,13.03.2020 15:59:58,tp 119.177,0.0,-0.0,0.0,0.0,117477,13.03.2020 06:15:00,18086,-0.0,271.26,IS,0.17,0.0,Phase3-EA-T1v2-EURJPY-M15-322,EURJPYMT4,3584,9h 44m,Buy
194416.27,107375,13.03.2020 20:29:58,tp 107.375,0.0,-0.0,0.0,0.0,106975,13.03.2020 19:45:00,18087,-0.0,100.58,IS,0.27,0.0,Phase3-EA-S1v2-USDJPY-M15-0,USDJPYMT4,4964,44m 58s,Buy
194351.03,119619,13.03.2020 21:29:58,sl 119.619,0.0,-65.23999999999069,0.0,0.0,118839,13.03.2020 19:30:00,18088,-0.022938209547572797,-65.24,IS,0.09,0.0,Phase3-EA-TR1v1-EURJPY-M30-91,EURJPYMT4,3144,1h 59m,Sell
194408.53,0.95512,16.03.2020 02:00:00,tp 0.95512,-3.23,-7.739999999990687,0.0,0.0,0.95612,13.03.2020 23:30:00,18089,-0.002721363303157958,57.5,IS,0.58,0.0,Phase3-EA-SA2v2-USDCHF-M15-107,USDCHFMT4,3622,2d 2h 30m,Sell
194456.25,1.05595,16.03.2020 02:09:58,tp 1.05595,0.0,-0.0,0.0,0.0,1.05705,16.03.2020 02:00:00,18090,-0.0,47.72,IS,0.41,0.0,Phase3-EA-SA2v2-EURCHF-M5-43,EURCHFMT4,9322,9m 58s,Sell
194540.94,131676,16.03.2020 02:39:58,tp 131.676,0.0,-0.0,0.0,0.0,131286,16.03.2020 02:25:00,18091,-0.0,84.69,IS,0.23,0.0,Phase3-EA-S4v1-GBPJPY-M5-194,GBPJPYMT4,3928,14m 58s,Buy
194602.19,0.94696,16.03.2020 02:44:57,tp 0.94696,0.0,-0.0,0.0,0.0,0.94596,16.03.2020 02:15:00,18092,-0.0,61.25,IS,0.58,0.0,Phase3-EA-SA2v2-USDCHF-M15-107,USDCHFMT4,3624,29m 57s,Buy
194535.94,119011,16.03.2020 03:59:58,sl 119.011,0.0,-66.25,0.0,0.0,118231,16.03.2020 02:30:00,18093,-0.023278106187447026,-66.25,IS,0.09,0.0,Phase3-EA-TR1v1-EURJPY-M30-91,EURJPYMT4,3146,1h 29m,Sell
194637.98,105841,16.03.2020 19:59:58,tp 105.841,0.0,-0.0,0.0,0.0,106241,16.03.2020 18:15:00,18094,-0.0,102.04,IS,0.27,0.0,Phase3-EA-S1v2-USDJPY-M15-0,USDJPYMT4,4966,1h 44m,Sell
194601.13,118667,16.03.2020 23:14:58,sl 118.667,0.0,-36.84999999997672,0.0,0.0,118437,16.03.2020 14:15:00,18095,-0.012946269503450163,-36.85,IS,0.17,0.0,Phase3-EA-T1v2-EURJPY-M15-322,EURJPYMT4,3586,8h 59m,Sell
194685.62,129707,16.03.2020 23:34:58,tp 129.707,0.0,-0.0,0.0,0.0,130097,16.03.2020 23:20:00,18096,-0.0,84.49,IS,0.23,0.0,Phase3-EA-S4v1-GBPJPY-M5-194,GBPJPYMT4,3930,14m 58s,Sell
194746.92,0.94614,16.03.2020 23:59:58,tp 0.94614,0.0,-0.0,0.0,0.0,0.94714,16.03.2020 23:00:00,18097,-0.0,61.3,IS,0.58,0.0,Phase3-EA-SA2v2-USDCHF-M15-107,USDCHFMT4,3626,59m 58s,Sell
194807.18,106229,17.03.2020 02:45:00,,-0.74,-0.0,0.0,0.0,105989,16.03.2020 23:45:00,18098,-0.0,60.26,IS,0.27,0.0,Phase3-EA-S1v2-USDJPY-M15-0,USDJPYMT4,4968,3h 0m,Buy
194868.37,0.94788,17.03.2020 04:14:58,tp 0.94788,0.0,-0.0,0.0,0.0,0.94688,17.03.2020 00:45:00,18099,-0.0,61.19,IS,0.58,0.0,Phase3-EA-SA2v2-USDCHF-M15-107,USDCHFMT4,3628,3h 29m,Buy
194714.93,1.05929,17.03.2020 05:10:00,,-2.17,-153.44000000000233,0.0,0.0,1.05579,16.03.2020 20:50:00,18100,-0.053863473856364516,-153.44,IS,0.41,0.0,Phase3-EA-SA2v2-EURCHF-M5-43,EURCHFMT4,9324,8h 20m,Sell
194823.46,119365,17.03.2020 05:29:58,tp 119.365,-0.42,-44.90999999997439,0.0,0.0,118075,16.03.2020 20:30:00,18101,-0.015765176035505177,108.53,IS,0.09,0.0,Phase3-EA-TR1v1-EURJPY-M30-91,EURJPYMT4,3148,8h 59m,Buy
194651.25,131029,17.03.2020 05:34:59,sl 131.029,0.0,-217.11999999999534,0.0,0.0,130229,17.03.2020 02:55:00,18102,-0.07621765800113031,-172.21,IS,0.23,0.0,Phase3-EA-S4v1-GBPJPY-M5-194,GBPJPYMT4,3932,2h 39m,Sell
194617.19,1.05921,17.03.2020 10:00:00,,0.0,-251.17999999999302,0.0,0.0,1.05826,17.03.2020 01:15:00,18103,-0.08817405737253035,-34.06,IS,0.34,0.0,Phase3-EA-S4v1-EURCHF-M15-221,EURCHFMT4,4788,8h 45m,Sell
194575.19,1.22242,17.03.2020 12:29:57,sl 1.22242,0.0,-293.179999999993,0.0,0.0,1.21942,17.03.2020 12:00:00,18104,-0.10291770897554961,-42.0,IS,0.14,0.0,Phase3-EA-B1v1-GBPUSD-M30-14,GBPUSDMT4,1222,29m 57s,Sell
194606.5,106928,17.03.2020 18:15:00,,0.0,-261.86999999999534,0.0,0.0,106804,17.03.2020 17:45:00,18105,-0.09192666774482346,31.31,IS,0.27,0.0,Phase3-EA-S1v2-USDJPY-M15-0,USDJPYMT4,4970,30m 0s,Buy
194653.37,1.05668,17.03.2020 21:14:58,tp 1.05668,0.0,-215.0,0.0,0.0,1.05778,17.03.2020 20:30:00,18106,-0.07547345463450336,46.87,IS,0.41,0.0,Phase3-EA-SA2v2-EURCHF-M5-43,EURCHFMT4,9326,44m 58s,Sell
194593.02,118245,17.03.2020 22:29:58,sl 118.245,0.0,-275.3499999999767,0.0,0.0,117525,17.03.2020 17:30:00,18107,-0.09665867783073834,-60.35,IS,0.09,0.0,Phase3-EA-TR1v1-EURJPY-M30-91,EURJPYMT4,3150,4h 59m,Sell
194640.02,1.0571,18.03.2020 02:34:58,tp 1.05710,0.0,-228.34999999997672,0.0,0.0,1.0582,18.03.2020 02:20:00,18108,-0.08015982960831203,47.0,IS,0.41,0.0,Phase3-EA-SA2v2-EURCHF-M5-43,EURCHFMT4,9328,14m 58s,Sell
194723.58,130188,18.03.2020 03:59:57,tp 130.188,0.0,-144.78999999997905,0.0,0.0,129798,18.03.2020 00:50:00,18109,-0.050826983704782135,83.56,IS,0.23,0.0,Phase3-EA-S4v1-GBPJPY-M5-194,GBPJPYMT4,3934,3h 9m,Buy
194687.09,118188,18.03.2020 06:44:58,sl 118.188,0.0,-181.27999999996973,0.0,0.0,117958,18.03.2020 05:15:00,18110,-0.06363640863321156,-36.49,IS,0.17,0.0,Phase3-EA-T1v2-EURJPY-M15-322,EURJPYMT4,3588,1h 29m,Sell
194621.16,107297,18.03.2020 11:45:00,,0.0,-247.20999999996275,0.0,0.0,107559,18.03.2020 01:30:00,18111,-0.08678043125671053,-65.93,IS,0.27,0.0,Phase3-EA-S1v2-USDJPY-M15-0,USDJPYMT4,4972,10h 15m,Buy
194775.16,126782,18.03.2020 20:59:58,tp 126.782,0.0,-93.20999999996275,0.0,0.0,128632,18.03.2020 14:30:00,18112,-0.03272037537897324,154.0,IS,0.09,0.0,Phase3-EA-B1v1-GBPJPY-M30-1,GBPJPYMT4,1614,6h 29m,Sell
194821.78,1.0543,19.03.2020 01:19:58,tp 1.05430,0.0,-46.589999999967404,0.0,0.0,1.0554,19.03.2020 00:40:00,18113,-0.016354922099623494,46.62,IS,0.41,0.0,Phase3-EA-SA2v2-EURCHF-M5-43,EURCHFMT4,9330,39m 58s,Sell
194881.66,0.96863,19.03.2020 02:29:58,tp 0.96863,0.0,-0.0,0.0,0.0,0.96763,19.03.2020 00:30:00,18114,-0.0,59.88,IS,0.58,0.0,Phase3-EA-SA2v2-USDCHF-M15-107,USDCHFMT4,3630,1h 59m,Buy
194843.85,118148,19.03.2020 02:59:58,sl 118.148,-1.65,-37.80999999999767,0.0,0.0,117918,18.03.2020 15:15:00,18115,-0.013272177647377342,-37.81,IS,0.17,0.0,Phase3-EA-T1v2-EURJPY-M15-322,EURJPYMT4,3590,11h 44m,Sell
194706.27,1.05872,19.03.2020 03:14:58,sl 1.05872,0.0,-175.39000000001397,0.0,0.0,1.05482,19.03.2020 01:15:00,18116,-0.06156591477317749,-137.58,IS,0.34,0.0,Phase3-EA-S4v1-EURCHF-M15-221,EURCHFMT4,4790,1h 59m,Sell
194812.36,118822,19.03.2020 03:59:57,tp 118.822,-1.22,-69.29999999998836,0.0,0.0,117532,18.03.2020 23:30:00,18117,-0.024325890266150542,106.09,IS,0.09,0.0,Phase3-EA-TR1v1-EURJPY-M30-91,EURJPYMT4,3152,4h 29m,Buy
194909.84,108378,19.03.2020 03:59:58,tp 108.378,-2.17,-0.0,0.0,0.0,107978,18.03.2020 22:45:00,18118,-0.0,97.48,IS,0.27,0.0,Phase3-EA-S1v2-USDJPY-M15-0,USDJPYMT4,4974,5h 14m,Buy
195017.05,1.05527,19.03.2020 12:30:00,,0.0,-0.0,0.0,0.0,1.05833,19.03.2020 03:45:00,18119,-0.0,107.21,IS,0.34,0.0,Phase3-EA-S4v1-EURCHF-M15-221,EURCHFMT4,4792,8h 45m,Sell
194981.5,118493,19.03.2020 18:29:57,sl 118.493,0.0,-35.54999999998836,0.0,0.0,118723,19.03.2020 18:15:00,18120,-0.012472938022475573,-35.55,IS,0.17,0.0,Phase3-EA-T1v2-EURJPY-M15-322,EURJPYMT4,3592,14m 57s,Buy
195026.24,1.05405,20.03.2020 00:39:58,tp 1.05405,-1.0,-0.0,0.0,0.0,1.05295,19.03.2020 20:30:00,18121,-0.0,44.74,IS,0.41,0.0,Phase3-EA-SA2v2-EURCHF-M5-43,EURCHFMT4,9332,4h 9m,Buy
195071.95,1.05306,20.03.2020 01:19:57,tp 1.05306,0.0,-0.0,0.0,0.0,1.05416,20.03.2020 00:45:00,18122,-0.0,45.71,IS,0.41,0.0,Phase3-EA-SA2v2-EURCHF-M5-43,EURCHFMT4,9334,34m 57s,Sell
195152.79,127046,20.03.2020 03:09:57,tp 127.046,0.0,-0.0,0.0,0.0,126656,20.03.2020 02:20:00,18123,-0.0,80.84,IS,0.23,0.0,Phase3-EA-S4v1-GBPJPY-M5-194,GBPJPYMT4,3936,49m 57s,Buy
195233.46,127549,20.03.2020 04:09:58,tp 127.549,0.0,-0.0,0.0,0.0,127939,20.03.2020 03:50:00,18124,-0.0,80.67,IS,0.23,0.0,Phase3-EA-S4v1-GBPJPY-M5-194,GBPJPYMT4,3938,19m 58s,Sell
195191.46,1.15137,20.03.2020 04:29:58,sl 1.15137,0.0,-42.0,0.0,0.0,1.14837,20.03.2020 01:00:00,18125,-0.014724780185326022,-42.0,IS,0.14,0.0,Phase3-EA-B1v1-GBPUSD-M30-14,GBPUSDMT4,1224,3h 29m,Sell
195250.21,0.98728,20.03.2020 04:44:58,tp 0.98728,0.0,-0.0,0.0,0.0,0.98828,20.03.2020 02:45:00,18126,-0.0,58.75,IS,0.58,0.0,Phase3-EA-SA2v2-USDCHF-M15-107,USDCHFMT4,3632,1h 59m,Sell
195277.63,1.05304,20.03.2020 09:45:00,,0.0,-0.0,0.0,0.0,1.05383,20.03.2020 01:00:00,18127,-0.0,27.42,IS,0.34,0.0,Phase3-EA-S4v1-EURCHF-M15-221,EURCHFMT4,4794,8h 45m,Sell
195242.08,118311,20.03.2020 13:44:58,sl 118.311,0.0,-35.54999999998836,0.0,0.0,118541,20.03.2020 13:00:00,18128,-0.012461544916784471,-35.55,IS,0.17,0.0,Phase3-EA-T1v2-EURJPY-M15-322,EURJPYMT4,3594,44m 58s,Buy
195206.53,118417,20.03.2020 16:44:58,sl 118.417,0.0,-71.09999999997672,0.0,0.0,118187,20.03.2020 14:15:00,18129,-0.024923089833568942,-35.55,IS,0.17,0.0,Phase3-EA-T1v2-EURJPY-M15-322,EURJPYMT4,3596,2h 29m,Sell
195252.18,1.05442,20.03.2020 21:44:58,tp 1.05442,0.0,-25.449999999953434,0.0,0.0,1.05332,20.03.2020 21:05:00,18130,-0.008921134124660713,45.65,IS,0.41,0.0,Phase3-EA-SA2v2-EURCHF-M5-43,EURCHFMT4,9336,39m 58s,Buy
195321.22,111.45,20.03.2020 23:30:00,,0.0,-0.0,0.0,0.0,111165,20.03.2020 23:00:00,18131,-0.0,69.04,IS,0.27,0.0,Phase3-EA-S1v2-USDJPY-M15-0,USDJPYMT4,4976,30m 0s,Buy
195376.82,0.98792,23.03.2020 02:00:00,tp 0.98792,-3.11,-0.0,0.0,0.0,0.98892,20.03.2020 22:30:00,18132,-0.0,55.6,IS,0.58,0.0,Phase3-EA-SA2v2-USDCHF-M15-107,USDCHFMT4,3634,2d 3h 30m,Sell
195340.68,118334,23.03.2020 02:14:58,sl 118.334,-0.75,-36.14000000001397,0.0,0.0,118564,20.03.2020 23:45:00,18133,-0.01266395778045807,-36.14,IS,0.17,0.0,Phase3-EA-T1v2-EURJPY-M15-322,EURJPYMT4,3598,2d 2h 29m,Buy
195427.28,1.05533,23.03.2020 11:45:00,,0.0,-0.0,0.0,0.0,1.05282,23.03.2020 03:00:00,18134,-0.0,86.6,IS,0.34,0.0,Phase3-EA-S4v1-EURCHF-M15-221,EURCHFMT4,4796,8h 45m,Buy
195524.91,110618,23.03.2020 17:29:58,tp 110.618,0.0,-0.0,0.0,0.0,110218,23.03.2020 17:00:00,18135,-0.0,97.63,IS,0.27,0.0,Phase3-EA-S1v2-USDJPY-M15-0,USDJPYMT4,4978,29m 58s,Buy
195629.89,119555,23.03.2020 18:59:58,tp 119.555,0.0,-0.0,0.0,0.0,118265,23.03.2020 15:30:00,18136,-0.0,104.98,IS,0.09,0.0,Phase3-EA-TR1v1-EURJPY-M30-91,EURJPYMT4,3154,3h 29m,Buy
195675.82,1.05654,23.03.2020 21:19:57,tp 1.05654,0.0,-0.0,0.0,0.0,1.05544,23.03.2020 20:30:00,18137,-0.0,45.93,IS,0.41,0.0,Phase3-EA-SA2v2-EURCHF-M5-43,EURCHFMT4,9338,49m 57s,Buy
195721.66,1.05674,24.03.2020 02:09:58,tp 1.05674,0.0,-0.0,0.0,0.0,1.05564,24.03.2020 00:05:00,18138,-0.0,45.84,IS,0.41,0.0,Phase3-EA-SA2v2-EURCHF-M5-43,EURCHFMT4,9340,2h 4m,Buy
195767.54,1.05615,24.03.2020 03:04:58,tp 1.05615,0.0,-0.0,0.0,0.0,1.05725,24.03.2020 02:20:00,18139,-0.0,45.88,IS,0.41,0.0,Phase3-EA-SA2v2-EURCHF-M5-43,EURCHFMT4,9342,44m 58s,Sell
195564.41,110321,24.03.2020 05:29:57,sl 110.321,0.0,-203.13000000000466,0.0,0.0,111151,24.03.2020 00:30:00,18140,-0.07108225097924133,-203.13,IS,0.27,0.0,Phase3-EA-S1v2-USDJPY-M15-0,USDJPYMT4,4980,4h 59m,Buy
195582.45,1.05672,24.03.2020 10:15:00,,0.0,-185.0900000000256,0.0,0.0,1.0562,24.03.2020 01:30:00,18141,-0.06476942762639343,18.04,IS,0.34,0.0,Phase3-EA-S4v1-EURCHF-M15-221,EURCHFMT4,4798,8h 45m,Buy
195657.88,110963,24.03.2020 17:45:00,,0.0,-109.6600000000326,0.0,0.0,110653,24.03.2020 17:15:00,18142,-0.038373847498575996,75.43,IS,0.27,0.0,Phase3-EA-S1v2-USDJPY-M15-0,USDJPYMT4,4982,30m 0s,Buy
195603.72,130638,24.03.2020 21:59:58,sl 130.638,0.0,-163.82000000000698,0.0,0.0,131308,24.03.2020 20:00:00,18143,-0.05732631494815903,-54.16,IS,0.09,0.0,Phase3-EA-B1v1-GBPJPY-M30-1,GBPJPYMT4,1616,1h 59m,Buy
195629.94,119846,24.03.2020 23:15:00,,0.0,-137.60000000003492,0.0,0.0,119674,24.03.2020 11:15:00,18144,-0.048151025130437966,26.22,IS,0.17,0.0,Phase3-EA-T1v2-EURJPY-M15-322,EURJPYMT4,3600,12h 0m,Buy
195688.93,0.98318,24.03.2020 23:59:59,tp 0.98318,0.0,-78.61000000004424,0.0,0.0,0.98418,24.03.2020 23:30:00,18145,-0.02750837271442513,58.99,IS,0.58,0.0,Phase3-EA-SA2v2-USDCHF-M15-107,USDCHFMT4,3636,29m 59s,Sell
195733.85,1.05935,25.03.2020 02:04:58,tp 1.05935,-1.0,-33.690000000060536,0.0,0.0,1.05825,24.03.2020 21:05:00,18146,-0.011789302591911034,44.92,IS,0.41,0.0,Phase3-EA-SA2v2-EURCHF-M5-43,EURCHFMT4,9344,4h 59m,Buy
195779.83,1.05892,25.03.2020 03:29:58,tp 1.05892,0.0,-0.0,0.0,0.0,1.06002,25.03.2020 02:25:00,18147,-0.0,45.98,IS,0.41,0.0,Phase3-EA-SA2v2-EURCHF-M5-43,EURCHFMT4,9346,1h 4m,Sell
195838.84,0.98293,25.03.2020 04:59:57,tp 0.98293,0.0,-0.0,0.0,0.0,0.98193,25.03.2020 00:45:00,18148,-0.0,59.01,IS,0.58,0.0,Phase3-EA-SA2v2-USDCHF-M15-107,USDCHFMT4,3638,4h 14m,Buy
195777.41,111197,25.03.2020 08:45:00,,0.0,-61.429999999993015,0.0,0.0,111.45,25.03.2020 00:15:00,18149,-0.021491131156281207,-61.43,IS,0.27,0.0,Phase3-EA-S1v2-USDJPY-M15-0,USDJPYMT4,4984,8h 30m,Buy
196041.48,1.18164,25.03.2020 09:29:58,tp 1.18164,-0.53,-0.0,0.0,0.0,1.16274,24.03.2020 08:00:00,18150,-0.0,264.07,IS,0.14,0.0,Phase3-EA-B1v1-GBPUSD-M30-14,GBPUSDMT4,1226,1d 1h 29m,Buy
195971.83,1.06168,25.03.2020 11:45:00,,0.0,-69.65000000002328,0.0,0.0,1.05967,25.03.2020 03:00:00,18151,-0.024349615307550157,-69.65,IS,0.34,0.0,Phase3-EA-S4v1-EURCHF-M15-221,EURCHFMT4,4800,8h 45m,Sell
196072.92,120594,25.03.2020 11:59:57,tp 120.594,-0.8,-0.0,0.0,0.0,119334,23.03.2020 18:30:00,18152,-0.0,101.09,IS,0.09,0.0,Phase3-EA-TR1v1-EURJPY-M30-91,EURJPYMT4,3155,1d 17h 29m,Buy
196150.88,120601,25.03.2020 18:45:00,,0.0,-0.0,0.0,0.0,120089,25.03.2020 08:00:00,18153,-0.0,77.96,IS,0.17,0.0,Phase3-EA-T1v2-EURJPY-M15-322,EURJPYMT4,3602,10h 45m,Buy
196190.86,1.06007,26.03.2020 01:24:58,tp 1.06007,-6.3,-0.0,0.0,0.0,1.06117,25.03.2020 20:35:00,18154,-0.0,39.98,IS,0.41,0.0,Phase3-EA-SA2v2-EURCHF-M5-43,EURCHFMT4,9348,4h 49m,Sell
196271.77,131548,26.03.2020 04:29:58,tp 131.548,0.0,-0.0,0.0,0.0,131158,26.03.2020 03:10:00,18155,-0.0,80.91,IS,0.23,0.0,Phase3-EA-S4v1-GBPJPY-M5-194,GBPJPYMT4,3940,1h 19m,Buy
196065.58,1.06537,26.03.2020 04:54:58,sl 1.06537,0.0,-206.19000000000233,0.0,0.0,1.06047,26.03.2020 02:00:00,18156,-0.07202596330053836,-206.19,IS,0.41,0.0,Phase3-EA-SA2v2-EURCHF-M5-43,EURCHFMT4,9350,2h 54m,Sell
196077.12,1.06388,26.03.2020 14:00:00,,0.0,-194.65000000002328,0.0,0.0,1.06421,26.03.2020 05:15:00,18157,-0.067994828829969,11.54,IS,0.34,0.0,Phase3-EA-S4v1-EURCHF-M15-221,EURCHFMT4,4802,8h 45m,Sell
196145.39,109548,26.03.2020 19:30:00,,0.0,-126.38000000000466,0.0,0.0,109825,26.03.2020 18:30:00,18158,-0.044146860865814395,68.27,IS,0.27,0.0,Phase3-EA-S1v2-USDJPY-M15-0,USDJPYMT4,4986,1h 0m,Sell
196202.13,109453,26.03.2020 21:00:00,,0.0,-69.64000000001397,0.0,0.0,109683,26.03.2020 20:30:00,18159,-0.024326534188129592,56.74,IS,0.27,0.0,Phase3-EA-S1v2-USDJPY-M15-0,USDJPYMT4,4988,30m 0s,Sell
196262.36,0.96294,27.03.2020 00:59:57,tp 0.96294,0.0,-9.410000000032596,0.0,0.0,0.96194,27.03.2020 00:15:00,18160,-0.0032870862537485138,60.23,IS,0.58,0.0,Phase3-EA-SA2v2-USDCHF-M15-107,USDCHFMT4,3640,44m 57s,Buy
196313.23,109334,27.03.2020 03:00:00,,0.0,-0.0,0.0,0.0,109.54,27.03.2020 01:00:00,18161,-0.0,50.87,IS,0.27,0.0,Phase3-EA-S1v2-USDJPY-M15-0,USDJPYMT4,4990,2h 0m,Sell
196395.27,133178,27.03.2020 03:24:57,tp 133.178,0.0,-0.0,0.0,0.0,132788,27.03.2020 02:25:00,18162,-0.0,82.04,IS,0.23,0.0,Phase3-EA-S4v1-GBPJPY-M5-194,GBPJPYMT4,3942,59m 57s,Buy
196341.86,1.06211,27.03.2020 04:20:00,,-1.02,-53.40999999997439,0.0,0.0,1.06334,26.03.2020 20:00:00,18163,-0.018649051012600244,-53.41,IS,0.41,0.0,Phase3-EA-SA2v2-EURCHF-M5-43,EURCHFMT4,9352,8h 20m,Buy
196280.66,119903,27.03.2020 05:59:58,sl 119.903,-1.59,-114.60999999998603,0.0,0.0,120623,25.03.2020 12:30:00,18164,-0.040018119014320876,-61.2,IS,0.09,0.0,Phase3-EA-TR1v1-EURJPY-M30-91,EURJPYMT4,3158,1d 17h 29m,Buy
196073.08,107958,27.03.2020 19:44:58,sl 107.958,0.0,-322.1900000000023,0.0,0.0,108788,27.03.2020 17:00:00,18165,-0.11249836633126,-207.58,IS,0.27,0.0,Phase3-EA-S1v2-USDJPY-M15-0,USDJPYMT4,4992,2h 44m,Buy
196013.19,119647,27.03.2020 20:29:58,sl 119.647,0.0,-382.0800000000163,0.0,0.0,118927,27.03.2020 18:30:00,18166,-0.13341002454405582,-59.89,IS,0.09,0.0,Phase3-EA-TR1v1-EURJPY-M30-91,EURJPYMT4,3160,1h 59m,Sell
196060.38,1.05781,27.03.2020 21:34:57,tp 1.05781,0.0,-334.89000000001397,0.0,0.0,1.05891,27.03.2020 20:30:00,18167,-0.11693279710939807,47.19,IS,0.41,0.0,Phase3-EA-SA2v2-EURCHF-M5-43,EURCHFMT4,9354,1h 4m,Sell
196120.49,0.95326,30.03.2020 02:14:58,tp 0.95326,-0.73,-274.78000000002794,0.0,0.0,0.95226,27.03.2020 23:45:00,18168,-0.09594432198549471,60.11,IS,0.58,0.0,Phase3-EA-SA2v2-USDCHF-M15-107,USDCHFMT4,3642,2d 2h 29m,Buy
196167.87,1.05891,30.03.2020 02:19:57,tp 1.05891,0.0,-227.40000000002328,0.0,0.0,1.06001,30.03.2020 02:15:00,18169,-0.07940075267305303,47.38,IS,0.41,0.0,Phase3-EA-SA2v2-EURCHF-M5-43,EURCHFMT4,9356,4m 57s,Sell
196196.7,1.05882,30.03.2020 13:00:00,,0.0,-198.57000000000698,0.0,0.0,1.05801,30.03.2020 04:15:00,18170,-0.06933424563890538,28.83,IS,0.34,0.0,Phase3-EA-S4v1-EURCHF-M15-221,EURCHFMT4,4804,8h 45m,Buy
196131.19,118841,30.03.2020 19:59:57,sl 118.841,-0.41,-264.0800000000163,0.0,0.0,119621,27.03.2020 21:00:00,18171,-0.0922082267629683,-65.51,IS,0.09,0.0,Phase3-EA-TR1v1-EURJPY-M30-91,EURJPYMT4,3162,2d 22h 59m,Buy
196178.18,1.05745,30.03.2020 21:19:58,tp 1.05745,0.0,-217.0900000000256,0.0,0.0,1.05855,30.03.2020 20:00:00,18172,-0.07580083288387578,46.99,IS,0.41,0.0,Phase3-EA-SA2v2-EURCHF-M5-43,EURCHFMT4,9358,1h 19m,Sell
196223.11,1.05773,31.03.2020 01:04:57,tp 1.05773,-2.14,-172.1600000000326,0.0,0.0,1.05883,30.03.2020 23:30:00,18173,-0.06011272462706244,44.93,IS,0.41,0.0,Phase3-EA-SA2v2-EURCHF-M5-43,EURCHFMT4,9360,1h 34m,Sell
196270.18,1.05815,31.03.2020 01:34:57,tp 1.05815,0.0,-125.09000000002561,0.0,0.0,1.05925,31.03.2020 01:30:00,18174,-0.04367739732573976,47.07,IS,0.41,0.0,Phase3-EA-SA2v2-EURCHF-M5-43,EURCHFMT4,9362,4m 57s,Sell
196330.6,0.95987,31.03.2020 03:14:57,tp 0.95987,0.0,-64.67000000004191,0.0,0.0,0.95887,31.03.2020 00:45:00,18175,-0.022580680190717423,60.42,IS,0.58,0.0,Phase3-EA-SA2v2-USDCHF-M15-107,USDCHFMT4,3644,2h 29m,Buy
196355.1,108085,31.03.2020 03:15:00,,-0.73,-40.17000000004191,0.0,0.0,107984,30.03.2020 21:15:00,18176,-0.014026069634474678,24.5,IS,0.27,0.0,Phase3-EA-S1v2-USDJPY-M15-0,USDJPYMT4,4994,6h 0m,Buy
196318.39,119489,31.03.2020 04:59:58,sl 119.489,-0.55,-76.88000000006286,0.0,0.0,119259,30.03.2020 18:00:00,18177,-0.02684401875773388,-36.71,IS,0.17,0.0,Phase3-EA-T1v2-EURJPY-M15-322,EURJPYMT4,3604,10h 59m,Sell
196363.19,1.06017,01.04.2020 00:59:59,tp 1.06017,-2.13,-32.080000000074506,0.0,0.0,1.06127,31.03.2020 22:50:00,18178,-0.011201302312036924,44.8,IS,0.41,0.0,Phase3-EA-SA2v2-EURCHF-M5-43,EURCHFMT4,9364,2h 9m,Sell
196288.97,0.96116,01.04.2020 04:45:00,,0.0,-106.30000000004657,0.0,0.0,0.96239,01.04.2020 00:30:00,18179,-0.0371165347807756,-74.22,IS,0.58,0.0,Phase3-EA-SA2v2-USDCHF-M15-107,USDCHFMT4,3646,4h 15m,Buy
196252.53,118564,01.04.2020 04:59:58,sl 118.564,0.0,-142.7400000000489,0.0,0.0,118334,01.04.2020 04:30:00,18180,-0.049840208604020726,-36.44,IS,0.17,0.0,Phase3-EA-T1v2-EURJPY-M15-322,EURJPYMT4,3606,29m 58s,Sell
196230.77,1.05908,01.04.2020 09:25:00,,0.0,-164.5000000000582,0.0,0.0,1.05959,01.04.2020 01:05:00,18181,-0.05743809944907876,-21.76,IS,0.41,0.0,Phase3-EA-SA2v2-EURCHF-M5-43,EURCHFMT4,9366,8h 20m,Buy
196184.51,1.0582,01.04.2020 10:45:00,,0.0,-210.76000000006752,0.0,0.0,1.05951,01.04.2020 02:00:00,18182,-0.07359060085037954,-46.26,IS,0.34,0.0,Phase3-EA-S4v1-EURCHF-M15-221,EURCHFMT4,4806,8h 45m,Buy
196289.67,117386,01.04.2020 16:59:58,tp 117.386,-0.29,-105.60000000009313,0.0,0.0,118646,31.03.2020 17:30:00,18183,-0.03687211733632778,105.16,IS,0.09,0.0,Phase3-EA-TR1v1-EURJPY-M30-91,EURJPYMT4,3164,23h 29m,Sell
196341.12,107052,01.04.2020 23:30:00,,0.0,-54.15000000008149,0.0,0.0,107256,01.04.2020 21:45:00,18184,-0.01890743516821395,51.45,IS,0.27,0.0,Phase3-EA-S1v2-USDJPY-M15-0,USDJPYMT4,4996,1h 45m,Sell
196363.33,106962,01.04.2020 23:45:00,,0.0,-31.940000000060536,0.0,0.0,107.05,01.04.2020 23:30:00,18185,-0.011152418823139231,22.21,IS,0.27,0.0,Phase3-EA-S1v2-USDJPY-M15-0,USDJPYMT4,4998,15m 0s,Sell
196409.98,1.05823,01.04.2020 23:59:58,tp 1.05823,0.0,-0.0,0.0,0.0,1.05713,01.04.2020 22:00:00,18186,-0.0,46.65,IS,0.41,0.0,Phase3-EA-SA2v2-EURCHF-M5-43,EURCHFMT4,9368,1h 59m,Buy
196456.71,1.05741,02.04.2020 01:19:58,tp 1.05741,0.0,-0.0,0.0,0.0,1.05851,02.04.2020 00:15:00,18187,-0.0,46.73,IS,0.41,0.0,Phase3-EA-SA2v2-EURCHF-M5-43,EURCHFMT4,9370,1h 4m,Sell
196503.48,1.0575,02.04.2020 02:04:58,tp 1.05750,0.0,-0.0,0.0,0.0,1.0564,02.04.2020 01:45:00,18188,-0.0,46.77,IS,0.41,0.0,Phase3-EA-SA2v2-EURCHF-M5-43,EURCHFMT4,9372,19m 58s,Buy
196543.58,1.05832,02.04.2020 10:45:00,,0.0,-0.0,0.0,0.0,1.05718,02.04.2020 02:00:00,18189,-0.0,40.1,IS,0.34,0.0,Phase3-EA-S4v1-EURCHF-M15-221,EURCHFMT4,4808,8h 45m,Buy
196811.79,116677,02.04.2020 16:59:58,tp 116.677,-1.67,-0.0,0.0,0.0,118377,01.04.2020 10:00:00,18190,-0.0,268.21,IS,0.17,0.0,Phase3-EA-T1v2-EURJPY-M15-322,EURJPYMT4,3608,1d 6h 59m,Sell
196871.38,0.97339,02.04.2020 22:59:58,tp 0.97339,0.0,-0.0,0.0,0.0,0.97439,02.04.2020 22:15:00,18191,-0.0,59.59,IS,0.58,0.0,Phase3-EA-SA2v2-USDCHF-M15-107,USDCHFMT4,3648,44m 58s,Sell
196917.71,1.05639,02.04.2020 23:44:58,tp 1.05639,0.0,-0.0,0.0,0.0,1.05529,02.04.2020 21:45:00,18192,-0.0,46.33,IS,0.41,0.0,Phase3-EA-SA2v2-EURCHF-M5-43,EURCHFMT4,9374,1h 59m,Buy
196964.03,1.05595,03.04.2020 01:04:58,tp 1.05595,0.0,-0.0,0.0,0.0,1.05705,03.04.2020 00:25:00,18193,-0.0,46.32,IS,0.41,0.0,Phase3-EA-SA2v2-EURCHF-M5-43,EURCHFMT4,9376,39m 58s,Sell
197010.42,1.05575,03.04.2020 01:39:57,tp 1.05575,0.0,-0.0,0.0,0.0,1.05465,03.04.2020 01:35:00,18194,-0.0,46.39,IS,0.41,0.0,Phase3-EA-SA2v2-EURCHF-M5-43,EURCHFMT4,9378,4m 57s,Buy
197020.69,107823,03.04.2020 01:45:00,,0.0,-0.0,0.0,0.0,107866,03.04.2020 00:30:00,18195,-0.0,10.27,IS,0.27,0.0,Phase3-EA-S1v2-USDJPY-M15-0,USDJPYMT4,5000,1h 15m,Buy
197047.45,107973,03.04.2020 02:15:00,,0.0,-0.0,0.0,0.0,107864,03.04.2020 00:30:00,18196,-0.0,26.76,IS,0.27,0.0,Phase3-EA-S1v2-USDJPY-M15-0,USDJPYMT4,5001,1h 45m,Sell
197010.67,117287,03.04.2020 02:29:58,sl 117.287,-0.55,-36.78000000002794,0.0,0.0,117057,02.04.2020 20:30:00,18197,-0.012813212589078148,-36.78,IS,0.17,0.0,Phase3-EA-T1v2-EURJPY-M15-322,EURJPYMT4,3610,5h 59m,Sell
197093.73,133625,03.04.2020 04:24:57,tp 133.625,0.0,-0.0,0.0,0.0,134015,03.04.2020 03:15:00,18198,-0.0,83.06,IS,0.23,0.0,Phase3-EA-S4v1-GBPJPY-M5-194,GBPJPYMT4,3944,1h 9m,Sell
197112.24,1.0562,03.04.2020 09:45:00,,0.0,-0.0,0.0,0.0,1.05673,03.04.2020 01:00:00,18199,-0.0,18.51,IS,0.34,0.0,Phase3-EA-S4v1-EURCHF-M15-221,EURCHFMT4,4810,8h 45m,Sell
197076.18,117289,03.04.2020 13:59:58,sl 117.289,0.0,-36.05999999999767,0.0,0.0,117059,03.04.2020 07:45:00,18200,-0.012559548140475496,-36.06,IS,0.17,0.0,Phase3-EA-T1v2-EURJPY-M15-322,EURJPYMT4,3612,6h 14m,Sell
197059.75,108469,03.04.2020 18:00:00,,0.0,-52.48999999999069,0.0,0.0,108535,03.04.2020 17:45:00,18201,-0.018282048860052257,-16.43,IS,0.27,0.0,Phase3-EA-S1v2-USDJPY-M15-0,USDJPYMT4,5004,15m 0s,Buy
197060.5,108506,03.04.2020 19:30:00,,0.0,-51.73999999999069,0.0,0.0,108503,03.04.2020 19:00:00,18202,-0.01802082697693087,0.75,IS,0.27,0.0,Phase3-EA-S1v2-USDJPY-M15-0,USDJPYMT4,5006,30m 0s,Buy
197079.4,108584,03.04.2020 19:45:00,,0.0,-32.839999999967404,0.0,0.0,108508,03.04.2020 19:30:00,18203,-0.011438035522263797,18.9,IS,0.27,0.0,Phase3-EA-S1v2-USDJPY-M15-0,USDJPYMT4,5008,15m 0s,Buy
197062.98,108.52,03.04.2020 20:00:00,,0.0,-49.259999999951106,0.0,0.0,108586,03.04.2020 19:45:00,18204,-0.017157053283395694,-16.42,IS,0.27,0.0,Phase3-EA-S1v2-USDJPY-M15-0,USDJPYMT4,5010,15m 0s,Buy
197121.7,0.97588,06.04.2020 01:14:58,tp 0.97588,-0.71,-0.0,0.0,0.0,0.97488,03.04.2020 23:30:00,18205,-0.0,58.72,IS,0.58,0.0,Phase3-EA-SA2v2-USDCHF-M15-107,USDCHFMT4,3650,2d 1h 44m,Buy
197204.37,132947,06.04.2020 02:04:58,tp 132.947,0.0,-0.0,0.0,0.0,132557,06.04.2020 01:10:00,18206,-0.0,82.67,IS,0.23,0.0,Phase3-EA-S4v1-GBPJPY-M5-194,GBPJPYMT4,3946,54m 58s,Buy
197249.51,1.05614,06.04.2020 02:04:58,tp 1.05614,-1.01,-0.0,0.0,0.0,1.05504,03.04.2020 23:30:00,18207,-0.0,45.14,IS,0.41,0.0,Phase3-EA-SA2v2-EURCHF-M5-43,EURCHFMT4,9380,2d 2h 34m,Buy
197188.56,118087,06.04.2020 09:59:58,sl 118.087,-1.46,-60.95000000001164,0.0,0.0,117367,01.04.2020 17:00:00,18208,-0.02121848702196617,-60.95,IS,0.09,0.0,Phase3-EA-TR1v1-EURJPY-M30-91,EURJPYMT4,3166,4d 16h 59m,Sell
197162.12,1.05712,06.04.2020 10:40:00,,0.0,-87.39000000001397,0.0,0.0,1.05649,06.04.2020 02:20:00,18209,-0.030423028397859982,-26.44,IS,0.41,0.0,Phase3-EA-SA2v2-EURCHF-M5-43,EURCHFMT4,9382,8h 20m,Sell
197147.51,1.05695,06.04.2020 11:15:00,,0.0,-102.0,0.0,0.0,1.05653,06.04.2020 02:30:00,18210,-0.03550919895389887,-14.61,IS,0.34,0.0,Phase3-EA-S4v1-EURCHF-M15-221,EURCHFMT4,4812,8h 45m,Sell
197206.81,0.9781,07.04.2020 03:59:57,tp 0.97810,0.0,-42.70000000001164,0.0,0.0,0.9791,07.04.2020 02:30:00,18211,-0.014865125444430343,59.3,IS,0.58,0.0,Phase3-EA-SA2v2-USDCHF-M15-107,USDCHFMT4,3652,1h 29m,Sell
197170.96,117579,07.04.2020 04:44:58,sl 117.579,0.0,-78.54999999998836,0.0,0.0,117809,07.04.2020 00:30:00,18212,-0.027345564488513163,-35.85,IS,0.17,0.0,Phase3-EA-T1v2-EURJPY-M15-322,EURJPYMT4,3614,4h 14m,Buy
197127.78,133256,07.04.2020 05:05:00,,-0.76,-121.72999999998137,0.0,0.0,133457,06.04.2020 23:40:00,18213,-0.04237779204566125,-43.18,IS,0.23,0.0,Phase3-EA-S4v1-GBPJPY-M5-194,GBPJPYMT4,3948,5h 25m,Buy
197172.91,1.05658,07.04.2020 06:54:58,tp 1.05658,-1.01,-76.59999999997672,0.0,0.0,1.05548,06.04.2020 23:50:00,18214,-0.026666712155566926,45.13,IS,0.41,0.0,Phase3-EA-SA2v2-EURCHF-M5-43,EURCHFMT4,9384,7h 4m,Buy
197108.3,118624,07.04.2020 14:29:58,sl 118.624,-0.29,-141.20999999996275,0.0,0.0,117844,06.04.2020 13:00:00,18215,-0.04915935278704644,-64.61,IS,0.09,0.0,Phase3-EA-TR1v1-EURJPY-M30-91,EURJPYMT4,3168,1d 1h 29m,Sell
197236.98,118674,07.04.2020 23:00:00,,0.0,-12.529999999969732,0.0,0.0,117.85,07.04.2020 10:00:00,18216,-0.004362061400894883,128.68,IS,0.17,0.0,Phase3-EA-T1v2-EURJPY-M15-322,EURJPYMT4,3616,13h 0m,Buy
197261.99,0.96947,08.04.2020 02:30:00,,-0.72,-0.0,0.0,0.0,0.96904,07.04.2020 22:15:00,18217,-0.0,25.01,IS,0.58,0.0,Phase3-EA-SA2v2-USDCHF-M15-107,USDCHFMT4,3654,4h 15m,Buy
197233.86,134008,08.04.2020 06:35:00,,0.0,-28.130000000004657,0.0,0.0,134141,08.04.2020 01:10:00,18218,-0.009792454616082186,-28.13,IS,0.23,0.0,Phase3-EA-S4v1-GBPJPY-M5-194,GBPJPYMT4,3950,5h 25m,Buy
197196.98,1.0559,08.04.2020 07:00:00,,-1.02,-65.01000000000931,0.0,0.0,1.05675,07.04.2020 22:40:00,18219,-0.022630909157180544,-36.88,IS,0.41,0.0,Phase3-EA-SA2v2-EURCHF-M5-43,EURCHFMT4,9386,8h 20m,Buy
197210.63,1.05654,08.04.2020 09:45:00,,0.0,-51.35999999998603,0.0,0.0,1.05615,08.04.2020 01:00:00,18220,-0.01787914927414721,13.65,IS,0.34,0.0,Phase3-EA-S4v1-EURCHF-M15-221,EURCHFMT4,4814,8h 45m,Buy
197150.66,118006,08.04.2020 10:29:58,sl 118.006,-0.41,-111.32999999995809,0.0,0.0,118726,07.04.2020 14:30:00,18221,-0.03875556247450547,-59.97,IS,0.09,0.0,Phase3-EA-TR1v1-EURJPY-M30-91,EURJPYMT4,3170,19h 59m,Buy
197114.76,118262,08.04.2020 13:14:58,sl 118.262,0.0,-147.22999999998137,0.0,0.0,118032,08.04.2020 10:15:00,18222,-0.051252865024008505,-35.9,IS,0.17,0.0,Phase3-EA-T1v2-EURJPY-M15-322,EURJPYMT4,3618,2h 59m,Sell
197174.47,0.97133,09.04.2020 00:59:59,tp 0.97133,0.0,-87.51999999996042,0.0,0.0,0.97233,09.04.2020 00:45:00,18223,-0.030466961535690847,59.71,IS,0.58,0.0,Phase3-EA-SA2v2-USDCHF-M15-107,USDCHFMT4,3656,14m 59s,Sell
197256.83,135004,09.04.2020 03:24:58,tp 135.004,0.0,-5.159999999974389,0.0,0.0,134614,09.04.2020 01:25:00,18224,-0.0017962696700577646,82.36,IS,0.23,0.0,Phase3-EA-S4v1-GBPJPY-M5-194,GBPJPYMT4,3952,1h 59m,Buy
197284.61,1.05578,09.04.2020 04:55:00,,-3.04,-0.0,0.0,0.0,1.05505,08.04.2020 20:35:00,18225,-0.0,27.78,IS,0.41,0.0,Phase3-EA-SA2v2-EURCHF-M5-43,EURCHFMT4,9388,8h 20m,Buy
197248.53,118439,09.04.2020 20:14:58,sl 118.439,0.0,-36.0800000000163,0.0,0.0,118669,09.04.2020 17:00:00,18226,-0.012558974182437463,-36.08,IS,0.17,0.0,Phase3-EA-T1v2-EURJPY-M15-322,EURJPYMT4,3620,3h 14m,Buy
197247.51,1.0561,10.04.2020 04:25:00,,-1.02,-37.100000000034925,0.0,0.0,1.0561,09.04.2020 20:05:00,18227,-0.012914022787379657,-1.02,IS,0.41,0.0,Phase3-EA-SA2v2-EURCHF-M5-43,EURCHFMT4,9390,8h 20m,Buy
197225.75,108561,10.04.2020 05:00:00,,-1.12,-58.86000000004424,0.0,0.0,108478,09.04.2020 23:00:00,18228,-0.020488393026011385,-21.76,IS,0.27,0.0,Phase3-EA-S1v2-USDJPY-M15-0,USDJPYMT4,5012,6h 0m,Sell
197271.46,1.05631,13.04.2020 01:09:57,tp 1.05631,-1.02,-13.150000000023283,0.0,0.0,1.05521,10.04.2020 21:35:00,18229,-0.004577342308738094,45.71,IS,0.41,0.0,Phase3-EA-SA2v2-EURCHF-M5-43,EURCHFMT4,9392,2d 3h 34m,Buy
197328.41,0.96444,13.04.2020 01:14:58,tp 0.96444,-3.19,-0.0,0.0,0.0,0.96544,10.04.2020 22:15:00,18230,-0.0,56.95,IS,0.58,0.0,Phase3-EA-SA2v2-USDCHF-M15-107,USDCHFMT4,3658,2d 2h 59m,Sell
197285.81,134909,13.04.2020 04:35:00,,-0.76,-42.59999999997672,0.0,0.0,135106,10.04.2020 23:10:00,18231,-0.014826240120138678,-42.6,IS,0.23,0.0,Phase3-EA-S4v1-GBPJPY-M5-194,GBPJPYMT4,3954,2d 5h 25m,Buy
197547.22,1.24898,13.04.2020 10:29:58,tp 1.24898,-3.19,-0.0,0.0,0.0,1.23008,07.04.2020 10:30:00,18232,-0.0,261.41,IS,0.14,0.0,Phase3-EA-B1v1-GBPUSD-M30-14,GBPUSDMT4,1228,5d 23h 59m,Buy
197505.22,1.24781,13.04.2020 15:29:57,sl 1.24781,0.0,-42.0,0.0,0.0,1.25081,13.04.2020 10:30:00,18233,-0.014606296663205379,-42.0,IS,0.14,0.0,Phase3-EA-B1v1-GBPUSD-M30-14,GBPUSDMT4,1230,4h 59m,Buy
197526.43,107546,14.04.2020 04:15:00,,-1.13,-20.789999999979045,0.0,0.0,107635,13.04.2020 23:45:00,18234,-0.0072301168482793755,21.21,IS,0.27,0.0,Phase3-EA-S1v2-USDJPY-M15-0,USDJPYMT4,5014,4h 30m,Sell
197533.47,1.05523,14.04.2020 05:35:00,,-1.02,-13.75,0.0,0.0,1.05504,13.04.2020 21:15:00,18235,-0.004781823312358904,7.04,IS,0.41,0.0,Phase3-EA-SA2v2-EURCHF-M5-43,EURCHFMT4,9394,8h 20m,Buy
197492.85,134985,14.04.2020 05:50:00,,0.0,-54.36999999999534,0.0,0.0,134795,14.04.2020 00:25:00,18236,-0.018908198799485916,-40.62,IS,0.23,0.0,Phase3-EA-S4v1-GBPJPY-M5-194,GBPJPYMT4,3956,5h 25m,Sell
197472.03,1.05456,14.04.2020 14:15:00,,0.0,-75.19000000000233,0.0,0.0,1.05515,14.04.2020 05:30:00,18237,-0.026148748716820155,-20.82,IS,0.34,0.0,Phase3-EA-S4v1-EURCHF-M15-221,EURCHFMT4,4816,8h 45m,Buy
197435.57,117528,14.04.2020 19:14:58,sl 117.528,0.0,-111.65000000002328,0.0,0.0,117758,14.04.2020 17:15:00,18238,-0.038828405296362396,-36.46,IS,0.17,0.0,Phase3-EA-T1v2-EURJPY-M15-322,EURJPYMT4,3622,1h 59m,Buy
197474.81,107006,15.04.2020 04:15:00,,-1.13,-72.4100000000326,0.0,0.0,107166,14.04.2020 23:45:00,18239,-0.025181950985313752,39.24,IS,0.27,0.0,Phase3-EA-S1v2-USDJPY-M15-0,USDJPYMT4,5016,4h 30m,Sell
197517.08,0.96048,15.04.2020 05:45:00,,0.0,-30.14000000001397,0.0,0.0,0.95978,15.04.2020 01:30:00,18240,-0.010481756700695576,42.27,IS,0.58,0.0,Phase3-EA-SA2v2-USDCHF-M15-107,USDCHFMT4,3660,4h 15m,Buy
197501.7,1.0547,15.04.2020 06:20:00,,-2.14,-45.52000000001863,0.0,0.0,1.05439,14.04.2020 22:00:00,18241,-0.015830443431175737,-15.38,IS,0.41,0.0,Phase3-EA-SA2v2-EURCHF-M5-43,EURCHFMT4,9396,8h 20m,Sell
197609.2,117272,15.04.2020 11:59:57,tp 117.272,-0.87,-0.0,0.0,0.0,118562,10.04.2020 21:30:00,18242,-0.0,107.5,IS,0.09,0.0,Phase3-EA-TR1v1-EURJPY-M30-91,EURJPYMT4,3172,4d 14h 29m,Sell
197654.26,1.05345,15.04.2020 14:45:00,,0.0,-0.0,0.0,0.0,1.05473,15.04.2020 06:00:00,18243,-0.0,45.06,IS,0.34,0.0,Phase3-EA-S4v1-EURCHF-M15-221,EURCHFMT4,4818,8h 45m,Sell
197759.29,116.88,15.04.2020 16:59:58,tp 116.880,-0.58,-0.0,0.0,0.0,118.14,13.04.2020 08:00:00,18244,-0.0,105.03,IS,0.09,0.0,Phase3-EA-TR1v1-EURJPY-M30-91,EURJPYMT4,3173,2d 8h 59m,Sell
197703.13,134739,15.04.2020 21:29:58,sl 134.739,0.0,-56.15999999997439,0.0,0.0,134069,15.04.2020 16:00:00,18245,-0.01951631170620909,-56.16,IS,0.09,0.0,Phase3-EA-B1v1-GBPJPY-M30-1,GBPJPYMT4,1618,5h 29m,Sell
197763.34,0.96337,15.04.2020 22:59:58,tp 0.96337,0.0,-0.0,0.0,0.0,0.96237,15.04.2020 22:30:00,18246,-0.0,60.21,IS,0.58,0.0,Phase3-EA-SA2v2-USDCHF-M15-107,USDCHFMT4,3662,29m 58s,Buy
197804.83,107381,16.04.2020 01:15:00,,0.0,-0.0,0.0,0.0,107546,16.04.2020 00:15:00,18247,-0.0,41.49,IS,0.27,0.0,Phase3-EA-S1v2-USDJPY-M15-0,USDJPYMT4,5018,1h 0m,Sell
197768.45,117.25,16.04.2020 03:44:58,sl 117.250,0.0,-36.38000000000466,0.0,0.0,117.02,16.04.2020 01:45:00,18248,-0.012640510584900367,-36.38,IS,0.17,0.0,Phase3-EA-T1v2-EURJPY-M15-322,EURJPYMT4,3624,1h 59m,Sell
197851.78,134821,16.04.2020 04:09:58,tp 134.821,0.0,-0.0,0.0,0.0,134431,16.04.2020 01:10:00,18249,-0.0,83.33,IS,0.23,0.0,Phase3-EA-S4v1-GBPJPY-M5-194,GBPJPYMT4,3958,2h 59m,Buy
197838.13,1.05242,16.04.2020 07:30:00,,-3.06,-13.650000000023283,0.0,0.0,1.05267,15.04.2020 23:10:00,18250,-0.004742023829077321,-13.65,IS,0.41,0.0,Phase3-EA-SA2v2-EURCHF-M5-43,EURCHFMT4,9398,8h 20m,Buy
197781.11,134127,16.04.2020 18:29:58,sl 134.127,-0.9,-70.67000000004191,0.0,0.0,134797,15.04.2020 22:30:00,18251,-0.024550829597107797,-57.02,IS,0.09,0.0,Phase3-EA-B1v1-GBPJPY-M30-1,GBPJPYMT4,1620,19h 59m,Buy
197840.97,0.96893,17.04.2020 01:59:58,tp 0.96893,0.0,-10.81000000005588,0.0,0.0,0.96993,17.04.2020 00:30:00,18252,-0.00375540495183175,59.86,IS,0.58,0.0,Phase3-EA-SA2v2-USDCHF-M15-107,USDCHFMT4,3664,1h 29m,Sell
197886.48,1.05211,17.04.2020 02:04:58,tp 1.05211,-1.02,-0.0,0.0,0.0,1.05101,16.04.2020 20:45:00,18253,-0.0,45.51,IS,0.41,0.0,Phase3-EA-SA2v2-EURCHF-M5-43,EURCHFMT4,9400,5h 19m,Buy
197820.91,134706,17.04.2020 06:35:00,,0.0,-65.57000000000698,0.0,0.0,134399,17.04.2020 01:10:00,18254,-0.02277633878465106,-65.57,IS,0.23,0.0,Phase3-EA-S4v1-GBPJPY-M5-194,GBPJPYMT4,3960,5h 25m,Sell
197806.53,1.05234,17.04.2020 10:45:00,,0.0,-79.95000000001164,0.0,0.0,1052,17.04.2020 02:25:00,18255,-0.027771363212336794,-14.38,IS,0.41,0.0,Phase3-EA-SA2v2-EURCHF-M5-43,EURCHFMT4,9402,8h 20m,Sell
197833.16,1.05157,17.04.2020 12:45:00,,0.0,-53.320000000006985,0.0,0.0,1.05233,17.04.2020 04:00:00,18256,-0.01852118932434992,26.63,IS,0.34,0.0,Phase3-EA-S4v1-EURCHF-M15-221,EURCHFMT4,4820,8h 45m,Sell
197876.26,107439,20.04.2020 01:15:00,,-1.13,-10.220000000030268,0.0,0.0,107615,17.04.2020 20:30:00,18257,-0.0035500104068903224,43.1,IS,0.27,0.0,Phase3-EA-S1v2-USDJPY-M15-0,USDJPYMT4,5020,2d 4h 45m,Sell
197839.93,117012,20.04.2020 03:59:57,sl 117.012,0.0,-46.550000000046566,0.0,0.0,116782,20.04.2020 01:30:00,18258,-0.01616956794916051,-36.33,IS,0.17,0.0,Phase3-EA-T1v2-EURJPY-M15-322,EURJPYMT4,3626,2h 29m,Sell
197817.36,117005,20.04.2020 22:15:00,,0.0,-69.12000000005355,0.0,0.0,117148,20.04.2020 18:30:00,18259,-0.024009463730305526,-22.57,IS,0.17,0.0,Phase3-EA-T1v2-EURJPY-M15-322,EURJPYMT4,3628,3h 45m,Buy
197877.32,0.96725,21.04.2020 01:14:58,tp 0.96725,0.0,-9.160000000032596,0.0,0.0,0.96825,21.04.2020 00:15:00,18260,-0.0031818097188977264,59.96,IS,0.58,0.0,Phase3-EA-SA2v2-USDCHF-M15-107,USDCHFMT4,3666,59m 58s,Sell
197848.79,133905,21.04.2020 04:30:00,,-0.77,-37.690000000060536,0.0,0.0,134035,20.04.2020 23:05:00,18261,-0.013091965972163883,-28.53,IS,0.23,0.0,Phase3-EA-S4v1-GBPJPY-M5-194,GBPJPYMT4,3962,5h 25m,Buy
197860.71,1.05148,21.04.2020 10:30:00,,0.0,-25.770000000076834,0.0,0.0,1.05114,21.04.2020 01:45:00,18262,-0.008951445027941823,11.92,IS,0.34,0.0,Phase3-EA-S4v1-EURCHF-M15-221,EURCHFMT4,4822,8h 45m,Buy
197861.56,1.05161,21.04.2020 10:35:00,,0.0,-24.920000000100117,0.0,0.0,1.05163,21.04.2020 02:15:00,18263,-0.008656189759275953,0.85,IS,0.41,0.0,Phase3-EA-SA2v2-EURCHF-M5-43,EURCHFMT4,9404,8h 20m,Sell
198125.47,1.22838,21.04.2020 16:59:58,tp 1.22838,-0.69,-0.0,0.0,0.0,1.24728,20.04.2020 09:30:00,18264,-0.0,263.91,IS,0.14,0.0,Phase3-EA-B1v1-GBPUSD-M30-14,GBPUSDMT4,1232,1d 7h 29m,Sell
198117.44,1.05267,22.04.2020 05:35:00,,-2.11,-8.03000000002794,0.0,0.0,1.05253,21.04.2020 21:15:00,18265,-0.002786980269404128,-8.03,IS,0.41,0.0,Phase3-EA-SA2v2-EURCHF-M5-43,EURCHFMT4,9406,8h 20m,Sell
198144.12,132.46,22.04.2020 06:35:00,,0.0,-0.0,0.0,0.0,132335,22.04.2020 01:10:00,18266,-0.0,26.68,IS,0.23,0.0,Phase3-EA-S4v1-GBPJPY-M5-194,GBPJPYMT4,3964,5h 25m,Buy
198127.71,116937,22.04.2020 07:00:00,,0.0,-16.40999999997439,0.0,0.0,117041,22.04.2020 05:00:00,18267,-0.005695066760333104,-16.41,IS,0.17,0.0,Phase3-EA-T1v2-EURJPY-M15-322,EURJPYMT4,3630,2h 0m,Buy
198091.48,116728,22.04.2020 18:59:58,sl 116.728,0.0,-52.63999999995576,0.0,0.0,116958,22.04.2020 13:45:00,18268,-0.0182686358479068,-36.23,IS,0.17,0.0,Phase3-EA-T1v2-EURJPY-M15-322,EURJPYMT4,3632,5h 14m,Buy
198086.33,1.05136,23.04.2020 04:50:00,,-3.04,-57.789999999979045,0.0,0.0,1.05141,22.04.2020 20:30:00,18269,-0.02005593589762611,-5.15,IS,0.41,0.0,Phase3-EA-SA2v2-EURCHF-M5-43,EURCHFMT4,9408,8h 20m,Buy
198132.53,1.05282,23.04.2020 22:49:57,tp 1.05282,0.0,-11.589999999967404,0.0,0.0,1.05172,23.04.2020 22:00:00,18270,-0.004022292733222307,46.2,IS,0.41,0.0,Phase3-EA-SA2v2-EURCHF-M5-43,EURCHFMT4,9410,49m 57s,Buy
198176.59,1.0518,24.04.2020 00:29:58,tp 1.05180,-2.1,-0.0,0.0,0.0,1.0529,23.04.2020 23:00:00,18271,-0.0,44.06,IS,0.41,0.0,Phase3-EA-SA2v2-EURCHF-M5-43,EURCHFMT4,9412,1h 29m,Sell
198278.71,115544,24.04.2020 11:29:58,tp 115.544,-3.21,-0.0,0.0,0.0,116804,15.04.2020 17:00:00,18272,-0.0,102.12,IS,0.09,0.0,Phase3-EA-TR1v1-EURJPY-M30-91,EURJPYMT4,3176,8d 18h 29m,Sell
198338.3,0.97338,27.04.2020 02:14:57,tp 0.97338,0.0,-0.0,0.0,0.0,0.97238,27.04.2020 01:15:00,18273,-0.0,59.59,IS,0.58,0.0,Phase3-EA-SA2v2-USDCHF-M15-107,USDCHFMT4,3668,59m 57s,Buy
198309.24,1.05371,27.04.2020 05:40:00,,-2.1,-29.05999999999767,0.0,0.0,1.05307,24.04.2020 21:20:00,18274,-0.010078439111279204,-29.06,IS,0.41,0.0,Phase3-EA-SA2v2-EURCHF-M5-43,EURCHFMT4,9414,2d 8h 20m,Sell
198265.59,133205,27.04.2020 06:45:00,,0.0,-72.71000000002095,0.0,0.0,133001,27.04.2020 01:20:00,18275,-0.02521690666832006,-43.65,IS,0.23,0.0,Phase3-EA-S4v1-GBPJPY-M5-194,GBPJPYMT4,3966,5h 25m,Sell
198358.96,1.05525,27.04.2020 10:45:00,,0.0,-0.0,0.0,0.0,1.05258,27.04.2020 02:00:00,18276,-0.0,93.37,IS,0.34,0.0,Phase3-EA-S4v1-EURCHF-M15-221,EURCHFMT4,4824,8h 45m,Buy
198360.89,1.05638,28.04.2020 04:40:00,,-1.01,-0.0,0.0,0.0,1.05631,27.04.2020 20:20:00,18277,-0.0,1.93,IS,0.41,0.0,Phase3-EA-SA2v2-EURCHF-M5-43,EURCHFMT4,9416,8h 20m,Buy
198330.19,106857,29.04.2020 02:00:00,,-1.14,-30.70000000001164,0.0,0.0,106.74,28.04.2020 18:00:00,18278,-0.010646381345268956,-30.7,IS,0.27,0.0,Phase3-EA-S1v2-USDJPY-M15-0,USDJPYMT4,5022,8h 0m,Sell
198281.59,1.0548,29.04.2020 04:25:00,,-1.01,-79.29999999998836,0.0,0.0,1.05593,28.04.2020 20:05:00,18279,-0.02750026191138059,-48.6,IS,0.41,0.0,Phase3-EA-SA2v2-EURCHF-M5-43,EURCHFMT4,9418,8h 20m,Buy
198315.12,1.05573,29.04.2020 10:30:00,,0.0,-45.76999999996042,0.0,0.0,1.05477,29.04.2020 01:45:00,18280,-0.01587247147141218,33.53,IS,0.34,0.0,Phase3-EA-S4v1-EURCHF-M15-221,EURCHFMT4,4826,8h 45m,Buy
198299.14,1.05905,30.04.2020 04:40:00,,-6.31,-61.74999999994179,0.0,0.0,1.05882,29.04.2020 20:20:00,18281,-0.02141413837359899,-15.98,IS,0.41,0.0,Phase3-EA-SA2v2-EURCHF-M5-43,EURCHFMT4,9420,8h 20m,Sell
198256.91,116924,30.04.2020 18:59:57,sl 116.924,-5.54,-103.97999999992317,0.0,0.0,116694,22.04.2020 19:15:00,18282,-0.03605898150748626,-42.23,IS,0.17,0.0,Phase3-EA-T1v2-EURJPY-M15-322,EURJPYMT4,3634,7d 23h 44m,Sell
198194.9,133819,30.04.2020 18:59:58,sl 133.819,-5.36,-165.98999999993248,0.0,0.0,133149,21.04.2020 12:00:00,18283,-0.05756328467426075,-62.01,IS,0.09,0.0,Phase3-EA-B1v1-GBPJPY-M30-1,GBPJPYMT4,1622,9d 6h 59m,Sell
198127.48,117065,30.04.2020 18:59:58,sl 117.065,-1.47,-233.40999999991618,0.0,0.0,116285,27.04.2020 08:00:00,18284,-0.08094370911392157,-67.42,IS,0.09,0.0,Phase3-EA-TR1v1-EURJPY-M30-91,EURJPYMT4,3178,3d 10h 59m,Sell
198065.71,116.32,30.04.2020 18:59:58,sl 116.320,-0.89,-295.1799999999348,0.0,0.0,115.6,29.04.2020 05:30:00,18285,-0.10236478324086659,-61.77,IS,0.09,0.0,Phase3-EA-TR1v1-EURJPY-M30-91,EURJPYMT4,3179,1d 13h 29m,Sell
198090.81,0.96606,01.05.2020 02:15:00,,-0.72,-270.0799999999581,0.0,0.0,0.96563,30.04.2020 22:00:00,18286,-0.09366041282503919,25.1,IS,0.58,0.0,Phase3-EA-SA2v2-USDCHF-M15-107,USDCHFMT4,3670,4h 15m,Buy
198173.35,134672,01.05.2020 02:24:57,tp 134.672,-1.24,-187.53999999997905,0.0,0.0,135062,30.04.2020 23:10:00,18287,-0.06503655887592051,82.54,IS,0.23,0.0,Phase3-EA-S4v1-GBPJPY-M5-194,GBPJPYMT4,3968,3h 14m,Sell
198227.17,107361,01.05.2020 04:15:00,,0.0,-133.71999999997206,0.0,0.0,107147,01.05.2020 01:15:00,18288,-0.046372446693437375,53.82,IS,0.27,0.0,Phase3-EA-S1v2-USDJPY-M15-0,USDJPYMT4,5024,3h 0m,Buy
198271.75,1.05649,01.05.2020 06:29:58,tp 1.05649,-2.12,-89.13999999995576,0.0,0.0,1.05759,30.04.2020 23:05:00,18289,-0.03091265254450957,44.58,IS,0.41,0.0,Phase3-EA-SA2v2-EURCHF-M5-43,EURCHFMT4,9422,7h 24m,Sell
198261.73,117304,01.05.2020 13:00:00,,0.0,-99.15999999997439,0.0,0.0,117367,01.05.2020 10:45:00,18290,-0.03438746495753083,-10.02,IS,0.17,0.0,Phase3-EA-T1v2-EURJPY-M15-322,EURJPYMT4,3636,2h 15m,Buy
198258.55,1.05683,01.05.2020 14:45:00,,0.0,-102.3399999999674,0.0,0.0,1.05692,01.05.2020 06:00:00,18291,-0.035490249735311556,-3.18,IS,0.34,0.0,Phase3-EA-S4v1-EURCHF-M15-221,EURCHFMT4,4828,8h 45m,Buy
198254.89,117247,01.05.2020 15:30:00,,0.0,-105.99999999994179,0.0,0.0,117.27,01.05.2020 14:15:00,18292,-0.03675949259275119,-3.66,IS,0.17,0.0,Phase3-EA-T1v2-EURJPY-M15-322,EURJPYMT4,3638,1h 15m,Buy
198218.25,117369,01.05.2020 19:59:58,sl 117.369,0.0,-142.63999999995576,0.0,0.0,117599,01.05.2020 18:15:00,18293,-0.04946579267388003,-36.64,IS,0.17,0.0,Phase3-EA-T1v2-EURJPY-M15-322,EURJPYMT4,3640,1h 44m,Buy
198275.44,0.96046,04.05.2020 01:14:57,tp 0.96046,-3.2,-85.44999999995343,0.0,0.0,0.96146,01.05.2020 23:15:00,18294,-0.029633006057081156,57.19,IS,0.58,0.0,Phase3-EA-SA2v2-USDCHF-M15-107,USDCHFMT4,3672,2d 1h 59m,Sell
198274.55,106768,04.05.2020 01:15:00,,-1.14,-86.3399999999674,0.0,0.0,106769,01.05.2020 17:45:00,18295,-0.029941647079798895,-0.89,IS,0.27,0.0,Phase3-EA-S1v2-USDJPY-M15-0,USDJPYMT4,5026,2d 7h 30m,Sell
198188.96,132931,04.05.2020 06:45:00,,0.0,-171.92999999999302,0.0,0.0,133328,04.05.2020 01:20:00,18296,-0.05962320341014082,-85.59,IS,0.23,0.0,Phase3-EA-S4v1-GBPJPY-M5-194,GBPJPYMT4,3970,5h 25m,Buy
198139.0,0.9636,04.05.2020 07:00:00,,0.0,-221.89000000001397,0.0,0.0,0.96277,04.05.2020 02:45:00,18297,-0.07694871520198637,-49.96,IS,0.58,0.0,Phase3-EA-SA2v2-USDCHF-M15-107,USDCHFMT4,3674,4h 15m,Sell
198090.47,1054,04.05.2020 10:50:00,,0.0,-270.4200000000419,0.0,0.0,1.05514,04.05.2020 02:30:00,18298,-0.0937783206314979,-48.53,IS,0.41,0.0,Phase3-EA-SA2v2-EURCHF-M5-43,EURCHFMT4,9424,8h 20m,Buy
198037.93,1.05376,04.05.2020 11:45:00,,0.0,-322.96000000002095,0.0,0.0,1.05525,04.05.2020 03:00:00,18299,-0.11199854460153033,-52.54,IS,0.34,0.0,Phase3-EA-S4v1-EURCHF-M15-221,EURCHFMT4,4830,8h 45m,Buy
198094.86,0.96489,05.05.2020 00:59:59,tp 0.96489,-3.18,-266.03000000002794,0.0,0.0,0.96589,04.05.2020 22:30:00,18300,-0.09225592277788676,56.93,IS,0.58,0.0,Phase3-EA-SA2v2-USDCHF-M15-107,USDCHFMT4,3676,2h 29m,Sell
198102.34,1.05285,05.05.2020 04:30:00,,-1.02,-258.55000000004657,0.0,0.0,1.05265,04.05.2020 20:10:00,18301,-0.08966195103644106,7.48,IS,0.41,0.0,Phase3-EA-SA2v2-EURCHF-M5-43,EURCHFMT4,9426,8h 20m,Buy
198095.73,0.96488,05.05.2020 05:30:00,,0.0,-265.1600000000326,0.0,0.0,0.96499,05.05.2020 01:15:00,18302,-0.09195421750849488,-6.61,IS,0.58,0.0,Phase3-EA-SA2v2-USDCHF-M15-107,USDCHFMT4,3678,4h 15m,Buy
198126.36,1.05325,05.05.2020 10:00:00,,0.0,-234.53000000002794,0.0,0.0,1.05238,05.05.2020 01:15:00,18303,-0.08133211129984622,30.63,IS,0.34,0.0,Phase3-EA-S4v1-EURCHF-M15-221,EURCHFMT4,4832,8h 45m,Buy
198234.57,115932,05.05.2020 12:59:58,tp 115.932,-0.59,-126.32000000000698,0.0,0.0,117222,01.05.2020 03:00:00,18304,-0.04380621796527488,108.21,IS,0.09,0.0,Phase3-EA-TR1v1-EURJPY-M30-91,EURJPYMT4,3182,4d 9h 59m,Sell
198192.57,1.24414,05.05.2020 18:29:58,sl 1.24414,0.0,-168.32000000000698,0.0,0.0,1.24714,05.05.2020 18:00:00,18305,-0.058371299935995616,-42.0,IS,0.14,0.0,Phase3-EA-B1v1-GBPUSD-M30-14,GBPUSDMT4,1234,29m 58s,Buy
198298.71,115438,05.05.2020 20:59:57,tp 115.438,-0.3,-62.179999999993015,0.0,0.0,116698,04.05.2020 10:00:00,18306,-0.021563257069983657,106.14,IS,0.09,0.0,Phase3-EA-TR1v1-EURJPY-M30-91,EURJPYMT4,3183,1d 10h 59m,Sell
198357.6,0.97297,06.05.2020 00:59:57,tp 0.97297,-0.72,-3.2899999999790452,0.0,0.0,0.97197,05.05.2020 22:45:00,18307,-0.0011409314210325241,58.89,IS,0.58,0.0,Phase3-EA-SA2v2-USDCHF-M15-107,USDCHFMT4,3680,2h 14m,Buy
198339.05,1.05381,06.05.2020 09:10:00,,0.0,-21.839999999967404,0.0,0.0,1.05425,06.05.2020 00:50:00,18308,-0.007573842624763479,-18.55,IS,0.41,0.0,Phase3-EA-SA2v2-EURCHF-M5-43,EURCHFMT4,9428,8h 20m,Buy
198609.72,115.01,06.05.2020 12:14:58,tp 115.010,-1.12,-0.0,0.0,0.0,116.71,04.05.2020 18:45:00,18309,-0.0,270.67,IS,0.17,0.0,Phase3-EA-T1v2-EURJPY-M15-322,EURJPYMT4,3642,1d 17h 29m,Sell
198764.76,131579,06.05.2020 12:59:57,tp 131.579,-1.47,-0.0,0.0,0.0,133429,01.05.2020 22:00:00,18310,-0.0,155.04,IS,0.09,0.0,Phase3-EA-B1v1-GBPJPY-M30-1,GBPJPYMT4,1624,4d 14h 59m,Sell
198710.03,1.05242,06.05.2020 13:30:00,,0.0,-54.72999999998137,0.0,0.0,1.05399,06.05.2020 04:45:00,18311,-0.018953143728473374,-54.73,IS,0.34,0.0,Phase3-EA-S4v1-EURCHF-M15-221,EURCHFMT4,4834,8h 45m,Buy
198643.93,114467,06.05.2020 18:59:58,sl 114.467,0.0,-120.82999999995809,0.0,0.0,115247,06.05.2020 08:00:00,18312,-0.04184374852387032,-66.1,IS,0.09,0.0,Phase3-EA-TR1v1-EURJPY-M30-91,EURJPYMT4,3186,10h 59m,Buy
198610.09,0.97534,07.05.2020 03:30:00,,-9.46,-154.6699999999837,0.0,0.0,0.97493,06.05.2020 23:15:00,18313,-0.05356263001066445,-33.84,IS,0.58,0.0,Phase3-EA-SA2v2-USDCHF-M15-107,USDCHFMT4,3682,4h 15m,Sell
198615.47,1.05299,07.05.2020 08:15:00,,-3.03,-149.28999999997905,0.0,0.0,1.05279,06.05.2020 23:55:00,18314,-0.05169952178374485,5.38,IS,0.41,0.0,Phase3-EA-SA2v2-EURCHF-M5-43,EURCHFMT4,9430,8h 20m,Buy
198621.4,1.05268,07.05.2020 10:00:00,,0.0,-143.35999999998603,0.0,0.0,1.05251,07.05.2020 01:15:00,18315,-0.04964594710240458,5.93,IS,0.34,0.0,Phase3-EA-S4v1-EURCHF-M15-221,EURCHFMT4,4836,8h 45m,Buy
198563.14,131913,07.05.2020 11:29:58,sl 131.913,-1.48,-201.61999999999534,0.0,0.0,131243,06.05.2020 18:00:00,18316,-0.0698215391656498,-58.26,IS,0.09,0.0,Phase3-EA-B1v1-GBPJPY-M30-1,GBPJPYMT4,1626,17h 29m,Sell
198506.48,131228,07.05.2020 17:29:58,sl 131.228,0.0,-258.27999999996973,0.0,0.0,131898,07.05.2020 14:30:00,18317,-0.08944304699782926,-56.66,IS,0.09,0.0,Phase3-EA-B1v1-GBPJPY-M30-1,GBPJPYMT4,1628,2h 59m,Buy
198535.35,106603,07.05.2020 18:00:00,,0.0,-229.4099999999744,0.0,0.0,106489,07.05.2020 17:15:00,18318,-0.0794452896537561,28.87,IS,0.27,0.0,Phase3-EA-S1v2-USDJPY-M15-0,USDJPYMT4,5028,45m 0s,Buy
198542.46,106278,08.05.2020 05:45:00,,0.0,-222.29999999998836,0.0,0.0,106306,08.05.2020 01:30:00,18319,-0.07698307785201615,7.11,IS,0.27,0.0,Phase3-EA-S1v2-USDJPY-M15-0,USDJPYMT4,5030,4h 15m,Sell
198475.01,0.97164,08.05.2020 07:00:00,,0.0,-289.75,0.0,0.0,0.97277,08.05.2020 02:45:00,18320,-0.10034119121737674,-67.45,IS,0.58,0.0,Phase3-EA-SA2v2-USDCHF-M15-107,USDCHFMT4,3684,4h 15m,Buy
198476.28,1.05407,08.05.2020 08:00:00,,-2.11,-288.4799999999814,0.0,0.0,1.05415,07.05.2020 23:40:00,18321,-0.09990138685897143,1.27,IS,0.41,0.0,Phase3-EA-SA2v2-EURCHF-M5-43,EURCHFMT4,9432,8h 20m,Sell
198526.69,1.05288,08.05.2020 13:15:00,,0.0,-238.07000000000698,0.0,0.0,1.05432,08.05.2020 04:30:00,18322,-0.0824442705543454,50.41,IS,0.34,0.0,Phase3-EA-S4v1-EURCHF-M15-221,EURCHFMT4,4838,8h 45m,Sell
198610.69,132503,11.05.2020 02:29:58,tp 132.503,0.0,-154.07000000000698,0.0,0.0,132113,11.05.2020 01:10:00,18323,-0.053354848424027386,84.0,IS,0.23,0.0,Phase3-EA-S4v1-GBPJPY-M5-194,GBPJPYMT4,3972,1h 19m,Buy
198717.23,115912,11.05.2020 04:29:58,tp 115.912,-2.07,-47.53000000002794,0.0,0.0,114622,06.05.2020 20:00:00,18324,-0.016459764688747956,106.54,IS,0.09,0.0,Phase3-EA-TR1v1-EURJPY-M30-91,EURJPYMT4,3188,4d 8h 29m,Buy
198712.84,1.05253,11.05.2020 05:55:00,,-1.01,-51.92000000004191,0.0,0.0,1.05261,08.05.2020 21:35:00,18325,-0.017980033297706317,-4.39,IS,0.41,0.0,Phase3-EA-SA2v2-EURCHF-M5-43,EURCHFMT4,9434,2d 8h 20m,Buy
198712.67,1.05154,12.05.2020 05:30:00,,-1.01,-52.09000000002561,0.0,0.0,1.05152,11.05.2020 21:10:00,18326,-0.018038904747250128,-0.17,IS,0.41,0.0,Phase3-EA-SA2v2-EURCHF-M5-43,EURCHFMT4,9436,8h 20m,Buy
198688.56,107525,12.05.2020 10:45:00,,0.0,-76.20000000001164,0.0,0.0,107621,12.05.2020 00:15:00,18327,-0.026388261503935376,-24.11,IS,0.27,0.0,Phase3-EA-S1v2-USDJPY-M15-0,USDJPYMT4,5032,10h 30m,Buy
198793.41,116528,12.05.2020 16:29:58,tp 116.528,-0.82,-0.0,0.0,0.0,115268,08.05.2020 04:30:00,18328,-0.0,104.85,IS,0.09,0.0,Phase3-EA-TR1v1-EURJPY-M30-91,EURJPYMT4,3189,4d 11h 59m,Buy
198807.2,1.05179,13.05.2020 05:50:00,,-1.02,-0.0,0.0,0.0,1.05144,12.05.2020 21:30:00,18329,-0.0,13.79,IS,0.41,0.0,Phase3-EA-SA2v2-EURCHF-M5-43,EURCHFMT4,9438,8h 20m,Buy
198855.24,131553,13.05.2020 06:35:00,,0.0,-0.0,0.0,0.0,131329,13.05.2020 01:10:00,18330,-0.0,48.04,IS,0.23,0.0,Phase3-EA-S4v1-GBPJPY-M5-194,GBPJPYMT4,3974,5h 25m,Buy
198862.95,1.05179,13.05.2020 12:30:00,,0.0,-0.0,0.0,0.0,1.05201,13.05.2020 03:45:00,18331,-0.0,7.71,IS,0.34,0.0,Phase3-EA-S4v1-EURCHF-M15-221,EURCHFMT4,4840,8h 45m,Sell
198858.64,1.05176,14.05.2020 04:25:00,,-3.04,-4.309999999997672,0.0,0.0,1.05179,13.05.2020 20:05:00,18332,-0.0014920570464289926,-4.31,IS,0.41,0.0,Phase3-EA-SA2v2-EURCHF-M5-43,EURCHFMT4,9440,8h 20m,Buy
198863.18,1.05157,14.05.2020 10:30:00,,0.0,-0.0,0.0,0.0,1.05144,14.05.2020 01:45:00,18333,-0.0,4.54,IS,0.34,0.0,Phase3-EA-S4v1-EURCHF-M15-221,EURCHFMT4,4842,8h 45m,Buy
198888.33,107354,15.05.2020 04:00:00,,0.0,-0.0,0.0,0.0,107254,15.05.2020 01:15:00,18334,-0.0,25.15,IS,0.27,0.0,Phase3-EA-S1v2-USDJPY-M15-0,USDJPYMT4,5034,2h 45m,Buy
198904.19,131129,15.05.2020 05:30:00,,0.0,-0.0,0.0,0.0,131203,15.05.2020 00:05:00,18335,-0.0,15.86,IS,0.23,0.0,Phase3-EA-S4v1-GBPJPY-M5-194,GBPJPYMT4,3976,5h 25m,Sell
198882.28,1.05165,15.05.2020 08:10:00,,-2.11,-21.90999999997439,0.0,0.0,1.05118,14.05.2020 23:50:00,18336,-0.007583829088797334,-21.91,IS,0.41,0.0,Phase3-EA-SA2v2-EURCHF-M5-43,EURCHFMT4,9442,8h 20m,Sell
198888.92,1.05151,15.05.2020 10:15:00,,0.0,-15.269999999960419,0.0,0.0,1.0517,15.05.2020 01:30:00,18337,-0.005285489282782769,6.64,IS,0.34,0.0,Phase3-EA-S4v1-EURCHF-M15-221,EURCHFMT4,4844,8h 45m,Sell
199041.85,129554,18.05.2020 01:00:00,tp 129.554,-2.44,-0.0,0.0,0.0,131404,13.05.2020 02:30:00,18338,-0.0,152.93,IS,0.09,0.0,Phase3-EA-B1v1-GBPJPY-M30-1,GBPJPYMT4,1630,4d 22h 30m,Sell
199037.46,1.0514,18.05.2020 05:50:00,,-1.01,-4.39000000001397,0.0,0.0,1.05148,15.05.2020 21:30:00,18339,-0.0015188112032959778,-4.39,IS,0.41,0.0,Phase3-EA-SA2v2-EURCHF-M5-43,EURCHFMT4,9444,2d 8h 20m,Buy
199045.83,129648,18.05.2020 08:25:00,,0.0,-0.0,0.0,0.0,129687,18.05.2020 03:00:00,18340,-0.0,8.37,IS,0.23,0.0,Phase3-EA-S4v1-GBPJPY-M5-194,GBPJPYMT4,3978,5h 25m,Sell
199058.78,1.05142,18.05.2020 10:45:00,,0.0,-0.0,0.0,0.0,1.05105,18.05.2020 02:00:00,18341,-0.0,12.95,IS,0.34,0.0,Phase3-EA-S4v1-EURCHF-M15-221,EURCHFMT4,4846,8h 45m,Buy
199038.9,107175,18.05.2020 10:45:00,,-0.73,-19.880000000004657,0.0,0.0,107251,15.05.2020 23:45:00,18342,-0.006877493913177309,-19.88,IS,0.27,0.0,Phase3-EA-S1v2-USDJPY-M15-0,USDJPYMT4,5036,2d 11h 0m,Buy
198999.72,116.48,18.05.2020 16:44:57,sl 116.480,-2.77,-59.05999999999767,0.0,0.0,116.25,13.05.2020 08:15:00,18343,-0.02043183050865899,-39.18,IS,0.17,0.0,Phase3-EA-T1v2-EURJPY-M15-322,EURJPYMT4,3644,5d 8h 29m,Sell
198937.94,116928,18.05.2020 19:29:58,sl 116.928,-1.46,-120.84000000002561,0.0,0.0,116388,12.05.2020 21:30:00,18344,-0.041804646100016475,-61.78,IS,0.09,0.0,Phase3-EA-TR1v1-EURJPY-M30-91,EURJPYMT4,3192,5d 21h 59m,Sell
198731.3,1.06244,18.05.2020 21:14:58,sl 1.06244,0.0,-327.4800000000396,0.0,0.0,1.05754,18.05.2020 20:05:00,18345,-0.1132918363524673,-206.64,IS,0.41,0.0,Phase3-EA-SA2v2-EURCHF-M5-43,EURCHFMT4,9446,1h 9m,Sell
198664.09,117168,18.05.2020 21:29:58,sl 117.168,-1.75,-394.69000000006054,0.0,0.0,116208,13.05.2020 01:30:00,18346,-0.13654316260521795,-67.21,IS,0.09,0.0,Phase3-EA-TR1v1-EURJPY-M30-91,EURJPYMT4,3193,5d 19h 59m,Sell
198710.35,1.0635,18.05.2020 21:29:58,tp 1.06350,0.0,-348.4300000000512,0.0,0.0,1.0646,18.05.2020 21:15:00,18347,-0.12053949719155739,46.26,IS,0.41,0.0,Phase3-EA-SA2v2-EURCHF-M5-43,EURCHFMT4,9448,14m 58s,Sell
198756.76,1.06148,19.05.2020 01:44:57,tp 1.06148,0.0,-302.02000000007683,0.0,0.0,1.06038,19.05.2020 01:05:00,18348,-0.10448393921820186,46.41,IS,0.41,0.0,Phase3-EA-SA2v2-EURCHF-M5-43,EURCHFMT4,9450,39m 57s,Buy
198654.02,0.97096,19.05.2020 04:30:00,,0.0,-404.7600000000675,0.0,0.0,0.97268,19.05.2020 00:15:00,18349,-0.14002688311355432,-102.74,IS,0.58,0.0,Phase3-EA-SA2v2-USDCHF-M15-107,USDCHFMT4,3686,4h 15m,Buy
198758.87,118095,19.05.2020 16:29:58,tp 118.095,-0.41,-299.9100000000908,0.0,0.0,116835,18.05.2020 19:30:00,18350,-0.10375398387832738,104.85,IS,0.09,0.0,Phase3-EA-TR1v1-EURJPY-M30-91,EURJPYMT4,3195,20h 59m,Buy
198805.26,1.06241,19.05.2020 20:59:59,tp 1.06241,0.0,-253.52000000007683,0.0,0.0,1.06351,19.05.2020 20:05:00,18351,-0.08770534491291909,46.39,IS,0.41,0.0,Phase3-EA-SA2v2-EURCHF-M5-43,EURCHFMT4,9452,54m 59s,Sell
198864.96,0.97146,19.05.2020 23:59:58,tp 0.97146,0.0,-193.8200000000652,0.0,0.0,0.97046,19.05.2020 22:30:00,18352,-0.06705210614950514,59.7,IS,0.58,0.0,Phase3-EA-SA2v2-USDCHF-M15-107,USDCHFMT4,3688,1h 29m,Buy
198924.72,0.97055,20.05.2020 01:00:00,tp 0.97055,0.0,-134.06000000005588,0.0,0.0,0.97155,20.05.2020 00:15:00,18353,-0.04637811036220917,59.76,IS,0.58,0.0,Phase3-EA-SA2v2-USDCHF-M15-107,USDCHFMT4,3690,45m 0s,Sell
198923.99,107828,20.05.2020 03:00:00,,-0.73,-134.79000000003725,0.0,0.0,107828,19.05.2020 21:00:00,18354,-0.04663065415277709,-0.73,IS,0.27,0.0,Phase3-EA-S1v2-USDJPY-M15-0,USDJPYMT4,5038,6h 0m,Buy
199007.1,132321,20.05.2020 04:09:59,tp 132.321,0.0,-51.68000000005122,0.0,0.0,131931,20.05.2020 00:15:00,18355,-0.01787871657109016,83.11,IS,0.23,0.0,Phase3-EA-S4v1-GBPJPY-M5-194,GBPJPYMT4,3980,3h 54m,Buy
198961.7,1.06128,20.05.2020 06:05:00,,-1.01,-97.0800000000745,0.0,0.0,1.06233,19.05.2020 21:45:00,18356,-0.03358486464243507,-45.4,IS,0.41,0.0,Phase3-EA-SA2v2-EURCHF-M5-43,EURCHFMT4,9454,8h 20m,Buy
198931.48,1.06018,20.05.2020 11:15:00,,0.0,-127.30000000004657,0.0,0.0,1.06104,20.05.2020 02:30:00,18357,-0.04403948567140778,-30.22,IS,0.34,0.0,Phase3-EA-S4v1-EURCHF-M15-221,EURCHFMT4,4848,8h 45m,Buy
198913.56,1.05914,21.05.2020 05:05:00,,-3.06,-145.22000000003027,0.0,0.0,1.05949,20.05.2020 20:45:00,18358,-0.050238916804405585,-17.92,IS,0.41,0.0,Phase3-EA-SA2v2-EURCHF-M5-43,EURCHFMT4,9456,8h 20m,Buy
198996.84,131339,21.05.2020 05:39:58,tp 131.339,0.0,-61.94000000000233,0.0,0.0,131729,21.05.2020 02:45:00,18359,-0.021428167655036155,83.28,IS,0.23,0.0,Phase3-EA-S4v1-GBPJPY-M5-194,GBPJPYMT4,3982,2h 54m,Sell
199008.42,118023,21.05.2020 07:15:00,,-2.32,-50.35999999998603,0.0,0.0,117935,20.05.2020 04:30:00,18360,-0.017422062045645476,11.58,IS,0.17,0.0,Phase3-EA-T1v2-EURJPY-M15-322,EURJPYMT4,3646,1d 2h 45m,Buy
199059.82,1.06037,21.05.2020 14:45:00,,0.0,-0.0,0.0,0.0,1.05891,21.05.2020 06:00:00,18361,-0.0,51.4,IS,0.34,0.0,Phase3-EA-S4v1-EURCHF-M15-221,EURCHFMT4,4850,8h 45m,Buy
199023.52,117926,21.05.2020 18:59:58,sl 117.926,0.0,-36.29999999998836,0.0,0.0,118156,21.05.2020 11:00:00,18362,-0.012557954267040032,-36.3,IS,0.17,0.0,Phase3-EA-T1v2-EURJPY-M15-322,EURJPYMT4,3648,7h 59m,Buy
199052.8,0.97059,22.05.2020 04:30:00,,0.0,-7.019999999960419,0.0,0.0,0.97108,22.05.2020 00:15:00,18363,-0.002428563056588216,29.28,IS,0.58,0.0,Phase3-EA-SA2v2-USDCHF-M15-107,USDCHFMT4,3692,4h 15m,Sell
199080.16,131574,22.05.2020 05:35:00,,0.0,-0.0,0.0,0.0,131446,22.05.2020 00:10:00,18364,-0.0,27.36,IS,0.23,0.0,Phase3-EA-S4v1-GBPJPY-M5-194,GBPJPYMT4,3984,5h 25m,Buy
199082.27,1.06294,22.05.2020 05:55:00,,-2.11,-0.0,0.0,0.0,1.06304,21.05.2020 21:35:00,18365,-0.0,2.11,IS,0.41,0.0,Phase3-EA-SA2v2-EURCHF-M5-43,EURCHFMT4,9458,8h 20m,Sell
199039.74,1.22036,22.05.2020 09:29:58,sl 1.22036,-0.53,-42.53000000002794,0.0,0.0,1.22336,21.05.2020 16:30:00,18366,-0.014712074870599222,-42.53,IS,0.14,0.0,Phase3-EA-B1v1-GBPUSD-M30-14,GBPUSDMT4,1236,16h 59m,Buy
199084.07,1.05809,25.05.2020 01:14:57,tp 1.05809,-2.11,-0.0,0.0,0.0,1.05919,22.05.2020 21:10:00,18367,-0.0,44.33,IS,0.41,0.0,Phase3-EA-SA2v2-EURCHF-M5-43,EURCHFMT4,9460,2d 4h 4m,Sell
199084.71,131199,25.05.2020 08:30:00,,0.0,-0.0,0.0,0.0,131202,25.05.2020 03:05:00,18368,-0.0,0.64,IS,0.23,0.0,Phase3-EA-S4v1-GBPJPY-M5-194,GBPJPYMT4,3986,5h 25m,Sell
199098.62,1.0591,25.05.2020 09:40:00,,0.0,-0.0,0.0,0.0,1.05877,25.05.2020 01:20:00,18369,-0.0,13.91,IS,0.41,0.0,Phase3-EA-SA2v2-EURCHF-M5-43,EURCHFMT4,9462,8h 20m,Buy
199091.36,117366,25.05.2020 21:30:00,,0.0,-7.260000000009313,0.0,0.0,117412,25.05.2020 13:45:00,18370,-0.002511253772158888,-7.26,IS,0.17,0.0,Phase3-EA-T1v2-EURJPY-M15-322,EURJPYMT4,3650,7h 45m,Buy
199136.77,1.05897,26.05.2020 03:49:57,tp 1.05897,-1.01,-0.0,0.0,0.0,1.05787,25.05.2020 20:10:00,18371,-0.0,45.41,IS,0.41,0.0,Phase3-EA-SA2v2-EURCHF-M5-43,EURCHFMT4,9464,7h 39m,Buy
199220.04,131632,26.05.2020 04:54:58,tp 131.632,0.0,-0.0,0.0,0.0,131242,26.05.2020 01:05:00,18372,-0.0,83.27,IS,0.23,0.0,Phase3-EA-S4v1-GBPJPY-M5-194,GBPJPYMT4,3988,3h 49m,Buy
199159.35,118053,26.05.2020 12:59:57,sl 118.053,-0.58,-60.69000000000233,0.0,0.0,117962,19.05.2020 19:30:00,18373,-0.020984023098815047,-60.69,IS,0.09,0.0,Phase3-EA-TR1v1-EURJPY-M30-91,EURJPYMT4,3198,6d 17h 29m,Sell
199123.17,1.06023,26.05.2020 15:00:00,,0.0,-96.86999999999534,0.0,0.0,1.0592,26.05.2020 06:15:00,18374,-0.033493529701467094,-36.18,IS,0.34,0.0,Phase3-EA-S4v1-EURCHF-M15-221,EURCHFMT4,4852,8h 45m,Sell
199148.03,107517,26.05.2020 23:15:00,,0.0,-72.01000000000931,0.0,0.0,107616,26.05.2020 18:00:00,18375,-0.024897998077868005,24.86,IS,0.27,0.0,Phase3-EA-S1v2-USDJPY-M15-0,USDJPYMT4,5040,5h 15m,Sell
199155.12,0.96546,27.05.2020 03:00:00,,-0.72,-64.9199999999837,0.0,0.0,0.96533,26.05.2020 22:45:00,18376,-0.02244657735334781,7.09,IS,0.58,0.0,Phase3-EA-SA2v2-USDCHF-M15-107,USDCHFMT4,3694,4h 15m,Buy
199113.8,1.05948,27.05.2020 06:20:00,,-1.02,-106.23999999999069,0.0,0.0,1.06043,26.05.2020 22:00:00,18377,-0.03673327754189866,-41.32,IS,0.41,0.0,Phase3-EA-SA2v2-EURCHF-M5-43,EURCHFMT4,9466,8h 20m,Buy
199254.06,1.06373,27.05.2020 12:14:58,tp 1.06373,0.0,-0.0,0.0,0.0,1.05973,27.05.2020 05:00:00,18378,-0.0,140.26,IS,0.34,0.0,Phase3-EA-S4v1-EURCHF-M15-221,EURCHFMT4,4854,7h 14m,Buy
199186.57,118742,27.05.2020 13:59:58,sl 118.742,-2.33,-67.48999999999069,0.0,0.0,117333,22.05.2020 11:00:00,18379,-0.023332429629506483,-67.49,IS,0.09,0.0,Phase3-EA-TR1v1-EURJPY-M30-91,EURJPYMT4,3199,5d 2h 59m,Sell
199246.43,0.96888,27.05.2020 23:14:57,tp 0.96888,0.0,-7.630000000004657,0.0,0.0,0.96788,27.05.2020 22:00:00,18380,-0.002637819500270672,59.86,IS,0.58,0.0,Phase3-EA-SA2v2-USDCHF-M15-107,USDCHFMT4,3696,1h 14m,Buy
199292.97,1.0648,27.05.2020 23:14:58,tp 1.06480,0.0,-0.0,0.0,0.0,1.0637,27.05.2020 20:05:00,18381,-0.0,46.54,IS,0.41,0.0,Phase3-EA-SA2v2-EURCHF-M5-43,EURCHFMT4,9468,3h 9m,Buy
199293.8,107756,28.05.2020 03:00:00,,-2.18,-0.0,0.0,0.0,107744,27.05.2020 18:30:00,18382,-0.0,0.83,IS,0.27,0.0,Phase3-EA-S1v2-USDJPY-M15-0,USDJPYMT4,5042,8h 30m,Buy
199275.83,0.96814,28.05.2020 05:30:00,,0.0,-17.96999999997206,0.0,0.0,0.96844,28.05.2020 01:15:00,18383,-0.00621167823160123,-17.97,IS,0.58,0.0,Phase3-EA-SA2v2-USDCHF-M15-107,USDCHFMT4,3698,4h 15m,Buy
199234.0,132281,28.05.2020 05:55:00,,0.0,-59.79999999998836,0.0,0.0,132085,28.05.2020 00:30:00,18384,-0.020671027170298208,-41.83,IS,0.23,0.0,Phase3-EA-S4v1-GBPJPY-M5-194,GBPJPYMT4,3990,5h 25m,Sell
199173.46,1.06631,28.05.2020 08:10:00,,-6.35,-120.3399999999674,0.0,0.0,1.06503,27.05.2020 23:50:00,18385,-0.04159784966009192,-60.54,IS,0.41,0.0,Phase3-EA-SA2v2-EURCHF-M5-43,EURCHFMT4,9470,8h 20m,Sell
199121.14,1.06713,28.05.2020 10:15:00,,0.0,-172.6599999999744,0.0,0.0,1.06564,28.05.2020 01:30:00,18386,-0.05968327008735542,-52.32,IS,0.34,0.0,Phase3-EA-S4v1-EURCHF-M15-221,EURCHFMT4,4856,8h 45m,Sell
199128.39,118647,28.05.2020 12:00:00,,0.0,-165.4099999999744,0.0,0.0,118601,28.05.2020 00:45:00,18387,-0.05717716729496928,7.25,IS,0.17,0.0,Phase3-EA-T1v2-EURJPY-M15-322,EURJPYMT4,3652,11h 15m,Buy
199232.13,119315,28.05.2020 21:29:58,tp 119.315,-1.64,-61.6699999999837,0.0,0.0,118055,26.05.2020 13:00:00,18388,-0.021317428856056884,103.74,IS,0.09,0.0,Phase3-EA-TR1v1-EURJPY-M30-91,EURJPYMT4,3201,2d 8h 29m,Buy
199278.92,1.06838,28.05.2020 21:39:58,tp 1.06838,0.0,-14.880000000004657,0.0,0.0,1.06728,28.05.2020 20:00:00,18389,-0.005143559938029991,46.79,IS,0.41,0.0,Phase3-EA-SA2v2-EURCHF-M5-43,EURCHFMT4,9472,1h 39m,Buy
199323.6,1.06719,29.05.2020 01:04:58,tp 1.06719,-2.13,-0.0,0.0,0.0,1.06829,28.05.2020 21:55:00,18390,-0.0,44.68,IS,0.41,0.0,Phase3-EA-SA2v2-EURCHF-M5-43,EURCHFMT4,9474,3h 9m,Sell
199384.85,132393,29.05.2020 08:00:00,,0.0,-0.0,0.0,0.0,132679,29.05.2020 02:35:00,18391,-0.0,61.25,IS,0.23,0.0,Phase3-EA-S4v1-GBPJPY-M5-194,GBPJPYMT4,3992,5h 25m,Sell
199536.18,133059,29.05.2020 18:29:58,tp 133.059,-3.6,-0.0,0.0,0.0,131209,19.05.2020 04:30:00,18392,-0.0,151.33,IS,0.09,0.0,Phase3-EA-B1v1-GBPJPY-M30-1,GBPJPYMT4,1632,10d 13h 59m,Buy
199534.73,1.06761,30.05.2020 00:49:59,end of test,-1.02,-1.4500000000116415,0.0,0.0,1.06762,29.05.2020 20:25:00,18393,-5.008009707151752E-4,-1.45,IS,0.41,0.0,Phase3-EA-SA2v2-EURCHF-M5-43,EURCHFMT4,9476,4h 24m,Buy
199724.88,1.2355,30.05.2020 00:59:59,end of test,-3.19,-0.0,0.0,0.0,1.22169,26.05.2020 05:00:00,18394,-0.0,190.15,IS,0.14,0.0,Phase3-EA-B1v1-GBPUSD-M30-14,GBPUSDMT4,1238,3d 19h 59m,Buy
199760.54,119714,30.05.2020 00:59:59,end of test,-0.82,-0.0,0.0,0.0,119277,28.05.2020 21:30:00,18395,-0.0,35.66,IS,0.09,0.0,Phase3-EA-TR1v1-EURJPY-M30-91,EURJPYMT4,3204,1d 3h 29m,Buy
199840.67,119714,30.05.2020 23:59:00,end of test,-0.77,-0.0,0.0,0.0,119201,29.05.2020 13:00:00,18396,-0.0,80.13,IS,0.17,0.0,Phase3-EA-T1v2-EURJPY-M15-322,EURJPYMT4,3654,1d 10h 59m,Buy
